,Unnamed: 0,Player,Season,Age,Player_Season_Num,PTS,GP,prev_GP,prev_G,prev_A,prev_PTS,prev_S,prev_TOI,career_GP,career_G,career_A,career_PTS,career_S,games,total_goals_per_game,goals_pp,chances_pp,shots,shot_pct,pts_per_game_predict
0,0,A.J. Greer,2017-18,21.0,2,1,5,5,0,1,1,8.0,68.0,5,0,1,1,8.0,82,5.45,47,245,2478,9.0,0.27470005
1,1,A.J. Greer,2018-19,22.0,3,3,17,17,0,3,3,13.0,126.0,22,0,4,4,21.0,82,5.86,50,250,2620,9.2,0.18568274
2,2,A.J. Greer,2019-20,23.0,4,2,15,15,1,1,2,9.0,94.0,37,1,5,6,30.0,82,5.96,47,239,2579,9.5,0.20595708
3,3,Aaron Broten,1981-82,21.0,2,0,2,2,0,0,0,1.0,,2,0,0,0,1.0,80,7.69,77,340,2441,12.6,0.24642405
4,4,Aaron Broten,1982-83,22.0,3,39,58,58,15,24,39,67.0,,60,15,24,39,68.0,80,8.03,73,320,2489,12.9,0.59473306
5,5,Aaron Broten,1983-84,23.0,4,55,73,73,16,39,55,126.0,,133,31,63,94,194.0,80,7.73,71,310,2444,12.7,0.6578746
6,6,Aaron Broten,1984-85,24.0,5,36,80,80,13,23,36,103.0,,213,44,86,130,297.0,80,7.89,74,336,2448,12.9,0.5088616
7,7,Aaron Broten,1985-86,25.0,6,57,80,80,22,35,57,169.0,,293,66,121,187,466.0,80,7.77,71,321,2447,12.7,0.6855526
8,8,Aaron Broten,1986-87,26.0,7,43,66,66,18,25,43,157.0,,359,84,146,230,623.0,80,7.94,82,370,2484,12.8,0.7094641
9,9,Aaron Broten,1987-88,27.0,8,79,80,80,26,53,79,179.0,,439,110,199,309,802.0,80,7.34,72,344,2400,12.2,0.876771
10,10,Aaron Broten,1988-89,28.0,9,83,80,80,26,57,83,180.0,,519,136,256,392,982.0,80,7.43,89,437,2435,12.2,0.8888469
11,11,Aaron Broten,1989-90,29.0,10,59,80,80,16,43,59,178.0,,599,152,299,451,1160.0,80,7.48,85,403,2430,12.3,0.69467646
12,12,Aaron Broten,1990-91,30.0,11,36,77,77,19,17,36,148.0,,676,171,316,487,1308.0,80,7.37,76,367,2421,12.2,0.44641948
13,13,Aaron Broten,1991-92,31.0,12,19,47,47,11,8,19,85.0,,723,182,324,506,1393.0,80,6.91,71,366,2385,11.6,0.4292551
14,14,Aaron Broten,1992-93,32.0,13,9,25,25,4,5,9,29.0,,748,186,329,515,1422.0,80,6.96,77,402,2440,11.4,0.4776288
15,15,Aaron Downey,2000-01,26.0,2,0,1,1,0,0,0,0.0,9.0,1,0,0,0,0.0,82,5.49,53,331,2294,9.8,0.15208486
16,16,Aaron Downey,2001-02,27.0,3,0,3,3,0,0,0,2.0,17.0,4,0,0,0,2.0,82,5.51,63,376,2272,9.9,0.1464718
17,17,Aaron Downey,2002-03,28.0,4,1,36,36,1,0,1,10.0,184.0,40,1,0,1,12.0,82,5.24,53,338,2262,9.5,0.10240513
18,18,Aaron Downey,2003-04,29.0,5,2,43,43,1,1,2,14.0,205.0,83,2,1,3,26.0,82,5.31,60,363,2326,9.4,0.08956024
19,19,Aaron Downey,2004-05,30.0,6,2,37,37,1,1,2,11.0,167.0,120,3,2,5,37.0,82,5.14,57,348,2300,9.2,0.0913783
20,20,Aaron Downey,2006-07,32.0,7,7,42,42,3,4,7,21.0,235.0,162,6,6,12,58.0,82,6.05,85,480,2458,10.1,0.112455696
21,21,Aaron Downey,2007-08,33.0,8,1,21,21,1,0,1,10.0,105.0,183,7,6,13,68.0,82,5.76,70,398,2426,9.7,0.089019
22,22,Aaron Downey,2008-09,34.0,9,3,56,56,0,3,3,15.0,257.0,239,7,9,16,83.0,82,5.44,62,351,2383,9.4,0.09130582
23,23,Aaron Downey,2009-10,35.0,10,2,4,4,1,1,2,2.0,21.0,243,8,10,18,85.0,82,5.7,65,341,2477,9.4,0.15157661
24,24,Aaron Ekblad,2015-16,19.0,2,39,81,81,12,27,39,170.0,1767.0,81,12,27,39,170.0,82,5.32,47,251,2453,8.9,0.5474535
25,25,Aaron Ekblad,2016-17,20.0,3,36,78,78,15,21,36,182.0,1691.0,159,27,48,75,352.0,82,5.34,48,255,2438,9.0,0.50914305
26,26,Aaron Ekblad,2017-18,21.0,4,21,68,68,10,11,21,225.0,1459.0,227,37,59,96,577.0,82,5.45,47,245,2478,9.0,0.4635343
27,27,Aaron Ekblad,2018-19,22.0,5,38,82,82,16,22,38,189.0,1918.0,309,53,81,134,766.0,82,5.86,50,250,2620,9.2,0.5613605
28,28,Aaron Ekblad,2019-20,23.0,6,37,82,82,13,24,37,180.0,1939.0,391,66,105,171,946.0,82,5.96,47,239,2579,9.5,0.5949527
29,29,Aaron Ekblad,2020-21,24.0,7,41,67,67,5,36,41,147.0,1539.0,458,71,141,212,1093.0,70,5.96,42,208,2192,9.5,0.5754548
30,30,Aaron Gagnon,2010-11,24.0,2,0,2,2,0,0,0,2.0,18.0,2,0,0,0,2.0,82,5.53,56,304,2486,9.1,0.17076418
31,31,Aaron Gagnon,2011-12,25.0,3,2,19,19,0,2,2,9.0,153.0,21,0,2,2,11.0,82,5.46,52,291,2492,9.0,0.1084511
32,32,Aaron Gagnon,2012-13,26.0,4,0,7,7,0,0,0,6.0,66.0,28,0,2,2,17.0,82,5.32,47,271,2439,8.9,0.14722037
33,33,Aaron Gagnon,2013-14,27.0,5,3,10,10,3,0,3,11.0,82.0,38,3,2,5,28.0,48,5.31,29,160,1399,9.1,0.3094496
34,34,Aaron Gavey,1996-97,22.0,2,12,73,73,8,4,12,65.0,,73,8,4,12,65.0,82,6.29,74,413,2481,10.4,0.23165616
35,35,Aaron Gavey,1997-98,23.0,3,19,57,57,8,11,19,62.0,,130,16,15,31,127.0,82,5.83,55,336,2444,9.8,0.30973637
36,36,Aaron Gavey,1998-99,24.0,4,5,26,26,2,3,5,27.0,,156,18,18,36,154.0,82,5.28,57,380,2242,9.6,0.2222316
37,37,Aaron Gavey,1999-00,25.0,5,0,7,7,0,0,0,4.0,57.0,163,18,18,36,158.0,82,5.27,57,359,2285,9.4,0.16945544
38,38,Aaron Gavey,2000-01,26.0,6,13,41,41,7,6,13,39.0,406.0,204,25,24,49,197.0,82,5.49,53,331,2294,9.8,0.2579279
39,39,Aaron Gavey,2001-02,27.0,7,24,75,75,10,14,24,100.0,1050.0,279,35,38,73,297.0,82,5.51,63,376,2272,9.9,0.26957893
40,40,Aaron Gavey,2002-03,28.0,8,17,71,71,6,11,17,75.0,846.0,350,41,49,90,372.0,82,5.24,53,338,2262,9.5,0.2431882
41,41,Aaron Gavey,2003-04,29.0,9,1,5,5,0,1,1,8.0,57.0,355,41,50,91,380.0,82,5.31,60,363,2326,9.4,0.20566598
42,42,Aaron Gavey,2006-07,32.0,10,0,5,5,0,0,0,2.0,20.0,360,41,50,91,382.0,82,6.05,85,480,2458,10.1,0.19019431
43,43,Aaron Johnson,2004-05,21.0,2,8,29,29,2,6,8,33.0,436.0,29,2,6,8,33.0,82,5.14,57,348,2300,9.2,0.3014567
44,44,Aaron Johnson,2006-07,23.0,3,8,26,26,2,6,8,28.0,369.0,55,4,12,16,61.0,82,6.05,85,480,2458,10.1,0.2693982
45,45,Aaron Johnson,2007-08,24.0,4,10,61,61,3,7,10,52.0,776.0,116,7,19,26,113.0,82,5.76,70,398,2426,9.7,0.21973997
46,46,Aaron Johnson,2008-09,25.0,5,2,30,30,0,2,2,16.0,416.0,146,7,21,28,129.0,82,5.44,62,351,2383,9.4,0.1348094
47,47,Aaron Johnson,2009-10,26.0,6,8,38,38,3,5,8,27.0,537.0,184,10,26,36,156.0,82,5.7,65,341,2477,9.4,0.16274837
48,48,Aaron Johnson,2010-11,27.0,7,10,41,41,4,6,10,36.0,642.0,225,14,32,46,192.0,82,5.53,56,304,2486,9.1,0.20213282
49,49,Aaron Johnson,2012-13,29.0,8,16,56,56,3,13,16,63.0,924.0,281,17,45,62,255.0,82,5.32,47,271,2439,8.9,0.20535618
50,50,Aaron Johnson,2013-14,30.0,9,0,10,10,0,0,0,8.0,149.0,291,17,45,62,263.0,48,5.31,29,160,1399,9.1,0.14739034
51,51,Aaron MacKenzie,2009-10,28.0,2,0,5,5,0,0,0,3.0,73.0,5,0,0,0,3.0,82,5.7,65,341,2477,9.4,0.1468429
52,52,Aaron Miller,1994-95,23.0,2,0,1,1,0,0,0,0.0,,1,0,0,0,0.0,84,6.48,76,407,2545,10.7,0.16312629
53,53,Aaron Miller,1995-96,24.0,3,3,9,9,0,3,3,12.0,,10,0,3,3,12.0,48,5.97,37,209,1408,10.2,0.23614907
54,54,Aaron Miller,1996-97,25.0,4,0,5,5,0,0,0,2.0,,15,0,3,3,14.0,82,6.29,74,413,2481,10.4,0.15546519
55,55,Aaron Miller,1997-98,26.0,5,17,56,56,5,12,17,47.0,,71,5,15,20,61.0,82,5.83,55,336,2444,9.8,0.23349947
56,56,Aaron Miller,1998-99,27.0,6,4,55,55,2,2,4,29.0,,126,7,17,24,90.0,82,5.28,57,380,2242,9.6,0.10458857
57,57,Aaron Miller,1999-00,28.0,7,18,76,76,5,13,18,87.0,1658.0,202,12,30,42,177.0,82,5.27,57,359,2285,9.4,0.20513263
58,58,Aaron Miller,2000-01,29.0,8,8,53,53,1,7,8,44.0,1012.0,255,13,37,50,221.0,82,5.49,53,331,2294,9.8,0.15202108
59,59,Aaron Miller,2001-02,30.0,9,18,69,69,4,14,18,59.0,1327.0,324,17,51,68,280.0,82,5.51,63,376,2272,9.9,0.20544446
60,60,Aaron Miller,2002-03,31.0,10,17,74,74,5,12,17,75.0,1654.0,398,22,63,85,355.0,82,5.24,53,338,2262,9.5,0.2153266
61,61,Aaron Miller,2003-04,32.0,11,6,49,49,1,5,6,34.0,1053.0,447,23,68,91,389.0,82,5.31,60,363,2326,9.4,0.13099712
62,62,Aaron Miller,2004-05,33.0,12,3,35,35,1,2,3,26.0,665.0,482,24,70,94,415.0,82,5.14,57,348,2300,9.2,0.16215804
63,63,Aaron Miller,2006-07,35.0,13,8,56,56,0,8,8,32.0,1033.0,538,24,78,102,447.0,82,6.05,85,480,2458,10.1,0.11298072
64,64,Aaron Miller,2007-08,36.0,14,8,82,82,0,8,8,56.0,1607.0,620,24,86,110,503.0,82,5.76,70,398,2426,9.7,0.1216079
65,65,Aaron Miller,2008-09,37.0,15,9,57,57,1,8,9,27.0,988.0,677,25,94,119,530.0,82,5.44,62,351,2383,9.4,0.110984355
66,66,Aaron Ness,2012-13,22.0,2,0,9,9,0,0,0,6.0,152.0,9,0,0,0,6.0,82,5.32,47,271,2439,8.9,0.17404303
67,67,Aaron Ness,2014-15,24.0,3,3,20,20,1,2,3,23.0,296.0,29,1,2,3,29.0,82,5.34,48,269,2463,8.9,0.1965099
68,68,Aaron Ness,2016-17,26.0,4,2,8,8,0,2,2,8.0,99.0,37,1,4,5,37.0,82,5.34,48,255,2438,9.0,0.16048291
69,69,Aaron Ness,2017-18,27.0,5,0,2,2,0,0,0,0.0,26.0,39,1,4,5,37.0,82,5.45,47,245,2478,9.0,0.13356665
70,70,Aaron Ness,2018-19,28.0,6,1,8,8,0,1,1,2.0,102.0,47,1,5,6,39.0,82,5.86,50,250,2620,9.2,0.13388449
71,71,Aaron Ness,2020-21,30.0,7,1,24,24,0,1,1,11.0,301.0,71,1,6,7,50.0,70,5.96,42,208,2192,9.5,0.09146544
72,72,Aaron Palushaj,2011-12,22.0,2,0,3,3,0,0,0,3.0,26.0,3,0,0,0,3.0,82,5.46,52,291,2492,9.0,0.18394265
73,73,Aaron Palushaj,2012-13,23.0,3,5,38,38,1,4,5,37.0,288.0,41,1,4,5,40.0,82,5.32,47,271,2439,8.9,0.1736519
74,74,Aaron Palushaj,2013-14,24.0,4,9,25,25,2,7,9,29.0,283.0,66,3,11,14,69.0,48,5.31,29,160,1399,9.1,0.25962344
75,75,Aaron Palushaj,2014-15,25.0,5,0,2,2,0,0,0,2.0,19.0,68,3,11,14,71.0,82,5.34,48,269,2463,8.9,0.14689988
76,76,Aaron Rome,2007-08,24.0,2,0,1,1,0,0,0,1.0,15.0,1,0,0,0,1.0,82,5.76,70,398,2426,9.7,0.1588009
77,77,Aaron Rome,2008-09,25.0,3,2,17,17,1,1,2,15.0,309.0,18,1,1,2,16.0,82,5.44,62,351,2383,9.4,0.18935585
78,78,Aaron Rome,2009-10,26.0,4,1,8,8,0,1,1,7.0,124.0,26,1,2,3,23.0,82,5.7,65,341,2477,9.4,0.16784915
79,79,Aaron Rome,2010-11,27.0,5,4,49,49,0,4,4,49.0,744.0,75,1,6,7,72.0,82,5.53,56,304,2486,9.1,0.13850516
80,80,Aaron Rome,2011-12,28.0,6,5,56,56,1,4,5,50.0,975.0,131,2,10,12,122.0,82,5.46,52,291,2492,9.0,0.12038788
81,81,Aaron Rome,2012-13,29.0,7,10,43,43,4,6,10,42.0,655.0,174,6,16,22,164.0,82,5.32,47,271,2439,8.9,0.15768126
82,82,Aaron Rome,2013-14,30.0,8,5,27,27,0,5,5,15.0,414.0,201,6,21,27,179.0,48,5.31,29,160,1399,9.1,0.11477128
83,83,Aaron Rome,2014-15,31.0,9,1,25,25,0,1,1,15.0,327.0,226,6,22,28,194.0,82,5.34,48,269,2463,8.9,0.0945009
84,84,Aaron Volpatti,2011-12,26.0,2,2,15,15,1,1,2,6.0,102.0,15,1,1,2,6.0,82,5.46,52,291,2492,9.0,0.17413369
85,85,Aaron Volpatti,2012-13,27.0,3,1,23,23,1,0,1,17.0,206.0,38,2,1,3,23.0,82,5.32,47,271,2439,8.9,0.13001499
86,86,Aaron Volpatti,2013-14,28.0,4,2,33,33,1,1,2,21.0,275.0,71,3,2,5,44.0,48,5.31,29,160,1399,9.1,0.13586038
87,87,Aaron Volpatti,2014-15,29.0,5,2,41,41,2,0,2,18.0,302.0,112,5,2,7,62.0,82,5.34,48,269,2463,8.9,0.10196158
88,88,Aaron Volpatti,2015-16,30.0,6,0,2,2,0,0,0,1.0,19.0,114,5,2,7,63.0,82,5.32,47,251,2453,8.9,0.112119526
89,89,Aaron Voros,2008-09,27.0,2,14,55,55,7,7,14,52.0,505.0,55,7,7,14,52.0,82,5.44,62,351,2383,9.4,0.24277899
90,90,Aaron Voros,2009-10,28.0,3,16,54,54,8,8,16,66.0,604.0,109,15,15,30,118.0,82,5.7,65,341,2477,9.4,0.30523738
91,91,Aaron Voros,2010-11,29.0,4,7,41,41,3,4,7,22.0,252.0,150,18,19,37,140.0,82,5.53,56,304,2486,9.1,0.15218872
92,92,Aaron Voros,2011-12,30.0,5,0,12,12,0,0,0,8.0,67.0,162,18,19,37,148.0,82,5.46,52,291,2492,9.0,0.13383138
93,93,Aaron Ward,1994-95,22.0,2,1,5,5,1,0,1,3.0,,5,1,0,1,3.0,84,6.48,76,407,2545,10.7,0.24665102
94,94,Aaron Ward,1995-96,23.0,3,1,1,1,0,1,1,0.0,,6,1,1,2,3.0,48,5.97,37,209,1408,10.2,0.21778467
95,95,Aaron Ward,1997-98,25.0,4,7,49,49,2,5,7,40.0,,55,3,6,9,43.0,82,5.83,55,336,2444,9.8,0.15849397
96,96,Aaron Ward,1998-99,26.0,5,10,52,52,5,5,10,47.0,,107,8,11,19,90.0,82,5.28,57,380,2242,9.6,0.21317023
97,97,Aaron Ward,1999-00,27.0,6,11,60,60,3,8,11,46.0,835.0,167,11,19,30,136.0,82,5.27,57,359,2285,9.4,0.1726745
98,98,Aaron Ward,2000-01,28.0,7,4,36,36,1,3,4,25.0,453.0,203,12,22,34,161.0,82,5.49,53,331,2294,9.8,0.13118336
99,99,Aaron Ward,2001-02,29.0,8,9,73,73,4,5,9,48.0,1241.0,276,16,27,43,209.0,82,5.51,63,376,2272,9.9,0.15498272
100,100,Aaron Ward,2002-03,30.0,9,14,79,79,3,11,14,69.0,1554.0,355,19,38,57,278.0,82,5.24,53,338,2262,9.5,0.16069397
101,101,Aaron Ward,2003-04,31.0,10,9,77,77,3,6,9,66.0,1441.0,432,22,44,66,344.0,82,5.31,60,363,2326,9.4,0.14917526
102,102,Aaron Ward,2004-05,32.0,11,8,49,49,3,5,8,51.0,875.0,481,25,49,74,395.0,82,5.14,57,348,2300,9.2,0.16280004
103,103,Aaron Ward,2006-07,34.0,12,25,71,71,6,19,25,60.0,1358.0,552,31,68,99,455.0,82,6.05,85,480,2458,10.1,0.24767154
104,104,Aaron Ward,2007-08,35.0,13,16,80,80,4,12,16,62.0,1614.0,632,35,80,115,517.0,82,5.76,70,398,2426,9.7,0.1697453
105,105,Aaron Ward,2008-09,36.0,14,13,65,65,5,8,13,68.0,1348.0,697,40,88,128,585.0,82,5.44,62,351,2383,9.4,0.15483639
106,106,Aaron Ward,2009-10,37.0,15,10,65,65,3,7,10,53.0,1236.0,762,43,95,138,638.0,82,5.7,65,341,2477,9.4,0.13005516
107,107,Aaron Ward,2010-11,38.0,16,13,77,77,1,12,13,41.0,1332.0,839,44,107,151,679.0,82,5.53,56,304,2486,9.1,0.113979965
108,108,Adam Almqvist,2014-15,23.0,2,1,2,2,1,0,1,2.0,34.0,2,1,0,1,2.0,82,5.34,48,269,2463,8.9,0.22227293
109,109,Adam Bennett,1992-93,21.0,2,0,5,5,0,0,0,6.0,,5,0,0,0,6.0,80,6.96,77,402,2440,11.4,0.2464051
110,110,Adam Bennett,1993-94,22.0,3,2,16,16,0,2,2,15.0,,21,0,2,2,21.0,84,7.25,87,443,2603,11.7,0.2093184
111,111,Adam Bennett,1994-95,23.0,4,9,48,48,3,6,9,57.0,,69,3,8,11,78.0,84,6.48,76,407,2545,10.7,0.21938586
112,112,Adam Berti,2008-09,22.0,2,0,2,2,0,0,0,1.0,20.0,2,0,0,0,1.0,82,5.44,62,351,2383,9.4,0.18293896
113,113,Adam Boqvist,2020-21,20.0,2,13,41,41,4,9,13,50.0,665.0,41,4,9,13,50.0,70,5.96,42,208,2192,9.5,0.34164235
114,114,Adam Brooks,2020-21,24.0,2,3,7,7,0,3,3,2.0,55.0,7,0,3,3,2.0,70,5.96,42,208,2192,9.5,0.23140585
115,115,Adam Burish,2007-08,25.0,2,0,9,9,0,0,0,12.0,100.0,9,0,0,0,12.0,82,5.76,70,398,2426,9.7,0.17634493
116,116,Adam Burish,2008-09,26.0,3,8,81,81,4,4,8,69.0,952.0,90,4,4,8,81.0,82,5.44,62,351,2383,9.4,0.16913274
117,117,Adam Burish,2009-10,27.0,4,9,66,66,6,3,9,83.0,608.0,156,10,7,17,164.0,82,5.7,65,341,2477,9.4,0.18427739
118,118,Adam Burish,2010-11,28.0,5,4,13,13,1,3,4,9.0,114.0,169,11,10,21,173.0,82,5.53,56,304,2486,9.1,0.16854158
119,119,Adam Burish,2011-12,29.0,6,14,63,63,8,6,14,89.0,904.0,232,19,16,35,262.0,82,5.46,52,291,2492,9.0,0.1998288
120,120,Adam Burish,2012-13,30.0,7,19,65,65,6,13,19,82.0,831.0,297,25,29,54,344.0,82,5.32,47,271,2439,8.9,0.22267762
121,121,Adam Burish,2013-14,31.0,8,3,46,46,1,2,3,39.0,486.0,343,26,31,57,383.0,48,5.31,29,160,1399,9.1,0.13812128
122,122,Adam Burish,2014-15,32.0,9,0,15,15,0,0,0,9.0,144.0,358,26,31,57,392.0,82,5.34,48,269,2463,8.9,0.12976581
123,123,Adam Burish,2015-16,33.0,10,3,20,20,1,2,3,22.0,223.0,378,27,33,60,414.0,82,5.32,47,251,2453,8.9,0.1345014
124,124,Adam Burt,1989-90,21.0,2,0,5,5,0,0,0,1.0,,5,0,0,0,1.0,80,7.48,85,403,2430,12.3,0.2297807
125,125,Adam Burt,1990-91,22.0,3,12,63,63,4,8,12,83.0,,68,4,8,12,84.0,80,7.37,76,367,2421,12.2,0.2618499
126,126,Adam Burt,1991-92,23.0,4,9,42,42,2,7,9,43.0,,110,6,15,21,127.0,80,6.91,71,366,2385,11.6,0.23685986
127,127,Adam Burt,1992-93,24.0,5,24,66,66,9,15,24,89.0,,176,15,30,45,216.0,80,6.96,77,402,2440,11.4,0.32017156
128,128,Adam Burt,1993-94,25.0,6,20,65,65,6,14,20,81.0,,241,21,44,65,297.0,84,7.25,87,443,2603,11.7,0.2846007
129,129,Adam Burt,1994-95,26.0,7,18,63,63,1,17,18,91.0,,304,22,61,83,388.0,84,6.48,76,407,2545,10.7,0.24073568
130,130,Adam Burt,1995-96,27.0,8,18,46,46,7,11,18,73.0,,350,29,72,101,461.0,48,5.97,37,209,1408,10.2,0.36981094
131,131,Adam Burt,1996-97,28.0,9,13,78,78,4,9,13,90.0,,428,33,81,114,551.0,82,6.29,74,413,2481,10.4,0.2070226
132,132,Adam Burt,1997-98,29.0,10,13,71,71,2,11,13,85.0,,499,35,92,127,636.0,82,5.83,55,336,2444,9.8,0.19156966
133,133,Adam Burt,1998-99,30.0,11,12,76,76,1,11,12,51.0,,575,36,103,139,687.0,82,5.28,57,380,2242,9.6,0.13574782
134,134,Adam Burt,1999-00,31.0,12,4,68,68,0,4,4,61.0,1247.0,643,36,107,143,748.0,82,5.27,57,359,2285,9.4,0.13296983
135,135,Adam Burt,2000-01,32.0,13,7,67,67,1,6,7,49.0,1093.0,710,37,113,150,797.0,82,5.49,53,331,2294,9.8,0.12724626
136,136,Adam Burt,2001-02,33.0,14,2,27,27,0,2,2,18.0,515.0,737,37,115,152,815.0,82,5.51,63,376,2272,9.9,0.10575399
137,137,Adam Clendening,2015-16,23.0,2,4,21,21,1,3,4,17.0,349.0,21,1,3,4,17.0,82,5.32,47,251,2453,8.9,0.18444487
138,138,Adam Clendening,2016-17,24.0,3,7,29,29,1,6,7,43.0,429.0,50,2,9,11,60.0,82,5.34,48,255,2438,9.0,0.19247052
139,139,Adam Clendening,2017-18,25.0,4,11,31,31,2,9,11,38.0,490.0,81,4,18,22,98.0,82,5.45,47,245,2478,9.0,0.2413091
140,140,Adam Clendening,2018-19,26.0,5,2,5,5,0,2,2,4.0,80.0,86,4,20,24,102.0,82,5.86,50,250,2620,9.2,0.18527919
141,141,Adam Clendening,2019-20,27.0,6,0,4,4,0,0,0,3.0,43.0,90,4,20,24,105.0,82,5.96,47,239,2579,9.5,0.15290466
142,142,Adam Cracknell,2011-12,26.0,2,7,24,24,3,4,7,26.0,214.0,24,3,4,7,26.0,82,5.46,52,291,2492,9.0,0.22847345
143,143,Adam Cracknell,2012-13,27.0,3,1,2,2,1,0,1,1.0,15.0,26,4,4,8,27.0,82,5.32,47,271,2439,8.9,0.16646591
144,144,Adam Cracknell,2013-14,28.0,4,6,20,20,2,4,6,21.0,172.0,46,6,8,14,48.0,48,5.31,29,160,1399,9.1,0.22976121
145,145,Adam Cracknell,2014-15,29.0,5,2,19,19,0,2,2,16.0,155.0,65,6,10,16,64.0,82,5.34,48,269,2463,8.9,0.125489
146,146,Adam Cracknell,2015-16,30.0,6,1,17,17,0,1,1,17.0,169.0,82,6,11,17,81.0,82,5.32,47,251,2453,8.9,0.14670312
147,147,Adam Cracknell,2016-17,31.0,7,10,52,52,5,5,10,68.0,636.0,134,11,16,27,149.0,82,5.34,48,255,2438,9.0,0.18791148
148,148,Adam Cracknell,2017-18,32.0,8,16,69,69,10,6,16,87.0,722.0,203,21,22,43,236.0,82,5.45,47,245,2478,9.0,0.21880585
149,149,Adam Cracknell,2018-19,33.0,9,0,5,5,0,0,0,6.0,39.0,208,21,22,43,242.0,82,5.86,50,250,2620,9.2,0.15149894
150,150,Adam Cracknell,2019-20,34.0,10,0,2,2,0,0,0,3.0,21.0,210,21,22,43,245.0,82,5.96,47,239,2579,9.5,0.16231364
151,151,Adam Creighton,1984-85,19.0,2,4,7,7,2,2,4,8.0,,7,2,2,4,8.0,80,7.89,74,336,2448,12.9,0.37981614
152,152,Adam Creighton,1985-86,20.0,3,10,30,30,2,8,10,20.0,,37,4,10,14,28.0,80,7.77,71,321,2447,12.7,0.33243725
153,153,Adam Creighton,1986-87,21.0,4,2,19,19,1,1,2,9.0,,56,5,11,16,37.0,80,7.94,82,370,2484,12.8,0.3334989
154,154,Adam Creighton,1987-88,22.0,5,40,56,56,18,22,40,109.0,,112,23,33,56,146.0,80,7.34,72,344,2400,12.2,0.6334644
155,155,Adam Creighton,1988-89,23.0,6,27,36,36,10,17,27,61.0,,148,33,50,83,207.0,80,7.43,89,437,2435,12.2,0.57104266
156,156,Adam Creighton,1989-90,24.0,7,46,67,67,22,24,46,155.0,,215,55,74,129,362.0,80,7.48,85,403,2430,12.3,0.6360129
157,157,Adam Creighton,1990-91,25.0,8,70,80,80,34,36,70,156.0,,295,89,110,199,518.0,80,7.37,76,367,2421,12.2,0.8200691
158,158,Adam Creighton,1991-92,26.0,9,51,72,72,22,29,51,127.0,,367,111,139,250,645.0,80,6.91,71,366,2385,11.6,0.61245006
159,159,Adam Creighton,1992-93,27.0,10,36,77,77,21,15,36,140.0,,444,132,154,286,785.0,80,6.96,77,402,2440,11.4,0.49323717
160,160,Adam Creighton,1993-94,28.0,11,39,83,83,19,20,39,168.0,,527,151,174,325,953.0,84,7.25,87,443,2603,11.7,0.47503462
161,161,Adam Creighton,1994-95,29.0,12,20,53,53,10,10,20,77.0,,580,161,184,345,1030.0,84,6.48,76,407,2545,10.7,0.42376965
162,162,Adam Creighton,1995-96,30.0,13,34,48,48,14,20,34,81.0,,628,175,204,379,1111.0,48,5.97,37,209,1408,10.2,0.56618637
163,163,Adam Creighton,1996-97,31.0,14,21,61,61,11,10,21,98.0,,689,186,214,400,1209.0,82,6.29,74,413,2481,10.4,0.30706307
164,164,Adam Creighton,1997-98,32.0,15,3,19,19,1,2,3,20.0,,708,187,216,403,1229.0,82,5.83,55,336,2444,9.8,0.29903966
165,165,Adam Deadmarsh,1995-96,20.0,2,17,48,48,9,8,17,48.0,,48,9,8,17,48.0,48,5.97,37,209,1408,10.2,0.36481845
166,166,Adam Deadmarsh,1996-97,21.0,3,48,78,78,21,27,48,151.0,,126,30,35,65,199.0,82,6.29,74,413,2481,10.4,0.63182503
167,167,Adam Deadmarsh,1997-98,22.0,4,60,78,78,33,27,60,198.0,,204,63,62,125,397.0,82,5.83,55,336,2444,9.8,0.7078687
168,168,Adam Deadmarsh,1998-99,23.0,5,43,73,73,22,21,43,187.0,,277,85,83,168,584.0,82,5.28,57,380,2242,9.6,0.63660604
169,169,Adam Deadmarsh,1999-00,24.0,6,49,66,66,22,27,49,152.0,1371.0,343,107,110,217,736.0,82,5.27,57,359,2285,9.4,0.7234419
170,170,Adam Deadmarsh,2000-01,25.0,7,45,71,71,18,27,45,153.0,1452.0,414,125,137,262,889.0,82,5.49,53,331,2294,9.8,0.59368336
171,171,Adam Deadmarsh,2001-02,26.0,8,32,57,57,17,15,32,126.0,1026.0,471,142,152,294,1015.0,82,5.51,63,376,2272,9.9,0.5674348
172,172,Adam Deadmarsh,2002-03,27.0,9,62,76,76,29,33,62,139.0,1465.0,547,171,185,356,1154.0,82,5.24,53,338,2262,9.5,0.75307095
173,173,Adam Deadmarsh,2003-04,28.0,10,17,20,20,13,4,17,55.0,386.0,567,184,189,373,1209.0,82,5.31,60,363,2326,9.4,0.8422034
174,174,Adam Erne,2017-18,22.0,2,3,26,26,3,0,3,40.0,307.0,26,3,0,3,40.0,82,5.45,47,245,2478,9.0,0.2565741
175,175,Adam Erne,2018-19,23.0,3,4,23,23,3,1,4,29.0,233.0,49,6,1,7,69.0,82,5.86,50,250,2620,9.2,0.25488484
176,176,Adam Erne,2019-20,24.0,4,20,65,65,7,13,20,70.0,686.0,114,13,14,27,139.0,82,5.96,47,239,2579,9.5,0.28369635
177,177,Adam Erne,2020-21,25.0,5,5,56,56,2,3,5,63.0,662.0,170,15,17,32,202.0,70,5.96,42,208,2192,9.5,0.18641865
178,178,Adam Foote,1992-93,21.0,2,7,46,46,2,5,7,55.0,,46,2,5,7,55.0,80,6.96,77,402,2440,11.4,0.26992983
179,179,Adam Foote,1993-94,22.0,3,16,81,81,4,12,16,54.0,,127,6,17,23,109.0,84,7.25,87,443,2603,11.7,0.21884343
180,180,Adam Foote,1994-95,23.0,4,8,45,45,2,6,8,42.0,,172,8,23,31,151.0,84,6.48,76,407,2545,10.7,0.22838429
181,181,Adam Foote,1995-96,24.0,5,7,35,35,0,7,7,24.0,,207,8,30,38,175.0,48,5.97,37,209,1408,10.2,0.18652585
182,182,Adam Foote,1996-97,25.0,6,16,73,73,5,11,16,49.0,,280,13,41,54,224.0,82,6.29,74,413,2481,10.4,0.1979301
183,183,Adam Foote,1997-98,26.0,7,21,78,78,2,19,21,60.0,,358,15,60,75,284.0,82,5.83,55,336,2444,9.8,0.21549717
184,184,Adam Foote,1998-99,27.0,8,17,77,77,3,14,17,64.0,,435,18,74,92,348.0,82,5.28,57,380,2242,9.6,0.18862826
185,185,Adam Foote,1999-00,28.0,9,21,64,64,5,16,21,83.0,1589.0,499,23,90,113,431.0,82,5.27,57,359,2285,9.4,0.28016713
186,186,Adam Foote,2000-01,29.0,10,18,59,59,5,13,18,63.0,1526.0,558,28,103,131,494.0,82,5.49,53,331,2294,9.8,0.25980914
187,187,Adam Foote,2001-02,30.0,11,15,35,35,3,12,15,59.0,888.0,593,31,115,146,553.0,82,5.51,63,376,2272,9.9,0.26157904
188,188,Adam Foote,2002-03,31.0,12,27,55,55,5,22,27,85.0,1429.0,648,36,137,173,638.0,82,5.24,53,338,2262,9.5,0.3506743
189,189,Adam Foote,2003-04,32.0,13,31,78,78,11,20,31,106.0,2005.0,726,47,157,204,744.0,82,5.31,60,363,2326,9.4,0.31112814
190,190,Adam Foote,2004-05,33.0,14,30,73,73,8,22,30,105.0,1756.0,799,55,179,234,849.0,82,5.14,57,348,2300,9.2,0.35713875
191,191,Adam Foote,2006-07,35.0,15,22,65,65,6,16,22,67.0,1597.0,864,61,195,256,916.0,82,6.05,85,480,2458,10.1,0.2243784
192,192,Adam Foote,2007-08,36.0,16,12,59,59,3,9,12,78.0,1459.0,923,64,204,268,994.0,82,5.76,70,398,2426,9.7,0.17579961
193,193,Adam Foote,2008-09,37.0,17,16,75,75,1,15,16,66.0,1754.0,998,65,219,284,1060.0,82,5.44,62,351,2383,9.4,0.16457409
194,194,Adam Foote,2009-10,38.0,18,7,42,42,1,6,7,19.0,826.0,1040,66,225,291,1079.0,82,5.7,65,341,2477,9.4,0.12655663
195,195,Adam Foote,2010-11,39.0,19,9,67,67,0,9,9,26.0,1297.0,1107,66,234,300,1105.0,82,5.53,56,304,2486,9.1,0.117554784
196,196,Adam Foote,2011-12,40.0,20,8,47,47,0,8,8,23.0,842.0,1154,66,242,308,1128.0,82,5.46,52,291,2492,9.0,0.12402111
197,197,Adam Fox,2020-21,22.0,2,42,70,70,8,34,42,125.0,1323.0,70,8,34,42,125.0,70,5.96,42,208,2192,9.5,0.5544051
198,198,Adam Gaudette,2018-19,22.0,2,0,5,5,0,0,0,9.0,64.0,5,0,0,0,9.0,82,5.86,50,250,2620,9.2,0.19341981
199,199,Adam Gaudette,2019-20,23.0,3,12,56,56,5,7,12,55.0,613.0,61,5,7,12,64.0,82,5.96,47,239,2579,9.5,0.23719195
200,200,Adam Gaudette,2020-21,24.0,4,33,59,59,12,21,33,75.0,731.0,120,17,28,45,139.0,70,5.96,42,208,2192,9.5,0.47775
201,201,Adam Graves,1988-89,20.0,2,1,9,9,0,1,1,9.0,,9,0,1,1,9.0,80,7.43,89,437,2435,12.2,0.30674207
202,202,Adam Graves,1989-90,21.0,3,12,56,56,7,5,12,60.0,,65,7,6,13,69.0,80,7.48,85,403,2430,12.3,0.300265
203,203,Adam Graves,1990-91,22.0,4,22,76,76,9,13,22,94.0,,141,16,19,35,163.0,80,7.37,76,367,2421,12.2,0.3164189
204,204,Adam Graves,1991-92,23.0,5,25,76,76,7,18,25,126.0,,217,23,37,60,289.0,80,6.91,71,366,2385,11.6,0.37371004
205,205,Adam Graves,1992-93,24.0,6,59,80,80,26,33,59,228.0,,297,49,70,119,517.0,80,6.96,77,402,2440,11.4,0.75931686
206,206,Adam Graves,1993-94,25.0,7,65,84,84,36,29,65,275.0,,381,85,99,184,792.0,84,7.25,87,443,2603,11.7,0.7278382
207,207,Adam Graves,1994-95,26.0,8,79,84,84,52,27,79,291.0,,465,137,126,263,1083.0,84,6.48,76,407,2545,10.7,0.77901757
208,208,Adam Graves,1995-96,27.0,9,31,47,47,17,14,31,185.0,,512,154,140,294,1268.0,48,5.97,37,209,1408,10.2,0.68908024
209,209,Adam Graves,1996-97,28.0,10,58,82,82,22,36,58,266.0,,594,176,176,352,1534.0,82,6.29,74,413,2481,10.4,0.6884481
210,210,Adam Graves,1997-98,29.0,11,61,82,82,33,28,61,269.0,,676,209,204,413,1803.0,82,5.83,55,336,2444,9.8,0.6939421
211,211,Adam Graves,1998-99,30.0,12,35,72,72,23,12,35,226.0,,748,232,216,448,2029.0,82,5.28,57,380,2242,9.6,0.5600442
212,212,Adam Graves,1999-00,31.0,13,53,82,82,38,15,53,239.0,1685.0,830,270,231,501,2268.0,82,5.27,57,359,2285,9.4,0.6372232
213,213,Adam Graves,2000-01,32.0,14,40,77,77,23,17,40,194.0,1445.0,907,293,248,541,2462.0,82,5.49,53,331,2294,9.8,0.4920586
214,214,Adam Graves,2001-02,33.0,15,26,82,82,10,16,26,136.0,1290.0,989,303,264,567,2598.0,82,5.51,63,376,2272,9.9,0.3137483
215,215,Adam Graves,2002-03,34.0,16,31,81,81,17,14,31,139.0,1279.0,1070,320,278,598,2737.0,82,5.24,53,338,2262,9.5,0.38736102
216,216,Adam Graves,2003-04,35.0,17,18,82,82,9,9,18,118.0,1070.0,1152,329,287,616,2855.0,82,5.31,60,363,2326,9.4,0.28860998
217,217,Adam Hall,2002-03,22.0,2,1,1,1,0,1,1,2.0,14.0,1,0,1,1,2.0,82,5.24,53,338,2262,9.5,0.19693315
218,218,Adam Hall,2003-04,23.0,3,28,79,79,16,12,28,146.0,1117.0,80,16,13,29,148.0,82,5.31,60,363,2326,9.4,0.44007835
219,219,Adam Hall,2004-05,24.0,4,27,79,79,13,14,27,151.0,1283.0,159,29,27,56,299.0,82,5.14,57,348,2300,9.2,0.5044695
220,220,Adam Hall,2006-07,26.0,5,29,75,75,14,15,29,122.0,1258.0,234,43,42,85,421.0,82,6.05,85,480,2458,10.1,0.38611925
221,221,Adam Hall,2007-08,27.0,6,17,72,72,6,11,17,103.0,891.0,306,49,53,102,524.0,82,5.76,70,398,2426,9.7,0.2667848
222,222,Adam Hall,2008-09,28.0,7,6,46,46,2,4,6,39.0,546.0,352,51,57,108,563.0,82,5.44,62,351,2383,9.4,0.18995863
223,223,Adam Hall,2009-10,29.0,8,10,74,74,5,5,10,90.0,829.0,426,56,62,118,653.0,82,5.7,65,341,2477,9.4,0.22998899
224,224,Adam Hall,2011-12,31.0,9,18,82,82,7,11,18,167.0,1218.0,508,63,73,136,820.0,82,5.46,52,291,2492,9.0,0.2584638
225,225,Adam Hall,2012-13,32.0,10,7,57,57,2,5,7,63.0,676.0,565,65,78,143,883.0,82,5.32,47,271,2439,8.9,0.17907006
226,226,Adam Hall,2013-14,33.0,11,4,37,37,0,4,4,34.0,390.0,602,65,82,147,917.0,48,5.31,29,160,1399,9.1,0.12270653
227,227,Adam Hall,2014-15,34.0,12,9,80,80,4,5,9,61.0,787.0,682,69,87,156,978.0,82,5.34,48,269,2463,8.9,0.14311838
228,228,Adam Henrique,2011-12,21.0,2,0,1,1,0,0,0,3.0,13.0,1,0,0,0,3.0,82,5.46,52,291,2492,9.0,0.21491829
229,229,Adam Henrique,2012-13,22.0,3,51,74,74,16,35,51,130.0,1344.0,75,16,35,51,133.0,82,5.32,47,271,2439,8.9,0.64626783
230,230,Adam Henrique,2013-14,23.0,4,16,42,42,11,5,16,78.0,769.0,117,27,40,67,211.0,48,5.31,29,160,1399,9.1,0.45587498
231,231,Adam Henrique,2014-15,24.0,5,43,77,77,25,18,43,137.0,1390.0,194,52,58,110,348.0,82,5.34,48,269,2463,8.9,0.5551145
232,232,Adam Henrique,2015-16,25.0,6,43,75,75,16,27,43,127.0,1331.0,269,68,85,153,475.0,82,5.32,47,251,2453,8.9,0.53569907
233,233,Adam Henrique,2016-17,26.0,7,50,80,80,30,20,50,149.0,1586.0,349,98,105,203,624.0,82,5.34,48,255,2438,9.0,0.63777626
234,234,Adam Henrique,2017-18,27.0,8,40,82,82,20,20,40,142.0,1490.0,431,118,125,243,766.0,82,5.45,47,245,2478,9.0,0.5161513
235,235,Adam Henrique,2018-19,28.0,9,50,81,81,24,26,50,151.0,1441.0,512,142,151,293,917.0,82,5.86,50,250,2620,9.2,0.586893
236,236,Adam Henrique,2019-20,29.0,10,42,82,82,18,24,42,122.0,1349.0,594,160,175,335,1039.0,82,5.96,47,239,2579,9.5,0.47024286
237,237,Adam Henrique,2020-21,30.0,11,43,71,71,26,17,43,169.0,1198.0,665,186,192,378,1208.0,70,5.96,42,208,2192,9.5,0.5855413
238,238,Adam Johnson,2019-20,25.0,2,2,6,6,0,2,2,3.0,32.0,6,0,2,2,3.0,82,5.96,47,239,2579,9.5,0.18763459
239,239,Adam Johnson,2020-21,26.0,3,2,7,7,1,1,2,5.0,47.0,13,1,3,4,8.0,70,5.96,42,208,2192,9.5,0.22856751
240,240,Adam Larsson,2012-13,20.0,2,18,65,65,2,16,18,68.0,1340.0,65,2,16,18,68.0,82,5.32,47,271,2439,8.9,0.3033836
241,241,Adam Larsson,2013-14,21.0,3,6,37,37,0,6,6,30.0,670.0,102,2,22,24,98.0,48,5.31,29,160,1399,9.1,0.23944417
242,242,Adam Larsson,2014-15,22.0,4,3,26,26,1,2,3,20.0,462.0,128,3,24,27,118.0,82,5.34,48,269,2463,8.9,0.21849471
243,243,Adam Larsson,2015-16,23.0,5,24,64,64,3,21,24,91.0,1342.0,192,6,45,51,209.0,82,5.32,47,251,2453,8.9,0.31118897
244,244,Adam Larsson,2016-17,24.0,6,18,82,82,3,15,18,65.0,1846.0,274,9,60,69,274.0,82,5.34,48,255,2438,9.0,0.2297138
245,245,Adam Larsson,2017-18,25.0,7,19,79,79,4,15,19,85.0,1592.0,353,13,75,88,359.0,82,5.45,47,245,2478,9.0,0.24924752
246,246,Adam Larsson,2018-19,26.0,8,13,63,63,4,9,13,92.0,1382.0,416,17,84,101,451.0,82,5.86,50,250,2620,9.2,0.22902966
247,247,Adam Larsson,2019-20,27.0,9,20,82,82,3,17,20,117.0,1773.0,498,20,101,121,568.0,82,5.96,47,239,2579,9.5,0.25769824
248,248,Adam Larsson,2020-21,28.0,10,6,49,49,1,5,6,61.0,972.0,547,21,106,127,629.0,70,5.96,42,208,2192,9.5,0.19125664
249,249,Adam Lowry,2015-16,22.0,2,23,80,80,11,12,23,104.0,1100.0,80,11,12,23,104.0,82,5.32,47,251,2453,8.9,0.3366115
250,250,Adam Lowry,2016-17,23.0,3,17,74,74,7,10,17,73.0,1037.0,154,18,22,40,177.0,82,5.34,48,255,2438,9.0,0.30061868
251,251,Adam Lowry,2017-18,24.0,4,29,82,82,15,14,29,122.0,1316.0,236,33,36,69,299.0,82,5.45,47,245,2478,9.0,0.4217912
252,252,Adam Lowry,2018-19,25.0,5,21,45,45,8,13,21,70.0,670.0,281,41,49,90,369.0,82,5.86,50,250,2620,9.2,0.3993876
253,253,Adam Lowry,2019-20,26.0,6,23,78,78,12,11,23,105.0,1142.0,359,53,60,113,474.0,82,5.96,47,239,2579,9.5,0.3009235
254,254,Adam Lowry,2020-21,27.0,7,10,49,49,4,6,10,68.0,733.0,408,57,66,123,542.0,70,5.96,42,208,2192,9.5,0.27781597
255,255,Adam Mair,2000-01,21.0,2,1,8,8,1,0,1,7.0,92.0,8,1,0,1,7.0,82,5.49,53,331,2294,9.8,0.20484716
256,256,Adam Mair,2001-02,22.0,3,2,26,26,0,2,2,22.0,207.0,34,1,2,3,29.0,82,5.51,63,376,2272,9.9,0.16559973
257,257,Adam Mair,2002-03,23.0,4,2,18,18,1,1,2,10.0,129.0,52,2,3,5,39.0,82,5.24,53,338,2262,9.5,0.20696145
258,258,Adam Mair,2003-04,24.0,5,17,79,79,6,11,17,83.0,839.0,131,8,14,22,122.0,82,5.31,60,363,2326,9.4,0.24052382
259,259,Adam Mair,2004-05,25.0,6,20,81,81,6,14,20,82.0,780.0,212,14,28,42,204.0,82,5.14,57,348,2300,9.2,0.26160735
260,260,Adam Mair,2006-07,27.0,7,7,40,40,2,5,7,40.0,320.0,252,16,33,49,244.0,82,6.05,85,480,2458,10.1,0.17356557
261,261,Adam Mair,2007-08,28.0,8,11,82,82,2,9,11,73.0,619.0,334,18,42,60,317.0,82,5.76,70,398,2426,9.7,0.1774768
262,262,Adam Mair,2008-09,29.0,9,17,72,72,5,12,17,62.0,638.0,406,23,54,77,379.0,82,5.44,62,351,2383,9.4,0.2059559
263,263,Adam Mair,2009-10,30.0,10,19,75,75,8,11,19,75.0,793.0,481,31,65,96,454.0,82,5.7,65,341,2477,9.4,0.2294426
264,264,Adam Mair,2010-11,31.0,11,14,69,69,6,8,14,67.0,637.0,550,37,73,110,521.0,82,5.53,56,304,2486,9.1,0.164397
265,265,Adam Mair,2011-12,32.0,12,4,65,65,1,3,4,58.0,591.0,615,38,76,114,579.0,82,5.46,52,291,2492,9.0,0.12506062
266,266,Adam McQuaid,2010-11,24.0,2,1,19,19,1,0,1,10.0,204.0,19,1,0,1,10.0,82,5.53,56,304,2486,9.1,0.13623098
267,267,Adam McQuaid,2011-12,25.0,3,15,67,67,3,12,15,46.0,996.0,86,4,12,16,56.0,82,5.46,52,291,2492,9.0,0.1785518
268,268,Adam McQuaid,2012-13,26.0,4,10,72,72,2,8,10,63.0,1077.0,158,6,20,26,119.0,82,5.32,47,271,2439,8.9,0.16853347
269,269,Adam McQuaid,2013-14,27.0,5,4,32,32,1,3,4,26.0,457.0,190,7,23,30,145.0,48,5.31,29,160,1399,9.1,0.1613498
270,270,Adam McQuaid,2014-15,28.0,6,6,30,30,1,5,6,25.0,481.0,220,8,28,36,170.0,82,5.34,48,269,2463,8.9,0.15825945
271,271,Adam McQuaid,2015-16,29.0,7,7,63,63,1,6,7,60.0,1161.0,283,9,34,43,230.0,82,5.32,47,251,2453,8.9,0.12148857
272,272,Adam McQuaid,2016-17,30.0,8,9,64,64,1,8,9,42.0,1155.0,347,10,42,52,272.0,82,5.34,48,255,2438,9.0,0.1254819
273,273,Adam McQuaid,2017-18,31.0,9,10,77,77,2,8,10,64.0,1405.0,424,12,50,62,336.0,82,5.45,47,245,2478,9.0,0.15157443
274,274,Adam McQuaid,2018-19,32.0,10,4,38,38,1,3,4,39.0,597.0,462,13,53,66,375.0,82,5.86,50,250,2620,9.2,0.13151851
275,275,Adam McQuaid,2019-20,33.0,11,7,50,50,3,4,7,28.0,789.0,512,16,57,73,403.0,82,5.96,47,239,2579,9.5,0.09542251
276,276,Adam Oates,1986-87,24.0,2,20,38,38,9,11,20,49.0,,38,9,11,20,49.0,80,7.94,82,370,2484,12.8,0.47607875
277,277,Adam Oates,1987-88,25.0,3,47,76,76,15,32,47,138.0,,114,24,43,67,187.0,80,7.34,72,344,2400,12.2,0.64790803
278,278,Adam Oates,1988-89,26.0,4,54,63,63,14,40,54,111.0,,177,38,83,121,298.0,80,7.43,89,437,2435,12.2,0.7904836
279,279,Adam Oates,1989-90,27.0,5,78,69,69,16,62,78,127.0,,246,54,145,199,425.0,80,7.48,85,403,2430,12.3,0.88875854
280,280,Adam Oates,1990-91,28.0,6,102,80,80,23,79,102,168.0,,326,77,224,301,593.0,80,7.37,76,367,2421,12.2,1.3154491
281,281,Adam Oates,1991-92,29.0,7,115,61,61,25,90,115,139.0,,387,102,314,416,732.0,80,6.91,71,366,2385,11.6,1.2654035
282,282,Adam Oates,1992-93,30.0,8,99,80,80,20,79,99,191.0,,467,122,393,515,923.0,80,6.96,77,402,2440,11.4,1.3158046
283,283,Adam Oates,1993-94,31.0,9,142,84,84,45,97,142,254.0,,551,167,490,657,1177.0,84,7.25,87,443,2603,11.7,1.3960178
284,284,Adam Oates,1994-95,32.0,10,112,77,77,32,80,112,197.0,,628,199,570,769,1374.0,84,6.48,76,407,2545,10.7,1.1210093
285,285,Adam Oates,1995-96,33.0,11,53,48,48,12,41,53,109.0,,676,211,611,822,1483.0,48,5.97,37,209,1408,10.2,1.1632545
286,286,Adam Oates,1996-97,34.0,12,92,70,70,25,67,92,183.0,,746,236,678,914,1666.0,82,6.29,74,413,2481,10.4,1.0343974
287,287,Adam Oates,1997-98,35.0,13,82,80,80,22,60,82,160.0,,826,258,738,996,1826.0,82,5.83,55,336,2444,9.8,0.9062164
288,288,Adam Oates,1998-99,36.0,14,76,82,82,18,58,76,121.0,,908,276,796,1072,1947.0,82,5.28,57,380,2242,9.6,0.8322964
289,289,Adam Oates,1999-00,37.0,15,54,59,59,12,42,54,79.0,1213.0,967,288,838,1126,2026.0,82,5.27,57,359,2285,9.4,0.81583583
290,290,Adam Oates,2000-01,38.0,16,71,82,82,15,56,71,93.0,1832.0,1049,303,894,1197,2119.0,82,5.49,53,331,2294,9.8,0.82585317
291,291,Adam Oates,2001-02,39.0,17,82,81,81,13,69,82,72.0,1701.0,1130,316,963,1279,2191.0,82,5.51,63,376,2272,9.9,0.86570835
292,292,Adam Oates,2002-03,40.0,18,78,80,80,14,64,78,102.0,1750.0,1210,330,1027,1357,2293.0,82,5.24,53,338,2262,9.5,0.7679275
293,293,Adam Oates,2003-04,41.0,19,45,67,67,9,36,45,67.0,1249.0,1277,339,1063,1402,2360.0,82,5.31,60,363,2326,9.4,0.5034015
294,294,Adam Oates,2004-05,42.0,20,18,60,60,2,16,18,32.0,870.0,1337,341,1079,1420,2392.0,82,5.14,57,348,2300,9.2,0.36222702
295,295,Adam Pardy,2009-10,25.0,2,10,60,60,1,9,10,38.0,900.0,60,1,9,10,38.0,82,5.7,65,341,2477,9.4,0.17190209
296,296,Adam Pardy,2010-11,26.0,3,9,57,57,2,7,9,40.0,904.0,117,3,16,19,78.0,82,5.53,56,304,2486,9.1,0.17450148
297,297,Adam Pardy,2011-12,27.0,4,7,30,30,1,6,7,36.0,441.0,147,4,22,26,114.0,82,5.46,52,291,2492,9.0,0.16092372
298,298,Adam Pardy,2012-13,28.0,5,3,36,36,0,3,3,29.0,593.0,183,4,25,29,143.0,82,5.32,47,271,2439,8.9,0.11490747
299,299,Adam Pardy,2013-14,29.0,6,4,17,17,0,4,4,6.0,281.0,200,4,29,33,149.0,48,5.31,29,160,1399,9.1,0.14388257
300,300,Adam Pardy,2014-15,30.0,7,6,60,60,0,6,6,47.0,865.0,260,4,35,39,196.0,82,5.34,48,269,2463,8.9,0.11534241
301,301,Adam Pardy,2015-16,31.0,8,9,55,55,0,9,9,29.0,826.0,315,4,44,48,225.0,82,5.32,47,251,2453,8.9,0.09012067
302,302,Adam Pardy,2016-17,32.0,9,4,23,23,0,4,4,22.0,365.0,338,4,48,52,247.0,82,5.34,48,255,2438,9.0,0.12519836
303,303,Adam Pardy,2017-18,33.0,10,0,4,4,0,0,0,4.0,44.0,342,4,48,52,251.0,82,5.45,47,245,2478,9.0,0.123369396
304,304,Adam Payerl,2014-15,23.0,2,0,2,2,0,0,0,4.0,18.0,2,0,0,0,4.0,82,5.34,48,269,2463,8.9,0.17318648
305,305,Adam Pelech,2016-17,22.0,2,2,9,9,0,2,2,8.0,158.0,9,0,2,2,8.0,82,5.34,48,255,2438,9.0,0.19767702
306,306,Adam Pelech,2017-18,23.0,3,10,44,44,3,7,10,40.0,741.0,53,3,9,12,48.0,82,5.45,47,245,2478,9.0,0.22603387
307,307,Adam Pelech,2018-19,24.0,4,19,78,78,3,16,19,106.0,1503.0,131,6,25,31,154.0,82,5.86,50,250,2620,9.2,0.24676219
308,308,Adam Pelech,2019-20,25.0,5,21,78,78,5,16,21,110.0,1453.0,209,11,41,52,264.0,82,5.96,47,239,2579,9.5,0.25874305
309,309,Adam Pelech,2020-21,26.0,6,9,38,38,1,8,9,49.0,803.0,247,12,49,61,313.0,70,5.96,42,208,2192,9.5,0.22270459
310,310,Adam Pineault,2008-09,22.0,2,0,3,3,0,0,0,5.0,33.0,3,0,0,0,5.0,82,5.44,62,351,2383,9.4,0.19415745
311,311,Adrian Aucoin,1995-96,22.0,2,1,1,1,1,0,1,2.0,,1,1,0,1,2.0,48,5.97,37,209,1408,10.2,0.25961864
312,312,Adrian Aucoin,1996-97,23.0,3,18,49,49,4,14,18,85.0,,50,5,14,19,87.0,82,6.29,74,413,2481,10.4,0.37278068
313,313,Adrian Aucoin,1997-98,24.0,4,21,70,70,5,16,21,116.0,,120,10,30,40,203.0,82,5.83,55,336,2444,9.8,0.2769586
314,314,Adrian Aucoin,1998-99,25.0,5,6,35,35,3,3,6,44.0,,155,13,33,46,247.0,82,5.28,57,380,2242,9.6,0.23412886
315,315,Adrian Aucoin,1999-00,26.0,6,34,82,82,23,11,34,174.0,1957.0,237,36,44,80,421.0,82,5.27,57,359,2285,9.4,0.4844627
316,316,Adrian Aucoin,2000-01,27.0,7,24,57,57,10,14,24,126.0,1317.0,294,46,58,104,547.0,82,5.49,53,331,2294,9.8,0.35273036
317,317,Adrian Aucoin,2001-02,28.0,8,28,73,73,4,24,28,159.0,1475.0,367,50,82,132,706.0,82,5.51,63,376,2272,9.9,0.3579833
318,318,Adrian Aucoin,2002-03,29.0,9,34,81,81,12,22,34,232.0,2340.0,448,62,104,166,938.0,82,5.24,53,338,2262,9.5,0.45405617
319,319,Adrian Aucoin,2003-04,30.0,10,35,73,73,8,27,35,175.0,2118.0,521,70,131,201,1113.0,82,5.31,60,363,2326,9.4,0.43521306
320,320,Adrian Aucoin,2004-05,31.0,11,44,81,81,13,31,44,213.0,2157.0,602,83,162,245,1326.0,82,5.14,57,348,2300,9.2,0.48732597
321,321,Adrian Aucoin,2006-07,33.0,12,6,33,33,1,5,6,59.0,758.0,635,84,167,251,1385.0,82,6.05,85,480,2458,10.1,0.2221821
322,322,Adrian Aucoin,2007-08,34.0,13,16,59,59,4,12,16,96.0,1229.0,694,88,179,267,1481.0,82,5.76,70,398,2426,9.7,0.2692333
323,323,Adrian Aucoin,2008-09,35.0,14,35,76,76,10,25,35,121.0,1593.0,770,98,204,302,1602.0,82,5.44,62,351,2383,9.4,0.3242104
324,324,Adrian Aucoin,2009-10,36.0,15,34,81,81,10,24,34,126.0,1806.0,851,108,228,336,1728.0,82,5.7,65,341,2477,9.4,0.2998328
325,325,Adrian Aucoin,2010-11,37.0,16,28,82,82,8,20,28,144.0,1849.0,933,116,248,364,1872.0,82,5.53,56,304,2486,9.1,0.2914604
326,326,Adrian Aucoin,2011-12,38.0,17,22,75,75,3,19,22,99.0,1625.0,1008,119,267,386,1971.0,82,5.46,52,291,2492,9.0,0.23488858
327,327,Adrian Aucoin,2012-13,39.0,18,9,64,64,2,7,9,92.0,1296.0,1072,121,274,395,2063.0,82,5.32,47,271,2439,8.9,0.16892955
328,328,Adrian Aucoin,2013-14,40.0,19,4,36,36,0,4,4,26.0,588.0,1108,121,278,399,2089.0,48,5.31,29,160,1399,9.1,0.15503961
329,329,Adrian Kempe,2017-18,21.0,2,6,25,25,2,4,6,32.0,306.0,25,2,4,6,32.0,82,5.45,47,245,2478,9.0,0.3031816
330,330,Adrian Kempe,2018-19,22.0,3,37,81,81,16,21,37,119.0,1080.0,106,18,25,43,151.0,82,5.86,50,250,2620,9.2,0.5086512
331,331,Adrian Kempe,2019-20,23.0,4,28,81,81,12,16,28,118.0,1175.0,187,30,41,71,269.0,82,5.96,47,239,2579,9.5,0.40430164
332,332,Adrian Kempe,2020-21,24.0,5,32,69,69,11,21,32,148.0,1105.0,256,41,62,103,417.0,70,5.96,42,208,2192,9.5,0.50761175
333,333,Adrien Plavsic,1990-91,21.0,2,6,15,15,3,3,6,14.0,,15,3,3,6,14.0,80,7.37,76,367,2421,12.2,0.38545537
334,334,Adrien Plavsic,1991-92,22.0,3,12,48,48,2,10,12,69.0,,63,5,13,18,83.0,80,6.91,71,366,2385,11.6,0.32063305
335,335,Adrien Plavsic,1992-93,23.0,4,10,16,16,1,9,10,21.0,,79,6,22,28,104.0,80,6.96,77,402,2440,11.4,0.35906312
336,336,Adrien Plavsic,1993-94,24.0,5,27,57,57,6,21,27,62.0,,136,12,43,55,166.0,84,7.25,87,443,2603,11.7,0.37179837
337,337,Adrien Plavsic,1994-95,25.0,6,10,47,47,1,9,10,41.0,,183,13,52,65,207.0,84,6.48,76,407,2545,10.7,0.1931721
338,338,Adrien Plavsic,1995-96,26.0,7,4,18,18,2,2,4,35.0,,201,15,54,69,242.0,48,5.97,37,209,1408,10.2,0.300537
339,339,Adrien Plavsic,1996-97,27.0,8,3,7,7,1,2,3,4.0,,208,16,56,72,246.0,82,6.29,74,413,2481,10.4,0.20422268
340,340,Adrien Plavsic,1997-98,28.0,9,0,6,6,0,0,0,3.0,,214,16,56,72,249.0,82,5.83,55,336,2444,9.8,0.2146081
341,341,Aki Berg,1996-97,19.0,2,7,51,51,0,7,7,56.0,,51,0,7,7,56.0,82,6.29,74,413,2481,10.4,0.22598416
342,342,Aki Berg,1997-98,20.0,3,8,41,41,2,6,8,65.0,,92,2,13,15,121.0,82,5.83,55,336,2444,9.8,0.2725644
343,343,Aki Berg,1998-99,21.0,4,8,72,72,0,8,8,58.0,,164,2,21,23,179.0,82,5.28,57,380,2242,9.6,0.2060577
344,344,Aki Berg,2000-01,23.0,5,16,70,70,3,13,16,70.0,1165.0,234,5,34,39,249.0,82,5.49,53,331,2294,9.8,0.22260913
345,345,Aki Berg,2001-02,24.0,6,7,59,59,3,4,7,43.0,919.0,293,8,38,46,292.0,82,5.51,63,376,2272,9.9,0.18160471
346,346,Aki Berg,2002-03,25.0,7,11,81,81,1,10,11,66.0,1516.0,374,9,48,57,358.0,82,5.24,53,338,2262,9.5,0.15874481
347,347,Aki Berg,2003-04,26.0,8,11,78,78,4,7,11,49.0,1173.0,452,13,55,68,407.0,82,5.31,60,363,2326,9.4,0.15716624
348,348,Aki Berg,2004-05,27.0,9,9,79,79,2,7,9,69.0,1446.0,531,15,62,77,476.0,82,5.14,57,348,2300,9.2,0.18213946
349,349,Aki Berg,2006-07,29.0,10,8,75,75,0,8,8,42.0,1197.0,606,15,70,85,518.0,82,6.05,85,480,2458,10.1,0.1437141
350,350,Akim Aliu,2012-13,23.0,2,3,2,2,2,1,3,3.0,22.0,2,2,1,3,3.0,82,5.32,47,271,2439,8.9,0.25201884
351,351,Akim Aliu,2013-14,24.0,3,0,5,5,0,0,0,2.0,54.0,7,2,1,3,5.0,48,5.31,29,160,1399,9.1,0.19259855
352,352,Al Conroy,1992-93,27.0,2,11,31,31,2,9,11,25.0,,31,2,9,11,25.0,80,6.96,77,402,2440,11.4,0.27621076
353,353,Al Conroy,1993-94,28.0,3,5,21,21,3,2,5,24.0,,52,5,11,16,49.0,84,7.25,87,443,2603,11.7,0.2486181
354,354,Al Conroy,1994-95,29.0,4,7,62,62,4,3,7,40.0,,114,9,14,23,89.0,84,6.48,76,407,2545,10.7,0.16865033
355,355,Al Hangsleben,1980-81,27.0,2,35,74,74,13,22,35,107.0,,74,13,22,35,107.0,80,7.03,61,280,2352,12.0,0.4565277
356,356,Al Hangsleben,1981-82,28.0,3,24,76,76,5,19,24,110.0,,150,18,41,59,217.0,80,7.69,77,340,2441,12.6,0.30219686
357,357,Al Hangsleben,1982-83,29.0,4,10,35,35,3,7,10,31.0,,185,21,48,69,248.0,80,8.03,73,320,2489,12.9,0.3039496
358,358,Al Iafrate,1985-86,19.0,2,21,68,68,5,16,21,88.0,,68,5,16,21,88.0,80,7.77,71,321,2447,12.7,0.38964644
359,359,Al Iafrate,1986-87,20.0,3,33,65,65,8,25,33,97.0,,133,13,41,54,185.0,80,7.94,82,370,2484,12.8,0.49823782
360,360,Al Iafrate,1987-88,21.0,4,30,80,80,9,21,30,133.0,,213,22,62,84,318.0,80,7.34,72,344,2400,12.2,0.49791065
361,361,Al Iafrate,1988-89,22.0,5,52,77,77,22,30,52,169.0,,290,44,92,136,487.0,80,7.43,89,437,2435,12.2,0.68459165
362,362,Al Iafrate,1989-90,23.0,6,33,65,65,13,20,33,105.0,,355,57,112,169,592.0,80,7.48,85,403,2430,12.3,0.56785977
363,363,Al Iafrate,1990-91,24.0,7,63,75,75,21,42,63,153.0,,430,78,154,232,745.0,80,7.37,76,367,2421,12.2,0.69765985
364,364,Al Iafrate,1991-92,25.0,8,32,72,72,9,23,32,106.0,,502,87,177,264,851.0,80,6.91,71,366,2385,11.6,0.4648408
365,365,Al Iafrate,1992-93,26.0,9,51,78,78,17,34,51,151.0,,580,104,211,315,1002.0,80,6.96,77,402,2440,11.4,0.6445311
366,366,Al Iafrate,1993-94,27.0,10,66,81,81,25,41,66,289.0,,661,129,252,381,1291.0,84,7.25,87,443,2603,11.7,0.71721923
367,367,Al Iafrate,1994-95,28.0,11,58,79,79,15,43,58,299.0,,740,144,295,439,1590.0,84,6.48,76,407,2545,10.7,0.6457813
368,368,Al Iafrate,1997-98,31.0,12,15,38,38,6,9,15,91.0,,778,150,304,454,1681.0,82,5.83,55,336,2444,9.8,0.37402922
369,369,Al Iafrate,1998-99,32.0,13,9,21,21,2,7,9,37.0,,799,152,311,463,1718.0,82,5.28,57,380,2242,9.6,0.3508331
370,370,Al MacInnis,1982-83,19.0,2,0,2,2,0,0,0,2.0,,2,0,0,0,2.0,80,8.03,73,320,2489,12.9,0.27447498
371,371,Al MacInnis,1983-84,20.0,3,4,14,14,1,3,4,7.0,,16,1,3,4,9.0,80,7.73,71,310,2444,12.7,0.31607628
372,372,Al MacInnis,1984-85,21.0,4,45,51,51,11,34,45,160.0,,67,12,37,49,169.0,80,7.89,74,336,2448,12.9,0.866327
373,373,Al MacInnis,1985-86,22.0,5,66,67,67,14,52,66,259.0,,134,26,89,115,428.0,80,7.77,71,321,2447,12.7,0.940825
374,374,Al MacInnis,1986-87,23.0,6,68,77,77,11,57,68,241.0,,211,37,146,183,669.0,80,7.94,82,370,2484,12.8,0.80018836
375,375,Al MacInnis,1987-88,24.0,7,76,79,79,20,56,76,262.0,,290,57,202,259,931.0,80,7.34,72,344,2400,12.2,0.9796798
376,376,Al MacInnis,1988-89,25.0,8,83,80,80,25,58,83,245.0,,370,82,260,342,1176.0,80,7.43,89,437,2435,12.2,0.9326493
377,377,Al MacInnis,1989-90,26.0,9,74,79,79,16,58,74,277.0,,449,98,318,416,1453.0,80,7.48,85,403,2430,12.3,0.9488293
378,378,Al MacInnis,1990-91,27.0,10,90,79,79,28,62,90,304.0,,528,126,380,506,1757.0,80,7.37,76,367,2421,12.2,1.1381186
379,379,Al MacInnis,1991-92,28.0,11,103,78,78,28,75,103,305.0,,606,154,455,609,2062.0,80,6.91,71,366,2385,11.6,1.169026
380,380,Al MacInnis,1992-93,29.0,12,77,72,72,20,57,77,304.0,,678,174,512,686,2366.0,80,6.96,77,402,2440,11.4,0.99954003
381,381,Al MacInnis,1993-94,30.0,13,54,50,50,11,43,54,201.0,,728,185,555,740,2567.0,84,7.25,87,443,2603,11.7,1.0293949
382,382,Al MacInnis,1994-95,31.0,14,82,75,75,28,54,82,324.0,,803,213,609,822,2891.0,84,6.48,76,407,2545,10.7,0.9205469
383,383,Al MacInnis,1995-96,32.0,15,28,32,32,8,20,28,110.0,,835,221,629,850,3001.0,48,5.97,37,209,1408,10.2,0.80569476
384,384,Al MacInnis,1996-97,33.0,16,61,82,82,17,44,61,317.0,,917,238,673,911,3318.0,82,6.29,74,413,2481,10.4,0.659279
385,385,Al MacInnis,1997-98,34.0,17,43,72,72,13,30,43,296.0,,989,251,703,954,3614.0,82,5.83,55,336,2444,9.8,0.6028764
386,386,Al MacInnis,1998-99,35.0,18,49,71,71,19,30,49,227.0,,1060,270,733,1003,3841.0,82,5.28,57,380,2242,9.6,0.6483159
387,387,Al MacInnis,1999-00,36.0,19,62,82,82,20,42,62,314.0,2388.0,1142,290,775,1065,4155.0,82,5.27,57,359,2285,9.4,0.6943839
388,388,Al MacInnis,2000-01,37.0,20,39,61,61,11,28,39,245.0,1593.0,1203,301,803,1104,4400.0,82,5.49,53,331,2294,9.8,0.64183915
389,389,Al MacInnis,2001-02,38.0,21,54,59,59,12,42,54,218.0,1565.0,1262,313,845,1158,4618.0,82,5.51,63,376,2272,9.9,0.6908257
390,390,Al MacInnis,2002-03,39.0,22,46,71,71,11,35,46,231.0,1912.0,1333,324,880,1204,4849.0,82,5.24,53,338,2262,9.5,0.60451114
391,391,Al MacInnis,2003-04,40.0,23,68,80,80,16,52,68,299.0,2153.0,1413,340,932,1272,5148.0,82,5.31,60,363,2326,9.4,0.7358706
392,392,Al MacInnis,2004-05,41.0,24,2,3,3,0,2,2,9.0,75.0,1416,340,934,1274,5157.0,82,5.14,57,348,2300,9.2,0.3145948
393,393,Alain Cote,1980-81,23.0,2,16,41,41,5,11,16,58.0,,41,5,11,16,58.0,80,7.03,61,280,2352,12.0,0.38278922
394,394,Alain Cote,1981-82,24.0,3,26,51,51,8,18,26,65.0,,92,13,29,42,123.0,80,7.69,77,340,2441,12.6,0.45403984
395,395,Alain Cote,1982-83,25.0,4,31,79,79,15,16,31,95.0,,171,28,45,73,218.0,80,8.03,73,320,2489,12.9,0.42203388
396,396,Alain Cote,1983-84,26.0,5,40,79,79,12,28,40,88.0,,250,40,73,113,306.0,80,7.73,71,310,2444,12.7,0.47520876
397,397,Alain Cote,1984-85,27.0,6,43,77,77,19,24,43,116.0,,327,59,97,156,422.0,80,7.89,74,336,2448,12.9,0.46258008
398,398,Alain Cote,1985-86,28.0,7,35,80,80,13,22,35,127.0,,407,72,119,191,549.0,80,7.77,71,321,2447,12.7,0.44039857
399,399,Alain Cote,1986-87,29.0,8,34,78,78,13,21,34,120.0,,485,85,140,225,669.0,80,7.94,82,370,2484,12.8,0.4063844
400,400,Alain Cote,1987-88,30.0,9,36,80,80,12,24,36,131.0,,565,97,164,261,800.0,80,7.34,72,344,2400,12.2,0.400386
401,401,Alain Cote,1988-89,31.0,10,22,76,76,4,18,22,84.0,,641,101,182,283,884.0,80,7.43,89,437,2435,12.2,0.2719583
402,402,Alain Cote,1989-90,32.0,11,10,55,55,2,8,10,31.0,,696,103,190,293,915.0,80,7.48,85,403,2430,12.3,0.26253647
403,403,Alain Cote0,1986-87,19.0,2,6,32,32,0,6,6,15.0,,32,0,6,6,15.0,80,7.94,82,370,2484,12.8,0.22712672
404,404,Alain Cote0,1987-88,20.0,3,0,3,3,0,0,0,1.0,,35,0,6,6,16.0,80,7.34,72,344,2400,12.2,0.23604
405,405,Alain Cote0,1988-89,21.0,4,0,2,2,0,0,0,1.0,,37,0,6,6,17.0,80,7.43,89,437,2435,12.2,0.22213957
406,406,Alain Cote0,1989-90,22.0,5,5,31,31,2,3,5,45.0,,68,2,9,11,62.0,80,7.48,85,403,2430,12.3,0.27202272
407,407,Alain Cote0,1990-91,23.0,6,0,2,2,0,0,0,2.0,,70,2,9,11,64.0,80,7.37,76,367,2421,12.2,0.18956876
408,408,Alain Cote0,1991-92,24.0,7,6,28,28,0,6,6,24.0,,98,2,15,17,88.0,80,6.91,71,366,2385,11.6,0.20651236
409,409,Alain Cote0,1992-93,25.0,8,3,13,13,0,3,3,6.0,,111,2,18,20,94.0,80,6.96,77,402,2440,11.4,0.2110571
410,410,Alain Cote0,1993-94,26.0,9,0,2,2,0,0,0,1.0,,113,2,18,20,95.0,84,7.25,87,443,2603,11.7,0.17769319
411,411,Alain Cote0,1994-95,27.0,10,0,6,6,0,0,0,4.0,,119,2,18,20,99.0,84,6.48,76,407,2545,10.7,0.133726
412,412,Alain Lemieux,1982-83,21.0,2,1,3,3,0,1,1,7.0,,3,0,1,1,7.0,80,8.03,73,320,2489,12.9,0.31319612
413,413,Alain Lemieux,1983-84,22.0,3,34,42,42,9,25,34,72.0,,45,9,26,35,79.0,80,7.73,71,310,2444,12.7,0.6409867
414,414,Alain Lemieux,1984-85,23.0,4,9,17,17,4,5,9,14.0,,62,13,31,44,93.0,80,7.89,74,336,2448,12.9,0.46307492
415,415,Alain Lemieux,1985-86,24.0,5,28,49,49,15,13,28,58.0,,111,28,44,72,151.0,80,7.77,71,321,2447,12.7,0.47940317
416,416,Alain Lemieux,1986-87,25.0,6,0,7,7,0,0,0,1.0,,118,28,44,72,152.0,80,7.94,82,370,2484,12.8,0.2787348
417,417,Alain Lemieux,1987-88,26.0,7,0,1,1,0,0,0,0.0,,119,28,44,72,152.0,80,7.34,72,344,2400,12.2,0.3350459
418,418,Alain Nasreddine,1999-00,24.0,2,0,15,15,0,0,0,3.0,151.0,15,0,0,0,3.0,82,5.27,57,359,2285,9.4,0.1508674
419,419,Alain Nasreddine,2003-04,28.0,3,0,3,3,0,0,0,0.0,37.0,18,0,0,0,3.0,82,5.31,60,363,2326,9.4,0.13430277
420,420,Alain Nasreddine,2006-07,31.0,4,0,6,6,0,0,0,3.0,91.0,24,0,0,0,6.0,82,6.05,85,480,2458,10.1,0.13122466
421,421,Alain Nasreddine,2007-08,32.0,5,5,44,44,1,4,5,29.0,694.0,68,1,4,5,35.0,82,5.76,70,398,2426,9.7,0.09281108
422,422,Alain Nasreddine,2008-09,33.0,6,0,6,6,0,0,0,3.0,77.0,74,1,4,5,38.0,82,5.44,62,351,2383,9.4,0.110521734
423,423,Alain Vigneault,1982-83,21.0,2,3,14,14,1,2,3,9.0,,14,1,2,3,9.0,80,8.03,73,320,2489,12.9,0.31560937
424,424,Alain Vigneault,1983-84,22.0,3,4,28,28,1,3,4,13.0,,42,2,5,7,22.0,80,7.73,71,310,2444,12.7,0.19646648
425,425,Alan Haworth,1981-82,21.0,2,36,49,49,16,20,36,72.0,,49,16,20,36,72.0,80,7.69,77,340,2441,12.6,0.65928876
426,426,Alan Haworth,1982-83,22.0,3,39,57,57,21,18,39,114.0,,106,37,38,75,186.0,80,8.03,73,320,2489,12.9,0.65375715
427,427,Alan Haworth,1983-84,23.0,4,50,74,74,23,27,50,145.0,,180,60,65,125,331.0,80,7.73,71,310,2444,12.7,0.67636544
428,428,Alan Haworth,1984-85,24.0,5,55,75,75,24,31,55,164.0,,255,84,96,180,495.0,80,7.89,74,336,2448,12.9,0.73116696
429,429,Alan Haworth,1985-86,25.0,6,49,76,76,23,26,49,154.0,,331,107,122,229,649.0,80,7.77,71,321,2447,12.7,0.6792852
430,430,Alan Haworth,1986-87,26.0,7,73,71,71,34,39,73,194.0,,402,141,161,302,843.0,80,7.94,82,370,2484,12.8,0.825198
431,431,Alan Haworth,1987-88,27.0,8,41,50,50,25,16,41,143.0,,452,166,177,343,986.0,80,7.34,72,344,2400,12.2,0.7682228
432,432,Alan Haworth,1988-89,28.0,9,57,72,72,23,34,57,171.0,,524,189,211,400,1157.0,80,7.43,89,437,2435,12.2,0.7880883
433,433,Alan Hepple,1984-85,21.0,2,0,1,1,0,0,0,0.0,,1,0,0,0,0.0,80,7.89,74,336,2448,12.9,0.22589162
434,434,Alan Hepple,1985-86,22.0,3,0,1,1,0,0,0,2.0,,2,0,0,0,2.0,80,7.77,71,321,2447,12.7,0.21188053
435,435,Alan Hepple,1986-87,23.0,4,0,1,1,0,0,0,0.0,,3,0,0,0,2.0,80,7.94,82,370,2484,12.8,0.18982989
436,436,Alan Kerr,1985-86,21.0,2,4,19,19,3,1,4,17.0,,19,3,1,4,17.0,80,7.77,71,321,2447,12.7,0.35163397
437,437,Alan Kerr,1986-87,22.0,3,1,7,7,0,1,1,9.0,,26,3,2,5,26.0,80,7.94,82,370,2484,12.8,0.24143174
438,438,Alan Kerr,1987-88,23.0,4,17,72,72,7,10,17,97.0,,98,10,12,22,123.0,80,7.34,72,344,2400,12.2,0.33715028
439,439,Alan Kerr,1988-89,24.0,5,58,80,80,24,34,58,196.0,,178,34,46,80,319.0,80,7.43,89,437,2435,12.2,0.69113535
440,440,Alan Kerr,1989-90,25.0,6,38,71,71,20,18,38,147.0,,249,54,64,118,466.0,80,7.48,85,403,2430,12.3,0.5034611
441,441,Alan Kerr,1990-91,26.0,7,36,75,75,15,21,36,127.0,,324,69,85,154,593.0,80,7.37,76,367,2421,12.2,0.4514293
442,442,Alan Kerr,1991-92,27.0,8,0,2,2,0,0,0,2.0,,326,69,85,154,595.0,80,6.91,71,366,2385,11.6,0.2889892
443,443,Alan Kerr,1992-93,28.0,9,11,58,58,3,8,11,41.0,,384,72,93,165,636.0,80,6.96,77,402,2440,11.4,0.2963286
444,444,Alan Kerr,1993-94,29.0,10,1,7,7,0,1,1,1.0,,391,72,94,166,637.0,84,7.25,87,443,2603,11.7,0.2544884
445,445,Alan Letang,2000-01,25.0,2,0,8,8,0,0,0,1.0,80.0,8,0,0,0,1.0,82,5.49,53,331,2294,9.8,0.15239698
446,446,Alan Letang,2002-03,27.0,3,0,2,2,0,0,0,0.0,22.0,10,0,0,0,1.0,82,5.24,53,338,2262,9.5,0.14669693
447,447,Alan Letang,2003-04,28.0,4,0,4,4,0,0,0,2.0,54.0,14,0,0,0,3.0,82,5.31,60,363,2326,9.4,0.13420096
448,448,Alan May,1988-89,24.0,2,0,3,3,0,0,0,3.0,,3,0,0,0,3.0,80,7.43,89,437,2435,12.2,0.23191011
449,449,Alan May,1989-90,25.0,3,1,3,3,1,0,1,3.0,,6,1,0,1,6.0,80,7.48,85,403,2430,12.3,0.23272368
450,450,Alan May,1990-91,26.0,4,17,77,77,7,10,17,67.0,,83,8,10,18,73.0,80,7.37,76,367,2421,12.2,0.23238376
451,451,Alan May,1991-92,27.0,5,10,67,67,4,6,10,66.0,,150,12,16,28,139.0,80,6.91,71,366,2385,11.6,0.20415461
452,452,Alan May,1992-93,28.0,6,15,75,75,6,9,15,43.0,,225,18,25,43,182.0,80,6.96,77,402,2440,11.4,0.21069318
453,453,Alan May,1993-94,29.0,7,16,83,83,6,10,16,75.0,,308,24,35,59,257.0,84,7.25,87,443,2603,11.7,0.20264044
454,454,Alan May,1994-95,30.0,8,12,51,51,5,7,12,40.0,,359,29,42,71,297.0,84,6.48,76,407,2545,10.7,0.18233395
455,455,Alan May,1995-96,31.0,9,5,34,34,2,3,5,28.0,,393,31,45,76,325.0,48,5.97,37,209,1408,10.2,0.17303926
456,456,Alan Quine,2016-17,23.0,2,1,2,2,1,0,1,5.0,36.0,2,1,0,1,5.0,82,5.34,48,255,2438,9.0,0.22416201
457,457,Alan Quine,2017-18,24.0,3,18,61,61,5,13,18,82.0,764.0,63,6,13,19,87.0,82,5.45,47,245,2478,9.0,0.2945954
458,458,Alan Quine,2018-19,25.0,4,3,21,21,0,3,3,15.0,246.0,84,6,16,22,102.0,82,5.86,50,250,2620,9.2,0.16643718
459,459,Alan Quine,2019-20,26.0,5,5,13,13,3,2,5,11.0,123.0,97,9,18,27,113.0,82,5.96,47,239,2579,9.5,0.26351732
460,460,Alan Quine,2020-21,27.0,6,1,9,9,1,0,1,12.0,88.0,106,10,18,28,125.0,70,5.96,42,208,2192,9.5,0.20481583
461,461,Alec Martinez,2010-11,23.0,2,0,4,4,0,0,0,6.0,62.0,4,0,0,0,6.0,82,5.53,56,304,2486,9.1,0.17674801
462,462,Alec Martinez,2011-12,24.0,3,16,60,60,5,11,16,74.0,917.0,64,5,11,16,80.0,82,5.46,52,291,2492,9.0,0.2749555
463,463,Alec Martinez,2012-13,25.0,4,12,51,51,6,6,12,78.0,751.0,115,11,17,28,158.0,82,5.32,47,271,2439,8.9,0.2794063
464,464,Alec Martinez,2013-14,26.0,5,5,27,27,1,4,5,30.0,433.0,142,12,21,33,188.0,48,5.31,29,160,1399,9.1,0.19657445
465,465,Alec Martinez,2014-15,27.0,6,22,61,61,11,11,22,79.0,957.0,203,23,32,55,267.0,82,5.34,48,269,2463,8.9,0.28780535
466,466,Alec Martinez,2015-16,28.0,7,22,56,56,6,16,22,103.0,1116.0,259,29,48,77,370.0,82,5.32,47,251,2453,8.9,0.35469317
467,467,Alec Martinez,2016-17,29.0,8,31,78,78,10,21,31,124.0,1650.0,337,39,69,108,494.0,82,5.34,48,255,2438,9.0,0.35840482
468,468,Alec Martinez,2017-18,30.0,9,39,82,82,9,30,39,144.0,1775.0,419,48,99,147,638.0,82,5.45,47,245,2478,9.0,0.42864448
469,469,Alec Martinez,2018-19,31.0,10,25,77,77,9,16,25,111.0,1760.0,496,57,115,172,749.0,82,5.86,50,250,2620,9.2,0.29681224
470,470,Alec Martinez,2019-20,32.0,11,18,60,60,4,14,18,78.0,1282.0,556,61,129,190,827.0,82,5.96,47,239,2579,9.5,0.2580098
471,471,Alec Martinez,2020-21,33.0,12,16,51,51,3,13,16,75.0,1097.0,607,64,142,206,902.0,70,5.96,42,208,2192,9.5,0.3086211
472,472,Alek Stojanov,1995-96,22.0,2,0,4,4,0,0,0,1.0,,4,0,0,0,1.0,48,5.97,37,209,1408,10.2,0.19276294
473,473,Alek Stojanov,1996-97,23.0,3,2,68,68,1,1,2,20.0,,72,1,1,2,21.0,82,6.29,74,413,2481,10.4,0.11661455
474,474,Alek Stojanov,1997-98,24.0,4,5,35,35,1,4,5,11.0,,107,2,5,7,32.0,82,5.83,55,336,2444,9.8,0.13404292
475,475,Aleksander Barkov,2014-15,19.0,2,24,54,54,8,16,24,87.0,923.0,54,8,16,24,87.0,82,5.34,48,269,2463,8.9,0.45065454
476,476,Aleksander Barkov,2015-16,20.0,3,36,71,71,16,20,36,123.0,1242.0,125,24,36,60,210.0,82,5.32,47,251,2453,8.9,0.51661897
477,477,Aleksander Barkov,2016-17,21.0,4,59,66,66,28,31,59,171.0,1282.0,191,52,67,119,381.0,82,5.34,48,255,2438,9.0,0.8827755
478,478,Aleksander Barkov,2017-18,22.0,5,52,61,61,21,31,52,142.0,1184.0,252,73,98,171,523.0,82,5.45,47,245,2478,9.0,0.8111606
479,479,Aleksander Barkov,2018-19,23.0,6,78,79,79,27,51,78,256.0,1744.0,331,100,149,249,779.0,82,5.86,50,250,2620,9.2,0.97624016
480,480,Aleksander Barkov,2019-20,24.0,7,96,82,82,35,61,96,206.0,1833.0,413,135,210,345,985.0,82,5.96,47,239,2579,9.5,1.0320805
481,481,Aleksander Barkov,2020-21,25.0,8,62,66,66,20,42,62,172.0,1321.0,479,155,252,407,1157.0,70,5.96,42,208,2192,9.5,0.91823727
482,482,Aleksey Morozov,1998-99,21.0,2,26,76,76,13,13,26,80.0,,76,13,13,26,80.0,82,5.28,57,380,2242,9.6,0.38613352
483,483,Aleksey Morozov,1999-00,22.0,3,19,67,67,9,10,19,75.0,793.0,143,22,23,45,155.0,82,5.27,57,359,2285,9.4,0.3638628
484,484,Aleksey Morozov,2000-01,23.0,4,31,68,68,12,19,31,101.0,942.0,211,34,42,76,256.0,82,5.49,53,331,2294,9.8,0.47583166
485,485,Aleksey Morozov,2001-02,24.0,5,19,66,66,5,14,19,72.0,705.0,277,39,56,95,328.0,82,5.51,63,376,2272,9.9,0.32117096
486,486,Aleksey Morozov,2002-03,25.0,6,49,72,72,20,29,49,162.0,1203.0,349,59,85,144,490.0,82,5.24,53,338,2262,9.5,0.6080189
487,487,Aleksey Morozov,2003-04,26.0,7,25,27,27,9,16,25,46.0,505.0,376,68,101,169,536.0,82,5.31,60,363,2326,9.4,0.6839117
488,488,Aleksey Morozov,2004-05,27.0,8,50,75,75,16,34,50,132.0,1243.0,451,84,135,219,668.0,82,5.14,57,348,2300,9.2,0.6890925
489,489,Aleksi Saarela,2020-21,24.0,2,4,9,9,2,2,4,15.0,110.0,9,2,2,4,15.0,70,5.96,42,208,2192,9.5,0.27954757
490,490,Ales Hemsky,2003-04,20.0,2,30,59,59,6,24,30,50.0,712.0,59,6,24,30,50.0,82,5.31,60,363,2326,9.4,0.49998876
491,491,Ales Hemsky,2004-05,21.0,3,34,71,71,12,22,34,87.0,1025.0,130,18,46,64,137.0,82,5.14,57,348,2300,9.2,0.6890038
492,492,Ales Hemsky,2006-07,23.0,4,77,81,81,19,58,77,178.0,1375.0,211,37,104,141,315.0,82,6.05,85,480,2458,10.1,0.86079955
493,493,Ales Hemsky,2007-08,24.0,5,53,64,64,13,40,53,122.0,1087.0,275,50,144,194,437.0,82,5.76,70,398,2426,9.7,0.78259087
494,494,Ales Hemsky,2008-09,25.0,6,71,74,74,20,51,71,184.0,1375.0,349,70,195,265,621.0,82,5.44,62,351,2383,9.4,0.8911464
495,495,Ales Hemsky,2009-10,26.0,7,66,72,72,23,43,66,185.0,1343.0,421,93,238,331,806.0,82,5.7,65,341,2477,9.4,0.8442015
496,496,Ales Hemsky,2010-11,27.0,8,22,22,22,7,15,22,57.0,395.0,443,100,253,353,863.0,82,5.53,56,304,2486,9.1,0.76950395
497,497,Ales Hemsky,2011-12,28.0,9,42,47,47,14,28,42,100.0,859.0,490,114,281,395,963.0,82,5.46,52,291,2492,9.0,0.70248836
498,498,Ales Hemsky,2012-13,29.0,10,36,69,69,10,26,36,137.0,1214.0,559,124,307,431,1100.0,82,5.32,47,271,2439,8.9,0.47998327
499,499,Ales Hemsky,2013-14,30.0,11,20,38,38,9,11,20,82.0,597.0,597,133,318,451,1182.0,48,5.31,29,160,1399,9.1,0.57455313
500,500,Ales Hemsky,2014-15,31.0,12,43,75,75,13,30,43,138.0,1197.0,672,146,348,494,1320.0,82,5.34,48,269,2463,8.9,0.51682806
501,501,Ales Hemsky,2015-16,32.0,13,32,76,76,11,21,32,140.0,1037.0,748,157,369,526,1460.0,82,5.32,47,251,2453,8.9,0.4104475
502,502,Ales Hemsky,2016-17,33.0,14,39,75,75,13,26,39,155.0,983.0,823,170,395,565,1615.0,82,5.34,48,255,2438,9.0,0.4970982
503,503,Ales Hemsky,2017-18,34.0,15,7,15,15,4,3,7,30.0,216.0,838,174,398,572,1645.0,82,5.45,47,245,2478,9.0,0.26178554
504,504,Ales Hemsky,2018-19,35.0,16,0,7,7,0,0,0,5.0,69.0,845,174,398,572,1650.0,82,5.86,50,250,2620,9.2,0.22238562
505,505,Ales Kotalik,2002-03,24.0,2,4,13,13,1,3,4,21.0,164.0,13,1,3,4,21.0,82,5.24,53,338,2262,9.5,0.2429393
506,506,Ales Kotalik,2003-04,25.0,3,35,68,68,21,14,35,138.0,1037.0,81,22,17,39,159.0,82,5.31,60,363,2326,9.4,0.47827384
507,507,Ales Kotalik,2004-05,26.0,4,26,62,62,15,11,26,142.0,941.0,143,37,28,65,301.0,82,5.14,57,348,2300,9.2,0.56477535
508,508,Ales Kotalik,2006-07,28.0,5,62,82,82,25,37,62,261.0,1276.0,225,62,65,127,562.0,82,6.05,85,480,2458,10.1,0.69809365
509,509,Ales Kotalik,2007-08,29.0,6,38,66,66,16,22,38,162.0,958.0,291,78,87,165,724.0,82,5.76,70,398,2426,9.7,0.53322065
510,510,Ales Kotalik,2008-09,30.0,7,43,79,79,23,20,43,207.0,1212.0,370,101,107,208,931.0,82,5.44,62,351,2383,9.4,0.54907537
511,511,Ales Kotalik,2009-10,31.0,8,43,75,75,20,23,43,208.0,1159.0,445,121,130,251,1139.0,82,5.7,65,341,2477,9.4,0.513408
512,512,Ales Kotalik,2010-11,32.0,9,27,71,71,11,16,27,172.0,1007.0,516,132,146,278,1311.0,82,5.53,56,304,2486,9.1,0.3620952
513,513,Ales Kotalik,2011-12,33.0,10,6,26,26,4,2,6,62.0,322.0,542,136,148,284,1373.0,82,5.46,52,291,2492,9.0,0.29460433
514,514,Ales Pisa,2002-03,26.0,2,0,2,2,0,0,0,3.0,30.0,2,0,0,0,3.0,82,5.24,53,338,2262,9.5,0.16791895
515,515,Ales Pisa,2003-04,27.0,3,4,51,51,1,3,4,37.0,663.0,53,1,3,4,40.0,82,5.31,60,363,2326,9.4,0.12707031
516,516,Alex Biega,2015-16,27.0,2,1,7,7,1,0,1,7.0,111.0,7,1,0,1,7.0,82,5.32,47,251,2453,8.9,0.20211035
517,517,Alex Biega,2016-17,28.0,3,7,51,51,0,7,7,61.0,855.0,58,1,7,8,68.0,82,5.34,48,255,2438,9.0,0.13259676
518,518,Alex Biega,2017-18,29.0,4,3,36,36,0,3,3,37.0,474.0,94,1,10,11,105.0,82,5.45,47,245,2478,9.0,0.14600003
519,519,Alex Biega,2018-19,30.0,5,9,44,44,1,8,9,79.0,661.0,138,2,18,20,184.0,82,5.86,50,250,2620,9.2,0.15821868
520,520,Alex Biega,2019-20,31.0,6,16,41,41,2,14,16,91.0,725.0,179,4,32,36,275.0,82,5.96,47,239,2579,9.5,0.28824455
521,521,Alex Biega,2020-21,32.0,7,3,49,49,0,3,3,55.0,805.0,228,4,35,39,330.0,70,5.96,42,208,2192,9.5,0.15166295
522,522,Alex Broadhurst,2018-19,25.0,2,0,2,2,0,0,0,1.0,20.0,2,0,0,0,1.0,82,5.86,50,250,2620,9.2,0.15961453
523,523,Alex Brooks,2007-08,31.0,2,1,19,19,0,1,1,4.0,164.0,19,0,1,1,4.0,82,5.76,70,398,2426,9.7,0.08306202
524,524,Alex Chiasson,2013-14,23.0,2,7,7,7,6,1,7,13.0,99.0,7,6,1,7,13.0,48,5.31,29,160,1399,9.1,0.42099458
525,525,Alex Chiasson,2014-15,24.0,3,35,79,79,13,22,35,144.0,1194.0,86,19,23,42,157.0,82,5.34,48,269,2463,8.9,0.4414003
526,526,Alex Chiasson,2015-16,25.0,4,26,76,76,11,15,26,105.0,1017.0,162,30,38,68,262.0,82,5.32,47,251,2453,8.9,0.34420133
527,527,Alex Chiasson,2016-17,26.0,5,14,77,77,8,6,14,88.0,1050.0,239,38,44,82,350.0,82,5.34,48,255,2438,9.0,0.25222236
528,528,Alex Chiasson,2017-18,27.0,6,24,81,81,12,12,24,104.0,1084.0,320,50,56,106,454.0,82,5.45,47,245,2478,9.0,0.29592896
529,529,Alex Chiasson,2018-19,28.0,7,18,61,61,9,9,18,59.0,718.0,381,59,65,124,513.0,82,5.86,50,250,2620,9.2,0.2805121
530,530,Alex Chiasson,2019-20,29.0,8,38,73,73,22,16,38,123.0,1239.0,454,81,81,162,636.0,82,5.96,47,239,2579,9.5,0.43737113
531,531,Alex Chiasson,2020-21,30.0,9,24,65,65,11,13,24,97.0,853.0,519,92,94,186,733.0,70,5.96,42,208,2192,9.5,0.33602166
532,532,Alex DeBrincat,2018-19,21.0,2,52,82,82,28,24,52,181.0,1214.0,82,28,24,52,181.0,82,5.86,50,250,2620,9.2,0.7202022
533,533,Alex DeBrincat,2019-20,22.0,3,76,82,82,41,35,76,220.0,1451.0,164,69,59,128,401.0,82,5.96,47,239,2579,9.5,0.8523569
534,534,Alex DeBrincat,2020-21,23.0,4,45,70,70,18,27,45,207.0,1225.0,234,87,86,173,608.0,70,5.96,42,208,2192,9.5,0.7414624
535,535,Alex Formenton,2018-19,19.0,2,0,1,1,0,0,0,0.0,5.0,1,0,0,0,0.0,82,5.86,50,250,2620,9.2,0.2105726
536,536,Alex Formenton,2019-20,20.0,3,1,9,9,1,0,1,16.0,105.0,10,1,0,1,16.0,82,5.96,47,239,2579,9.5,0.2848227
537,537,Alex Foster,2008-09,24.0,2,0,3,3,0,0,0,1.0,11.0,3,0,0,0,1.0,82,5.44,62,351,2383,9.4,0.16871434
538,538,Alex Friesen,2016-17,26.0,2,0,1,1,0,0,0,1.0,12.0,1,0,0,0,1.0,82,5.34,48,255,2438,9.0,0.15961453
539,539,Alex Frolov,2003-04,21.0,2,31,79,79,14,17,31,141.0,1136.0,79,14,17,31,141.0,82,5.31,60,363,2326,9.4,0.48485246
540,540,Alex Frolov,2004-05,22.0,3,48,77,77,24,24,48,168.0,1326.0,156,38,41,79,309.0,82,5.14,57,348,2300,9.2,0.8074374
541,541,Alex Frolov,2006-07,24.0,4,54,69,69,21,33,54,174.0,1332.0,225,59,74,133,483.0,82,6.05,85,480,2458,10.1,0.7089421
542,542,Alex Frolov,2007-08,25.0,5,71,82,82,35,36,71,195.0,1635.0,307,94,110,204,678.0,82,5.76,70,398,2426,9.7,0.8634333
543,543,Alex Frolov,2008-09,26.0,6,67,71,71,23,44,67,160.0,1335.0,378,117,154,271,838.0,82,5.44,62,351,2383,9.4,0.8172027
544,544,Alex Frolov,2009-10,27.0,7,59,77,77,32,27,59,176.0,1534.0,455,149,181,330,1014.0,82,5.7,65,341,2477,9.4,0.66703624
545,545,Alex Frolov,2010-11,28.0,8,51,81,81,19,32,51,182.0,1493.0,536,168,213,381,1196.0,82,5.53,56,304,2486,9.1,0.64220774
546,546,Alex Frolov,2011-12,29.0,9,16,43,43,7,9,16,78.0,620.0,579,175,222,397,1274.0,82,5.46,52,291,2492,9.0,0.4410752
547,547,Alex Galchenyuk,2013-14,19.0,2,27,48,48,9,18,27,79.0,591.0,48,9,18,27,79.0,48,5.31,29,160,1399,9.1,0.51781386
548,548,Alex Galchenyuk,2014-15,20.0,3,31,65,65,13,18,31,110.0,936.0,113,22,36,58,189.0,82,5.34,48,269,2463,8.9,0.4924325
549,549,Alex Galchenyuk,2015-16,21.0,4,46,80,80,20,26,46,163.0,1314.0,193,42,62,104,352.0,82,5.32,47,251,2453,8.9,0.6049296
550,550,Alex Galchenyuk,2016-17,22.0,5,56,82,82,30,26,56,201.0,1333.0,275,72,88,160,553.0,82,5.34,48,255,2438,9.0,0.7295619
551,551,Alex Galchenyuk,2017-18,23.0,6,44,61,61,17,27,44,104.0,972.0,336,89,115,204,657.0,82,5.45,47,245,2478,9.0,0.63225985
552,552,Alex Galchenyuk,2018-19,24.0,7,51,82,82,19,32,51,213.0,1331.0,418,108,147,255,870.0,82,5.86,50,250,2620,9.2,0.6443131
553,553,Alex Galchenyuk,2019-20,25.0,8,41,72,72,19,22,41,159.0,1133.0,490,127,169,296,1029.0,82,5.96,47,239,2579,9.5,0.5759409
554,554,Alex Galchenyuk,2020-21,26.0,9,24,59,59,8,16,24,86.0,726.0,549,135,185,320,1115.0,70,5.96,42,208,2192,9.5,0.44512606
555,555,Alex Goligoski,2008-09,23.0,2,2,3,3,0,2,2,2.0,42.0,3,0,2,2,2.0,82,5.44,62,351,2383,9.4,0.21466026
556,556,Alex Goligoski,2009-10,24.0,3,20,45,45,6,14,20,61.0,824.0,48,6,16,22,63.0,82,5.7,65,341,2477,9.4,0.35301343
557,557,Alex Goligoski,2010-11,25.0,4,37,69,69,8,29,37,98.0,1478.0,117,14,45,59,161.0,82,5.53,56,304,2486,9.1,0.4526315
558,558,Alex Goligoski,2011-12,26.0,5,46,83,83,14,32,46,162.0,1846.0,200,28,77,105,323.0,82,5.46,52,291,2492,9.0,0.5318816
559,559,Alex Goligoski,2012-13,27.0,6,30,71,71,9,21,30,140.0,1617.0,271,37,98,135,463.0,82,5.32,47,271,2439,8.9,0.45300055
560,560,Alex Goligoski,2013-14,28.0,7,27,47,47,3,24,27,80.0,1052.0,318,40,122,162,543.0,48,5.31,29,160,1399,9.1,0.50095975
561,561,Alex Goligoski,2014-15,29.0,8,42,81,81,6,36,42,141.0,1969.0,399,46,158,204,684.0,82,5.34,48,269,2463,8.9,0.4794281
562,562,Alex Goligoski,2015-16,30.0,9,36,81,81,4,32,36,122.0,1929.0,480,50,190,240,806.0,82,5.32,47,251,2453,8.9,0.39175212
563,563,Alex Goligoski,2016-17,31.0,10,37,82,82,5,32,37,127.0,1954.0,562,55,222,277,933.0,82,5.34,48,255,2438,9.0,0.39989153
564,564,Alex Goligoski,2017-18,32.0,11,36,82,82,6,30,36,112.0,1913.0,644,61,252,313,1045.0,82,5.45,47,245,2478,9.0,0.38139895
565,565,Alex Goligoski,2018-19,33.0,12,35,78,78,12,23,35,119.0,1816.0,722,73,275,348,1164.0,82,5.86,50,250,2620,9.2,0.37469208
566,566,Alex Goligoski,2019-20,34.0,13,27,76,76,3,24,27,102.0,1582.0,798,76,299,375,1266.0,82,5.96,47,239,2579,9.5,0.3062916
567,567,Alex Goligoski,2020-21,35.0,14,32,70,70,4,28,32,101.0,1614.0,868,80,327,407,1367.0,70,5.96,42,208,2192,9.5,0.35762465
568,568,Alex Grant,2014-15,26.0,2,2,2,2,2,0,2,2.0,24.0,2,2,0,2,2.0,82,5.34,48,269,2463,8.9,0.21202925
569,569,Alex Grant,2016-17,28.0,3,0,5,5,0,0,0,4.0,66.0,7,2,0,2,6.0,82,5.34,48,255,2438,9.0,0.15336734
570,570,Alex Henry,2003-04,24.0,2,0,41,41,0,0,0,8.0,160.0,41,0,0,0,8.0,82,5.31,60,363,2326,9.4,0.0922485
571,571,Alex Henry,2004-05,25.0,3,6,71,71,2,4,6,37.0,1057.0,112,2,4,6,45.0,82,5.14,57,348,2300,9.2,0.17340678
572,572,Alex Henry,2006-07,27.0,4,5,63,63,0,5,5,41.0,720.0,175,2,9,11,86.0,82,6.05,85,480,2458,10.1,0.12012178
573,573,Alex Henry,2009-10,30.0,5,0,2,2,0,0,0,0.0,13.0,177,2,9,11,86.0,82,5.7,65,341,2477,9.4,0.12604272
574,574,Alex Hicks,1996-97,27.0,2,21,64,64,10,11,21,83.0,,64,10,11,21,83.0,82,6.29,74,413,2481,10.4,0.2940744
575,575,Alex Hicks,1997-98,28.0,3,28,73,73,7,21,28,78.0,,137,17,32,49,161.0,82,5.83,55,336,2444,9.8,0.33788607
576,576,Alex Hicks,1998-99,29.0,4,20,58,58,7,13,20,78.0,,195,24,45,69,239.0,82,5.28,57,380,2242,9.6,0.31642494
577,577,Alex Hicks,1999-00,30.0,5,7,55,55,0,7,7,51.0,546.0,250,24,52,76,290.0,82,5.27,57,359,2285,9.4,0.22148791
578,578,Alex Hicks,2000-01,31.0,6,3,8,8,1,2,3,6.0,69.0,258,25,54,79,296.0,82,5.49,53,331,2294,9.8,0.22501227
579,579,Alex Iafallo,2018-19,25.0,2,25,75,75,9,16,25,129.0,1133.0,75,9,16,25,129.0,82,5.86,50,250,2620,9.2,0.34966052
580,580,Alex Iafallo,2019-20,26.0,3,33,82,82,15,18,33,148.0,1380.0,157,24,34,58,277.0,82,5.96,47,239,2579,9.5,0.4327858
581,581,Alex Iafallo,2020-21,27.0,4,43,70,70,17,26,43,142.0,1325.0,227,41,60,101,419.0,70,5.96,42,208,2192,9.5,0.5736476
582,582,Alex Killorn,2013-14,24.0,2,19,38,38,7,12,19,82.0,639.0,38,7,12,19,82.0,48,5.31,29,160,1399,9.1,0.49413452
583,583,Alex Killorn,2014-15,25.0,3,41,82,82,17,24,41,173.0,1376.0,120,24,36,60,255.0,82,5.34,48,269,2463,8.9,0.51543987
584,584,Alex Killorn,2015-16,26.0,4,38,71,71,15,23,38,130.0,1202.0,191,39,59,98,385.0,82,5.32,47,251,2453,8.9,0.51088697
585,585,Alex Killorn,2016-17,27.0,5,40,81,81,14,26,40,154.0,1360.0,272,53,85,138,539.0,82,5.34,48,255,2438,9.0,0.50191844
586,586,Alex Killorn,2017-18,28.0,6,36,81,81,19,17,36,176.0,1458.0,353,72,102,174,715.0,82,5.45,47,245,2478,9.0,0.52714777
587,587,Alex Killorn,2018-19,29.0,7,47,82,82,15,32,47,156.0,1353.0,435,87,134,221,871.0,82,5.86,50,250,2620,9.2,0.5270209
588,588,Alex Killorn,2019-20,30.0,8,40,82,82,18,22,40,153.0,1220.0,517,105,156,261,1024.0,82,5.96,47,239,2579,9.5,0.49061856
589,589,Alex Killorn,2020-21,31.0,9,49,68,68,26,23,49,130.0,1219.0,585,131,179,310,1154.0,70,5.96,42,208,2192,9.5,0.59952027
590,590,Alex Kovalev,1993-94,20.0,2,38,65,65,20,18,38,134.0,,65,20,18,38,134.0,84,7.25,87,443,2603,11.7,0.61875695
591,591,Alex Kovalev,1994-95,21.0,3,56,76,76,23,33,56,184.0,,141,43,51,94,318.0,84,6.48,76,407,2545,10.7,0.6708754
592,592,Alex Kovalev,1995-96,22.0,4,28,48,48,13,15,28,103.0,,189,56,66,122,421.0,48,5.97,37,209,1408,10.2,0.6302788
593,593,Alex Kovalev,1996-97,23.0,5,58,81,81,24,34,58,206.0,,270,80,100,180,627.0,82,6.29,74,413,2481,10.4,0.72856826
594,594,Alex Kovalev,1997-98,24.0,6,35,45,45,13,22,35,110.0,,315,93,122,215,737.0,82,5.83,55,336,2444,9.8,0.7001234
595,595,Alex Kovalev,1998-99,25.0,7,53,73,73,23,30,53,173.0,,388,116,152,268,910.0,82,5.28,57,380,2242,9.6,0.68218136
596,596,Alex Kovalev,1999-00,26.0,8,53,77,77,23,30,53,191.0,1570.0,465,139,182,321,1101.0,82,5.27,57,359,2285,9.4,0.6901604
597,597,Alex Kovalev,2000-01,27.0,9,66,82,82,26,40,66,254.0,1876.0,547,165,222,387,1355.0,82,5.49,53,331,2294,9.8,0.86234725
598,598,Alex Kovalev,2001-02,28.0,10,95,79,79,44,51,95,307.0,1863.0,626,209,273,482,1662.0,82,5.51,63,376,2272,9.9,0.99980795
599,599,Alex Kovalev,2002-03,29.0,11,76,67,67,32,44,76,266.0,1611.0,693,241,317,558,1928.0,82,5.24,53,338,2262,9.5,0.9200473
600,600,Alex Kovalev,2003-04,30.0,12,77,78,78,37,40,77,271.0,1783.0,771,278,357,635,2199.0,82,5.31,60,363,2326,9.4,0.8395053
601,601,Alex Kovalev,2004-05,31.0,13,45,78,78,14,31,45,207.0,1482.0,849,292,388,680,2406.0,82,5.14,57,348,2300,9.2,0.757498
602,602,Alex Kovalev,2006-07,33.0,14,65,69,69,23,42,65,206.0,1344.0,918,315,430,745,2612.0,82,6.05,85,480,2458,10.1,0.7637832
603,603,Alex Kovalev,2007-08,34.0,15,47,73,73,18,29,47,197.0,1332.0,991,333,459,792,2809.0,82,5.76,70,398,2426,9.7,0.6474587
604,604,Alex Kovalev,2008-09,35.0,16,84,82,82,35,49,84,230.0,1603.0,1073,368,508,876,3039.0,82,5.44,62,351,2383,9.4,0.8832385
605,605,Alex Kovalev,2009-10,36.0,17,65,78,78,26,39,65,209.0,1515.0,1151,394,547,941,3248.0,82,5.7,65,341,2477,9.4,0.70663726
606,606,Alex Kovalev,2010-11,37.0,18,49,77,77,18,31,49,165.0,1398.0,1228,412,578,990,3413.0,82,5.53,56,304,2486,9.1,0.54598165
607,607,Alex Kovalev,2011-12,38.0,19,34,74,74,16,18,34,151.0,1222.0,1302,428,596,1024,3564.0,82,5.46,52,291,2492,9.0,0.4016378
608,608,Alex Kovalev,2013-14,40.0,20,5,14,14,2,3,5,21.0,219.0,1316,430,599,1029,3585.0,48,5.31,29,160,1399,9.1,0.50408834
609,609,Alex Ovechkin,2006-07,21.0,2,106,81,81,52,54,106,425.0,1751.0,81,52,54,106,425.0,82,6.05,85,480,2458,10.1,1.2087858
610,610,Alex Ovechkin,2007-08,22.0,3,92,82,82,46,46,92,392.0,1754.0,163,98,100,198,817.0,82,5.76,70,398,2426,9.7,1.1628242
611,611,Alex Ovechkin,2008-09,23.0,4,112,82,82,65,47,112,446.0,1894.0,245,163,147,310,1263.0,82,5.44,62,351,2383,9.4,1.2759597
612,612,Alex Ovechkin,2009-10,24.0,5,110,79,79,56,54,110,528.0,1817.0,324,219,201,420,1791.0,82,5.7,65,341,2477,9.4,1.3386613
613,613,Alex Ovechkin,2010-11,25.0,6,109,72,72,50,59,109,368.0,1569.0,396,269,260,529,2159.0,82,5.53,56,304,2486,9.1,1.2426362
614,614,Alex Ovechkin,2011-12,26.0,7,85,79,79,32,53,85,367.0,1688.0,475,301,313,614,2526.0,82,5.46,52,291,2492,9.0,1.0311143
615,615,Alex Ovechkin,2012-13,27.0,8,65,78,78,38,27,65,303.0,1544.0,553,339,340,679,2829.0,82,5.32,47,271,2439,8.9,0.9262463
616,616,Alex Ovechkin,2013-14,28.0,9,56,48,48,32,24,56,220.0,1002.0,601,371,364,735,3049.0,48,5.31,29,160,1399,9.1,1.084302
617,617,Alex Ovechkin,2014-15,29.0,10,79,78,78,51,28,79,386.0,1603.0,679,422,392,814,3435.0,82,5.34,48,269,2463,8.9,0.9034889
618,618,Alex Ovechkin,2015-16,30.0,11,81,81,81,53,28,81,395.0,1646.0,760,475,420,895,3830.0,82,5.32,47,251,2453,8.9,0.92997825
619,619,Alex Ovechkin,2016-17,31.0,12,71,79,79,50,21,71,398.0,1604.0,839,525,441,966,4228.0,82,5.34,48,255,2438,9.0,0.8758319
620,620,Alex Ovechkin,2017-18,32.0,13,69,82,82,33,36,69,313.0,1506.0,921,558,477,1035,4541.0,82,5.45,47,245,2478,9.0,0.8861754
621,621,Alex Ovechkin,2018-19,33.0,14,87,82,82,49,38,87,355.0,1652.0,1003,607,515,1122,4896.0,82,5.86,50,250,2620,9.2,1.0149853
622,622,Alex Ovechkin,2019-20,34.0,15,89,81,81,51,38,89,338.0,1695.0,1084,658,553,1211,5234.0,82,5.96,47,239,2579,9.5,0.9921808
623,623,Alex Ovechkin,2020-21,35.0,16,67,68,68,48,19,67,311.0,1405.0,1152,706,572,1278,5545.0,70,5.96,42,208,2192,9.5,0.8366757
624,624,Alex Pietrangelo,2009-10,20.0,2,1,8,8,0,1,1,7.0,132.0,8,0,1,1,7.0,82,5.7,65,341,2477,9.4,0.2451888
625,625,Alex Pietrangelo,2010-11,21.0,3,2,9,9,1,1,2,7.0,149.0,17,1,2,3,14.0,82,5.53,56,304,2486,9.1,0.24480072
626,626,Alex Pietrangelo,2011-12,22.0,4,43,79,79,11,32,43,161.0,1738.0,96,12,34,46,175.0,82,5.46,52,291,2492,9.0,0.52061677
627,627,Alex Pietrangelo,2012-13,23.0,5,51,81,81,12,39,51,202.0,2003.0,177,24,73,97,377.0,82,5.32,47,271,2439,8.9,0.6182896
628,628,Alex Pietrangelo,2013-14,24.0,6,24,47,47,5,19,24,93.0,1180.0,224,29,92,121,470.0,48,5.31,29,160,1399,9.1,0.49542543
629,629,Alex Pietrangelo,2014-15,25.0,7,51,81,81,8,43,51,164.0,2054.0,305,37,135,172,634.0,82,5.34,48,269,2463,8.9,0.5946363
630,630,Alex Pietrangelo,2015-16,26.0,8,46,81,81,7,39,46,195.0,2058.0,386,44,174,218,829.0,82,5.32,47,251,2453,8.9,0.5797669
631,631,Alex Pietrangelo,2016-17,27.0,9,37,73,73,7,30,37,182.0,1920.0,459,51,204,255,1011.0,82,5.34,48,255,2438,9.0,0.5341989
632,632,Alex Pietrangelo,2017-18,28.0,10,48,80,80,14,34,48,181.0,2023.0,539,65,238,303,1192.0,82,5.45,47,245,2478,9.0,0.6252182
633,633,Alex Pietrangelo,2018-19,29.0,11,54,78,78,15,39,54,216.0,2007.0,617,80,277,357,1408.0,82,5.86,50,250,2620,9.2,0.66057736
634,634,Alex Pietrangelo,2019-20,30.0,12,41,71,71,13,28,41,168.0,1709.0,688,93,305,398,1576.0,82,5.96,47,239,2579,9.5,0.53377837
635,635,Alex Pietrangelo,2020-21,31.0,13,52,70,70,16,36,52,225.0,1693.0,758,109,341,450,1801.0,70,5.96,42,208,2192,9.5,0.67628163
636,636,Alex Plante,2010-11,21.0,2,1,4,4,0,1,1,4.0,54.0,4,0,1,1,4.0,82,5.53,56,304,2486,9.1,0.25361988
637,637,Alex Plante,2011-12,22.0,3,0,3,3,0,0,0,5.0,45.0,7,0,1,1,9.0,82,5.46,52,291,2492,9.0,0.17990834
638,638,Alex Plante,2012-13,23.0,4,1,3,3,0,1,1,0.0,32.0,10,0,2,2,9.0,82,5.32,47,271,2439,8.9,0.1864563
639,639,Alex Selivanov,1995-96,24.0,2,16,43,43,10,6,16,94.0,,43,10,6,16,94.0,48,5.97,37,209,1408,10.2,0.40898043
640,640,Alex Selivanov,1996-97,25.0,3,52,79,79,31,21,52,215.0,,122,41,27,68,309.0,82,6.29,74,413,2481,10.4,0.58652776
641,641,Alex Selivanov,1997-98,26.0,4,33,69,69,15,18,33,187.0,,191,56,45,101,496.0,82,5.83,55,336,2444,9.8,0.5035011
642,642,Alex Selivanov,1998-99,27.0,5,35,70,70,16,19,35,206.0,,261,72,64,136,702.0,82,5.28,57,380,2242,9.6,0.53646827
643,643,Alex Selivanov,1999-00,28.0,6,33,72,72,14,19,33,177.0,1067.0,333,86,83,169,879.0,82,5.27,57,359,2285,9.4,0.5404722
644,644,Alex Selivanov,2000-01,29.0,7,47,67,67,27,20,47,122.0,969.0,400,113,103,216,1001.0,82,5.49,53,331,2294,9.8,0.5883076
645,645,Alex Selivanov,2001-02,30.0,8,19,59,59,8,11,19,104.0,832.0,459,121,114,235,1105.0,82,5.51,63,376,2272,9.9,0.33365577
646,646,Alex Steen,2006-07,22.0,2,45,75,75,18,27,45,176.0,1322.0,75,18,27,45,176.0,82,6.05,85,480,2458,10.1,0.6138184
647,647,Alex Steen,2007-08,23.0,3,35,82,82,15,20,35,192.0,1287.0,157,33,47,80,368.0,82,5.76,70,398,2426,9.7,0.5153329
648,648,Alex Steen,2008-09,24.0,4,42,76,76,15,27,42,169.0,1375.0,233,48,74,122,537.0,82,5.44,62,351,2383,9.4,0.54590106
649,649,Alex Steen,2009-10,25.0,5,28,81,81,8,20,28,148.0,1323.0,314,56,94,150,685.0,82,5.7,65,341,2477,9.4,0.4441998
650,650,Alex Steen,2010-11,26.0,6,47,68,68,24,23,47,189.0,1107.0,382,80,117,197,874.0,82,5.53,56,304,2486,9.1,0.69559336
651,651,Alex Steen,2011-12,27.0,7,51,72,72,20,31,51,218.0,1408.0,454,100,148,248,1092.0,82,5.46,52,291,2492,9.0,0.6164322
652,652,Alex Steen,2012-13,28.0,8,28,43,43,15,13,28,134.0,822.0,497,115,161,276,1226.0,82,5.32,47,271,2439,8.9,0.5954615
653,653,Alex Steen,2013-14,29.0,9,27,40,40,8,19,27,129.0,760.0,537,123,180,303,1355.0,48,5.31,29,160,1399,9.1,0.72602326
654,654,Alex Steen,2014-15,30.0,10,62,68,68,33,29,62,211.0,1379.0,605,156,209,365,1566.0,82,5.34,48,269,2463,8.9,0.78439844
655,655,Alex Steen,2015-16,31.0,11,64,74,74,24,40,64,223.0,1479.0,679,180,249,429,1789.0,82,5.32,47,251,2453,8.9,0.711475
656,656,Alex Steen,2016-17,32.0,12,52,67,67,17,35,52,172.0,1365.0,746,197,284,481,1961.0,82,5.34,48,255,2438,9.0,0.61472267
657,657,Alex Steen,2017-18,33.0,13,51,76,76,16,35,51,117.0,1467.0,822,213,319,532,2078.0,82,5.45,47,245,2478,9.0,0.57786906
658,658,Alex Steen,2018-19,34.0,14,46,76,76,15,31,46,168.0,1421.0,898,228,350,578,2246.0,82,5.86,50,250,2620,9.2,0.48820522
659,659,Alex Steen,2019-20,35.0,15,27,65,65,10,17,27,114.0,1030.0,963,238,367,605,2360.0,82,5.96,47,239,2579,9.5,0.3057843
660,660,Alex Steen,2020-21,36.0,16,17,55,55,7,10,17,71.0,772.0,1018,245,377,622,2431.0,70,5.96,42,208,2192,9.5,0.31060964
661,661,Alex Tanguay,2000-01,21.0,2,51,76,76,17,34,51,74.0,1188.0,76,17,34,51,74.0,82,5.49,53,331,2294,9.8,0.661362
662,662,Alex Tanguay,2001-02,22.0,3,77,82,82,27,50,77,135.0,1464.0,158,44,84,128,209.0,82,5.51,63,376,2272,9.9,0.86285627
663,663,Alex Tanguay,2002-03,23.0,4,48,70,70,13,35,48,90.0,1284.0,228,57,119,176,299.0,82,5.24,53,338,2262,9.5,0.76403236
664,664,Alex Tanguay,2003-04,24.0,5,67,82,82,26,41,67,142.0,1460.0,310,83,160,243,441.0,82,5.31,60,363,2326,9.4,0.86301637
665,665,Alex Tanguay,2004-05,25.0,6,79,69,69,25,54,79,117.0,1266.0,379,108,214,322,558.0,82,5.14,57,348,2300,9.2,1.0558975
666,666,Alex Tanguay,2006-07,27.0,7,78,71,71,29,49,78,125.0,1304.0,450,137,263,400,683.0,82,6.05,85,480,2458,10.1,0.8912875
667,667,Alex Tanguay,2007-08,28.0,8,81,81,81,22,59,81,107.0,1431.0,531,159,322,481,790.0,82,5.76,70,398,2426,9.7,0.8351971
668,668,Alex Tanguay,2008-09,29.0,9,58,78,78,18,40,58,121.0,1463.0,609,177,362,539,911.0,82,5.44,62,351,2383,9.4,0.71645474
669,669,Alex Tanguay,2009-10,30.0,10,41,50,50,16,25,41,76.0,805.0,659,193,387,580,987.0,82,5.7,65,341,2477,9.4,0.67116183
670,670,Alex Tanguay,2010-11,31.0,11,37,80,80,10,27,37,91.0,1263.0,739,203,414,617,1078.0,82,5.53,56,304,2486,9.1,0.45473778
671,671,Alex Tanguay,2011-12,32.0,12,69,79,79,22,47,69,120.0,1561.0,818,225,461,686,1198.0,82,5.46,52,291,2492,9.0,0.79254323
672,672,Alex Tanguay,2012-13,33.0,13,49,64,64,13,36,49,84.0,1219.0,882,238,497,735,1282.0,82,5.32,47,271,2439,8.9,0.6368155
673,673,Alex Tanguay,2013-14,34.0,14,27,40,40,11,16,27,44.0,774.0,922,249,513,762,1326.0,48,5.31,29,160,1399,9.1,0.58278465
674,674,Alex Tanguay,2014-15,35.0,15,11,16,16,4,7,11,24.0,276.0,938,253,520,773,1350.0,82,5.34,48,269,2463,8.9,0.4922534
675,675,Alex Tanguay,2015-16,36.0,16,55,80,80,22,33,55,104.0,1453.0,1018,275,553,828,1454.0,82,5.32,47,251,2453,8.9,0.5844634
676,676,Alex Tanguay,2016-17,37.0,17,35,70,70,8,27,35,71.0,1105.0,1088,283,580,863,1525.0,82,5.34,48,255,2438,9.0,0.34612793
677,677,Alex Tuch,2017-18,21.0,2,0,6,6,0,0,0,8.0,64.0,6,0,0,0,8.0,82,5.45,47,245,2478,9.0,0.24101004
678,678,Alex Tuch,2018-19,22.0,3,37,78,78,15,22,37,171.0,1190.0,84,15,22,37,179.0,82,5.86,50,250,2620,9.2,0.5413139
679,679,Alex Tuch,2019-20,23.0,4,52,74,74,20,32,52,180.0,1238.0,158,35,54,89,359.0,82,5.96,47,239,2579,9.5,0.63851106
680,680,Alex Tuch,2020-21,24.0,5,17,42,42,8,9,17,98.0,614.0,200,43,63,106,457.0,70,5.96,42,208,2192,9.5,0.47087917
681,681,Alex Zhamnov,1993-94,23.0,2,72,68,68,25,47,72,163.0,,68,25,47,72,163.0,84,7.25,87,443,2603,11.7,0.910936
682,682,Alex Zhamnov,1994-95,24.0,3,71,61,61,26,45,71,196.0,,129,51,92,143,359.0,84,6.48,76,407,2545,10.7,1.0436989
683,683,Alex Zhamnov,1995-96,25.0,4,65,48,48,30,35,65,155.0,,177,81,127,208,514.0,48,5.97,37,209,1408,10.2,1.1096847
684,684,Alex Zhamnov,1996-97,26.0,5,59,58,58,22,37,59,199.0,,235,103,164,267,713.0,82,6.29,74,413,2481,10.4,0.8873085
685,685,Alex Zhamnov,1997-98,27.0,6,62,74,74,20,42,62,208.0,,309,123,206,329,921.0,82,5.83,55,336,2444,9.8,0.77964795
686,686,Alex Zhamnov,1998-99,28.0,7,49,70,70,21,28,49,193.0,,379,144,234,378,1114.0,82,5.28,57,380,2242,9.6,0.7205009
687,687,Alex Zhamnov,1999-00,29.0,8,61,76,76,20,41,61,200.0,1634.0,455,164,275,439,1314.0,82,5.27,57,359,2285,9.4,0.75345117
688,688,Alex Zhamnov,2000-01,30.0,9,60,71,71,23,37,60,175.0,1572.0,526,187,312,499,1489.0,82,5.49,53,331,2294,9.8,0.7914226
689,689,Alex Zhamnov,2001-02,31.0,10,49,63,63,13,36,49,117.0,1339.0,589,200,348,548,1606.0,82,5.51,63,376,2272,9.9,0.6542523
690,690,Alex Zhamnov,2002-03,32.0,11,67,77,77,22,45,67,173.0,1718.0,666,222,393,615,1779.0,82,5.24,53,338,2262,9.5,0.81198573
691,691,Alex Zhamnov,2003-04,33.0,12,58,74,74,15,43,58,166.0,1561.0,740,237,436,673,1945.0,82,5.31,60,363,2326,9.4,0.72161424
692,692,Alex Zhamnov,2004-05,34.0,13,36,43,43,11,25,36,96.0,821.0,783,248,461,709,2041.0,82,5.14,57,348,2300,9.2,0.7129641
693,693,Alex Zhamnov,2006-07,36.0,14,10,24,24,1,9,10,37.0,389.0,807,249,470,719,2078.0,82,6.05,85,480,2458,10.1,0.4044863
694,694,Alexander Andrievski,1993-94,25.0,2,0,1,1,0,0,0,0.0,,1,0,0,0,0.0,84,7.25,87,443,2603,11.7,0.15710375
695,695,Alexander Burmistrov,2011-12,20.0,2,20,74,74,6,14,20,92.0,978.0,74,6,14,20,92.0,82,5.46,52,291,2492,9.0,0.3456561
696,696,Alexander Burmistrov,2012-13,21.0,3,28,76,76,13,15,28,123.0,1266.0,150,19,29,48,215.0,82,5.32,47,271,2439,8.9,0.41328233
697,697,Alexander Burmistrov,2013-14,22.0,4,10,44,44,4,6,10,55.0,688.0,194,23,35,58,270.0,48,5.31,29,160,1399,9.1,0.34616297
698,698,Alexander Burmistrov,2016-17,25.0,5,21,81,81,7,14,21,102.0,1310.0,275,30,49,79,372.0,82,5.34,48,255,2438,9.0,0.29222023
699,699,Alexander Burmistrov,2017-18,26.0,6,16,49,49,5,11,16,45.0,654.0,324,35,60,95,417.0,82,5.45,47,245,2478,9.0,0.28110784
700,700,Alexander Burmistrov,2018-19,27.0,7,6,24,24,2,4,6,18.0,287.0,348,37,64,101,435.0,82,5.86,50,250,2620,9.2,0.20868686
701,701,Alexander Edler,2007-08,21.0,2,3,22,22,1,2,3,10.0,252.0,22,1,2,3,10.0,82,5.76,70,398,2426,9.7,0.20003203
702,702,Alexander Edler,2008-09,22.0,3,20,75,75,8,12,20,124.0,1600.0,97,9,14,23,134.0,82,5.44,62,351,2383,9.4,0.34607315
703,703,Alexander Edler,2009-10,23.0,4,37,80,80,10,27,37,145.0,1690.0,177,19,41,60,279.0,82,5.7,65,341,2477,9.4,0.4728585
704,704,Alexander Edler,2010-11,24.0,5,42,76,76,5,37,42,161.0,1721.0,253,24,78,102,440.0,82,5.53,56,304,2486,9.1,0.51524425
705,705,Alexander Edler,2011-12,25.0,6,33,51,51,8,25,33,121.0,1239.0,304,32,103,135,561.0,82,5.46,52,291,2492,9.0,0.5901992
706,706,Alexander Edler,2012-13,26.0,7,49,82,82,11,38,49,228.0,1957.0,386,43,141,184,789.0,82,5.32,47,271,2439,8.9,0.60497344
707,707,Alexander Edler,2013-14,27.0,8,22,45,45,8,14,22,113.0,1073.0,431,51,155,206,902.0,48,5.31,29,160,1399,9.1,0.51018566
708,708,Alexander Edler,2014-15,28.0,9,22,63,63,7,15,22,178.0,1467.0,494,58,170,228,1080.0,82,5.34,48,269,2463,8.9,0.40411556
709,709,Alexander Edler,2015-16,29.0,10,31,74,74,8,23,31,175.0,1774.0,568,66,193,259,1255.0,82,5.32,47,251,2453,8.9,0.43374443
710,710,Alexander Edler,2016-17,30.0,11,20,52,52,6,14,20,111.0,1272.0,620,72,207,279,1366.0,82,5.34,48,255,2438,9.0,0.42835325
711,711,Alexander Edler,2017-18,31.0,12,21,68,68,6,15,21,138.0,1653.0,688,78,222,300,1504.0,82,5.45,47,245,2478,9.0,0.31016928
712,712,Alexander Edler,2018-19,32.0,13,34,70,70,6,28,34,172.0,1699.0,758,84,250,334,1676.0,82,5.86,50,250,2620,9.2,0.42976618
713,713,Alexander Edler,2019-20,33.0,14,34,56,56,10,24,34,128.0,1376.0,814,94,274,368,1804.0,82,5.96,47,239,2579,9.5,0.4944231
714,714,Alexander Edler,2020-21,34.0,15,33,59,59,5,28,33,118.0,1334.0,873,99,302,401,1922.0,70,5.96,42,208,2192,9.5,0.40597123
715,715,Alexander Godynyuk,1991-92,22.0,2,3,18,18,0,3,3,15.0,,18,0,3,3,15.0,80,6.91,71,366,2385,11.6,0.22346097
716,716,Alexander Godynyuk,1992-93,23.0,3,10,37,37,3,7,10,42.0,,55,3,10,13,57.0,80,6.96,77,402,2440,11.4,0.2722166
717,717,Alexander Godynyuk,1993-94,24.0,4,7,27,27,3,4,7,35.0,,82,6,14,20,92.0,84,7.25,87,443,2603,11.7,0.27340505
718,718,Alexander Godynyuk,1994-95,25.0,5,22,69,69,3,19,22,110.0,,151,9,33,42,202.0,84,6.48,76,407,2545,10.7,0.2620476
719,719,Alexander Godynyuk,1995-96,26.0,6,0,14,14,0,0,0,16.0,,165,9,33,42,218.0,48,5.97,37,209,1408,10.2,0.17773429
720,720,Alexander Godynyuk,1996-97,27.0,7,0,3,3,0,0,0,1.0,,168,9,33,42,219.0,82,6.29,74,413,2481,10.4,0.15010715
721,721,Alexander Godynyuk,1997-98,28.0,8,7,55,55,1,6,7,34.0,,223,10,39,49,253.0,82,5.83,55,336,2444,9.8,0.14240918
722,722,Alexander Karpovtsev,1994-95,24.0,2,18,67,67,3,15,18,78.0,,67,3,15,18,78.0,84,6.48,76,407,2545,10.7,0.26874357
723,723,Alexander Karpovtsev,1995-96,25.0,3,12,47,47,4,8,12,82.0,,114,7,23,30,160.0,48,5.97,37,209,1408,10.2,0.30526555
724,724,Alexander Karpovtsev,1996-97,26.0,4,18,40,40,2,16,18,71.0,,154,9,39,48,231.0,82,6.29,74,413,2481,10.4,0.3727492
725,725,Alexander Karpovtsev,1997-98,27.0,5,38,77,77,9,29,38,84.0,,231,18,68,86,315.0,82,5.83,55,336,2444,9.8,0.38345054
726,726,Alexander Karpovtsev,1998-99,28.0,6,10,47,47,3,7,10,46.0,,278,21,75,96,361.0,82,5.28,57,380,2242,9.6,0.22290325
727,727,Alexander Karpovtsev,1999-00,29.0,7,28,58,58,3,25,28,65.0,1219.0,336,24,100,124,426.0,82,5.27,57,359,2285,9.4,0.38597783
728,728,Alexander Karpovtsev,2000-01,30.0,8,17,69,69,3,14,17,51.0,1396.0,405,27,114,141,477.0,82,5.49,53,331,2294,9.8,0.22262982
729,729,Alexander Karpovtsev,2001-02,31.0,9,15,53,53,2,13,15,52.0,1085.0,458,29,127,156,529.0,82,5.51,63,376,2272,9.9,0.21456674
730,730,Alexander Karpovtsev,2002-03,32.0,10,10,65,65,1,9,10,40.0,1343.0,523,30,136,166,569.0,82,5.24,53,338,2262,9.5,0.18669584
731,731,Alexander Karpovtsev,2003-04,33.0,11,14,40,40,4,10,14,36.0,867.0,563,34,146,180,605.0,82,5.31,60,363,2326,9.4,0.22145686
732,732,Alexander Karpovtsev,2004-05,34.0,12,8,27,27,0,8,8,34.0,511.0,590,34,154,188,639.0,82,5.14,57,348,2300,9.2,0.1591602
733,733,Alexander Karpovtsev,2006-07,36.0,13,0,6,6,0,0,0,4.0,66.0,596,34,154,188,643.0,82,6.05,85,480,2458,10.1,0.12757647
734,734,Alexander Kerch,1994-95,27.0,2,0,5,5,0,0,0,4.0,,5,0,0,0,4.0,84,6.48,76,407,2545,10.7,0.15394169
735,735,Alexander Kerfoot,2018-19,24.0,2,43,79,79,19,24,43,81.0,1062.0,79,19,24,43,81.0,82,5.86,50,250,2620,9.2,0.5047648
736,736,Alexander Kerfoot,2019-20,25.0,3,42,78,78,15,27,42,116.0,1161.0,157,34,51,85,197.0,82,5.96,47,239,2579,9.5,0.48017162
737,737,Alexander Kerfoot,2020-21,26.0,4,28,65,65,9,19,28,88.0,960.0,222,43,70,113,285.0,70,5.96,42,208,2192,9.5,0.42230988
738,738,Alexander Kharitonov,2001-02,25.0,2,22,66,66,7,15,22,103.0,770.0,66,7,15,22,103.0,82,5.51,63,376,2272,9.9,0.30642873
739,739,Alexander Kharitonov,2002-03,26.0,3,0,5,5,0,0,0,5.0,20.0,71,7,15,22,108.0,82,5.24,53,338,2262,9.5,0.1896173
740,740,Alexander Khavanov,2001-02,30.0,2,23,74,74,7,16,23,92.0,1547.0,74,7,16,23,92.0,82,5.51,63,376,2272,9.9,0.30254713
741,741,Alexander Khavanov,2002-03,31.0,3,24,81,81,3,21,24,87.0,1395.0,155,10,37,47,179.0,82,5.24,53,338,2262,9.5,0.25629374
742,742,Alexander Khavanov,2003-04,32.0,4,33,81,81,8,25,33,90.0,1778.0,236,18,62,80,269.0,82,5.31,60,363,2326,9.4,0.36849195
743,743,Alexander Khavanov,2004-05,33.0,5,10,48,48,3,7,10,62.0,928.0,284,21,69,90,331.0,82,5.14,57,348,2300,9.2,0.24321845
744,744,Alexander Khavanov,2006-07,35.0,6,12,64,64,6,6,12,44.0,1096.0,348,27,75,102,375.0,82,6.05,85,480,2458,10.1,0.1864472
745,745,Alexander Khokhlachev,2014-15,21.0,2,0,1,1,0,0,0,2.0,15.0,1,0,0,0,2.0,82,5.34,48,269,2463,8.9,0.20231566
746,746,Alexander Khokhlachev,2015-16,22.0,3,0,3,3,0,0,0,1.0,25.0,4,0,0,0,3.0,82,5.32,47,251,2453,8.9,0.1705524
747,747,Alexander Khokhlachev,2016-17,23.0,4,0,5,5,0,0,0,4.0,51.0,9,0,0,0,7.0,82,5.34,48,255,2438,9.0,0.16873544
748,748,Alexander Korolyuk,1998-99,23.0,2,5,19,19,2,3,5,23.0,,19,2,3,5,23.0,82,5.28,57,380,2242,9.6,0.2621961
749,749,Alexander Korolyuk,1999-00,24.0,3,30,55,55,12,18,30,96.0,764.0,74,14,21,35,119.0,82,5.27,57,359,2285,9.4,0.4875796
750,750,Alexander Korolyuk,2000-01,25.0,4,35,57,57,14,21,35,124.0,776.0,131,28,42,70,243.0,82,5.49,53,331,2294,9.8,0.51421267
751,751,Alexander Korolyuk,2001-02,26.0,5,25,70,70,12,13,25,140.0,835.0,201,40,55,95,383.0,82,5.51,63,376,2272,9.9,0.41251093
752,752,Alexander Korolyuk,2002-03,27.0,6,10,32,32,3,7,10,49.0,393.0,233,43,62,105,432.0,82,5.24,53,338,2262,9.5,0.31440687
753,753,Alexander Korolyuk,2004-05,29.0,7,37,63,63,19,18,37,108.0,940.0,296,62,80,142,540.0,82,5.14,57,348,2300,9.2,0.59916395
754,754,Alexander Mogilny,1990-91,21.0,2,43,65,65,15,28,43,130.0,,65,15,28,43,130.0,80,7.37,76,367,2421,12.2,0.730838
755,755,Alexander Mogilny,1991-92,22.0,3,64,62,62,30,34,64,201.0,,127,45,62,107,331.0,80,6.91,71,366,2385,11.6,1.092592
756,756,Alexander Mogilny,1992-93,23.0,4,84,67,67,39,45,84,236.0,,194,84,107,191,567.0,80,6.96,77,402,2440,11.4,1.2326739
757,757,Alexander Mogilny,1993-94,24.0,5,127,77,77,76,51,127,360.0,,271,160,158,318,927.0,84,7.25,87,443,2603,11.7,1.1989615
758,758,Alexander Mogilny,1994-95,25.0,6,79,66,66,32,47,79,258.0,,337,192,205,397,1185.0,84,6.48,76,407,2545,10.7,1.0584211
759,759,Alexander Mogilny,1995-96,26.0,7,47,44,44,19,28,47,148.0,,381,211,233,444,1333.0,48,5.97,37,209,1408,10.2,1.2257578
760,760,Alexander Mogilny,1996-97,27.0,8,107,79,79,55,52,107,292.0,,460,266,285,551,1625.0,82,6.29,74,413,2481,10.4,1.0731057
761,761,Alexander Mogilny,1997-98,28.0,9,73,76,76,31,42,73,174.0,,536,297,327,624,1799.0,82,5.83,55,336,2444,9.8,0.88576084
762,762,Alexander Mogilny,1998-99,29.0,10,45,51,51,18,27,45,118.0,,587,315,354,669,1917.0,82,5.28,57,380,2242,9.6,0.78464925
763,763,Alexander Mogilny,1999-00,30.0,11,45,59,59,14,31,45,110.0,1214.0,646,329,385,714,2027.0,82,5.27,57,359,2285,9.4,0.6387159
764,764,Alexander Mogilny,2000-01,31.0,12,44,59,59,24,20,44,161.0,1125.0,705,353,405,758,2188.0,82,5.49,53,331,2294,9.8,0.7275369
765,765,Alexander Mogilny,2001-02,32.0,13,83,75,75,43,40,83,240.0,1266.0,780,396,445,841,2428.0,82,5.51,63,376,2272,9.9,0.89448524
766,766,Alexander Mogilny,2002-03,33.0,14,57,66,66,24,33,57,188.0,1164.0,846,420,478,898,2616.0,82,5.24,53,338,2262,9.5,0.87777513
767,767,Alexander Mogilny,2003-04,34.0,15,79,73,73,33,46,79,165.0,1463.0,919,453,524,977,2781.0,82,5.31,60,363,2326,9.4,0.83406305
768,768,Alexander Mogilny,2004-05,35.0,16,30,37,37,8,22,30,92.0,684.0,956,461,546,1007,2873.0,82,5.14,57,348,2300,9.2,0.70587957
769,769,Alexander Mogilny,2006-07,37.0,17,25,34,34,12,13,25,93.0,549.0,990,473,559,1032,2966.0,82,6.05,85,480,2458,10.1,0.58835006
770,770,Alexander Nikulin,2008-09,23.0,2,0,2,2,0,0,0,0.0,10.0,2,0,0,0,0.0,82,5.44,62,351,2383,9.4,0.17438605
771,771,Alexander Nikulin,2009-10,24.0,3,0,1,1,0,0,0,1.0,6.0,3,0,0,0,1.0,82,5.7,65,341,2477,9.4,0.1694499
772,772,Alexander Nylander,2017-18,19.0,2,1,4,4,0,1,1,4.0,49.0,4,0,1,1,4.0,82,5.45,47,245,2478,9.0,0.29078734
773,773,Alexander Nylander,2018-19,20.0,3,1,3,3,1,0,1,2.0,39.0,7,1,1,2,6.0,82,5.86,50,250,2620,9.2,0.2660435
774,774,Alexander Nylander,2019-20,21.0,4,4,12,12,2,2,4,16.0,146.0,19,3,3,6,22.0,82,5.96,47,239,2579,9.5,0.3143306
775,775,Alexander Nylander,2020-21,22.0,5,26,65,65,10,16,26,94.0,789.0,84,13,19,32,116.0,70,5.96,42,208,2192,9.5,0.3895667
776,776,Alexander Perezhogin,2006-07,23.0,2,19,67,67,9,10,19,109.0,679.0,67,9,10,19,109.0,82,6.05,85,480,2458,10.1,0.332034
777,777,Alexander Perezhogin,2007-08,24.0,3,15,61,61,6,9,15,103.0,723.0,128,15,19,34,212.0,82,5.76,70,398,2426,9.7,0.27363646
778,778,Alexander Petrovic,2013-14,21.0,2,0,6,6,0,0,0,5.0,113.0,6,0,0,0,5.0,48,5.31,29,160,1399,9.1,0.21354589
779,779,Alexander Petrovic,2014-15,22.0,3,1,7,7,0,1,1,4.0,86.0,13,0,1,1,9.0,82,5.34,48,269,2463,8.9,0.18601239
780,780,Alexander Petrovic,2015-16,23.0,4,3,33,33,0,3,3,29.0,537.0,46,0,4,4,38.0,82,5.32,47,251,2453,8.9,0.17588192
781,781,Alexander Petrovic,2016-17,24.0,5,17,66,66,2,15,17,53.0,1119.0,112,2,19,21,91.0,82,5.34,48,255,2438,9.0,0.20032823
782,782,Alexander Petrovic,2017-18,25.0,6,14,49,49,1,13,14,55.0,889.0,161,3,32,35,146.0,82,5.45,47,245,2478,9.0,0.20968527
783,783,Alexander Petrovic,2018-19,26.0,7,13,67,67,2,11,13,60.0,982.0,228,5,43,48,206.0,82,5.86,50,250,2620,9.2,0.16822681
784,784,Alexander Petrovic,2019-20,27.0,8,2,35,35,0,2,2,47.0,578.0,263,5,45,50,253.0,82,5.96,47,239,2579,9.5,0.17083779
785,785,Alexander Radulov,2007-08,21.0,2,37,64,64,18,19,37,96.0,745.0,64,18,19,37,96.0,82,5.76,70,398,2426,9.7,0.58017343
786,786,Alexander Radulov,2008-09,22.0,3,58,81,81,26,32,58,183.0,1328.0,145,44,51,95,279.0,82,5.44,62,351,2383,9.4,0.74934685
787,787,Alexander Radulov,2012-13,26.0,4,7,9,9,3,4,7,21.0,174.0,154,47,55,102,300.0,82,5.32,47,271,2439,8.9,0.42239106
788,788,Alexander Radulov,2017-18,31.0,5,54,76,76,18,36,54,147.0,1390.0,230,65,91,156,447.0,82,5.45,47,245,2478,9.0,0.6186435
789,789,Alexander Radulov,2018-19,32.0,6,72,82,82,27,45,72,217.0,1650.0,312,92,136,228,664.0,82,5.86,50,250,2620,9.2,0.82510793
790,790,Alexander Radulov,2019-20,33.0,7,72,70,70,29,43,72,209.0,1385.0,382,121,179,300,873.0,82,5.96,47,239,2579,9.5,0.8102592
791,791,Alexander Radulov,2020-21,34.0,8,34,60,60,15,19,34,132.0,1005.0,442,136,198,334,1005.0,70,5.96,42,208,2192,9.5,0.5161203
792,792,Alexander Semak,1992-93,26.0,2,11,25,25,5,6,11,45.0,,25,5,6,11,45.0,80,6.96,77,402,2440,11.4,0.36741668
793,793,Alexander Semak,1993-94,27.0,3,79,82,82,37,42,79,217.0,,107,42,48,90,262.0,84,7.25,87,443,2603,11.7,0.7074263
794,794,Alexander Semak,1994-95,28.0,4,29,54,54,12,17,29,88.0,,161,54,65,119,350.0,84,6.48,76,407,2545,10.7,0.49736297
795,795,Alexander Semak,1995-96,29.0,5,18,41,41,7,11,18,71.0,,202,61,76,137,421.0,48,5.97,37,209,1408,10.2,0.48727262
796,796,Alexander Semak,1996-97,30.0,6,34,69,69,20,14,34,128.0,,271,81,90,171,549.0,82,6.29,74,413,2481,10.4,0.43191028
797,797,Alexander Semak,1997-98,31.0,7,3,18,18,2,1,3,12.0,,289,83,91,174,561.0,82,5.83,55,336,2444,9.8,0.31794477
798,798,Alexander Semin,2004-05,20.0,2,22,52,52,10,12,22,92.0,656.0,52,10,12,22,92.0,82,5.14,57,348,2300,9.2,0.6589957
799,799,Alexander Semin,2007-08,23.0,3,73,77,77,38,35,73,243.0,1417.0,129,48,47,95,335.0,82,5.76,70,398,2426,9.7,0.86591804
800,800,Alexander Semin,2008-09,24.0,4,42,63,63,26,16,42,185.0,1065.0,192,74,63,137,520.0,82,5.44,62,351,2383,9.4,0.7369474
801,801,Alexander Semin,2009-10,25.0,5,79,62,62,34,45,79,223.0,1193.0,254,108,108,216,743.0,82,5.7,65,341,2477,9.4,1.109179
802,802,Alexander Semin,2010-11,26.0,6,84,73,73,40,44,84,278.0,1396.0,327,148,152,300,1021.0,82,5.53,56,304,2486,9.1,1.0457888
803,803,Alexander Semin,2011-12,27.0,7,54,65,65,28,26,54,196.0,1175.0,392,176,178,354,1217.0,82,5.46,52,291,2492,9.0,0.78965116
804,804,Alexander Semin,2012-13,28.0,8,54,77,77,21,33,54,183.0,1293.0,469,197,211,408,1400.0,82,5.32,47,271,2439,8.9,0.71482635
805,805,Alexander Semin,2013-14,29.0,9,44,44,44,13,31,44,150.0,921.0,513,210,242,452,1550.0,48,5.31,29,160,1399,9.1,0.8546841
806,806,Alexander Semin,2014-15,30.0,10,42,65,65,22,20,42,210.0,1294.0,578,232,262,494,1760.0,82,5.34,48,269,2463,8.9,0.6498786
807,807,Alexander Semin,2015-16,31.0,11,19,57,57,6,13,19,93.0,908.0,635,238,275,513,1853.0,82,5.32,47,251,2453,8.9,0.35408944
808,808,Alexander Semin,2016-17,32.0,12,4,15,15,1,3,4,18.0,185.0,650,239,278,517,1871.0,82,5.34,48,255,2438,9.0,0.40404898
809,809,Alexander Suglobov,2004-05,23.0,2,0,1,1,0,0,0,2.0,8.0,1,0,0,0,2.0,82,5.14,57,348,2300,9.2,0.270665
810,810,Alexander Suglobov,2006-07,25.0,3,1,3,3,1,0,1,5.0,36.0,4,1,0,1,7.0,82,6.05,85,480,2458,10.1,0.20172179
811,811,Alexander Suglobov,2007-08,26.0,4,0,14,14,0,0,0,17.0,104.0,18,1,0,1,24.0,82,5.76,70,398,2426,9.7,0.1686522
812,812,Alexander Sulzer,2009-10,25.0,2,0,2,2,0,0,0,0.0,13.0,2,0,0,0,0.0,82,5.7,65,341,2477,9.4,0.1539588
813,813,Alexander Sulzer,2010-11,26.0,3,2,20,20,0,2,2,15.0,268.0,22,0,2,2,15.0,82,5.53,56,304,2486,9.1,0.12404719
814,814,Alexander Sulzer,2011-12,27.0,4,5,40,40,1,4,5,37.0,702.0,62,1,6,7,52.0,82,5.46,52,291,2492,9.0,0.12487543
815,815,Alexander Sulzer,2012-13,28.0,5,9,27,27,3,6,9,33.0,481.0,89,4,12,16,85.0,82,5.32,47,271,2439,8.9,0.20857632
816,816,Alexander Sulzer,2013-14,29.0,6,4,17,17,3,1,4,15.0,281.0,106,7,13,20,100.0,48,5.31,29,160,1399,9.1,0.24421787
817,817,Alexander Sulzer,2014-15,30.0,7,2,25,25,0,2,2,21.0,453.0,131,7,15,22,121.0,82,5.34,48,269,2463,8.9,0.1057224
818,818,Alexander Svitov,2003-04,21.0,2,8,63,63,4,4,8,69.0,557.0,63,4,4,8,69.0,82,5.31,60,363,2326,9.4,0.25390446
819,819,Alexander Svitov,2004-05,22.0,3,11,40,40,2,9,11,52.0,469.0,103,6,13,19,121.0,82,5.14,57,348,2300,9.2,0.33254528
820,820,Alexander Svitov,2007-08,25.0,4,18,76,76,7,11,18,83.0,1047.0,179,13,24,37,204.0,82,5.76,70,398,2426,9.7,0.24847984
821,821,Alexander True,2020-21,23.0,2,4,12,12,0,4,4,12.0,120.0,12,0,4,4,12.0,70,5.96,42,208,2192,9.5,0.24509463
822,822,Alexander Urbom,2011-12,21.0,2,1,8,8,1,0,1,5.0,101.0,8,1,0,1,5.0,82,5.46,52,291,2492,9.0,0.22345677
823,823,Alexander Urbom,2012-13,22.0,3,1,5,5,1,0,1,3.0,68.0,13,2,0,2,8.0,82,5.32,47,271,2439,8.9,0.22385061
824,824,Alexander Urbom,2013-14,23.0,4,0,1,1,0,0,0,0.0,14.0,14,2,0,2,8.0,48,5.31,29,160,1399,9.1,0.18742007
825,825,Alexander Urbom,2014-15,24.0,5,2,20,20,1,1,2,16.0,292.0,34,3,1,4,24.0,82,5.34,48,269,2463,8.9,0.15533474
826,826,Alexander Vasilevski,1996-97,22.0,2,0,1,1,0,0,0,0.0,,1,0,0,0,0.0,82,6.29,74,413,2481,10.4,0.1544433
827,827,Alexander Vasilevski,1997-98,23.0,3,0,3,3,0,0,0,3.0,,4,0,0,0,3.0,82,5.83,55,336,2444,9.8,0.16939813
828,828,Alexander Vasyunov,2011-12,23.0,2,5,18,18,1,4,5,18.0,207.0,18,1,4,5,18.0,82,5.46,52,291,2492,9.0,0.22724414
829,829,Alexander Volkov,2020-21,23.0,2,1,9,9,0,1,1,7.0,92.0,9,0,1,1,7.0,70,5.96,42,208,2192,9.5,0.21753478
830,830,Alexander Wennberg,2015-16,21.0,2,20,68,68,4,16,20,85.0,1062.0,68,4,16,20,85.0,82,5.32,47,251,2453,8.9,0.33258575
831,831,Alexander Wennberg,2016-17,22.0,3,40,69,69,8,32,40,97.0,1094.0,137,12,48,60,182.0,82,5.34,48,255,2438,9.0,0.50481975
832,832,Alexander Wennberg,2017-18,23.0,4,59,80,80,13,46,59,109.0,1470.0,217,25,94,119,291.0,82,5.45,47,245,2478,9.0,0.6763213
833,833,Alexander Wennberg,2018-19,24.0,5,35,66,66,8,27,35,74.0,1197.0,283,33,121,154,365.0,82,5.86,50,250,2620,9.2,0.47461
834,834,Alexander Wennberg,2019-20,25.0,6,25,75,75,2,23,25,64.0,1131.0,358,35,144,179,429.0,82,5.96,47,239,2579,9.5,0.36961743
835,835,Alexander Wennberg,2020-21,26.0,7,22,57,57,5,17,22,72.0,951.0,415,40,161,201,501.0,70,5.96,42,208,2192,9.5,0.40469044
836,836,Alexander Yelesin,2020-21,24.0,2,0,4,4,0,0,0,2.0,50.0,4,0,0,0,2.0,70,5.96,42,208,2192,9.5,0.19378299
837,837,Alexandre Boikov,2000-01,25.0,2,0,2,2,0,0,0,1.0,17.0,2,0,0,0,1.0,82,5.49,53,331,2294,9.8,0.16222295
838,838,Alexandre Boikov,2001-02,26.0,3,0,8,8,0,0,0,3.0,50.0,10,0,0,0,4.0,82,5.51,63,376,2272,9.9,0.1501387
839,839,Alexandre Bolduc,2009-10,24.0,2,1,7,7,0,1,1,7.0,51.0,7,0,1,1,7.0,82,5.7,65,341,2477,9.4,0.1839855
840,840,Alexandre Bolduc,2010-11,25.0,3,0,15,15,0,0,0,14.0,150.0,22,0,1,1,21.0,82,5.53,56,304,2486,9.1,0.15927047
841,841,Alexandre Bolduc,2011-12,26.0,4,4,24,24,2,2,4,21.0,178.0,46,2,3,5,42.0,82,5.46,52,291,2492,9.0,0.17653266
842,842,Alexandre Bolduc,2012-13,27.0,5,0,2,2,0,0,0,1.0,14.0,48,2,3,5,43.0,82,5.32,47,271,2439,8.9,0.11751881
843,843,Alexandre Bolduc,2013-14,28.0,6,0,14,14,0,0,0,17.0,107.0,62,2,3,5,60.0,48,5.31,29,160,1399,9.1,0.13327613
844,844,Alexandre Bolduc,2015-16,30.0,7,0,3,3,0,0,0,3.0,32.0,65,2,3,5,63.0,82,5.32,47,251,2453,8.9,0.10803318
845,845,Alexandre Burrows,2006-07,25.0,2,12,43,43,7,5,12,49.0,447.0,43,7,5,12,49.0,82,6.05,85,480,2458,10.1,0.2375086
846,846,Alexandre Burrows,2007-08,26.0,3,9,81,81,3,6,9,70.0,927.0,124,10,11,21,119.0,82,5.76,70,398,2426,9.7,0.15742698
847,847,Alexandre Burrows,2008-09,27.0,4,31,82,82,12,19,31,126.0,1238.0,206,22,30,52,245.0,82,5.44,62,351,2383,9.4,0.3574981
848,848,Alexandre Burrows,2009-10,28.0,5,51,82,82,28,23,51,175.0,1382.0,288,50,53,103,420.0,82,5.7,65,341,2477,9.4,0.56894827
849,849,Alexandre Burrows,2010-11,29.0,6,67,82,82,35,32,67,209.0,1465.0,370,85,85,170,629.0,82,5.53,56,304,2486,9.1,0.71127486
850,850,Alexandre Burrows,2011-12,30.0,7,48,72,72,26,22,48,152.0,1226.0,442,111,107,218,781.0,82,5.46,52,291,2492,9.0,0.565842
851,851,Alexandre Burrows,2012-13,31.0,8,52,80,80,28,24,52,198.0,1478.0,522,139,131,270,979.0,82,5.32,47,271,2439,8.9,0.57252115
852,852,Alexandre Burrows,2013-14,32.0,9,24,47,47,13,11,24,140.0,889.0,569,152,142,294,1119.0,48,5.31,29,160,1399,9.1,0.49168524
853,853,Alexandre Burrows,2014-15,33.0,10,15,49,49,5,10,15,104.0,873.0,618,157,152,309,1223.0,82,5.34,48,269,2463,8.9,0.31339705
854,854,Alexandre Burrows,2015-16,34.0,11,33,70,70,18,15,33,145.0,1083.0,688,175,167,342,1368.0,82,5.32,47,251,2453,8.9,0.37524387
855,855,Alexandre Burrows,2016-17,35.0,12,22,79,79,9,13,22,135.0,1198.0,767,184,180,364,1503.0,82,5.34,48,255,2438,9.0,0.2735762
856,856,Alexandre Burrows,2017-18,36.0,13,31,75,75,15,16,31,143.0,1099.0,842,199,196,395,1646.0,82,5.45,47,245,2478,9.0,0.34639663
857,857,Alexandre Burrows,2018-19,37.0,14,14,71,71,6,8,14,90.0,830.0,913,205,204,409,1736.0,82,5.86,50,250,2620,9.2,0.19263089
858,858,Alexandre Carrier,2017-18,21.0,2,0,2,2,0,0,0,1.0,21.0,2,0,0,0,1.0,82,5.45,47,245,2478,9.0,0.23246074
859,859,Alexandre Carrier,2020-21,24.0,3,0,3,3,0,0,0,4.0,32.0,5,0,0,0,5.0,70,5.96,42,208,2192,9.5,0.18707949
860,860,Alexandre Daigle,1994-95,19.0,2,51,84,84,20,31,51,168.0,,84,20,31,51,168.0,84,6.48,76,407,2545,10.7,0.6362101
861,861,Alexandre Daigle,1995-96,20.0,3,37,47,47,16,21,37,105.0,,131,36,52,88,273.0,48,5.97,37,209,1408,10.2,0.7158462
862,862,Alexandre Daigle,1996-97,21.0,4,17,50,50,5,12,17,77.0,,181,41,64,105,350.0,82,6.29,74,413,2481,10.4,0.48057935
863,863,Alexandre Daigle,1997-98,22.0,5,51,82,82,26,25,51,203.0,,263,67,89,156,553.0,82,5.83,55,336,2444,9.8,0.67347366
864,864,Alexandre Daigle,1998-99,23.0,6,42,75,75,16,26,42,146.0,,338,83,115,198,699.0,82,5.28,57,380,2242,9.6,0.597069
865,865,Alexandre Daigle,1999-00,24.0,7,17,63,63,9,8,17,82.0,695.0,401,92,123,215,781.0,82,5.27,57,359,2285,9.4,0.37998986
866,866,Alexandre Daigle,2000-01,25.0,8,26,58,58,8,18,26,52.0,637.0,459,100,141,241,833.0,82,5.49,53,331,2294,9.8,0.41196278
867,867,Alexandre Daigle,2003-04,28.0,9,7,33,33,4,3,7,48.0,361.0,492,104,144,248,881.0,82,5.31,60,363,2326,9.4,0.37155965
868,868,Alexandre Daigle,2004-05,29.0,10,51,78,78,20,31,51,145.0,1183.0,570,124,175,299,1026.0,82,5.14,57,348,2300,9.2,0.61823434
869,869,Alexandre Daigle,2006-07,31.0,11,28,46,46,5,23,28,59.0,598.0,616,129,198,327,1085.0,82,6.05,85,480,2458,10.1,0.4527207
870,870,Alexandre Fortin,2019-20,22.0,2,6,24,24,3,3,6,29.0,254.0,24,3,3,6,29.0,82,5.96,47,239,2579,9.5,0.27548438
871,871,Alexandre Giroux,2006-07,25.0,2,0,1,1,0,0,0,0.0,3.0,1,0,0,0,0.0,82,6.05,85,480,2458,10.1,0.14312965
872,872,Alexandre Giroux,2007-08,26.0,3,4,9,9,2,2,4,11.0,92.0,10,2,2,4,11.0,82,5.76,70,398,2426,9.7,0.21926388
873,873,Alexandre Giroux,2009-10,28.0,4,2,12,12,1,1,2,20.0,127.0,22,3,3,6,31.0,82,5.7,65,341,2477,9.4,0.20481831
874,874,Alexandre Giroux,2010-11,29.0,5,3,9,9,1,2,3,17.0,93.0,31,4,5,9,48.0,82,5.53,56,304,2486,9.1,0.18153736
875,875,Alexandre Giroux,2011-12,30.0,6,2,8,8,1,1,2,13.0,118.0,39,5,6,11,61.0,82,5.46,52,291,2492,9.0,0.17461845
876,876,Alexandre Giroux,2012-13,31.0,7,1,9,9,1,0,1,18.0,110.0,48,6,6,12,79.0,82,5.32,47,271,2439,8.9,0.15871015
877,877,Alexandre Grenier,2016-17,25.0,2,0,6,6,0,0,0,9.0,69.0,6,0,0,0,9.0,82,5.34,48,255,2438,9.0,0.17314458
878,878,Alexandre Grenier,2017-18,26.0,3,0,3,3,0,0,0,1.0,19.0,9,0,0,0,10.0,82,5.45,47,245,2478,9.0,0.16418326
879,879,Alexandre Picard,2006-07,21.0,2,0,17,17,0,0,0,10.0,156.0,17,0,0,0,10.0,82,6.05,85,480,2458,10.1,0.18852463
880,880,Alexandre Picard,2007-08,22.0,3,1,23,23,0,1,1,20.0,180.0,40,0,1,1,30.0,82,5.76,70,398,2426,9.7,0.16122279
881,881,Alexandre Picard,2008-09,23.0,4,0,3,3,0,0,0,1.0,20.0,43,0,1,1,31.0,82,5.44,62,351,2383,9.4,0.1464487
882,882,Alexandre Picard,2009-10,24.0,5,1,15,15,0,1,1,10.0,103.0,58,0,2,2,41.0,82,5.7,65,341,2477,9.4,0.14306605
883,883,Alexandre Picard,2010-11,25.0,6,0,9,9,0,0,0,12.0,65.0,67,0,2,2,53.0,82,5.53,56,304,2486,9.1,0.1565988
884,884,Alexandre Picard0,2006-07,21.0,2,0,6,6,0,0,0,9.0,57.0,6,0,0,0,9.0,82,6.05,85,480,2458,10.1,0.21959653
885,885,Alexandre Picard0,2007-08,22.0,3,22,62,62,3,19,22,56.0,1146.0,68,3,19,22,65.0,82,5.76,70,398,2426,9.7,0.29473394
886,886,Alexandre Picard0,2008-09,23.0,4,6,24,24,3,3,6,24.0,490.0,92,6,22,28,89.0,82,5.44,62,351,2383,9.4,0.29185098
887,887,Alexandre Picard0,2009-10,24.0,5,14,47,47,6,8,14,72.0,887.0,139,12,30,42,161.0,82,5.7,65,341,2477,9.4,0.3015644
888,888,Alexandre Picard0,2010-11,25.0,6,15,54,54,4,11,15,71.0,993.0,193,16,41,57,232.0,82,5.53,56,304,2486,9.1,0.24408743
889,889,Alexandre Picard0,2011-12,26.0,7,8,43,43,3,5,8,49.0,706.0,236,19,46,65,281.0,82,5.46,52,291,2492,9.0,0.19057637
890,890,Alexandre Picard0,2012-13,27.0,8,4,17,17,0,4,4,10.0,223.0,253,19,50,69,291.0,82,5.32,47,271,2439,8.9,0.21497706
891,891,Alexandre Texier,2019-20,20.0,2,1,2,2,1,0,1,6.0,26.0,2,1,0,1,6.0,82,5.96,47,239,2579,9.5,0.29010978
892,892,Alexandre Texier,2020-21,21.0,3,13,36,36,6,7,13,49.0,459.0,38,7,7,14,55.0,70,5.96,42,208,2192,9.5,0.37729913
893,893,Alexandre Volchkov,2000-01,23.0,2,0,3,3,0,0,0,1.0,30.0,3,0,0,0,1.0,82,5.49,53,331,2294,9.8,0.162162
894,894,Alexei Emelin,2012-13,26.0,2,7,67,67,3,4,7,62.0,1159.0,67,3,4,7,62.0,82,5.32,47,271,2439,8.9,0.1572538
895,895,Alexei Emelin,2013-14,27.0,3,12,38,38,3,9,12,33.0,747.0,105,6,13,19,95.0,48,5.31,29,160,1399,9.1,0.24743614
896,896,Alexei Emelin,2014-15,28.0,4,17,59,59,3,14,17,58.0,1136.0,164,9,27,36,153.0,82,5.34,48,269,2463,8.9,0.21720484
897,897,Alexei Emelin,2015-16,29.0,5,14,68,68,3,11,14,43.0,1348.0,232,12,38,50,196.0,82,5.32,47,251,2453,8.9,0.16595006
898,898,Alexei Emelin,2016-17,30.0,6,12,72,72,0,12,12,71.0,1476.0,304,12,50,62,267.0,82,5.34,48,255,2438,9.0,0.1362611
899,899,Alexei Emelin,2017-18,31.0,7,10,76,76,2,8,10,82.0,1620.0,380,14,58,72,349.0,82,5.45,47,245,2478,9.0,0.1727852
900,900,Alexei Emelin,2018-19,32.0,8,9,76,76,1,8,9,59.0,1283.0,456,15,66,81,408.0,82,5.86,50,250,2620,9.2,0.1413913
901,901,Alexei Gusarov,1991-92,27.0,2,12,36,36,3,9,12,36.0,,36,3,9,12,36.0,80,6.91,71,366,2385,11.6,0.25709677
902,902,Alexei Gusarov,1992-93,28.0,3,23,68,68,5,18,23,66.0,,104,8,27,35,102.0,80,6.96,77,402,2440,11.4,0.29079884
903,903,Alexei Gusarov,1993-94,29.0,4,30,79,79,8,22,30,60.0,,183,16,49,65,162.0,84,7.25,87,443,2603,11.7,0.3266774
904,904,Alexei Gusarov,1994-95,30.0,5,25,76,76,5,20,25,84.0,,259,21,69,90,246.0,84,6.48,76,407,2545,10.7,0.2761714
905,905,Alexei Gusarov,1995-96,31.0,6,3,14,14,1,2,3,7.0,,273,22,71,93,253.0,48,5.97,37,209,1408,10.2,0.23959005
906,906,Alexei Gusarov,1996-97,32.0,7,20,65,65,5,15,20,42.0,,338,27,86,113,295.0,82,6.29,74,413,2481,10.4,0.2503809
907,907,Alexei Gusarov,1997-98,33.0,8,14,58,58,2,12,14,33.0,,396,29,98,127,328.0,82,5.83,55,336,2444,9.8,0.1971589
908,908,Alexei Gusarov,1998-99,34.0,9,14,72,72,4,10,14,47.0,,468,33,108,141,375.0,82,5.28,57,380,2242,9.6,0.17304632
909,909,Alexei Gusarov,1999-00,35.0,10,13,54,54,3,10,13,28.0,1077.0,522,36,118,154,403.0,82,5.27,57,359,2285,9.4,0.16704929
910,910,Alexei Gusarov,2000-01,36.0,11,4,34,34,2,2,4,16.0,662.0,556,38,120,158,419.0,82,5.49,53,331,2294,9.8,0.15640569
911,911,Alexei Gusarov,2001-02,37.0,12,9,51,51,1,8,9,35.0,982.0,607,39,128,167,454.0,82,5.51,63,376,2272,9.9,0.12523898
912,912,Alexei Kaigorodov,2007-08,24.0,2,1,6,6,0,1,1,3.0,29.0,6,0,1,1,3.0,82,5.76,70,398,2426,9.7,0.18681282
913,913,Alexei Kasatonov,1990-91,31.0,2,21,39,39,6,15,21,60.0,,39,6,15,21,60.0,80,7.37,76,367,2421,12.2,0.41239765
914,914,Alexei Kasatonov,1991-92,32.0,3,41,78,78,10,31,41,122.0,,117,16,46,62,182.0,80,6.91,71,366,2385,11.6,0.4439517
915,915,Alexei Kasatonov,1992-93,33.0,4,40,76,76,12,28,40,107.0,,193,28,74,102,289.0,80,6.96,77,402,2440,11.4,0.43838146
916,916,Alexei Kasatonov,1993-94,34.0,5,17,64,64,3,14,17,63.0,,257,31,88,119,352.0,84,7.25,87,443,2603,11.7,0.26832306
917,917,Alexei Kasatonov,1994-95,35.0,6,24,63,63,4,20,24,87.0,,320,35,108,143,439.0,84,6.48,76,407,2545,10.7,0.31891894
918,918,Alexei Kasatonov,1995-96,36.0,7,16,44,44,2,14,16,50.0,,364,37,122,159,489.0,48,5.97,37,209,1408,10.2,0.3264966
919,919,Alexei Kasatonov,1996-97,37.0,8,1,19,19,1,0,1,15.0,,383,38,122,160,504.0,82,6.29,74,413,2481,10.4,0.16193822
920,920,Alexei Kudashov,1994-95,23.0,2,1,25,25,1,0,1,24.0,,25,1,0,1,24.0,84,6.48,76,407,2545,10.7,0.2200711
921,921,Alexei Mikhnov,2007-08,25.0,2,0,2,2,0,0,0,0.0,14.0,2,0,0,0,0.0,82,5.76,70,398,2426,9.7,0.13847092
922,922,Alexei Ponikarovsky,2001-02,21.0,2,4,22,22,1,3,4,21.0,188.0,22,1,3,4,21.0,82,5.51,63,376,2272,9.9,0.22830144
923,923,Alexei Ponikarovsky,2002-03,22.0,3,2,8,8,2,0,2,8.0,64.0,30,3,3,6,29.0,82,5.24,53,338,2262,9.5,0.2467708
924,924,Alexei Ponikarovsky,2003-04,23.0,4,3,13,13,0,3,3,13.0,139.0,43,3,6,9,42.0,82,5.31,60,363,2326,9.4,0.21436083
925,925,Alexei Ponikarovsky,2004-05,24.0,5,28,73,73,9,19,28,110.0,847.0,116,12,25,37,152.0,82,5.14,57,348,2300,9.2,0.40622967
926,926,Alexei Ponikarovsky,2006-07,26.0,6,38,81,81,21,17,38,157.0,1142.0,197,33,42,75,309.0,82,6.05,85,480,2458,10.1,0.48150134
927,927,Alexei Ponikarovsky,2007-08,27.0,7,45,71,71,21,24,45,198.0,1214.0,268,54,66,120,507.0,82,5.76,70,398,2426,9.7,0.5576475
928,928,Alexei Ponikarovsky,2008-09,28.0,8,35,66,66,18,17,35,150.0,1054.0,334,72,83,155,657.0,82,5.44,62,351,2383,9.4,0.46918118
929,929,Alexei Ponikarovsky,2009-10,29.0,9,61,82,82,23,38,61,185.0,1294.0,416,95,121,216,842.0,82,5.7,65,341,2477,9.4,0.64361584
930,930,Alexei Ponikarovsky,2010-11,30.0,10,50,77,77,21,29,50,184.0,1268.0,493,116,150,266,1026.0,82,5.53,56,304,2486,9.1,0.54748243
931,931,Alexei Ponikarovsky,2011-12,31.0,11,15,61,61,5,10,15,94.0,769.0,554,121,160,281,1120.0,82,5.46,52,291,2492,9.0,0.2883558
932,932,Alexei Ponikarovsky,2012-13,32.0,12,33,82,82,14,19,33,156.0,1209.0,636,135,179,314,1276.0,82,5.32,47,271,2439,8.9,0.3697974
933,933,Alexei Ponikarovsky,2013-14,33.0,13,9,42,42,4,5,9,51.0,553.0,678,139,184,323,1327.0,48,5.31,29,160,1399,9.1,0.22128984
934,934,Alexei Semenov,2003-04,22.0,2,7,46,46,1,6,7,33.0,906.0,46,1,6,7,33.0,82,5.31,60,363,2326,9.4,0.1809426
935,935,Alexei Semenov,2004-05,23.0,3,5,46,46,2,3,5,36.0,794.0,92,3,9,12,69.0,82,5.14,57,348,2300,9.2,0.22006047
936,936,Alexei Semenov,2006-07,25.0,4,4,27,27,2,2,4,16.0,320.0,119,5,11,16,85.0,82,6.05,85,480,2458,10.1,0.17970845
937,937,Alexei Semenov,2007-08,26.0,5,5,23,23,0,5,5,23.0,285.0,142,5,16,21,108.0,82,5.76,70,398,2426,9.7,0.16846105
938,938,Alexei Semenov,2008-09,27.0,6,4,22,22,1,3,4,23.0,335.0,164,6,19,25,131.0,82,5.44,62,351,2383,9.4,0.16762781
939,939,Alexei Semenov,2009-10,28.0,7,8,47,47,1,7,8,28.0,613.0,211,7,26,33,159.0,82,5.7,65,341,2477,9.4,0.12205437
940,940,Alexei Smirnov,2003-04,22.0,2,5,44,44,3,2,5,46.0,389.0,44,3,2,5,46.0,82,5.31,60,363,2326,9.4,0.21153775
941,941,Alexei Smirnov,2004-05,23.0,3,1,8,8,0,1,1,8.0,58.0,52,3,3,6,54.0,82,5.14,57,348,2300,9.2,0.21454877
942,942,Alexei Tezikov,1999-00,21.0,2,0,5,5,0,0,0,4.0,91.0,5,0,0,0,4.0,82,5.27,57,359,2285,9.4,0.19303653
943,943,Alexei Tezikov,2000-01,22.0,3,2,23,23,1,1,2,18.0,242.0,28,1,1,2,22.0,82,5.49,53,331,2294,9.8,0.17139035
944,944,Alexei Tezikov,2002-03,24.0,4,0,2,2,0,0,0,0.0,24.0,30,1,1,2,22.0,82,5.24,53,338,2262,9.5,0.14455035
945,945,Alexei Vasiliev,2000-01,23.0,2,0,1,1,0,0,0,0.0,16.0,1,0,0,0,0.0,82,5.49,53,331,2294,9.8,0.16184989
946,946,Alexei Yashin,1994-95,21.0,2,79,83,83,30,49,79,232.0,,83,30,49,79,232.0,84,6.48,76,407,2545,10.7,0.89657533
947,947,Alexei Yashin,1995-96,22.0,3,44,47,47,21,23,44,154.0,,130,51,72,123,386.0,48,5.97,37,209,1408,10.2,1.0072951
948,948,Alexei Yashin,1996-97,23.0,4,39,46,46,15,24,39,143.0,,176,66,96,162,529.0,82,6.29,74,413,2481,10.4,0.82257503
949,949,Alexei Yashin,1997-98,24.0,5,75,82,82,35,40,75,291.0,,258,101,136,237,820.0,82,5.83,55,336,2444,9.8,0.91587317
950,950,Alexei Yashin,1998-99,25.0,6,72,82,82,33,39,72,291.0,,340,134,175,309,1111.0,82,5.28,57,380,2242,9.6,0.9049637
951,951,Alexei Yashin,1999-00,26.0,7,94,82,82,44,50,94,337.0,1811.0,422,178,225,403,1448.0,82,5.27,57,359,2285,9.4,1.0488099
952,952,Alexei Yashin,2001-02,28.0,8,88,82,82,40,48,88,263.0,1672.0,504,218,273,491,1711.0,82,5.51,63,376,2272,9.9,0.9647425
953,953,Alexei Yashin,2002-03,29.0,9,75,78,78,32,43,75,239.0,1609.0,582,250,316,566,1950.0,82,5.24,53,338,2262,9.5,0.8753524
954,954,Alexei Yashin,2003-04,30.0,10,65,81,81,26,39,65,274.0,1501.0,663,276,355,631,2224.0,82,5.31,60,363,2326,9.4,0.8114834
955,955,Alexei Yashin,2004-05,31.0,11,34,47,47,15,19,34,148.0,814.0,710,291,374,665,2372.0,82,5.14,57,348,2300,9.2,0.7927474
956,956,Alexei Yashin,2006-07,33.0,12,66,82,82,28,38,66,253.0,1517.0,792,319,412,731,2625.0,82,6.05,85,480,2458,10.1,0.81110173
957,957,Alexei Yashin,2007-08,34.0,13,50,58,58,18,32,50,203.0,990.0,850,337,444,781,2828.0,82,5.76,70,398,2426,9.7,0.80035335
958,958,Alexei Yegorov,1996-97,21.0,2,5,9,9,3,2,5,10.0,,9,3,2,5,10.0,82,6.29,74,413,2481,10.4,0.34033662
959,959,Alexei Yegorov,1997-98,22.0,3,1,2,2,0,1,1,0.0,,11,3,3,6,10.0,82,5.83,55,336,2444,9.8,0.21680322
960,960,Alexei Zhitnik,1993-94,21.0,2,48,78,78,12,36,48,136.0,,78,12,36,48,136.0,84,7.25,87,443,2603,11.7,0.6223023
961,961,Alexei Zhitnik,1994-95,22.0,3,52,81,81,12,40,52,227.0,,159,24,76,100,363.0,84,6.48,76,407,2545,10.7,0.56818706
962,962,Alexei Zhitnik,1995-96,23.0,4,14,32,32,4,10,14,66.0,,191,28,86,114,429.0,48,5.97,37,209,1408,10.2,0.46404833
963,963,Alexei Zhitnik,1996-97,24.0,5,36,80,80,6,30,36,193.0,,271,34,116,150,622.0,82,6.29,74,413,2481,10.4,0.5042619
964,964,Alexei Zhitnik,1997-98,25.0,6,35,80,80,7,28,35,170.0,,351,41,144,185,792.0,82,5.83,55,336,2444,9.8,0.49330264
965,965,Alexei Zhitnik,1998-99,26.0,7,45,78,78,15,30,45,191.0,,429,56,174,230,983.0,82,5.28,57,380,2242,9.6,0.5692205
966,966,Alexei Zhitnik,1999-00,27.0,8,33,81,81,7,26,33,185.0,2078.0,510,63,200,263,1168.0,82,5.27,57,359,2285,9.4,0.48808607
967,967,Alexei Zhitnik,2000-01,28.0,9,13,74,74,2,11,13,139.0,1835.0,584,65,211,276,1307.0,82,5.49,53,331,2294,9.8,0.31054956
968,968,Alexei Zhitnik,2001-02,29.0,10,37,78,78,8,29,37,149.0,1892.0,662,73,240,313,1456.0,82,5.51,63,376,2272,9.9,0.44920662
969,969,Alexei Zhitnik,2002-03,30.0,11,34,82,82,1,33,34,150.0,2100.0,744,74,273,347,1606.0,82,5.24,53,338,2262,9.5,0.42809248
970,970,Alexei Zhitnik,2003-04,31.0,12,21,70,70,3,18,21,138.0,1858.0,814,77,291,368,1744.0,82,5.31,60,363,2326,9.4,0.30644935
971,971,Alexei Zhitnik,2004-05,32.0,13,28,68,68,4,24,28,134.0,1701.0,882,81,315,396,1878.0,82,5.14,57,348,2300,9.2,0.49126416
972,972,Alexei Zhitnik,2006-07,34.0,14,29,59,59,5,24,29,99.0,1446.0,941,86,339,425,1977.0,82,6.05,85,480,2458,10.1,0.35325995
973,973,Alexei Zhitnik,2007-08,35.0,15,38,79,79,7,31,38,132.0,1904.0,1020,93,370,463,2109.0,82,5.76,70,398,2426,9.7,0.3657724
974,974,Alexei Zhitnik,2008-09,36.0,16,8,65,65,3,5,8,79.0,1236.0,1085,96,375,471,2188.0,82,5.44,62,351,2383,9.4,0.16982493
975,975,Alexey Marchenko,2014-15,23.0,2,0,1,1,0,0,0,0.0,13.0,1,0,0,0,0.0,82,5.34,48,269,2463,8.9,0.14718214
976,976,Alexey Marchenko,2015-16,24.0,3,2,13,13,1,1,2,7.0,201.0,14,1,1,2,7.0,82,5.32,47,251,2453,8.9,0.18126237
977,977,Alexey Marchenko,2016-17,25.0,4,11,66,66,2,9,11,40.0,1111.0,80,3,10,13,47.0,82,5.34,48,255,2438,9.0,0.15312284
978,978,Alexey Marchenko,2017-18,26.0,5,8,41,41,1,7,8,36.0,695.0,121,4,17,21,83.0,82,5.45,47,245,2478,9.0,0.15122002
979,979,Alfie Turcotte,1984-85,19.0,2,14,30,30,7,7,14,33.0,,30,7,7,14,33.0,80,7.89,74,336,2448,12.9,0.40632966
980,980,Alfie Turcotte,1985-86,20.0,3,24,53,53,8,16,24,59.0,,83,15,23,38,92.0,80,7.77,71,321,2447,12.7,0.4639513
981,981,Alfie Turcotte,1986-87,21.0,4,0,2,2,0,0,0,0.0,,85,15,23,38,92.0,80,7.94,82,370,2484,12.8,0.3362421
982,982,Alfie Turcotte,1988-89,23.0,5,0,3,3,0,0,0,3.0,,88,15,23,38,95.0,80,7.43,89,437,2435,12.2,0.2820803
983,983,Alfie Turcotte,1989-90,24.0,6,4,14,14,1,3,4,10.0,,102,16,26,42,105.0,80,7.48,85,403,2430,12.3,0.3047405
984,984,Alfie Turcotte,1990-91,25.0,7,2,4,4,0,2,2,4.0,,106,16,28,44,109.0,80,7.37,76,367,2421,12.2,0.26964974
985,985,Alfie Turcotte,1991-92,26.0,8,2,6,6,1,1,2,8.0,,112,17,29,46,117.0,80,6.91,71,366,2385,11.6,0.25583184
986,986,Allan Egeland,1996-97,24.0,2,0,5,5,0,0,0,1.0,,5,0,0,0,1.0,82,6.29,74,413,2481,10.4,0.15421098
987,987,Allan Egeland,1997-98,25.0,3,0,4,4,0,0,0,1.0,,9,0,0,0,2.0,82,5.83,55,336,2444,9.8,0.14934719
988,988,Allan Egeland,1998-99,26.0,4,0,8,8,0,0,0,4.0,,17,0,0,0,6.0,82,5.28,57,380,2242,9.6,0.15072525
989,989,Allan Rourke,2004-05,24.0,2,3,25,25,1,2,3,24.0,312.0,25,1,2,3,24.0,82,5.14,57,348,2300,9.2,0.21194735
990,990,Allan Rourke,2006-07,26.0,3,1,6,6,0,1,1,2.0,103.0,31,1,3,4,26.0,82,6.05,85,480,2458,10.1,0.16604891
991,991,Allan Rourke,2007-08,27.0,4,1,11,11,0,1,1,1.0,117.0,42,1,4,5,27.0,82,5.76,70,398,2426,9.7,0.12970152
992,992,Allan Rourke,2008-09,28.0,5,0,13,13,0,0,0,4.0,142.0,55,1,4,5,31.0,82,5.44,62,351,2383,9.4,0.11954209
993,993,Allan Stewart,1986-87,23.0,2,0,4,4,0,0,0,0.0,,4,0,0,0,0.0,80,7.94,82,370,2484,12.8,0.17614272
994,994,Allan Stewart,1987-88,24.0,3,1,7,7,1,0,1,8.0,,11,1,0,1,8.0,80,7.34,72,344,2400,12.2,0.22974637
995,995,Allan Stewart,1988-89,25.0,4,0,1,1,0,0,0,0.0,,12,1,0,1,8.0,80,7.43,89,437,2435,12.2,0.1873577
996,996,Allan Stewart,1989-90,26.0,5,2,6,6,0,2,2,4.0,,18,1,2,3,12.0,80,7.48,85,403,2430,12.3,0.2134223
997,997,Allan Stewart,1991-92,28.0,6,7,41,41,5,2,7,33.0,,59,6,4,10,45.0,80,6.91,71,366,2385,11.6,0.17089784
998,998,Allan Stewart,1992-93,29.0,7,0,5,5,0,0,0,1.0,,64,6,4,10,46.0,80,6.96,77,402,2440,11.4,0.14093962
999,999,Allan Tuer,1986-87,23.0,2,1,45,45,0,1,1,16.0,,45,0,1,1,16.0,80,7.94,82,370,2484,12.8,0.14476258
1000,1000,Allan Tuer,1988-89,25.0,3,1,6,6,1,0,1,1.0,,51,1,1,2,17.0,80,7.43,89,437,2435,12.2,0.1938324
1001,1001,Allan Tuer,1989-90,26.0,4,0,4,4,0,0,0,0.0,,55,1,1,2,17.0,80,7.48,85,403,2430,12.3,0.15677187
1002,1002,Allan Tuer,1990-91,27.0,5,0,2,2,0,0,0,0.0,,57,1,1,2,17.0,80,7.37,76,367,2421,12.2,0.1455569
1003,1003,Allen Pedersen,1987-88,23.0,2,12,79,79,1,11,12,56.0,,79,1,11,12,56.0,80,7.34,72,344,2400,12.2,0.19447389
1004,1004,Allen Pedersen,1988-89,24.0,3,6,78,78,0,6,6,43.0,,157,1,17,18,99.0,80,7.43,89,437,2435,12.2,0.15530151
1005,1005,Allen Pedersen,1989-90,25.0,4,6,51,51,0,6,6,24.0,,208,1,23,24,123.0,80,7.48,85,403,2430,12.3,0.1394172
1006,1006,Allen Pedersen,1990-91,26.0,5,3,68,68,1,2,3,32.0,,276,2,25,27,155.0,80,7.37,76,367,2421,12.2,0.13560045
1007,1007,Allen Pedersen,1991-92,27.0,6,8,57,57,2,6,8,34.0,,333,4,31,35,189.0,80,6.91,71,366,2385,11.6,0.1529853
1008,1008,Allen Pedersen,1992-93,28.0,7,1,29,29,0,1,1,17.0,,362,4,32,36,206.0,80,6.96,77,402,2440,11.4,0.106098205
1009,1009,Allen Pedersen,1993-94,29.0,8,5,59,59,1,4,5,16.0,,421,5,36,41,222.0,84,7.25,87,443,2603,11.7,0.09786481
1010,1010,Allen Pedersen,1994-95,30.0,9,0,7,7,0,0,0,1.0,,428,5,36,41,223.0,84,6.48,76,407,2545,10.7,0.1252402
1011,1011,Alyn McCauley,1998-99,21.0,2,16,60,60,6,10,16,77.0,,60,6,10,16,77.0,82,5.28,57,380,2242,9.6,0.3473677
1012,1012,Alyn McCauley,1999-00,22.0,3,24,39,39,9,15,24,76.0,592.0,99,15,25,40,153.0,82,5.27,57,359,2285,9.4,0.5168715
1013,1013,Alyn McCauley,2000-01,23.0,4,10,45,45,5,5,10,41.0,485.0,144,20,30,50,194.0,82,5.49,53,331,2294,9.8,0.30413586
1014,1014,Alyn McCauley,2001-02,24.0,5,1,14,14,1,0,1,13.0,147.0,158,21,30,51,207.0,82,5.51,63,376,2272,9.9,0.26366177
1015,1015,Alyn McCauley,2002-03,25.0,6,16,82,82,6,10,16,95.0,935.0,240,27,40,67,302.0,82,5.24,53,338,2262,9.5,0.28002065
1016,1016,Alyn McCauley,2003-04,26.0,7,25,80,80,9,16,25,108.0,1105.0,320,36,56,92,410.0,82,5.31,60,363,2326,9.4,0.30698317
1017,1017,Alyn McCauley,2004-05,27.0,8,47,82,82,20,27,47,146.0,1381.0,402,56,83,139,556.0,82,5.14,57,348,2300,9.2,0.5602276
1018,1018,Alyn McCauley,2006-07,29.0,9,26,76,76,12,14,26,105.0,1082.0,478,68,97,165,661.0,82,6.05,85,480,2458,10.1,0.30329505
1019,1019,Alyn McCauley,2007-08,30.0,10,1,10,10,1,0,1,4.0,97.0,488,69,97,166,665.0,82,5.76,70,398,2426,9.7,0.23714694
1020,1020,Anatoli Fedotov,1993-94,27.0,2,2,1,1,0,2,2,1.0,,1,0,2,2,1.0,84,7.25,87,443,2603,11.7,0.19934255
1021,1021,Anatoli Fedotov,1994-95,28.0,3,0,3,3,0,0,0,1.0,,4,0,2,2,2.0,84,6.48,76,407,2545,10.7,0.15450984
1022,1022,Anatoli Semenov,1991-92,29.0,2,31,57,57,15,16,31,101.0,,57,15,16,31,101.0,80,6.91,71,366,2385,11.6,0.5133443
1023,1023,Anatoli Semenov,1992-93,30.0,3,42,59,59,20,22,42,105.0,,116,35,38,73,206.0,80,6.96,77,402,2440,11.4,0.56687564
1024,1024,Anatoli Semenov,1993-94,31.0,4,49,75,75,12,37,49,102.0,,191,47,75,122,308.0,84,7.25,87,443,2603,11.7,0.5111549
1025,1025,Anatoli Semenov,1994-95,32.0,5,30,49,49,11,19,30,103.0,,240,58,94,152,411.0,84,6.48,76,407,2545,10.7,0.49688253
1026,1026,Anatoli Semenov,1995-96,33.0,6,10,41,41,4,6,10,69.0,,281,62,100,162,480.0,48,5.97,37,209,1408,10.2,0.369973
1027,1027,Anatoli Semenov,1996-97,34.0,7,26,56,56,4,22,26,79.0,,337,66,122,188,559.0,82,6.29,74,413,2481,10.4,0.41482428
1028,1028,Anatoli Semenov,1997-98,35.0,8,6,25,25,2,4,6,21.0,,362,68,126,194,580.0,82,5.83,55,336,2444,9.8,0.26568282
1029,1029,Anders Bjork,2018-19,22.0,2,12,30,30,4,8,12,30.0,370.0,30,4,8,12,30.0,82,5.86,50,250,2620,9.2,0.2888442
1030,1030,Anders Bjork,2019-20,23.0,3,3,20,20,1,2,3,18.0,236.0,50,5,10,15,48.0,82,5.96,47,239,2579,9.5,0.23085684
1031,1031,Anders Bjork,2020-21,24.0,4,19,58,58,9,10,19,66.0,750.0,108,14,20,34,114.0,70,5.96,42,208,2192,9.5,0.32540676
1032,1032,Anders Carlsson,1987-88,27.0,2,20,48,48,2,18,20,36.0,,48,2,18,20,36.0,80,7.34,72,344,2400,12.2,0.33905584
1033,1033,Anders Carlsson,1988-89,28.0,3,1,9,9,1,0,1,6.0,,57,3,18,21,42.0,80,7.43,89,437,2435,12.2,0.20878983
1034,1034,Anders Carlsson,1989-90,29.0,4,12,47,47,4,8,12,42.0,,104,7,26,33,84.0,80,7.48,85,403,2430,12.3,0.27027106
1035,1035,Anders Eldebrink,1982-83,22.0,2,9,38,38,1,8,9,47.0,,38,1,8,9,47.0,80,8.03,73,320,2489,12.9,0.24877554
1036,1036,Anders Eldebrink,1983-84,23.0,3,5,17,17,2,3,5,20.0,,55,3,11,14,67.0,80,7.73,71,310,2444,12.7,0.30991858
1037,1037,Anders Eriksson,1996-97,22.0,2,0,1,1,0,0,0,0.0,,1,0,0,0,0.0,82,6.29,74,413,2481,10.4,0.1544433
1038,1038,Anders Eriksson,1997-98,23.0,3,6,23,23,0,6,6,27.0,,24,0,6,6,27.0,82,5.83,55,336,2444,9.8,0.21103692
1039,1039,Anders Eriksson,1998-99,24.0,4,21,66,66,7,14,21,91.0,,90,7,20,27,118.0,82,5.28,57,380,2242,9.6,0.30984664
1040,1040,Anders Eriksson,1999-00,25.0,5,20,72,72,2,18,20,79.0,1221.0,162,9,38,47,197.0,82,5.27,57,359,2285,9.4,0.26278132
1041,1041,Anders Eriksson,2000-01,26.0,6,28,73,73,3,25,28,86.0,1537.0,235,12,63,75,283.0,82,5.49,53,331,2294,9.8,0.35012016
1042,1042,Anders Eriksson,2001-02,27.0,7,26,73,73,2,24,26,99.0,1540.0,308,14,87,101,382.0,82,5.51,63,376,2272,9.9,0.33290708
1043,1043,Anders Eriksson,2002-03,28.0,8,2,34,34,0,2,2,31.0,541.0,342,14,89,103,413.0,82,5.24,53,338,2262,9.5,0.20152941
1044,1044,Anders Eriksson,2003-04,29.0,9,0,4,4,0,0,0,7.0,76.0,346,14,89,103,420.0,82,5.31,60,363,2326,9.4,0.20020041
1045,1045,Anders Eriksson,2004-05,30.0,10,27,66,66,7,20,27,84.0,1366.0,412,21,109,130,504.0,82,5.14,57,348,2300,9.2,0.35719985
1046,1046,Anders Eriksson,2007-08,33.0,11,23,79,79,0,23,23,78.0,1596.0,491,21,132,153,582.0,82,5.76,70,398,2426,9.7,0.24380937
1047,1047,Anders Eriksson,2008-09,34.0,12,18,61,61,1,17,18,50.0,1268.0,552,22,149,171,632.0,82,5.44,62,351,2383,9.4,0.22410524
1048,1048,Anders Eriksson,2010-11,36.0,13,5,20,20,0,5,5,6.0,305.0,572,22,154,176,638.0,82,5.53,56,304,2486,9.1,0.121171385
1049,1049,Anders Hakansson,1982-83,26.0,2,16,72,72,12,4,16,76.0,,72,12,4,16,76.0,80,8.03,73,320,2489,12.9,0.30078575
1050,1050,Anders Hakansson,1983-84,27.0,3,21,67,67,9,12,21,70.0,,139,21,16,37,146.0,80,7.73,71,310,2444,12.7,0.3087604
1051,1051,Anders Hakansson,1984-85,28.0,4,32,80,80,15,17,32,117.0,,219,36,33,69,263.0,80,7.89,74,336,2448,12.9,0.3859812
1052,1052,Anders Hakansson,1985-86,29.0,5,24,73,73,12,12,24,76.0,,292,48,45,93,339.0,80,7.77,71,321,2447,12.7,0.31828824
1053,1053,Anders Hakansson,1986-87,30.0,6,5,38,38,4,1,5,29.0,,330,52,46,98,368.0,80,7.94,82,370,2484,12.8,0.19726545
1054,1054,Anders Kallur,1980-81,28.0,2,52,76,76,22,30,52,138.0,,76,22,30,52,138.0,80,7.03,61,280,2352,12.0,0.6458911
1055,1055,Anders Kallur,1981-82,29.0,3,64,78,78,36,28,64,163.0,,154,58,58,116,301.0,80,7.69,77,340,2441,12.6,0.71339214
1056,1056,Anders Kallur,1982-83,30.0,4,40,58,58,18,22,40,74.0,,212,76,80,156,375.0,80,8.03,73,320,2489,12.9,0.5287572
1057,1057,Anders Kallur,1983-84,31.0,5,14,55,55,6,8,14,80.0,,267,82,88,170,455.0,80,7.73,71,310,2444,12.7,0.4110208
1058,1058,Anders Kallur,1984-85,32.0,6,23,65,65,9,14,23,70.0,,332,91,102,193,525.0,80,7.89,74,336,2448,12.9,0.38202107
1059,1059,Anders Kallur,1985-86,33.0,7,18,51,51,10,8,18,71.0,,383,101,110,211,596.0,80,7.77,71,321,2447,12.7,0.41769868
1060,1060,Anders Lee,2013-14,23.0,2,2,2,2,1,1,2,2.0,16.0,2,1,1,2,2.0,48,5.31,29,160,1399,9.1,0.3107342
1061,1061,Anders Lee,2014-15,24.0,3,14,22,22,9,5,14,68.0,346.0,24,10,6,16,70.0,82,5.34,48,269,2463,8.9,0.3838011
1062,1062,Anders Lee,2015-16,25.0,4,41,76,76,25,16,41,197.0,1094.0,100,35,22,57,267.0,82,5.32,47,251,2453,8.9,0.5478066
1063,1063,Anders Lee,2016-17,26.0,5,36,80,80,15,21,36,183.0,1166.0,180,50,43,93,450.0,82,5.34,48,255,2438,9.0,0.49966973
1064,1064,Anders Lee,2017-18,27.0,6,52,81,81,34,18,52,191.0,1263.0,261,84,61,145,641.0,82,5.45,47,245,2478,9.0,0.6121282
1065,1065,Anders Lee,2018-19,28.0,7,62,82,82,40,22,62,208.0,1416.0,343,124,83,207,849.0,82,5.86,50,250,2620,9.2,0.6962102
1066,1066,Anders Lee,2019-20,29.0,8,51,82,82,28,23,51,204.0,1401.0,425,152,106,258,1053.0,82,5.96,47,239,2579,9.5,0.6028228
1067,1067,Anders Lee,2020-21,30.0,9,43,68,68,20,23,43,195.0,1244.0,493,172,129,301,1248.0,70,5.96,42,208,2192,9.5,0.6164626
1068,1068,Anders Myrvold,1996-97,21.0,2,1,4,4,0,1,1,4.0,,4,0,1,1,4.0,82,6.29,74,413,2481,10.4,0.2534008
1069,1069,Anders Myrvold,1997-98,22.0,3,2,9,9,0,2,2,8.0,,13,0,3,3,12.0,82,5.83,55,336,2444,9.8,0.18616912
1070,1070,Anders Myrvold,2001-02,26.0,4,1,12,12,0,1,1,8.0,113.0,25,0,4,4,20.0,82,5.51,63,376,2272,9.9,0.1433878
1071,1071,Anders Myrvold,2004-05,29.0,5,1,8,8,0,1,1,6.0,98.0,33,0,5,5,26.0,82,5.14,57,348,2300,9.2,0.17040706
1072,1072,Anders Steen,1981-82,26.0,2,16,42,42,5,11,16,57.0,,42,5,11,16,57.0,80,7.69,77,340,2441,12.6,0.3533886
1073,1073,Andre Benoit,2011-12,28.0,2,1,8,8,0,1,1,17.0,135.0,8,0,1,1,17.0,82,5.46,52,291,2492,9.0,0.20060584
1074,1074,Andre Benoit,2013-14,30.0,3,10,33,33,3,7,10,50.0,542.0,41,3,8,11,67.0,48,5.31,29,160,1399,9.1,0.25484347
1075,1075,Andre Benoit,2014-15,31.0,4,28,79,79,7,21,28,113.0,1597.0,120,10,29,39,180.0,82,5.34,48,269,2463,8.9,0.3117601
1076,1076,Andre Benoit,2015-16,32.0,5,9,59,59,1,8,9,45.0,1069.0,179,11,37,48,225.0,82,5.32,47,251,2453,8.9,0.14251214
1077,1077,Andre Benoit,2016-17,33.0,6,0,2,2,0,0,0,0.0,27.0,181,11,37,48,225.0,82,5.34,48,255,2438,9.0,0.17953184
1078,1078,Andre Burakovsky,2015-16,20.0,2,22,53,53,9,13,22,65.0,685.0,53,9,13,22,65.0,82,5.32,47,251,2453,8.9,0.40058112
1079,1079,Andre Burakovsky,2016-17,21.0,3,38,79,79,17,21,38,126.0,1029.0,132,26,34,60,191.0,82,5.34,48,255,2438,9.0,0.5220491
1080,1080,Andre Burakovsky,2017-18,22.0,4,35,64,64,12,23,35,111.0,849.0,196,38,57,95,302.0,82,5.45,47,245,2478,9.0,0.52185714
1081,1081,Andre Burakovsky,2018-19,23.0,5,25,56,56,12,13,25,84.0,775.0,252,50,70,120,386.0,82,5.86,50,250,2620,9.2,0.47685063
1082,1082,Andre Burakovsky,2019-20,24.0,6,25,76,76,12,13,25,100.0,846.0,328,62,83,145,486.0,82,5.96,47,239,2579,9.5,0.45226422
1083,1083,Andre Burakovsky,2020-21,25.0,7,45,58,58,20,25,45,103.0,882.0,386,82,108,190,589.0,70,5.96,42,208,2192,9.5,0.65436107
1084,1084,Andre Deveaux,2009-10,25.0,2,1,21,21,0,1,1,15.0,152.0,21,0,1,1,15.0,82,5.7,65,341,2477,9.4,0.12633035
1085,1085,Andre Deveaux,2010-11,26.0,3,0,1,1,0,0,0,1.0,6.0,22,0,1,1,16.0,82,5.53,56,304,2486,9.1,0.15479085
1086,1086,Andre Deveaux,2012-13,28.0,4,1,9,9,0,1,1,2.0,48.0,31,0,2,2,18.0,82,5.32,47,271,2439,8.9,0.13914251
1087,1087,Andre Faust,1993-94,24.0,2,4,10,10,2,2,4,11.0,,10,2,2,4,11.0,84,7.25,87,443,2603,11.7,0.2752095
1088,1088,Andre Faust,1994-95,25.0,3,13,37,37,8,5,13,33.0,,47,10,7,17,44.0,84,6.48,76,407,2545,10.7,0.2671882
1089,1089,Andre Hidi,1984-85,24.0,2,0,1,1,0,0,0,1.0,,1,0,0,0,1.0,80,7.89,74,336,2448,12.9,0.22530669
1090,1090,Andre Hidi,1985-86,25.0,3,3,6,6,2,1,3,7.0,,7,2,1,3,8.0,80,7.77,71,321,2447,12.7,0.31105512
1091,1091,Andre Petersson,2012-13,22.0,2,0,1,1,0,0,0,0.0,5.0,1,0,0,0,0.0,82,5.32,47,271,2439,8.9,0.14758375
1092,1092,Andre Roy,1996-97,21.0,2,0,3,3,0,0,0,0.0,,3,0,0,0,0.0,82,6.29,74,413,2481,10.4,0.17969257
1093,1093,Andre Roy,1997-98,22.0,3,2,10,10,0,2,2,12.0,,13,0,2,2,12.0,82,5.83,55,336,2444,9.8,0.19761589
1094,1094,Andre Roy,2000-01,25.0,4,7,73,73,4,3,7,39.0,474.0,86,4,5,9,51.0,82,5.49,53,331,2294,9.8,0.14924344
1095,1095,Andre Roy,2001-02,26.0,5,8,64,64,3,5,8,33.0,294.0,150,7,10,17,84.0,82,5.51,63,376,2272,9.9,0.13798788
1096,1096,Andre Roy,2002-03,27.0,6,16,65,65,7,9,16,66.0,550.0,215,14,19,33,150.0,82,5.24,53,338,2262,9.5,0.19835126
1097,1097,Andre Roy,2003-04,28.0,7,17,62,62,10,7,17,85.0,667.0,277,24,26,50,235.0,82,5.31,60,363,2326,9.4,0.222626
1098,1098,Andre Roy,2004-05,29.0,8,2,33,33,1,1,2,24.0,259.0,310,25,27,52,259.0,82,5.14,57,348,2300,9.2,0.18223786
1099,1099,Andre Roy,2006-07,31.0,9,3,42,42,2,1,3,11.0,212.0,352,27,28,55,270.0,82,6.05,85,480,2458,10.1,0.107429296
1100,1100,Andre Roy,2007-08,32.0,10,3,56,56,1,2,3,15.0,250.0,408,28,30,58,285.0,82,5.76,70,398,2426,9.7,0.08907947
1101,1101,Andre Roy,2008-09,33.0,11,7,63,63,4,3,7,38.0,344.0,471,32,33,65,323.0,82,5.44,62,351,2383,9.4,0.11373946
1102,1102,Andre Roy,2009-10,34.0,12,3,44,44,3,0,3,26.0,242.0,515,35,33,68,349.0,82,5.7,65,341,2477,9.4,0.09600896
1103,1103,Andre Savage,1999-00,24.0,2,1,6,6,1,0,1,8.0,57.0,6,1,0,1,8.0,82,5.27,57,359,2285,9.4,0.21212354
1104,1104,Andre Savage,2000-01,25.0,3,20,43,43,7,13,20,70.0,631.0,49,8,13,21,78.0,82,5.49,53,331,2294,9.8,0.3526124
1105,1105,Andre Savage,2001-02,26.0,4,0,1,1,0,0,0,1.0,5.0,50,8,13,21,79.0,82,5.51,63,376,2272,9.9,0.1766912
1106,1106,Andre Savage,2003-04,28.0,5,3,16,16,2,1,3,13.0,125.0,66,10,14,24,92.0,82,5.31,60,363,2326,9.4,0.22043884
1107,1107,Andreas Athanasiou,2016-17,22.0,2,14,37,37,9,5,14,53.0,334.0,37,9,5,14,53.0,82,5.34,48,255,2438,9.0,0.34839064
1108,1108,Andreas Athanasiou,2017-18,23.0,3,29,64,64,18,11,29,120.0,862.0,101,27,16,43,173.0,82,5.45,47,245,2478,9.0,0.4369502
1109,1109,Andreas Athanasiou,2018-19,24.0,4,33,71,71,16,17,33,170.0,1087.0,172,43,33,76,343.0,82,5.86,50,250,2620,9.2,0.5208543
1110,1110,Andreas Athanasiou,2019-20,25.0,5,54,76,76,30,24,54,216.0,1290.0,248,73,57,130,559.0,82,5.96,47,239,2579,9.5,0.6573275
1111,1111,Andreas Athanasiou,2020-21,26.0,6,26,55,55,11,15,26,129.0,871.0,303,84,72,156,688.0,70,5.96,42,208,2192,9.5,0.5200434
1112,1112,Andreas Borgman,2018-19,23.0,2,11,48,48,3,8,11,46.0,657.0,48,3,8,11,46.0,82,5.86,50,250,2620,9.2,0.23522961
1113,1113,Andreas Dackell,1997-98,25.0,2,31,79,79,12,19,31,79.0,,79,12,19,31,79.0,82,5.83,55,336,2444,9.8,0.38991335
1114,1114,Andreas Dackell,1998-99,26.0,3,33,82,82,15,18,33,130.0,,161,27,37,64,209.0,82,5.28,57,380,2242,9.6,0.4351981
1115,1115,Andreas Dackell,1999-00,27.0,4,50,77,77,15,35,50,107.0,1332.0,238,42,72,114,316.0,82,5.27,57,359,2285,9.4,0.5633194
1116,1116,Andreas Dackell,2000-01,28.0,5,35,82,82,10,25,35,99.0,1335.0,320,52,97,149,415.0,82,5.49,53,331,2294,9.8,0.43793967
1117,1117,Andreas Dackell,2001-02,29.0,6,31,81,81,13,18,31,72.0,1136.0,401,65,115,180,487.0,82,5.51,63,376,2272,9.9,0.40100434
1118,1118,Andreas Dackell,2002-03,30.0,7,33,79,79,15,18,33,83.0,1361.0,480,80,133,213,570.0,82,5.24,53,338,2262,9.5,0.41228712
1119,1119,Andreas Dackell,2003-04,31.0,8,25,73,73,7,18,25,74.0,1087.0,553,87,151,238,644.0,82,5.31,60,363,2326,9.4,0.31908727
1120,1120,Andreas Dackell,2004-05,32.0,9,12,60,60,4,8,12,50.0,921.0,613,91,159,250,694.0,82,5.14,57,348,2300,9.2,0.24332416
1121,1121,Andreas Englund,2017-18,22.0,2,0,5,5,0,0,0,3.0,53.0,5,0,0,0,3.0,82,5.45,47,245,2478,9.0,0.19091848
1122,1122,Andreas Englund,2018-19,23.0,3,0,1,1,0,0,0,0.0,11.0,6,0,0,0,3.0,82,5.86,50,250,2620,9.2,0.15939495
1123,1123,Andreas Englund,2019-20,24.0,4,0,3,3,0,0,0,2.0,40.0,9,0,0,0,5.0,82,5.96,47,239,2579,9.5,0.17077997
1124,1124,Andreas Englund,2020-21,25.0,5,3,24,24,0,3,3,10.0,262.0,33,0,3,3,15.0,70,5.96,42,208,2192,9.5,0.1902655
1125,1125,Andreas Engqvist,2011-12,24.0,2,0,3,3,0,0,0,1.0,26.0,3,0,0,0,1.0,82,5.46,52,291,2492,9.0,0.1571627
1126,1126,Andreas Engqvist,2012-13,25.0,3,0,12,12,0,0,0,3.0,79.0,15,0,0,0,4.0,82,5.32,47,271,2439,8.9,0.14731768
1127,1127,Andreas Johansson,1996-97,23.0,2,1,3,3,0,1,1,6.0,,3,0,1,1,6.0,82,6.29,74,413,2481,10.4,0.20212269
1128,1128,Andreas Johansson,1997-98,24.0,3,13,42,42,4,9,13,59.0,,45,4,10,14,65.0,82,5.83,55,336,2444,9.8,0.23987523
1129,1129,Andreas Johansson,1998-99,25.0,4,15,50,50,5,10,15,49.0,,95,9,20,29,114.0,82,5.28,57,380,2242,9.6,0.25741935
1130,1130,Andreas Johansson,1999-00,26.0,5,37,69,69,21,16,37,144.0,1011.0,164,30,36,66,258.0,82,5.27,57,359,2285,9.4,0.52150035
1131,1131,Andreas Johansson,2000-01,27.0,6,15,40,40,5,10,15,58.0,509.0,204,35,46,81,316.0,82,5.49,53,331,2294,9.8,0.3146984
1132,1132,Andreas Johansson,2002-03,29.0,7,24,70,70,14,10,24,108.0,1142.0,274,49,56,105,424.0,82,5.24,53,338,2262,9.5,0.35409927
1133,1133,Andreas Johansson,2003-04,30.0,8,37,56,56,20,17,37,124.0,939.0,330,69,73,142,548.0,82,5.31,60,363,2326,9.4,0.5759437
1134,1134,Andreas Johansson,2004-05,31.0,9,27,47,47,12,15,27,108.0,743.0,377,81,88,169,656.0,82,5.14,57,348,2300,9.2,0.5529339
1135,1135,Andreas Johnsson,2018-19,24.0,2,3,9,9,2,1,3,19.0,105.0,9,2,1,3,19.0,82,5.86,50,250,2620,9.2,0.2348876
1136,1136,Andreas Johnsson,2019-20,25.0,3,43,73,73,20,23,43,130.0,998.0,82,22,24,46,149.0,82,5.96,47,239,2579,9.5,0.5357005
1137,1137,Andreas Johnsson,2020-21,26.0,4,21,43,43,8,13,21,78.0,677.0,125,30,37,67,227.0,70,5.96,42,208,2192,9.5,0.44769803
1138,1138,Andreas Karlsson,2000-01,25.0,2,14,51,51,5,9,14,74.0,663.0,51,5,9,14,74.0,82,5.49,53,331,2294,9.8,0.26380777
1139,1139,Andreas Karlsson,2001-02,26.0,3,16,60,60,5,11,16,83.0,774.0,111,10,20,30,157.0,82,5.51,63,376,2272,9.9,0.2848009
1140,1140,Andreas Karlsson,2002-03,27.0,4,8,42,42,1,7,8,41.0,525.0,153,11,27,38,198.0,82,5.24,53,338,2262,9.5,0.15002775
1141,1141,Andreas Karlsson,2007-08,32.0,5,9,53,53,3,6,9,25.0,446.0,206,14,33,47,223.0,82,5.76,70,398,2426,9.7,0.119377255
1142,1142,Andreas Karlsson,2008-09,33.0,6,4,58,58,2,2,4,31.0,560.0,264,16,35,51,254.0,82,5.44,62,351,2383,9.4,0.12707514
1143,1143,Andreas Lilja,2001-02,26.0,2,0,2,2,0,0,0,1.0,25.0,2,0,0,0,1.0,82,5.51,63,376,2272,9.9,0.16294545
1144,1144,Andreas Lilja,2002-03,27.0,3,5,26,26,1,4,5,12.0,298.0,28,1,4,5,13.0,82,5.24,53,338,2262,9.5,0.13296294
1145,1145,Andreas Lilja,2003-04,28.0,4,15,73,73,4,11,15,72.0,1415.0,101,5,15,20,85.0,82,5.31,60,363,2326,9.4,0.20595059
1146,1146,Andreas Lilja,2004-05,29.0,5,7,79,79,3,4,7,79.0,1545.0,180,8,19,27,164.0,82,5.14,57,348,2300,9.2,0.1800304
1147,1147,Andreas Lilja,2006-07,31.0,6,15,82,82,2,13,15,78.0,1559.0,262,10,32,42,242.0,82,6.05,85,480,2458,10.1,0.17664176
1148,1148,Andreas Lilja,2007-08,32.0,7,5,57,57,0,5,5,37.0,878.0,319,10,37,47,279.0,82,5.76,70,398,2426,9.7,0.12229112
1149,1149,Andreas Lilja,2008-09,33.0,8,12,79,79,2,10,12,72.0,1440.0,398,12,47,59,351.0,82,5.44,62,351,2383,9.4,0.16444167
1150,1150,Andreas Lilja,2009-10,34.0,9,13,60,60,2,11,13,60.0,1020.0,458,14,58,72,411.0,82,5.7,65,341,2477,9.4,0.17221591
1151,1151,Andreas Lilja,2010-11,35.0,10,2,20,20,1,1,2,19.0,283.0,478,15,59,74,430.0,82,5.53,56,304,2486,9.1,0.1166603
1152,1152,Andreas Lilja,2011-12,36.0,11,7,52,52,1,6,7,31.0,907.0,530,16,65,81,461.0,82,5.46,52,291,2492,9.0,0.1018517
1153,1153,Andreas Lilja,2012-13,37.0,12,6,46,46,0,6,6,35.0,630.0,576,16,71,87,496.0,82,5.32,47,271,2439,8.9,0.11231303
1154,1154,Andreas Lilja,2013-14,38.0,13,0,4,4,0,0,0,2.0,67.0,580,16,71,87,498.0,48,5.31,29,160,1399,9.1,0.14871874
1155,1155,Andreas Martinsen,2016-17,26.0,2,11,55,55,4,7,11,52.0,610.0,55,4,7,11,52.0,82,5.34,48,255,2438,9.0,0.18488032
1156,1156,Andreas Martinsen,2017-18,27.0,3,7,64,64,3,4,7,73.0,637.0,119,7,11,18,125.0,82,5.45,47,245,2478,9.0,0.17979899
1157,1157,Andreas Martinsen,2018-19,28.0,4,1,9,9,1,0,1,14.0,114.0,128,8,11,19,139.0,82,5.86,50,250,2620,9.2,0.16614425
1158,1158,Andreas Martinsen,2019-20,29.0,5,4,24,24,1,3,4,21.0,190.0,152,9,14,23,160.0,82,5.96,47,239,2579,9.5,0.14588761
1159,1159,Andreas Nodl,2009-10,22.0,2,4,38,38,1,3,4,33.0,424.0,38,1,3,4,33.0,82,5.7,65,341,2477,9.4,0.1778017
1160,1160,Andreas Nodl,2010-11,23.0,3,1,10,10,0,1,1,2.0,89.0,48,1,4,5,35.0,82,5.53,56,304,2486,9.1,0.16835153
1161,1161,Andreas Nodl,2011-12,24.0,4,22,67,67,11,11,22,100.0,889.0,115,12,15,27,135.0,82,5.46,52,291,2492,9.0,0.31170744
1162,1162,Andreas Nodl,2012-13,25.0,5,8,60,60,3,5,8,66.0,703.0,175,15,20,35,201.0,82,5.32,47,271,2439,8.9,0.17057618
1163,1163,Andreas Nodl,2013-14,26.0,6,1,8,8,0,1,1,6.0,68.0,183,15,21,36,207.0,48,5.31,29,160,1399,9.1,0.17324305
1164,1164,Andreas Salomonsson,2002-03,29.0,2,9,39,39,4,5,9,58.0,527.0,39,4,5,9,58.0,82,5.24,53,338,2262,9.5,0.20469621
1165,1165,Andreas Salomonsson,2003-04,30.0,3,5,32,32,1,4,5,20.0,282.0,71,5,9,14,78.0,82,5.31,60,363,2326,9.4,0.17389819
1166,1166,Andreas Thuresson,2010-11,23.0,2,3,22,22,1,2,3,30.0,220.0,22,1,2,3,30.0,82,5.53,56,304,2486,9.1,0.23294908
1167,1167,Andreas Thuresson,2011-12,24.0,3,0,3,3,0,0,0,2.0,30.0,25,1,2,3,32.0,82,5.46,52,291,2492,9.0,0.15649676
1168,1168,Andrei Bashkirov,1999-00,29.0,2,0,10,10,0,0,0,4.0,70.0,10,0,0,0,4.0,82,5.27,57,359,2285,9.4,0.13914013
1169,1169,Andrei Bashkirov,2000-01,30.0,3,0,2,2,0,0,0,0.0,10.0,12,0,0,0,4.0,82,5.49,53,331,2294,9.8,0.12783352
1170,1170,Andrei Bashkirov,2001-02,31.0,4,3,18,18,0,3,3,22.0,210.0,30,0,3,3,26.0,82,5.51,63,376,2272,9.9,0.16947684
1171,1171,Andrei Chibisov,2020-21,27.0,2,0,2,2,0,0,0,1.0,15.0,2,0,0,0,1.0,70,5.96,42,208,2192,9.5,0.18147737
1172,1172,Andrei Kostitsyn,2006-07,21.0,2,3,12,12,2,1,3,9.0,90.0,12,2,1,3,9.0,82,6.05,85,480,2458,10.1,0.29811043
1173,1173,Andrei Kostitsyn,2007-08,22.0,3,11,22,22,1,10,11,38.0,292.0,34,3,11,14,47.0,82,5.76,70,398,2426,9.7,0.29864192
1174,1174,Andrei Kostitsyn,2008-09,23.0,4,53,78,78,26,27,53,156.0,1224.0,112,29,38,67,203.0,82,5.44,62,351,2383,9.4,0.6788585
1175,1175,Andrei Kostitsyn,2009-10,24.0,5,41,74,74,23,18,41,169.0,1154.0,186,52,56,108,372.0,82,5.7,65,341,2477,9.4,0.5451753
1176,1176,Andrei Kostitsyn,2010-11,25.0,6,33,59,59,15,18,33,136.0,943.0,245,67,74,141,508.0,82,5.53,56,304,2486,9.1,0.53840923
1177,1177,Andrei Kostitsyn,2011-12,26.0,7,45,81,81,20,25,45,196.0,1287.0,326,87,99,186,704.0,82,5.46,52,291,2492,9.0,0.58699876
1178,1178,Andrei Kostitsyn,2012-13,27.0,8,36,72,72,16,20,36,122.0,1088.0,398,103,119,222,826.0,82,5.32,47,271,2439,8.9,0.48588717
1179,1179,Andrei Kovalenko,1993-94,23.0,2,68,81,81,27,41,68,153.0,,81,27,41,68,153.0,84,7.25,87,443,2603,11.7,0.7485751
1180,1180,Andrei Kovalenko,1994-95,24.0,3,33,58,58,16,17,33,92.0,,139,43,58,101,245.0,84,6.48,76,407,2545,10.7,0.52671623
1181,1181,Andrei Kovalenko,1995-96,25.0,4,24,45,45,14,10,24,63.0,,184,57,68,125,308.0,48,5.97,37,209,1408,10.2,0.5614269
1182,1182,Andrei Kovalenko,1996-97,26.0,5,56,77,77,28,28,56,131.0,,261,85,96,181,439.0,82,6.29,74,413,2481,10.4,0.6583178
1183,1183,Andrei Kovalenko,1997-98,27.0,6,59,74,74,32,27,59,163.0,,335,117,123,240,602.0,82,5.83,55,336,2444,9.8,0.63400996
1184,1184,Andrei Kovalenko,1998-99,28.0,7,23,59,59,6,17,23,89.0,,394,123,140,263,691.0,82,5.28,57,380,2242,9.6,0.39821288
1185,1185,Andrei Kovalenko,1999-00,29.0,8,40,74,74,19,21,40,104.0,1056.0,468,142,161,303,795.0,82,5.27,57,359,2285,9.4,0.49713928
1186,1186,Andrei Kovalenko,2000-01,30.0,9,39,76,76,15,24,39,114.0,1138.0,544,157,185,342,909.0,82,5.49,53,331,2294,9.8,0.48476043
1187,1187,Andrei Kovalenko,2001-02,31.0,10,37,76,76,16,21,37,119.0,1174.0,620,173,206,379,1028.0,82,5.51,63,376,2272,9.9,0.4204965
1188,1188,Andrei Loktionov,2010-11,20.0,2,0,1,1,0,0,0,1.0,12.0,1,0,0,0,1.0,82,5.53,56,304,2486,9.1,0.24500105
1189,1189,Andrei Loktionov,2011-12,21.0,3,7,19,19,4,3,7,26.0,280.0,20,4,3,7,27.0,82,5.46,52,291,2492,9.0,0.3512301
1190,1190,Andrei Loktionov,2012-13,22.0,4,7,39,39,3,4,7,60.0,489.0,59,7,7,14,87.0,82,5.32,47,271,2439,8.9,0.2754451
1191,1191,Andrei Loktionov,2013-14,23.0,5,12,28,28,8,4,12,47.0,399.0,87,15,11,26,134.0,48,5.31,29,160,1399,9.1,0.3859471
1192,1192,Andrei Loktionov,2014-15,24.0,6,22,68,68,7,15,22,78.0,883.0,155,22,26,48,212.0,82,5.34,48,269,2463,8.9,0.29441726
1193,1193,Andrei Lomakin,1992-93,28.0,2,30,57,57,14,16,30,82.0,,57,14,16,30,82.0,80,6.96,77,402,2440,11.4,0.46285117
1194,1194,Andrei Lomakin,1993-94,29.0,3,20,51,51,8,12,20,64.0,,108,22,28,50,146.0,84,7.25,87,443,2603,11.7,0.3686884
1195,1195,Andrei Lomakin,1994-95,30.0,4,47,76,76,19,28,47,139.0,,184,41,56,97,285.0,84,6.48,76,407,2545,10.7,0.48171803
1196,1196,Andrei Lomakin,1995-96,31.0,5,7,31,31,1,6,7,25.0,,215,42,62,104,310.0,48,5.97,37,209,1408,10.2,0.24579334
1197,1197,Andrei Markov,2001-02,23.0,2,23,63,63,6,17,23,82.0,1064.0,63,6,17,23,82.0,82,5.51,63,376,2272,9.9,0.36145276
1198,1198,Andrei Markov,2002-03,24.0,3,24,56,56,5,19,24,73.0,966.0,119,11,36,47,155.0,82,5.24,53,338,2262,9.5,0.39478606
1199,1199,Andrei Markov,2003-04,25.0,4,37,79,79,13,24,37,159.0,1840.0,198,24,60,84,314.0,82,5.31,60,363,2326,9.4,0.50897807
1200,1200,Andrei Markov,2004-05,26.0,5,28,69,69,6,22,28,105.0,1482.0,267,30,82,112,419.0,82,5.14,57,348,2300,9.2,0.47970724
1201,1201,Andrei Markov,2006-07,28.0,6,46,67,67,10,36,46,88.0,1578.0,334,40,118,158,507.0,82,6.05,85,480,2458,10.1,0.52427983
1202,1202,Andrei Markov,2007-08,29.0,7,49,77,77,6,43,49,128.0,1885.0,411,46,161,207,635.0,82,5.76,70,398,2426,9.7,0.52752113
1203,1203,Andrei Markov,2008-09,30.0,8,58,82,82,16,42,58,145.0,2048.0,493,62,203,265,780.0,82,5.44,62,351,2383,9.4,0.6796641
1204,1204,Andrei Markov,2009-10,31.0,9,64,78,78,12,52,64,165.0,1921.0,571,74,255,329,945.0,82,5.7,65,341,2477,9.4,0.68431556
1205,1205,Andrei Markov,2010-11,32.0,10,34,45,45,6,28,34,85.0,1071.0,616,80,283,363,1030.0,82,5.53,56,304,2486,9.1,0.53267914
1206,1206,Andrei Markov,2011-12,33.0,11,3,7,7,1,2,3,20.0,160.0,623,81,285,366,1050.0,82,5.46,52,291,2492,9.0,0.26652187
1207,1207,Andrei Markov,2012-13,34.0,12,3,13,13,0,3,3,17.0,234.0,636,81,288,369,1067.0,82,5.32,47,271,2439,8.9,0.27742535
1208,1208,Andrei Markov,2013-14,35.0,13,30,48,48,10,20,30,79.0,1158.0,684,91,308,399,1146.0,48,5.31,29,160,1399,9.1,0.5198661
1209,1209,Andrei Markov,2014-15,36.0,14,43,81,81,7,36,43,131.0,2044.0,765,98,344,442,1277.0,82,5.34,48,269,2463,8.9,0.47574183
1210,1210,Andrei Markov,2015-16,37.0,15,50,81,81,10,40,50,135.0,2018.0,846,108,384,492,1412.0,82,5.32,47,251,2453,8.9,0.5120237
1211,1211,Andrei Markov,2016-17,38.0,16,44,82,82,5,39,44,117.0,1955.0,928,113,423,536,1529.0,82,5.34,48,255,2438,9.0,0.44914058
1212,1212,Andrei Markov,2017-18,39.0,17,36,62,62,6,30,36,98.0,1354.0,990,119,453,572,1627.0,82,5.45,47,245,2478,9.0,0.40047207
1213,1213,Andrei Mironov,2018-19,24.0,2,3,10,10,1,2,3,3.0,110.0,10,1,2,3,3.0,82,5.86,50,250,2620,9.2,0.20388201
1214,1214,Andrei Nazarov,1994-95,20.0,2,0,1,1,0,0,0,0.0,,1,0,0,0,0.0,84,6.48,76,407,2545,10.7,0.23598891
1215,1215,Andrei Nazarov,1995-96,21.0,3,8,26,26,3,5,8,19.0,,27,3,5,8,19.0,48,5.97,37,209,1408,10.2,0.33080557
1216,1216,Andrei Nazarov,1996-97,22.0,4,14,42,42,7,7,14,55.0,,69,10,12,22,74.0,82,6.29,74,413,2481,10.4,0.3376158
1217,1217,Andrei Nazarov,1997-98,23.0,5,27,60,60,12,15,27,116.0,,129,22,27,49,190.0,82,5.83,55,336,2444,9.8,0.40520972
1218,1218,Andrei Nazarov,1998-99,24.0,6,4,54,54,2,2,4,50.0,,183,24,29,53,240.0,82,5.28,57,380,2242,9.6,0.2042365
1219,1219,Andrei Nazarov,1999-00,25.0,7,16,62,62,7,9,16,71.0,736.0,245,31,38,69,311.0,82,5.27,57,359,2285,9.4,0.25305706
1220,1220,Andrei Nazarov,2000-01,26.0,8,32,76,76,10,22,32,110.0,892.0,321,41,60,101,421.0,82,5.49,53,331,2294,9.8,0.38045335
1221,1221,Andrei Nazarov,2001-02,27.0,9,6,79,79,2,4,6,63.0,655.0,400,43,64,107,484.0,82,5.51,63,376,2272,9.9,0.18953928
1222,1222,Andrei Nazarov,2002-03,28.0,10,11,77,77,6,5,11,56.0,376.0,477,49,69,118,540.0,82,5.24,53,338,2262,9.5,0.1880332
1223,1223,Andrei Nazarov,2003-04,29.0,11,3,59,59,3,0,3,35.0,387.0,536,52,69,121,575.0,82,5.31,60,363,2326,9.4,0.14866516
1224,1224,Andrei Nazarov,2004-05,30.0,12,3,33,33,1,2,3,17.0,180.0,569,53,71,124,592.0,82,5.14,57,348,2300,9.2,0.15798461
1225,1225,Andrei Nazarov,2006-07,32.0,13,0,2,2,0,0,0,0.0,10.0,571,53,71,124,592.0,82,6.05,85,480,2458,10.1,0.19693908
1226,1226,Andrei Nikolishin,1995-96,22.0,2,18,39,39,8,10,18,57.0,,39,8,10,18,57.0,48,5.97,37,209,1408,10.2,0.46934253
1227,1227,Andrei Nikolishin,1996-97,23.0,3,51,61,61,14,37,51,83.0,,100,22,47,69,140.0,82,6.29,74,413,2481,10.4,0.6486511
1228,1228,Andrei Nikolishin,1997-98,24.0,4,28,71,71,9,19,28,98.0,,171,31,66,97,238.0,82,5.83,55,336,2444,9.8,0.40075582
1229,1229,Andrei Nikolishin,1998-99,25.0,5,16,38,38,6,10,16,40.0,,209,37,76,113,278.0,82,5.28,57,380,2242,9.6,0.4060542
1230,1230,Andrei Nikolishin,1999-00,26.0,6,35,73,73,8,27,35,121.0,1282.0,282,45,103,148,399.0,82,5.27,57,359,2285,9.4,0.48499873
1231,1231,Andrei Nikolishin,2000-01,27.0,7,25,76,76,11,14,25,98.0,1195.0,358,56,117,173,497.0,82,5.49,53,331,2294,9.8,0.3854315
1232,1232,Andrei Nikolishin,2001-02,28.0,8,38,81,81,13,25,38,145.0,1259.0,439,69,142,211,642.0,82,5.51,63,376,2272,9.9,0.47334185
1233,1233,Andrei Nikolishin,2002-03,29.0,9,36,80,80,13,23,36,143.0,1391.0,519,82,165,247,785.0,82,5.24,53,338,2262,9.5,0.45270023
1234,1234,Andrei Nikolishin,2003-04,30.0,10,21,60,60,6,15,21,73.0,1021.0,579,88,180,268,858.0,82,5.31,60,363,2326,9.4,0.3174616
1235,1235,Andrei Nikolishin,2004-05,31.0,11,12,49,49,5,7,12,71.0,798.0,628,93,187,280,929.0,82,5.14,57,348,2300,9.2,0.31250635
1236,1236,Andrei Skopintsev,1999-00,28.0,2,2,19,19,1,1,2,17.0,306.0,19,1,1,2,17.0,82,5.27,57,359,2285,9.4,0.1707778
1237,1237,Andrei Skopintsev,2000-01,29.0,3,0,4,4,0,0,0,0.0,56.0,23,1,1,2,17.0,82,5.49,53,331,2294,9.8,0.13622719
1238,1238,Andrei Skopintsev,2001-02,30.0,4,4,17,17,1,3,4,10.0,310.0,40,2,4,6,27.0,82,5.51,63,376,2272,9.9,0.1545361
1239,1239,Andrei Svechnikov,2019-20,19.0,2,37,82,82,20,17,37,189.0,1201.0,82,20,17,37,189.0,82,5.96,47,239,2579,9.5,0.62860364
1240,1240,Andrei Svechnikov,2020-21,20.0,3,61,68,68,24,37,61,183.0,1138.0,150,44,54,98,372.0,70,5.96,42,208,2192,9.5,0.9015893
1241,1241,Andrei Vasilyev,1995-96,23.0,2,0,2,2,0,0,0,2.0,,2,0,0,0,2.0,48,5.97,37,209,1408,10.2,0.20231268
1242,1242,Andrei Vasilyev,1996-97,24.0,3,7,10,10,2,5,7,12.0,,12,2,5,7,14.0,82,6.29,74,413,2481,10.4,0.2551191
1243,1243,Andrei Vasilyev,1997-98,25.0,4,0,3,3,0,0,0,1.0,,15,2,5,7,15.0,82,5.83,55,336,2444,9.8,0.1441851
1244,1244,Andrei Vasilyev,1999-00,27.0,5,0,1,1,0,0,0,0.0,1.0,16,2,5,7,15.0,82,5.27,57,359,2285,9.4,0.15054148
1245,1245,Andrei Zubarev,2011-12,24.0,2,1,4,4,0,1,1,2.0,80.0,4,0,1,1,2.0,82,5.46,52,291,2492,9.0,0.1865156
1246,1246,Andrei Zyuzin,1998-99,21.0,2,13,56,56,6,7,13,72.0,,56,6,7,13,72.0,82,5.28,57,380,2242,9.6,0.30933654
1247,1247,Andrei Zyuzin,1999-00,22.0,3,4,25,25,3,1,4,44.0,398.0,81,9,8,17,116.0,82,5.27,57,359,2285,9.4,0.28509307
1248,1248,Andrei Zyuzin,2000-01,23.0,4,11,34,34,2,9,11,47.0,696.0,115,11,17,28,163.0,82,5.49,53,331,2294,9.8,0.3005851
1249,1249,Andrei Zyuzin,2001-02,24.0,5,20,64,64,4,16,20,92.0,1193.0,179,15,33,48,255.0,82,5.51,63,376,2272,9.9,0.26441345
1250,1250,Andrei Zyuzin,2002-03,25.0,6,5,47,47,1,4,5,61.0,750.0,226,16,37,53,316.0,82,5.24,53,338,2262,9.5,0.18954271
1251,1251,Andrei Zyuzin,2003-04,26.0,7,17,67,67,4,13,17,113.0,1448.0,293,20,50,70,429.0,82,5.31,60,363,2326,9.4,0.23737717
1252,1252,Andrei Zyuzin,2004-05,27.0,8,21,65,65,8,13,21,104.0,1324.0,358,28,63,91,533.0,82,5.14,57,348,2300,9.2,0.31029716
1253,1253,Andrei Zyuzin,2006-07,29.0,9,18,57,57,7,11,18,80.0,1076.0,415,35,74,109,613.0,82,6.05,85,480,2458,10.1,0.27195448
1254,1254,Andrei Zyuzin,2007-08,30.0,10,6,49,49,1,5,6,36.0,677.0,464,36,79,115,649.0,82,5.76,70,398,2426,9.7,0.15510976
1255,1255,Andrei Zyuzin,2008-09,31.0,11,5,32,32,2,3,5,34.0,479.0,496,38,82,120,683.0,82,5.44,62,351,2383,9.4,0.18354046
1256,1256,Andrej Meszaros,2006-07,21.0,2,39,82,82,10,29,39,137.0,1491.0,82,10,29,39,137.0,82,6.05,85,480,2458,10.1,0.5025049
1257,1257,Andrej Meszaros,2007-08,22.0,3,35,82,82,7,28,35,147.0,1778.0,164,17,57,74,284.0,82,5.76,70,398,2426,9.7,0.4495412
1258,1258,Andrej Meszaros,2008-09,23.0,4,36,82,82,9,27,36,160.0,1725.0,246,26,84,110,444.0,82,5.44,62,351,2383,9.4,0.49500084
1259,1259,Andrej Meszaros,2009-10,24.0,5,16,52,52,2,14,16,87.0,1257.0,298,28,98,126,531.0,82,5.7,65,341,2477,9.4,0.3665324
1260,1260,Andrej Meszaros,2010-11,25.0,6,17,81,81,6,11,17,145.0,1635.0,379,34,109,143,676.0,82,5.53,56,304,2486,9.1,0.3349026
1261,1261,Andrej Meszaros,2011-12,26.0,7,32,81,81,8,24,32,144.0,1711.0,460,42,133,175,820.0,82,5.46,52,291,2492,9.0,0.46375442
1262,1262,Andrej Meszaros,2012-13,27.0,8,25,62,62,7,18,25,114.0,1281.0,522,49,151,200,934.0,82,5.32,47,271,2439,8.9,0.3935794
1263,1263,Andrej Meszaros,2013-14,28.0,9,2,11,11,0,2,2,18.0,203.0,533,49,153,202,952.0,48,5.31,29,160,1399,9.1,0.2725161
1264,1264,Andrej Meszaros,2014-15,29.0,10,22,52,52,7,15,22,84.0,925.0,585,56,168,224,1036.0,82,5.34,48,269,2463,8.9,0.40630707
1265,1265,Andrej Meszaros,2015-16,30.0,11,14,60,60,7,7,14,67.0,1074.0,645,63,175,238,1103.0,82,5.32,47,251,2453,8.9,0.23242962
1266,1266,Andrej Nedorost,2002-03,22.0,2,2,7,7,0,2,2,12.0,91.0,7,0,2,2,12.0,82,5.24,53,338,2262,9.5,0.20748067
1267,1267,Andrej Nedorost,2003-04,23.0,3,1,12,12,0,1,1,10.0,111.0,19,0,3,3,22.0,82,5.31,60,363,2326,9.4,0.18282449
1268,1268,Andrej Nedorost,2004-05,24.0,4,2,9,9,2,0,2,16.0,117.0,28,2,3,5,38.0,82,5.14,57,348,2300,9.2,0.24076924
1269,1269,Andrej Nestrasil,2015-16,24.0,2,20,54,54,7,13,20,82.0,721.0,54,7,13,20,82.0,82,5.32,47,251,2453,8.9,0.38709795
1270,1270,Andrej Nestrasil,2016-17,25.0,3,23,55,55,9,14,23,105.0,789.0,109,16,27,43,187.0,82,5.34,48,255,2438,9.0,0.37539488
1271,1271,Andrej Nestrasil,2017-18,26.0,4,5,19,19,1,4,5,27.0,207.0,128,17,31,48,214.0,82,5.45,47,245,2478,9.0,0.22074467
1272,1272,Andrej Podkonicky,2001-02,23.0,2,1,6,6,1,0,1,5.0,36.0,6,1,0,1,5.0,82,5.51,63,376,2272,9.9,0.21237683
1273,1273,Andrej Podkonicky,2004-05,26.0,3,0,2,2,0,0,0,1.0,7.0,8,1,0,1,6.0,82,5.14,57,348,2300,9.2,0.16053483
1274,1274,Andrej Sekera,2007-08,21.0,2,0,2,2,0,0,0,0.0,15.0,2,0,0,0,0.0,82,5.76,70,398,2426,9.7,0.18428248
1275,1275,Andrej Sekera,2008-09,22.0,3,8,37,37,2,6,8,28.0,726.0,39,2,6,8,28.0,82,5.44,62,351,2383,9.4,0.23721519
1276,1276,Andrej Sekera,2009-10,23.0,4,19,69,69,3,16,19,84.0,1428.0,108,5,22,27,112.0,82,5.7,65,341,2477,9.4,0.28694415
1277,1277,Andrej Sekera,2010-11,24.0,5,11,49,49,4,7,11,59.0,855.0,157,9,29,38,171.0,82,5.53,56,304,2486,9.1,0.23593637
1278,1278,Andrej Sekera,2011-12,25.0,6,29,76,76,3,26,29,88.0,1603.0,233,12,55,67,259.0,82,5.46,52,291,2492,9.0,0.3276204
1279,1279,Andrej Sekera,2012-13,26.0,7,13,69,69,3,10,13,88.0,1353.0,302,15,65,80,347.0,82,5.32,47,271,2439,8.9,0.2035701
1280,1280,Andrej Sekera,2013-14,27.0,8,12,37,37,2,10,12,33.0,785.0,339,17,75,92,380.0,48,5.31,29,160,1399,9.1,0.24389163
1281,1281,Andrej Sekera,2014-15,28.0,9,44,74,74,11,33,44,142.0,1752.0,413,28,108,136,522.0,82,5.34,48,269,2463,8.9,0.4650081
1282,1282,Andrej Sekera,2015-16,29.0,10,23,73,73,3,20,23,100.0,1605.0,486,31,128,159,622.0,82,5.32,47,251,2453,8.9,0.27229846
1283,1283,Andrej Sekera,2016-17,30.0,11,30,81,81,6,24,30,155.0,1769.0,567,37,152,189,777.0,82,5.34,48,255,2438,9.0,0.38742822
1284,1284,Andrej Sekera,2017-18,31.0,12,35,80,80,8,27,35,128.0,1719.0,647,45,179,224,905.0,82,5.45,47,245,2478,9.0,0.34507275
1285,1285,Andrej Sekera,2018-19,32.0,13,8,36,36,0,8,8,36.0,588.0,683,45,187,232,941.0,82,5.86,50,250,2620,9.2,0.16536549
1286,1286,Andrej Sekera,2019-20,33.0,14,4,24,24,0,4,4,28.0,396.0,707,45,191,236,969.0,82,5.96,47,239,2579,9.5,0.17405653
1287,1287,Andrej Sekera,2020-21,34.0,15,8,57,57,2,6,8,63.0,1026.0,764,47,197,244,1032.0,70,5.96,42,208,2192,9.5,0.14859399
1288,1288,Andrej Sustr,2013-14,23.0,2,0,2,2,0,0,0,2.0,21.0,2,0,0,0,2.0,48,5.31,29,160,1399,9.1,0.20228621
1289,1289,Andrej Sustr,2014-15,24.0,3,8,43,43,1,7,8,39.0,679.0,45,1,7,8,41.0,82,5.34,48,269,2463,8.9,0.16298753
1290,1290,Andrej Sustr,2015-16,25.0,4,13,72,72,0,13,13,55.0,1275.0,117,1,20,21,96.0,82,5.32,47,251,2453,8.9,0.16862276
1291,1291,Andrej Sustr,2016-17,26.0,5,21,77,77,4,17,21,65.0,1296.0,194,5,37,42,161.0,82,5.34,48,255,2438,9.0,0.2118071
1292,1292,Andrej Sustr,2017-18,27.0,6,14,80,80,3,11,14,93.0,1407.0,274,8,48,56,254.0,82,5.45,47,245,2478,9.0,0.20013356
1293,1293,Andrej Sustr,2018-19,28.0,7,7,44,44,2,5,7,45.0,565.0,318,10,53,63,299.0,82,5.86,50,250,2620,9.2,0.15396646
1294,1294,Andrej Sustr,2019-20,29.0,8,0,5,5,0,0,0,6.0,60.0,323,10,53,63,305.0,82,5.96,47,239,2579,9.5,0.1506964
1295,1295,Andrew Agozzino,2015-16,25.0,2,1,1,1,0,1,1,1.0,10.0,1,0,1,1,1.0,82,5.32,47,251,2453,8.9,0.18236744
1296,1296,Andrew Agozzino,2016-17,26.0,3,2,9,9,0,2,2,3.0,77.0,10,0,3,3,4.0,82,5.34,48,255,2438,9.0,0.17569563
1297,1297,Andrew Agozzino,2019-20,29.0,4,2,11,11,1,1,2,11.0,86.0,21,1,4,5,15.0,82,5.96,47,239,2579,9.5,0.1788553
1298,1298,Andrew Agozzino,2020-21,30.0,5,3,22,22,1,2,3,10.0,162.0,43,2,6,8,25.0,70,5.96,42,208,2192,9.5,0.15085962
1299,1299,Andrew Alberts,2006-07,25.0,2,7,73,73,1,6,7,30.0,936.0,73,1,6,7,30.0,82,6.05,85,480,2458,10.1,0.1235106
1300,1300,Andrew Alberts,2007-08,26.0,3,10,76,76,0,10,10,41.0,1495.0,149,1,16,17,71.0,82,5.76,70,398,2426,9.7,0.13630313
1301,1301,Andrew Alberts,2008-09,27.0,4,2,35,35,0,2,2,25.0,722.0,184,1,18,19,96.0,82,5.44,62,351,2383,9.4,0.1358262
1302,1302,Andrew Alberts,2009-10,28.0,5,13,79,79,1,12,13,46.0,1248.0,263,2,30,32,142.0,82,5.7,65,341,2477,9.4,0.14253896
1303,1303,Andrew Alberts,2010-11,29.0,6,12,76,76,3,9,12,50.0,1169.0,339,5,39,44,192.0,82,5.53,56,304,2486,9.1,0.15097031
1304,1304,Andrew Alberts,2011-12,30.0,7,7,42,42,1,6,7,21.0,637.0,381,6,45,51,213.0,82,5.46,52,291,2492,9.0,0.1079171
1305,1305,Andrew Alberts,2012-13,31.0,8,3,44,44,2,1,3,19.0,629.0,425,8,46,54,232.0,82,5.32,47,271,2439,8.9,0.101165056
1306,1306,Andrew Alberts,2013-14,32.0,9,1,24,24,0,1,1,15.0,364.0,449,8,47,55,247.0,48,5.31,29,160,1399,9.1,0.0957382
1307,1307,Andrew Alberts,2014-15,33.0,10,0,10,10,0,0,0,5.0,74.0,459,8,47,55,252.0,82,5.34,48,269,2463,8.9,0.12249184
1308,1308,Andrew Bodnarchuk,2010-11,22.0,2,0,5,5,0,0,0,0.0,37.0,5,0,0,0,0.0,82,5.53,56,304,2486,9.1,0.16131172
1309,1309,Andrew Bodnarchuk,2016-17,28.0,3,4,37,37,0,4,4,9.0,457.0,42,0,4,4,9.0,82,5.34,48,255,2438,9.0,0.08457747
1310,1310,Andrew Brunette,1996-97,23.0,2,6,11,11,3,3,6,16.0,,11,3,3,6,16.0,82,6.29,74,413,2481,10.4,0.2895723
1311,1311,Andrew Brunette,1997-98,24.0,3,11,23,23,4,7,11,23.0,,34,7,10,17,39.0,82,5.83,55,336,2444,9.8,0.31053376
1312,1312,Andrew Brunette,1998-99,25.0,4,23,28,28,11,12,23,42.0,,62,18,22,40,81.0,82,5.28,57,380,2242,9.6,0.47537947
1313,1313,Andrew Brunette,1999-00,26.0,5,31,77,77,11,20,31,65.0,1018.0,139,29,42,71,146.0,82,5.27,57,359,2285,9.4,0.42416954
1314,1314,Andrew Brunette,2000-01,27.0,6,50,81,81,23,27,50,107.0,1272.0,220,52,69,121,253.0,82,5.49,53,331,2294,9.8,0.54948163
1315,1315,Andrew Brunette,2001-02,28.0,7,59,77,77,15,44,59,104.0,1307.0,297,67,113,180,357.0,82,5.51,63,376,2272,9.9,0.64725745
1316,1316,Andrew Brunette,2002-03,29.0,8,69,81,81,21,48,69,106.0,1299.0,378,88,161,249,463.0,82,5.24,53,338,2262,9.5,0.76142395
1317,1317,Andrew Brunette,2003-04,30.0,9,46,82,82,18,28,46,97.0,1187.0,460,106,189,295,560.0,82,5.31,60,363,2326,9.4,0.51358324
1318,1318,Andrew Brunette,2004-05,31.0,10,49,82,82,15,34,49,90.0,1273.0,542,121,223,344,650.0,82,5.14,57,348,2300,9.2,0.64008784
1319,1319,Andrew Brunette,2006-07,33.0,11,63,82,82,24,39,63,129.0,1231.0,624,145,262,407,779.0,82,6.05,85,480,2458,10.1,0.6889015
1320,1320,Andrew Brunette,2007-08,34.0,12,83,82,82,27,56,83,173.0,1436.0,706,172,318,490,952.0,82,5.76,70,398,2426,9.7,0.8096216
1321,1321,Andrew Brunette,2008-09,35.0,13,59,82,82,19,40,59,125.0,1275.0,788,191,358,549,1077.0,82,5.44,62,351,2383,9.4,0.6425575
1322,1322,Andrew Brunette,2009-10,36.0,14,50,80,80,22,28,50,118.0,1356.0,868,213,386,599,1195.0,82,5.7,65,341,2477,9.4,0.5369387
1323,1323,Andrew Brunette,2010-11,37.0,15,61,82,82,25,36,61,129.0,1396.0,950,238,422,660,1324.0,82,5.53,56,304,2486,9.1,0.59222853
1324,1324,Andrew Brunette,2011-12,38.0,16,46,82,82,18,28,46,117.0,1378.0,1032,256,450,706,1441.0,82,5.46,52,291,2492,9.0,0.4509552
1325,1325,Andrew Brunette,2012-13,39.0,17,27,78,78,12,15,27,75.0,1057.0,1110,268,465,733,1516.0,82,5.32,47,271,2439,8.9,0.25638682
1326,1326,Andrew Campbell,2014-15,26.0,2,0,3,3,0,0,0,4.0,38.0,3,0,0,0,4.0,82,5.34,48,269,2463,8.9,0.16342145
1327,1327,Andrew Campbell,2015-16,27.0,3,1,33,33,0,1,1,28.0,579.0,36,0,1,1,32.0,82,5.32,47,251,2453,8.9,0.14854643
1328,1328,Andrew Campbell,2016-17,28.0,4,1,6,6,0,1,1,1.0,70.0,42,0,2,2,33.0,82,5.34,48,255,2438,9.0,0.1348167
1329,1329,Andrew Cassels,1990-91,21.0,2,2,6,6,2,0,2,5.0,,6,2,0,2,5.0,80,7.37,76,367,2421,12.2,0.3374369
1330,1330,Andrew Cassels,1991-92,22.0,3,25,54,54,6,19,25,55.0,,60,8,19,27,60.0,80,6.91,71,366,2385,11.6,0.41391698
1331,1331,Andrew Cassels,1992-93,23.0,4,41,67,67,11,30,41,99.0,,127,19,49,68,159.0,80,6.96,77,402,2440,11.4,0.5448275
1332,1332,Andrew Cassels,1993-94,24.0,5,85,84,84,21,64,85,134.0,,211,40,113,153,293.0,84,7.25,87,443,2603,11.7,0.86679554
1333,1333,Andrew Cassels,1994-95,25.0,6,58,79,79,16,42,58,126.0,,290,56,155,211,419.0,84,6.48,76,407,2545,10.7,0.6162984
1334,1334,Andrew Cassels,1995-96,26.0,7,37,46,46,7,30,37,74.0,,336,63,185,248,493.0,48,5.97,37,209,1408,10.2,0.7939843
1335,1335,Andrew Cassels,1996-97,27.0,8,63,81,81,20,43,63,135.0,,417,83,228,311,628.0,82,6.29,74,413,2481,10.4,0.6721368
1336,1336,Andrew Cassels,1997-98,28.0,9,66,81,81,22,44,66,142.0,,498,105,272,377,770.0,82,5.83,55,336,2444,9.8,0.7490558
1337,1337,Andrew Cassels,1998-99,29.0,10,44,81,81,17,27,44,138.0,,579,122,299,421,908.0,82,5.28,57,380,2242,9.6,0.5258166
1338,1338,Andrew Cassels,1999-00,30.0,11,37,70,70,12,25,37,97.0,1328.0,649,134,324,458,1005.0,82,5.27,57,359,2285,9.4,0.52122366
1339,1339,Andrew Cassels,2000-01,31.0,12,62,79,79,17,45,62,109.0,1526.0,728,151,369,520,1114.0,82,5.49,53,331,2294,9.8,0.7466895
1340,1340,Andrew Cassels,2001-02,32.0,13,56,66,66,12,44,56,104.0,1278.0,794,163,413,576,1218.0,82,5.51,63,376,2272,9.9,0.7182318
1341,1341,Andrew Cassels,2002-03,33.0,14,50,53,53,11,39,50,64.0,925.0,847,174,452,626,1282.0,82,5.24,53,338,2262,9.5,0.68804806
1342,1342,Andrew Cassels,2003-04,34.0,15,68,79,79,20,48,68,113.0,1569.0,926,194,500,694,1395.0,82,5.31,60,363,2326,9.4,0.7060589
1343,1343,Andrew Cassels,2004-05,35.0,16,26,58,58,6,20,26,91.0,1119.0,984,200,520,720,1486.0,82,5.14,57,348,2300,9.2,0.45401073
1344,1344,Andrew Cassels,2006-07,37.0,17,12,31,31,4,8,12,29.0,410.0,1015,204,528,732,1515.0,82,6.05,85,480,2458,10.1,0.29088745
1345,1345,Andrew Cogliano,2008-09,21.0,2,45,82,82,18,27,45,98.0,1120.0,82,18,27,45,98.0,82,5.44,62,351,2383,9.4,0.5967884
1346,1346,Andrew Cogliano,2009-10,22.0,3,38,82,82,18,20,38,116.0,1181.0,164,36,47,83,214.0,82,5.7,65,341,2477,9.4,0.5105209
1347,1347,Andrew Cogliano,2010-11,23.0,4,28,82,82,10,18,28,139.0,1162.0,246,46,65,111,353.0,82,5.53,56,304,2486,9.1,0.44845766
1348,1348,Andrew Cogliano,2011-12,24.0,5,35,82,82,11,24,35,129.0,1415.0,328,57,89,146,482.0,82,5.46,52,291,2492,9.0,0.46007004
1349,1349,Andrew Cogliano,2012-13,25.0,6,26,82,82,13,13,26,115.0,1206.0,410,70,102,172,597.0,82,5.32,47,271,2439,8.9,0.44578132
1350,1350,Andrew Cogliano,2013-14,26.0,7,23,48,48,13,10,23,79.0,738.0,458,83,112,195,676.0,48,5.31,29,160,1399,9.1,0.49279568
1351,1351,Andrew Cogliano,2014-15,27.0,8,42,82,82,21,21,42,157.0,1262.0,540,104,133,237,833.0,82,5.34,48,269,2463,8.9,0.52088636
1352,1352,Andrew Cogliano,2015-16,28.0,9,29,82,82,15,14,29,134.0,1197.0,622,119,147,266,967.0,82,5.32,47,251,2453,8.9,0.3865411
1353,1353,Andrew Cogliano,2016-17,29.0,10,32,82,82,9,23,32,131.0,1183.0,704,128,170,298,1098.0,82,5.34,48,255,2438,9.0,0.41120422
1354,1354,Andrew Cogliano,2017-18,30.0,11,35,82,82,16,19,35,178.0,1241.0,786,144,189,333,1276.0,82,5.45,47,245,2478,9.0,0.45135435
1355,1355,Andrew Cogliano,2018-19,31.0,12,35,80,80,12,23,35,175.0,1216.0,866,156,212,368,1451.0,82,5.86,50,250,2620,9.2,0.4207175
1356,1356,Andrew Cogliano,2019-20,32.0,13,17,78,78,6,11,17,106.0,982.0,944,162,223,385,1557.0,82,5.96,47,239,2579,9.5,0.2560237
1357,1357,Andrew Cogliano,2020-21,33.0,14,14,68,68,3,11,14,68.0,848.0,1012,165,234,399,1625.0,70,5.96,42,208,2192,9.5,0.2365923
1358,1358,Andrew Copp,2015-16,21.0,2,1,1,1,0,1,1,4.0,13.0,1,0,1,1,4.0,82,5.32,47,251,2453,8.9,0.2606961
1359,1359,Andrew Copp,2016-17,22.0,3,13,77,77,7,6,13,54.0,616.0,78,7,7,14,58.0,82,5.34,48,255,2438,9.0,0.22558787
1360,1360,Andrew Copp,2017-18,23.0,4,17,64,64,9,8,17,77.0,790.0,142,16,15,31,135.0,82,5.45,47,245,2478,9.0,0.27056003
1361,1361,Andrew Copp,2018-19,24.0,5,28,82,82,9,19,28,96.0,1126.0,224,25,34,59,231.0,82,5.86,50,250,2620,9.2,0.34895098
1362,1362,Andrew Copp,2019-20,25.0,6,25,69,69,11,14,25,82.0,839.0,293,36,48,84,313.0,82,5.96,47,239,2579,9.5,0.31518167
1363,1363,Andrew Copp,2020-21,26.0,7,26,63,63,10,16,26,121.0,1115.0,356,46,64,110,434.0,70,5.96,42,208,2192,9.5,0.39837497
1364,1364,Andrew Crescenzi,2018-19,26.0,2,0,2,2,0,0,0,0.0,16.0,2,0,0,0,0.0,82,5.86,50,250,2620,9.2,0.14306575
1365,1365,Andrew Desjardins,2011-12,25.0,2,3,17,17,1,2,3,12.0,121.0,17,1,2,3,12.0,82,5.46,52,291,2492,9.0,0.19370192
1366,1366,Andrew Desjardins,2012-13,26.0,3,17,76,76,4,13,17,80.0,728.0,93,5,15,20,92.0,82,5.32,47,271,2439,8.9,0.22521788
1367,1367,Andrew Desjardins,2013-14,27.0,4,3,42,42,2,1,3,51.0,425.0,135,7,16,23,143.0,48,5.31,29,160,1399,9.1,0.17185262
1368,1368,Andrew Desjardins,2014-15,28.0,5,17,81,81,3,14,17,95.0,903.0,216,10,30,40,238.0,82,5.34,48,269,2463,8.9,0.20151156
1369,1369,Andrew Desjardins,2015-16,29.0,6,10,69,69,5,5,10,59.0,741.0,285,15,35,50,297.0,82,5.32,47,251,2453,8.9,0.1592322
1370,1370,Andrew Desjardins,2016-17,30.0,7,13,77,77,8,5,13,96.0,1030.0,362,23,40,63,393.0,82,5.34,48,255,2438,9.0,0.18644318
1371,1371,Andrew Desjardins,2017-18,31.0,8,1,46,46,0,1,1,46.0,432.0,408,23,41,64,439.0,82,5.45,47,245,2478,9.0,0.151818
1372,1372,Andrew Ebbett,2008-09,26.0,2,0,3,3,0,0,0,3.0,40.0,3,0,0,0,3.0,82,5.44,62,351,2383,9.4,0.17709354
1373,1373,Andrew Ebbett,2009-10,27.0,3,32,48,48,8,24,32,100.0,666.0,51,8,24,32,103.0,82,5.7,65,341,2477,9.4,0.5104093
1374,1374,Andrew Ebbett,2010-11,28.0,4,15,61,61,9,6,15,72.0,775.0,112,17,30,47,175.0,82,5.53,56,304,2486,9.1,0.26269406
1375,1375,Andrew Ebbett,2011-12,29.0,5,5,33,33,2,3,5,23.0,331.0,145,19,33,52,198.0,82,5.46,52,291,2492,9.0,0.22442171
1376,1376,Andrew Ebbett,2012-13,30.0,6,6,18,18,5,1,6,27.0,173.0,163,24,34,58,225.0,82,5.32,47,271,2439,8.9,0.25101125
1377,1377,Andrew Ebbett,2013-14,31.0,7,6,28,28,1,5,6,23.0,345.0,191,25,39,64,248.0,48,5.31,29,160,1399,9.1,0.1926963
1378,1378,Andrew Ebbett,2014-15,32.0,8,1,9,9,0,1,1,9.0,99.0,200,25,40,65,257.0,82,5.34,48,269,2463,8.9,0.19377616
1379,1379,Andrew Ebbett,2015-16,33.0,9,6,24,24,1,5,6,21.0,216.0,224,26,45,71,278.0,82,5.32,47,251,2453,8.9,0.17774782
1380,1380,Andrew Ference,2000-01,21.0,2,6,30,30,2,4,6,26.0,490.0,30,2,4,6,26.0,82,5.49,53,331,2294,9.8,0.26870626
1381,1381,Andrew Ference,2001-02,22.0,3,15,36,36,4,11,15,47.0,679.0,66,6,15,21,73.0,82,5.51,63,376,2272,9.9,0.32611287
1382,1382,Andrew Ference,2002-03,23.0,4,11,75,75,4,7,11,82.0,1392.0,141,10,22,32,155.0,82,5.24,53,338,2262,9.5,0.22439134
1383,1383,Andrew Ference,2003-04,24.0,5,8,38,38,1,7,8,39.0,712.0,179,11,29,40,194.0,82,5.31,60,363,2326,9.4,0.18309155
1384,1384,Andrew Ference,2004-05,25.0,6,16,72,72,4,12,16,86.0,1344.0,251,15,41,56,280.0,82,5.14,57,348,2300,9.2,0.25000957
1385,1385,Andrew Ference,2006-07,27.0,7,31,82,82,4,27,31,111.0,1652.0,333,19,68,87,391.0,82,6.05,85,480,2458,10.1,0.35970524
1386,1386,Andrew Ference,2007-08,28.0,8,15,80,80,3,12,15,80.0,1580.0,413,22,80,102,471.0,82,5.76,70,398,2426,9.7,0.22093505
1387,1387,Andrew Ference,2008-09,29.0,9,15,59,59,1,14,15,71.0,1312.0,472,23,94,117,542.0,82,5.44,62,351,2383,9.4,0.20886007
1388,1388,Andrew Ference,2009-10,30.0,10,16,47,47,1,15,16,72.0,1012.0,519,24,109,133,614.0,82,5.7,65,341,2477,9.4,0.26455116
1389,1389,Andrew Ference,2010-11,31.0,11,8,51,51,0,8,8,60.0,1005.0,570,24,117,141,674.0,82,5.53,56,304,2486,9.1,0.13463885
1390,1390,Andrew Ference,2011-12,32.0,12,15,70,70,3,12,15,78.0,1259.0,640,27,129,156,752.0,82,5.46,52,291,2492,9.0,0.17573074
1391,1391,Andrew Ference,2012-13,33.0,13,24,72,72,6,18,24,107.0,1360.0,712,33,147,180,859.0,82,5.32,47,271,2439,8.9,0.26959187
1392,1392,Andrew Ference,2013-14,34.0,14,13,48,48,4,9,13,66.0,936.0,760,37,156,193,925.0,48,5.31,29,160,1399,9.1,0.22217682
1393,1393,Andrew Ference,2014-15,35.0,15,18,71,71,3,15,18,77.0,1495.0,831,40,171,211,1002.0,82,5.34,48,269,2463,8.9,0.20022312
1394,1394,Andrew Ference,2015-16,36.0,16,14,70,70,3,11,14,58.0,1321.0,901,43,182,225,1060.0,82,5.32,47,251,2453,8.9,0.1307241
1395,1395,Andrew Ference,2016-17,37.0,17,0,6,6,0,0,0,4.0,78.0,907,43,182,225,1064.0,82,5.34,48,255,2438,9.0,0.112252355
1396,1396,Andrew Gordon,2009-10,24.0,2,0,1,1,0,0,0,1.0,7.0,1,0,0,0,1.0,82,5.7,65,341,2477,9.4,0.17428878
1397,1397,Andrew Gordon,2010-11,25.0,3,0,2,2,0,0,0,0.0,13.0,3,0,0,0,1.0,82,5.53,56,304,2486,9.1,0.15568885
1398,1398,Andrew Gordon,2011-12,26.0,4,2,9,9,1,1,2,5.0,78.0,12,1,1,2,6.0,82,5.46,52,291,2492,9.0,0.18282852
1399,1399,Andrew Gordon,2012-13,27.0,5,5,37,37,2,3,5,38.0,402.0,49,3,4,7,44.0,82,5.32,47,271,2439,8.9,0.1517671
1400,1400,Andrew Gordon,2013-14,28.0,6,0,6,6,0,0,0,2.0,51.0,55,3,4,7,46.0,48,5.31,29,160,1399,9.1,0.12664324
1401,1401,Andrew Hutchinson,2004-05,24.0,2,8,18,18,4,4,8,24.0,301.0,18,4,4,8,24.0,82,5.14,57,348,2300,9.2,0.30156302
1402,1402,Andrew Hutchinson,2006-07,26.0,3,11,36,36,3,8,11,33.0,373.0,54,7,12,19,57.0,82,6.05,85,480,2458,10.1,0.21848246
1403,1403,Andrew Hutchinson,2007-08,27.0,4,14,41,41,3,11,14,45.0,501.0,95,10,23,33,102.0,82,5.76,70,398,2426,9.7,0.23580372
1404,1404,Andrew Hutchinson,2009-10,29.0,5,5,40,40,2,3,5,58.0,574.0,135,12,26,38,160.0,82,5.7,65,341,2477,9.4,0.17485988
1405,1405,Andrew Hutchinson,2011-12,31.0,6,1,5,5,0,1,1,2.0,77.0,140,12,27,39,162.0,82,5.46,52,291,2492,9.0,0.124563664
1406,1406,Andrew Joudrey,2012-13,28.0,2,0,1,1,0,0,0,1.0,9.0,1,0,0,0,1.0,82,5.32,47,271,2439,8.9,0.14887348
1407,1407,Andrew Ladd,2006-07,21.0,2,11,29,29,6,5,11,43.0,324.0,29,6,5,11,43.0,82,6.05,85,480,2458,10.1,0.3577369
1408,1408,Andrew Ladd,2007-08,22.0,3,21,65,65,11,10,21,109.0,728.0,94,17,15,32,152.0,82,5.76,70,398,2426,9.7,0.34789592
1409,1409,Andrew Ladd,2008-09,23.0,4,30,63,63,14,16,30,131.0,804.0,157,31,31,62,283.0,82,5.44,62,351,2383,9.4,0.49267602
1410,1410,Andrew Ladd,2009-10,24.0,5,49,82,82,15,34,49,195.0,1180.0,239,46,65,111,478.0,82,5.7,65,341,2477,9.4,0.6061427
1411,1411,Andrew Ladd,2010-11,25.0,6,38,82,82,17,21,38,148.0,1123.0,321,63,86,149,626.0,82,5.53,56,304,2486,9.1,0.50863534
1412,1412,Andrew Ladd,2011-12,26.0,7,59,81,81,29,30,59,195.0,1626.0,402,92,116,208,821.0,82,5.46,52,291,2492,9.0,0.6640489
1413,1413,Andrew Ladd,2012-13,27.0,8,50,82,82,28,22,50,265.0,1604.0,484,120,138,258,1086.0,82,5.32,47,271,2439,8.9,0.6509337
1414,1414,Andrew Ladd,2013-14,28.0,9,46,48,48,18,28,46,121.0,945.0,532,138,166,304,1207.0,48,5.31,29,160,1399,9.1,0.77150494
1415,1415,Andrew Ladd,2014-15,29.0,10,54,78,78,23,31,54,189.0,1539.0,610,161,197,358,1396.0,82,5.34,48,269,2463,8.9,0.6223076
1416,1416,Andrew Ladd,2015-16,30.0,11,62,81,81,24,38,62,224.0,1626.0,691,185,235,420,1620.0,82,5.32,47,251,2453,8.9,0.71357477
1417,1417,Andrew Ladd,2016-17,31.0,12,46,78,78,25,21,46,181.0,1475.0,769,210,256,466,1801.0,82,5.34,48,255,2438,9.0,0.5522499
1418,1418,Andrew Ladd,2017-18,32.0,13,31,78,78,23,8,31,142.0,1262.0,847,233,264,497,1943.0,82,5.45,47,245,2478,9.0,0.40964097
1419,1419,Andrew Ladd,2018-19,33.0,14,29,73,73,12,17,29,112.0,1160.0,920,245,281,526,2055.0,82,5.86,50,250,2620,9.2,0.33140665
1420,1420,Andrew Ladd,2019-20,34.0,15,11,26,26,3,8,11,34.0,360.0,946,248,289,537,2089.0,82,5.96,47,239,2579,9.5,0.26627117
1421,1421,Andrew Ladd,2020-21,35.0,16,1,4,4,1,0,1,5.0,48.0,950,249,289,538,2094.0,70,5.96,42,208,2192,9.5,0.24248242
1422,1422,Andrew MacDonald,2009-10,23.0,2,0,3,3,0,0,0,1.0,31.0,3,0,0,0,1.0,82,5.7,65,341,2477,9.4,0.1756827
1423,1423,Andrew MacDonald,2010-11,24.0,3,7,46,46,1,6,7,43.0,924.0,49,1,6,7,44.0,82,5.53,56,304,2486,9.1,0.16711402
1424,1424,Andrew MacDonald,2011-12,25.0,4,27,60,60,4,23,27,72.0,1405.0,109,5,29,34,116.0,82,5.46,52,291,2492,9.0,0.35200554
1425,1425,Andrew MacDonald,2012-13,26.0,5,19,75,75,5,14,19,71.0,1753.0,184,10,43,53,187.0,82,5.32,47,271,2439,8.9,0.23330715
1426,1426,Andrew MacDonald,2013-14,27.0,6,12,48,48,3,9,12,45.0,1129.0,232,13,52,65,232.0,48,5.31,29,160,1399,9.1,0.24037644
1427,1427,Andrew MacDonald,2014-15,28.0,7,28,82,82,4,24,28,92.0,2020.0,314,17,76,93,324.0,82,5.34,48,269,2463,8.9,0.3102894
1428,1428,Andrew MacDonald,2015-16,29.0,8,12,58,58,2,10,12,62.0,1161.0,372,19,86,105,386.0,82,5.32,47,251,2453,8.9,0.21496776
1429,1429,Andrew MacDonald,2016-17,30.0,9,8,28,28,1,7,8,20.0,563.0,400,20,93,113,406.0,82,5.34,48,255,2438,9.0,0.20481959
1430,1430,Andrew MacDonald,2017-18,31.0,10,18,73,73,2,16,18,65.0,1468.0,473,22,109,131,471.0,82,5.45,47,245,2478,9.0,0.23150992
1431,1431,Andrew MacDonald,2018-19,32.0,11,21,66,66,6,15,21,82.0,1310.0,539,28,124,152,553.0,82,5.86,50,250,2620,9.2,0.25053936
1432,1432,Andrew MacDonald,2019-20,33.0,12,9,47,47,0,9,9,41.0,771.0,586,28,133,161,594.0,82,5.96,47,239,2579,9.5,0.12782377
1433,1433,Andrew MacWilliam,2015-16,25.0,2,2,12,12,0,2,2,5.0,185.0,12,0,2,2,5.0,82,5.32,47,251,2453,8.9,0.17308685
1434,1434,Andrew Mangiapane,2018-19,22.0,2,0,10,10,0,0,0,7.0,89.0,10,0,0,0,7.0,82,5.86,50,250,2620,9.2,0.17282125
1435,1435,Andrew Mangiapane,2019-20,23.0,3,13,44,44,8,5,13,65.0,464.0,54,8,5,13,72.0,82,5.96,47,239,2579,9.5,0.31705135
1436,1436,Andrew Mangiapane,2020-21,24.0,4,32,68,68,17,15,32,109.0,932.0,122,25,20,45,181.0,70,5.96,42,208,2192,9.5,0.4397393
1437,1437,Andrew McBain,1984-85,20.0,2,30,78,78,11,19,30,93.0,,78,11,19,30,93.0,80,7.89,74,336,2448,12.9,0.45073128
1438,1438,Andrew McBain,1985-86,21.0,3,22,77,77,7,15,22,64.0,,155,18,34,52,157.0,80,7.77,71,321,2447,12.7,0.3373301
1439,1439,Andrew McBain,1986-87,22.0,4,6,28,28,3,3,6,24.0,,183,21,37,58,181.0,80,7.94,82,370,2484,12.8,0.39884734
1440,1440,Andrew McBain,1987-88,23.0,5,32,71,71,11,21,32,85.0,,254,32,58,90,266.0,80,7.34,72,344,2400,12.2,0.45950487
1441,1441,Andrew McBain,1988-89,24.0,6,63,74,74,32,31,63,146.0,,328,64,89,153,412.0,80,7.43,89,437,2435,12.2,0.7790229
1442,1442,Andrew McBain,1989-90,25.0,7,77,80,80,37,40,77,180.0,,408,101,129,230,592.0,80,7.48,85,403,2430,12.3,0.78532463
1443,1443,Andrew McBain,1990-91,26.0,8,23,67,67,9,14,23,106.0,,475,110,143,253,698.0,80,7.37,76,367,2421,12.2,0.37379476
1444,1444,Andrew McBain,1991-92,27.0,9,5,13,13,0,5,5,8.0,,488,110,148,258,706.0,80,6.91,71,366,2385,11.6,0.3197025
1445,1445,Andrew McBain,1992-93,28.0,10,1,6,6,1,0,1,11.0,,494,111,148,259,717.0,80,6.96,77,402,2440,11.4,0.3164609
1446,1446,Andrew McBain,1993-94,29.0,11,23,59,59,7,16,23,71.0,,553,118,164,282,788.0,84,7.25,87,443,2603,11.7,0.3368832
1447,1447,Andrew McBain,1994-95,30.0,12,19,55,55,11,8,19,91.0,,608,129,172,301,879.0,84,6.48,76,407,2545,10.7,0.3405998
1448,1448,Andrew McKim,1993-94,23.0,2,4,7,7,1,3,4,12.0,,7,1,3,4,12.0,84,7.25,87,443,2603,11.7,0.2721579
1449,1449,Andrew McKim,1994-95,24.0,3,1,29,29,0,1,1,22.0,,36,1,4,5,34.0,84,6.48,76,407,2545,10.7,0.15237975
1450,1450,Andrew McKim,1995-96,25.0,4,0,2,2,0,0,0,0.0,,38,1,4,5,34.0,48,5.97,37,209,1408,10.2,0.16748756
1451,1451,Andrew Miller,2015-16,27.0,2,6,9,9,1,5,6,14.0,124.0,9,1,5,6,14.0,82,5.32,47,251,2453,8.9,0.23693639
1452,1452,Andrew Miller,2016-17,28.0,3,0,6,6,0,0,0,3.0,55.0,15,1,5,6,17.0,82,5.34,48,255,2438,9.0,0.14651904
1453,1453,Andrew Murray,2008-09,27.0,2,10,39,39,6,4,10,45.0,457.0,39,6,4,10,45.0,82,5.44,62,351,2383,9.4,0.24740648
1454,1454,Andrew Murray,2009-10,28.0,3,11,67,67,8,3,11,89.0,755.0,106,14,7,21,134.0,82,5.7,65,341,2477,9.4,0.2217496
1455,1455,Andrew Murray,2010-11,29.0,4,7,46,46,5,2,7,73.0,477.0,152,19,9,28,207.0,82,5.53,56,304,2486,9.1,0.21536767
1456,1456,Andrew Murray,2011-12,30.0,5,8,29,29,4,4,8,48.0,330.0,181,23,13,36,255.0,82,5.46,52,291,2492,9.0,0.21493635
1457,1457,Andrew Murray,2012-13,31.0,6,4,39,39,1,3,4,33.0,300.0,220,24,16,40,288.0,82,5.32,47,271,2439,8.9,0.13032421
1458,1458,Andrew Murray,2013-14,32.0,7,0,1,1,0,0,0,2.0,8.0,221,24,16,40,290.0,48,5.31,29,160,1399,9.1,0.169337
1459,1459,Andrew Peeke,2020-21,22.0,2,3,22,22,1,2,3,23.0,305.0,22,1,2,3,23.0,70,5.96,42,208,2192,9.5,0.25527838
1460,1460,Andrew Peters,2004-05,24.0,2,2,42,42,2,0,2,19.0,175.0,42,2,0,2,19.0,82,5.14,57,348,2300,9.2,0.13679364
1461,1461,Andrew Peters,2006-07,26.0,3,0,28,28,0,0,0,6.0,91.0,70,2,0,2,25.0,82,6.05,85,480,2458,10.1,0.1055851
1462,1462,Andrew Peters,2007-08,27.0,4,2,58,58,1,1,2,19.0,219.0,128,3,1,4,44.0,82,5.76,70,398,2426,9.7,0.084627986
1463,1463,Andrew Peters,2008-09,28.0,5,2,44,44,1,1,2,18.0,138.0,172,4,2,6,62.0,82,5.44,62,351,2383,9.4,0.09171316
1464,1464,Andrew Peters,2009-10,29.0,6,1,28,28,0,1,1,10.0,113.0,200,4,3,7,72.0,82,5.7,65,341,2477,9.4,0.0822832
1465,1465,Andrew Peters,2010-11,30.0,7,0,29,29,0,0,0,15.0,151.0,229,4,3,7,87.0,82,5.53,56,304,2486,9.1,0.08307934
1466,1466,Andrew Poturalski,2017-18,24.0,2,0,2,2,0,0,0,1.0,25.0,2,0,0,0,1.0,82,5.45,47,245,2478,9.0,0.17658868
1467,1467,Andrew Shaw,2012-13,21.0,2,23,37,37,12,11,23,74.0,563.0,37,12,11,23,74.0,82,5.32,47,271,2439,8.9,0.521932
1468,1468,Andrew Shaw,2013-14,22.0,3,15,48,48,9,6,15,64.0,722.0,85,21,17,38,138.0,48,5.31,29,160,1399,9.1,0.38397267
1469,1469,Andrew Shaw,2014-15,23.0,4,39,80,80,20,19,39,149.0,1255.0,165,41,36,77,287.0,82,5.34,48,269,2463,8.9,0.49915826
1470,1470,Andrew Shaw,2015-16,24.0,5,26,79,79,15,11,26,146.0,1181.0,244,56,47,103,433.0,82,5.32,47,251,2453,8.9,0.43432078
1471,1471,Andrew Shaw,2016-17,25.0,6,34,78,78,14,20,34,153.0,1143.0,322,70,67,137,586.0,82,5.34,48,255,2438,9.0,0.45514894
1472,1472,Andrew Shaw,2017-18,26.0,7,29,68,68,12,17,29,127.0,1034.0,390,82,84,166,713.0,82,5.45,47,245,2478,9.0,0.43777692
1473,1473,Andrew Shaw,2018-19,27.0,8,20,51,51,10,10,20,94.0,806.0,441,92,94,186,807.0,82,5.86,50,250,2620,9.2,0.42077917
1474,1474,Andrew Shaw,2019-20,28.0,9,47,63,63,19,28,47,135.0,1003.0,504,111,122,233,942.0,82,5.96,47,239,2579,9.5,0.6296197
1475,1475,Andrew Shaw,2020-21,29.0,10,10,26,26,3,7,10,46.0,376.0,530,114,129,243,988.0,70,5.96,42,208,2192,9.5,0.39257625
1476,1476,Andrey Pedan,2016-17,23.0,2,0,13,13,0,0,0,11.0,142.0,13,0,0,0,11.0,82,5.34,48,255,2438,9.0,0.18069187
1477,1477,Andy Andreoff,2015-16,24.0,2,3,18,18,2,1,3,14.0,154.0,18,2,1,3,14.0,82,5.32,47,251,2453,8.9,0.2128022
1478,1478,Andy Andreoff,2016-17,25.0,3,10,60,60,8,2,10,46.0,528.0,78,10,3,13,60.0,82,5.34,48,255,2438,9.0,0.19336846
1479,1479,Andy Andreoff,2017-18,26.0,4,2,36,36,0,2,2,38.0,381.0,114,10,5,15,98.0,82,5.45,47,245,2478,9.0,0.16816774
1480,1480,Andy Andreoff,2018-19,27.0,5,9,45,45,3,6,9,47.0,423.0,159,13,11,24,145.0,82,5.86,50,250,2620,9.2,0.14787143
1481,1481,Andy Andreoff,2020-21,29.0,6,1,14,14,0,1,1,14.0,119.0,173,13,12,25,159.0,70,5.96,42,208,2192,9.5,0.14918056
1482,1482,Andy Brickley,1983-84,22.0,2,2,3,3,1,1,2,7.0,,3,1,1,2,7.0,80,7.73,71,310,2444,12.7,0.309761
1483,1483,Andy Brickley,1984-85,23.0,3,38,50,50,18,20,38,75.0,,53,19,21,40,82.0,80,7.89,74,336,2448,12.9,0.6286712
1484,1484,Andy Brickley,1985-86,24.0,4,22,45,45,7,15,22,58.0,,98,26,36,62,140.0,80,7.77,71,321,2447,12.7,0.45961177
1485,1485,Andy Brickley,1987-88,26.0,5,23,51,51,11,12,23,55.0,,149,37,48,85,195.0,80,7.34,72,344,2400,12.2,0.4201471
1486,1486,Andy Brickley,1988-89,27.0,6,22,45,45,8,14,22,61.0,,194,45,62,107,256.0,80,7.43,89,437,2435,12.2,0.40562704
1487,1487,Andy Brickley,1989-90,28.0,7,35,71,71,13,22,35,98.0,,265,58,84,142,354.0,80,7.48,85,403,2430,12.3,0.4748278
1488,1488,Andy Brickley,1990-91,29.0,8,40,43,43,12,28,40,69.0,,308,70,112,182,423.0,80,7.37,76,367,2421,12.2,0.61623204
1489,1489,Andy Brickley,1991-92,30.0,9,11,40,40,2,9,11,28.0,,348,72,121,193,451.0,80,6.91,71,366,2385,11.6,0.45401663
1490,1490,Andy Brickley,1992-93,31.0,10,27,23,23,10,17,27,28.0,,371,82,138,220,479.0,80,6.96,77,402,2440,11.4,0.43385977
1491,1491,Andy Brickley,1993-94,32.0,11,2,12,12,0,2,2,5.0,,383,82,140,222,484.0,84,7.25,87,443,2603,11.7,0.2447893
1492,1492,Andy Brickley,1994-95,33.0,12,0,2,2,0,0,0,0.0,,385,82,140,222,484.0,84,6.48,76,407,2545,10.7,0.39756918
1493,1493,Andy Delmore,1999-00,23.0,2,1,2,2,0,1,1,2.0,41.0,2,0,1,1,2.0,82,5.27,57,359,2285,9.4,0.20873314
1494,1494,Andy Delmore,2000-01,24.0,3,7,27,27,2,5,7,55.0,467.0,29,2,6,8,57.0,82,5.49,53,331,2294,9.8,0.22736341
1495,1495,Andy Delmore,2001-02,25.0,4,14,66,66,5,9,14,119.0,1164.0,95,7,15,22,176.0,82,5.51,63,376,2272,9.9,0.23924363
1496,1496,Andy Delmore,2002-03,26.0,5,38,73,73,16,22,38,175.0,1436.0,168,23,37,60,351.0,82,5.24,53,338,2262,9.5,0.55676985
1497,1497,Andy Delmore,2003-04,27.0,6,34,71,71,18,16,34,149.0,1213.0,239,41,53,94,500.0,82,5.31,60,363,2326,9.4,0.46723497
1498,1498,Andy Delmore,2004-05,28.0,7,7,37,37,2,5,7,40.0,562.0,276,43,58,101,540.0,82,5.14,57,348,2300,9.2,0.24700075
1499,1499,Andy Delmore,2006-07,30.0,8,0,7,7,0,0,0,7.0,108.0,283,43,58,101,547.0,82,6.05,85,480,2458,10.1,0.2070826
1500,1500,Andy Greene,2007-08,25.0,2,6,23,23,1,5,6,23.0,328.0,23,1,5,6,23.0,82,5.76,70,398,2426,9.7,0.21515629
1501,1501,Andy Greene,2008-09,26.0,3,10,59,59,2,8,10,50.0,1151.0,82,3,13,16,73.0,82,5.44,62,351,2383,9.4,0.20113865
1502,1502,Andy Greene,2009-10,27.0,4,9,49,49,2,7,9,38.0,798.0,131,5,20,25,111.0,82,5.7,65,341,2477,9.4,0.15163198
1503,1503,Andy Greene,2010-11,28.0,5,37,78,78,6,31,37,86.0,1836.0,209,11,51,62,197.0,82,5.53,56,304,2486,9.1,0.3770154
1504,1504,Andy Greene,2011-12,29.0,6,23,82,82,4,19,23,91.0,1834.0,291,15,70,85,288.0,82,5.46,52,291,2492,9.0,0.23965946
1505,1505,Andy Greene,2012-13,30.0,7,16,56,56,1,15,16,53.0,1092.0,347,16,85,101,341.0,82,5.32,47,271,2439,8.9,0.24115631
1506,1506,Andy Greene,2013-14,31.0,8,16,48,48,4,12,16,63.0,1106.0,395,20,97,117,404.0,48,5.31,29,160,1399,9.1,0.30415672
1507,1507,Andy Greene,2014-15,32.0,9,32,82,82,8,24,32,134.0,2015.0,477,28,121,149,538.0,82,5.34,48,269,2463,8.9,0.35444993
1508,1508,Andy Greene,2015-16,33.0,10,22,82,82,3,19,22,83.0,1931.0,559,31,140,171,621.0,82,5.32,47,251,2453,8.9,0.21614325
1509,1509,Andy Greene,2016-17,34.0,11,13,82,82,4,9,13,63.0,1882.0,641,35,149,184,684.0,82,5.34,48,255,2438,9.0,0.15271828
1510,1510,Andy Greene,2017-18,35.0,12,13,66,66,4,9,13,83.0,1448.0,707,39,158,197,767.0,82,5.45,47,245,2478,9.0,0.15905249
1511,1511,Andy Greene,2018-19,36.0,13,13,81,81,3,10,13,93.0,1711.0,788,42,168,210,860.0,82,5.86,50,250,2620,9.2,0.17238966
1512,1512,Andy Greene,2019-20,37.0,14,25,82,82,5,20,25,104.0,1708.0,870,47,188,235,964.0,82,5.96,47,239,2579,9.5,0.23123887
1513,1513,Andy Greene,2020-21,38.0,15,14,63,63,2,12,14,60.0,1231.0,933,49,200,249,1024.0,70,5.96,42,208,2192,9.5,0.15662682
1514,1514,Andy Hilbert,2002-03,21.0,2,1,6,6,1,0,1,11.0,69.0,6,1,0,1,11.0,82,5.24,53,338,2262,9.5,0.23531562
1515,1515,Andy Hilbert,2003-04,22.0,3,3,14,14,0,3,3,22.0,161.0,20,1,3,4,33.0,82,5.31,60,363,2326,9.4,0.22097966
1516,1516,Andy Hilbert,2004-05,23.0,4,2,18,18,2,0,2,27.0,161.0,38,3,3,6,60.0,82,5.14,57,348,2300,9.2,0.2820156
1517,1517,Andy Hilbert,2006-07,25.0,5,27,47,47,12,15,27,101.0,614.0,85,15,18,33,161.0,82,6.05,85,480,2458,10.1,0.44451162
1518,1518,Andy Hilbert,2007-08,26.0,6,28,81,81,8,20,28,164.0,931.0,166,23,38,61,325.0,82,5.76,70,398,2426,9.7,0.37815067
1519,1519,Andy Hilbert,2008-09,27.0,7,16,70,70,8,8,16,127.0,943.0,236,31,46,77,452.0,82,5.44,62,351,2383,9.4,0.26631504
1520,1520,Andy Hilbert,2009-10,28.0,8,27,67,67,11,16,27,167.0,1082.0,303,42,62,104,619.0,82,5.7,65,341,2477,9.4,0.31706613
1521,1521,Andy Hilbert,2010-11,29.0,9,0,4,4,0,0,0,6.0,39.0,307,42,62,104,625.0,82,5.53,56,304,2486,9.1,0.22735894
1522,1522,Andy McDonald,2001-02,24.0,2,1,16,16,1,0,1,21.0,179.0,16,1,0,1,21.0,82,5.51,63,376,2272,9.9,0.20582455
1523,1523,Andy McDonald,2002-03,25.0,3,28,53,53,7,21,28,79.0,847.0,69,8,21,29,100.0,82,5.24,53,338,2262,9.5,0.4362687
1524,1524,Andy McDonald,2003-04,26.0,4,21,46,46,10,11,21,92.0,852.0,115,18,32,50,192.0,82,5.31,60,363,2326,9.4,0.39674366
1525,1525,Andy McDonald,2004-05,27.0,5,30,79,79,9,21,30,162.0,1308.0,194,27,53,80,354.0,82,5.14,57,348,2300,9.2,0.5778882
1526,1526,Andy McDonald,2006-07,29.0,6,85,82,82,34,51,85,229.0,1378.0,276,61,104,165,583.0,82,6.05,85,480,2458,10.1,0.8824527
1527,1527,Andy McDonald,2007-08,30.0,7,78,82,82,27,51,78,252.0,1442.0,358,88,155,243,835.0,82,5.76,70,398,2426,9.7,0.80097586
1528,1528,Andy McDonald,2008-09,31.0,8,52,82,82,18,34,52,182.0,1465.0,440,106,189,295,1017.0,82,5.44,62,351,2383,9.4,0.6109859
1529,1529,Andy McDonald,2009-10,32.0,9,44,46,46,15,29,44,128.0,877.0,486,121,218,339,1145.0,82,5.7,65,341,2477,9.4,0.73006344
1530,1530,Andy McDonald,2010-11,33.0,10,57,79,79,24,33,57,191.0,1432.0,565,145,251,396,1336.0,82,5.53,56,304,2486,9.1,0.6857474
1531,1531,Andy McDonald,2011-12,34.0,11,50,58,58,20,30,50,180.0,1162.0,623,165,281,446,1516.0,82,5.46,52,291,2492,9.0,0.69132745
1532,1532,Andy McDonald,2012-13,35.0,12,22,25,25,10,12,22,64.0,463.0,648,175,293,468,1580.0,82,5.32,47,271,2439,8.9,0.6907291
1533,1533,Andy McDonald,2013-14,36.0,13,21,37,37,7,14,21,86.0,638.0,685,182,307,489,1666.0,48,5.31,29,160,1399,9.1,0.50763065
1534,1534,Andy Miele,2012-13,24.0,2,0,7,7,0,0,0,4.0,63.0,7,0,0,0,4.0,82,5.32,47,271,2439,8.9,0.16555953
1535,1535,Andy Miele,2013-14,25.0,3,0,1,1,0,0,0,0.0,9.0,8,0,0,0,4.0,48,5.31,29,160,1399,9.1,0.17501658
1536,1536,Andy Miele,2014-15,26.0,4,2,7,7,0,2,2,6.0,65.0,15,0,2,2,10.0,82,5.34,48,269,2463,8.9,0.15993622
1537,1537,Andy Roach,2006-07,33.0,2,3,5,5,1,2,3,2.0,72.0,5,1,2,3,2.0,82,6.05,85,480,2458,10.1,0.19288632
1538,1538,Andy Rymsha,1992-93,24.0,2,0,6,6,0,0,0,4.0,,6,0,0,0,4.0,80,6.96,77,402,2440,11.4,0.21770963
1539,1539,Andy Schliebener,1982-83,20.0,2,1,22,22,0,1,1,19.0,,22,0,1,1,19.0,80,8.03,73,320,2489,12.9,0.2766667
1540,1540,Andy Schliebener,1984-85,22.0,3,12,51,51,2,10,12,62.0,,73,2,11,13,81.0,80,7.89,74,336,2448,12.9,0.27944887
1541,1541,Andy Schliebener,1985-86,23.0,4,0,11,11,0,0,0,6.0,,84,2,11,13,87.0,80,7.77,71,321,2447,12.7,0.21479538
1542,1542,Andy Schneider,1994-95,22.0,2,0,10,10,0,0,0,4.0,,10,0,0,0,4.0,84,6.48,76,407,2545,10.7,0.17668039
1543,1543,Andy Sutton,1999-00,24.0,2,3,31,31,0,3,3,24.0,402.0,31,0,3,3,24.0,82,5.27,57,359,2285,9.4,0.1891343
1544,1544,Andy Sutton,2000-01,25.0,3,2,40,40,1,1,2,29.0,518.0,71,1,4,5,53.0,82,5.49,53,331,2294,9.8,0.11807257
1545,1545,Andy Sutton,2001-02,26.0,4,7,69,69,3,4,7,64.0,891.0,140,4,8,12,117.0,82,5.51,63,376,2272,9.9,0.14799911
1546,1546,Andy Sutton,2002-03,27.0,5,10,43,43,2,8,10,41.0,578.0,183,6,16,22,158.0,82,5.24,53,338,2262,9.5,0.16694468
1547,1547,Andy Sutton,2003-04,28.0,6,21,53,53,3,18,21,65.0,954.0,236,9,34,43,223.0,82,5.31,60,363,2326,9.4,0.29738283
1548,1548,Andy Sutton,2004-05,29.0,7,21,65,65,8,13,21,102.0,1517.0,301,17,47,64,325.0,82,5.14,57,348,2300,9.2,0.2899034
1549,1549,Andy Sutton,2006-07,31.0,8,25,76,76,8,17,25,86.0,1602.0,377,25,64,89,411.0,82,6.05,85,480,2458,10.1,0.2654617
1550,1550,Andy Sutton,2007-08,32.0,9,16,55,55,2,14,16,51.0,1070.0,432,27,78,105,462.0,82,5.76,70,398,2426,9.7,0.23900908
1551,1551,Andy Sutton,2008-09,33.0,10,8,58,58,1,7,8,57.0,1053.0,490,28,85,113,519.0,82,5.44,62,351,2383,9.4,0.16032693
1552,1552,Andy Sutton,2009-10,34.0,11,10,23,23,2,8,10,19.0,465.0,513,30,93,123,538.0,82,5.7,65,341,2477,9.4,0.20862406
1553,1553,Andy Sutton,2010-11,35.0,12,13,72,72,5,8,13,77.0,1470.0,585,35,101,136,615.0,82,5.53,56,304,2486,9.1,0.1663056
1554,1554,Andy Sutton,2011-12,36.0,13,4,39,39,0,4,4,31.0,575.0,624,35,105,140,646.0,82,5.46,52,291,2492,9.0,0.11728355
1555,1555,Andy Sutton,2012-13,37.0,14,10,52,52,3,7,10,41.0,868.0,676,38,112,150,687.0,82,5.32,47,271,2439,8.9,0.14767611
1556,1556,Andy Welinski,2018-19,25.0,2,2,7,7,0,2,2,6.0,113.0,7,0,2,2,6.0,82,5.86,50,250,2620,9.2,0.17972994
1557,1557,Andy Welinski,2019-20,26.0,3,4,26,26,1,3,4,32.0,417.0,33,1,5,6,38.0,82,5.96,47,239,2579,9.5,0.19206864
1558,1558,Andy Wozniewski,2006-07,26.0,2,1,13,13,0,1,1,6.0,233.0,13,0,1,1,6.0,82,6.05,85,480,2458,10.1,0.16976297
1559,1559,Andy Wozniewski,2007-08,27.0,3,2,15,15,0,2,2,10.0,209.0,28,0,3,3,16.0,82,5.76,70,398,2426,9.7,0.16109014
1560,1560,Andy Wozniewski,2008-09,28.0,4,9,48,48,2,7,9,34.0,680.0,76,2,10,12,50.0,82,5.44,62,351,2383,9.4,0.14634126
1561,1561,Andy Wozniewski,2009-10,29.0,5,0,1,1,0,0,0,0.0,7.0,77,2,10,12,50.0,82,5.7,65,341,2477,9.4,0.13922825
1562,1562,Andy Wozniewski,2010-11,30.0,6,0,2,2,0,0,0,1.0,19.0,79,2,10,12,51.0,82,5.53,56,304,2486,9.1,0.12777868
1563,1563,Anson Carter,1997-98,23.0,2,18,38,38,11,7,18,79.0,,38,11,7,18,79.0,82,5.83,55,336,2444,9.8,0.45128927
1564,1564,Anson Carter,1998-99,24.0,3,43,78,78,16,27,43,179.0,,116,27,34,61,258.0,82,5.28,57,380,2242,9.6,0.551648
1565,1565,Anson Carter,1999-00,25.0,4,40,55,55,24,16,40,123.0,1030.0,171,51,50,101,381.0,82,5.27,57,359,2285,9.4,0.72787243
1566,1566,Anson Carter,2000-01,26.0,5,47,59,59,22,25,47,144.0,1211.0,230,73,75,148,525.0,82,5.49,53,331,2294,9.8,0.7398349
1567,1567,Anson Carter,2001-02,27.0,6,42,61,61,16,26,42,102.0,1111.0,291,89,101,190,627.0,82,5.51,63,376,2272,9.9,0.63063574
1568,1568,Anson Carter,2002-03,28.0,7,60,82,82,28,32,60,181.0,1583.0,373,117,133,250,808.0,82,5.24,53,338,2262,9.5,0.6880004
1569,1569,Anson Carter,2003-04,29.0,8,60,79,79,26,34,60,193.0,1532.0,452,143,167,310,1001.0,82,5.31,60,363,2326,9.4,0.6866931
1570,1570,Anson Carter,2004-05,30.0,9,28,77,77,15,13,28,114.0,1292.0,529,158,180,338,1115.0,82,5.14,57,348,2300,9.2,0.50283355
1571,1571,Anson Carter,2006-07,32.0,10,55,81,81,33,22,55,146.0,1179.0,610,191,202,393,1261.0,82,6.05,85,480,2458,10.1,0.6060102
1572,1572,Anson Carter,2007-08,33.0,11,28,64,64,11,17,28,70.0,901.0,674,202,219,421,1331.0,82,5.76,70,398,2426,9.7,0.34297448
1573,1573,Anssi Melametsa,1986-87,25.0,2,3,27,27,0,3,3,20.0,,27,0,3,3,20.0,80,7.94,82,370,2484,12.8,0.19383717
1574,1574,Anssi Salmela,2009-10,25.0,2,6,26,26,1,5,6,41.0,416.0,26,1,5,6,41.0,82,5.7,65,341,2477,9.4,0.20748743
1575,1575,Anssi Salmela,2010-11,26.0,3,8,38,38,2,6,8,41.0,512.0,64,3,11,14,82.0,82,5.53,56,304,2486,9.1,0.18221816
1576,1576,Anssi Salmela,2011-12,27.0,4,7,48,48,1,6,7,57.0,835.0,112,4,17,21,139.0,82,5.46,52,291,2492,9.0,0.16359201
1577,1577,Antero Lehtonen,1980-81,26.0,2,21,65,65,9,12,21,101.0,,65,9,12,21,101.0,80,7.03,61,280,2352,12.0,0.33248872
1578,1578,Anthony Angello,2020-21,24.0,2,1,8,8,1,0,1,5.0,46.0,8,1,0,1,5.0,70,5.96,42,208,2192,9.5,0.22876143
1579,1579,Anthony Beauvillier,2017-18,20.0,2,24,66,66,9,15,24,101.0,859.0,66,9,15,24,101.0,82,5.45,47,245,2478,9.0,0.4023084
1580,1580,Anthony Beauvillier,2018-19,21.0,3,36,71,71,21,15,36,132.0,1031.0,137,30,30,60,233.0,82,5.86,50,250,2620,9.2,0.50687766
1581,1581,Anthony Beauvillier,2019-20,22.0,4,28,81,81,18,10,28,156.0,1186.0,218,48,40,88,389.0,82,5.96,47,239,2579,9.5,0.4872758
1582,1582,Anthony Beauvillier,2020-21,23.0,5,39,68,68,18,21,39,132.0,1174.0,286,66,61,127,521.0,70,5.96,42,208,2192,9.5,0.6063365
1583,1583,Anthony Bitetto,2015-16,25.0,2,0,7,7,0,0,0,2.0,82.0,7,0,0,0,2.0,82,5.32,47,251,2453,8.9,0.16342145
1584,1584,Anthony Bitetto,2016-17,26.0,3,6,28,28,1,5,6,19.0,340.0,35,1,5,6,21.0,82,5.34,48,255,2438,9.0,0.1651969
1585,1585,Anthony Bitetto,2017-18,27.0,4,7,29,29,0,7,7,17.0,342.0,64,1,12,13,38.0,82,5.45,47,245,2478,9.0,0.14045453
1586,1586,Anthony Bitetto,2018-19,28.0,5,3,32,32,1,2,3,25.0,430.0,96,2,14,16,63.0,82,5.86,50,250,2620,9.2,0.16420582
1587,1587,Anthony Bitetto,2019-20,29.0,6,3,36,36,0,3,3,30.0,429.0,132,2,17,19,93.0,82,5.96,47,239,2579,9.5,0.10980177
1588,1588,Anthony Bitetto,2020-21,30.0,7,8,51,51,0,8,8,54.0,773.0,183,2,25,27,147.0,70,5.96,42,208,2192,9.5,0.14636248
1589,1589,Anthony Cirelli,2018-19,21.0,2,11,18,18,5,6,11,26.0,238.0,18,5,6,11,26.0,82,5.86,50,250,2620,9.2,0.37485904
1590,1590,Anthony Cirelli,2019-20,22.0,3,39,82,82,19,20,39,123.0,1217.0,100,24,26,50,149.0,82,5.96,47,239,2579,9.5,0.5274062
1591,1591,Anthony Cirelli,2020-21,23.0,4,44,68,68,16,28,44,113.0,1255.0,168,40,54,94,262.0,70,5.96,42,208,2192,9.5,0.6020905
1592,1592,Anthony DeAngelo,2017-18,22.0,2,14,39,39,5,9,14,60.0,667.0,39,5,9,14,60.0,82,5.45,47,245,2478,9.0,0.32936686
1593,1593,Anthony DeAngelo,2018-19,23.0,3,8,32,32,0,8,8,68.0,530.0,71,5,17,22,128.0,82,5.86,50,250,2620,9.2,0.2747022
1594,1594,Anthony DeAngelo,2019-20,24.0,4,30,61,61,4,26,30,111.0,1179.0,132,9,43,52,239.0,82,5.96,47,239,2579,9.5,0.41700205
1595,1595,Anthony DeAngelo,2020-21,25.0,5,53,68,68,15,38,53,149.0,1312.0,200,24,81,105,388.0,70,5.96,42,208,2192,9.5,0.73588586
1596,1596,Anthony Duclair,2015-16,20.0,2,7,18,18,1,6,7,18.0,219.0,18,1,6,7,18.0,82,5.32,47,251,2453,8.9,0.2898581
1597,1597,Anthony Duclair,2016-17,21.0,3,44,81,81,20,24,44,105.0,1164.0,99,21,30,51,123.0,82,5.34,48,255,2438,9.0,0.5797612
1598,1598,Anthony Duclair,2017-18,22.0,4,15,58,58,5,10,15,76.0,771.0,157,26,40,66,199.0,82,5.45,47,245,2478,9.0,0.33260873
1599,1599,Anthony Duclair,2018-19,23.0,5,23,56,56,11,12,23,97.0,744.0,213,37,52,89,296.0,82,5.86,50,250,2620,9.2,0.47378683
1600,1600,Anthony Duclair,2019-20,24.0,6,33,74,74,19,14,33,132.0,940.0,287,56,66,122,428.0,82,5.96,47,239,2579,9.5,0.4607617
1601,1601,Anthony Duclair,2020-21,25.0,7,40,66,66,23,17,40,184.0,1073.0,353,79,83,162,612.0,70,5.96,42,208,2192,9.5,0.65241086
1602,1602,Anthony Greco,2019-20,26.0,2,0,1,1,0,0,0,2.0,10.0,1,0,0,0,2.0,82,5.96,47,239,2579,9.5,0.17333889
1603,1603,Anthony Mantha,2016-17,22.0,2,3,10,10,2,1,3,18.0,117.0,10,2,1,3,18.0,82,5.34,48,255,2438,9.0,0.2631538
1604,1604,Anthony Mantha,2017-18,23.0,3,36,60,60,17,19,36,133.0,954.0,70,19,20,39,151.0,82,5.45,47,245,2478,9.0,0.53924704
1605,1605,Anthony Mantha,2018-19,24.0,4,48,80,80,24,24,48,190.0,1384.0,150,43,44,87,341.0,82,5.86,50,250,2620,9.2,0.6303308
1606,1606,Anthony Mantha,2019-20,25.0,5,48,67,67,25,23,48,198.0,1194.0,217,68,67,135,539.0,82,5.96,47,239,2579,9.5,0.7042651
1607,1607,Anthony Mantha,2020-21,26.0,6,38,43,43,16,22,38,137.0,812.0,260,84,89,173,676.0,70,5.96,42,208,2192,9.5,0.7663061
1608,1608,Anthony Peluso,2013-14,24.0,2,2,5,5,0,2,2,4.0,25.0,5,0,2,2,4.0,48,5.31,29,160,1399,9.1,0.22100452
1609,1609,Anthony Peluso,2014-15,25.0,3,5,53,53,2,3,5,24.0,306.0,58,2,5,7,28.0,82,5.34,48,269,2463,8.9,0.10899362
1610,1610,Anthony Peluso,2015-16,26.0,4,2,49,49,1,1,2,23.0,288.0,107,3,6,9,51.0,82,5.32,47,251,2453,8.9,0.116012156
1611,1611,Anthony Peluso,2016-17,27.0,5,5,35,35,1,4,5,16.0,223.0,142,4,10,14,67.0,82,5.34,48,255,2438,9.0,0.12177938
1612,1612,Anthony Peluso,2018-19,29.0,6,0,2,2,0,0,0,0.0,9.0,144,4,10,14,67.0,82,5.86,50,250,2620,9.2,0.124441385
1613,1613,Anthony Peluso,2019-20,30.0,7,0,4,4,0,0,0,1.0,16.0,148,4,10,14,68.0,82,5.96,47,239,2579,9.5,0.111179054
1614,1614,Anthony Richard,2019-20,23.0,2,0,1,1,0,0,0,0.0,7.0,1,0,0,0,0.0,82,5.96,47,239,2579,9.5,0.1702128
1615,1615,Anthony Richard,2020-21,24.0,3,0,1,1,0,0,0,2.0,4.0,2,0,0,0,2.0,70,5.96,42,208,2192,9.5,0.19498473
1616,1616,Anthony Stewart,2006-07,22.0,2,3,10,10,2,1,3,16.0,72.0,10,2,1,3,16.0,82,6.05,85,480,2458,10.1,0.26644492
1617,1617,Anthony Stewart,2007-08,23.0,3,1,10,10,0,1,1,8.0,69.0,20,2,2,4,24.0,82,5.76,70,398,2426,9.7,0.18478245
1618,1618,Anthony Stewart,2008-09,24.0,4,1,26,26,0,1,1,21.0,160.0,46,2,3,5,45.0,82,5.44,62,351,2383,9.4,0.15173045
1619,1619,Anthony Stewart,2009-10,25.0,5,7,59,59,2,5,7,56.0,451.0,105,4,8,12,101.0,82,5.7,65,341,2477,9.4,0.17109296
1620,1620,Anthony Stewart,2011-12,27.0,6,39,80,80,14,25,39,141.0,1198.0,185,18,33,51,242.0,82,5.46,52,291,2492,9.0,0.4238063
1621,1621,Anthony Stewart,2012-13,28.0,7,20,77,77,9,11,20,64.0,626.0,262,27,44,71,306.0,82,5.32,47,271,2439,8.9,0.23323214
1622,1622,Antoine Roussel,2013-14,24.0,2,14,39,39,7,7,14,46.0,367.0,39,7,7,14,46.0,48,5.31,29,160,1399,9.1,0.35638475
1623,1623,Antoine Roussel,2014-15,25.0,3,29,81,81,14,15,29,113.0,1080.0,120,21,22,43,159.0,82,5.34,48,269,2463,8.9,0.36907673
1624,1624,Antoine Roussel,2015-16,26.0,4,25,80,80,13,12,25,113.0,1162.0,200,34,34,68,272.0,82,5.32,47,251,2453,8.9,0.34424615
1625,1625,Antoine Roussel,2016-17,27.0,5,29,80,80,13,16,29,111.0,1109.0,280,47,50,97,383.0,82,5.34,48,255,2438,9.0,0.3644158
1626,1626,Antoine Roussel,2017-18,28.0,6,27,60,60,12,15,27,82.0,931.0,340,59,65,124,465.0,82,5.45,47,245,2478,9.0,0.34543842
1627,1627,Antoine Roussel,2018-19,29.0,7,17,73,73,5,12,17,85.0,908.0,413,64,77,141,550.0,82,5.86,50,250,2620,9.2,0.2531684
1628,1628,Antoine Roussel,2019-20,30.0,8,31,65,65,9,22,31,84.0,894.0,478,73,99,172,634.0,82,5.96,47,239,2579,9.5,0.374345
1629,1629,Antoine Roussel,2020-21,31.0,9,13,41,41,7,6,13,55.0,485.0,519,80,105,185,689.0,70,5.96,42,208,2192,9.5,0.33455235
1630,1630,Antoine Vermette,2004-05,22.0,2,14,57,57,7,7,14,63.0,684.0,57,7,7,14,63.0,82,5.14,57,348,2300,9.2,0.31657913
1631,1631,Antoine Vermette,2006-07,24.0,3,33,82,82,21,12,33,123.0,1031.0,139,28,19,47,186.0,82,6.05,85,480,2458,10.1,0.42230296
1632,1632,Antoine Vermette,2007-08,25.0,4,39,77,77,19,20,39,151.0,1210.0,216,47,39,86,337.0,82,5.76,70,398,2426,9.7,0.49967486
1633,1633,Antoine Vermette,2008-09,26.0,5,53,81,81,24,29,53,175.0,1424.0,297,71,68,139,512.0,82,5.44,62,351,2383,9.4,0.6417898
1634,1634,Antoine Vermette,2009-10,27.0,6,41,79,79,16,25,41,174.0,1450.0,376,87,93,180,686.0,82,5.7,65,341,2477,9.4,0.52590877
1635,1635,Antoine Vermette,2010-11,28.0,7,65,82,82,27,38,65,156.0,1652.0,458,114,131,245,842.0,82,5.53,56,304,2486,9.1,0.68489844
1636,1636,Antoine Vermette,2011-12,29.0,8,47,82,82,19,28,47,183.0,1543.0,540,133,159,292,1025.0,82,5.46,52,291,2492,9.0,0.5726621
1637,1637,Antoine Vermette,2012-13,30.0,9,37,82,82,11,26,37,149.0,1411.0,622,144,185,329,1174.0,82,5.32,47,271,2439,8.9,0.48727125
1638,1638,Antoine Vermette,2013-14,31.0,10,21,48,48,13,8,21,91.0,876.0,670,157,193,350,1265.0,48,5.31,29,160,1399,9.1,0.44317153
1639,1639,Antoine Vermette,2014-15,32.0,11,45,82,82,24,21,45,160.0,1575.0,752,181,214,395,1425.0,82,5.34,48,269,2463,8.9,0.51618826
1640,1640,Antoine Vermette,2015-16,33.0,12,38,82,82,13,25,38,109.0,1463.0,834,194,239,433,1534.0,82,5.32,47,251,2453,8.9,0.43497086
1641,1641,Antoine Vermette,2016-17,34.0,13,38,76,76,17,21,38,123.0,1265.0,910,211,260,471,1657.0,82,5.34,48,255,2438,9.0,0.41824967
1642,1642,Antoine Vermette,2017-18,35.0,14,28,72,72,9,19,28,88.0,1145.0,982,220,279,499,1745.0,82,5.45,47,245,2478,9.0,0.30682367
1643,1643,Antoine Vermette,2018-19,36.0,15,16,64,64,8,8,16,91.0,880.0,1046,228,287,515,1836.0,82,5.86,50,250,2620,9.2,0.26981705
1644,1644,Anton Babchuk,2004-05,20.0,2,2,5,5,0,2,2,11.0,64.0,5,0,2,2,11.0,82,5.14,57,348,2300,9.2,0.27958998
1645,1645,Anton Babchuk,2006-07,22.0,3,10,39,39,5,5,10,56.0,577.0,44,5,7,12,67.0,82,6.05,85,480,2458,10.1,0.28500533
1646,1646,Anton Babchuk,2007-08,23.0,4,14,52,52,2,12,14,63.0,906.0,96,7,19,26,130.0,82,5.76,70,398,2426,9.7,0.2883496
1647,1647,Anton Babchuk,2009-10,25.0,5,35,72,72,16,19,35,127.0,1301.0,168,23,38,61,257.0,82,5.7,65,341,2477,9.4,0.4204476
1648,1648,Anton Babchuk,2011-12,27.0,6,35,82,82,11,24,35,132.0,1340.0,250,34,62,96,389.0,82,5.46,52,291,2492,9.0,0.4031116
1649,1649,Anton Babchuk,2012-13,28.0,7,10,32,32,2,8,10,48.0,464.0,282,36,70,106,437.0,82,5.32,47,271,2439,8.9,0.2536363
1650,1650,Anton Babchuk,2013-14,29.0,8,1,7,7,0,1,1,5.0,83.0,289,36,71,107,442.0,48,5.31,29,160,1399,9.1,0.21535039
1651,1651,Anton Belov,2014-15,28.0,2,7,57,57,1,6,7,54.0,951.0,57,1,6,7,54.0,82,5.34,48,269,2463,8.9,0.15195242
1652,1652,Anton Blidh,2017-18,22.0,2,2,19,19,1,1,2,26.0,167.0,19,1,1,2,26.0,82,5.45,47,245,2478,9.0,0.21761295
1653,1653,Anton Blidh,2018-19,23.0,3,0,1,1,0,0,0,0.0,10.0,20,1,1,2,26.0,82,5.86,50,250,2620,9.2,0.15502292
1654,1654,Anton Blidh,2019-20,24.0,4,0,1,1,0,0,0,0.0,14.0,21,1,1,2,26.0,82,5.96,47,239,2579,9.5,0.15995267
1655,1655,Anton Blidh,2020-21,25.0,5,0,7,7,0,0,0,9.0,81.0,28,1,1,2,35.0,70,5.96,42,208,2192,9.5,0.23980826
1656,1656,Anton Klementyev,2010-11,20.0,2,0,1,1,0,0,0,0.0,6.0,1,0,0,0,0.0,82,5.53,56,304,2486,9.1,0.23860925
1657,1657,Anton Lander,2012-13,21.0,2,6,56,56,2,4,6,54.0,594.0,56,2,4,6,54.0,82,5.32,47,271,2439,8.9,0.2195656
1658,1658,Anton Lander,2013-14,22.0,3,1,11,11,0,1,1,11.0,121.0,67,2,5,7,65.0,48,5.31,29,160,1399,9.1,0.21621922
1659,1659,Anton Lander,2014-15,23.0,4,1,27,27,0,1,1,18.0,368.0,94,2,6,8,83.0,82,5.34,48,269,2463,8.9,0.16679344
1660,1660,Anton Lander,2015-16,24.0,5,20,38,38,6,14,20,61.0,570.0,132,8,20,28,144.0,82,5.32,47,251,2453,8.9,0.35583642
1661,1661,Anton Lander,2016-17,25.0,6,3,61,61,1,2,3,54.0,737.0,193,9,22,31,198.0,82,5.34,48,255,2438,9.0,0.15222007
1662,1662,Anton Lander,2017-18,26.0,7,4,22,22,1,3,4,12.0,215.0,215,10,25,35,210.0,82,5.45,47,245,2478,9.0,0.12523225
1663,1663,Anton Lindholm,2017-18,23.0,2,0,12,12,0,0,0,7.0,177.0,12,0,0,0,7.0,82,5.45,47,245,2478,9.0,0.17263487
1664,1664,Anton Lindholm,2018-19,24.0,3,4,48,48,0,4,4,22.0,632.0,60,0,4,4,29.0,82,5.86,50,250,2620,9.2,0.10013223
1665,1665,Anton Lindholm,2019-20,25.0,4,0,2,2,0,0,0,0.0,14.0,62,0,4,4,29.0,82,5.96,47,239,2579,9.5,0.13578624
1666,1666,Anton Lindholm,2020-21,26.0,5,1,4,4,0,1,1,1.0,47.0,66,0,5,5,30.0,70,5.96,42,208,2192,9.5,0.16392964
1667,1667,Anton Rodin,2017-18,27.0,2,1,3,3,0,1,1,2.0,27.0,3,0,1,1,2.0,82,5.45,47,245,2478,9.0,0.17439914
1668,1668,Anton Slepyshev,2016-17,22.0,2,1,11,11,0,1,1,5.0,96.0,11,0,1,1,5.0,82,5.34,48,255,2438,9.0,0.18877718
1669,1669,Anton Slepyshev,2017-18,23.0,3,10,41,41,4,6,10,55.0,456.0,52,4,7,11,60.0,82,5.45,47,245,2478,9.0,0.265401
1670,1670,Anton Slepyshev,2018-19,24.0,4,12,50,50,6,6,12,73.0,591.0,102,10,13,23,133.0,82,5.86,50,250,2620,9.2,0.2966943
1671,1671,Anton Stastny,1981-82,22.0,2,85,80,80,39,46,85,177.0,,80,39,46,85,177.0,80,7.69,77,340,2441,12.6,1.1231883
1672,1672,Anton Stastny,1982-83,23.0,3,72,68,68,26,46,72,137.0,,148,65,92,157,314.0,80,8.03,73,320,2489,12.9,0.9275701
1673,1673,Anton Stastny,1983-84,24.0,4,92,79,79,32,60,92,166.0,,227,97,152,249,480.0,80,7.73,71,310,2444,12.7,1.0805643
1674,1674,Anton Stastny,1984-85,25.0,5,62,69,69,25,37,62,147.0,,296,122,189,311,627.0,80,7.89,74,336,2448,12.9,0.8418244
1675,1675,Anton Stastny,1985-86,26.0,6,80,79,79,38,42,80,176.0,,375,160,231,391,803.0,80,7.77,71,321,2447,12.7,0.9883916
1676,1676,Anton Stastny,1986-87,27.0,7,74,74,74,31,43,74,163.0,,449,191,274,465,966.0,80,7.94,82,370,2484,12.8,0.8254713
1677,1677,Anton Stastny,1987-88,28.0,8,62,77,77,27,35,62,178.0,,526,218,309,527,1144.0,80,7.34,72,344,2400,12.2,0.8375527
1678,1678,Anton Stastny,1988-89,29.0,9,72,69,69,27,45,72,177.0,,595,245,354,599,1321.0,80,7.43,89,437,2435,12.2,0.8805228
1679,1679,Anton Stastny,1989-90,30.0,10,37,55,55,7,30,37,84.0,,650,252,384,636,1405.0,80,7.48,85,403,2430,12.3,0.63162917
1680,1680,Anton Stralman,2008-09,22.0,2,9,50,50,3,6,9,40.0,641.0,50,3,6,9,40.0,82,5.44,62,351,2383,9.4,0.21392852
1681,1681,Anton Stralman,2009-10,23.0,3,13,38,38,1,12,13,43.0,592.0,88,4,18,22,83.0,82,5.7,65,341,2477,9.4,0.2708676
1682,1682,Anton Stralman,2010-11,24.0,4,34,73,73,6,28,34,121.0,1496.0,161,10,46,56,204.0,82,5.53,56,304,2486,9.1,0.3885514
1683,1683,Anton Stralman,2011-12,25.0,5,18,51,51,1,17,18,80.0,1006.0,212,11,63,74,284.0,82,5.46,52,291,2492,9.0,0.3328091
1684,1684,Anton Stralman,2012-13,26.0,6,18,53,53,2,16,18,55.0,906.0,265,13,79,92,339.0,82,5.32,47,271,2439,8.9,0.32394367
1685,1685,Anton Stralman,2013-14,27.0,7,7,48,48,4,3,7,66.0,866.0,313,17,82,99,405.0,48,5.31,29,160,1399,9.1,0.21805266
1686,1686,Anton Stralman,2014-15,28.0,8,13,81,81,1,12,13,104.0,1571.0,394,18,94,112,509.0,82,5.34,48,269,2463,8.9,0.21954593
1687,1687,Anton Stralman,2015-16,29.0,9,39,82,82,9,30,39,138.0,1800.0,476,27,124,151,647.0,82,5.32,47,251,2453,8.9,0.41754264
1688,1688,Anton Stralman,2016-17,30.0,10,34,73,73,9,25,34,127.0,1612.0,549,36,149,185,774.0,82,5.34,48,255,2438,9.0,0.37388486
1689,1689,Anton Stralman,2017-18,31.0,11,22,73,73,5,17,22,130.0,1672.0,622,41,166,207,904.0,82,5.45,47,245,2478,9.0,0.28366333
1690,1690,Anton Stralman,2018-19,32.0,12,18,80,80,4,14,18,131.0,1719.0,702,45,180,225,1035.0,82,5.86,50,250,2620,9.2,0.2624179
1691,1691,Anton Stralman,2019-20,33.0,13,17,47,47,2,15,17,57.0,965.0,749,47,195,242,1092.0,82,5.96,47,239,2579,9.5,0.2638435
1692,1692,Anton Stralman,2020-21,34.0,14,19,69,69,5,14,19,89.0,1454.0,818,52,209,261,1181.0,70,5.96,42,208,2192,9.5,0.25478327
1693,1693,Anton Volchenkov,2003-04,21.0,2,16,57,57,3,13,16,75.0,884.0,57,3,13,16,75.0,82,5.31,60,363,2326,9.4,0.32393244
1694,1694,Anton Volchenkov,2004-05,22.0,3,3,19,19,1,2,3,15.0,248.0,76,4,15,19,90.0,82,5.14,57,348,2300,9.2,0.28207874
1695,1695,Anton Volchenkov,2006-07,24.0,4,17,75,75,4,13,17,82.0,1354.0,151,8,28,36,172.0,82,6.05,85,480,2458,10.1,0.2267473
1696,1696,Anton Volchenkov,2007-08,25.0,5,19,78,78,1,18,19,85.0,1660.0,229,9,46,55,257.0,82,5.76,70,398,2426,9.7,0.23811385
1697,1697,Anton Volchenkov,2008-09,26.0,6,15,67,67,1,14,15,71.0,1374.0,296,10,60,70,328.0,82,5.44,62,351,2383,9.4,0.19283336
1698,1698,Anton Volchenkov,2009-10,27.0,7,10,68,68,2,8,10,79.0,1370.0,364,12,68,80,407.0,82,5.7,65,341,2477,9.4,0.2003429
1699,1699,Anton Volchenkov,2010-11,28.0,8,14,64,64,4,10,14,69.0,1324.0,428,16,78,94,476.0,82,5.53,56,304,2486,9.1,0.18485051
1700,1700,Anton Volchenkov,2011-12,29.0,9,8,57,57,0,8,8,65.0,1032.0,485,16,86,102,541.0,82,5.46,52,291,2492,9.0,0.162148
1701,1701,Anton Volchenkov,2012-13,30.0,10,11,72,72,2,9,11,63.0,1294.0,557,18,95,113,604.0,82,5.32,47,271,2439,8.9,0.15589088
1702,1702,Anton Volchenkov,2013-14,31.0,11,5,37,37,1,4,5,38.0,594.0,594,19,99,118,642.0,48,5.31,29,160,1399,9.1,0.15770185
1703,1703,Anton Volchenkov,2014-15,32.0,12,8,56,56,0,8,8,42.0,940.0,650,19,107,126,684.0,82,5.34,48,269,2463,8.9,0.12562454
1704,1704,Anton Volchenkov,2015-16,33.0,13,7,46,46,0,7,7,35.0,606.0,696,19,114,133,719.0,82,5.32,47,251,2453,8.9,0.11253768
1705,1705,Anton Wedin,2020-21,27.0,2,0,4,4,0,0,0,2.0,36.0,4,0,0,0,2.0,70,5.96,42,208,2192,9.5,0.17624131
1706,1706,Antti Aalto,1998-99,23.0,2,0,3,3,0,0,0,1.0,,3,0,0,0,1.0,82,5.28,57,380,2242,9.6,0.1592103
1707,1707,Antti Aalto,1999-00,24.0,3,8,73,73,3,5,8,61.0,685.0,76,3,5,8,62.0,82,5.27,57,359,2285,9.4,0.17261076
1708,1708,Antti Aalto,2000-01,25.0,4,18,63,63,7,11,18,102.0,830.0,139,10,16,26,164.0,82,5.49,53,331,2294,9.8,0.2682464
1709,1709,Antti Aalto,2001-02,26.0,5,2,12,12,1,1,2,18.0,127.0,151,11,17,28,182.0,82,5.51,63,376,2272,9.9,0.18901029
1710,1710,Antti Laaksonen,1999-00,26.0,2,3,11,11,1,2,3,8.0,103.0,11,1,2,3,8.0,82,5.27,57,359,2285,9.4,0.20031884
1711,1711,Antti Laaksonen,2000-01,27.0,3,9,27,27,6,3,9,23.0,212.0,38,7,5,12,31.0,82,5.49,53,331,2294,9.8,0.23540816
1712,1712,Antti Laaksonen,2001-02,28.0,4,28,82,82,12,16,28,129.0,1349.0,120,19,21,40,160.0,82,5.51,63,376,2272,9.9,0.34373206
1713,1713,Antti Laaksonen,2002-03,29.0,5,33,82,82,16,17,33,104.0,1339.0,202,35,38,73,264.0,82,5.24,53,338,2262,9.5,0.40873295
1714,1714,Antti Laaksonen,2003-04,30.0,6,31,82,82,15,16,31,106.0,1305.0,284,50,54,104,370.0,82,5.31,60,363,2326,9.4,0.37266842
1715,1715,Antti Laaksonen,2004-05,31.0,7,26,77,77,12,14,26,100.0,1236.0,361,62,68,130,470.0,82,5.14,57,348,2300,9.2,0.36476797
1716,1716,Antti Laaksonen,2006-07,33.0,8,34,81,81,16,18,34,141.0,1297.0,442,78,86,164,611.0,82,6.05,85,480,2458,10.1,0.38195315
1717,1717,Antti Laaksonen,2007-08,34.0,9,4,41,41,3,1,4,43.0,438.0,483,81,87,168,654.0,82,5.76,70,398,2426,9.7,0.18395159
1718,1718,Antti Miettinen,2004-05,24.0,2,1,16,16,1,0,1,17.0,158.0,16,1,0,1,17.0,82,5.14,57,348,2300,9.2,0.20158133
1719,1719,Antti Miettinen,2006-07,26.0,3,31,79,79,11,20,31,107.0,956.0,95,12,20,32,124.0,82,6.05,85,480,2458,10.1,0.38357177
1720,1720,Antti Miettinen,2007-08,27.0,4,25,74,74,11,14,25,141.0,1060.0,169,23,34,57,265.0,82,5.76,70,398,2426,9.7,0.3291292
1721,1721,Antti Miettinen,2008-09,28.0,5,34,69,69,15,19,34,136.0,965.0,238,38,53,91,401.0,82,5.44,62,351,2383,9.4,0.46759042
1722,1722,Antti Miettinen,2009-10,29.0,6,44,82,82,15,29,44,186.0,1499.0,320,53,82,135,587.0,82,5.7,65,341,2477,9.4,0.52105737
1723,1723,Antti Miettinen,2010-11,30.0,7,42,79,79,20,22,42,175.0,1426.0,399,73,104,177,762.0,82,5.53,56,304,2486,9.1,0.5134953
1724,1724,Antti Miettinen,2011-12,31.0,8,35,73,73,16,19,35,168.0,1243.0,472,89,123,212,930.0,82,5.46,52,291,2492,9.0,0.42193544
1725,1725,Antti Miettinen,2012-13,32.0,9,13,45,45,5,8,13,58.0,527.0,517,94,131,225,988.0,82,5.32,47,271,2439,8.9,0.26547468
1726,1726,Antti Miettinen,2013-14,33.0,10,5,22,22,3,2,5,26.0,278.0,539,97,133,230,1014.0,48,5.31,29,160,1399,9.1,0.3160377
1727,1727,Antti Pihlstrom,2008-09,24.0,2,0,1,1,0,0,0,1.0,9.0,1,0,0,0,1.0,82,5.44,62,351,2383,9.4,0.17854032
1728,1728,Antti Pihlstrom,2009-10,25.0,3,7,53,53,2,5,7,88.0,607.0,54,2,5,7,89.0,82,5.7,65,341,2477,9.4,0.2222633
1729,1729,Antti Suomela,2019-20,25.0,2,8,27,27,3,5,8,42.0,306.0,27,3,5,8,42.0,82,5.96,47,239,2579,9.5,0.23273191
1730,1730,Antti Suomela,2020-21,26.0,3,7,20,20,1,6,7,18.0,194.0,47,4,11,15,60.0,70,5.96,42,208,2192,9.5,0.23673424
1731,1731,Antti Tormanen,1996-97,26.0,2,15,50,50,7,8,15,68.0,,50,7,8,15,68.0,82,6.29,74,413,2481,10.4,0.28223726
1732,1732,Antti-Jussi Niemi,2001-02,24.0,2,2,28,28,1,1,2,18.0,446.0,28,1,1,2,18.0,82,5.51,63,376,2272,9.9,0.14967334
1733,1733,Antti-Jussi Niemi,2002-03,25.0,3,0,1,1,0,0,0,0.0,10.0,29,1,1,2,18.0,82,5.24,53,338,2262,9.5,0.14609438
1734,1734,Anze Kopitar,2007-08,20.0,2,61,72,72,20,41,61,193.0,1479.0,72,20,41,61,193.0,82,5.76,70,398,2426,9.7,0.83695555
1735,1735,Anze Kopitar,2008-09,21.0,3,77,82,82,32,45,77,201.0,1696.0,154,52,86,138,394.0,82,5.44,62,351,2383,9.4,0.9384795
1736,1736,Anze Kopitar,2009-10,22.0,4,66,82,82,27,39,66,234.0,1677.0,236,79,125,204,628.0,82,5.7,65,341,2477,9.4,0.90331745
1737,1737,Anze Kopitar,2010-11,23.0,5,81,82,82,34,47,81,259.0,1786.0,318,113,172,285,887.0,82,5.53,56,304,2486,9.1,0.9718395
1738,1738,Anze Kopitar,2011-12,24.0,6,73,75,75,25,48,73,233.0,1619.0,393,138,220,358,1120.0,82,5.46,52,291,2492,9.0,0.922404
1739,1739,Anze Kopitar,2012-13,25.0,7,76,82,82,25,51,76,230.0,1750.0,475,163,271,434,1350.0,82,5.32,47,271,2439,8.9,0.93279856
1740,1740,Anze Kopitar,2013-14,26.0,8,42,47,47,10,32,42,98.0,963.0,522,173,303,476,1448.0,48,5.31,29,160,1399,9.1,0.8395992
1741,1741,Anze Kopitar,2014-15,27.0,9,70,82,82,29,41,70,200.0,1713.0,604,202,344,546,1648.0,82,5.34,48,269,2463,8.9,0.86610615
1742,1742,Anze Kopitar,2015-16,28.0,10,64,79,79,16,48,64,134.0,1532.0,683,218,392,610,1782.0,82,5.32,47,251,2453,8.9,0.7938682
1743,1743,Anze Kopitar,2016-17,29.0,11,74,81,81,25,49,74,177.0,1690.0,764,243,441,684,1959.0,82,5.34,48,255,2438,9.0,0.8832512
1744,1744,Anze Kopitar,2017-18,30.0,12,52,76,76,12,40,52,150.0,1578.0,840,255,481,736,2109.0,82,5.45,47,245,2478,9.0,0.6419332
1745,1745,Anze Kopitar,2018-19,31.0,13,92,82,82,35,57,92,200.0,1811.0,922,290,538,828,2309.0,82,5.86,50,250,2620,9.2,0.9682012
1746,1746,Anze Kopitar,2019-20,32.0,14,60,81,81,22,38,60,156.0,1807.0,1003,312,576,888,2465.0,82,5.96,47,239,2579,9.5,0.6852809
1747,1747,Anze Kopitar,2020-21,33.0,15,62,70,70,21,41,62,135.0,1473.0,1073,333,617,950,2600.0,70,5.96,42,208,2192,9.5,0.8397567
1748,1748,Archie Henderson,1981-82,24.0,2,1,7,7,1,0,1,4.0,,7,1,0,1,4.0,80,7.69,77,340,2441,12.6,0.269494
1749,1749,Archie Henderson,1982-83,25.0,3,0,1,1,0,0,0,0.0,,8,1,0,1,4.0,80,8.03,73,320,2489,12.9,0.19985512
1750,1750,Archie Henderson,1983-84,26.0,4,3,15,15,2,1,3,7.0,,23,3,1,4,11.0,80,7.73,71,310,2444,12.7,0.2800913
1751,1751,Ari Haanpaa,1986-87,21.0,2,7,18,18,0,7,7,16.0,,18,0,7,7,16.0,80,7.94,82,370,2484,12.8,0.2965199
1752,1752,Ari Haanpaa,1987-88,22.0,3,10,41,41,6,4,10,45.0,,59,6,11,17,61.0,80,7.34,72,344,2400,12.2,0.31153437
1753,1753,Ari Haanpaa,1988-89,23.0,4,0,1,1,0,0,0,0.0,,60,6,11,17,61.0,80,7.43,89,437,2435,12.2,0.214941
1754,1754,Aris Brimanis,1994-95,22.0,2,0,1,1,0,0,0,1.0,,1,0,0,0,1.0,84,6.48,76,407,2545,10.7,0.17530912
1755,1755,Aris Brimanis,1996-97,24.0,3,2,17,17,0,2,2,11.0,,18,0,2,2,12.0,82,6.29,74,413,2481,10.4,0.1722691
1756,1756,Aris Brimanis,1997-98,25.0,4,1,3,3,0,1,1,1.0,,21,0,3,3,13.0,82,5.83,55,336,2444,9.8,0.16353282
1757,1757,Aris Brimanis,2000-01,28.0,5,3,18,18,2,1,3,16.0,360.0,39,2,4,6,29.0,82,5.49,53,331,2294,9.8,0.17932925
1758,1758,Aris Brimanis,2001-02,29.0,6,8,56,56,0,8,8,66.0,874.0,95,2,12,14,95.0,82,5.51,63,376,2272,9.9,0.130526
1759,1759,Aris Brimanis,2002-03,30.0,7,0,5,5,0,0,0,2.0,48.0,100,2,12,14,97.0,82,5.24,53,338,2262,9.5,0.13192308
1760,1760,Aris Brimanis,2004-05,32.0,8,0,13,13,0,0,0,3.0,156.0,113,2,12,14,100.0,82,5.14,57,348,2300,9.2,0.16180298
1761,1761,Arron Asham,1999-00,21.0,2,0,7,7,0,0,0,5.0,52.0,7,0,0,0,5.0,82,5.27,57,359,2285,9.4,0.18502599
1762,1762,Arron Asham,2000-01,22.0,3,6,33,33,4,2,6,29.0,338.0,40,4,2,6,34.0,82,5.49,53,331,2294,9.8,0.2611659
1763,1763,Arron Asham,2001-02,23.0,4,5,46,46,2,3,5,32.0,389.0,86,6,5,11,66.0,82,5.51,63,376,2272,9.9,0.18616647
1764,1764,Arron Asham,2002-03,24.0,5,9,35,35,5,4,9,30.0,287.0,121,11,9,20,96.0,82,5.24,53,338,2262,9.5,0.22491372
1765,1765,Arron Asham,2003-04,25.0,6,34,78,78,15,19,34,114.0,953.0,199,26,28,54,210.0,82,5.31,60,363,2326,9.4,0.38237864
1766,1766,Arron Asham,2004-05,26.0,7,24,79,79,12,12,24,108.0,1044.0,278,38,40,78,318.0,82,5.14,57,348,2300,9.2,0.34711444
1767,1767,Arron Asham,2006-07,28.0,8,24,63,63,9,15,24,99.0,853.0,341,47,55,102,417.0,82,6.05,85,480,2458,10.1,0.31372648
1768,1768,Arron Asham,2007-08,29.0,9,23,80,80,11,12,23,85.0,746.0,421,58,67,125,502.0,82,5.76,70,398,2426,9.7,0.25942338
1769,1769,Arron Asham,2008-09,30.0,10,10,77,77,6,4,10,68.0,659.0,498,64,71,135,570.0,82,5.44,62,351,2383,9.4,0.21048447
1770,1770,Arron Asham,2009-10,31.0,11,20,78,78,8,12,20,74.0,682.0,576,72,83,155,644.0,82,5.7,65,341,2477,9.4,0.24320883
1771,1771,Arron Asham,2010-11,32.0,12,24,72,72,10,14,24,91.0,725.0,648,82,97,179,735.0,82,5.53,56,304,2486,9.1,0.27148432
1772,1772,Arron Asham,2011-12,33.0,13,11,44,44,5,6,11,60.0,420.0,692,87,103,190,795.0,82,5.46,52,291,2492,9.0,0.20494273
1773,1773,Arron Asham,2012-13,34.0,14,16,64,64,5,11,16,49.0,591.0,756,92,114,206,844.0,82,5.32,47,271,2439,8.9,0.18024
1774,1774,Arron Asham,2013-14,35.0,15,2,27,27,2,0,2,14.0,179.0,783,94,114,208,858.0,48,5.31,29,160,1399,9.1,0.17317298
1775,1775,Arron Asham,2014-15,36.0,16,0,6,6,0,0,0,1.0,45.0,789,94,114,208,859.0,82,5.34,48,269,2463,8.9,0.15981519
1776,1776,Artem Anisimov,2009-10,21.0,2,0,1,1,0,0,0,1.0,9.0,1,0,0,0,1.0,82,5.7,65,341,2477,9.4,0.20738643
1777,1777,Artem Anisimov,2010-11,22.0,3,28,82,82,12,16,28,124.0,1058.0,83,12,16,28,125.0,82,5.53,56,304,2486,9.1,0.39383566
1778,1778,Artem Anisimov,2011-12,23.0,4,44,82,82,18,26,44,190.0,1329.0,165,30,42,72,315.0,82,5.46,52,291,2492,9.0,0.57291216
1779,1779,Artem Anisimov,2012-13,24.0,5,36,79,79,16,20,36,132.0,1217.0,244,46,62,108,447.0,82,5.32,47,271,2439,8.9,0.4826577
1780,1780,Artem Anisimov,2013-14,25.0,6,18,35,35,11,7,18,68.0,574.0,279,57,69,126,515.0,48,5.31,29,160,1399,9.1,0.47194546
1781,1781,Artem Anisimov,2014-15,26.0,7,39,81,81,22,17,39,162.0,1344.0,360,79,86,165,677.0,82,5.34,48,269,2463,8.9,0.52420694
1782,1782,Artem Anisimov,2015-16,27.0,8,27,52,52,7,20,27,88.0,852.0,412,86,106,192,765.0,82,5.32,47,251,2453,8.9,0.49785018
1783,1783,Artem Anisimov,2016-17,28.0,9,42,77,77,20,22,42,121.0,1393.0,489,106,128,234,886.0,82,5.34,48,255,2438,9.0,0.47461474
1784,1784,Artem Anisimov,2017-18,29.0,10,45,64,64,22,23,45,105.0,1142.0,553,128,151,279,991.0,82,5.45,47,245,2478,9.0,0.57848805
1785,1785,Artem Anisimov,2018-19,30.0,11,31,72,72,20,11,31,130.0,1209.0,625,148,162,310,1121.0,82,5.86,50,250,2620,9.2,0.40446874
1786,1786,Artem Anisimov,2019-20,31.0,12,37,78,78,15,22,37,142.0,1275.0,703,163,184,347,1263.0,82,5.96,47,239,2579,9.5,0.4293124
1787,1787,Artem Anisimov,2020-21,32.0,13,20,49,49,15,5,20,87.0,679.0,752,178,189,367,1350.0,70,5.96,42,208,2192,9.5,0.4066376
1788,1788,Artem Chubarov,2000-01,21.0,2,9,49,49,1,8,9,53.0,574.0,49,1,8,9,53.0,82,5.49,53,331,2294,9.8,0.21517128
1789,1789,Artem Chubarov,2001-02,22.0,3,0,1,1,0,0,0,0.0,15.0,50,1,8,9,53.0,82,5.51,63,376,2272,9.9,0.14844328
1790,1790,Artem Chubarov,2002-03,23.0,4,10,51,51,5,5,10,73.0,644.0,101,6,13,19,126.0,82,5.24,53,338,2262,9.5,0.29515588
1791,1791,Artem Chubarov,2003-04,24.0,5,20,62,62,7,13,20,78.0,889.0,163,13,26,39,204.0,82,5.31,60,363,2326,9.4,0.29256326
1792,1792,Artem Chubarov,2004-05,25.0,6,19,65,65,12,7,19,93.0,915.0,228,25,33,58,297.0,82,5.14,57,348,2300,9.2,0.3305375
1793,1793,Artemi Panarin,2016-17,25.0,2,77,80,80,30,47,77,187.0,1482.0,80,30,47,77,187.0,82,5.34,48,255,2438,9.0,0.8483763
1794,1794,Artemi Panarin,2017-18,26.0,3,74,82,82,31,43,74,211.0,1597.0,162,61,90,151,398.0,82,5.45,47,245,2478,9.0,0.8766363
1795,1795,Artemi Panarin,2018-19,27.0,4,82,81,81,27,55,82,228.0,1631.0,243,88,145,233,626.0,82,5.86,50,250,2620,9.2,0.94405717
1796,1796,Artemi Panarin,2019-20,28.0,5,87,79,79,28,59,87,191.0,1569.0,322,116,204,320,817.0,82,5.96,47,239,2579,9.5,1.0785713
1797,1797,Artemi Panarin,2020-21,29.0,6,95,69,69,32,63,95,209.0,1422.0,391,148,267,415,1026.0,70,5.96,42,208,2192,9.5,1.1979349
1798,1798,Arto Blomsten,1994-95,29.0,2,2,18,18,0,2,2,15.0,,18,0,2,2,15.0,84,6.48,76,407,2545,10.7,0.17929783
1799,1799,Arto Blomsten,1995-96,30.0,3,1,5,5,0,1,1,1.0,,23,0,3,3,16.0,48,5.97,37,209,1408,10.2,0.15972266
1800,1800,Arto Blomsten,1996-97,31.0,4,1,2,2,0,1,1,1.0,,25,0,4,4,17.0,82,6.29,74,413,2481,10.4,0.14108798
1801,1801,Arto Javanainen,1985-86,26.0,2,5,14,14,4,1,5,20.0,,14,4,1,5,20.0,80,7.77,71,321,2447,12.7,0.33650285
1802,1802,Artturi Lehkonen,2017-18,22.0,2,28,73,73,18,10,28,158.0,1012.0,73,18,10,28,158.0,82,5.45,47,245,2478,9.0,0.47313416
1803,1803,Artturi Lehkonen,2018-19,23.0,3,21,66,66,12,9,21,164.0,1088.0,139,30,19,49,322.0,82,5.86,50,250,2620,9.2,0.37284553
1804,1804,Artturi Lehkonen,2019-20,24.0,4,31,82,82,11,20,31,176.0,1276.0,221,41,39,80,498.0,82,5.96,47,239,2579,9.5,0.46270534
1805,1805,Artturi Lehkonen,2020-21,25.0,5,27,70,70,13,14,27,140.0,1080.0,291,54,53,107,638.0,70,5.96,42,208,2192,9.5,0.44183674
1806,1806,Arturs Kulda ,2010-11,22.0,2,2,4,4,0,2,2,5.0,48.0,4,0,2,2,5.0,82,5.53,56,304,2486,9.1,0.2207264
1807,1807,Arturs Kulda ,2011-12,23.0,3,0,2,2,0,0,0,3.0,22.0,6,0,2,2,8.0,82,5.46,52,291,2492,9.0,0.16685265
1808,1808,Arturs Kulda ,2012-13,24.0,4,0,9,9,0,0,0,8.0,98.0,15,0,2,2,16.0,82,5.32,47,271,2439,8.9,0.14798215
1809,1809,Ashton Sautner,2018-19,24.0,2,2,5,5,0,2,2,3.0,67.0,5,0,2,2,3.0,82,5.86,50,250,2620,9.2,0.1859555
1810,1810,Ashton Sautner,2019-20,25.0,3,1,17,17,0,1,1,21.0,247.0,22,0,3,3,24.0,82,5.96,47,239,2579,9.5,0.19235608
1811,1811,Ashton Sautner,2020-21,26.0,4,0,1,1,0,0,0,1.0,3.0,23,0,3,3,25.0,70,5.96,42,208,2192,9.5,0.1744586
1812,1812,Austin Czarnik,2017-18,25.0,2,13,49,49,5,8,13,66.0,638.0,49,5,8,13,66.0,82,5.45,47,245,2478,9.0,0.25154996
1813,1813,Austin Czarnik,2018-19,26.0,3,4,10,10,0,4,4,7.0,109.0,59,5,12,17,73.0,82,5.86,50,250,2620,9.2,0.19014704
1814,1814,Austin Czarnik,2019-20,27.0,4,18,54,54,6,12,18,65.0,612.0,113,11,24,35,138.0,82,5.96,47,239,2579,9.5,0.33731097
1815,1815,Austin Czarnik,2020-21,28.0,5,3,8,8,2,1,3,9.0,82.0,121,13,25,38,147.0,70,5.96,42,208,2192,9.5,0.24700302
1816,1816,Austin Poganski,2020-21,24.0,2,0,1,1,0,0,0,0.0,6.0,1,0,0,0,0.0,70,5.96,42,208,2192,9.5,0.18837601
1817,1817,Austin Wagner,2019-20,22.0,2,21,62,62,12,9,21,67.0,554.0,62,12,9,21,67.0,82,5.96,47,239,2579,9.5,0.33184594
1818,1818,Austin Wagner,2020-21,23.0,3,11,65,65,6,5,11,124.0,763.0,127,18,14,32,191.0,70,5.96,42,208,2192,9.5,0.2796662
1819,1819,Austin Watson,2013-14,22.0,2,1,6,6,1,0,1,4.0,76.0,6,1,0,1,4.0,48,5.31,29,160,1399,9.1,0.25389427
1820,1820,Austin Watson,2016-17,25.0,3,10,57,57,3,7,10,55.0,570.0,63,4,7,11,59.0,82,5.34,48,255,2438,9.0,0.17978081
1821,1821,Austin Watson,2017-18,26.0,4,17,77,77,5,12,17,90.0,957.0,140,9,19,28,149.0,82,5.45,47,245,2478,9.0,0.22527021
1822,1822,Austin Watson,2018-19,27.0,5,19,76,76,14,5,19,96.0,937.0,216,23,24,47,245.0,82,5.86,50,250,2620,9.2,0.2700739
1823,1823,Austin Watson,2019-20,28.0,6,16,37,37,7,9,16,64.0,536.0,253,30,33,63,309.0,82,5.96,47,239,2579,9.5,0.33802333
1824,1824,Austin Watson,2020-21,29.0,7,14,53,53,6,8,14,50.0,616.0,306,36,41,77,359.0,70,5.96,42,208,2192,9.5,0.26186243
1825,1825,Auston Matthews,2017-18,20.0,2,69,82,82,40,29,69,279.0,1446.0,82,40,29,69,279.0,82,5.45,47,245,2478,9.0,0.9102783
1826,1826,Auston Matthews,2018-19,21.0,3,63,62,62,34,29,63,187.0,1124.0,144,74,58,132,466.0,82,5.86,50,250,2620,9.2,0.95765215
1827,1827,Auston Matthews,2019-20,22.0,4,73,68,68,37,36,73,251.0,1262.0,212,111,94,205,717.0,82,5.96,47,239,2579,9.5,1.0212348
1828,1828,Auston Matthews,2020-21,23.0,5,80,70,70,47,33,80,290.0,1468.0,282,158,127,285,1007.0,70,5.96,42,208,2192,9.5,1.0334582
1829,1829,B.J. Crombeen,2008-09,23.0,2,2,8,8,0,2,2,9.0,53.0,8,0,2,2,9.0,82,5.44,62,351,2383,9.4,0.20648715
1830,1830,B.J. Crombeen,2009-10,24.0,3,22,81,81,12,10,22,124.0,1031.0,89,12,12,24,133.0,82,5.7,65,341,2477,9.4,0.32875824
1831,1831,B.J. Crombeen,2010-11,25.0,4,15,79,79,7,8,15,120.0,1033.0,168,19,20,39,253.0,82,5.53,56,304,2486,9.1,0.23911238
1832,1832,B.J. Crombeen,2011-12,26.0,5,14,80,80,7,7,14,113.0,1024.0,248,26,27,53,366.0,82,5.46,52,291,2492,9.0,0.22196981
1833,1833,B.J. Crombeen,2012-13,27.0,6,3,40,40,1,2,3,50.0,332.0,288,27,29,56,416.0,82,5.32,47,271,2439,8.9,0.1601465
1834,1834,B.J. Crombeen,2013-14,28.0,7,8,44,44,1,7,8,50.0,488.0,332,28,36,64,466.0,48,5.31,29,160,1399,9.1,0.18112221
1835,1835,B.J. Crombeen,2014-15,29.0,8,10,55,55,3,7,10,60.0,559.0,387,31,43,74,526.0,82,5.34,48,269,2463,8.9,0.19034693
1836,1836,B.J. Crombeen,2015-16,30.0,9,6,58,58,3,3,6,43.0,469.0,445,34,46,80,569.0,82,5.32,47,251,2453,8.9,0.1312151
1837,1837,B.J. Young,2000-01,23.0,2,0,1,1,0,0,0,1.0,1.0,1,0,0,0,1.0,82,5.49,53,331,2294,9.8,0.17198798
1838,1838,Barclay Goodrow,2015-16,22.0,2,12,60,60,4,8,12,68.0,664.0,60,4,8,12,68.0,82,5.32,47,251,2453,8.9,0.22853398
1839,1839,Barclay Goodrow,2016-17,23.0,3,3,14,14,0,3,3,7.0,144.0,74,4,11,15,75.0,82,5.34,48,255,2438,9.0,0.22051817
1840,1840,Barclay Goodrow,2017-18,24.0,4,1,3,3,0,1,1,3.0,34.0,77,4,12,16,78.0,82,5.45,47,245,2478,9.0,0.19653833
1841,1841,Barclay Goodrow,2018-19,25.0,5,14,47,47,7,7,14,57.0,512.0,124,11,19,30,135.0,82,5.86,50,250,2620,9.2,0.2563842
1842,1842,Barclay Goodrow,2019-20,26.0,6,17,82,82,7,10,17,84.0,903.0,206,18,29,47,219.0,82,5.96,47,239,2579,9.5,0.22907516
1843,1843,Barclay Goodrow,2020-21,27.0,7,26,70,70,8,18,26,102.0,1115.0,276,26,47,73,321.0,70,5.96,42,208,2192,9.5,0.33907804
1844,1844,Barret Jackman,2002-03,21.0,2,0,1,1,0,0,0,1.0,19.0,1,0,0,0,1.0,82,5.24,53,338,2262,9.5,0.17989916
1845,1845,Barret Jackman,2003-04,22.0,3,19,82,82,3,16,19,66.0,1644.0,83,3,16,19,67.0,82,5.31,60,363,2326,9.4,0.26627824
1846,1846,Barret Jackman,2004-05,23.0,4,3,15,15,1,2,3,11.0,274.0,98,4,18,22,78.0,82,5.14,57,348,2300,9.2,0.30044496
1847,1847,Barret Jackman,2006-07,25.0,5,10,63,63,4,6,10,56.0,1182.0,161,8,24,32,134.0,82,6.05,85,480,2458,10.1,0.17080575
1848,1848,Barret Jackman,2007-08,26.0,6,27,70,70,3,24,27,86.0,1505.0,231,11,48,59,220.0,82,5.76,70,398,2426,9.7,0.32491332
1849,1849,Barret Jackman,2008-09,27.0,7,16,78,78,2,14,16,80.0,1747.0,309,13,62,75,300.0,82,5.44,62,351,2383,9.4,0.20954686
1850,1850,Barret Jackman,2009-10,28.0,8,21,82,82,4,17,21,89.0,1922.0,391,17,79,96,389.0,82,5.7,65,341,2477,9.4,0.25328416
1851,1851,Barret Jackman,2010-11,29.0,9,17,66,66,2,15,17,73.0,1497.0,457,19,94,113,462.0,82,5.53,56,304,2486,9.1,0.22157568
1852,1852,Barret Jackman,2011-12,30.0,10,13,60,60,0,13,13,65.0,1248.0,517,19,107,126,527.0,82,5.46,52,291,2492,9.0,0.1613949
1853,1853,Barret Jackman,2012-13,31.0,11,13,81,81,1,12,13,82.0,1675.0,598,20,119,139,609.0,82,5.32,47,271,2439,8.9,0.14227048
1854,1854,Barret Jackman,2013-14,32.0,12,12,46,46,3,9,12,39.0,889.0,644,23,128,151,648.0,48,5.31,29,160,1399,9.1,0.1992433
1855,1855,Barret Jackman,2014-15,33.0,13,15,79,79,3,12,15,83.0,1416.0,723,26,140,166,731.0,82,5.34,48,269,2463,8.9,0.17246452
1856,1856,Barret Jackman,2015-16,34.0,14,15,80,80,2,13,15,86.0,1345.0,803,28,153,181,817.0,82,5.32,47,251,2453,8.9,0.16232818
1857,1857,Barret Jackman,2016-17,35.0,15,5,73,73,1,4,5,64.0,1012.0,876,29,157,186,881.0,82,5.34,48,255,2438,9.0,0.10612184
1858,1858,Barrett Hayton,2020-21,20.0,2,4,20,20,1,3,4,27.0,223.0,20,1,3,4,27.0,70,5.96,42,208,2192,9.5,0.29776174
1859,1859,Barrett Heisten,2002-03,22.0,2,0,10,10,0,0,0,7.0,76.0,10,0,0,0,7.0,82,5.24,53,338,2262,9.5,0.17117813
1860,1860,Barrie Moore,1996-97,21.0,2,0,3,3,0,0,0,3.0,,3,0,0,0,3.0,82,6.29,74,413,2481,10.4,0.21502173
1861,1861,Barrie Moore,1997-98,22.0,3,8,35,35,2,6,8,43.0,,38,2,6,8,46.0,82,5.83,55,336,2444,9.8,0.24822554
1862,1862,Barrie Moore,2000-01,25.0,4,0,1,1,0,0,0,2.0,10.0,39,2,6,8,48.0,82,5.49,53,331,2294,9.8,0.15308824
1863,1863,Barry Legge,1980-81,26.0,2,3,31,31,0,3,3,15.0,,31,0,3,3,15.0,80,7.03,61,280,2352,12.0,0.1635305
1864,1864,Barry Legge,1981-82,27.0,3,6,38,38,0,6,6,14.0,,69,0,9,9,29.0,80,7.69,77,340,2441,12.6,0.13802493
1865,1865,Barry Legge,1982-83,28.0,4,3,38,38,1,2,3,23.0,,107,1,11,12,52.0,80,8.03,73,320,2489,12.9,0.13199371
1866,1866,Barry Melrose,1980-81,24.0,2,10,74,74,4,6,10,101.0,,74,4,6,10,101.0,80,7.03,61,280,2352,12.0,0.27342853
1867,1867,Barry Melrose,1981-82,25.0,3,9,75,75,3,6,9,55.0,,149,7,12,19,156.0,80,7.69,77,340,2441,12.6,0.18519801
1868,1868,Barry Melrose,1982-83,26.0,4,6,64,64,1,5,6,45.0,,213,8,17,25,201.0,80,8.03,73,320,2489,12.9,0.1778521
1869,1869,Barry Melrose,1983-84,27.0,5,7,52,52,2,5,7,25.0,,265,10,22,32,226.0,80,7.73,71,310,2444,12.7,0.14505523
1870,1870,Barry Melrose,1984-85,28.0,6,1,21,21,0,1,1,8.0,,286,10,23,33,234.0,80,7.89,74,336,2448,12.9,0.11290473
1871,1871,Barry Melrose,1986-87,30.0,7,0,14,14,0,0,0,2.0,,300,10,23,33,236.0,80,7.94,82,370,2484,12.8,0.122520834
1872,1872,Barry Nieckar,1993-94,26.0,2,0,2,2,0,0,0,1.0,,2,0,0,0,1.0,84,7.25,87,443,2603,11.7,0.19729981
1873,1873,Barry Nieckar,1995-96,28.0,3,0,3,3,0,0,0,0.0,,5,0,0,0,1.0,48,5.97,37,209,1408,10.2,0.15535364
1874,1874,Barry Nieckar,1997-98,30.0,4,0,2,2,0,0,0,0.0,,7,0,0,0,1.0,82,5.83,55,336,2444,9.8,0.12651223
1875,1875,Barry Nieckar,1998-99,31.0,5,0,1,1,0,0,0,0.0,,8,0,0,0,1.0,82,5.28,57,380,2242,9.6,0.12373471
1876,1876,Barry Pederson,1981-82,20.0,2,5,9,9,1,4,5,20.0,,9,1,4,5,20.0,80,7.69,77,340,2441,12.6,0.36615914
1877,1877,Barry Pederson,1982-83,21.0,3,92,80,80,44,48,92,197.0,,89,45,52,97,217.0,80,8.03,73,320,2489,12.9,1.1631414
1878,1878,Barry Pederson,1983-84,22.0,4,107,77,77,46,61,107,213.0,,166,91,113,204,430.0,80,7.73,71,310,2444,12.7,1.2856529
1879,1879,Barry Pederson,1984-85,23.0,5,116,80,80,39,77,116,236.0,,246,130,190,320,666.0,80,7.89,74,336,2448,12.9,1.1369629
1880,1880,Barry Pederson,1985-86,24.0,6,12,22,22,4,8,12,35.0,,268,134,198,332,701.0,80,7.77,71,321,2447,12.7,0.7174978
1881,1881,Barry Pederson,1986-87,25.0,7,76,79,79,29,47,76,192.0,,347,163,245,408,893.0,80,7.94,82,370,2484,12.8,0.90136814
1882,1882,Barry Pederson,1987-88,26.0,8,76,79,79,24,52,76,182.0,,426,187,297,484,1075.0,80,7.34,72,344,2400,12.2,0.9310809
1883,1883,Barry Pederson,1988-89,27.0,9,71,76,76,19,52,71,163.0,,502,206,349,555,1238.0,80,7.43,89,437,2435,12.2,0.8858037
1884,1884,Barry Pederson,1989-90,28.0,10,41,62,62,15,26,41,98.0,,564,221,375,596,1336.0,80,7.48,85,403,2430,12.3,0.6326506
1885,1885,Barry Pederson,1990-91,29.0,11,31,54,54,6,25,31,80.0,,618,227,400,627,1416.0,80,7.37,76,367,2421,12.2,0.5809436
1886,1886,Barry Pederson,1991-92,30.0,12,14,46,46,6,8,14,26.0,,664,233,408,641,1442.0,80,6.91,71,366,2385,11.6,0.48553148
1887,1887,Barry Pederson,1992-93,31.0,13,13,37,37,5,8,13,47.0,,701,238,416,654,1489.0,80,6.96,77,402,2440,11.4,0.43593523
1888,1888,Barry Potomski,1996-97,24.0,2,5,33,33,3,2,5,23.0,,33,3,2,5,23.0,82,6.29,74,413,2481,10.4,0.24025252
1889,1889,Barry Potomski,1997-98,25.0,3,5,26,26,3,2,5,18.0,,59,6,4,10,41.0,82,5.83,55,336,2444,9.8,0.17904413
1890,1890,Barry Potomski,1998-99,26.0,4,1,9,9,0,1,1,4.0,,68,6,5,11,45.0,82,5.28,57,380,2242,9.6,0.15211707
1891,1891,Barry Richter,1996-97,26.0,2,1,4,4,0,1,1,3.0,,4,0,1,1,3.0,82,6.29,74,413,2481,10.4,0.18527624
1892,1892,Barry Richter,1997-98,27.0,3,18,50,50,5,13,18,79.0,,54,5,14,19,82.0,82,5.83,55,336,2444,9.8,0.32399702
1893,1893,Barry Richter,1999-00,29.0,4,24,72,72,6,18,24,111.0,1522.0,126,11,32,43,193.0,82,5.27,57,359,2285,9.4,0.29435337
1894,1894,Barry Richter,2000-01,30.0,5,2,23,23,0,2,2,13.0,282.0,149,11,34,45,206.0,82,5.49,53,331,2294,9.8,0.1295768
1895,1895,Barry Richter,2001-02,31.0,6,0,2,2,0,0,0,0.0,21.0,151,11,34,45,206.0,82,5.51,63,376,2272,9.9,0.1680179
1896,1896,Barry Tallackson,2006-07,23.0,2,2,10,10,1,1,2,11.0,81.0,10,1,1,2,11.0,82,6.05,85,480,2458,10.1,0.23243079
1897,1897,Barry Tallackson,2007-08,24.0,3,0,3,3,0,0,0,3.0,36.0,13,1,1,2,14.0,82,5.76,70,398,2426,9.7,0.16544634
1898,1898,Barry Tallackson,2008-09,25.0,4,0,3,3,0,0,0,0.0,21.0,16,1,1,2,14.0,82,5.44,62,351,2383,9.4,0.14715865
1899,1899,Barry Tallackson,2009-10,26.0,5,0,4,4,0,0,0,2.0,18.0,20,1,1,2,16.0,82,5.7,65,341,2477,9.4,0.15067759
1900,1900,Basil McRae,1982-83,22.0,2,7,20,20,4,3,7,20.0,,20,4,3,7,20.0,80,8.03,73,320,2489,12.9,0.3801661
1901,1901,Basil McRae,1983-84,23.0,3,2,22,22,1,1,2,6.0,,42,5,4,9,26.0,80,7.73,71,310,2444,12.7,0.21991768
1902,1902,Basil McRae,1984-85,24.0,4,0,3,3,0,0,0,7.0,,45,5,4,9,33.0,80,7.89,74,336,2448,12.9,0.2022183
1903,1903,Basil McRae,1985-86,25.0,5,0,1,1,0,0,0,0.0,,46,5,4,9,33.0,80,7.77,71,321,2447,12.7,0.16923952
1904,1904,Basil McRae,1986-87,26.0,6,0,4,4,0,0,0,3.0,,50,5,4,9,36.0,80,7.94,82,370,2484,12.8,0.18314561
1905,1905,Basil McRae,1987-88,27.0,7,18,69,69,11,7,18,56.0,,119,16,11,27,92.0,80,7.34,72,344,2400,12.2,0.25752997
1906,1906,Basil McRae,1988-89,28.0,8,16,80,80,5,11,16,107.0,,199,21,22,43,199.0,80,7.43,89,437,2435,12.2,0.2547315
1907,1907,Basil McRae,1989-90,29.0,9,31,78,78,12,19,31,122.0,,277,33,41,74,321.0,80,7.48,85,403,2430,12.3,0.34637395
1908,1908,Basil McRae,1990-91,30.0,10,26,66,66,9,17,26,95.0,,343,42,58,100,416.0,80,7.37,76,367,2421,12.2,0.29929298
1909,1909,Basil McRae,1991-92,31.0,11,4,40,40,1,3,4,44.0,,383,43,61,104,460.0,80,6.91,71,366,2385,11.6,0.14342308
1910,1910,Basil McRae,1992-93,32.0,12,13,59,59,5,8,13,64.0,,442,48,69,117,524.0,80,6.96,77,402,2440,11.4,0.24045908
1911,1911,Basil McRae,1993-94,33.0,13,9,47,47,3,6,9,45.0,,489,51,75,126,569.0,84,7.25,87,443,2603,11.7,0.15924448
1912,1912,Basil McRae,1994-95,34.0,14,3,40,40,1,2,3,23.0,,529,52,77,129,592.0,84,6.48,76,407,2545,10.7,0.11247823
1913,1913,Basil McRae,1995-96,35.0,15,5,21,21,0,5,5,14.0,,550,52,82,134,606.0,48,5.97,37,209,1408,10.2,0.12362796
1914,1914,Basil McRae,1996-97,36.0,16,2,18,18,1,1,2,5.0,,568,53,83,136,611.0,82,6.29,74,413,2481,10.4,0.114088595
1915,1915,Basil McRae,1997-98,37.0,17,0,8,8,0,0,0,1.0,,576,53,83,136,612.0,82,5.83,55,336,2444,9.8,0.17462945
1916,1916,Bates Battaglia,1998-99,23.0,2,6,33,33,2,4,6,21.0,,33,2,4,6,21.0,82,5.28,57,380,2242,9.6,0.24660942
1917,1917,Bates Battaglia,1999-00,24.0,3,18,60,60,7,11,18,52.0,593.0,93,9,15,24,73.0,82,5.27,57,359,2285,9.4,0.29833537
1918,1918,Bates Battaglia,2000-01,25.0,4,34,77,77,16,18,34,86.0,1171.0,170,25,33,58,159.0,82,5.49,53,331,2294,9.8,0.40521783
1919,1919,Bates Battaglia,2001-02,26.0,5,27,80,80,12,15,27,133.0,1157.0,250,37,48,85,292.0,82,5.51,63,376,2272,9.9,0.38513738
1920,1920,Bates Battaglia,2002-03,27.0,6,46,82,82,21,25,46,167.0,1565.0,332,58,73,131,459.0,82,5.24,53,338,2262,9.5,0.53867817
1921,1921,Bates Battaglia,2003-04,28.0,7,25,83,83,6,19,25,123.0,1505.0,415,64,92,156,582.0,82,5.31,60,363,2326,9.4,0.3298379
1922,1922,Bates Battaglia,2004-05,29.0,8,11,70,70,4,7,11,70.0,943.0,485,68,99,167,652.0,82,5.14,57,348,2300,9.2,0.26252323
1923,1923,Bates Battaglia,2007-08,32.0,9,31,82,82,12,19,31,94.0,1021.0,567,80,118,198,746.0,82,5.76,70,398,2426,9.7,0.31195283
1924,1924,Bates Battaglia,2008-09,33.0,10,0,13,13,0,0,0,6.0,62.0,580,80,118,198,752.0,82,5.44,62,351,2383,9.4,0.20500702
1925,1925,Beau Bennett,2013-14,22.0,2,14,26,26,3,11,14,30.0,320.0,26,3,11,14,30.0,48,5.31,29,160,1399,9.1,0.35234487
1926,1926,Beau Bennett,2014-15,23.0,3,7,21,21,3,4,7,27.0,291.0,47,6,15,21,57.0,82,5.34,48,269,2463,8.9,0.2896549
1927,1927,Beau Bennett,2015-16,24.0,4,12,49,49,4,8,12,81.0,612.0,96,10,23,33,138.0,82,5.32,47,251,2453,8.9,0.2779801
1928,1928,Beau Bennett,2016-17,25.0,5,12,33,33,6,6,12,52.0,393.0,129,16,29,45,190.0,82,5.34,48,255,2438,9.0,0.26689035
1929,1929,Beau Bennett,2017-18,26.0,6,19,65,65,8,11,19,101.0,881.0,194,24,40,64,291.0,82,5.45,47,245,2478,9.0,0.28498846
1930,1930,Beau Bennett,2018-19,27.0,7,0,6,6,0,0,0,6.0,65.0,200,24,40,64,297.0,82,5.86,50,250,2620,9.2,0.22493857
1931,1931,Beck Malenstyn,2020-21,22.0,2,0,3,3,0,0,0,4.0,28.0,3,0,0,0,4.0,70,5.96,42,208,2192,9.5,0.20590216
1932,1932,Ben Chiarot,2014-15,23.0,2,0,1,1,0,0,0,0.0,11.0,1,0,0,0,0.0,82,5.34,48,269,2463,8.9,0.14718214
1933,1933,Ben Chiarot,2015-16,24.0,3,8,40,40,2,6,8,37.0,681.0,41,2,6,8,37.0,82,5.32,47,251,2453,8.9,0.18973303
1934,1934,Ben Chiarot,2016-17,25.0,4,10,70,70,1,9,10,74.0,1012.0,111,3,15,18,111.0,82,5.34,48,255,2438,9.0,0.18580759
1935,1935,Ben Chiarot,2017-18,26.0,5,12,59,59,2,10,12,49.0,904.0,170,5,25,30,160.0,82,5.45,47,245,2478,9.0,0.18757609
1936,1936,Ben Chiarot,2018-19,27.0,6,14,57,57,2,12,14,57.0,871.0,227,7,37,44,217.0,82,5.86,50,250,2620,9.2,0.18501663
1937,1937,Ben Chiarot,2019-20,28.0,7,20,78,78,5,15,20,111.0,1452.0,305,12,52,64,328.0,82,5.96,47,239,2579,9.5,0.23379129
1938,1938,Ben Chiarot,2020-21,29.0,8,21,69,69,9,12,21,130.0,1596.0,374,21,64,85,458.0,70,5.96,42,208,2192,9.5,0.32844728
1939,1939,Ben Clymer,2000-01,22.0,2,8,60,60,2,6,8,98.0,1177.0,60,2,6,8,98.0,82,5.49,53,331,2294,9.8,0.22712502
1940,1940,Ben Clymer,2001-02,23.0,3,6,23,23,5,1,6,25.0,300.0,83,7,7,14,123.0,82,5.51,63,376,2272,9.9,0.29403383
1941,1941,Ben Clymer,2002-03,24.0,4,34,81,81,14,20,34,151.0,1412.0,164,21,27,48,274.0,82,5.24,53,338,2262,9.5,0.4470551
1942,1942,Ben Clymer,2003-04,25.0,5,18,65,65,6,12,18,103.0,887.0,229,27,39,66,377.0,82,5.31,60,363,2326,9.4,0.30844936
1943,1943,Ben Clymer,2004-05,26.0,6,10,66,66,2,8,10,96.0,647.0,295,29,47,76,473.0,82,5.14,57,348,2300,9.2,0.23194268
1944,1944,Ben Clymer,2006-07,28.0,7,33,77,77,16,17,33,149.0,1091.0,372,45,64,109,622.0,82,6.05,85,480,2458,10.1,0.42218873
1945,1945,Ben Clymer,2007-08,29.0,8,20,66,66,7,13,20,78.0,920.0,438,52,77,129,700.0,82,5.76,70,398,2426,9.7,0.27435344
1946,1946,Ben Eager,2006-07,23.0,2,8,25,25,3,5,8,21.0,185.0,25,3,5,8,21.0,82,6.05,85,480,2458,10.1,0.2700637
1947,1947,Ben Eager,2007-08,24.0,3,11,63,63,6,5,11,48.0,519.0,88,9,10,19,69.0,82,5.76,70,398,2426,9.7,0.19265333
1948,1948,Ben Eager,2008-09,25.0,4,2,32,32,0,2,2,16.0,186.0,120,9,12,21,85.0,82,5.44,62,351,2383,9.4,0.14478761
1949,1949,Ben Eager,2009-10,26.0,5,15,75,75,11,4,15,80.0,639.0,195,20,16,36,165.0,82,5.7,65,341,2477,9.4,0.23023903
1950,1950,Ben Eager,2010-11,27.0,6,16,60,60,7,9,16,68.0,500.0,255,27,25,52,233.0,82,5.53,56,304,2486,9.1,0.23812807
1951,1951,Ben Eager,2011-12,28.0,7,17,68,68,7,10,17,84.0,723.0,323,34,35,69,317.0,82,5.46,52,291,2492,9.0,0.2206853
1952,1952,Ben Eager,2012-13,29.0,8,13,63,63,8,5,13,69.0,538.0,386,42,40,82,386.0,82,5.32,47,271,2439,8.9,0.18511003
1953,1953,Ben Eager,2013-14,30.0,9,2,14,14,1,1,2,14.0,135.0,400,43,41,84,400.0,48,5.31,29,160,1399,9.1,0.2063083
1954,1954,Ben Eager,2014-15,31.0,10,1,7,7,0,1,1,4.0,51.0,407,43,42,85,404.0,82,5.34,48,269,2463,8.9,0.17318875
1955,1955,Ben Gleason,2019-20,21.0,2,1,4,4,0,1,1,2.0,60.0,4,0,1,1,2.0,82,5.96,47,239,2579,9.5,0.27137116
1956,1956,Ben Guite,2006-07,28.0,2,0,1,1,0,0,0,2.0,9.0,1,0,0,0,2.0,82,6.05,85,480,2458,10.1,0.15345633
1957,1957,Ben Guite,2007-08,29.0,3,11,39,39,3,8,11,63.0,479.0,40,3,8,11,65.0,82,5.76,70,398,2426,9.7,0.21308109
1958,1958,Ben Guite,2008-09,30.0,4,22,79,79,11,11,22,103.0,1033.0,119,14,19,33,168.0,82,5.44,62,351,2383,9.4,0.2587539
1959,1959,Ben Guite,2009-10,31.0,5,12,50,50,5,7,12,63.0,636.0,169,19,26,45,231.0,82,5.7,65,341,2477,9.4,0.21659201
1960,1960,Ben Guite,2010-11,32.0,6,0,6,6,0,0,0,5.0,51.0,175,19,26,45,236.0,82,5.53,56,304,2486,9.1,0.15448424
1961,1961,Ben Hankinson,1993-94,24.0,2,3,4,4,2,1,3,3.0,,4,2,1,3,3.0,84,7.25,87,443,2603,11.7,0.28905997
1962,1962,Ben Hankinson,1994-95,25.0,3,1,13,13,1,0,1,14.0,,17,3,1,4,17.0,84,6.48,76,407,2545,10.7,0.1924505
1963,1963,Ben Hankinson,1995-96,26.0,4,2,26,26,0,2,2,26.0,,43,3,3,6,43.0,48,5.97,37,209,1408,10.2,0.1660535
1964,1964,Ben Hanowski,2013-14,23.0,2,1,5,5,1,0,1,4.0,66.0,5,1,0,1,4.0,48,5.31,29,160,1399,9.1,0.2366657
1965,1965,Ben Hanowski,2014-15,24.0,3,2,11,11,0,2,2,10.0,80.0,16,1,2,3,14.0,82,5.34,48,269,2463,8.9,0.17977127
1966,1966,Ben Harpur,2016-17,22.0,2,1,5,5,0,1,1,3.0,68.0,5,0,1,1,3.0,82,5.34,48,255,2438,9.0,0.20460084
1967,1967,Ben Harpur,2017-18,23.0,3,0,6,6,0,0,0,3.0,107.0,11,0,1,1,6.0,82,5.45,47,245,2478,9.0,0.17335454
1968,1968,Ben Harpur,2018-19,24.0,4,1,41,41,0,1,1,26.0,610.0,52,0,2,2,32.0,82,5.86,50,250,2620,9.2,0.10984182
1969,1969,Ben Harpur,2019-20,25.0,5,5,51,51,1,4,5,50.0,899.0,103,1,6,7,82.0,82,5.96,47,239,2579,9.5,0.15954214
1970,1970,Ben Holmstrom,2011-12,24.0,2,0,2,2,0,0,0,0.0,18.0,2,0,0,0,0.0,82,5.46,52,291,2492,9.0,0.14520383
1971,1971,Ben Holmstrom,2012-13,25.0,3,0,5,5,0,0,0,3.0,34.0,7,0,0,0,3.0,82,5.32,47,271,2439,8.9,0.15891996
1972,1972,Ben Hutton,2016-17,23.0,2,25,75,75,1,24,25,104.0,1491.0,75,1,24,25,104.0,82,5.34,48,255,2438,9.0,0.34097397
1973,1973,Ben Hutton,2017-18,24.0,3,19,71,71,5,14,19,130.0,1455.0,146,6,38,44,234.0,82,5.45,47,245,2478,9.0,0.31257486
1974,1974,Ben Hutton,2018-19,25.0,4,6,61,61,0,6,6,103.0,1123.0,207,6,44,50,337.0,82,5.86,50,250,2620,9.2,0.1922946
1975,1975,Ben Hutton,2019-20,26.0,5,20,69,69,5,15,20,114.0,1543.0,276,11,59,70,451.0,82,5.96,47,239,2579,9.5,0.27551812
1976,1976,Ben Hutton,2020-21,27.0,6,16,65,65,4,12,16,114.0,1187.0,341,15,71,86,565.0,70,5.96,42,208,2192,9.5,0.26424032
1977,1977,Ben Lovejoy,2009-10,25.0,2,0,2,2,0,0,0,1.0,24.0,2,0,0,0,1.0,82,5.7,65,341,2477,9.4,0.17050758
1978,1978,Ben Lovejoy,2010-11,26.0,3,3,12,12,0,3,3,14.0,199.0,14,0,3,3,15.0,82,5.53,56,304,2486,9.1,0.185521
1979,1979,Ben Lovejoy,2011-12,27.0,4,17,47,47,3,14,17,60.0,705.0,61,3,17,20,75.0,82,5.46,52,291,2492,9.0,0.28001454
1980,1980,Ben Lovejoy,2012-13,28.0,5,5,34,34,1,4,5,48.0,451.0,95,4,21,25,123.0,82,5.32,47,271,2439,8.9,0.18879977
1981,1981,Ben Lovejoy,2013-14,29.0,6,10,35,35,0,10,10,58.0,624.0,130,4,31,35,181.0,48,5.31,29,160,1399,9.1,0.19038922
1982,1982,Ben Lovejoy,2014-15,30.0,7,18,78,78,5,13,18,107.0,1513.0,208,9,44,53,288.0,82,5.34,48,269,2463,8.9,0.21872139
1983,1983,Ben Lovejoy,2015-16,31.0,8,14,60,60,2,12,14,86.0,1166.0,268,11,56,67,374.0,82,5.32,47,251,2453,8.9,0.1937156
1984,1984,Ben Lovejoy,2016-17,32.0,9,10,66,66,4,6,10,90.0,1245.0,334,15,62,77,464.0,82,5.34,48,255,2438,9.0,0.1764372
1985,1985,Ben Lovejoy,2017-18,33.0,10,7,82,82,1,6,7,84.0,1703.0,416,16,68,84,548.0,82,5.45,47,245,2478,9.0,0.14566144
1986,1986,Ben Lovejoy,2018-19,34.0,11,8,57,57,2,6,8,74.0,946.0,473,18,74,92,622.0,82,5.86,50,250,2620,9.2,0.15832967
1987,1987,Ben Lovejoy,2019-20,35.0,12,9,71,71,2,7,9,95.0,1213.0,544,20,81,101,717.0,82,5.96,47,239,2579,9.5,0.1589
1988,1988,Ben Maxwell,2009-10,21.0,2,0,7,7,0,0,0,2.0,69.0,7,0,0,0,2.0,82,5.7,65,341,2477,9.4,0.18309438
1989,1989,Ben Maxwell,2010-11,22.0,3,0,13,13,0,0,0,6.0,114.0,20,0,0,0,8.0,82,5.53,56,304,2486,9.1,0.15479094
1990,1990,Ben Maxwell,2011-12,23.0,4,2,12,12,1,1,2,13.0,144.0,32,1,1,2,21.0,82,5.46,52,291,2492,9.0,0.21165174
1991,1991,Ben Maxwell,2012-13,24.0,5,6,15,15,1,5,6,10.0,101.0,47,2,6,8,31.0,82,5.32,47,271,2439,8.9,0.2008133
1992,1992,Ben Ondrus,2006-07,24.0,2,0,22,22,0,0,0,17.0,223.0,22,0,0,0,17.0,82,6.05,85,480,2458,10.1,0.13909313
1993,1993,Ben Ondrus,2007-08,25.0,3,2,16,16,0,2,2,7.0,78.0,38,0,2,2,24.0,82,5.76,70,398,2426,9.7,0.15592271
1994,1994,Ben Ondrus,2008-09,26.0,4,0,3,3,0,0,0,4.0,15.0,41,0,2,2,28.0,82,5.44,62,351,2383,9.4,0.1419172
1995,1995,Ben Ondrus,2009-10,27.0,5,0,11,11,0,0,0,2.0,104.0,52,0,2,2,30.0,82,5.7,65,341,2477,9.4,0.11466017
1996,1996,Ben Sexton,2018-19,27.0,2,0,2,2,0,0,0,1.0,21.0,2,0,0,0,1.0,82,5.86,50,250,2620,9.2,0.15240568
1997,1997,Ben Simon,2002-03,24.0,2,0,6,6,0,0,0,7.0,56.0,6,0,0,0,7.0,82,5.24,53,338,2262,9.5,0.16952816
1998,1998,Ben Simon,2003-04,25.0,3,1,10,10,0,1,1,7.0,94.0,16,0,1,1,14.0,82,5.31,60,363,2326,9.4,0.15279669
1999,1999,Ben Simon,2004-05,26.0,4,3,52,52,3,0,3,30.0,316.0,68,3,1,4,44.0,82,5.14,57,348,2300,9.2,0.11523929
2000,2000,Ben Simon,2006-07,28.0,5,0,13,13,0,0,0,7.0,73.0,81,3,1,4,51.0,82,6.05,85,480,2458,10.1,0.11861253
2001,2001,Ben Smith,2011-12,23.0,2,1,6,6,1,0,1,6.0,83.0,6,1,0,1,6.0,82,5.46,52,291,2492,9.0,0.21782991
2002,2002,Ben Smith,2012-13,24.0,3,2,13,13,2,0,2,18.0,128.0,19,3,0,3,24.0,82,5.32,47,271,2439,8.9,0.22189102
2003,2003,Ben Smith,2013-14,25.0,4,1,1,1,1,0,1,1.0,18.0,20,4,0,4,25.0,48,5.31,29,160,1399,9.1,0.21057591
2004,2004,Ben Smith,2014-15,26.0,5,26,75,75,14,12,26,90.0,955.0,95,18,12,30,115.0,82,5.34,48,269,2463,8.9,0.33142167
2005,2005,Ben Smith,2015-16,27.0,6,14,80,80,7,7,14,92.0,1044.0,175,25,19,44,207.0,82,5.32,47,251,2453,8.9,0.20655233
2006,2006,Ben Smith,2016-17,28.0,7,6,22,22,2,4,6,17.0,266.0,197,27,23,50,224.0,82,5.34,48,255,2438,9.0,0.19909257
2007,2007,Ben Smith,2017-18,29.0,8,4,40,40,2,2,4,30.0,459.0,237,29,25,54,254.0,82,5.45,47,245,2478,9.0,0.1546964
2008,2008,Ben Street,2013-14,26.0,2,1,6,6,0,1,1,13.0,82.0,6,0,1,1,13.0,48,5.31,29,160,1399,9.1,0.21032959
2009,2009,Ben Street,2014-15,27.0,3,1,13,13,0,1,1,17.0,138.0,19,0,2,2,30.0,82,5.34,48,269,2463,8.9,0.16649729
2010,2010,Ben Street,2015-16,28.0,4,0,3,3,0,0,0,4.0,35.0,22,0,2,2,34.0,82,5.32,47,251,2453,8.9,0.14027521
2011,2011,Ben Street,2016-17,29.0,5,0,7,7,0,0,0,8.0,51.0,29,0,2,2,42.0,82,5.34,48,255,2438,9.0,0.13071096
2012,2012,Ben Street,2017-18,30.0,6,1,6,6,0,1,1,8.0,50.0,35,0,3,3,50.0,82,5.45,47,245,2478,9.0,0.124409705
2013,2013,Ben Street,2019-20,32.0,7,5,21,21,3,2,5,19.0,253.0,56,3,5,8,69.0,82,5.96,47,239,2579,9.5,0.17531034
2014,2014,Ben Street,2020-21,33.0,8,1,3,3,0,1,1,4.0,24.0,59,3,6,9,73.0,70,5.96,42,208,2192,9.5,0.15396443
2015,2015,Ben Thomson,2017-18,25.0,2,0,3,3,0,0,0,7.0,33.0,3,0,0,0,7.0,82,5.45,47,245,2478,9.0,0.17064324
2016,2016,Ben Walter,2006-07,22.0,2,0,6,6,0,0,0,6.0,71.0,6,0,0,0,6.0,82,6.05,85,480,2458,10.1,0.1856696
2017,2017,Ben Walter,2007-08,23.0,3,0,4,4,0,0,0,0.0,25.0,10,0,0,0,6.0,82,5.76,70,398,2426,9.7,0.16333917
2018,2018,Ben Walter,2008-09,24.0,4,1,8,8,1,0,1,6.0,49.0,18,1,0,1,12.0,82,5.44,62,351,2383,9.4,0.18514329
2019,2019,Ben Walter,2009-10,25.0,5,0,4,4,0,0,0,2.0,44.0,22,1,0,1,14.0,82,5.7,65,341,2477,9.4,0.15067759
2020,2020,Ben Walter,2010-11,26.0,6,0,2,2,0,0,0,0.0,12.0,24,1,0,1,14.0,82,5.53,56,304,2486,9.1,0.14116192
2021,2021,Bengt Lundholm,1982-83,27.0,2,44,66,66,14,30,44,99.0,,66,14,30,44,99.0,80,8.03,73,320,2489,12.9,0.6007934
2022,2022,Bengt Lundholm,1983-84,28.0,3,42,58,58,14,28,42,60.0,,124,28,58,86,159.0,80,7.73,71,310,2444,12.7,0.52335024
2023,2023,Bengt Lundholm,1984-85,29.0,4,19,57,57,5,14,19,48.0,,181,33,72,105,207.0,80,7.89,74,336,2448,12.9,0.35107595
2024,2024,Bengt Lundholm,1985-86,30.0,5,30,78,78,12,18,30,59.0,,259,45,90,135,266.0,80,7.77,71,321,2447,12.7,0.37563267
2025,2025,Bengt Lundholm,1986-87,31.0,6,8,16,16,3,5,8,14.0,,275,48,95,143,280.0,80,7.94,82,370,2484,12.8,0.32146472
2026,2026,Bengt-Ake Gustafsson,1980-81,22.0,2,60,80,80,22,38,60,185.0,,80,22,38,60,185.0,80,7.03,61,280,2352,12.0,0.7839211
2027,2027,Bengt-Ake Gustafsson,1981-82,23.0,3,55,72,72,21,34,55,170.0,,152,43,72,115,355.0,80,7.69,77,340,2441,12.6,0.74152684
2028,2028,Bengt-Ake Gustafsson,1982-83,24.0,4,60,70,70,26,34,60,144.0,,222,69,106,175,499.0,80,8.03,73,320,2489,12.9,0.8308997
2029,2029,Bengt-Ake Gustafsson,1983-84,25.0,5,64,67,67,22,42,64,138.0,,289,91,148,239,637.0,80,7.73,71,310,2444,12.7,0.8375129
2030,2030,Bengt-Ake Gustafsson,1984-85,26.0,6,75,69,69,32,43,75,146.0,,358,123,191,314,783.0,80,7.89,74,336,2448,12.9,0.92244655
2031,2031,Bengt-Ake Gustafsson,1985-86,27.0,7,42,51,51,13,29,42,98.0,,409,136,220,356,881.0,80,7.77,71,321,2447,12.7,0.77798843
2032,2032,Bengt-Ake Gustafsson,1986-87,28.0,8,75,70,70,23,52,75,113.0,,479,159,272,431,994.0,80,7.94,82,370,2484,12.8,0.75693595
2033,2033,Bengt-Ake Gustafsson,1988-89,30.0,9,54,78,78,18,36,54,136.0,,557,177,308,485,1130.0,80,7.43,89,437,2435,12.2,0.7074671
2034,2034,Bengt-Ake Gustafsson,1989-90,31.0,10,69,72,72,18,51,69,107.0,,629,195,359,554,1237.0,80,7.48,85,403,2430,12.3,0.72739756
2035,2035,Benn Ferriero,2010-11,23.0,2,5,24,24,2,3,5,42.0,267.0,24,2,3,5,42.0,82,5.53,56,304,2486,9.1,0.25218982
2036,2036,Benn Ferriero,2011-12,24.0,3,9,33,33,5,4,9,56.0,432.0,57,7,7,14,98.0,82,5.46,52,291,2492,9.0,0.27388218
2037,2037,Benn Ferriero,2012-13,25.0,4,8,35,35,7,1,8,68.0,422.0,92,14,8,22,166.0,82,5.32,47,271,2439,8.9,0.28103548
2038,2038,Benn Ferriero,2013-14,26.0,5,1,4,4,0,1,1,4.0,38.0,96,14,9,23,170.0,48,5.31,29,160,1399,9.1,0.21209118
2039,2039,Benn Ferriero,2014-15,27.0,6,0,2,2,0,0,0,0.0,9.0,98,14,9,23,170.0,82,5.34,48,269,2463,8.9,0.15668657
2040,2040,Bennett Wolf,1981-82,22.0,2,1,24,24,0,1,1,14.0,,24,0,1,1,14.0,80,7.69,77,340,2441,12.6,0.17529434
2041,2041,Bennett Wolf,1982-83,23.0,3,0,1,1,0,0,0,0.0,,25,0,1,1,14.0,80,8.03,73,320,2489,12.9,0.18936637
2042,2042,Bennett Wolf,1983-84,24.0,4,0,5,5,0,0,0,4.0,,30,0,1,1,18.0,80,7.73,71,310,2444,12.7,0.19268546
2043,2043,Benoit Brunet,1989-90,21.0,2,1,2,2,0,1,1,1.0,,2,0,1,1,1.0,80,7.48,85,403,2430,12.3,0.28862292
2044,2044,Benoit Brunet,1991-92,23.0,3,4,17,17,1,3,4,12.0,,19,1,4,5,13.0,80,6.91,71,366,2385,11.6,0.24602434
2045,2045,Benoit Brunet,1992-93,24.0,4,10,18,18,4,6,10,37.0,,37,5,10,15,50.0,80,6.96,77,402,2440,11.4,0.35178745
2046,2046,Benoit Brunet,1993-94,25.0,5,25,47,47,10,15,25,71.0,,84,15,25,40,121.0,84,7.25,87,443,2603,11.7,0.380782
2047,2047,Benoit Brunet,1994-95,26.0,6,30,71,71,10,20,30,92.0,,155,25,45,70,213.0,84,6.48,76,407,2545,10.7,0.38608965
2048,2048,Benoit Brunet,1995-96,27.0,7,25,45,45,7,18,25,80.0,,200,32,63,95,293.0,48,5.97,37,209,1408,10.2,0.45447803
2049,2049,Benoit Brunet,1996-97,28.0,8,15,26,26,7,8,15,48.0,,226,39,71,110,341.0,82,6.29,74,413,2481,10.4,0.41457814
2050,2050,Benoit Brunet,1997-98,29.0,9,23,39,39,10,13,23,63.0,,265,49,84,133,404.0,82,5.83,55,336,2444,9.8,0.4546828
2051,2051,Benoit Brunet,1998-99,30.0,10,32,68,68,12,20,32,87.0,,333,61,104,165,491.0,82,5.28,57,380,2242,9.6,0.42561033
2052,2052,Benoit Brunet,1999-00,31.0,11,31,60,60,14,17,31,115.0,1067.0,393,75,121,196,606.0,82,5.27,57,359,2285,9.4,0.4785853
2053,2053,Benoit Brunet,2000-01,32.0,12,29,50,50,14,15,29,103.0,899.0,443,89,136,225,709.0,82,5.49,53,331,2294,9.8,0.47136992
2054,2054,Benoit Brunet,2001-02,33.0,13,14,35,35,3,11,14,61.0,583.0,478,92,147,239,770.0,82,5.51,63,376,2272,9.9,0.2712835
2055,2055,Benoit Brunet,2002-03,34.0,14,23,61,61,9,14,23,72.0,847.0,539,101,161,262,842.0,82,5.24,53,338,2262,9.5,0.30555803
2056,2056,Benoit Dusablon,2004-05,25.0,2,0,3,3,0,0,0,3.0,25.0,3,0,0,0,3.0,82,5.14,57,348,2300,9.2,0.1792824
2057,2057,Benoit Gratton,1998-99,22.0,2,1,6,6,0,1,1,5.0,,6,0,1,1,5.0,82,5.28,57,380,2242,9.6,0.20794392
2058,2058,Benoit Gratton,1999-00,23.0,3,7,16,16,4,3,7,24.0,215.0,22,4,4,8,29.0,82,5.27,57,359,2285,9.4,0.31992227
2059,2059,Benoit Gratton,2000-01,24.0,4,2,10,10,0,2,2,4.0,83.0,32,4,6,10,33.0,82,5.49,53,331,2294,9.8,0.18623981
2060,2060,Benoit Gratton,2001-02,25.0,5,4,14,14,1,3,4,13.0,129.0,46,5,9,14,46.0,82,5.51,63,376,2272,9.9,0.2070401
2061,2061,Benoit Gratton,2002-03,26.0,6,1,8,8,1,0,1,8.0,79.0,54,6,9,15,54.0,82,5.24,53,338,2262,9.5,0.17783535
2062,2062,Benoit Gratton,2004-05,28.0,7,1,4,4,0,1,1,3.0,39.0,58,6,10,16,57.0,82,5.14,57,348,2300,9.2,0.19017592
2063,2063,Benoit Hogue,1988-89,22.0,2,2,3,3,1,1,2,3.0,,3,1,1,2,3.0,80,7.43,89,437,2435,12.2,0.29383796
2064,2064,Benoit Hogue,1989-90,23.0,3,44,69,69,14,30,44,114.0,,72,15,31,46,117.0,80,7.48,85,403,2430,12.3,0.5939442
2065,2065,Benoit Hogue,1990-91,24.0,4,18,45,45,11,7,18,73.0,,117,26,38,64,190.0,80,7.37,76,367,2421,12.2,0.45204738
2066,2066,Benoit Hogue,1991-92,25.0,5,47,76,76,19,28,47,134.0,,193,45,66,111,324.0,80,6.91,71,366,2385,11.6,0.6053837
2067,2067,Benoit Hogue,1992-93,26.0,6,76,75,75,30,46,76,149.0,,268,75,112,187,473.0,80,6.96,77,402,2440,11.4,0.90061754
2068,2068,Benoit Hogue,1993-94,27.0,7,75,70,70,33,42,75,147.0,,338,108,154,262,620.0,84,7.25,87,443,2603,11.7,0.7830865
2069,2069,Benoit Hogue,1994-95,28.0,8,69,83,83,36,33,69,218.0,,421,144,187,331,838.0,84,6.48,76,407,2545,10.7,0.6977361
2070,2070,Benoit Hogue,1995-96,29.0,9,16,45,45,9,7,16,66.0,,466,153,194,347,904.0,48,5.97,37,209,1408,10.2,0.46238625
2071,2071,Benoit Hogue,1996-97,30.0,10,64,78,78,19,45,64,155.0,,544,172,239,411,1059.0,82,6.29,74,413,2481,10.4,0.67362595
2072,2072,Benoit Hogue,1997-98,31.0,11,43,73,73,19,24,43,131.0,,617,191,263,454,1190.0,82,5.83,55,336,2444,9.8,0.48979244
2073,2073,Benoit Hogue,1998-99,32.0,12,22,53,53,6,16,22,55.0,,670,197,279,476,1245.0,82,5.28,57,380,2242,9.6,0.37568453
2074,2074,Benoit Hogue,1999-00,33.0,13,29,74,74,12,17,29,121.0,1197.0,744,209,296,505,1366.0,82,5.27,57,359,2285,9.4,0.39851367
2075,2075,Benoit Hogue,2000-01,34.0,14,13,27,27,3,10,13,39.0,425.0,771,212,306,518,1405.0,82,5.49,53,331,2294,9.8,0.3317975
2076,2076,Benoit Hogue,2001-02,35.0,15,10,34,34,3,7,10,35.0,424.0,805,215,313,528,1440.0,82,5.51,63,376,2272,9.9,0.25088388
2077,2077,Benoit Hogue,2002-03,36.0,16,15,58,58,7,8,15,42.0,651.0,863,222,321,543,1482.0,82,5.24,53,338,2262,9.5,0.2401894
2078,2078,Benoit Pouliot,2007-08,21.0,2,0,3,3,0,0,0,1.0,21.0,3,0,0,0,1.0,82,5.76,70,398,2426,9.7,0.18608436
2079,2079,Benoit Pouliot,2008-09,22.0,3,3,11,11,2,1,3,10.0,97.0,14,2,1,3,11.0,82,5.44,62,351,2383,9.4,0.2580623
2080,2080,Benoit Pouliot,2009-10,23.0,4,11,37,37,5,6,11,34.0,438.0,51,7,7,14,45.0,82,5.7,65,341,2477,9.4,0.27353933
2081,2081,Benoit Pouliot,2010-11,24.0,5,28,53,53,17,11,28,111.0,820.0,104,24,18,42,156.0,82,5.53,56,304,2486,9.1,0.47147352
2082,2082,Benoit Pouliot,2011-12,25.0,6,30,79,79,13,17,30,129.0,911.0,183,37,35,72,285.0,82,5.46,52,291,2492,9.0,0.40424585
2083,2083,Benoit Pouliot,2012-13,26.0,7,32,74,74,16,16,32,107.0,904.0,257,53,51,104,392.0,82,5.32,47,271,2439,8.9,0.42997032
2084,2084,Benoit Pouliot,2013-14,27.0,8,20,34,34,8,12,20,60.0,450.0,291,61,63,124,452.0,48,5.31,29,160,1399,9.1,0.460738
2085,2085,Benoit Pouliot,2014-15,28.0,9,36,80,80,15,21,36,141.0,1075.0,371,76,84,160,593.0,82,5.34,48,269,2463,8.9,0.4401924
2086,2086,Benoit Pouliot,2015-16,29.0,10,34,58,58,19,15,34,105.0,964.0,429,95,99,194,698.0,82,5.32,47,251,2453,8.9,0.47374758
2087,2087,Benoit Pouliot,2016-17,30.0,11,36,55,55,14,22,36,109.0,883.0,484,109,121,230,807.0,82,5.34,48,255,2438,9.0,0.48473272
2088,2088,Benoit Pouliot,2017-18,31.0,12,14,67,67,8,6,14,77.0,942.0,551,117,127,244,884.0,82,5.45,47,245,2478,9.0,0.21483344
2089,2089,Benoit Pouliot,2018-19,32.0,13,19,74,74,13,6,19,83.0,1013.0,625,130,133,263,967.0,82,5.86,50,250,2620,9.2,0.27577907
2090,2090,Bernie Johnston,1980-81,24.0,2,21,32,32,8,13,21,54.0,,32,8,13,21,54.0,80,7.03,61,280,2352,12.0,0.47712636
2091,2091,Bernie Johnston,1981-82,25.0,3,15,25,25,4,11,15,34.0,,57,12,24,36,88.0,80,7.69,77,340,2441,12.6,0.4305885
2092,2092,Bernie Nicholls,1982-83,21.0,2,32,22,22,14,18,32,63.0,,22,14,18,32,63.0,80,8.03,73,320,2489,12.9,0.7870985
2093,2093,Bernie Nicholls,1983-84,22.0,3,50,71,71,28,22,50,171.0,,93,42,40,82,234.0,80,7.73,71,310,2444,12.7,0.78540653
2094,2094,Bernie Nicholls,1984-85,23.0,4,95,78,78,41,54,95,255.0,,171,83,94,177,489.0,80,7.89,74,336,2448,12.9,1.1444881
2095,2095,Bernie Nicholls,1985-86,24.0,5,100,80,80,46,54,100,329.0,,251,129,148,277,818.0,80,7.77,71,321,2447,12.7,1.1977437
2096,2096,Bernie Nicholls,1986-87,25.0,6,97,80,80,36,61,97,281.0,,331,165,209,374,1099.0,80,7.94,82,370,2484,12.8,1.0825322
2097,2097,Bernie Nicholls,1987-88,26.0,7,81,80,80,33,48,81,227.0,,411,198,257,455,1326.0,80,7.34,72,344,2400,12.2,1.0352889
2098,2098,Bernie Nicholls,1988-89,27.0,8,78,65,65,32,46,78,236.0,,476,230,303,533,1562.0,80,7.43,89,437,2435,12.2,1.3105394
2099,2099,Bernie Nicholls,1989-90,28.0,9,150,79,79,70,80,150,385.0,,555,300,383,683,1947.0,80,7.48,85,403,2430,12.3,1.4386897
2100,2100,Bernie Nicholls,1990-91,29.0,10,112,79,79,39,73,112,287.0,,634,339,456,795,2234.0,80,7.37,76,367,2421,12.2,1.162713
2101,2101,Bernie Nicholls,1991-92,30.0,11,73,71,71,25,48,73,163.0,,705,364,504,868,2397.0,80,6.91,71,366,2385,11.6,0.9311044
2102,2102,Bernie Nicholls,1992-93,31.0,12,49,50,50,20,29,49,117.0,,755,384,533,917,2514.0,80,6.96,77,402,2440,11.4,0.928962
2103,2103,Bernie Nicholls,1993-94,32.0,13,60,69,69,13,47,60,132.0,,824,397,580,977,2646.0,84,7.25,87,443,2603,11.7,0.784034
2104,2104,Bernie Nicholls,1994-95,33.0,14,46,61,61,19,27,46,142.0,,885,416,607,1023,2788.0,84,6.48,76,407,2545,10.7,0.7326985
2105,2105,Bernie Nicholls,1995-96,34.0,15,51,48,48,22,29,51,114.0,,933,438,636,1074,2902.0,48,5.97,37,209,1408,10.2,1.0319331
2106,2106,Bernie Nicholls,1996-97,35.0,16,60,59,59,19,41,60,100.0,,992,457,677,1134,3002.0,82,6.29,74,413,2481,10.4,0.73893046
2107,2107,Bernie Nicholls,1997-98,36.0,17,45,65,65,12,33,45,137.0,,1057,469,710,1179,3139.0,82,5.83,55,336,2444,9.8,0.56200594
2108,2108,Bernie Nicholls,1998-99,37.0,18,28,60,60,6,22,28,81.0,,1117,475,732,1207,3220.0,82,5.28,57,380,2242,9.6,0.38919044
2109,2109,Bernie Nicholls,1999-00,38.0,19,2,10,10,0,2,2,11.0,110.0,1127,475,734,1209,3231.0,82,5.27,57,359,2285,9.4,0.3951666
2110,2110,Bernie Saunders,1980-81,24.0,2,0,4,4,0,0,0,4.0,,4,0,0,0,4.0,80,7.03,61,280,2352,12.0,0.22482711
2111,2111,Bernie Saunders,1981-82,25.0,3,1,6,6,0,1,1,5.0,,10,0,1,1,9.0,80,7.69,77,340,2441,12.6,0.20548677
2112,2112,Bert Robertsson,1998-99,24.0,2,6,30,30,2,4,6,19.0,,30,2,4,6,19.0,82,5.28,57,380,2242,9.6,0.19734916
2113,2113,Bert Robertsson,1999-00,25.0,3,4,39,39,2,2,4,13.0,290.0,69,4,6,10,32.0,82,5.27,57,359,2285,9.4,0.13429564
2114,2114,Bert Robertsson,2000-01,26.0,4,4,52,52,0,4,4,31.0,562.0,121,4,10,14,63.0,82,5.49,53,331,2294,9.8,0.10295871
2115,2115,Bert Robertsson,2001-02,27.0,5,0,2,2,0,0,0,0.0,11.0,123,4,10,14,63.0,82,5.51,63,376,2272,9.9,0.12542704
2116,2116,Bill Armstrong,1991-92,25.0,2,1,1,1,0,1,1,1.0,,1,0,1,1,1.0,80,6.91,71,366,2385,11.6,0.21080127
2117,2117,Bill Arnold,2014-15,22.0,2,0,1,1,0,0,0,0.0,14.0,1,0,0,0,0.0,82,5.34,48,269,2463,8.9,0.14922687
2118,2118,Bill Baker,1981-82,25.0,2,3,24,24,0,3,3,25.0,,24,0,3,3,25.0,80,7.69,77,340,2441,12.6,0.22203317
2119,2119,Bill Baker,1982-83,26.0,3,11,49,49,3,8,11,55.0,,73,3,11,14,80.0,80,8.03,73,320,2489,12.9,0.25638038
2120,2120,Bill Baker,1983-84,27.0,4,18,70,70,4,14,18,65.0,,143,7,25,32,145.0,80,7.73,71,310,2444,12.7,0.24019477
2121,2121,Bill Berg,1989-90,22.0,2,3,7,7,1,2,3,10.0,,7,1,2,3,10.0,80,7.48,85,403,2430,12.3,0.290389
2122,2122,Bill Berg,1991-92,24.0,3,23,78,78,9,14,23,95.0,,85,10,16,26,105.0,80,6.91,71,366,2385,11.6,0.3265624
2123,2123,Bill Berg,1992-93,25.0,4,14,47,47,5,9,14,60.0,,132,15,25,40,165.0,80,6.96,77,402,2440,11.4,0.30720276
2124,2124,Bill Berg,1993-94,26.0,5,24,80,80,13,11,24,113.0,,212,28,36,64,278.0,84,7.25,87,443,2603,11.7,0.32281268
2125,2125,Bill Berg,1994-95,27.0,6,19,83,83,8,11,19,99.0,,295,36,47,83,377.0,84,6.48,76,407,2545,10.7,0.2451236
2126,2126,Bill Berg,1995-96,28.0,7,6,32,32,5,1,6,57.0,,327,41,48,89,434.0,48,5.97,37,209,1408,10.2,0.26373544
2127,2127,Bill Berg,1996-97,29.0,8,5,41,41,3,2,5,60.0,,368,44,50,94,494.0,82,6.29,74,413,2481,10.4,0.20051503
2128,2128,Bill Berg,1997-98,30.0,9,14,67,67,8,6,14,84.0,,435,52,56,108,578.0,82,5.83,55,336,2444,9.8,0.21378082
2129,2129,Bill Berg,1998-99,31.0,10,10,67,67,1,9,10,74.0,,502,53,65,118,652.0,82,5.28,57,380,2242,9.6,0.19447544
2130,2130,Bill Berg,1999-00,32.0,11,4,44,44,2,2,4,40.0,455.0,546,55,67,122,692.0,82,5.27,57,359,2285,9.4,0.145286
2131,2131,Bill Bowler,2001-02,27.0,2,2,9,9,0,2,2,3.0,88.0,9,0,2,2,3.0,82,5.51,63,376,2272,9.9,0.15158561
2132,2132,Bill Gardner,1981-82,21.0,2,0,1,1,0,0,0,0.0,,1,0,0,0,0.0,80,7.69,77,340,2441,12.6,0.216385
2133,2133,Bill Gardner,1982-83,22.0,3,23,69,69,8,15,23,66.0,,70,8,15,23,66.0,80,8.03,73,320,2489,12.9,0.349401
2134,2134,Bill Gardner,1983-84,23.0,4,40,77,77,15,25,40,105.0,,147,23,40,63,171.0,80,7.73,71,310,2444,12.7,0.5074033
2135,2135,Bill Gardner,1984-85,24.0,5,48,79,79,27,21,48,115.0,,226,50,61,111,286.0,80,7.89,74,336,2448,12.9,0.58765423
2136,2136,Bill Gardner,1985-86,25.0,6,51,74,74,17,34,51,119.0,,300,67,95,162,405.0,80,7.77,71,321,2447,12.7,0.60348207
2137,2137,Bill Gardner,1986-87,26.0,7,22,64,64,4,18,22,41.0,,364,71,113,184,446.0,80,7.94,82,370,2484,12.8,0.28755385
2138,2138,Bill Gardner,1987-88,27.0,8,1,8,8,0,1,1,7.0,,372,71,114,185,453.0,80,7.34,72,344,2400,12.2,0.41763324
2139,2139,Bill Gardner,1988-89,28.0,9,1,2,2,1,0,1,1.0,,374,72,114,186,454.0,80,7.43,89,437,2435,12.2,0.3132522
2140,2140,Bill Gardner,1989-90,29.0,10,2,6,6,1,1,2,4.0,,380,73,115,188,458.0,80,7.48,85,403,2430,12.3,0.32384056
2141,2141,Bill Guerin,1992-93,22.0,2,1,5,5,0,1,1,8.0,,5,0,1,1,8.0,80,6.96,77,402,2440,11.4,0.24874854
2142,2142,Bill Guerin,1993-94,23.0,3,34,65,65,14,20,34,123.0,,70,14,21,35,131.0,84,7.25,87,443,2603,11.7,0.49533397
2143,2143,Bill Guerin,1994-95,24.0,4,44,81,81,25,19,44,195.0,,151,39,40,79,326.0,84,6.48,76,407,2545,10.7,0.57960004
2144,2144,Bill Guerin,1995-96,25.0,5,25,48,48,12,13,25,96.0,,199,51,53,104,422.0,48,5.97,37,209,1408,10.2,0.55894136
2145,2145,Bill Guerin,1996-97,26.0,6,53,80,80,23,30,53,216.0,,279,74,83,157,638.0,82,6.29,74,413,2481,10.4,0.6006855
2146,2146,Bill Guerin,1997-98,27.0,7,47,82,82,29,18,47,177.0,,361,103,101,204,815.0,82,5.83,55,336,2444,9.8,0.5936393
2147,2147,Bill Guerin,1998-99,28.0,8,39,59,59,18,21,39,178.0,,420,121,122,243,993.0,82,5.28,57,380,2242,9.6,0.6569567
2148,2148,Bill Guerin,1999-00,29.0,9,64,80,80,30,34,64,261.0,1576.0,500,151,156,307,1254.0,82,5.27,57,359,2285,9.4,0.75380135
2149,2149,Bill Guerin,2000-01,30.0,10,46,70,70,24,22,46,188.0,1262.0,570,175,178,353,1442.0,82,5.49,53,331,2294,9.8,0.6496757
2150,2150,Bill Guerin,2001-02,31.0,11,85,85,85,40,45,85,289.0,1870.0,655,215,223,438,1731.0,82,5.51,63,376,2272,9.9,0.89746577
2151,2151,Bill Guerin,2002-03,32.0,12,66,78,78,41,25,66,355.0,1618.0,733,256,248,504,2086.0,82,5.24,53,338,2262,9.5,0.7713444
2152,2152,Bill Guerin,2003-04,33.0,13,50,64,64,25,25,50,229.0,1187.0,797,281,273,554,2315.0,82,5.31,60,363,2326,9.4,0.7388627
2153,2153,Bill Guerin,2004-05,34.0,14,69,82,82,34,35,69,263.0,1533.0,879,315,308,623,2578.0,82,5.14,57,348,2300,9.2,0.7835111
2154,2154,Bill Guerin,2006-07,36.0,15,40,70,70,13,27,40,210.0,1150.0,949,328,335,663,2788.0,82,6.05,85,480,2458,10.1,0.581969
2155,2155,Bill Guerin,2007-08,37.0,16,56,77,77,36,20,56,225.0,1309.0,1026,364,355,719,3013.0,82,5.76,70,398,2426,9.7,0.60870916
2156,2156,Bill Guerin,2008-09,38.0,17,44,81,81,23,21,44,227.0,1408.0,1107,387,376,763,3240.0,82,5.44,62,351,2383,9.4,0.5171464
2157,2157,Bill Guerin,2009-10,39.0,18,48,78,78,21,27,48,226.0,1300.0,1185,408,403,811,3466.0,82,5.7,65,341,2477,9.4,0.5484905
2158,2158,Bill Guerin,2010-11,40.0,19,45,78,78,21,24,45,227.0,1367.0,1263,429,427,856,3693.0,82,5.53,56,304,2486,9.1,0.50590837
2159,2159,Bill Houlder,1988-89,21.0,2,3,30,30,1,2,3,20.0,,30,1,2,3,20.0,80,7.43,89,437,2435,12.2,0.27668065
2160,2160,Bill Houlder,1989-90,22.0,3,3,8,8,0,3,3,5.0,,38,1,5,6,25.0,80,7.48,85,403,2430,12.3,0.23648003
2161,2161,Bill Houlder,1990-91,23.0,4,12,41,41,1,11,12,49.0,,79,2,16,18,74.0,80,7.37,76,367,2421,12.2,0.25856704
2162,2162,Bill Houlder,1991-92,24.0,5,2,7,7,0,2,2,7.0,,86,2,18,20,81.0,80,6.91,71,366,2385,11.6,0.21709177
2163,2163,Bill Houlder,1992-93,25.0,6,1,10,10,1,0,1,18.0,,96,3,18,21,99.0,80,6.96,77,402,2440,11.4,0.23780647
2164,2164,Bill Houlder,1993-94,26.0,7,8,15,15,3,5,8,29.0,,111,6,23,29,128.0,84,7.25,87,443,2603,11.7,0.3174696
2165,2165,Bill Houlder,1994-95,27.0,8,39,80,80,14,25,39,187.0,,191,20,48,68,315.0,84,6.48,76,407,2545,10.7,0.46489
2166,2166,Bill Houlder,1995-96,28.0,9,18,41,41,5,13,18,59.0,,232,25,61,86,374.0,48,5.97,37,209,1408,10.2,0.373741
2167,2167,Bill Houlder,1996-97,29.0,10,28,61,61,5,23,28,90.0,,293,30,84,114,464.0,82,6.29,74,413,2481,10.4,0.3719977
2168,2168,Bill Houlder,1997-98,30.0,11,25,79,79,4,21,25,116.0,,372,34,105,139,580.0,82,5.83,55,336,2444,9.8,0.28072643
2169,2169,Bill Houlder,1998-99,31.0,12,32,82,82,7,25,32,102.0,,454,41,130,171,682.0,82,5.28,57,380,2242,9.6,0.3498633
2170,2170,Bill Houlder,1999-00,32.0,13,32,76,76,9,23,32,115.0,1682.0,530,50,153,203,797.0,82,5.27,57,359,2285,9.4,0.36589515
2171,2171,Bill Houlder,2000-01,33.0,14,17,71,71,3,14,17,89.0,1589.0,601,53,167,220,886.0,82,5.49,53,331,2294,9.8,0.22912765
2172,2172,Bill Houlder,2001-02,34.0,15,16,81,81,4,12,16,78.0,1717.0,682,57,179,236,964.0,82,5.51,63,376,2272,9.9,0.17999378
2173,2173,Bill Houlder,2002-03,35.0,16,8,82,82,0,8,8,44.0,1768.0,764,57,187,244,1008.0,82,5.24,53,338,2262,9.5,0.12044287
2174,2174,Bill Houlder,2003-04,36.0,17,6,82,82,2,4,6,51.0,1567.0,846,59,191,250,1059.0,82,5.31,60,363,2326,9.4,0.12262136
2175,2175,Bill Huard,1993-94,26.0,2,0,2,2,0,0,0,0.0,,2,0,0,0,0.0,84,7.25,87,443,2603,11.7,0.15710375
2176,2176,Bill Huard,1994-95,27.0,3,4,63,63,2,2,4,24.0,,65,2,2,4,24.0,84,6.48,76,407,2545,10.7,0.10779059
2177,2177,Bill Huard,1995-96,28.0,4,6,33,33,3,3,6,21.0,,98,5,5,10,45.0,48,5.97,37,209,1408,10.2,0.21736696
2178,2178,Bill Huard,1996-97,29.0,5,12,51,51,6,6,12,34.0,,149,11,11,22,79.0,82,6.29,74,413,2481,10.4,0.17773002
2179,2179,Bill Huard,1997-98,30.0,6,11,40,40,5,6,11,34.0,,189,16,17,33,113.0,82,5.83,55,336,2444,9.8,0.16648039
2180,2180,Bill Huard,1998-99,31.0,7,1,30,30,0,1,1,12.0,,219,16,18,34,125.0,82,5.28,57,380,2242,9.6,0.08691099
2181,2181,Bill Huard,1999-00,32.0,8,0,3,3,0,0,0,2.0,17.0,222,16,18,34,127.0,82,5.27,57,359,2285,9.4,0.1272431
2182,2182,Bill Huard,2000-01,33.0,9,0,1,1,0,0,0,0.0,2.0,223,16,18,34,127.0,82,5.49,53,331,2294,9.8,0.13889527
2183,2183,Bill Kitchen,1982-83,22.0,2,0,1,1,0,0,0,0.0,,1,0,0,0,0.0,80,8.03,73,320,2489,12.9,0.20696738
2184,2184,Bill Kitchen,1983-84,23.0,3,0,8,8,0,0,0,3.0,,9,0,0,0,3.0,80,7.73,71,310,2444,12.7,0.20689765
2185,2185,Bill Kitchen,1984-85,24.0,4,0,3,3,0,0,0,3.0,,12,0,0,0,6.0,80,7.89,74,336,2448,12.9,0.19827878
2186,2186,Bill Kitchen,1985-86,25.0,5,5,29,29,1,4,5,21.0,,41,1,4,5,27.0,80,7.77,71,321,2447,12.7,0.1745485
2187,2187,Bill Lindsay,1992-93,21.0,2,6,23,23,2,4,6,35.0,,23,2,4,6,35.0,80,6.96,77,402,2440,11.4,0.41189206
2188,2188,Bill Lindsay,1993-94,22.0,3,13,44,44,4,9,13,58.0,,67,6,13,19,93.0,84,7.25,87,443,2603,11.7,0.27782822
2189,2189,Bill Lindsay,1994-95,23.0,4,12,84,84,6,6,12,90.0,,151,12,19,31,183.0,84,6.48,76,407,2545,10.7,0.2416864
2190,2190,Bill Lindsay,1995-96,24.0,5,19,48,48,10,9,19,63.0,,199,22,28,50,246.0,48,5.97,37,209,1408,10.2,0.38243872
2191,2191,Bill Lindsay,1996-97,25.0,6,34,73,73,12,22,34,118.0,,272,34,50,84,364.0,82,6.29,74,413,2481,10.4,0.40165073
2192,2192,Bill Lindsay,1997-98,26.0,7,34,81,81,11,23,34,168.0,,353,45,73,118,532.0,82,5.83,55,336,2444,9.8,0.42424142
2193,2193,Bill Lindsay,1998-99,27.0,8,28,82,82,12,16,28,150.0,,435,57,89,146,682.0,82,5.28,57,380,2242,9.6,0.3766684
2194,2194,Bill Lindsay,1999-00,28.0,9,27,75,75,12,15,27,135.0,1021.0,510,69,104,173,817.0,82,5.27,57,359,2285,9.4,0.35292864
2195,2195,Bill Lindsay,2000-01,29.0,10,20,80,80,8,12,20,147.0,1034.0,590,77,116,193,964.0,82,5.49,53,331,2294,9.8,0.30821663
2196,2196,Bill Lindsay,2001-02,30.0,11,14,68,68,1,13,14,71.0,696.0,658,78,129,207,1035.0,82,5.51,63,376,2272,9.9,0.17862538
2197,2197,Bill Lindsay,2002-03,31.0,12,15,76,76,5,10,15,77.0,742.0,734,83,139,222,1112.0,82,5.24,53,338,2262,9.5,0.22139344
2198,2198,Bill Lindsay,2003-04,32.0,13,2,19,19,0,2,2,7.0,101.0,753,83,141,224,1119.0,82,5.31,60,363,2326,9.4,0.15904933
2199,2199,Bill Lindsay,2004-05,33.0,14,0,24,24,0,0,0,10.0,142.0,777,83,141,224,1129.0,82,5.14,57,348,2300,9.2,0.14994732
2200,2200,Bill McCreary,1981-82,21.0,2,1,12,12,1,0,1,7.0,,12,1,0,1,7.0,80,7.69,77,340,2441,12.6,0.24254113
2201,2201,Bill McDougall,1991-92,25.0,2,1,2,2,0,1,1,3.0,,2,0,1,1,3.0,80,6.91,71,366,2385,11.6,0.21080127
2202,2202,Bill McDougall,1993-94,27.0,3,3,4,4,2,1,3,8.0,,6,2,2,4,11.0,84,7.25,87,443,2603,11.7,0.2531345
2203,2203,Bill McDougall,1994-95,28.0,4,6,22,22,3,3,6,26.0,,28,5,5,10,37.0,84,6.48,76,407,2545,10.7,0.23898357
2204,2204,Bill Muckalt,1999-00,25.0,2,36,73,73,16,20,36,119.0,1124.0,73,16,20,36,119.0,82,5.27,57,359,2285,9.4,0.46643335
2205,2205,Bill Muckalt,2000-01,26.0,3,19,45,45,8,11,19,79.0,629.0,118,24,31,55,198.0,82,5.49,53,331,2294,9.8,0.3810341
2206,2206,Bill Muckalt,2001-02,27.0,4,26,60,60,11,15,26,90.0,823.0,178,35,46,81,288.0,82,5.51,63,376,2272,9.9,0.35321343
2207,2207,Bill Muckalt,2002-03,28.0,5,8,70,70,0,8,8,73.0,684.0,248,35,54,89,361.0,82,5.24,53,338,2262,9.5,0.24005699
2208,2208,Bill Muckalt,2003-04,29.0,6,8,8,8,5,3,8,13.0,104.0,256,40,57,97,374.0,82,5.31,60,363,2326,9.4,0.32328397
2209,2209,Bill O'Dwyer,1984-85,25.0,2,0,5,5,0,0,0,2.0,,5,0,0,0,2.0,80,7.89,74,336,2448,12.9,0.21237499
2210,2210,Bill O'Dwyer,1985-86,26.0,3,1,13,13,1,0,1,8.0,,18,1,0,1,10.0,80,7.77,71,321,2447,12.7,0.21832216
2211,2211,Bill O'Dwyer,1988-89,29.0,4,17,77,77,7,10,17,98.0,,95,8,10,18,108.0,80,7.43,89,437,2435,12.2,0.2682294
2212,2212,Bill O'Dwyer,1989-90,30.0,5,3,19,19,1,2,3,18.0,,114,9,12,21,126.0,80,7.48,85,403,2430,12.3,0.20477554
2213,2213,Bill O'Dwyer,1990-91,31.0,6,1,6,6,0,1,1,7.0,,120,9,13,22,133.0,80,7.37,76,367,2421,12.2,0.17260608
2214,2214,Bill Root,1983-84,24.0,2,5,46,46,2,3,5,44.0,,46,2,3,5,44.0,80,7.73,71,310,2444,12.7,0.20937425
2215,2215,Bill Root,1984-85,25.0,3,17,72,72,4,13,17,70.0,,118,6,16,22,114.0,80,7.89,74,336,2448,12.9,0.27074343
2216,2216,Bill Root,1985-86,26.0,4,2,35,35,1,1,2,34.0,,153,7,17,24,148.0,80,7.77,71,321,2447,12.7,0.17742154
2217,2217,Bill Root,1986-87,27.0,5,1,27,27,0,1,1,34.0,,180,7,18,25,182.0,80,7.94,82,370,2484,12.8,0.17130882
2218,2218,Bill Root,1987-88,28.0,6,6,34,34,3,3,6,31.0,,214,10,21,31,213.0,80,7.34,72,344,2400,12.2,0.1919322
2219,2219,Bill Root,1988-89,29.0,7,3,33,33,1,2,3,19.0,,247,11,23,34,232.0,80,7.43,89,437,2435,12.2,0.14622462
2220,2220,Bill Sweatt,2012-13,24.0,2,0,2,2,0,0,0,2.0,11.0,2,0,0,0,2.0,82,5.32,47,271,2439,8.9,0.16555953
2221,2221,Bill Sweatt,2013-14,25.0,3,0,1,1,0,0,0,0.0,12.0,3,0,0,0,2.0,48,5.31,29,160,1399,9.1,0.17501658
2222,2222,Bill Terry,1988-89,27.0,2,0,5,5,0,0,0,3.0,,5,0,0,0,3.0,80,7.43,89,437,2435,12.2,0.19070011
2223,2223,Bill Thomas,2006-07,23.0,2,3,9,9,1,2,3,15.0,122.0,9,1,2,3,15.0,82,6.05,85,480,2458,10.1,0.2527938
2224,2224,Bill Thomas,2007-08,24.0,3,14,24,24,8,6,14,60.0,324.0,33,9,8,17,75.0,82,5.76,70,398,2426,9.7,0.37526336
2225,2225,Bill Thomas,2008-09,25.0,4,0,7,7,0,0,0,9.0,92.0,40,9,8,17,84.0,82,5.44,62,351,2383,9.4,0.19728434
2226,2226,Bill Thomas,2009-10,26.0,5,3,16,16,2,1,3,17.0,152.0,56,11,9,20,101.0,82,5.7,65,341,2477,9.4,0.23205382
2227,2227,Bill Thomas,2011-12,28.0,6,7,24,24,4,3,7,33.0,204.0,80,15,12,27,134.0,82,5.46,52,291,2492,9.0,0.22282124
2228,2228,Bill Thomas,2012-13,29.0,7,1,7,7,1,0,1,9.0,61.0,87,16,12,28,143.0,82,5.32,47,271,2439,8.9,0.17713168
2229,2229,Bill Watson,1986-87,22.0,2,24,52,52,8,16,24,67.0,,52,8,16,24,67.0,80,7.94,82,370,2484,12.8,0.43106246
2230,2230,Bill Watson,1987-88,23.0,3,32,51,51,13,19,32,107.0,,103,21,35,56,174.0,80,7.34,72,344,2400,12.2,0.56964946
2231,2231,Bill Watson,1988-89,24.0,4,2,9,9,2,0,2,7.0,,112,23,35,58,181.0,80,7.43,89,437,2435,12.2,0.3711408
2232,2232,Bill Watson,1989-90,25.0,5,1,3,3,0,1,1,2.0,,115,23,36,59,183.0,80,7.48,85,403,2430,12.3,0.3021114
2233,2233,Bill Whelton,1981-82,22.0,2,0,2,2,0,0,0,1.0,,2,0,0,0,1.0,80,7.69,77,340,2441,12.6,0.23124611
2234,2234,Billy Carroll,1981-82,23.0,2,8,18,18,4,4,8,25.0,,18,4,4,8,25.0,80,7.69,77,340,2441,12.6,0.37527606
2235,2235,Billy Carroll,1982-83,24.0,3,29,72,72,9,20,29,42.0,,90,13,24,37,67.0,80,8.03,73,320,2489,12.9,0.3749956
2236,2236,Billy Carroll,1983-84,25.0,4,12,71,71,1,11,12,48.0,,161,14,35,49,115.0,80,7.73,71,310,2444,12.7,0.21990481
2237,2237,Billy Carroll,1984-85,26.0,5,7,39,39,5,2,7,39.0,,200,19,37,56,154.0,80,7.89,74,336,2448,12.9,0.2616375
2238,2238,Billy Carroll,1985-86,27.0,6,17,65,65,8,9,17,44.0,,265,27,46,73,198.0,80,7.77,71,321,2447,12.7,0.26184773
2239,2239,Billy Carroll,1986-87,28.0,7,8,26,26,2,6,8,13.0,,291,29,52,81,211.0,80,7.94,82,370,2484,12.8,0.25292748
2240,2240,Billy Carroll,1987-88,29.0,8,3,31,31,1,2,3,12.0,,322,30,54,84,223.0,80,7.34,72,344,2400,12.2,0.16513273
2241,2241,Billy Tibbetts,2001-02,27.0,2,3,29,29,1,2,3,16.0,210.0,29,1,2,3,16.0,82,5.51,63,376,2272,9.9,0.14578846
2242,2242,Billy Tibbetts,2002-03,28.0,3,7,42,42,1,6,7,48.0,459.0,71,2,8,10,64.0,82,5.24,53,338,2262,9.5,0.1459648
2243,2243,Billy Tibbetts,2003-04,29.0,4,0,11,11,0,0,0,6.0,110.0,82,2,8,10,70.0,82,5.31,60,363,2326,9.4,0.12972033
2244,2244,Bjorn Melin,2007-08,26.0,2,1,3,3,1,0,1,1.0,22.0,3,1,0,1,1.0,82,5.76,70,398,2426,9.7,0.21848038
2245,2245,Blair Atcheynum,1993-94,24.0,2,1,4,4,0,1,1,2.0,,4,0,1,1,2.0,84,7.25,87,443,2603,11.7,0.21476078
2246,2246,Blair Atcheynum,1998-99,29.0,3,26,61,61,11,15,26,103.0,,65,11,16,27,105.0,82,5.28,57,380,2242,9.6,0.37405303
2247,2247,Blair Atcheynum,1999-00,30.0,4,18,65,65,10,8,18,93.0,977.0,130,21,24,45,198.0,82,5.27,57,359,2285,9.4,0.27947327
2248,2248,Blair Atcheynum,2000-01,31.0,5,12,47,47,5,7,12,48.0,576.0,177,26,31,57,246.0,82,5.49,53,331,2294,9.8,0.20789814
2249,2249,Blair Atcheynum,2001-02,32.0,6,3,19,19,1,2,3,18.0,173.0,196,27,33,60,264.0,82,5.51,63,376,2272,9.9,0.16571304
2250,2250,Blair Barnes,1983-84,23.0,2,0,1,1,0,0,0,0.0,,1,0,0,0,0.0,80,7.73,71,310,2444,12.7,0.19256687
2251,2251,Blair Betts,2002-03,22.0,2,1,6,6,1,0,1,4.0,43.0,6,1,0,1,4.0,82,5.24,53,338,2262,9.5,0.22834012
2252,2252,Blair Betts,2003-04,23.0,3,4,9,9,1,3,4,16.0,104.0,15,2,3,5,20.0,82,5.31,60,363,2326,9.4,0.23756835
2253,2253,Blair Betts,2004-05,24.0,4,3,20,20,1,2,3,21.0,255.0,35,3,5,8,41.0,82,5.14,57,348,2300,9.2,0.2052711
2254,2254,Blair Betts,2006-07,26.0,5,10,66,66,8,2,10,94.0,853.0,101,11,7,18,135.0,82,6.05,85,480,2458,10.1,0.22193536
2255,2255,Blair Betts,2007-08,27.0,6,13,82,82,9,4,13,120.0,1151.0,183,20,11,31,255.0,82,5.76,70,398,2426,9.7,0.21710083
2256,2256,Blair Betts,2008-09,28.0,7,7,75,75,2,5,7,85.0,889.0,258,22,16,38,340.0,82,5.44,62,351,2383,9.4,0.17618474
2257,2257,Blair Betts,2009-10,29.0,8,10,81,81,6,4,10,83.0,860.0,339,28,20,48,423.0,82,5.7,65,341,2477,9.4,0.192547
2258,2258,Blair Betts,2010-11,30.0,9,18,63,63,8,10,18,63.0,795.0,402,36,30,66,486.0,82,5.53,56,304,2486,9.1,0.21744645
2259,2259,Blair Betts,2011-12,31.0,10,12,75,75,5,7,12,51.0,784.0,477,41,37,78,537.0,82,5.46,52,291,2492,9.0,0.15352687
2260,2260,Blair Jones,2007-08,21.0,2,3,20,20,1,2,3,6.0,115.0,20,1,2,3,6.0,82,5.76,70,398,2426,9.7,0.1877226
2261,2261,Blair Jones,2008-09,22.0,3,0,4,4,0,0,0,1.0,8.0,24,1,2,3,7.0,82,5.44,62,351,2383,9.4,0.16048682
2262,2262,Blair Jones,2010-11,24.0,4,0,14,14,0,0,0,26.0,180.0,38,1,2,3,33.0,82,5.53,56,304,2486,9.1,0.18952894
2263,2263,Blair Jones,2011-12,25.0,5,3,18,18,1,2,3,20.0,144.0,56,2,4,6,53.0,82,5.46,52,291,2492,9.0,0.17675447
2264,2264,Blair Jones,2012-13,26.0,6,8,43,43,3,5,8,58.0,488.0,99,5,9,14,111.0,82,5.32,47,271,2439,8.9,0.16701064
2265,2265,Blair Jones,2013-14,27.0,7,1,15,15,0,1,1,22.0,161.0,114,5,10,15,133.0,48,5.31,29,160,1399,9.1,0.18924561
2266,2266,Blair Jones,2014-15,28.0,8,2,14,14,2,0,2,14.0,159.0,128,7,10,17,147.0,82,5.34,48,269,2463,8.9,0.17219856
2267,2267,Blair Jones,2015-16,29.0,9,0,4,4,0,0,0,0.0,28.0,132,7,10,17,147.0,82,5.32,47,251,2453,8.9,0.12172097
2268,2268,Blair MacDonald,1980-81,27.0,2,94,80,80,46,48,94,266.0,,80,46,48,94,266.0,80,7.03,61,280,2352,12.0,1.0824585
2269,2269,Blair MacDonald,1981-82,28.0,3,57,63,63,24,33,57,172.0,,143,70,81,151,438.0,80,7.69,77,340,2441,12.6,0.7746712
2270,2270,Blair MacDonald,1982-83,29.0,4,33,59,59,18,15,33,116.0,,202,88,96,184,554.0,80,8.03,73,320,2489,12.9,0.5833979
2271,2271,Blair MacDonald,1983-84,30.0,5,7,17,17,3,4,7,29.0,,219,91,100,191,583.0,80,7.73,71,310,2444,12.7,0.5566562
2272,2272,Blake Bellefeuille,2002-03,25.0,2,1,2,2,0,1,1,2.0,17.0,2,0,1,1,2.0,82,5.24,53,338,2262,9.5,0.18454158
2273,2273,Blake Bellefeuille,2003-04,26.0,3,0,3,3,0,0,0,0.0,21.0,5,0,1,1,2.0,82,5.31,60,363,2326,9.4,0.14731231
2274,2274,Blake Coleman,2017-18,26.0,2,2,23,23,1,1,2,29.0,295.0,23,1,1,2,29.0,82,5.45,47,245,2478,9.0,0.19433069
2275,2275,Blake Coleman,2018-19,27.0,3,25,79,79,13,12,25,146.0,1137.0,102,14,13,27,175.0,82,5.86,50,250,2620,9.2,0.3454886
2276,2276,Blake Coleman,2019-20,28.0,4,36,78,78,22,14,36,213.0,1327.0,180,36,27,63,388.0,82,5.96,47,239,2579,9.5,0.47418568
2277,2277,Blake Coleman,2020-21,29.0,5,32,66,66,21,11,32,200.0,1103.0,246,57,38,95,588.0,70,5.96,42,208,2192,9.5,0.53152704
2278,2278,Blake Comeau,2007-08,21.0,2,0,3,3,0,0,0,1.0,28.0,3,0,0,0,1.0,82,5.76,70,398,2426,9.7,0.18608436
2279,2279,Blake Comeau,2008-09,22.0,3,15,51,51,8,7,15,67.0,595.0,54,8,7,15,68.0,82,5.44,62,351,2383,9.4,0.3247416
2280,2280,Blake Comeau,2009-10,23.0,4,25,53,53,7,18,25,78.0,863.0,107,15,25,40,146.0,82,5.7,65,341,2477,9.4,0.44768476
2281,2281,Blake Comeau,2010-11,24.0,5,35,61,61,17,18,35,133.0,940.0,168,32,43,75,279.0,82,5.53,56,304,2486,9.1,0.5131616
2282,2282,Blake Comeau,2011-12,25.0,6,46,77,77,24,22,46,182.0,1439.0,245,56,65,121,461.0,82,5.46,52,291,2492,9.0,0.57496667
2283,2283,Blake Comeau,2012-13,26.0,7,15,74,74,5,10,15,137.0,1143.0,319,61,75,136,598.0,82,5.32,47,271,2439,8.9,0.30071864
2284,2284,Blake Comeau,2013-14,27.0,8,12,42,42,6,6,12,48.0,511.0,361,67,81,148,646.0,48,5.31,29,160,1399,9.1,0.32262546
2285,2285,Blake Comeau,2014-15,28.0,9,16,61,61,5,11,16,107.0,736.0,422,72,92,164,753.0,82,5.34,48,269,2463,8.9,0.3184189
2286,2286,Blake Comeau,2015-16,29.0,10,31,61,61,16,15,31,147.0,932.0,483,88,107,195,900.0,82,5.32,47,251,2453,8.9,0.510787
2287,2287,Blake Comeau,2016-17,30.0,11,36,81,81,12,24,36,142.0,1428.0,564,100,131,231,1042.0,82,5.34,48,255,2438,9.0,0.38731444
2288,2288,Blake Comeau,2017-18,31.0,12,20,77,77,8,12,20,103.0,1154.0,641,108,143,251,1145.0,82,5.45,47,245,2478,9.0,0.27092493
2289,2289,Blake Comeau,2018-19,32.0,13,34,79,79,13,21,34,123.0,1254.0,720,121,164,285,1268.0,82,5.86,50,250,2620,9.2,0.3354923
2290,2290,Blake Comeau,2019-20,33.0,14,18,77,77,7,11,18,102.0,1211.0,797,128,175,303,1370.0,82,5.96,47,239,2579,9.5,0.2499451
2291,2291,Blake Comeau,2020-21,34.0,15,16,55,55,8,8,16,74.0,822.0,852,136,183,319,1444.0,70,5.96,42,208,2192,9.5,0.2710034
2292,2292,Blake Geoffrion,2011-12,23.0,2,8,20,20,6,2,8,24.0,165.0,20,6,2,8,24.0,82,5.46,52,291,2492,9.0,0.31827286
2293,2293,Blake Geoffrion,2012-13,24.0,3,5,35,35,2,3,5,29.0,386.0,55,8,5,13,53.0,82,5.32,47,271,2439,8.9,0.19722411
2294,2294,Blake Hillman,2018-19,23.0,2,1,4,4,1,0,1,5.0,72.0,4,1,0,1,5.0,82,5.86,50,250,2620,9.2,0.22416201
2295,2295,Blake Lizotte,2019-20,22.0,2,0,1,1,0,0,0,1.0,11.0,1,0,0,0,1.0,82,5.96,47,239,2579,9.5,0.18239564
2296,2296,Blake Lizotte,2020-21,23.0,3,23,65,65,6,17,23,87.0,907.0,66,6,17,23,88.0,70,5.96,42,208,2192,9.5,0.3642031
2297,2297,Blake Pietila,2016-17,23.0,2,2,7,7,1,1,2,10.0,84.0,7,1,1,2,10.0,82,5.34,48,255,2438,9.0,0.2334055
2298,2298,Blake Pietila,2017-18,24.0,3,1,10,10,0,1,1,9.0,130.0,17,1,2,3,19.0,82,5.45,47,245,2478,9.0,0.17496467
2299,2299,Blake Pietila,2018-19,25.0,4,0,2,2,0,0,0,1.0,19.0,19,1,2,3,20.0,82,5.86,50,250,2620,9.2,0.14930245
2300,2300,Blake Pietila,2019-20,26.0,5,1,19,19,0,1,1,22.0,252.0,38,1,3,4,42.0,82,5.96,47,239,2579,9.5,0.21007401
2301,2301,Blake Sloan,1999-00,24.0,2,0,14,14,0,0,0,7.0,126.0,14,0,0,0,7.0,82,5.27,57,359,2285,9.4,0.15400127
2302,2302,Blake Sloan,2000-01,25.0,3,17,67,67,4,13,17,78.0,904.0,81,4,13,17,85.0,82,5.49,53,331,2294,9.8,0.23499984
2303,2303,Blake Sloan,2001-02,26.0,4,5,47,47,3,2,5,45.0,514.0,128,7,15,22,130.0,82,5.51,63,376,2272,9.9,0.15907627
2304,2304,Blake Sloan,2002-03,27.0,5,11,67,67,2,9,11,56.0,742.0,195,9,24,33,186.0,82,5.24,53,338,2262,9.5,0.15541196
2305,2305,Blake Sloan,2003-04,28.0,6,10,67,67,2,8,10,56.0,830.0,262,11,32,43,242.0,82,5.31,60,363,2326,9.4,0.17275304
2306,2306,Blake Sloan,2004-05,29.0,7,0,28,28,0,0,0,23.0,201.0,290,11,32,43,265.0,82,5.14,57,348,2300,9.2,0.15772638
2307,2307,Blake Speers,2017-18,21.0,2,0,3,3,0,0,0,3.0,28.0,3,0,0,0,3.0,82,5.45,47,245,2478,9.0,0.24101004
2308,2308,Blake Wesley,1980-81,21.0,2,1,2,2,0,1,1,4.0,,2,0,1,1,4.0,80,7.03,61,280,2352,12.0,0.29760927
2309,2309,Blake Wesley,1981-82,22.0,3,10,50,50,3,7,10,53.0,,52,3,8,11,57.0,80,7.69,77,340,2441,12.6,0.276568
2310,2310,Blake Wesley,1982-83,23.0,4,27,78,78,9,18,27,115.0,,130,12,26,38,172.0,80,8.03,73,320,2489,12.9,0.34871703
2311,2311,Blake Wesley,1983-84,24.0,5,13,74,74,4,9,13,71.0,,204,16,35,51,243.0,80,7.73,71,310,2444,12.7,0.24814141
2312,2312,Blake Wesley,1984-85,25.0,6,10,46,46,2,8,10,40.0,,250,18,43,61,283.0,80,7.89,74,336,2448,12.9,0.26537573
2313,2313,Blake Wesley,1985-86,26.0,7,2,21,21,0,2,2,11.0,,271,18,45,63,294.0,80,7.77,71,321,2447,12.7,0.18496117
2314,2314,Blake Wesley,1986-87,27.0,8,1,27,27,0,1,1,11.0,,298,18,46,64,305.0,80,7.94,82,370,2484,12.8,0.16085947
2315,2315,Blake Wheeler,2009-10,23.0,2,45,81,81,21,24,45,150.0,1109.0,81,21,24,45,150.0,82,5.7,65,341,2477,9.4,0.5637326
2316,2316,Blake Wheeler,2010-11,24.0,3,38,82,82,18,20,38,159.0,1295.0,163,39,44,83,309.0,82,5.53,56,304,2486,9.1,0.5080269
2317,2317,Blake Wheeler,2011-12,25.0,4,44,81,81,18,26,44,179.0,1316.0,244,57,70,127,488.0,82,5.46,52,291,2492,9.0,0.5776706
2318,2318,Blake Wheeler,2012-13,26.0,5,64,80,80,17,47,64,208.0,1526.0,324,74,117,191,696.0,82,5.32,47,271,2439,8.9,0.77832377
2319,2319,Blake Wheeler,2013-14,27.0,6,41,48,48,19,22,41,129.0,902.0,372,93,139,232,825.0,48,5.31,29,160,1399,9.1,0.7962897
2320,2320,Blake Wheeler,2014-15,28.0,7,69,82,82,28,41,69,225.0,1532.0,454,121,180,301,1050.0,82,5.34,48,269,2463,8.9,0.8065545
2321,2321,Blake Wheeler,2015-16,29.0,8,61,79,79,26,35,61,244.0,1553.0,533,147,215,362,1294.0,82,5.32,47,251,2453,8.9,0.76722556
2322,2322,Blake Wheeler,2016-17,30.0,9,78,82,82,26,52,78,256.0,1623.0,615,173,267,440,1550.0,82,5.34,48,255,2438,9.0,0.8542883
2323,2323,Blake Wheeler,2017-18,31.0,10,74,82,82,26,48,74,259.0,1652.0,697,199,315,514,1809.0,82,5.45,47,245,2478,9.0,0.85187495
2324,2324,Blake Wheeler,2018-19,32.0,11,91,81,81,23,68,91,246.0,1641.0,778,222,383,605,2055.0,82,5.86,50,250,2620,9.2,1.0003157
2325,2325,Blake Wheeler,2019-20,33.0,12,91,82,82,20,71,91,231.0,1698.0,860,242,454,696,2286.0,82,5.96,47,239,2579,9.5,0.92945343
2326,2326,Blake Wheeler,2020-21,34.0,13,65,71,71,22,43,65,180.0,1372.0,931,264,497,761,2466.0,70,5.96,42,208,2192,9.5,0.7572723
2327,2327,Bo Berglund,1984-85,29.0,2,43,75,75,16,27,43,83.0,,75,16,27,43,83.0,80,7.89,74,336,2448,12.9,0.50700426
2328,2328,Bo Berglund,1985-86,30.0,3,20,45,45,10,10,20,58.0,,120,26,37,63,141.0,80,7.77,71,321,2447,12.7,0.41567856
2329,2329,Bo Berglund,1986-87,31.0,4,4,10,10,2,2,4,11.0,,130,28,39,67,152.0,80,7.94,82,370,2484,12.8,0.3136059
2330,2330,Bo Horvat,2015-16,20.0,2,25,68,68,13,12,25,93.0,834.0,68,13,12,25,93.0,82,5.32,47,251,2453,8.9,0.4302562
2331,2331,Bo Horvat,2016-17,21.0,3,40,82,82,16,24,40,155.0,1405.0,150,29,36,65,248.0,82,5.34,48,255,2438,9.0,0.5620829
2332,2332,Bo Horvat,2017-18,22.0,4,52,81,81,20,32,52,158.0,1461.0,231,49,68,117,406.0,82,5.45,47,245,2478,9.0,0.65307987
2333,2333,Bo Horvat,2018-19,23.0,5,44,64,64,22,22,44,158.0,1238.0,295,71,90,161,564.0,82,5.86,50,250,2620,9.2,0.68470526
2334,2334,Bo Horvat,2019-20,24.0,6,61,82,82,27,34,61,227.0,1709.0,377,98,124,222,791.0,82,5.96,47,239,2579,9.5,0.768849
2335,2335,Bo Horvat,2020-21,25.0,7,53,69,69,22,31,53,178.0,1362.0,446,120,155,275,969.0,70,5.96,42,208,2192,9.5,0.7386364
2336,2336,Bob Attwell,1980-81,21.0,2,2,7,7,1,1,2,2.0,,7,1,1,2,2.0,80,7.03,61,280,2352,12.0,0.30764616
2337,2337,Bob Attwell,1981-82,22.0,3,4,15,15,0,4,4,11.0,,22,1,5,6,13.0,80,7.69,77,340,2441,12.6,0.24228331
2338,2338,Bob Bassen,1986-87,21.0,2,3,11,11,2,1,3,5.0,,11,2,1,3,5.0,80,7.94,82,370,2484,12.8,0.3507542
2339,2339,Bob Bassen,1987-88,22.0,3,17,77,77,7,10,17,59.0,,88,9,11,20,64.0,80,7.34,72,344,2400,12.2,0.28630435
2340,2340,Bob Bassen,1988-89,23.0,4,22,77,77,6,16,22,65.0,,165,15,27,42,129.0,80,7.43,89,437,2435,12.2,0.27715093
2341,2341,Bob Bassen,1989-90,24.0,5,21,68,68,5,16,21,51.0,,233,20,43,63,180.0,80,7.48,85,403,2430,12.3,0.30129898
2342,2342,Bob Bassen,1990-91,25.0,6,2,6,6,1,1,2,7.0,,239,21,44,65,187.0,80,7.37,76,367,2421,12.2,0.28842562
2343,2343,Bob Bassen,1991-92,26.0,7,34,79,79,16,18,34,117.0,,318,37,62,99,304.0,80,6.91,71,366,2385,11.6,0.40713686
2344,2344,Bob Bassen,1992-93,27.0,8,32,79,79,7,25,32,101.0,,397,44,87,131,405.0,80,6.96,77,402,2440,11.4,0.3969335
2345,2345,Bob Bassen,1993-94,28.0,9,19,53,53,9,10,19,61.0,,450,53,97,150,466.0,84,7.25,87,443,2603,11.7,0.32753876
2346,2346,Bob Bassen,1994-95,29.0,10,28,83,83,13,15,28,129.0,,533,66,112,178,595.0,84,6.48,76,407,2545,10.7,0.34976
2347,2347,Bob Bassen,1995-96,30.0,11,27,47,47,12,15,27,66.0,,580,78,127,205,661.0,48,5.97,37,209,1408,10.2,0.45034
2348,2348,Bob Bassen,1996-97,31.0,12,1,13,13,0,1,1,9.0,,593,78,128,206,670.0,82,6.29,74,413,2481,10.4,0.1847189
2349,2349,Bob Bassen,1997-98,32.0,13,12,46,46,5,7,12,50.0,,639,83,135,218,720.0,82,5.83,55,336,2444,9.8,0.21903649
2350,2350,Bob Bassen,1998-99,33.0,14,7,58,58,3,4,7,40.0,,697,86,139,225,760.0,82,5.28,57,380,2242,9.6,0.1473118
2351,2351,Bob Bassen,1999-00,34.0,15,3,41,41,1,2,3,47.0,517.0,738,87,141,228,807.0,82,5.27,57,359,2285,9.4,0.15598667
2352,2352,Bob Bassen,2000-01,35.0,16,4,27,27,1,3,4,26.0,266.0,765,88,144,232,833.0,82,5.49,53,331,2294,9.8,0.17119542
2353,2353,Bob Beers,1990-91,23.0,2,1,3,3,0,1,1,0.0,,3,0,1,1,0.0,80,7.37,76,367,2421,12.2,0.23517048
2354,2354,Bob Beers,1991-92,24.0,3,1,16,16,0,1,1,9.0,,19,0,2,2,9.0,80,6.91,71,366,2385,11.6,0.18854105
2355,2355,Bob Beers,1992-93,25.0,4,5,31,31,0,5,5,25.0,,50,0,7,7,34.0,80,6.96,77,402,2440,11.4,0.18080783
2356,2356,Bob Beers,1993-94,26.0,5,36,64,64,12,24,36,138.0,,114,12,31,43,172.0,84,7.25,87,443,2603,11.7,0.4914206
2357,2357,Bob Beers,1994-95,27.0,6,43,82,82,11,32,43,187.0,,196,23,63,86,359.0,84,6.48,76,407,2545,10.7,0.4431278
2358,2358,Bob Beers,1995-96,28.0,7,9,22,22,2,7,9,38.0,,218,25,70,95,397.0,48,5.97,37,209,1408,10.2,0.32929173
2359,2359,Bob Beers,1996-97,29.0,8,5,13,13,0,5,5,9.0,,231,25,75,100,406.0,82,6.29,74,413,2481,10.4,0.24144983
2360,2360,Bob Beers,1997-98,30.0,9,7,27,27,3,4,7,49.0,,258,28,79,107,455.0,82,5.83,55,336,2444,9.8,0.26339358
2361,2361,Bob Bergloff,1983-84,25.0,2,0,2,2,0,0,0,1.0,,2,0,0,0,1.0,80,7.73,71,310,2444,12.7,0.21705627
2362,2362,Bob Bodak,1988-89,27.0,2,0,3,3,0,0,0,0.0,,3,0,0,0,0.0,80,7.43,89,437,2435,12.2,0.16129571
2363,2363,Bob Bodak,1990-91,29.0,3,0,1,1,0,0,0,1.0,,4,0,0,0,1.0,80,7.37,76,367,2421,12.2,0.18041041
2364,2364,Bob Boughner,1996-97,25.0,2,1,31,31,0,1,1,14.0,,31,0,1,1,14.0,82,6.29,74,413,2481,10.4,0.11486262
2365,2365,Bob Boughner,1997-98,26.0,3,8,77,77,1,7,8,34.0,,108,1,8,9,48.0,82,5.83,55,336,2444,9.8,0.1378994
2366,2366,Bob Boughner,1998-99,27.0,4,4,69,69,1,3,4,26.0,,177,2,11,13,74.0,82,5.28,57,380,2242,9.6,0.09722981
2367,2367,Bob Boughner,1999-00,28.0,5,13,79,79,3,10,13,59.0,1463.0,256,5,21,26,133.0,82,5.27,57,359,2285,9.4,0.16367036
2368,2368,Bob Boughner,2000-01,29.0,6,7,73,73,3,4,7,40.0,1262.0,329,8,25,33,173.0,82,5.49,53,331,2294,9.8,0.12733051
2369,2369,Bob Boughner,2001-02,30.0,7,4,58,58,1,3,4,46.0,957.0,387,9,28,37,219.0,82,5.51,63,376,2272,9.9,0.11905944
2370,2370,Bob Boughner,2002-03,31.0,8,6,79,79,2,4,6,58.0,1479.0,466,11,32,43,277.0,82,5.24,53,338,2262,9.5,0.13123462
2371,2371,Bob Boughner,2003-04,32.0,9,17,69,69,3,14,17,62.0,1370.0,535,14,46,60,339.0,82,5.31,60,363,2326,9.4,0.17995077
2372,2372,Bob Boughner,2004-05,33.0,10,5,54,54,0,5,5,34.0,784.0,589,14,51,65,373.0,82,5.14,57,348,2300,9.2,0.11320582
2373,2373,Bob Boughner,2006-07,35.0,11,7,41,41,1,6,7,15.0,297.0,630,15,57,72,388.0,82,6.05,85,480,2458,10.1,0.09695318
2374,2374,Bob Brooke,1984-85,24.0,2,3,9,9,1,2,3,10.0,,9,1,2,3,10.0,80,7.89,74,336,2448,12.9,0.29690427
2375,2375,Bob Brooke,1985-86,25.0,3,16,72,72,7,9,16,96.0,,81,8,11,19,106.0,80,7.77,71,321,2447,12.7,0.30577826
2376,2376,Bob Brooke,1986-87,26.0,4,44,79,79,24,20,44,178.0,,160,32,31,63,284.0,80,7.94,82,370,2484,12.8,0.5328499
2377,2377,Bob Brooke,1987-88,27.0,5,36,80,80,13,23,36,138.0,,240,45,54,99,422.0,80,7.34,72,344,2400,12.2,0.4870971
2378,2378,Bob Brooke,1988-89,28.0,6,25,77,77,5,20,25,127.0,,317,50,74,124,549.0,80,7.43,89,437,2435,12.2,0.30909085
2379,2379,Bob Brooke,1989-90,29.0,7,16,57,57,7,9,16,77.0,,374,57,83,140,626.0,80,7.48,85,403,2430,12.3,0.32380366
2380,2380,Bob Brooke,1990-91,30.0,8,26,73,73,12,14,26,109.0,,447,69,97,166,735.0,80,7.37,76,367,2421,12.2,0.31294
2381,2381,Bob Carpenter,1982-83,19.0,2,67,80,80,32,35,67,262.0,,80,32,35,67,262.0,80,8.03,73,320,2489,12.9,0.88765955
2382,2382,Bob Carpenter,1983-84,20.0,3,69,80,80,32,37,69,197.0,,160,64,72,136,459.0,80,7.73,71,310,2444,12.7,0.9099479
2383,2383,Bob Carpenter,1984-85,21.0,4,68,80,80,28,40,68,228.0,,240,92,112,204,687.0,80,7.89,74,336,2448,12.9,0.9494734
2384,2384,Bob Carpenter,1985-86,22.0,5,95,80,80,53,42,95,260.0,,320,145,154,299,947.0,80,7.77,71,321,2447,12.7,1.1475482
2385,2385,Bob Carpenter,1986-87,23.0,6,56,80,80,27,29,56,205.0,,400,172,183,355,1152.0,80,7.94,82,370,2484,12.8,0.757548
2386,2386,Bob Carpenter,1987-88,24.0,7,27,60,60,9,18,27,113.0,,460,181,201,382,1265.0,80,7.34,72,344,2400,12.2,0.53401065
2387,2387,Bob Carpenter,1988-89,25.0,8,52,71,71,19,33,52,176.0,,531,200,234,434,1441.0,80,7.43,89,437,2435,12.2,0.75941193
2388,2388,Bob Carpenter,1989-90,26.0,9,40,57,57,16,24,40,137.0,,588,216,258,474,1578.0,80,7.48,85,403,2430,12.3,0.7413648
2389,2389,Bob Carpenter,1990-91,27.0,10,56,80,80,25,31,56,220.0,,668,241,289,530,1798.0,80,7.37,76,367,2421,12.2,0.69357616
2390,2390,Bob Carpenter,1991-92,28.0,11,16,29,29,8,8,16,54.0,,697,249,297,546,1852.0,80,6.91,71,366,2385,11.6,0.6396032
2391,2391,Bob Carpenter,1992-93,29.0,12,48,60,60,25,23,48,171.0,,757,274,320,594,2023.0,80,6.96,77,402,2440,11.4,0.7225146
2392,2392,Bob Carpenter,1993-94,30.0,13,28,68,68,11,17,28,141.0,,825,285,337,622,2164.0,84,7.25,87,443,2603,11.7,0.44155762
2393,2393,Bob Carpenter,1994-95,31.0,14,33,76,76,10,23,33,125.0,,901,295,360,655,2289.0,84,6.48,76,407,2545,10.7,0.3814323
2394,2394,Bob Carpenter,1995-96,32.0,15,16,41,41,5,11,16,69.0,,942,300,371,671,2358.0,48,5.97,37,209,1408,10.2,0.41785794
2395,2395,Bob Carpenter,1996-97,33.0,16,10,52,52,5,5,10,63.0,,994,305,376,681,2421.0,82,6.29,74,413,2481,10.4,0.2849422
2396,2396,Bob Carpenter,1997-98,34.0,17,19,62,62,4,15,19,76.0,,1056,309,391,700,2497.0,82,5.83,55,336,2444,9.8,0.25445694
2397,2397,Bob Carpenter,1998-99,35.0,18,18,66,66,9,9,18,81.0,,1122,318,400,718,2578.0,82,5.28,57,380,2242,9.6,0.27614722
2398,2398,Bob Carpenter,1999-00,36.0,19,10,56,56,2,8,10,69.0,856.0,1178,320,408,728,2647.0,82,5.27,57,359,2285,9.4,0.29437602
2399,2399,Bob Corkum,1990-91,23.0,2,2,8,8,2,0,2,6.0,,8,2,0,2,6.0,80,7.37,76,367,2421,12.2,0.32051796
2400,2400,Bob Corkum,1992-93,25.0,3,6,20,20,2,4,6,23.0,,28,4,4,8,29.0,80,6.96,77,402,2440,11.4,0.29052636
2401,2401,Bob Corkum,1993-94,26.0,4,10,68,68,6,4,10,69.0,,96,10,8,18,98.0,84,7.25,87,443,2603,11.7,0.21419135
2402,2402,Bob Corkum,1994-95,27.0,5,51,76,76,23,28,51,180.0,,172,33,36,69,278.0,84,6.48,76,407,2545,10.7,0.5050017
2403,2403,Bob Corkum,1995-96,28.0,6,19,44,44,10,9,19,100.0,,216,43,45,88,378.0,48,5.97,37,209,1408,10.2,0.4153669
2404,2404,Bob Corkum,1996-97,29.0,7,19,76,76,9,10,19,126.0,,292,52,55,107,504.0,82,6.29,74,413,2481,10.4,0.2547075
2405,2405,Bob Corkum,1997-98,30.0,8,20,80,80,9,11,20,119.0,,372,61,66,127,623.0,82,5.83,55,336,2444,9.8,0.27039504
2406,2406,Bob Corkum,1998-99,31.0,9,21,76,76,12,9,21,105.0,,448,73,75,148,728.0,82,5.28,57,380,2242,9.6,0.26982278
2407,2407,Bob Corkum,1999-00,32.0,10,19,77,77,9,10,19,146.0,1328.0,525,82,85,167,874.0,82,5.27,57,359,2285,9.4,0.28271484
2408,2408,Bob Corkum,2000-01,33.0,11,11,45,45,5,6,11,45.0,650.0,570,87,91,178,919.0,82,5.49,53,331,2294,9.8,0.19701782
2409,2409,Bob Corkum,2001-02,34.0,12,14,75,75,7,7,14,66.0,946.0,645,94,98,192,985.0,82,5.51,63,376,2272,9.9,0.16612223
2410,2410,Bob Corkum,2002-03,35.0,13,8,75,75,3,5,8,80.0,1133.0,720,97,103,200,1065.0,82,5.24,53,338,2262,9.5,0.16694257
2411,2411,Bob Crawford,1980-81,21.0,2,1,8,8,1,0,1,12.0,,8,1,0,1,12.0,80,7.03,61,280,2352,12.0,0.2777415
2412,2412,Bob Crawford,1982-83,23.0,3,1,3,3,0,1,1,9.0,,11,1,1,2,21.0,80,8.03,73,320,2489,12.9,0.23665318
2413,2413,Bob Crawford,1983-84,24.0,4,14,27,27,5,9,14,63.0,,38,6,10,16,84.0,80,7.73,71,310,2444,12.7,0.4017824
2414,2414,Bob Crawford,1984-85,25.0,5,61,80,80,36,25,61,179.0,,118,42,35,77,263.0,80,7.89,74,336,2448,12.9,0.6686751
2415,2415,Bob Crawford,1985-86,26.0,6,28,45,45,14,14,28,90.0,,163,56,49,105,353.0,80,7.77,71,321,2447,12.7,0.50385857
2416,2416,Bob Crawford,1986-87,27.0,7,37,68,68,15,22,37,126.0,,231,71,71,142,479.0,80,7.94,82,370,2484,12.8,0.44811183
2417,2417,Bob Crawford,1987-88,28.0,8,0,15,15,0,0,0,14.0,,246,71,71,142,493.0,80,7.34,72,344,2400,12.2,0.41264713
2418,2418,Bob Errey,1984-85,20.0,2,22,65,65,9,13,22,84.0,,65,9,13,22,84.0,80,7.89,74,336,2448,12.9,0.39479238
2419,2419,Bob Errey,1985-86,21.0,3,2,16,16,0,2,2,12.0,,81,9,15,24,96.0,80,7.77,71,321,2447,12.7,0.40371984
2420,2420,Bob Errey,1986-87,22.0,4,17,37,37,11,6,17,57.0,,118,20,21,41,153.0,80,7.94,82,370,2484,12.8,0.48900774
2421,2421,Bob Errey,1987-88,23.0,5,34,72,72,16,18,34,138.0,,190,36,39,75,291.0,80,7.34,72,344,2400,12.2,0.4989597
2422,2422,Bob Errey,1988-89,24.0,6,9,17,17,3,6,9,18.0,,207,39,45,84,309.0,80,7.43,89,437,2435,12.2,0.40526482
2423,2423,Bob Errey,1989-90,25.0,7,58,76,76,26,32,58,130.0,,283,65,77,142,439.0,80,7.48,85,403,2430,12.3,0.65636706
2424,2424,Bob Errey,1990-91,26.0,8,39,78,78,20,19,39,127.0,,361,85,96,181,566.0,80,7.37,76,367,2421,12.2,0.4638896
2425,2425,Bob Errey,1991-92,27.0,9,42,79,79,20,22,42,131.0,,440,105,118,223,697.0,80,6.91,71,366,2385,11.6,0.5039271
2426,2426,Bob Errey,1992-93,28.0,10,35,78,78,19,16,35,122.0,,518,124,134,258,819.0,80,6.96,77,402,2440,11.4,0.41863754
2427,2427,Bob Errey,1993-94,29.0,11,18,62,62,9,9,18,88.0,,580,133,143,276,907.0,84,7.25,87,443,2603,11.7,0.30753553
2428,2428,Bob Errey,1994-95,30.0,12,30,64,64,12,18,30,89.0,,644,145,161,306,996.0,84,6.48,76,407,2545,10.7,0.367285
2429,2429,Bob Errey,1995-96,31.0,13,21,43,43,8,13,21,72.0,,687,153,174,327,1068.0,48,5.97,37,209,1408,10.2,0.41373494
2430,2430,Bob Errey,1996-97,32.0,14,32,71,71,11,21,32,85.0,,758,164,195,359,1153.0,82,6.29,74,413,2481,10.4,0.32325226
2431,2431,Bob Errey,1997-98,33.0,15,12,66,66,4,8,12,72.0,,824,168,203,371,1225.0,82,5.83,55,336,2444,9.8,0.1867333
2432,2432,Bob Errey,1998-99,34.0,16,11,71,71,2,9,11,45.0,,895,170,212,382,1270.0,82,5.28,57,380,2242,9.6,0.15762913
2433,2433,Bob Fitchner,1980-81,30.0,2,31,70,70,11,20,31,87.0,,70,11,20,31,87.0,80,7.03,61,280,2352,12.0,0.40408766
2434,2434,Bob Fitchner,1981-82,31.0,3,1,8,8,1,0,1,1.0,,78,12,20,32,88.0,80,7.69,77,340,2441,12.6,0.2446934
2435,2435,Bob Geale,1985-86,23.0,2,0,1,1,0,0,0,1.0,,1,0,0,0,1.0,80,7.77,71,321,2447,12.7,0.22860032
2436,2436,Bob Gladney,1983-84,26.0,2,0,1,1,0,0,0,2.0,,1,0,0,0,2.0,80,7.73,71,310,2444,12.7,0.22462675
2437,2437,Bob Gladney,1984-85,27.0,3,6,13,13,1,5,6,15.0,,14,1,5,6,17.0,80,7.89,74,336,2448,12.9,0.25452465
2438,2438,Bob Halkidis,1986-87,20.0,2,10,37,37,1,9,10,19.0,,37,1,9,10,19.0,80,7.94,82,370,2484,12.8,0.2677514
2439,2439,Bob Halkidis,1987-88,21.0,3,2,6,6,1,1,2,4.0,,43,2,10,12,23.0,80,7.34,72,344,2400,12.2,0.2819303
2440,2440,Bob Halkidis,1988-89,22.0,4,3,30,30,0,3,3,26.0,,73,2,13,15,49.0,80,7.43,89,437,2435,12.2,0.21742567
2441,2441,Bob Halkidis,1989-90,23.0,5,1,16,16,0,1,1,9.0,,89,2,14,16,58.0,80,7.48,85,403,2430,12.3,0.21820503
2442,2442,Bob Halkidis,1990-91,24.0,6,4,20,20,0,4,4,19.0,,109,2,18,20,77.0,80,7.37,76,367,2421,12.2,0.20241636
2443,2443,Bob Halkidis,1991-92,25.0,7,4,34,34,1,3,4,25.0,,143,3,21,24,102.0,80,6.91,71,366,2385,11.6,0.17096463
2444,2444,Bob Halkidis,1992-93,26.0,8,6,46,46,3,3,6,36.0,,189,6,24,30,138.0,80,6.96,77,402,2440,11.4,0.16547441
2445,2445,Bob Halkidis,1994-95,28.0,9,5,28,28,1,4,5,35.0,,217,7,28,35,173.0,84,6.48,76,407,2545,10.7,0.15762672
2446,2446,Bob Halkidis,1995-96,29.0,10,5,31,31,1,4,5,25.0,,248,8,32,40,198.0,48,5.97,37,209,1408,10.2,0.15290374
2447,2447,Bob Halkidis,1996-97,30.0,11,0,8,8,0,0,0,2.0,,256,8,32,40,200.0,82,6.29,74,413,2481,10.4,0.112812966
2448,2448,Bob Jay,1994-95,29.0,2,1,3,3,0,1,1,2.0,,3,0,1,1,2.0,84,6.48,76,407,2545,10.7,0.16509512
2449,2449,Bob Joyce,1988-89,22.0,2,12,15,15,7,5,12,30.0,,15,7,5,12,30.0,80,7.43,89,437,2435,12.2,0.4996843
2450,2450,Bob Joyce,1989-90,23.0,3,49,77,77,18,31,49,142.0,,92,25,36,61,172.0,80,7.48,85,403,2430,12.3,0.62939286
2451,2451,Bob Joyce,1990-91,24.0,4,16,47,47,6,10,16,62.0,,139,31,46,77,234.0,80,7.37,76,367,2421,12.2,0.42210925
2452,2452,Bob Joyce,1991-92,25.0,5,6,17,17,3,3,6,30.0,,156,34,49,83,264.0,80,6.91,71,366,2385,11.6,0.36091286
2453,2453,Bob Joyce,1992-93,26.0,6,0,1,1,0,0,0,0.0,,157,34,49,83,264.0,80,6.96,77,402,2440,11.4,0.30556387
2454,2454,Bob Joyce,1993-94,27.0,7,0,1,1,0,0,0,0.0,,158,34,49,83,264.0,84,7.25,87,443,2603,11.7,0.30033708
2455,2455,Bob Kudelski,1988-89,24.0,2,1,26,26,0,1,1,18.0,,26,0,1,1,18.0,80,7.43,89,437,2435,12.2,0.18782777
2456,2456,Bob Kudelski,1989-90,25.0,3,4,14,14,1,3,4,15.0,,40,1,4,5,33.0,80,7.48,85,403,2430,12.3,0.23290598
2457,2457,Bob Kudelski,1990-91,26.0,4,36,62,62,23,13,36,135.0,,102,24,17,41,168.0,80,7.37,76,367,2421,12.2,0.52427083
2458,2458,Bob Kudelski,1991-92,27.0,5,36,72,72,23,13,36,137.0,,174,47,30,77,305.0,80,6.91,71,366,2385,11.6,0.47795781
2459,2459,Bob Kudelski,1992-93,28.0,6,43,80,80,22,21,43,155.0,,254,69,51,120,460.0,80,6.96,77,402,2440,11.4,0.4992607
2460,2460,Bob Kudelski,1993-94,29.0,7,41,63,63,24,17,41,137.0,,317,93,68,161,597.0,84,7.25,87,443,2603,11.7,0.60964495
2461,2461,Bob Kudelski,1994-95,30.0,8,70,86,86,40,30,70,251.0,,403,133,98,231,848.0,84,6.48,76,407,2545,10.7,0.60532135
2462,2462,Bob Kudelski,1995-96,31.0,9,9,26,26,6,3,9,29.0,,429,139,101,240,877.0,48,5.97,37,209,1408,10.2,0.3332066
2463,2463,Bob Kudelski,1996-97,32.0,10,1,13,13,0,1,1,23.0,,442,139,102,241,900.0,82,6.29,74,413,2481,10.4,0.29181296
2464,2464,Bob LaForest,1984-85,21.0,2,1,5,5,1,0,1,15.0,,5,1,0,1,15.0,80,7.89,74,336,2448,12.9,0.30385014
2465,2465,Bob McGill,1982-83,20.0,2,11,68,68,1,10,11,35.0,,68,1,10,11,35.0,80,8.03,73,320,2489,12.9,0.23805004
2466,2466,Bob McGill,1983-84,21.0,3,0,30,30,0,0,0,13.0,,98,1,10,11,48.0,80,7.73,71,310,2444,12.7,0.19440842
2467,2467,Bob McGill,1984-85,22.0,4,2,12,12,0,2,2,3.0,,110,1,12,13,51.0,80,7.89,74,336,2448,12.9,0.1972659
2468,2468,Bob McGill,1985-86,23.0,5,5,72,72,0,5,5,35.0,,182,1,17,18,86.0,80,7.77,71,321,2447,12.7,0.15275666
2469,2469,Bob McGill,1986-87,24.0,6,5,61,61,1,4,5,28.0,,243,2,21,23,114.0,80,7.94,82,370,2484,12.8,0.12454021
2470,2470,Bob McGill,1987-88,25.0,7,5,56,56,1,4,5,27.0,,299,3,25,28,141.0,80,7.34,72,344,2400,12.2,0.122106224
2471,2471,Bob McGill,1988-89,26.0,8,11,67,67,4,7,11,56.0,,366,7,32,39,197.0,80,7.43,89,437,2435,12.2,0.18118435
2472,2472,Bob McGill,1989-90,27.0,9,4,68,68,0,4,4,38.0,,434,7,36,43,235.0,80,7.48,85,403,2430,12.3,0.11609718
2473,2473,Bob McGill,1990-91,28.0,10,12,69,69,2,10,12,53.0,,503,9,46,55,288.0,80,7.37,76,367,2421,12.2,0.18702358
2474,2474,Bob McGill,1991-92,29.0,11,9,77,77,4,5,9,69.0,,580,13,51,64,357.0,80,6.91,71,366,2385,11.6,0.15756643
2475,2475,Bob McGill,1992-93,30.0,12,4,74,74,3,1,4,62.0,,654,16,52,68,419.0,80,6.96,77,402,2440,11.4,0.13674101
2476,2476,Bob McGill,1993-94,31.0,13,1,19,19,1,0,1,8.0,,673,17,52,69,427.0,84,7.25,87,443,2603,11.7,0.122893214
2477,2477,Bob McGill,1994-95,32.0,14,3,33,33,0,3,3,14.0,,706,17,55,72,441.0,84,6.48,76,407,2545,10.7,0.08969873
2478,2478,Bob Mongrain,1980-81,21.0,2,10,34,34,4,6,10,33.0,,34,4,6,10,33.0,80,7.03,61,280,2352,12.0,0.34133244
2479,2479,Bob Mongrain,1981-82,22.0,3,0,4,4,0,0,0,2.0,,38,4,6,10,35.0,80,7.69,77,340,2441,12.6,0.22268891
2480,2480,Bob Mongrain,1982-83,23.0,4,10,24,24,6,4,10,29.0,,62,10,10,20,64.0,80,8.03,73,320,2489,12.9,0.36077392
2481,2481,Bob Mongrain,1985-86,26.0,5,2,8,8,1,1,2,10.0,,70,11,11,22,74.0,80,7.77,71,321,2447,12.7,0.2738868
2482,2482,Bob Mongrain,1986-87,27.0,6,5,11,11,2,3,5,10.0,,81,13,14,27,84.0,80,7.94,82,370,2484,12.8,0.2935192
2483,2483,Bob Probert,1986-87,21.0,2,21,44,44,8,13,21,46.0,,44,8,13,21,46.0,80,7.94,82,370,2484,12.8,0.4491592
2484,2484,Bob Probert,1987-88,22.0,3,24,63,63,13,11,24,55.0,,107,21,24,45,101.0,80,7.34,72,344,2400,12.2,0.4318117
2485,2485,Bob Probert,1988-89,23.0,4,62,74,74,29,33,62,126.0,,181,50,57,107,227.0,80,7.43,89,437,2435,12.2,0.70972776
2486,2486,Bob Probert,1989-90,24.0,5,6,25,25,4,2,6,23.0,,206,54,59,113,250.0,80,7.48,85,403,2430,12.3,0.47252643
2487,2487,Bob Probert,1990-91,25.0,6,3,4,4,3,0,3,12.0,,210,57,59,116,262.0,80,7.37,76,367,2421,12.2,0.50642765
2488,2488,Bob Probert,1991-92,26.0,7,39,55,55,16,23,39,88.0,,265,73,82,155,350.0,80,6.91,71,366,2385,11.6,0.60763794
2489,2489,Bob Probert,1992-93,27.0,8,44,63,63,20,24,44,96.0,,328,93,106,199,446.0,80,6.96,77,402,2440,11.4,0.5888855
2490,2490,Bob Probert,1993-94,28.0,9,43,80,80,14,29,43,128.0,,408,107,135,242,574.0,84,7.25,87,443,2603,11.7,0.43427455
2491,2491,Bob Probert,1994-95,29.0,10,17,66,66,7,10,17,105.0,,474,114,145,259,679.0,84,6.48,76,407,2545,10.7,0.2866162
2492,2492,Bob Probert,1996-97,31.0,11,40,78,78,19,21,40,97.0,,552,133,166,299,776.0,82,6.29,74,413,2481,10.4,0.4044292
2493,2493,Bob Probert,1997-98,32.0,12,23,82,82,9,14,23,111.0,,634,142,180,322,887.0,82,5.83,55,336,2444,9.8,0.27853468
2494,2494,Bob Probert,1998-99,33.0,13,3,14,14,2,1,3,18.0,,648,144,181,325,905.0,82,5.28,57,380,2242,9.6,0.25885624
2495,2495,Bob Probert,1999-00,34.0,14,21,78,78,7,14,21,87.0,829.0,726,151,195,346,992.0,82,5.27,57,359,2285,9.4,0.2427328
2496,2496,Bob Probert,2000-01,35.0,15,15,69,69,4,11,15,38.0,722.0,795,155,206,361,1030.0,82,5.49,53,331,2294,9.8,0.17310128
2497,2497,Bob Probert,2001-02,36.0,16,19,79,79,7,12,19,45.0,856.0,874,162,218,380,1075.0,82,5.51,63,376,2272,9.9,0.18407595
2498,2498,Bob Probert,2002-03,37.0,17,4,61,61,1,3,4,33.0,411.0,935,163,221,384,1108.0,82,5.24,53,338,2262,9.5,0.16079655
2499,2499,Bob Rouse,1984-85,20.0,2,0,1,1,0,0,0,0.0,,1,0,0,0,0.0,80,7.89,74,336,2448,12.9,0.27148372
2500,2500,Bob Rouse,1985-86,21.0,3,11,63,63,2,9,11,80.0,,64,2,9,11,80.0,80,7.77,71,321,2447,12.7,0.3081438
2501,2501,Bob Rouse,1986-87,22.0,4,15,75,75,1,14,15,91.0,,139,3,23,26,171.0,80,7.94,82,370,2484,12.8,0.25417137
2502,2502,Bob Rouse,1987-88,23.0,5,12,72,72,2,10,12,71.0,,211,5,33,38,242.0,80,7.34,72,344,2400,12.2,0.23758605
2503,2503,Bob Rouse,1988-89,24.0,6,12,74,74,0,12,12,62.0,,285,5,45,50,304.0,80,7.43,89,437,2435,12.2,0.19487944
2504,2504,Bob Rouse,1989-90,25.0,7,19,79,79,4,15,19,85.0,,364,9,60,69,389.0,80,7.48,85,403,2430,12.3,0.24126819
2505,2505,Bob Rouse,1990-91,26.0,8,20,70,70,4,16,20,72.0,,434,13,76,89,461.0,80,7.37,76,367,2421,12.2,0.24844047
2506,2506,Bob Rouse,1991-92,27.0,9,26,60,60,7,19,26,65.0,,494,20,95,115,526.0,80,6.91,71,366,2385,11.6,0.32313895
2507,2507,Bob Rouse,1992-93,28.0,10,22,79,79,3,19,22,115.0,,573,23,114,137,641.0,80,6.96,77,402,2440,11.4,0.24513704
2508,2508,Bob Rouse,1993-94,29.0,11,14,82,82,3,11,14,78.0,,655,26,125,151,719.0,84,7.25,87,443,2603,11.7,0.17586383
2509,2509,Bob Rouse,1994-95,30.0,12,16,63,63,5,11,16,77.0,,718,31,136,167,796.0,84,6.48,76,407,2545,10.7,0.22513032
2510,2510,Bob Rouse,1995-96,31.0,13,8,48,48,1,7,8,51.0,,766,32,143,175,847.0,48,5.97,37,209,1408,10.2,0.17335734
2511,2511,Bob Rouse,1996-97,32.0,14,6,58,58,0,6,6,49.0,,824,32,149,181,896.0,82,6.29,74,413,2481,10.4,0.12419838
2512,2512,Bob Rouse,1997-98,33.0,15,13,70,70,4,9,13,70.0,,894,36,158,194,966.0,82,5.83,55,336,2444,9.8,0.14496583
2513,2513,Bob Rouse,1998-99,34.0,16,12,71,71,1,11,12,54.0,,965,37,169,206,1020.0,82,5.28,57,380,2242,9.6,0.11238733
2514,2514,Bob Rouse,1999-00,35.0,17,11,70,70,0,11,11,75.0,1187.0,1035,37,180,217,1095.0,82,5.27,57,359,2285,9.4,0.12839594
2515,2515,Bob Rouse,2000-01,36.0,18,1,26,26,0,1,1,20.0,388.0,1061,37,181,218,1115.0,82,5.49,53,331,2294,9.8,0.10686201
2516,2516,Bob Stephenson,1980-81,26.0,2,5,18,18,2,3,5,13.0,,18,2,3,5,13.0,80,7.03,61,280,2352,12.0,0.29746094
2517,2517,Bob Sullivan,1983-84,26.0,2,37,62,62,18,19,37,93.0,,62,18,19,37,93.0,80,7.73,71,310,2444,12.7,0.5560185
2518,2518,Bob Sweeney,1987-88,24.0,2,6,14,14,2,4,6,13.0,,14,2,4,6,13.0,80,7.34,72,344,2400,12.2,0.31515235
2519,2519,Bob Sweeney,1988-89,25.0,3,45,80,80,22,23,45,118.0,,94,24,27,51,131.0,80,7.43,89,437,2435,12.2,0.5243814
2520,2520,Bob Sweeney,1989-90,26.0,4,28,75,75,14,14,28,117.0,,169,38,41,79,248.0,80,7.48,85,403,2430,12.3,0.43581074
2521,2521,Bob Sweeney,1990-91,27.0,5,46,70,70,22,24,46,147.0,,239,60,65,125,395.0,80,7.37,76,367,2421,12.2,0.5982468
2522,2522,Bob Sweeney,1991-92,28.0,6,48,80,80,15,33,48,116.0,,319,75,98,173,511.0,80,6.91,71,366,2385,11.6,0.53493893
2523,2523,Bob Sweeney,1992-93,29.0,7,20,63,63,6,14,20,70.0,,382,81,112,193,581.0,80,6.96,77,402,2440,11.4,0.33962402
2524,2524,Bob Sweeney,1993-94,30.0,8,47,80,80,21,26,47,120.0,,462,102,138,240,701.0,84,7.25,87,443,2603,11.7,0.50103563
2525,2525,Bob Sweeney,1994-95,31.0,9,25,60,60,11,14,25,76.0,,522,113,152,265,777.0,84,6.48,76,407,2545,10.7,0.32419664
2526,2526,Bob Sweeney,1995-96,32.0,10,9,45,45,5,4,9,47.0,,567,118,156,274,824.0,48,5.97,37,209,1408,10.2,0.25178128
2527,2527,Bob Sweeney,1996-97,33.0,11,14,72,72,7,7,14,62.0,,639,125,163,288,886.0,82,6.29,74,413,2481,10.4,0.19130063
2528,2528,Bob Wilkie,1991-92,22.0,2,3,8,8,1,2,3,9.0,,8,1,2,3,9.0,80,6.91,71,366,2385,11.6,0.28184542
2529,2529,Bob Wilkie,1994-95,25.0,3,4,10,10,1,3,4,10.0,,18,2,5,7,19.0,84,6.48,76,407,2545,10.7,0.20630312
2530,2530,Bob Wren,1998-99,24.0,2,0,3,3,0,0,0,4.0,,3,0,0,0,4.0,82,5.28,57,380,2242,9.6,0.17145029
2531,2531,Bob Wren,2001-02,27.0,3,0,1,1,0,0,0,0.0,12.0,4,0,0,0,4.0,82,5.51,63,376,2272,9.9,0.1442678
2532,2532,Bob Wren,2002-03,28.0,4,0,1,1,0,0,0,0.0,10.0,5,0,0,0,4.0,82,5.24,53,338,2262,9.5,0.14439112
2533,2533,Bobby Allen,2003-04,25.0,2,0,1,1,0,0,0,0.0,3.0,1,0,0,0,0.0,82,5.31,60,363,2326,9.4,0.16297561
2534,2534,Bobby Allen,2007-08,29.0,3,3,31,31,0,3,3,14.0,404.0,32,0,3,3,14.0,82,5.76,70,398,2426,9.7,0.11104843
2535,2535,Bobby Allen,2008-09,30.0,4,0,19,19,0,0,0,10.0,188.0,51,0,3,3,24.0,82,5.44,62,351,2383,9.4,0.09038544
2536,2536,Bobby Babcock,1991-92,23.0,2,0,1,1,0,0,0,0.0,,1,0,0,0,0.0,80,6.91,71,366,2385,11.6,0.19685954
2537,2537,Bobby Babcock,1993-94,25.0,3,0,1,1,0,0,0,0.0,,2,0,0,0,0.0,84,7.25,87,443,2603,11.7,0.15194392
2538,2538,Bobby Butler,2010-11,23.0,2,0,2,2,0,0,0,2.0,17.0,2,0,0,0,2.0,82,5.53,56,304,2486,9.1,0.17674801
2539,2539,Bobby Butler,2011-12,24.0,3,21,36,36,10,11,21,73.0,555.0,38,10,11,21,75.0,82,5.46,52,291,2492,9.0,0.43989313
2540,2540,Bobby Butler,2012-13,25.0,4,16,56,56,6,10,16,86.0,643.0,94,16,21,37,161.0,82,5.32,47,271,2439,8.9,0.2936992
2541,2541,Bobby Butler,2013-14,26.0,5,11,34,34,4,7,11,41.0,367.0,128,20,28,48,202.0,48,5.31,29,160,1399,9.1,0.2839821
2542,2542,Bobby Butler,2014-15,27.0,6,1,2,2,0,1,1,5.0,28.0,130,20,29,49,207.0,82,5.34,48,269,2463,8.9,0.17544392
2543,2543,Bobby Crawford,1981-82,21.0,2,4,15,15,1,3,4,25.0,,15,1,3,4,25.0,80,7.69,77,340,2441,12.6,0.3504557
2544,2544,Bobby Crawford,1983-84,23.0,3,0,1,1,0,0,0,1.0,,16,1,3,4,26.0,80,7.73,71,310,2444,12.7,0.20775431
2545,2545,Bobby Dollas,1984-85,20.0,2,0,1,1,0,0,0,0.0,,1,0,0,0,0.0,80,7.89,74,336,2448,12.9,0.27148372
2546,2546,Bobby Dollas,1985-86,21.0,3,0,9,9,0,0,0,3.0,,10,0,0,0,3.0,80,7.77,71,321,2447,12.7,0.2135641
2547,2547,Bobby Dollas,1986-87,22.0,4,5,46,46,0,5,5,52.0,,56,0,5,5,55.0,80,7.94,82,370,2484,12.8,0.15587926
2548,2548,Bobby Dollas,1988-89,24.0,5,0,9,9,0,0,0,5.0,,65,0,5,5,60.0,80,7.43,89,437,2435,12.2,0.19074634
2549,2549,Bobby Dollas,1989-90,25.0,6,3,16,16,0,3,3,11.0,,81,0,8,8,71.0,80,7.48,85,403,2430,12.3,0.21108255
2550,2550,Bobby Dollas,1991-92,27.0,7,8,56,56,3,5,8,59.0,,137,3,13,16,130.0,80,6.91,71,366,2385,11.6,0.16222998
2551,2551,Bobby Dollas,1992-93,28.0,8,4,27,27,3,1,4,26.0,,164,6,14,20,156.0,80,6.96,77,402,2440,11.4,0.22380963
2552,2552,Bobby Dollas,1993-94,29.0,9,0,6,6,0,0,0,5.0,,170,6,14,20,161.0,84,7.25,87,443,2603,11.7,0.14385337
2553,2553,Bobby Dollas,1994-95,30.0,10,20,77,77,9,11,20,121.0,,247,15,25,40,282.0,84,6.48,76,407,2545,10.7,0.22815001
2554,2554,Bobby Dollas,1995-96,31.0,11,20,45,45,7,13,20,70.0,,292,22,38,60,352.0,48,5.97,37,209,1408,10.2,0.36396307
2555,2555,Bobby Dollas,1996-97,32.0,12,30,82,82,8,22,30,117.0,,374,30,60,90,469.0,82,6.29,74,413,2481,10.4,0.3003903
2556,2556,Bobby Dollas,1997-98,33.0,13,18,79,79,4,14,18,96.0,,453,34,74,108,565.0,82,5.83,55,336,2444,9.8,0.22304031
2557,2557,Bobby Dollas,1998-99,34.0,14,8,52,52,2,6,8,38.0,,505,36,80,116,603.0,82,5.28,57,380,2242,9.6,0.14085567
2558,2558,Bobby Dollas,1999-00,35.0,15,10,70,70,2,8,10,34.0,1091.0,575,38,88,126,637.0,82,5.27,57,359,2285,9.4,0.1329794
2559,2559,Bobby Dollas,2000-01,36.0,16,10,50,50,3,7,10,36.0,1004.0,625,41,95,136,673.0,82,5.49,53,331,2294,9.8,0.14741847
2560,2560,Bobby Dollas,2001-02,37.0,17,2,21,21,1,1,2,11.0,270.0,646,42,96,138,684.0,82,5.51,63,376,2272,9.9,0.10399121
2561,2561,Bobby Farnham,2015-16,27.0,2,0,11,11,0,0,0,6.0,79.0,11,0,0,0,6.0,82,5.32,47,251,2453,8.9,0.17279434
2562,2562,Bobby Farnham,2016-17,28.0,3,10,53,53,8,2,10,50.0,494.0,64,8,2,10,56.0,82,5.34,48,255,2438,9.0,0.20387292
2563,2563,Bobby Farnham,2017-18,29.0,4,0,3,3,0,0,0,4.0,25.0,67,8,2,10,60.0,82,5.45,47,245,2478,9.0,0.14088896
2564,2564,Bobby Francis,1983-84,25.0,2,2,14,14,2,0,2,4.0,,14,2,0,2,4.0,80,7.73,71,310,2444,12.7,0.30721214
2565,2565,Bobby Gould,1980-81,23.0,2,0,1,1,0,0,0,1.0,,1,0,0,0,1.0,80,7.03,61,280,2352,12.0,0.23285186
2566,2566,Bobby Gould,1981-82,24.0,3,0,3,3,0,0,0,5.0,,4,0,0,0,6.0,80,7.69,77,340,2441,12.6,0.20876968
2567,2567,Bobby Gould,1982-83,25.0,4,34,76,76,21,13,34,121.0,,80,21,13,34,127.0,80,8.03,73,320,2489,12.9,0.44728374
2568,2568,Bobby Gould,1983-84,26.0,5,40,80,80,22,18,40,142.0,,160,43,31,74,269.0,80,7.73,71,310,2444,12.7,0.46220803
2569,2569,Bobby Gould,1984-85,27.0,6,40,78,78,21,19,40,155.0,,238,64,50,114,424.0,80,7.89,74,336,2448,12.9,0.4772149
2570,2570,Bobby Gould,1985-86,28.0,7,33,78,78,14,19,33,113.0,,316,78,69,147,537.0,80,7.77,71,321,2447,12.7,0.37976363
2571,2571,Bobby Gould,1986-87,29.0,8,38,79,79,19,19,38,123.0,,395,97,88,185,660.0,80,7.94,82,370,2484,12.8,0.42849892
2572,2572,Bobby Gould,1987-88,30.0,9,50,78,78,23,27,50,157.0,,473,120,115,235,817.0,80,7.34,72,344,2400,12.2,0.5517476
2573,2573,Bobby Gould,1988-89,31.0,10,26,72,72,12,14,26,119.0,,545,132,129,261,936.0,80,7.43,89,437,2435,12.2,0.30989859
2574,2574,Bobby Gould,1989-90,32.0,11,18,75,75,5,13,18,91.0,,620,137,142,279,1027.0,80,7.48,85,403,2430,12.3,0.25846282
2575,2575,Bobby Gould,1990-91,33.0,12,25,77,77,8,17,25,92.0,,697,145,159,304,1119.0,80,7.37,76,367,2421,12.2,0.25202465
2576,2576,Bobby Guindon,1980-81,30.0,2,1,6,6,0,1,1,10.0,,6,0,1,1,10.0,80,7.03,61,280,2352,12.0,0.23157433
2577,2577,Bobby Holik,1991-92,21.0,2,43,78,78,21,22,43,173.0,,78,21,22,43,173.0,80,6.91,71,366,2385,11.6,0.64882135
2578,2578,Bobby Holik,1992-93,22.0,3,45,76,76,21,24,45,207.0,,154,42,46,88,380.0,80,6.96,77,402,2440,11.4,0.69558275
2579,2579,Bobby Holik,1993-94,23.0,4,39,61,61,20,19,39,180.0,,215,62,65,127,560.0,84,7.25,87,443,2603,11.7,0.63694024
2580,2580,Bobby Holik,1994-95,24.0,5,33,70,70,13,20,33,130.0,,285,75,85,160,690.0,84,6.48,76,407,2545,10.7,0.4971479
2581,2581,Bobby Holik,1995-96,25.0,6,20,48,48,10,10,20,84.0,,333,85,95,180,774.0,48,5.97,37,209,1408,10.2,0.53578234
2582,2582,Bobby Holik,1996-97,26.0,7,30,63,63,13,17,30,157.0,,396,98,112,210,931.0,82,6.29,74,413,2481,10.4,0.50429547
2583,2583,Bobby Holik,1997-98,27.0,8,62,82,82,23,39,62,192.0,,478,121,151,272,1123.0,82,5.83,55,336,2444,9.8,0.69514114
2584,2584,Bobby Holik,1998-99,28.0,9,65,82,82,29,36,65,238.0,,560,150,187,337,1361.0,82,5.28,57,380,2242,9.6,0.76511246
2585,2585,Bobby Holik,1999-00,29.0,10,64,78,78,27,37,64,253.0,1370.0,638,177,224,401,1614.0,82,5.27,57,359,2285,9.4,0.7662418
2586,2586,Bobby Holik,2000-01,30.0,11,46,79,79,23,23,46,257.0,1333.0,717,200,247,447,1871.0,82,5.49,53,331,2294,9.8,0.6022482
2587,2587,Bobby Holik,2001-02,31.0,12,50,80,80,15,35,50,206.0,1266.0,797,215,282,497,2077.0,82,5.51,63,376,2272,9.9,0.57885504
2588,2588,Bobby Holik,2002-03,32.0,13,54,81,81,25,29,54,270.0,1434.0,878,240,311,551,2347.0,82,5.24,53,338,2262,9.5,0.64647824
2589,2589,Bobby Holik,2003-04,33.0,14,35,64,64,16,19,35,213.0,1159.0,942,256,330,586,2560.0,82,5.31,60,363,2326,9.4,0.5461119
2590,2590,Bobby Holik,2004-05,34.0,15,56,82,82,25,31,56,225.0,1522.0,1024,281,361,642,2785.0,82,5.14,57,348,2300,9.2,0.6718806
2591,2591,Bobby Holik,2006-07,36.0,16,33,64,64,15,18,33,151.0,1121.0,1088,296,379,675,2936.0,82,6.05,85,480,2458,10.1,0.43929505
2592,2592,Bobby Holik,2007-08,37.0,17,29,82,82,11,18,29,190.0,1307.0,1170,307,397,704,3126.0,82,5.76,70,398,2426,9.7,0.34277445
2593,2593,Bobby Holik,2008-09,38.0,18,34,82,82,15,19,34,140.0,1310.0,1252,322,416,738,3266.0,82,5.44,62,351,2383,9.4,0.38031644
2594,2594,Bobby Holik,2009-10,39.0,19,9,62,62,4,5,9,79.0,632.0,1314,326,421,747,3345.0,82,5.7,65,341,2477,9.4,0.23499241
2595,2595,Bobby Reynolds,1990-91,23.0,2,2,7,7,1,1,2,13.0,,7,1,1,2,13.0,80,7.37,76,367,2421,12.2,0.27630842
2596,2596,Bobby Robins,2015-16,34.0,2,0,3,3,0,0,0,0.0,23.0,3,0,0,0,0.0,82,5.32,47,251,2453,8.9,0.12137434
2597,2597,Bobby Ryan,2008-09,21.0,2,10,23,23,5,5,10,37.0,259.0,23,5,5,10,37.0,82,5.44,62,351,2383,9.4,0.40858623
2598,2598,Bobby Ryan,2009-10,22.0,3,57,64,64,31,26,57,174.0,988.0,87,36,31,67,211.0,82,5.7,65,341,2477,9.4,0.8345717
2599,2599,Bobby Ryan,2010-11,23.0,4,64,81,81,35,29,64,258.0,1498.0,168,71,60,131,469.0,82,5.53,56,304,2486,9.1,0.7600244
2600,2600,Bobby Ryan,2011-12,24.0,5,71,82,82,34,37,71,270.0,1655.0,250,105,97,202,739.0,82,5.46,52,291,2492,9.0,0.8731783
2601,2601,Bobby Ryan,2012-13,25.0,6,57,82,82,31,26,57,204.0,1505.0,332,136,123,259,943.0,82,5.32,47,271,2439,8.9,0.713598
2602,2602,Bobby Ryan,2013-14,26.0,7,30,46,46,11,19,30,101.0,763.0,378,147,142,289,1044.0,48,5.31,29,160,1399,9.1,0.6628644
2603,2603,Bobby Ryan,2014-15,27.0,8,48,70,70,23,25,48,190.0,1181.0,448,170,167,337,1234.0,82,5.34,48,269,2463,8.9,0.67394423
2604,2604,Bobby Ryan,2015-16,28.0,9,54,78,78,18,36,54,221.0,1363.0,526,188,203,391,1455.0,82,5.32,47,251,2453,8.9,0.7166671
2605,2605,Bobby Ryan,2016-17,29.0,10,56,81,81,22,34,56,183.0,1391.0,607,210,237,447,1638.0,82,5.34,48,255,2438,9.0,0.6488807
2606,2606,Bobby Ryan,2017-18,30.0,11,25,62,62,13,12,25,111.0,963.0,669,223,249,472,1749.0,82,5.45,47,245,2478,9.0,0.44146615
2607,2607,Bobby Ryan,2018-19,31.0,12,33,62,62,11,22,33,112.0,1019.0,731,234,271,505,1861.0,82,5.86,50,250,2620,9.2,0.46754444
2608,2608,Bobby Ryan,2019-20,32.0,13,42,78,78,15,27,42,160.0,1223.0,809,249,298,547,2021.0,82,5.96,47,239,2579,9.5,0.52024835
2609,2609,Bobby Ryan,2020-21,33.0,14,8,24,24,5,3,8,43.0,324.0,833,254,301,555,2064.0,70,5.96,42,208,2192,9.5,0.48592812
2610,2610,Bobby Sanguinetti,2010-11,22.0,2,0,5,5,0,0,0,5.0,58.0,5,0,0,0,5.0,82,5.53,56,304,2486,9.1,0.18725821
2611,2611,Bobby Sanguinetti,2012-13,24.0,3,0,3,3,0,0,0,5.0,36.0,8,0,0,0,10.0,82,5.32,47,271,2439,8.9,0.16270116
2612,2612,Bobby Sanguinetti,2013-14,25.0,4,6,37,37,2,4,6,48.0,546.0,45,2,4,6,58.0,48,5.31,29,160,1399,9.1,0.21433043
2613,2613,Bogdan Kiselevich,2019-20,29.0,2,8,32,32,0,8,8,14.0,475.0,32,0,8,8,14.0,82,5.96,47,239,2579,9.5,0.14884457
2614,2614,Bogdan Yakimov,2015-16,21.0,2,0,1,1,0,0,0,1.0,11.0,1,0,0,0,1.0,82,5.32,47,251,2453,8.9,0.20590746
2615,2615,Boo Nieves,2017-18,24.0,2,0,1,1,0,0,0,0.0,12.0,1,0,0,0,0.0,82,5.45,47,245,2478,9.0,0.1600399
2616,2616,Boo Nieves,2018-19,25.0,3,9,28,28,1,8,9,23.0,286.0,29,1,8,9,23.0,82,5.86,50,250,2620,9.2,0.20055977
2617,2617,Boo Nieves,2019-20,26.0,4,10,43,43,4,6,10,34.0,415.0,72,5,14,19,57.0,82,5.96,47,239,2579,9.5,0.19018811
2618,2618,Boo Nieves,2020-21,27.0,5,0,4,4,0,0,0,2.0,30.0,76,5,14,19,59.0,70,5.96,42,208,2192,9.5,0.16545388
2619,2619,Boone Jenner,2014-15,21.0,2,29,72,72,16,13,29,127.0,1014.0,72,16,13,29,127.0,82,5.34,48,269,2463,8.9,0.46625698
2620,2620,Boone Jenner,2015-16,22.0,3,17,31,31,9,8,17,83.0,566.0,103,25,21,46,210.0,82,5.32,47,251,2453,8.9,0.44379455
2621,2621,Boone Jenner,2016-17,23.0,4,49,82,82,30,19,49,225.0,1346.0,185,55,40,95,435.0,82,5.34,48,255,2438,9.0,0.64827365
2622,2622,Boone Jenner,2017-18,24.0,5,34,82,82,18,16,34,211.0,1317.0,267,73,56,129,646.0,82,5.45,47,245,2478,9.0,0.5006969
2623,2623,Boone Jenner,2018-19,25.0,6,32,75,75,13,19,32,187.0,1235.0,342,86,75,161,833.0,82,5.86,50,250,2620,9.2,0.45662403
2624,2624,Boone Jenner,2019-20,26.0,7,38,77,77,16,22,38,170.0,1314.0,419,102,97,199,1003.0,82,5.96,47,239,2579,9.5,0.5218046
2625,2625,Boone Jenner,2020-21,27.0,8,24,70,70,11,13,24,179.0,1268.0,489,113,110,223,1182.0,70,5.96,42,208,2192,9.5,0.40694994
2626,2626,Boris Mironov,1994-95,22.0,2,31,79,79,7,24,31,145.0,,79,7,24,31,145.0,84,6.48,76,407,2545,10.7,0.45293456
2627,2627,Boris Mironov,1995-96,23.0,3,8,29,29,1,7,8,48.0,,108,8,31,39,193.0,48,5.97,37,209,1408,10.2,0.31654668
2628,2628,Boris Mironov,1996-97,24.0,4,32,78,78,8,24,32,158.0,,186,16,55,71,351.0,82,6.29,74,413,2481,10.4,0.42630607
2629,2629,Boris Mironov,1997-98,25.0,5,32,55,55,6,26,32,147.0,,241,22,81,103,498.0,82,5.83,55,336,2444,9.8,0.5496018
2630,2630,Boris Mironov,1998-99,26.0,6,46,81,81,16,30,46,203.0,,322,38,111,149,701.0,82,5.28,57,380,2242,9.6,0.6013473
2631,2631,Boris Mironov,1999-00,27.0,7,49,75,75,11,38,49,173.0,1924.0,397,49,149,198,874.0,82,5.27,57,359,2285,9.4,0.563521
2632,2632,Boris Mironov,2000-01,28.0,8,37,58,58,9,28,37,144.0,1443.0,455,58,177,235,1018.0,82,5.49,53,331,2294,9.8,0.558126
2633,2633,Boris Mironov,2001-02,29.0,9,22,66,66,5,17,22,143.0,1458.0,521,63,194,257,1161.0,82,5.51,63,376,2272,9.9,0.3417432
2634,2634,Boris Mironov,2002-03,30.0,10,18,64,64,4,14,18,129.0,1454.0,585,67,208,275,1290.0,82,5.24,53,338,2262,9.5,0.3321053
2635,2635,Boris Mironov,2003-04,31.0,11,16,56,56,6,10,16,70.0,1125.0,641,73,218,291,1360.0,82,5.31,60,363,2326,9.4,0.2842549
2636,2636,Boris Mironov,2004-05,32.0,12,16,75,75,3,13,16,129.0,1547.0,716,76,231,307,1489.0,82,5.14,57,348,2300,9.2,0.34374088
2637,2637,Boris Valabik,2008-09,22.0,2,0,7,7,0,0,0,5.0,117.0,7,0,0,0,5.0,82,5.44,62,351,2383,9.4,0.17565298
2638,2638,Boris Valabik,2009-10,23.0,3,5,50,50,0,5,5,16.0,762.0,57,0,5,5,21.0,82,5.7,65,341,2477,9.4,0.105680555
2639,2639,Boris Valabik,2010-11,24.0,4,2,23,23,0,2,2,22.0,304.0,80,0,7,7,43.0,82,5.53,56,304,2486,9.1,0.14533651
2640,2640,Borna Rendulic,2015-16,23.0,2,2,11,11,1,1,2,6.0,103.0,11,1,1,2,6.0,82,5.32,47,251,2453,8.9,0.20869225
2641,2641,Borna Rendulic,2016-17,24.0,3,0,3,3,0,0,0,1.0,23.0,14,1,1,2,7.0,82,5.34,48,255,2438,9.0,0.14778012
2642,2642,Borna Rendulic,2017-18,25.0,4,0,1,1,0,0,0,1.0,5.0,15,1,1,2,8.0,82,5.45,47,245,2478,9.0,0.1624954
2643,2643,Boyd Devereaux,1998-99,20.0,2,5,38,38,1,4,5,27.0,,38,1,4,5,27.0,82,5.28,57,380,2242,9.6,0.19354573
2644,2644,Boyd Devereaux,1999-00,21.0,3,14,61,61,6,8,14,39.0,619.0,99,7,12,19,66.0,82,5.27,57,359,2285,9.4,0.26166993
2645,2645,Boyd Devereaux,2000-01,22.0,4,27,76,76,8,19,27,108.0,958.0,175,15,31,46,174.0,82,5.49,53,331,2294,9.8,0.35198426
2646,2646,Boyd Devereaux,2001-02,23.0,5,11,55,55,5,6,11,66.0,557.0,230,20,37,57,240.0,82,5.51,63,376,2272,9.9,0.31114468
2647,2647,Boyd Devereaux,2002-03,24.0,6,25,79,79,9,16,25,116.0,909.0,309,29,53,82,356.0,82,5.24,53,338,2262,9.5,0.34156036
2648,2648,Boyd Devereaux,2003-04,25.0,7,12,61,61,3,9,12,72.0,575.0,370,32,62,94,428.0,82,5.31,60,363,2326,9.4,0.22811282
2649,2649,Boyd Devereaux,2004-05,26.0,8,15,61,61,6,9,15,62.0,608.0,431,38,71,109,490.0,82,5.14,57,348,2300,9.2,0.2698627
2650,2650,Boyd Devereaux,2006-07,28.0,9,22,78,78,8,14,22,76.0,997.0,509,46,85,131,566.0,82,6.05,85,480,2458,10.1,0.2705973
2651,2651,Boyd Devereaux,2007-08,29.0,10,19,33,33,8,11,19,57.0,504.0,542,54,96,150,623.0,82,5.76,70,398,2426,9.7,0.40917706
2652,2652,Boyd Devereaux,2008-09,30.0,11,18,62,62,7,11,18,81.0,866.0,604,61,107,168,704.0,82,5.44,62,351,2383,9.4,0.28174388
2653,2653,Boyd Devereaux,2009-10,31.0,12,11,23,23,6,5,11,41.0,315.0,627,67,112,179,745.0,82,5.7,65,341,2477,9.4,0.29981163
2654,2654,Boyd Gordon,2004-05,21.0,2,6,41,41,1,5,6,42.0,540.0,41,1,5,6,42.0,82,5.14,57,348,2300,9.2,0.24626979
2655,2655,Boyd Gordon,2006-07,23.0,3,1,25,25,0,1,1,12.0,292.0,66,1,6,7,54.0,82,6.05,85,480,2458,10.1,0.1413669
2656,2656,Boyd Gordon,2007-08,24.0,4,29,71,71,7,22,29,104.0,1127.0,137,8,28,36,158.0,82,5.76,70,398,2426,9.7,0.36015683
2657,2657,Boyd Gordon,2008-09,25.0,5,16,67,67,7,9,16,100.0,1054.0,204,15,37,52,258.0,82,5.44,62,351,2383,9.4,0.26411128
2658,2658,Boyd Gordon,2009-10,26.0,6,14,63,63,5,9,14,69.0,848.0,267,20,46,66,327.0,82,5.7,65,341,2477,9.4,0.22335592
2659,2659,Boyd Gordon,2010-11,27.0,7,10,36,36,4,6,10,40.0,370.0,303,24,52,76,367.0,82,5.53,56,304,2486,9.1,0.2130324
2660,2660,Boyd Gordon,2011-12,28.0,8,9,60,60,3,6,9,77.0,783.0,363,27,58,85,444.0,82,5.46,52,291,2492,9.0,0.18395716
2661,2661,Boyd Gordon,2012-13,29.0,9,23,75,75,8,15,23,114.0,1194.0,438,35,73,108,558.0,82,5.32,47,271,2439,8.9,0.25676316
2662,2662,Boyd Gordon,2013-14,30.0,10,14,48,48,4,10,14,59.0,721.0,486,39,83,122,617.0,48,5.31,29,160,1399,9.1,0.24952188
2663,2663,Boyd Gordon,2014-15,31.0,11,21,74,74,8,13,21,80.0,1092.0,560,47,96,143,697.0,82,5.34,48,269,2463,8.9,0.24166983
2664,2664,Boyd Gordon,2015-16,32.0,12,13,68,68,6,7,13,65.0,906.0,628,53,103,156,762.0,82,5.32,47,251,2453,8.9,0.16203767
2665,2665,Boyd Gordon,2016-17,33.0,13,4,65,65,2,2,4,53.0,793.0,693,55,105,160,815.0,82,5.34,48,255,2438,9.0,0.12462643
2666,2666,Boyd Gordon,2017-18,34.0,14,1,13,13,1,0,1,8.0,106.0,706,56,105,161,823.0,82,5.45,47,245,2478,9.0,0.13404828
2667,2667,Boyd Kane,2004-05,26.0,2,0,7,7,0,0,0,6.0,70.0,7,0,0,0,6.0,82,5.14,57,348,2300,9.2,0.17265499
2668,2668,Boyd Kane,2006-07,28.0,3,1,5,5,0,1,1,1.0,20.0,12,0,1,1,7.0,82,6.05,85,480,2458,10.1,0.16696042
2669,2669,Boyd Kane,2007-08,29.0,4,2,15,15,0,2,2,7.0,104.0,27,0,3,3,14.0,82,5.76,70,398,2426,9.7,0.14112684
2670,2670,Boyd Kane,2009-10,31.0,5,0,1,1,0,0,0,0.0,8.0,28,0,3,3,14.0,82,5.7,65,341,2477,9.4,0.12509945
2671,2671,Boyd Kane,2010-11,32.0,6,0,3,3,0,0,0,2.0,25.0,31,0,3,3,16.0,82,5.53,56,304,2486,9.1,0.14538476
2672,2672,Bracken Kearns,2012-13,31.0,2,0,5,5,0,0,0,0.0,36.0,5,0,0,0,0.0,82,5.32,47,271,2439,8.9,0.10747486
2673,2673,Bracken Kearns,2013-14,32.0,3,0,1,1,0,0,0,0.0,12.0,6,0,0,0,0.0,48,5.31,29,160,1399,9.1,0.15237617
2674,2674,Bracken Kearns,2014-15,33.0,4,5,25,25,3,2,5,37.0,330.0,31,3,2,5,37.0,82,5.34,48,269,2463,8.9,0.1953215
2675,2675,Bracken Kearns,2016-17,35.0,5,1,2,2,0,1,1,0.0,32.0,33,3,3,6,37.0,82,5.34,48,255,2438,9.0,0.12975451
2676,2676,Bracken Kearns,2017-18,36.0,6,0,2,2,0,0,0,3.0,22.0,35,3,3,6,40.0,82,5.45,47,245,2478,9.0,0.12743428
2677,2677,Brad Aitken,1988-89,21.0,2,2,5,5,1,1,2,4.0,,5,1,1,2,4.0,80,7.43,89,437,2435,12.2,0.32395917
2678,2678,Brad Aitken,1991-92,24.0,3,2,9,9,0,2,2,3.0,,14,1,3,4,7.0,80,6.91,71,366,2385,11.6,0.21171507
2679,2679,Brad Berry,1986-87,21.0,2,1,13,13,1,0,1,15.0,,13,1,0,1,15.0,80,7.94,82,370,2484,12.8,0.24544364
2680,2680,Brad Berry,1987-88,22.0,3,10,52,52,2,8,10,40.0,,65,3,8,11,55.0,80,7.34,72,344,2400,12.2,0.27377665
2681,2681,Brad Berry,1988-89,23.0,4,6,48,48,0,6,6,31.0,,113,3,14,17,86.0,80,7.43,89,437,2435,12.2,0.20887849
2682,2682,Brad Berry,1989-90,24.0,5,9,38,38,0,9,9,21.0,,151,3,23,26,107.0,80,7.48,85,403,2430,12.3,0.1570496
2683,2683,Brad Berry,1990-91,25.0,6,3,12,12,1,2,3,7.0,,163,4,25,29,114.0,80,7.37,76,367,2421,12.2,0.1985741
2684,2684,Brad Berry,1992-93,27.0,7,0,7,7,0,0,0,2.0,,170,4,25,29,116.0,80,6.96,77,402,2440,11.4,0.14888373
2685,2685,Brad Berry,1993-94,28.0,8,3,63,63,0,3,3,49.0,,233,4,28,32,165.0,84,7.25,87,443,2603,11.7,0.123069614
2686,2686,Brad Berry,1994-95,29.0,9,0,8,8,0,0,0,4.0,,241,4,28,32,169.0,84,6.48,76,407,2545,10.7,0.11976978
2687,2687,Brad Bombardir,1998-99,26.0,2,6,43,43,1,5,6,16.0,,43,1,5,6,16.0,82,5.28,57,380,2242,9.6,0.12710616
2688,2688,Brad Bombardir,1999-00,27.0,3,8,56,56,1,7,8,47.0,843.0,99,2,12,14,63.0,82,5.27,57,359,2285,9.4,0.1455836
2689,2689,Brad Bombardir,2000-01,28.0,4,4,32,32,3,1,4,24.0,509.0,131,5,13,18,87.0,82,5.49,53,331,2294,9.8,0.18118873
2690,2690,Brad Bombardir,2001-02,29.0,5,15,70,70,0,15,15,81.0,1458.0,201,5,28,33,168.0,82,5.51,63,376,2272,9.9,0.17230654
2691,2691,Brad Bombardir,2002-03,30.0,6,3,28,28,1,2,3,24.0,575.0,229,6,30,36,192.0,82,5.24,53,338,2262,9.5,0.15221307
2692,2692,Brad Bombardir,2003-04,31.0,7,15,58,58,1,14,15,55.0,1277.0,287,7,44,51,247.0,82,5.31,60,363,2326,9.4,0.1622279
2693,2693,Brad Bombardir,2004-05,32.0,8,3,69,69,1,2,3,47.0,1380.0,356,8,46,54,294.0,82,5.14,57,348,2300,9.2,0.15105784
2694,2694,Brad Boyes,2004-05,22.0,2,0,1,1,0,0,0,0.0,13.0,1,0,0,0,0.0,82,5.14,57,348,2300,9.2,0.28400066
2695,2695,Brad Boyes,2006-07,24.0,3,69,82,82,26,43,69,203.0,1293.0,83,26,43,69,203.0,82,6.05,85,480,2458,10.1,0.78917146
2696,2696,Brad Boyes,2007-08,25.0,4,46,81,81,17,29,46,182.0,1327.0,164,43,72,115,385.0,82,5.76,70,398,2426,9.7,0.5783598
2697,2697,Brad Boyes,2008-09,26.0,5,65,82,82,43,22,65,207.0,1471.0,246,86,94,180,592.0,82,5.44,62,351,2383,9.4,0.8221179
2698,2698,Brad Boyes,2009-10,27.0,6,72,82,82,33,39,72,220.0,1570.0,328,119,133,252,812.0,82,5.7,65,341,2477,9.4,0.8032951
2699,2699,Brad Boyes,2010-11,28.0,7,42,82,82,14,28,42,197.0,1377.0,410,133,161,294,1009.0,82,5.53,56,304,2486,9.1,0.5719738
2700,2700,Brad Boyes,2011-12,29.0,8,55,83,83,17,38,55,178.0,1410.0,493,150,199,349,1187.0,82,5.46,52,291,2492,9.0,0.6620329
2701,2701,Brad Boyes,2012-13,30.0,9,23,65,65,8,15,23,100.0,856.0,558,158,214,372,1287.0,82,5.32,47,271,2439,8.9,0.37836075
2702,2702,Brad Boyes,2013-14,31.0,10,35,48,48,10,25,35,97.0,874.0,606,168,239,407,1384.0,48,5.31,29,160,1399,9.1,0.58025956
2703,2703,Brad Boyes,2014-15,32.0,11,36,78,78,21,15,36,176.0,1329.0,684,189,254,443,1560.0,82,5.34,48,269,2463,8.9,0.46294236
2704,2704,Brad Boyes,2015-16,33.0,12,38,78,78,14,24,38,151.0,1221.0,762,203,278,481,1711.0,82,5.32,47,251,2453,8.9,0.46950263
2705,2705,Brad Boyes,2016-17,34.0,13,24,60,60,8,16,24,85.0,718.0,822,211,294,505,1796.0,82,5.34,48,255,2438,9.0,0.36120698
2706,2706,Brad Brown,1997-98,22.0,2,0,8,8,0,0,0,0.0,,8,0,0,0,0.0,82,5.83,55,336,2444,9.8,0.13850203
2707,2707,Brad Brown,1999-00,24.0,3,8,66,66,1,7,8,26.0,953.0,74,1,7,8,26.0,82,5.27,57,359,2285,9.4,0.13124782
2708,2708,Brad Brown,2000-01,25.0,4,9,57,57,0,9,9,15.0,809.0,131,1,16,17,41.0,82,5.49,53,331,2294,9.8,0.09259269
2709,2709,Brad Brown,2001-02,26.0,5,4,48,48,1,3,4,14.0,697.0,179,2,19,21,55.0,82,5.51,63,376,2272,9.9,0.091134965
2710,2710,Brad Brown,2002-03,27.0,6,4,51,51,0,4,4,23.0,811.0,230,2,23,25,78.0,82,5.24,53,338,2262,9.5,0.08303046
2711,2711,Brad Brown,2003-04,28.0,7,1,57,57,0,1,1,10.0,526.0,287,2,24,26,88.0,82,5.31,60,363,2326,9.4,0.06992048
2712,2712,Brad Brown,2004-05,29.0,8,3,43,43,0,3,3,20.0,506.0,330,2,27,29,108.0,82,5.14,57,348,2300,9.2,0.10832554
2713,2713,Brad Chartrand,2000-01,26.0,2,12,50,50,6,6,12,51.0,552.0,50,6,6,12,51.0,82,5.49,53,331,2294,9.8,0.22109199
2714,2714,Brad Chartrand,2001-02,27.0,3,1,4,4,1,0,1,6.0,46.0,54,7,6,13,57.0,82,5.51,63,376,2272,9.9,0.1785239
2715,2715,Brad Chartrand,2002-03,28.0,4,16,46,46,7,9,16,49.0,556.0,100,14,15,29,106.0,82,5.24,53,338,2262,9.5,0.2840304
2716,2716,Brad Chartrand,2003-04,29.0,5,14,62,62,8,6,14,64.0,759.0,162,22,21,43,170.0,82,5.31,60,363,2326,9.4,0.20975238
2717,2717,Brad Chartrand,2004-05,30.0,6,7,53,53,3,4,7,63.0,615.0,215,25,25,50,233.0,82,5.14,57,348,2300,9.2,0.19487858
2718,2718,Brad Church,1998-99,22.0,2,0,2,2,0,0,0,4.0,,2,0,0,0,4.0,82,5.28,57,380,2242,9.6,0.18892884
2719,2719,Brad Dalgarno,1986-87,19.0,2,1,2,2,1,0,1,3.0,,2,1,0,1,3.0,80,7.94,82,370,2484,12.8,0.29237366
2720,2720,Brad Dalgarno,1988-89,21.0,3,10,38,38,2,8,10,39.0,,40,3,8,11,42.0,80,7.43,89,437,2435,12.2,0.3075962
2721,2721,Brad Dalgarno,1989-90,22.0,4,21,55,55,11,10,21,83.0,,95,14,18,32,125.0,80,7.48,85,403,2430,12.3,0.40205935
2722,2722,Brad Dalgarno,1991-92,24.0,5,15,41,41,3,12,15,34.0,,136,17,30,47,159.0,80,6.91,71,366,2385,11.6,0.310727
2723,2723,Brad Dalgarno,1992-93,25.0,6,3,15,15,2,1,3,17.0,,151,19,31,50,176.0,80,6.96,77,402,2440,11.4,0.31827042
2724,2724,Brad Dalgarno,1993-94,26.0,7,32,57,57,15,17,32,62.0,,208,34,48,82,238.0,84,7.25,87,443,2603,11.7,0.4364139
2725,2725,Brad Dalgarno,1994-95,27.0,8,30,73,73,11,19,30,97.0,,281,45,67,112,335.0,84,6.48,76,407,2545,10.7,0.34134975
2726,2726,Brad Dalgarno,1995-96,28.0,9,5,22,22,3,2,5,18.0,,303,48,69,117,353.0,48,5.97,37,209,1408,10.2,0.25623488
2727,2727,Brad Dalgarno,1996-97,29.0,10,3,18,18,1,2,3,11.0,,321,49,71,120,364.0,82,6.29,74,413,2481,10.4,0.23124626
2728,2728,Brad DeFauw,2003-04,26.0,2,3,9,9,3,0,3,19.0,124.0,9,3,0,3,19.0,82,5.31,60,363,2326,9.4,0.24859807
2729,2729,Brad Fast,2004-05,24.0,2,1,1,1,1,0,1,4.0,21.0,1,1,0,1,4.0,82,5.14,57,348,2300,9.2,0.3112707
2730,2730,Brad Ference,2000-01,21.0,2,2,13,13,0,2,2,10.0,178.0,13,0,2,2,10.0,82,5.49,53,331,2294,9.8,0.2275857
2731,2731,Brad Ference,2001-02,22.0,3,1,14,14,0,1,1,5.0,183.0,27,0,3,3,15.0,82,5.51,63,376,2272,9.9,0.15689301
2732,2732,Brad Ference,2002-03,23.0,4,17,80,80,2,15,17,65.0,1579.0,107,2,18,20,80.0,82,5.24,53,338,2262,9.5,0.21074209
2733,2733,Brad Ference,2003-04,24.0,5,9,75,75,2,7,9,49.0,1206.0,182,4,25,29,129.0,82,5.31,60,363,2326,9.4,0.17277533
2734,2734,Brad Ference,2004-05,25.0,6,5,63,63,0,5,5,39.0,885.0,245,4,30,34,168.0,82,5.14,57,348,2300,9.2,0.16623893
2735,2735,Brad Ference,2007-08,28.0,7,0,5,5,0,0,0,1.0,59.0,250,4,30,34,169.0,82,5.76,70,398,2426,9.7,0.13106623
2736,2736,Brad Hunt,2014-15,26.0,2,0,3,3,0,0,0,1.0,38.0,3,0,0,0,1.0,82,5.34,48,269,2463,8.9,0.15313554
2737,2737,Brad Hunt,2015-16,27.0,3,3,11,11,1,2,3,20.0,214.0,14,1,2,3,21.0,82,5.32,47,251,2453,8.9,0.2084181
2738,2738,Brad Hunt,2016-17,28.0,4,0,7,7,0,0,0,12.0,99.0,21,1,2,3,33.0,82,5.34,48,255,2438,9.0,0.15402046
2739,2739,Brad Hunt,2017-18,29.0,5,6,12,12,1,5,6,14.0,174.0,33,2,7,9,47.0,82,5.45,47,245,2478,9.0,0.20508477
2740,2740,Brad Hunt,2018-19,30.0,6,18,45,45,3,15,18,80.0,749.0,78,5,22,27,127.0,82,5.86,50,250,2620,9.2,0.31869173
2741,2741,Brad Hunt,2019-20,31.0,7,12,42,42,5,7,12,75.0,625.0,120,10,29,39,202.0,82,5.96,47,239,2579,9.5,0.2335355
2742,2742,Brad Hunt,2020-21,32.0,8,19,59,59,8,11,19,106.0,893.0,179,18,40,58,308.0,70,5.96,42,208,2192,9.5,0.30852622
2743,2743,Brad Isbister,1998-99,21.0,2,17,66,66,9,8,17,115.0,,66,9,8,17,115.0,82,5.28,57,380,2242,9.6,0.318837
2744,2744,Brad Isbister,1999-00,22.0,3,8,32,32,4,4,8,48.0,370.0,98,13,12,25,163.0,82,5.27,57,359,2285,9.4,0.3185566
2745,2745,Brad Isbister,2000-01,23.0,4,42,64,64,22,20,42,135.0,1086.0,162,35,32,67,298.0,82,5.49,53,331,2294,9.8,0.64545965
2746,2746,Brad Isbister,2001-02,24.0,5,32,51,51,18,14,32,129.0,991.0,213,53,46,99,427.0,82,5.51,63,376,2272,9.9,0.60552555
2747,2747,Brad Isbister,2002-03,25.0,6,38,79,79,17,21,38,142.0,1209.0,292,70,67,137,569.0,82,5.24,53,338,2262,9.5,0.5019508
2748,2748,Brad Isbister,2003-04,26.0,7,28,66,66,13,15,28,119.0,909.0,358,83,82,165,688.0,82,5.31,60,363,2326,9.4,0.44428387
2749,2749,Brad Isbister,2004-05,27.0,8,18,51,51,10,8,18,80.0,651.0,409,93,90,183,768.0,82,5.14,57,348,2300,9.2,0.44026044
2750,2750,Brad Isbister,2006-07,29.0,9,23,58,58,6,17,23,112.0,807.0,467,99,107,206,880.0,82,6.05,85,480,2458,10.1,0.35906366
2751,2751,Brad Isbister,2007-08,30.0,10,5,19,19,1,4,5,36.0,259.0,486,100,111,211,916.0,82,5.76,70,398,2426,9.7,0.2941751
2752,2752,Brad Isbister,2008-09,31.0,11,11,55,55,6,5,11,71.0,595.0,541,106,116,222,987.0,82,5.44,62,351,2383,9.4,0.23088849
2753,2753,Brad Jones,1987-88,22.0,2,1,4,4,1,0,1,8.0,,4,1,0,1,8.0,80,7.34,72,344,2400,12.2,0.29056233
2754,2754,Brad Jones,1988-89,23.0,3,7,19,19,2,5,7,33.0,,23,3,5,8,41.0,80,7.43,89,437,2435,12.2,0.36238664
2755,2755,Brad Jones,1989-90,24.0,4,11,22,22,6,5,11,25.0,,45,9,10,19,66.0,80,7.48,85,403,2430,12.3,0.3679335
2756,2756,Brad Jones,1990-91,25.0,5,0,2,2,0,0,0,0.0,,47,9,10,19,66.0,80,7.37,76,367,2421,12.2,0.19535372
2757,2757,Brad Jones,1991-92,26.0,6,20,53,53,9,11,20,47.0,,100,18,21,39,113.0,80,6.91,71,366,2385,11.6,0.35124764
2758,2758,Brad Jones,1992-93,27.0,7,17,48,48,7,10,17,67.0,,148,25,31,56,180.0,80,6.96,77,402,2440,11.4,0.32890654
2759,2759,Brad Larsen,1998-99,21.0,2,0,1,1,0,0,0,0.0,,1,0,0,0,0.0,82,5.28,57,380,2242,9.6,0.16920802
2760,2760,Brad Larsen,2001-02,24.0,3,0,9,9,0,0,0,3.0,84.0,10,0,0,0,3.0,82,5.51,63,376,2272,9.9,0.1539199
2761,2761,Brad Larsen,2002-03,25.0,4,9,50,50,2,7,9,38.0,406.0,60,2,7,9,41.0,82,5.24,53,338,2262,9.5,0.15680984
2762,2762,Brad Larsen,2003-04,26.0,5,3,6,6,0,3,3,6.0,50.0,66,2,10,12,47.0,82,5.31,60,363,2326,9.4,0.16233718
2763,2763,Brad Larsen,2004-05,27.0,6,4,32,32,2,2,4,23.0,282.0,98,4,12,16,70.0,82,5.14,57,348,2300,9.2,0.20587513
2764,2764,Brad Larsen,2006-07,29.0,7,15,62,62,7,8,15,48.0,681.0,160,11,20,31,118.0,82,6.05,85,480,2458,10.1,0.1667012
2765,2765,Brad Larsen,2007-08,30.0,8,13,72,72,7,6,13,61.0,891.0,232,18,26,44,179.0,82,5.76,70,398,2426,9.7,0.16548699
2766,2766,Brad Larsen,2008-09,31.0,9,4,62,62,1,3,4,35.0,560.0,294,19,29,48,214.0,82,5.44,62,351,2383,9.4,0.12676835
2767,2767,Brad Lauer,1987-88,21.0,2,21,61,61,7,14,21,75.0,,61,7,14,21,75.0,80,7.34,72,344,2400,12.2,0.40878052
2768,2768,Brad Lauer,1988-89,22.0,3,35,69,69,17,18,35,94.0,,130,24,32,56,169.0,80,7.43,89,437,2435,12.2,0.48920202
2769,2769,Brad Lauer,1989-90,23.0,4,5,14,14,3,2,5,21.0,,144,27,34,61,190.0,80,7.48,85,403,2430,12.3,0.3976732
2770,2770,Brad Lauer,1990-91,24.0,5,24,63,63,6,18,24,86.0,,207,33,52,85,276.0,80,7.37,76,367,2421,12.2,0.3643715
2771,2771,Brad Lauer,1991-92,25.0,6,12,44,44,4,8,12,70.0,,251,37,60,97,346.0,80,6.91,71,366,2385,11.6,0.31413794
2772,2772,Brad Lauer,1992-93,26.0,7,1,14,14,1,0,1,18.0,,265,38,60,98,364.0,80,6.96,77,402,2440,11.4,0.2743621
2773,2773,Brad Lauer,1993-94,27.0,8,1,7,7,0,1,1,8.0,,272,38,61,99,372.0,84,7.25,87,443,2603,11.7,0.23161179
2774,2774,Brad Lauer,1994-95,28.0,9,7,30,30,2,5,7,45.0,,302,40,66,106,417.0,84,6.48,76,407,2545,10.7,0.23943308
2775,2775,Brad Lauer,1996-97,30.0,10,5,21,21,4,1,5,29.0,,323,44,67,111,446.0,82,6.29,74,413,2481,10.4,0.2591554
2776,2776,Brad Leeb,2000-01,21.0,2,0,2,2,0,0,0,3.0,24.0,2,0,0,0,3.0,82,5.49,53,331,2294,9.8,0.1963087
2777,2777,Brad Leeb,2002-03,23.0,3,0,2,2,0,0,0,1.0,19.0,4,0,0,0,4.0,82,5.24,53,338,2262,9.5,0.16578168
2778,2778,Brad Leeb,2004-05,25.0,4,0,1,1,0,0,0,1.0,11.0,5,0,0,0,5.0,82,5.14,57,348,2300,9.2,0.14722762
2779,2779,Brad Lukowich,1998-99,22.0,2,1,4,4,0,1,1,2.0,,4,0,1,1,2.0,82,5.28,57,380,2242,9.6,0.18879038
2780,2780,Brad Lukowich,1999-00,23.0,3,3,14,14,1,2,3,8.0,228.0,18,1,3,4,10.0,82,5.27,57,359,2285,9.4,0.21285644
2781,2781,Brad Lukowich,2000-01,24.0,4,4,60,60,3,1,4,33.0,704.0,78,4,4,8,43.0,82,5.49,53,331,2294,9.8,0.14981037
2782,2782,Brad Lukowich,2001-02,25.0,5,14,80,80,4,10,14,43.0,1184.0,158,8,14,22,86.0,82,5.51,63,376,2272,9.9,0.15966791
2783,2783,Brad Lukowich,2002-03,26.0,6,7,66,66,1,6,7,56.0,873.0,224,9,20,29,142.0,82,5.24,53,338,2262,9.5,0.14591333
2784,2784,Brad Lukowich,2003-04,27.0,7,15,70,70,1,14,15,52.0,1230.0,294,10,34,44,194.0,82,5.31,60,363,2326,9.4,0.15025029
2785,2785,Brad Lukowich,2004-05,28.0,8,19,79,79,5,14,19,86.0,1482.0,373,15,48,63,280.0,82,5.14,57,348,2300,9.2,0.24206558
2786,2786,Brad Lukowich,2006-07,30.0,9,21,75,75,2,19,21,49.0,1443.0,448,17,67,84,329.0,82,6.05,85,480,2458,10.1,0.20884058
2787,2787,Brad Lukowich,2007-08,31.0,10,12,75,75,4,8,12,50.0,1517.0,523,21,75,96,379.0,82,5.76,70,398,2426,9.7,0.15220866
2788,2788,Brad Lukowich,2008-09,32.0,11,7,59,59,1,6,7,28.0,980.0,582,22,81,103,407.0,82,5.44,62,351,2383,9.4,0.11869317
2789,2789,Brad Lukowich,2009-10,33.0,12,8,58,58,0,8,8,43.0,940.0,640,22,89,111,450.0,82,5.7,65,341,2477,9.4,0.13533092
2790,2790,Brad Lukowich,2010-11,34.0,13,2,13,13,1,1,2,1.0,146.0,653,23,90,113,451.0,82,5.53,56,304,2486,9.1,0.12936881
2791,2791,Brad Lukowich,2011-12,35.0,14,0,5,5,0,0,0,3.0,51.0,658,23,90,113,454.0,82,5.46,52,291,2492,9.0,0.10447329
2792,2792,Brad Malone,2012-13,23.0,2,2,9,9,0,2,2,6.0,90.0,9,0,2,2,6.0,82,5.32,47,271,2439,8.9,0.19304419
2793,2793,Brad Malone,2013-14,24.0,3,2,13,13,1,1,2,10.0,114.0,22,1,3,4,16.0,48,5.31,29,160,1399,9.1,0.23058024
2794,2794,Brad Malone,2014-15,25.0,4,5,32,32,3,2,5,16.0,217.0,54,4,5,9,32.0,82,5.34,48,269,2463,8.9,0.17753008
2795,2795,Brad Malone,2015-16,26.0,5,15,65,65,7,8,15,65.0,660.0,119,11,13,24,97.0,82,5.32,47,251,2453,8.9,0.2048999
2796,2796,Brad Malone,2016-17,27.0,6,6,57,57,2,4,6,31.0,544.0,176,13,17,30,128.0,82,5.34,48,255,2438,9.0,0.10532871
2797,2797,Brad Malone,2018-19,29.0,7,0,7,7,0,0,0,9.0,56.0,183,13,17,30,137.0,82,5.86,50,250,2620,9.2,0.14853111
2798,2798,Brad Malone,2019-20,30.0,8,0,16,16,0,0,0,13.0,143.0,199,13,17,30,150.0,82,5.96,47,239,2579,9.5,0.119986564
2799,2799,Brad Marchand,2010-11,22.0,2,1,20,20,0,1,1,32.0,239.0,20,0,1,1,32.0,82,5.53,56,304,2486,9.1,0.19584757
2800,2800,Brad Marchand,2011-12,23.0,3,41,77,77,21,20,41,149.0,1077.0,97,21,21,42,181.0,82,5.46,52,291,2492,9.0,0.52485955
2801,2801,Brad Marchand,2012-13,24.0,4,55,76,76,28,27,55,167.0,1339.0,173,49,48,97,348.0,82,5.32,47,271,2439,8.9,0.68653476
2802,2802,Brad Marchand,2013-14,25.0,5,36,45,45,18,18,36,91.0,763.0,218,67,66,133,439.0,48,5.31,29,160,1399,9.1,0.6543882
2803,2803,Brad Marchand,2014-15,26.0,6,53,82,82,25,28,53,149.0,1308.0,300,92,94,186,588.0,82,5.34,48,269,2463,8.9,0.6383497
2804,2804,Brad Marchand,2015-16,27.0,7,42,77,77,24,18,42,180.0,1301.0,377,116,112,228,768.0,82,5.32,47,251,2453,8.9,0.5635067
2805,2805,Brad Marchand,2016-17,28.0,8,61,77,77,37,24,61,250.0,1432.0,454,153,136,289,1018.0,82,5.34,48,255,2438,9.0,0.7143866
2806,2806,Brad Marchand,2017-18,29.0,9,85,80,80,39,46,85,226.0,1555.0,534,192,182,374,1244.0,82,5.45,47,245,2478,9.0,0.9925964
2807,2807,Brad Marchand,2018-19,30.0,10,85,68,68,34,51,85,182.0,1341.0,602,226,233,459,1426.0,82,5.86,50,250,2620,9.2,1.0750768
2808,2808,Brad Marchand,2019-20,31.0,11,100,79,79,36,64,100,231.0,1550.0,681,262,297,559,1657.0,82,5.96,47,239,2579,9.5,1.0855778
2809,2809,Brad Marchand,2020-21,32.0,12,87,70,70,28,59,87,185.0,1362.0,751,290,356,646,1842.0,70,5.96,42,208,2192,9.5,1.0603662
2810,2810,Brad May,1992-93,21.0,2,17,69,69,11,6,17,82.0,,69,11,6,17,82.0,80,6.96,77,402,2440,11.4,0.35026193
2811,2811,Brad May,1993-94,22.0,3,26,82,82,13,13,26,114.0,,151,24,19,43,196.0,84,7.25,87,443,2603,11.7,0.39544126
2812,2812,Brad May,1994-95,23.0,4,45,84,84,18,27,45,166.0,,235,42,46,88,362.0,84,6.48,76,407,2545,10.7,0.50596386
2813,2813,Brad May,1995-96,24.0,5,6,33,33,3,3,6,42.0,,268,45,49,94,404.0,48,5.97,37,209,1408,10.2,0.38280332
2814,2814,Brad May,1996-97,25.0,6,44,79,79,15,29,44,168.0,,347,60,78,138,572.0,82,6.29,74,413,2481,10.4,0.5112029
2815,2815,Brad May,1997-98,26.0,7,7,42,42,3,4,7,75.0,,389,63,82,145,647.0,82,5.83,55,336,2444,9.8,0.28828603
2816,2816,Brad May,1998-99,27.0,8,23,63,63,13,10,23,97.0,,452,76,92,168,744.0,82,5.28,57,380,2242,9.6,0.36051762
2817,2817,Brad May,1999-00,28.0,9,17,66,66,6,11,17,91.0,862.0,518,82,103,185,835.0,82,5.27,57,359,2285,9.4,0.2927519
2818,2818,Brad May,2000-01,29.0,10,16,59,59,9,7,16,66.0,613.0,577,91,110,201,901.0,82,5.49,53,331,2294,9.8,0.2844339
2819,2819,Brad May,2001-02,30.0,11,25,62,62,11,14,25,83.0,693.0,639,102,124,226,984.0,82,5.51,63,376,2272,9.9,0.31582293
2820,2820,Brad May,2002-03,31.0,12,22,72,72,10,12,22,105.0,869.0,711,112,136,248,1089.0,82,5.24,53,338,2262,9.5,0.29023913
2821,2821,Brad May,2003-04,32.0,13,7,23,23,3,4,7,25.0,222.0,734,115,140,255,1114.0,82,5.31,60,363,2326,9.4,0.2789995
2822,2822,Brad May,2004-05,33.0,14,11,70,70,5,6,11,75.0,625.0,804,120,146,266,1189.0,82,5.14,57,348,2300,9.2,0.2154276
2823,2823,Brad May,2006-07,35.0,15,6,54,54,3,3,6,55.0,453.0,858,123,149,272,1244.0,82,6.05,85,480,2458,10.1,0.13523892
2824,2824,Brad May,2007-08,36.0,16,4,24,24,0,4,4,22.0,236.0,882,123,153,276,1266.0,82,5.76,70,398,2426,9.7,0.15958506
2825,2825,Brad May,2008-09,37.0,17,4,61,61,3,1,4,34.0,404.0,943,126,154,280,1300.0,82,5.44,62,351,2383,9.4,0.14226738
2826,2826,Brad May,2009-10,38.0,18,7,58,58,1,6,7,32.0,421.0,1001,127,160,287,1332.0,82,5.7,65,341,2477,9.4,0.13730535
2827,2827,Brad May,2010-11,39.0,19,1,40,40,0,1,1,26.0,279.0,1041,127,161,288,1358.0,82,5.53,56,304,2486,9.1,0.11261028
2828,2828,Brad McCrimmon,1980-81,21.0,2,16,72,72,5,11,16,89.0,,72,5,11,16,89.0,80,7.03,61,280,2352,12.0,0.32457674
2829,2829,Brad McCrimmon,1981-82,22.0,3,29,78,78,11,18,29,115.0,,150,16,29,45,204.0,80,7.69,77,340,2441,12.6,0.38883254
2830,2830,Brad McCrimmon,1982-83,23.0,4,9,78,78,1,8,9,136.0,,228,17,37,54,340.0,80,8.03,73,320,2489,12.9,0.25463867
2831,2831,Brad McCrimmon,1983-84,24.0,5,25,79,79,4,21,25,107.0,,307,21,58,79,447.0,80,7.73,71,310,2444,12.7,0.32175502
2832,2832,Brad McCrimmon,1984-85,25.0,6,24,71,71,0,24,24,107.0,,378,21,82,103,554.0,80,7.89,74,336,2448,12.9,0.39183748
2833,2833,Brad McCrimmon,1985-86,26.0,7,43,66,66,8,35,43,145.0,,444,29,117,146,699.0,80,7.77,71,321,2447,12.7,0.59275776
2834,2834,Brad McCrimmon,1986-87,27.0,8,56,80,80,13,43,56,167.0,,524,42,160,202,866.0,80,7.94,82,370,2484,12.8,0.5781613
2835,2835,Brad McCrimmon,1987-88,28.0,9,39,71,71,10,29,39,110.0,,595,52,189,241,976.0,80,7.34,72,344,2400,12.2,0.4588649
2836,2836,Brad McCrimmon,1988-89,29.0,10,42,80,80,7,35,42,102.0,,675,59,224,283,1078.0,80,7.43,89,437,2435,12.2,0.42563987
2837,2837,Brad McCrimmon,1989-90,30.0,11,22,72,72,5,17,22,78.0,,747,64,241,305,1156.0,80,7.48,85,403,2430,12.3,0.27931994
2838,2838,Brad McCrimmon,1990-91,31.0,12,19,79,79,4,15,19,97.0,,826,68,256,324,1253.0,80,7.37,76,367,2421,12.2,0.2520501
2839,2839,Brad McCrimmon,1991-92,32.0,13,13,64,64,0,13,13,43.0,,890,68,269,337,1296.0,80,6.91,71,366,2385,11.6,0.19460443
2840,2840,Brad McCrimmon,1992-93,33.0,14,29,79,79,7,22,29,94.0,,969,75,291,366,1390.0,80,6.96,77,402,2440,11.4,0.29530865
2841,2841,Brad McCrimmon,1993-94,34.0,15,15,60,60,1,14,15,53.0,,1029,76,305,381,1443.0,84,7.25,87,443,2603,11.7,0.1913175
2842,2842,Brad McCrimmon,1994-95,35.0,16,6,65,65,1,5,6,39.0,,1094,77,310,387,1482.0,84,6.48,76,407,2545,10.7,0.12919843
2843,2843,Brad McCrimmon,1995-96,36.0,17,1,33,33,0,1,1,13.0,,1127,77,311,388,1495.0,48,5.97,37,209,1408,10.2,0.13312101
2844,2844,Brad McCrimmon,1996-97,37.0,18,9,58,58,3,6,9,39.0,,1185,80,317,397,1534.0,82,6.29,74,413,2481,10.4,0.13187468
2845,2845,Brad McCrimmon,1997-98,38.0,19,6,37,37,1,5,6,28.0,,1222,81,322,403,1562.0,82,5.83,55,336,2444,9.8,0.16075802
2846,2846,Brad Miller,1989-90,20.0,2,0,7,7,0,0,0,0.0,,7,0,0,0,0.0,80,7.48,85,403,2430,12.3,0.22327197
2847,2847,Brad Miller,1990-91,21.0,3,0,1,1,0,0,0,0.0,,8,0,0,0,0.0,80,7.37,76,367,2421,12.2,0.18826756
2848,2848,Brad Miller,1991-92,22.0,4,0,13,13,0,0,0,4.0,,21,0,0,0,4.0,80,6.91,71,366,2385,11.6,0.16420019
2849,2849,Brad Miller,1992-93,23.0,5,5,42,42,1,4,5,30.0,,63,1,4,5,34.0,80,6.96,77,402,2440,11.4,0.14709735
2850,2850,Brad Miller,1993-94,24.0,6,0,11,11,0,0,0,2.0,,74,1,4,5,36.0,84,7.25,87,443,2603,11.7,0.15373978
2851,2851,Brad Miller,1994-95,25.0,7,1,8,8,0,1,1,2.0,,82,1,5,6,38.0,84,6.48,76,407,2545,10.7,0.14633867
2852,2852,Brad Mills,2011-12,28.0,2,1,4,4,1,0,1,6.0,33.0,4,1,0,1,6.0,82,5.46,52,291,2492,9.0,0.20235631
2853,2853,Brad Mills,2012-13,29.0,3,1,27,27,0,1,1,18.0,194.0,31,1,1,2,24.0,82,5.32,47,271,2439,8.9,0.1246461
2854,2854,Brad Mills,2014-15,31.0,4,0,3,3,0,0,0,2.0,31.0,34,1,1,2,26.0,82,5.34,48,269,2463,8.9,0.13324538
2855,2855,Brad Moran,2002-03,23.0,2,0,3,3,0,0,0,2.0,23.0,3,0,0,0,2.0,82,5.24,53,338,2262,9.5,0.17551199
2856,2856,Brad Moran,2004-05,25.0,3,2,2,2,1,1,2,4.0,20.0,5,1,1,2,6.0,82,5.14,57,348,2300,9.2,0.20770827
2857,2857,Brad Moran,2007-08,28.0,4,1,3,3,0,1,1,3.0,38.0,8,1,2,3,9.0,82,5.76,70,398,2426,9.7,0.17426378
2858,2858,Brad Norton,2002-03,27.0,2,2,22,22,0,2,2,6.0,203.0,22,0,2,2,6.0,82,5.24,53,338,2262,9.5,0.11665824
2859,2859,Brad Norton,2003-04,28.0,3,6,53,53,3,3,6,19.0,322.0,75,3,5,8,25.0,82,5.31,60,363,2326,9.4,0.11673769
2860,2860,Brad Norton,2004-05,29.0,4,2,36,36,0,2,2,16.0,377.0,111,3,7,10,41.0,82,5.14,57,348,2300,9.2,0.13245365
2861,2861,Brad Norton,2006-07,31.0,5,0,7,7,0,0,0,3.0,71.0,118,3,7,10,44.0,82,6.05,85,480,2458,10.1,0.11928132
2862,2862,Brad Norton,2007-08,32.0,6,1,6,6,0,1,1,2.0,25.0,124,3,8,11,46.0,82,5.76,70,398,2426,9.7,0.111995935
2863,2863,Brad Palmer,1981-82,20.0,2,8,23,23,4,4,8,59.0,,23,4,4,8,59.0,80,7.69,77,340,2441,12.6,0.46806812
2864,2864,Brad Palmer,1982-83,21.0,3,45,72,72,22,23,45,180.0,,95,26,27,53,239.0,80,8.03,73,320,2489,12.9,0.62768394
2865,2865,Brad Palmer,1983-84,22.0,4,17,73,73,6,11,17,123.0,,168,32,38,70,362.0,80,7.73,71,310,2444,12.7,0.38537616
2866,2866,Brad Ralph,2001-02,21.0,2,0,1,1,0,0,0,0.0,5.0,1,0,0,0,0.0,82,5.51,63,376,2272,9.9,0.17288223
2867,2867,Brad Richards,2001-02,21.0,2,62,82,82,21,41,62,179.0,1386.0,82,21,41,62,179.0,82,5.51,63,376,2272,9.9,0.7659683
2868,2868,Brad Richards,2002-03,22.0,3,62,82,82,20,42,62,251.0,1624.0,164,41,83,124,430.0,82,5.24,53,338,2262,9.5,0.7975781
2869,2869,Brad Richards,2003-04,23.0,4,74,80,80,17,57,74,277.0,1595.0,244,58,140,198,707.0,82,5.31,60,363,2326,9.4,0.9279586
2870,2870,Brad Richards,2004-05,24.0,5,79,82,82,26,53,79,244.0,1675.0,326,84,193,277,951.0,82,5.14,57,348,2300,9.2,1.0396347
2871,2871,Brad Richards,2006-07,26.0,6,91,82,82,23,68,91,282.0,1866.0,408,107,261,368,1233.0,82,6.05,85,480,2458,10.1,1.0321718
2872,2872,Brad Richards,2007-08,27.0,7,70,82,82,25,45,70,272.0,1977.0,490,132,306,438,1505.0,82,5.76,70,398,2426,9.7,0.8615589
2873,2873,Brad Richards,2008-09,28.0,8,62,74,74,20,42,62,249.0,1736.0,564,152,348,500,1754.0,82,5.44,62,351,2383,9.4,0.83430725
2874,2874,Brad Richards,2009-10,29.0,9,48,56,56,16,32,48,180.0,1147.0,620,168,380,548,1934.0,82,5.7,65,341,2477,9.4,0.8732271
2875,2875,Brad Richards,2010-11,30.0,10,91,80,80,24,67,91,284.0,1669.0,700,192,447,639,2218.0,82,5.53,56,304,2486,9.1,1.0374196
2876,2876,Brad Richards,2011-12,31.0,11,77,72,72,28,49,77,272.0,1564.0,772,220,496,716,2490.0,82,5.46,52,291,2492,9.0,0.86725545
2877,2877,Brad Richards,2012-13,32.0,12,66,82,82,25,41,66,229.0,1662.0,854,245,537,782,2719.0,82,5.32,47,271,2439,8.9,0.7652787
2878,2878,Brad Richards,2013-14,33.0,13,34,46,46,11,23,34,110.0,865.0,900,256,560,816,2829.0,48,5.31,29,160,1399,9.1,0.7015631
2879,2879,Brad Richards,2014-15,34.0,14,51,82,82,20,31,51,259.0,1531.0,982,276,591,867,3088.0,82,5.34,48,269,2463,8.9,0.6246527
2880,2880,Brad Richards,2015-16,35.0,15,37,76,76,12,25,37,199.0,1131.0,1058,288,616,904,3287.0,82,5.32,47,251,2453,8.9,0.5231723
2881,2881,Brad Richards,2016-17,36.0,16,28,68,68,10,18,28,164.0,1006.0,1126,298,634,932,3451.0,82,5.34,48,255,2438,9.0,0.40178993
2882,2882,Brad Richardson,2006-07,21.0,2,13,41,41,3,10,13,51.0,440.0,41,3,10,13,51.0,82,6.05,85,480,2458,10.1,0.2994526
2883,2883,Brad Richardson,2007-08,22.0,3,22,73,73,14,8,22,129.0,961.0,114,17,18,35,180.0,82,5.76,70,398,2426,9.7,0.3898367
2884,2884,Brad Richardson,2008-09,23.0,4,5,22,22,2,3,5,32.0,297.0,136,19,21,40,212.0,82,5.44,62,351,2383,9.4,0.31184208
2885,2885,Brad Richardson,2009-10,24.0,5,5,31,31,0,5,5,37.0,335.0,167,19,26,45,249.0,82,5.7,65,341,2477,9.4,0.22287783
2886,2886,Brad Richardson,2010-11,25.0,6,27,81,81,11,16,27,148.0,1041.0,248,30,42,72,397.0,82,5.53,56,304,2486,9.1,0.36075497
2887,2887,Brad Richardson,2011-12,26.0,7,19,68,68,7,12,19,103.0,800.0,316,37,54,91,500.0,82,5.46,52,291,2492,9.0,0.27389893
2888,2888,Brad Richardson,2012-13,27.0,8,8,59,59,5,3,8,98.0,759.0,375,42,57,99,598.0,82,5.32,47,271,2439,8.9,0.21741062
2889,2889,Brad Richardson,2013-14,28.0,9,6,16,16,1,5,6,27.0,174.0,391,43,62,105,625.0,48,5.31,29,160,1399,9.1,0.27859876
2890,2890,Brad Richardson,2014-15,29.0,10,23,73,73,11,12,23,85.0,1088.0,464,54,74,128,710.0,82,5.34,48,269,2463,8.9,0.2681418
2891,2891,Brad Richardson,2015-16,30.0,11,21,45,45,8,13,21,66.0,651.0,509,62,87,149,776.0,82,5.32,47,251,2453,8.9,0.37037766
2892,2892,Brad Richardson,2016-17,31.0,12,31,82,82,11,20,31,117.0,1281.0,591,73,107,180,893.0,82,5.34,48,255,2438,9.0,0.33049065
2893,2893,Brad Richardson,2017-18,32.0,13,9,16,16,5,4,9,25.0,246.0,607,78,111,189,918.0,82,5.45,47,245,2478,9.0,0.2868935
2894,2894,Brad Richardson,2018-19,33.0,14,15,76,76,3,12,15,105.0,1122.0,683,81,123,204,1023.0,82,5.86,50,250,2620,9.2,0.21520883
2895,2895,Brad Richardson,2019-20,34.0,15,27,66,66,19,8,27,128.0,1054.0,749,100,131,231,1151.0,82,5.96,47,239,2579,9.5,0.28118533
2896,2896,Brad Richardson,2020-21,35.0,16,11,59,59,6,5,11,76.0,805.0,808,106,136,242,1227.0,70,5.96,42,208,2192,9.5,0.21780103
2897,2897,Brad Schlegel,1992-93,24.0,2,1,15,15,0,1,1,7.0,,15,0,1,1,7.0,80,6.96,77,402,2440,11.4,0.21694094
2898,2898,Brad Schlegel,1993-94,25.0,3,1,7,7,0,1,1,8.0,,22,0,2,2,15.0,84,7.25,87,443,2603,11.7,0.18724713
2899,2899,Brad Schlegel,1994-95,26.0,4,7,26,26,1,6,7,24.0,,48,1,8,9,39.0,84,6.48,76,407,2545,10.7,0.18912628
2900,2900,Brad Shaw,1986-87,22.0,2,2,8,8,0,2,2,17.0,,8,0,2,2,17.0,80,7.94,82,370,2484,12.8,0.24346754
2901,2901,Brad Shaw,1987-88,23.0,3,0,2,2,0,0,0,2.0,,10,0,2,2,19.0,80,7.34,72,344,2400,12.2,0.20589256
2902,2902,Brad Shaw,1988-89,24.0,4,0,1,1,0,0,0,1.0,,11,0,2,2,20.0,80,7.43,89,437,2435,12.2,0.19812593
2903,2903,Brad Shaw,1989-90,25.0,5,1,3,3,1,0,1,2.0,,14,1,2,3,22.0,80,7.48,85,403,2430,12.3,0.2189193
2904,2904,Brad Shaw,1990-91,26.0,6,35,64,64,3,32,35,65.0,,78,4,34,38,87.0,80,7.37,76,367,2421,12.2,0.40100288
2905,2905,Brad Shaw,1991-92,27.0,7,32,72,72,4,28,32,129.0,,150,8,62,70,216.0,80,6.91,71,366,2385,11.6,0.41905007
2906,2906,Brad Shaw,1992-93,28.0,8,25,62,62,3,22,25,100.0,,212,11,84,95,316.0,80,6.96,77,402,2440,11.4,0.3568024
2907,2907,Brad Shaw,1993-94,29.0,9,41,81,81,7,34,41,166.0,,293,18,118,136,482.0,84,7.25,87,443,2603,11.7,0.46681315
2908,2908,Brad Shaw,1994-95,30.0,10,23,66,66,4,19,23,113.0,,359,22,137,159,595.0,84,6.48,76,407,2545,10.7,0.2902953
2909,2909,Brad Shaw,1995-96,31.0,11,0,2,2,0,0,0,3.0,,361,22,137,159,598.0,48,5.97,37,209,1408,10.2,0.19940844
2910,2910,Brad Shaw,1999-00,35.0,12,0,16,16,0,0,0,15.0,220.0,377,22,137,159,613.0,82,5.27,57,359,2285,9.4,0.2010032
2911,2911,Brad Smyth,1996-97,23.0,2,2,7,7,1,1,2,12.0,,7,1,1,2,12.0,82,6.29,74,413,2481,10.4,0.24834728
2912,2912,Brad Smyth,1997-98,24.0,3,17,52,52,9,8,17,84.0,,59,10,9,19,96.0,82,5.83,55,336,2444,9.8,0.349529
2913,2913,Brad Smyth,1998-99,25.0,4,4,10,10,1,3,4,13.0,,69,11,12,23,109.0,82,5.28,57,380,2242,9.6,0.23683187
2914,2914,Brad Smyth,1999-00,26.0,5,0,3,3,0,0,0,5.0,30.0,72,11,12,23,114.0,82,5.27,57,359,2285,9.4,0.18331155
2915,2915,Brad Smyth,2001-02,28.0,6,1,4,4,1,0,1,10.0,56.0,76,12,12,24,124.0,82,5.51,63,376,2272,9.9,0.20046806
2916,2916,Brad Smyth,2003-04,30.0,7,4,12,12,3,1,4,16.0,114.0,88,15,13,28,140.0,82,5.31,60,363,2326,9.4,0.25512427
2917,2917,Brad Staubitz,2009-10,25.0,2,3,35,35,1,2,3,22.0,218.0,35,1,2,3,22.0,82,5.7,65,341,2477,9.4,0.17421943
2918,2918,Brad Staubitz,2010-11,26.0,3,6,47,47,3,3,6,24.0,292.0,82,4,5,9,46.0,82,5.53,56,304,2486,9.1,0.13653591
2919,2919,Brad Staubitz,2011-12,27.0,4,9,71,71,4,5,9,29.0,463.0,153,8,10,18,75.0,82,5.46,52,291,2492,9.0,0.10215697
2920,2920,Brad Staubitz,2012-13,28.0,5,1,62,62,1,0,1,27.0,404.0,215,9,10,19,102.0,82,5.32,47,271,2439,8.9,0.09395519
2921,2921,Brad Staubitz,2013-14,29.0,6,2,15,15,1,1,2,5.0,93.0,230,10,11,21,107.0,48,5.31,29,160,1399,9.1,0.16183516
2922,2922,Brad Stuart,2000-01,21.0,2,36,82,82,10,26,36,133.0,1673.0,82,10,26,36,133.0,82,5.49,53,331,2294,9.8,0.47077063
2923,2923,Brad Stuart,2001-02,22.0,3,23,77,77,5,18,23,119.0,1547.0,159,15,44,59,252.0,82,5.51,63,376,2272,9.9,0.31962174
2924,2924,Brad Stuart,2002-03,23.0,4,29,82,82,6,23,29,96.0,1778.0,241,21,67,88,348.0,82,5.24,53,338,2262,9.5,0.40617892
2925,2925,Brad Stuart,2003-04,24.0,5,14,36,36,4,10,14,63.0,752.0,277,25,77,102,411.0,82,5.31,60,363,2326,9.4,0.3316629
2926,2926,Brad Stuart,2004-05,25.0,6,39,77,77,9,30,39,129.0,1705.0,354,34,107,141,540.0,82,5.14,57,348,2300,9.2,0.5822971
2927,2927,Brad Stuart,2006-07,27.0,7,43,78,78,12,31,43,163.0,1947.0,432,46,138,184,703.0,82,6.05,85,480,2458,10.1,0.47571635
2928,2928,Brad Stuart,2007-08,28.0,8,22,75,75,7,15,22,109.0,1716.0,507,53,153,206,812.0,82,5.76,70,398,2426,9.7,0.33040547
2929,2929,Brad Stuart,2008-09,29.0,9,23,72,72,6,17,23,132.0,1523.0,579,59,170,229,944.0,82,5.44,62,351,2383,9.4,0.34073395
2930,2930,Brad Stuart,2009-10,30.0,10,15,67,67,2,13,15,105.0,1355.0,646,61,183,244,1049.0,82,5.7,65,341,2477,9.4,0.26536006
2931,2931,Brad Stuart,2010-11,31.0,11,20,82,82,4,16,20,153.0,1900.0,728,65,199,264,1202.0,82,5.53,56,304,2486,9.1,0.2852465
2932,2932,Brad Stuart,2011-12,32.0,12,20,67,67,3,17,20,81.0,1442.0,795,68,216,284,1283.0,82,5.46,52,291,2492,9.0,0.25794038
2933,2933,Brad Stuart,2012-13,33.0,13,21,81,81,6,15,21,96.0,1705.0,876,74,231,305,1379.0,82,5.32,47,271,2439,8.9,0.26695758
2934,2934,Brad Stuart,2013-14,34.0,14,6,48,48,0,6,6,39.0,982.0,924,74,237,311,1418.0,48,5.31,29,160,1399,9.1,0.17702651
2935,2935,Brad Stuart,2014-15,35.0,15,11,61,61,3,8,11,64.0,1169.0,985,77,245,322,1482.0,82,5.34,48,269,2463,8.9,0.1614267
2936,2936,Brad Stuart,2015-16,36.0,16,13,65,65,3,10,13,64.0,1323.0,1050,80,255,335,1546.0,82,5.32,47,251,2453,8.9,0.15203592
2937,2937,Brad Stuart,2016-17,37.0,17,0,6,6,0,0,0,0.0,84.0,1056,80,255,335,1546.0,82,5.34,48,255,2438,9.0,0.22169966
2938,2938,Brad Tapper,2001-02,23.0,2,5,16,16,2,3,5,21.0,204.0,16,2,3,5,21.0,82,5.51,63,376,2272,9.9,0.2535463
2939,2939,Brad Tapper,2002-03,24.0,3,6,20,20,2,4,6,34.0,267.0,36,4,7,11,55.0,82,5.24,53,338,2262,9.5,0.23595253
2940,2940,Brad Tapper,2003-04,25.0,4,14,35,35,10,4,14,68.0,457.0,71,14,11,25,123.0,82,5.31,60,363,2326,9.4,0.3171852
2941,2941,Brad Tiley,1998-99,27.0,2,0,1,1,0,0,0,0.0,,1,0,0,0,0.0,82,5.28,57,380,2242,9.6,0.14665735
2942,2942,Brad Tiley,1999-00,28.0,3,0,8,8,0,0,0,1.0,92.0,9,0,0,0,1.0,82,5.27,57,359,2285,9.4,0.14003831
2943,2943,Brad Tiley,2001-02,30.0,4,0,2,2,0,0,0,1.0,32.0,11,0,0,0,2.0,82,5.51,63,376,2272,9.9,0.12845421
2944,2944,Brad Turner,1992-93,24.0,2,0,3,3,0,0,0,1.0,,3,0,0,0,1.0,80,6.96,77,402,2440,11.4,0.20740378
2945,2945,Brad Werenka,1993-94,24.0,2,9,27,27,5,4,9,38.0,,27,5,4,9,38.0,84,7.25,87,443,2603,11.7,0.30267996
2946,2946,Brad Werenka,1994-95,25.0,3,11,26,26,0,11,11,28.0,,53,5,15,20,66.0,84,6.48,76,407,2545,10.7,0.20359734
2947,2947,Brad Werenka,1996-97,27.0,4,0,9,9,0,0,0,2.0,,62,5,15,20,68.0,82,6.29,74,413,2481,10.4,0.14201605
2948,2948,Brad Werenka,1998-99,29.0,5,18,71,71,3,15,18,50.0,,133,8,30,38,118.0,82,5.28,57,380,2242,9.6,0.20850551
2949,2949,Brad Werenka,1999-00,30.0,6,24,81,81,6,18,24,77.0,1717.0,214,14,48,62,195.0,82,5.27,57,359,2285,9.4,0.26269597
2950,2950,Brad Werenka,2000-01,31.0,7,13,73,73,4,9,13,62.0,1396.0,287,18,57,75,257.0,82,5.49,53,331,2294,9.8,0.16253287
2951,2951,Brad Werenka,2001-02,32.0,8,5,33,33,1,4,5,23.0,595.0,320,19,61,80,280.0,82,5.51,63,376,2272,9.9,0.16913006
2952,2952,Brad Winchester,2006-07,25.0,2,1,19,19,0,1,1,19.0,116.0,19,0,1,1,19.0,82,6.05,85,480,2458,10.1,0.14021209
2953,2953,Brad Winchester,2007-08,26.0,3,9,59,59,4,5,9,66.0,476.0,78,4,6,10,85.0,82,5.76,70,398,2426,9.7,0.18476161
2954,2954,Brad Winchester,2008-09,27.0,4,3,41,41,1,2,3,36.0,310.0,119,5,8,13,121.0,82,5.44,62,351,2383,9.4,0.1463578
2955,2955,Brad Winchester,2009-10,28.0,5,21,64,64,13,8,21,82.0,778.0,183,18,16,34,203.0,82,5.7,65,341,2477,9.4,0.28256017
2956,2956,Brad Winchester,2010-11,29.0,6,8,64,64,3,5,8,69.0,580.0,247,21,21,42,272.0,82,5.53,56,304,2486,9.1,0.17135525
2957,2957,Brad Winchester,2011-12,30.0,7,16,76,76,10,6,16,90.0,797.0,323,31,27,58,362.0,82,5.46,52,291,2492,9.0,0.20104119
2958,2958,Brad Winchester,2012-13,31.0,8,10,67,67,6,4,10,72.0,523.0,390,37,31,68,434.0,82,5.32,47,271,2439,8.9,0.16923541
2959,2959,Brad Zavisha,1994-95,23.0,2,0,2,2,0,0,0,1.0,,2,0,0,0,1.0,84,6.48,76,407,2545,10.7,0.17551246
2960,2960,Brady Austin,2017-18,24.0,2,0,5,5,0,0,0,8.0,80.0,5,0,0,0,8.0,82,5.45,47,245,2478,9.0,0.17442444
2961,2961,Brady Keeper,2019-20,23.0,2,0,1,1,0,0,0,1.0,13.0,1,0,0,0,1.0,82,5.96,47,239,2579,9.5,0.18259898
2962,2962,Brady Murray,2008-09,24.0,2,1,4,4,1,0,1,2.0,45.0,4,1,0,1,2.0,82,5.44,62,351,2383,9.4,0.21145505
2963,2963,Brady Skjei,2016-17,22.0,2,0,7,7,0,0,0,6.0,124.0,7,0,0,0,6.0,82,5.34,48,255,2438,9.0,0.17757523
2964,2964,Brady Skjei,2017-18,23.0,3,39,80,80,5,34,39,127.0,1397.0,87,5,34,39,133.0,82,5.45,47,245,2478,9.0,0.475736
2965,2965,Brady Skjei,2018-19,24.0,4,25,82,82,4,21,25,153.0,1724.0,169,9,55,64,286.0,82,5.86,50,250,2620,9.2,0.33116135
2966,2966,Brady Skjei,2019-20,25.0,5,25,78,78,8,17,25,126.0,1656.0,247,17,72,89,412.0,82,5.96,47,239,2579,9.5,0.31910032
2967,2967,Brady Skjei,2020-21,26.0,6,24,67,67,8,16,24,139.0,1386.0,314,25,88,113,551.0,70,5.96,42,208,2192,9.5,0.42031896
2968,2968,Brady Tkachuk,2019-20,20.0,2,45,71,71,22,23,45,214.0,1138.0,71,22,23,45,214.0,82,5.96,47,239,2579,9.5,0.7138848
2969,2969,Brady Tkachuk,2020-21,21.0,3,44,71,71,21,23,44,259.0,1344.0,142,43,46,89,473.0,70,5.96,42,208,2192,9.5,0.7054727
2970,2970,Brandon Bochenski,2006-07,24.0,2,17,40,40,8,9,17,62.0,423.0,40,8,9,17,62.0,82,6.05,85,480,2458,10.1,0.36179632
2971,2971,Brandon Bochenski,2007-08,25.0,3,24,41,41,13,11,24,92.0,564.0,81,21,20,41,154.0,82,5.76,70,398,2426,9.7,0.48003972
2972,2972,Brandon Bochenski,2008-09,26.0,4,13,40,40,3,10,13,56.0,478.0,121,24,30,54,210.0,82,5.44,62,351,2383,9.4,0.2833972
2973,2973,Brandon Bochenski,2009-10,27.0,5,1,7,7,0,1,1,11.0,76.0,128,24,31,55,221.0,82,5.7,65,341,2477,9.4,0.22623938
2974,2974,Brandon Bochenski,2010-11,28.0,6,13,28,28,4,9,13,43.0,344.0,156,28,40,68,264.0,82,5.53,56,304,2486,9.1,0.27332753
2975,2975,Brandon Bollig,2012-13,26.0,2,0,18,18,0,0,0,16.0,106.0,18,0,0,0,16.0,82,5.32,47,271,2439,8.9,0.1589047
2976,2976,Brandon Bollig,2013-14,27.0,3,0,25,25,0,0,0,34.0,200.0,43,0,0,0,50.0,48,5.31,29,160,1399,9.1,0.15147394
2977,2977,Brandon Bollig,2014-15,28.0,4,14,82,82,7,7,14,109.0,843.0,125,7,7,14,159.0,82,5.34,48,269,2463,8.9,0.19325528
2978,2978,Brandon Bollig,2015-16,29.0,5,5,62,62,1,4,5,67.0,533.0,187,8,11,19,226.0,82,5.32,47,251,2453,8.9,0.12787959
2979,2979,Brandon Bollig,2016-17,30.0,6,4,54,54,2,2,4,56.0,502.0,241,10,13,23,282.0,82,5.34,48,255,2438,9.0,0.13046613
2980,2980,Brandon Carlo,2017-18,21.0,2,16,82,82,6,10,16,88.0,1707.0,82,6,10,16,88.0,82,5.45,47,245,2478,9.0,0.30930245
2981,2981,Brandon Carlo,2018-19,22.0,3,6,76,76,0,6,6,76.0,1462.0,158,6,16,22,164.0,82,5.86,50,250,2620,9.2,0.2048305
2982,2982,Brandon Carlo,2019-20,23.0,4,10,72,72,2,8,10,116.0,1506.0,230,8,24,32,280.0,82,5.96,47,239,2579,9.5,0.23875496
2983,2983,Brandon Carlo,2020-21,24.0,5,19,67,67,4,15,19,111.0,1372.0,297,12,39,51,391.0,70,5.96,42,208,2192,9.5,0.28843337
2984,2984,Brandon Convery,1996-97,22.0,2,7,11,11,5,2,7,16.0,,11,5,2,7,16.0,82,6.29,74,413,2481,10.4,0.3394081
2985,2985,Brandon Convery,1997-98,23.0,3,10,39,39,2,8,10,41.0,,50,7,10,17,57.0,82,5.83,55,336,2444,9.8,0.25276494
2986,2986,Brandon Convery,1998-99,24.0,4,2,7,7,0,2,2,2.0,,57,7,12,19,59.0,82,5.28,57,380,2242,9.6,0.19327033
2987,2987,Brandon Convery,1999-00,25.0,5,9,15,15,2,7,9,14.0,156.0,72,9,19,28,73.0,82,5.27,57,359,2285,9.4,0.2678368
2988,2988,Brandon Davidson,2015-16,24.0,2,1,12,12,1,0,1,7.0,182.0,12,1,0,1,7.0,82,5.32,47,251,2453,8.9,0.1887821
2989,2989,Brandon Davidson,2016-17,25.0,3,11,51,51,4,7,11,63.0,979.0,63,5,7,12,70.0,82,5.34,48,255,2438,9.0,0.19147274
2990,2990,Brandon Davidson,2017-18,26.0,4,3,38,38,0,3,3,42.0,597.0,101,5,10,15,112.0,82,5.45,47,245,2478,9.0,0.15968329
2991,2991,Brandon Davidson,2018-19,27.0,5,7,51,51,4,3,7,63.0,858.0,152,9,13,22,175.0,82,5.86,50,250,2620,9.2,0.15072465
2992,2992,Brandon Davidson,2019-20,28.0,6,1,10,10,0,1,1,7.0,138.0,162,9,14,23,182.0,82,5.96,47,239,2579,9.5,0.12955669
2993,2993,Brandon Davidson,2020-21,29.0,7,0,12,12,0,0,0,17.0,150.0,174,9,14,23,199.0,70,5.96,42,208,2192,9.5,0.1444245
2994,2994,Brandon DeFazio,2015-16,27.0,2,0,2,2,0,0,0,2.0,12.0,2,0,0,0,2.0,82,5.32,47,251,2453,8.9,0.15570766
2995,2995,Brandon Dubinsky,2007-08,21.0,2,0,6,6,0,0,0,9.0,49.0,6,0,0,0,9.0,82,5.76,70,398,2426,9.7,0.22285578
2996,2996,Brandon Dubinsky,2008-09,22.0,3,40,82,82,14,26,40,157.0,1189.0,88,14,26,40,166.0,82,5.44,62,351,2383,9.4,0.53503674
2997,2997,Brandon Dubinsky,2009-10,23.0,4,41,82,82,13,28,41,188.0,1364.0,170,27,54,81,354.0,82,5.7,65,341,2477,9.4,0.54356897
2998,2998,Brandon Dubinsky,2010-11,24.0,5,44,69,69,20,24,44,165.0,1349.0,239,47,78,125,519.0,82,5.53,56,304,2486,9.1,0.6256729
2999,2999,Brandon Dubinsky,2011-12,25.0,6,54,77,77,24,30,54,202.0,1557.0,316,71,108,179,721.0,82,5.46,52,291,2492,9.0,0.67573434
3000,3000,Brandon Dubinsky,2012-13,26.0,7,34,77,77,10,24,34,140.0,1253.0,393,81,132,213,861.0,82,5.32,47,271,2439,8.9,0.47276694
3001,3001,Brandon Dubinsky,2013-14,27.0,8,20,29,29,2,18,20,50.0,534.0,422,83,150,233,911.0,48,5.31,29,160,1399,9.1,0.6035652
3002,3002,Brandon Dubinsky,2014-15,28.0,9,50,76,76,16,34,50,189.0,1427.0,498,99,184,283,1100.0,82,5.34,48,269,2463,8.9,0.6307747
3003,3003,Brandon Dubinsky,2015-16,29.0,10,36,47,47,13,23,36,100.0,849.0,545,112,207,319,1200.0,82,5.32,47,251,2453,8.9,0.6051855
3004,3004,Brandon Dubinsky,2016-17,30.0,11,48,75,75,17,31,48,158.0,1407.0,620,129,238,367,1358.0,82,5.34,48,255,2438,9.0,0.5721208
3005,3005,Brandon Dubinsky,2017-18,31.0,12,41,80,80,12,29,41,115.0,1432.0,700,141,267,408,1473.0,82,5.45,47,245,2478,9.0,0.46211076
3006,3006,Brandon Dubinsky,2018-19,32.0,13,16,62,62,6,10,16,89.0,951.0,762,147,277,424,1562.0,82,5.86,50,250,2620,9.2,0.2822031
3007,3007,Brandon Dubinsky,2019-20,33.0,14,14,61,61,6,8,14,63.0,754.0,823,153,285,438,1625.0,82,5.96,47,239,2579,9.5,0.22699565
3008,3008,Brandon Gignac,2019-20,22.0,2,0,1,1,0,0,0,1.0,9.0,1,0,0,0,1.0,82,5.96,47,239,2579,9.5,0.18239564
3009,3009,Brandon Gormley,2014-15,22.0,2,0,5,5,0,0,0,4.0,73.0,5,0,0,0,4.0,82,5.34,48,269,2463,8.9,0.18369669
3010,3010,Brandon Gormley,2015-16,23.0,3,4,27,27,2,2,4,39.0,414.0,32,2,2,4,43.0,82,5.32,47,251,2453,8.9,0.2346803
3011,3011,Brandon Gormley,2016-17,24.0,4,1,26,26,0,1,1,11.0,317.0,58,2,3,5,54.0,82,5.34,48,255,2438,9.0,0.11237845
3012,3012,Brandon Hagel,2020-21,22.0,2,0,1,1,0,0,0,4.0,12.0,1,0,0,0,4.0,70,5.96,42,208,2192,9.5,0.20590216
3013,3013,Brandon Kozun,2015-16,25.0,2,4,20,20,2,2,4,8.0,158.0,20,2,2,4,8.0,82,5.32,47,251,2453,8.9,0.16253936
3014,3014,Brandon Manning,2012-13,22.0,2,0,4,4,0,0,0,6.0,55.0,4,0,0,0,6.0,82,5.32,47,271,2439,8.9,0.18205357
3015,3015,Brandon Manning,2013-14,23.0,3,2,6,6,0,2,2,5.0,89.0,10,0,2,2,11.0,48,5.31,29,160,1399,9.1,0.22490093
3016,3016,Brandon Manning,2015-16,25.0,4,3,11,11,0,3,3,10.0,189.0,21,0,5,5,21.0,82,5.32,47,251,2453,8.9,0.18020439
3017,3017,Brandon Manning,2016-17,26.0,5,7,56,56,1,6,7,67.0,926.0,77,1,11,12,88.0,82,5.34,48,255,2438,9.0,0.16044754
3018,3018,Brandon Manning,2017-18,27.0,6,12,65,65,3,9,12,84.0,1174.0,142,4,20,24,172.0,82,5.45,47,245,2478,9.0,0.17644727
3019,3019,Brandon Manning,2018-19,28.0,7,19,65,65,7,12,19,111.0,1167.0,207,11,32,43,283.0,82,5.86,50,250,2620,9.2,0.2484262
3020,3020,Brandon Manning,2019-20,29.0,8,4,39,39,2,2,4,33.0,579.0,246,13,34,47,316.0,82,5.96,47,239,2579,9.5,0.15508503
3021,3021,Brandon Manning,2020-21,30.0,9,1,9,9,1,0,1,8.0,99.0,255,14,34,48,324.0,70,5.96,42,208,2192,9.5,0.18961781
3022,3022,Brandon Mashinter,2011-12,23.0,2,0,13,13,0,0,0,5.0,83.0,13,0,0,0,5.0,82,5.46,52,291,2492,9.0,0.16284797
3023,3023,Brandon Mashinter,2013-14,25.0,3,0,4,4,0,0,0,2.0,24.0,17,0,0,0,7.0,48,5.31,29,160,1399,9.1,0.17462355
3024,3024,Brandon Mashinter,2014-15,26.0,4,0,6,6,0,0,0,3.0,27.0,23,0,0,0,10.0,82,5.34,48,269,2463,8.9,0.15140897
3025,3025,Brandon Mashinter,2016-17,28.0,5,5,41,41,4,1,5,25.0,307.0,64,4,1,5,35.0,82,5.34,48,255,2438,9.0,0.118249446
3026,3026,Brandon McMillan,2011-12,21.0,2,21,60,60,11,10,21,77.0,844.0,60,11,10,21,77.0,82,5.46,52,291,2492,9.0,0.36570543
3027,3027,Brandon McMillan,2012-13,22.0,3,4,25,25,0,4,4,26.0,280.0,85,11,14,25,103.0,82,5.32,47,271,2439,8.9,0.27623713
3028,3028,Brandon McMillan,2013-14,23.0,4,1,6,6,0,1,1,2.0,52.0,91,11,15,26,105.0,48,5.31,29,160,1399,9.1,0.25964472
3029,3029,Brandon McMillan,2014-15,24.0,5,6,22,22,2,4,6,35.0,277.0,113,13,19,32,140.0,82,5.34,48,269,2463,8.9,0.25471735
3030,3030,Brandon McMillan,2015-16,25.0,6,4,58,58,1,3,4,51.0,607.0,171,14,22,36,191.0,82,5.32,47,251,2453,8.9,0.1547268
3031,3031,Brandon Montour,2017-18,23.0,2,6,27,27,2,4,6,50.0,469.0,27,2,4,6,50.0,82,5.45,47,245,2478,9.0,0.26421496
3032,3032,Brandon Montour,2018-19,24.0,3,32,80,80,9,23,32,160.0,1638.0,107,11,27,38,210.0,82,5.86,50,250,2620,9.2,0.4295108
3033,3033,Brandon Montour,2019-20,25.0,4,35,82,82,8,27,35,181.0,1841.0,189,19,54,73,391.0,82,5.96,47,239,2579,9.5,0.45733148
3034,3034,Brandon Montour,2020-21,26.0,5,18,54,54,5,13,18,86.0,1053.0,243,24,67,91,477.0,70,5.96,42,208,2192,9.5,0.38820663
3035,3035,Brandon Nolan,2008-09,25.0,2,1,6,6,0,1,1,2.0,44.0,6,0,1,1,2.0,82,5.44,62,351,2383,9.4,0.17677543
3036,3036,Brandon Pirri,2011-12,20.0,2,0,1,1,0,0,0,1.0,9.0,1,0,0,0,1.0,82,5.46,52,291,2492,9.0,0.2507365
3037,3037,Brandon Pirri,2012-13,21.0,3,2,5,5,0,2,2,5.0,68.0,6,0,2,2,6.0,82,5.32,47,271,2439,8.9,0.25718784
3038,3038,Brandon Pirri,2013-14,22.0,4,0,1,1,0,0,0,2.0,18.0,7,0,2,2,8.0,48,5.31,29,160,1399,9.1,0.20220476
3039,3039,Brandon Pirri,2014-15,23.0,5,25,49,49,13,12,25,80.0,636.0,56,13,14,27,88.0,82,5.34,48,269,2463,8.9,0.4524462
3040,3040,Brandon Pirri,2015-16,24.0,6,24,49,49,22,2,24,143.0,724.0,105,35,16,51,231.0,82,5.32,47,251,2453,8.9,0.50549024
3041,3041,Brandon Pirri,2016-17,25.0,7,29,61,61,14,15,29,128.0,886.0,166,49,31,80,359.0,82,5.34,48,255,2438,9.0,0.40232146
3042,3042,Brandon Pirri,2017-18,26.0,8,18,60,60,8,10,18,96.0,737.0,226,57,41,98,455.0,82,5.45,47,245,2478,9.0,0.3689651
3043,3043,Brandon Pirri,2018-19,27.0,9,3,2,2,3,0,3,11.0,35.0,228,60,41,101,466.0,82,5.86,50,250,2620,9.2,0.42936492
3044,3044,Brandon Pirri,2019-20,28.0,10,18,31,31,12,6,18,82.0,448.0,259,72,47,119,548.0,82,5.96,47,239,2579,9.5,0.4520555
3045,3045,Brandon Pirri,2020-21,29.0,11,2,16,16,0,2,2,24.0,201.0,275,72,49,121,572.0,70,5.96,42,208,2192,9.5,0.33641157
3046,3046,Brandon Prust,2007-08,23.0,2,0,10,10,0,0,0,1.0,61.0,10,0,0,0,1.0,82,5.76,70,398,2426,9.7,0.15544084
3047,3047,Brandon Prust,2009-10,25.0,3,3,36,36,1,2,3,23.0,269.0,46,1,2,3,24.0,82,5.7,65,341,2477,9.4,0.15442681
3048,3048,Brandon Prust,2010-11,26.0,4,14,69,69,5,9,14,44.0,524.0,115,6,11,17,68.0,82,5.53,56,304,2486,9.1,0.18858996
3049,3049,Brandon Prust,2011-12,27.0,5,29,82,82,13,16,29,87.0,1133.0,197,19,27,46,155.0,82,5.46,52,291,2492,9.0,0.31215313
3050,3050,Brandon Prust,2012-13,28.0,6,17,82,82,5,12,17,68.0,979.0,279,24,39,63,223.0,82,5.32,47,271,2439,8.9,0.19656223
3051,3051,Brandon Prust,2013-14,29.0,7,14,38,38,5,9,14,39.0,518.0,317,29,48,77,262.0,48,5.31,29,160,1399,9.1,0.27965164
3052,3052,Brandon Prust,2014-15,30.0,8,13,52,52,6,7,13,49.0,667.0,369,35,55,90,311.0,82,5.34,48,269,2463,8.9,0.21499172
3053,3053,Brandon Prust,2015-16,31.0,9,18,82,82,4,14,18,78.0,1063.0,451,39,69,108,389.0,82,5.32,47,251,2453,8.9,0.22519475
3054,3054,Brandon Prust,2016-17,32.0,10,7,35,35,1,6,7,19.0,447.0,486,40,75,115,408.0,82,5.34,48,255,2438,9.0,0.16968635
3055,3055,Brandon Reid,2003-04,22.0,2,5,7,7,2,3,5,15.0,69.0,7,2,3,5,15.0,82,5.31,60,363,2326,9.4,0.2795121
3056,3056,Brandon Reid,2004-05,23.0,3,1,3,3,0,1,1,2.0,28.0,10,2,4,6,17.0,82,5.14,57,348,2300,9.2,0.2766726
3057,3057,Brandon Reid,2007-08,26.0,4,0,3,3,0,0,0,8.0,35.0,13,2,4,6,25.0,82,5.76,70,398,2426,9.7,0.16611376
3058,3058,Brandon Saad,2012-13,20.0,2,0,2,2,0,0,0,3.0,28.0,2,0,0,0,3.0,82,5.32,47,271,2439,8.9,0.25967795
3059,3059,Brandon Saad,2013-14,21.0,3,27,46,46,10,17,27,98.0,757.0,48,10,17,27,101.0,48,5.31,29,160,1399,9.1,0.53299576
3060,3060,Brandon Saad,2014-15,22.0,4,47,78,78,19,28,47,159.0,1271.0,126,29,45,74,260.0,82,5.34,48,269,2463,8.9,0.62503105
3061,3061,Brandon Saad,2015-16,23.0,5,52,82,82,23,29,52,203.0,1415.0,208,52,74,126,463.0,82,5.32,47,251,2453,8.9,0.65081704
3062,3062,Brandon Saad,2016-17,24.0,6,53,78,78,31,22,53,233.0,1343.0,286,83,96,179,696.0,82,5.34,48,255,2438,9.0,0.69871205
3063,3063,Brandon Saad,2017-18,25.0,7,53,82,82,24,29,53,210.0,1396.0,368,107,125,232,906.0,82,5.45,47,245,2478,9.0,0.68298376
3064,3064,Brandon Saad,2018-19,26.0,8,35,82,82,18,17,35,237.0,1435.0,450,125,142,267,1143.0,82,5.86,50,250,2620,9.2,0.53152037
3065,3065,Brandon Saad,2019-20,27.0,9,47,80,80,23,24,47,195.0,1415.0,530,148,166,314,1338.0,82,5.96,47,239,2579,9.5,0.63021344
3066,3066,Brandon Saad,2020-21,28.0,10,33,58,58,21,12,33,140.0,971.0,588,169,178,347,1478.0,70,5.96,42,208,2192,9.5,0.5947104
3067,3067,Brandon Segal,2009-10,26.0,2,0,2,2,0,0,0,2.0,28.0,2,0,0,0,2.0,82,5.7,65,341,2477,9.4,0.17807806
3068,3068,Brandon Segal,2010-11,27.0,3,12,44,44,6,6,12,55.0,385.0,46,6,6,12,57.0,82,5.53,56,304,2486,9.1,0.21885958
3069,3069,Brandon Segal,2011-12,28.0,4,10,46,46,5,5,10,40.0,381.0,92,11,11,22,97.0,82,5.46,52,291,2492,9.0,0.1943669
3070,3070,Brandon Segal,2012-13,29.0,5,0,10,10,0,0,0,8.0,66.0,102,11,11,22,105.0,82,5.32,47,271,2439,8.9,0.14860561
3071,3071,Brandon Segal,2013-14,30.0,6,0,1,1,0,0,0,0.0,5.0,103,11,11,22,105.0,48,5.31,29,160,1399,9.1,0.16621652
3072,3072,Brandon Smith,1999-00,26.0,2,0,5,5,0,0,0,2.0,48.0,5,0,0,0,2.0,82,5.27,57,359,2285,9.4,0.16484177
3073,3073,Brandon Smith,2000-01,27.0,3,6,22,22,2,4,6,24.0,429.0,27,2,4,6,26.0,82,5.49,53,331,2294,9.8,0.20501637
3074,3074,Brandon Smith,2001-02,28.0,4,1,3,3,1,0,1,2.0,20.0,30,3,4,7,28.0,82,5.51,63,376,2272,9.9,0.15808356
3075,3075,Brandon Smith,2003-04,30.0,5,0,3,3,0,0,0,1.0,30.0,33,3,4,7,29.0,82,5.31,60,363,2326,9.4,0.13053995
3076,3076,Brandon Sutter,2009-10,20.0,2,6,50,50,1,5,6,57.0,441.0,50,1,5,6,57.0,82,5.7,65,341,2477,9.4,0.2314586
3077,3077,Brandon Sutter,2010-11,21.0,3,40,72,72,21,19,40,168.0,1191.0,122,22,24,46,225.0,82,5.53,56,304,2486,9.1,0.5433682
3078,3078,Brandon Sutter,2011-12,22.0,4,29,82,82,14,15,29,145.0,1382.0,204,36,39,75,370.0,82,5.46,52,291,2492,9.0,0.4440359
3079,3079,Brandon Sutter,2012-13,23.0,5,32,82,82,17,15,32,171.0,1427.0,286,53,54,107,541.0,82,5.32,47,271,2439,8.9,0.4750606
3080,3080,Brandon Sutter,2013-14,24.0,6,19,48,48,11,8,19,82.0,788.0,334,64,62,126,623.0,48,5.31,29,160,1399,9.1,0.44537228
3081,3081,Brandon Sutter,2014-15,25.0,7,26,81,81,13,13,26,144.0,1277.0,415,77,75,152,767.0,82,5.34,48,269,2463,8.9,0.3700484
3082,3082,Brandon Sutter,2015-16,26.0,8,33,80,80,21,12,33,180.0,1386.0,495,98,87,185,947.0,82,5.32,47,251,2453,8.9,0.47384435
3083,3083,Brandon Sutter,2016-17,27.0,9,9,20,20,5,4,9,45.0,360.0,515,103,91,194,992.0,82,5.34,48,255,2438,9.0,0.37659568
3084,3084,Brandon Sutter,2017-18,28.0,10,34,81,81,17,17,34,160.0,1523.0,596,120,108,228,1152.0,82,5.45,47,245,2478,9.0,0.44431663
3085,3085,Brandon Sutter,2018-19,29.0,11,26,61,61,11,15,26,106.0,1056.0,657,131,123,254,1258.0,82,5.86,50,250,2620,9.2,0.36433896
3086,3086,Brandon Sutter,2019-20,30.0,12,6,26,26,4,2,6,43.0,454.0,683,135,125,260,1301.0,82,5.96,47,239,2579,9.5,0.2783893
3087,3087,Brandon Sutter,2020-21,31.0,13,17,44,44,8,9,17,76.0,653.0,727,143,134,277,1377.0,70,5.96,42,208,2192,9.5,0.34952345
3088,3088,Brandon Tanev,2016-17,25.0,2,0,3,3,0,0,0,4.0,36.0,3,0,0,0,4.0,82,5.34,48,255,2438,9.0,0.16531053
3089,3089,Brandon Tanev,2017-18,26.0,3,4,51,51,2,2,4,54.0,545.0,54,2,2,4,58.0,82,5.45,47,245,2478,9.0,0.1517644
3090,3090,Brandon Tanev,2018-19,27.0,4,18,61,61,8,10,18,79.0,772.0,115,10,12,22,137.0,82,5.86,50,250,2620,9.2,0.27453482
3091,3091,Brandon Tanev,2019-20,28.0,5,29,80,80,14,15,29,127.0,1129.0,195,24,27,51,264.0,82,5.96,47,239,2579,9.5,0.3241403
3092,3092,Brandon Tanev,2020-21,29.0,6,25,68,68,11,14,25,95.0,1004.0,263,35,41,76,359.0,70,5.96,42,208,2192,9.5,0.32939386
3093,3093,Brandon Yip,2010-11,25.0,2,19,32,32,11,8,19,65.0,470.0,32,11,8,19,65.0,82,5.53,56,304,2486,9.1,0.4047206
3094,3094,Brandon Yip,2011-12,26.0,3,22,71,71,12,10,22,127.0,975.0,103,23,18,41,192.0,82,5.46,52,291,2492,9.0,0.31868166
3095,3095,Brandon Yip,2012-13,27.0,4,7,35,35,3,4,7,41.0,374.0,138,26,22,48,233.0,82,5.32,47,271,2439,8.9,0.2274284
3096,3096,Brandon Yip,2013-14,28.0,5,8,34,34,3,5,8,35.0,409.0,172,29,27,56,268.0,48,5.31,29,160,1399,9.1,0.23668724
3097,3097,Brandon Yip,2014-15,29.0,6,0,2,2,0,0,0,1.0,14.0,174,29,27,56,269.0,82,5.34,48,269,2463,8.9,0.18596172
3098,3098,Brandy Semchuk,1993-94,22.0,2,0,1,1,0,0,0,0.0,,1,0,0,0,0.0,84,7.25,87,443,2603,11.7,0.17307612
3099,3099,Branislav Mezei,2001-02,21.0,2,5,42,42,1,4,5,29.0,622.0,42,1,4,5,29.0,82,5.51,63,376,2272,9.9,0.164648
3100,3100,Branislav Mezei,2002-03,22.0,3,2,24,24,0,2,2,4.0,203.0,66,1,6,7,33.0,82,5.24,53,338,2262,9.5,0.12376192
3101,3101,Branislav Mezei,2003-04,23.0,4,2,11,11,2,0,2,10.0,202.0,77,3,6,9,43.0,82,5.31,60,363,2326,9.4,0.23220783
3102,3102,Branislav Mezei,2004-05,24.0,5,7,45,45,0,7,7,26.0,798.0,122,3,13,16,69.0,82,5.14,57,348,2300,9.2,0.14282078
3103,3103,Branislav Mezei,2006-07,26.0,6,1,16,16,0,1,1,13.0,308.0,138,3,14,17,82.0,82,6.05,85,480,2458,10.1,0.1437605
3104,3104,Branislav Mezei,2007-08,27.0,7,3,45,45,0,3,3,24.0,718.0,183,3,17,20,106.0,82,5.76,70,398,2426,9.7,0.09771165
3105,3105,Branislav Mezei,2008-09,28.0,8,4,57,57,2,2,4,38.0,824.0,240,5,19,24,144.0,82,5.44,62,351,2383,9.4,0.13411167
3106,3106,Branko Radivojevic,2002-03,22.0,2,6,18,18,4,2,6,19.0,169.0,18,4,2,6,19.0,82,5.24,53,338,2262,9.5,0.29515928
3107,3107,Branko Radivojevic,2003-04,23.0,3,27,79,79,12,15,27,109.0,1051.0,97,16,17,33,128.0,82,5.31,60,363,2326,9.4,0.37910026
3108,3108,Branko Radivojevic,2004-05,24.0,4,32,77,77,10,22,32,107.0,1123.0,174,26,39,65,235.0,82,5.14,57,348,2300,9.2,0.45106363
3109,3109,Branko Radivojevic,2006-07,26.0,5,14,64,64,8,6,14,84.0,817.0,238,34,45,79,319.0,82,6.05,85,480,2458,10.1,0.24530596
3110,3110,Branko Radivojevic,2007-08,27.0,6,24,82,82,11,13,24,116.0,1064.0,320,45,58,103,435.0,82,5.76,70,398,2426,9.7,0.28030205
3111,3111,Branko Radivojevic,2008-09,28.0,7,17,73,73,7,10,17,91.0,1089.0,393,52,68,120,526.0,82,5.44,62,351,2383,9.4,0.26822132
3112,3112,Brantt Myhres,1995-96,21.0,2,2,15,15,2,0,2,4.0,,15,2,0,2,4.0,48,5.97,37,209,1408,10.2,0.30103415
3113,3113,Brantt Myhres,1997-98,23.0,3,4,47,47,3,1,4,13.0,,62,5,1,6,17.0,82,5.83,55,336,2444,9.8,0.1500834
3114,3114,Brantt Myhres,1998-99,24.0,4,0,23,23,0,0,0,0.0,,85,5,1,6,17.0,82,5.28,57,380,2242,9.6,0.102350205
3115,3115,Brantt Myhres,1999-00,25.0,5,1,30,30,1,0,1,7.0,144.0,115,6,1,7,24.0,82,5.27,57,359,2285,9.4,0.11620182
3116,3116,Brantt Myhres,2000-01,26.0,6,1,13,13,0,1,1,2.0,40.0,128,6,2,8,26.0,82,5.49,53,331,2294,9.8,0.12209898
3117,3117,Brantt Myhres,2001-02,27.0,7,0,25,25,0,0,0,1.0,94.0,153,6,2,8,27.0,82,5.51,63,376,2272,9.9,0.08021659
3118,3118,Brantt Myhres,2003-04,29.0,8,0,1,1,0,0,0,0.0,5.0,154,6,2,8,27.0,82,5.31,60,363,2326,9.4,0.123935014
3119,3119,Brayden Irwin,2010-11,23.0,2,0,2,2,0,0,0,3.0,20.0,2,0,0,0,3.0,82,5.53,56,304,2486,9.1,0.17674801
3120,3120,Brayden McNabb,2012-13,22.0,2,8,25,25,1,7,8,23.0,446.0,25,1,7,8,23.0,82,5.32,47,271,2439,8.9,0.22787821
3121,3121,Brayden McNabb,2014-15,24.0,3,0,12,12,0,0,0,10.0,207.0,37,1,7,8,33.0,82,5.34,48,269,2463,8.9,0.1695171
3122,3122,Brayden McNabb,2015-16,25.0,4,24,71,71,2,22,24,74.0,1129.0,108,3,29,32,107.0,82,5.32,47,251,2453,8.9,0.28323156
3123,3123,Brayden McNabb,2016-17,26.0,5,14,81,81,2,12,14,91.0,1524.0,189,5,41,46,198.0,82,5.34,48,255,2438,9.0,0.19928092
3124,3124,Brayden McNabb,2017-18,27.0,6,4,49,49,2,2,4,47.0,738.0,238,7,43,50,245.0,82,5.45,47,245,2478,9.0,0.16983628
3125,3125,Brayden McNabb,2018-19,28.0,7,15,76,76,5,10,15,88.0,1532.0,314,12,53,65,333.0,82,5.86,50,250,2620,9.2,0.19892672
3126,3126,Brayden McNabb,2019-20,29.0,8,16,81,81,4,12,16,84.0,1578.0,395,16,65,81,417.0,82,5.96,47,239,2579,9.5,0.2022042
3127,3127,Brayden McNabb,2020-21,30.0,9,9,71,71,2,7,9,73.0,1421.0,466,18,72,90,490.0,70,5.96,42,208,2192,9.5,0.20270056
3128,3128,Brayden Point,2017-18,21.0,2,40,68,68,18,22,40,122.0,1165.0,68,18,22,40,122.0,82,5.45,47,245,2478,9.0,0.614499
3129,3129,Brayden Point,2018-19,22.0,3,66,82,82,32,34,66,217.0,1609.0,150,50,56,106,339.0,82,5.86,50,250,2620,9.2,0.8636621
3130,3130,Brayden Point,2019-20,23.0,4,92,79,79,41,51,92,191.0,1495.0,229,91,107,198,530.0,82,5.96,47,239,2579,9.5,1.0667574
3131,3131,Brayden Point,2020-21,24.0,5,64,66,66,25,39,64,141.0,1248.0,295,116,146,262,671.0,70,5.96,42,208,2192,9.5,0.91096544
3132,3132,Brayden Schenn,2010-11,19.0,2,0,1,1,0,0,0,0.0,13.0,1,0,0,0,0.0,82,5.53,56,304,2486,9.1,0.22341225
3133,3133,Brayden Schenn,2011-12,20.0,3,2,8,8,0,2,2,11.0,90.0,9,0,2,2,11.0,82,5.46,52,291,2492,9.0,0.2634477
3134,3134,Brayden Schenn,2012-13,21.0,4,18,54,54,12,6,18,97.0,763.0,63,12,8,20,108.0,82,5.32,47,271,2439,8.9,0.40734887
3135,3135,Brayden Schenn,2013-14,22.0,5,26,47,47,8,18,26,79.0,730.0,110,20,26,46,187.0,48,5.31,29,160,1399,9.1,0.499976
3136,3136,Brayden Schenn,2014-15,23.0,6,41,82,82,20,21,41,178.0,1291.0,192,40,47,87,365.0,82,5.34,48,269,2463,8.9,0.5512886
3137,3137,Brayden Schenn,2015-16,24.0,7,47,82,82,18,29,47,156.0,1401.0,274,58,76,134,521.0,82,5.32,47,251,2453,8.9,0.5811893
3138,3138,Brayden Schenn,2016-17,25.0,8,59,80,80,26,33,59,178.0,1352.0,354,84,109,193,699.0,82,5.34,48,255,2438,9.0,0.6832999
3139,3139,Brayden Schenn,2017-18,26.0,9,55,79,79,25,30,55,178.0,1407.0,433,109,139,248,877.0,82,5.45,47,245,2478,9.0,0.66137123
3140,3140,Brayden Schenn,2018-19,27.0,10,70,82,82,28,42,70,210.0,1617.0,515,137,181,318,1087.0,82,5.86,50,250,2620,9.2,0.8032846
3141,3141,Brayden Schenn,2019-20,28.0,11,54,72,72,17,37,54,159.0,1338.0,587,154,218,372,1246.0,82,5.96,47,239,2579,9.5,0.6989031
3142,3142,Brayden Schenn,2020-21,29.0,12,58,71,71,25,33,58,138.0,1311.0,658,179,251,430,1384.0,70,5.96,42,208,2192,9.5,0.733733
3143,3143,Braydon Coburn,2006-07,21.0,2,1,9,9,0,1,1,4.0,69.0,9,0,1,1,4.0,82,6.05,85,480,2458,10.1,0.24147692
3144,3144,Braydon Coburn,2007-08,22.0,3,11,49,49,3,8,11,54.0,758.0,58,3,9,12,58.0,82,5.76,70,398,2426,9.7,0.23206434
3145,3145,Braydon Coburn,2008-09,23.0,4,36,78,78,9,27,36,113.0,1656.0,136,12,36,48,171.0,82,5.44,62,351,2383,9.4,0.4327335
3146,3146,Braydon Coburn,2009-10,24.0,5,28,80,80,7,21,28,130.0,1970.0,216,19,57,76,301.0,82,5.7,65,341,2477,9.4,0.3827818
3147,3147,Braydon Coburn,2010-11,25.0,6,19,81,81,5,14,19,122.0,1712.0,297,24,71,95,423.0,82,5.53,56,304,2486,9.1,0.27640438
3148,3148,Braydon Coburn,2011-12,26.0,7,16,82,82,2,14,16,114.0,1728.0,379,26,85,111,537.0,82,5.46,52,291,2492,9.0,0.26553082
3149,3149,Braydon Coburn,2012-13,27.0,8,24,81,81,4,20,24,113.0,1786.0,460,30,105,135,650.0,82,5.32,47,271,2439,8.9,0.27697966
3150,3150,Braydon Coburn,2013-14,28.0,9,5,33,33,1,4,5,38.0,746.0,493,31,109,140,688.0,48,5.31,29,160,1399,9.1,0.21321961
3151,3151,Braydon Coburn,2014-15,29.0,10,17,82,82,5,12,17,122.0,1840.0,575,36,121,157,810.0,82,5.34,48,269,2463,8.9,0.22503644
3152,3152,Braydon Coburn,2015-16,30.0,11,11,43,43,1,10,11,46.0,857.0,618,37,131,168,856.0,82,5.32,47,251,2453,8.9,0.17232612
3153,3153,Braydon Coburn,2016-17,31.0,12,10,80,80,1,9,10,92.0,1340.0,698,38,140,178,948.0,82,5.34,48,255,2438,9.0,0.1606707
3154,3154,Braydon Coburn,2017-18,32.0,13,12,80,80,5,7,12,102.0,1339.0,778,43,147,190,1050.0,82,5.45,47,245,2478,9.0,0.18806419
3155,3155,Braydon Coburn,2018-19,33.0,14,15,72,72,1,14,15,73.0,1154.0,850,44,161,205,1123.0,82,5.86,50,250,2620,9.2,0.16718915
3156,3156,Braydon Coburn,2019-20,34.0,15,23,74,74,4,19,23,113.0,1192.0,924,48,180,228,1236.0,82,5.96,47,239,2579,9.5,0.21863839
3157,3157,Braydon Coburn,2020-21,35.0,16,4,40,40,1,3,4,44.0,562.0,964,49,183,232,1280.0,70,5.96,42,208,2192,9.5,0.12457666
3158,3158,Brendan Bell,2006-07,23.0,2,0,1,1,0,0,0,2.0,14.0,1,0,0,0,2.0,82,6.05,85,480,2458,10.1,0.1699484
3159,3159,Brendan Bell,2007-08,24.0,3,7,45,45,1,6,7,47.0,616.0,46,1,6,7,49.0,82,5.76,70,398,2426,9.7,0.17590499
3160,3160,Brendan Bell,2008-09,25.0,4,0,2,2,0,0,0,0.0,30.0,48,1,6,7,49.0,82,5.44,62,351,2383,9.4,0.15686774
3161,3161,Brendan Bell,2009-10,26.0,5,21,53,53,6,15,21,76.0,940.0,101,7,21,28,125.0,82,5.7,65,341,2477,9.4,0.3601323
3162,3162,Brendan Bell,2012-13,29.0,6,0,1,1,0,0,0,2.0,11.0,102,7,21,28,127.0,82,5.32,47,271,2439,8.9,0.15129942
3163,3163,Brendan Gallagher,2013-14,21.0,2,28,44,44,15,13,28,117.0,610.0,44,15,13,28,117.0,48,5.31,29,160,1399,9.1,0.6156387
3164,3164,Brendan Gallagher,2014-15,22.0,3,41,81,81,19,22,41,211.0,1293.0,125,34,35,69,328.0,82,5.34,48,269,2463,8.9,0.57778805
3165,3165,Brendan Gallagher,2015-16,23.0,4,47,82,82,24,23,47,254.0,1360.0,207,58,58,116,582.0,82,5.32,47,251,2453,8.9,0.6908369
3166,3166,Brendan Gallagher,2016-17,24.0,5,40,53,53,19,21,40,173.0,879.0,260,77,79,156,755.0,82,5.34,48,255,2438,9.0,0.698754
3167,3167,Brendan Gallagher,2017-18,25.0,6,29,64,64,10,19,29,187.0,966.0,324,87,98,185,942.0,82,5.45,47,245,2478,9.0,0.5286489
3168,3168,Brendan Gallagher,2018-19,26.0,7,54,82,82,31,23,54,278.0,1325.0,406,118,121,239,1220.0,82,5.86,50,250,2620,9.2,0.701584
3169,3169,Brendan Gallagher,2019-20,27.0,8,52,82,82,33,19,52,302.0,1345.0,488,151,140,291,1522.0,82,5.96,47,239,2579,9.5,0.66463643
3170,3170,Brendan Gallagher,2020-21,28.0,9,43,59,59,22,21,43,226.0,998.0,547,173,161,334,1748.0,70,5.96,42,208,2192,9.5,0.7017144
3171,3171,Brendan Gaunce,2016-17,22.0,2,1,20,20,1,0,1,34.0,255.0,20,1,0,1,34.0,82,5.34,48,255,2438,9.0,0.21228024
3172,3172,Brendan Gaunce,2017-18,23.0,3,5,57,57,0,5,5,51.0,541.0,77,1,5,6,85.0,82,5.45,47,245,2478,9.0,0.1711258
3173,3173,Brendan Gaunce,2018-19,24.0,4,6,37,37,4,2,6,55.0,492.0,114,5,7,12,140.0,82,5.86,50,250,2620,9.2,0.22661379
3174,3174,Brendan Gaunce,2019-20,25.0,5,3,3,3,1,2,3,2.0,23.0,117,6,9,15,142.0,82,5.96,47,239,2579,9.5,0.21602279
3175,3175,Brendan Gaunce,2020-21,26.0,6,1,1,1,0,1,1,0.0,9.0,118,6,10,16,142.0,70,5.96,42,208,2192,9.5,0.18984693
3176,3176,Brendan Guhle,2017-18,20.0,2,0,3,3,0,0,0,4.0,49.0,3,0,0,0,4.0,82,5.45,47,245,2478,9.0,0.2783709
3177,3177,Brendan Guhle,2018-19,21.0,3,5,18,18,0,5,5,37.0,326.0,21,0,5,5,41.0,82,5.86,50,250,2620,9.2,0.27434197
3178,3178,Brendan Guhle,2019-20,22.0,4,1,8,8,0,1,1,15.0,120.0,29,0,6,6,56.0,82,5.96,47,239,2579,9.5,0.19793206
3179,3179,Brendan Guhle,2020-21,23.0,5,8,30,30,4,4,8,39.0,512.0,59,4,10,14,95.0,70,5.96,42,208,2192,9.5,0.28250414
3180,3180,Brendan Leipsic,2016-17,22.0,2,3,6,6,1,2,3,11.0,85.0,6,1,2,3,11.0,82,5.34,48,255,2438,9.0,0.2502224
3181,3181,Brendan Leipsic,2018-19,24.0,3,22,58,58,5,17,22,95.0,762.0,64,6,19,25,106.0,82,5.86,50,250,2620,9.2,0.33200112
3182,3182,Brendan Leipsic,2019-20,25.0,4,23,62,62,7,16,23,92.0,855.0,126,13,35,48,198.0,82,5.96,47,239,2579,9.5,0.3134467
3183,3183,Brendan Leipsic,2020-21,26.0,5,11,61,61,3,8,11,49.0,559.0,187,16,43,59,247.0,70,5.96,42,208,2192,9.5,0.24890321
3184,3184,Brendan Lemieux,2018-19,22.0,2,1,9,9,1,0,1,6.0,71.0,9,1,0,1,6.0,82,5.86,50,250,2620,9.2,0.2219727
3185,3185,Brendan Lemieux,2019-20,23.0,3,17,63,63,12,5,17,67.0,570.0,72,13,5,18,73.0,82,5.96,47,239,2579,9.5,0.28005758
3186,3186,Brendan Lemieux,2020-21,24.0,4,18,59,59,6,12,18,86.0,759.0,131,19,17,36,159.0,70,5.96,42,208,2192,9.5,0.34195626
3187,3187,Brendan Mikkelson,2009-10,22.0,2,2,34,34,0,2,2,19.0,474.0,34,0,2,2,19.0,82,5.7,65,341,2477,9.4,0.15486842
3188,3188,Brendan Mikkelson,2010-11,23.0,3,2,28,28,0,2,2,21.0,420.0,62,0,4,4,40.0,82,5.53,56,304,2486,9.1,0.16259971
3189,3189,Brendan Mikkelson,2011-12,24.0,4,2,24,24,0,2,2,14.0,341.0,86,0,6,6,54.0,82,5.46,52,291,2492,9.0,0.112698495
3190,3190,Brendan Mikkelson,2012-13,25.0,5,3,41,41,1,2,3,45.0,590.0,127,1,8,9,99.0,82,5.32,47,271,2439,8.9,0.13777089
3191,3191,Brendan Mikkelson,2013-14,26.0,6,1,4,4,0,1,1,0.0,39.0,131,1,9,10,99.0,48,5.31,29,160,1399,9.1,0.15710917
3192,3192,Brendan Morrison,1998-99,23.0,2,9,11,11,5,4,9,19.0,,11,5,4,9,19.0,82,5.28,57,380,2242,9.6,0.32093263
3193,3193,Brendan Morrison,1999-00,24.0,3,46,76,76,13,33,46,111.0,1058.0,87,18,37,55,130.0,82,5.27,57,359,2285,9.4,0.5231317
3194,3194,Brendan Morrison,2000-01,25.0,4,35,56,56,7,28,35,96.0,887.0,143,25,65,90,226.0,82,5.49,53,331,2294,9.8,0.49949592
3195,3195,Brendan Morrison,2001-02,26.0,5,54,82,82,16,38,54,179.0,1506.0,225,41,103,144,405.0,82,5.51,63,376,2272,9.9,0.7293745
3196,3196,Brendan Morrison,2002-03,27.0,6,67,82,82,23,44,67,183.0,1587.0,307,64,147,211,588.0,82,5.24,53,338,2262,9.5,0.79238385
3197,3197,Brendan Morrison,2003-04,28.0,7,71,82,82,25,46,71,167.0,1740.0,389,89,193,282,755.0,82,5.31,60,363,2326,9.4,0.7815076
3198,3198,Brendan Morrison,2004-05,29.0,8,60,82,82,22,38,60,161.0,1651.0,471,111,231,342,916.0,82,5.14,57,348,2300,9.2,0.77029914
3199,3199,Brendan Morrison,2006-07,31.0,9,56,82,82,19,37,56,156.0,1600.0,553,130,268,398,1072.0,82,6.05,85,480,2458,10.1,0.679174
3200,3200,Brendan Morrison,2007-08,32.0,10,51,82,82,20,31,51,139.0,1472.0,635,150,299,449,1211.0,82,5.76,70,398,2426,9.7,0.54268444
3201,3201,Brendan Morrison,2008-09,33.0,11,25,39,39,9,16,25,54.0,600.0,674,159,315,474,1265.0,82,5.44,62,351,2383,9.4,0.5239243
3202,3202,Brendan Morrison,2009-10,34.0,12,31,81,81,16,15,31,111.0,1151.0,755,175,330,505,1376.0,82,5.7,65,341,2477,9.4,0.4058653
3203,3203,Brendan Morrison,2010-11,35.0,13,42,74,74,12,30,42,105.0,1164.0,829,187,360,547,1481.0,82,5.53,56,304,2486,9.1,0.4834473
3204,3204,Brendan Morrison,2011-12,36.0,14,43,66,66,9,34,43,89.0,1102.0,895,196,394,590,1570.0,82,5.46,52,291,2492,9.0,0.5025014
3205,3205,Brendan Morrison,2012-13,37.0,15,11,39,39,4,7,11,43.0,521.0,934,200,401,601,1613.0,82,5.32,47,271,2439,8.9,0.21518177
3206,3206,Brendan Perlini,2017-18,21.0,2,21,57,57,14,7,21,92.0,846.0,57,14,7,21,92.0,82,5.45,47,245,2478,9.0,0.40447527
3207,3207,Brendan Perlini,2018-19,22.0,3,30,74,74,17,13,30,129.0,1074.0,131,31,20,51,221.0,82,5.86,50,250,2620,9.2,0.44726855
3208,3208,Brendan Perlini,2019-20,23.0,4,21,68,68,14,7,21,117.0,789.0,199,45,27,72,338.0,82,5.96,47,239,2579,9.5,0.385523
3209,3209,Brendan Perlini,2020-21,24.0,5,4,40,40,1,3,4,48.0,428.0,239,46,30,76,386.0,70,5.96,42,208,2192,9.5,0.27786818
3210,3210,Brendan Ranford,2015-16,23.0,2,0,1,1,0,0,0,0.0,9.0,1,0,0,0,0.0,82,5.32,47,251,2453,8.9,0.14718214
3211,3211,Brendan Shanahan,1988-89,20.0,2,26,65,65,7,19,26,72.0,,65,7,19,26,72.0,80,7.43,89,437,2435,12.2,0.43059948
3212,3212,Brendan Shanahan,1989-90,21.0,3,50,68,68,22,28,50,152.0,,133,29,47,76,224.0,80,7.48,85,403,2430,12.3,0.7899033
3213,3213,Brendan Shanahan,1990-91,22.0,4,72,73,73,30,42,72,196.0,,206,59,89,148,420.0,80,7.37,76,367,2421,12.2,0.91497016
3214,3214,Brendan Shanahan,1991-92,23.0,5,66,75,75,29,37,66,195.0,,281,88,126,214,615.0,80,6.91,71,366,2385,11.6,0.91305304
3215,3215,Brendan Shanahan,1992-93,24.0,6,69,80,80,33,36,69,215.0,,361,121,162,283,830.0,80,6.96,77,402,2440,11.4,0.9429445
3216,3216,Brendan Shanahan,1993-94,25.0,7,94,71,71,51,43,94,232.0,,432,172,205,377,1062.0,84,7.25,87,443,2603,11.7,1.0638518
3217,3217,Brendan Shanahan,1994-95,26.0,8,102,81,81,52,50,102,397.0,,513,224,255,479,1459.0,84,6.48,76,407,2545,10.7,1.0704231
3218,3218,Brendan Shanahan,1995-96,27.0,9,41,45,45,20,21,41,153.0,,558,244,276,520,1612.0,48,5.97,37,209,1408,10.2,0.92852616
3219,3219,Brendan Shanahan,1996-97,28.0,10,78,74,74,44,34,78,280.0,,632,288,310,598,1892.0,82,6.29,74,413,2481,10.4,0.87417173
3220,3220,Brendan Shanahan,1997-98,29.0,11,88,81,81,47,41,88,336.0,,713,335,351,686,2228.0,82,5.83,55,336,2444,9.8,0.9891928
3221,3221,Brendan Shanahan,1998-99,30.0,12,57,75,75,28,29,57,266.0,,788,363,380,743,2494.0,82,5.28,57,380,2242,9.6,0.7897862
3222,3222,Brendan Shanahan,1999-00,31.0,13,58,81,81,31,27,58,288.0,1419.0,869,394,407,801,2782.0,82,5.27,57,359,2285,9.4,0.73058856
3223,3223,Brendan Shanahan,2000-01,32.0,14,78,78,78,41,37,78,283.0,1449.0,947,435,444,879,3065.0,82,5.49,53,331,2294,9.8,0.88567996
3224,3224,Brendan Shanahan,2001-02,33.0,15,76,81,81,31,45,76,278.0,1488.0,1028,466,489,955,3343.0,82,5.51,63,376,2272,9.9,0.8459587
3225,3225,Brendan Shanahan,2002-03,34.0,16,75,80,80,37,38,75,277.0,1513.0,1108,503,527,1030,3620.0,82,5.24,53,338,2262,9.5,0.8412776
3226,3226,Brendan Shanahan,2003-04,35.0,17,68,78,78,30,38,68,260.0,1454.0,1186,533,565,1098,3880.0,82,5.31,60,363,2326,9.4,0.7734513
3227,3227,Brendan Shanahan,2004-05,36.0,18,53,82,82,25,28,53,280.0,1483.0,1268,558,593,1151,4160.0,82,5.14,57,348,2300,9.2,0.7736275
3228,3228,Brendan Shanahan,2006-07,38.0,19,81,82,82,40,41,81,289.0,1360.0,1350,598,634,1232,4449.0,82,6.05,85,480,2458,10.1,0.87421227
3229,3229,Brendan Shanahan,2007-08,39.0,20,62,67,67,29,33,62,295.0,1328.0,1417,627,667,1294,4744.0,82,5.76,70,398,2426,9.7,0.7163667
3230,3230,Brendan Shanahan,2008-09,40.0,21,46,73,73,23,23,46,265.0,1351.0,1490,650,690,1340,5009.0,82,5.44,62,351,2383,9.4,0.5352695
3231,3231,Brendan Shanahan,2009-10,41.0,22,14,34,34,6,8,14,77.0,506.0,1524,656,698,1354,5086.0,82,5.7,65,341,2477,9.4,0.33752504
3232,3232,Brendan Shinnimin,2015-16,25.0,2,1,12,12,0,1,1,10.0,132.0,12,0,1,1,10.0,82,5.32,47,251,2453,8.9,0.18680188
3233,3233,Brendan Smith,2012-13,23.0,2,7,14,14,1,6,7,13.0,219.0,14,1,6,7,13.0,82,5.32,47,271,2439,8.9,0.23487097
3234,3234,Brendan Smith,2013-14,24.0,3,8,34,34,0,8,8,33.0,626.0,48,1,14,15,46.0,48,5.31,29,160,1399,9.1,0.20755175
3235,3235,Brendan Smith,2014-15,25.0,4,19,71,71,5,14,19,90.0,1306.0,119,6,28,34,136.0,82,5.34,48,269,2463,8.9,0.25804645
3236,3236,Brendan Smith,2015-16,26.0,5,13,76,76,4,9,13,88.0,1360.0,195,10,37,47,224.0,82,5.32,47,251,2453,8.9,0.20073467
3237,3237,Brendan Smith,2016-17,27.0,6,15,63,63,3,12,15,82.0,1109.0,258,13,49,62,306.0,82,5.34,48,255,2438,9.0,0.2045689
3238,3238,Brendan Smith,2017-18,28.0,7,9,51,51,3,6,9,62.0,981.0,309,16,55,71,368.0,82,5.45,47,245,2478,9.0,0.1594322
3239,3239,Brendan Smith,2018-19,29.0,8,8,44,44,1,7,8,66.0,755.0,353,17,62,79,434.0,82,5.86,50,250,2620,9.2,0.17083612
3240,3240,Brendan Smith,2019-20,30.0,9,13,63,63,4,9,13,66.0,964.0,416,21,71,92,500.0,82,5.96,47,239,2579,9.5,0.17433956
3241,3241,Brendan Smith,2020-21,31.0,10,8,62,62,3,5,8,45.0,688.0,478,24,76,100,545.0,70,5.96,42,208,2192,9.5,0.15464854
3242,3242,Brendan Witt,1996-97,21.0,2,5,48,48,2,3,5,44.0,,48,2,3,5,44.0,82,6.29,74,413,2481,10.4,0.2295562
3243,3243,Brendan Witt,1997-98,22.0,3,5,44,44,3,2,5,41.0,,92,5,5,10,85.0,82,5.83,55,336,2444,9.8,0.20086294
3244,3244,Brendan Witt,1998-99,23.0,4,8,64,64,1,7,8,68.0,,156,6,12,18,153.0,82,5.28,57,380,2242,9.6,0.19319043
3245,3245,Brendan Witt,1999-00,24.0,5,7,54,54,2,5,7,51.0,855.0,210,8,17,25,204.0,82,5.27,57,359,2285,9.4,0.17909217
3246,3246,Brendan Witt,2000-01,25.0,6,8,77,77,1,7,8,64.0,1612.0,287,9,24,33,268.0,82,5.49,53,331,2294,9.8,0.14204562
3247,3247,Brendan Witt,2001-02,26.0,7,6,72,72,3,3,6,87.0,1489.0,359,12,27,39,355.0,82,5.51,63,376,2272,9.9,0.16873199
3248,3248,Brendan Witt,2002-03,27.0,8,10,68,68,3,7,10,81.0,1363.0,427,15,34,49,436.0,82,5.24,53,338,2262,9.5,0.17558742
3249,3249,Brendan Witt,2003-04,28.0,9,11,69,69,2,9,11,80.0,1444.0,496,17,43,60,516.0,82,5.31,60,363,2326,9.4,0.19238779
3250,3250,Brendan Witt,2004-05,29.0,10,12,72,72,2,10,12,91.0,1641.0,568,19,53,72,607.0,82,5.14,57,348,2300,9.2,0.18591127
3251,3251,Brendan Witt,2006-07,31.0,11,14,75,75,1,13,14,75.0,1555.0,643,20,66,86,682.0,82,6.05,85,480,2458,10.1,0.1446934
3252,3252,Brendan Witt,2007-08,32.0,12,14,81,81,1,13,14,75.0,1753.0,724,21,79,100,757.0,82,5.76,70,398,2426,9.7,0.13883474
3253,3253,Brendan Witt,2008-09,33.0,13,7,59,59,2,5,7,58.0,1285.0,783,23,84,107,815.0,82,5.44,62,351,2383,9.4,0.14287472
3254,3254,Brendan Witt,2009-10,34.0,14,9,65,65,0,9,9,52.0,1320.0,848,23,93,116,867.0,82,5.7,65,341,2477,9.4,0.12291461
3255,3255,Brendan Witt,2010-11,35.0,15,5,42,42,2,3,5,25.0,640.0,890,25,96,121,892.0,82,5.53,56,304,2486,9.1,0.09802729
3256,3256,Brendan Woods,2015-16,23.0,2,0,2,2,0,0,0,3.0,12.0,2,0,0,0,3.0,82,5.32,47,251,2453,8.9,0.17318648
3257,3257,Brendan Woods,2016-17,24.0,3,0,5,5,0,0,0,5.0,44.0,7,0,0,0,8.0,82,5.34,48,255,2438,9.0,0.16505742
3258,3258,Brenden Dillon,2012-13,22.0,2,0,1,1,0,0,0,6.0,20.0,1,0,0,0,6.0,82,5.32,47,271,2439,8.9,0.18205357
3259,3259,Brenden Dillon,2013-14,23.0,3,8,48,48,3,5,8,75.0,1026.0,49,3,5,8,81.0,48,5.31,29,160,1399,9.1,0.25596005
3260,3260,Brenden Dillon,2014-15,24.0,4,17,80,80,6,11,17,97.0,1687.0,129,9,16,25,178.0,82,5.34,48,269,2463,8.9,0.24959192
3261,3261,Brenden Dillon,2015-16,25.0,5,10,80,80,2,8,10,91.0,1566.0,209,11,24,35,269.0,82,5.32,47,251,2453,8.9,0.18350923
3262,3262,Brenden Dillon,2016-17,26.0,6,11,76,76,2,9,11,93.0,1268.0,285,13,33,46,362.0,82,5.34,48,255,2438,9.0,0.18452212
3263,3263,Brenden Dillon,2017-18,27.0,7,10,81,81,2,8,10,86.0,1334.0,366,15,41,56,448.0,82,5.45,47,245,2478,9.0,0.18186882
3264,3264,Brenden Dillon,2018-19,28.0,8,22,81,81,5,17,22,88.0,1403.0,447,20,58,78,536.0,82,5.86,50,250,2620,9.2,0.22616461
3265,3265,Brenden Dillon,2019-20,29.0,9,22,82,82,1,21,22,71.0,1455.0,529,21,79,100,607.0,82,5.96,47,239,2579,9.5,0.22748882
3266,3266,Brenden Dillon,2020-21,30.0,10,14,69,69,1,13,14,58.0,1343.0,598,22,92,114,665.0,70,5.96,42,208,2192,9.5,0.17271432
3267,3267,Brenden Morrow,2000-01,22.0,2,33,64,64,14,19,33,113.0,1014.0,64,14,19,33,113.0,82,5.49,53,331,2294,9.8,0.5021807
3268,3268,Brenden Morrow,2001-02,23.0,3,44,82,82,20,24,44,121.0,1270.0,146,34,43,77,234.0,82,5.51,63,376,2272,9.9,0.54399556
3269,3269,Brenden Morrow,2002-03,24.0,4,35,72,72,17,18,35,102.0,1215.0,218,51,61,112,336.0,82,5.24,53,338,2262,9.5,0.511138
3270,3270,Brenden Morrow,2003-04,25.0,5,43,71,71,21,22,43,105.0,1115.0,289,72,83,155,441.0,82,5.31,60,363,2326,9.4,0.5519525
3271,3271,Brenden Morrow,2004-05,26.0,6,49,81,81,25,24,49,132.0,1571.0,370,97,107,204,573.0,82,5.14,57,348,2300,9.2,0.7358274
3272,3272,Brenden Morrow,2006-07,28.0,7,65,81,81,23,42,65,146.0,1560.0,451,120,149,269,719.0,82,6.05,85,480,2458,10.1,0.6959251
3273,3273,Brenden Morrow,2007-08,29.0,8,31,40,40,16,15,31,101.0,731.0,491,136,164,300,820.0,82,5.76,70,398,2426,9.7,0.64174706
3274,3274,Brenden Morrow,2008-09,30.0,9,74,82,82,32,42,74,207.0,1639.0,573,168,206,374,1027.0,82,5.44,62,351,2383,9.4,0.8226297
3275,3275,Brenden Morrow,2009-10,31.0,10,15,18,18,5,10,15,52.0,384.0,591,173,216,389,1079.0,82,5.7,65,341,2477,9.4,0.51155704
3276,3276,Brenden Morrow,2010-11,32.0,11,46,76,76,20,26,46,155.0,1457.0,667,193,242,435,1234.0,82,5.53,56,304,2486,9.1,0.5184855
3277,3277,Brenden Morrow,2011-12,33.0,12,56,82,82,33,23,56,209.0,1577.0,749,226,265,491,1443.0,82,5.46,52,291,2492,9.0,0.6476859
3278,3278,Brenden Morrow,2012-13,34.0,13,26,57,57,11,15,26,88.0,971.0,806,237,280,517,1531.0,82,5.32,47,271,2439,8.9,0.3721426
3279,3279,Brenden Morrow,2013-14,35.0,14,25,44,44,12,13,25,55.0,654.0,850,249,293,542,1586.0,48,5.31,29,160,1399,9.1,0.45865518
3280,3280,Brenden Morrow,2014-15,36.0,15,25,71,71,13,12,25,56.0,845.0,921,262,305,567,1642.0,82,5.34,48,269,2463,8.9,0.28714707
3281,3281,Brenden Morrow,2015-16,37.0,16,8,70,70,3,5,8,28.0,653.0,991,265,310,575,1670.0,82,5.32,47,251,2453,8.9,0.16831037
3282,3282,Brendon Nash,2011-12,24.0,2,0,2,2,0,0,0,2.0,20.0,2,0,0,0,2.0,82,5.46,52,291,2492,9.0,0.16744861
3283,3283,Brennan Menell,2020-21,23.0,2,0,5,5,0,0,0,4.0,70.0,5,0,0,0,4.0,70,5.96,42,208,2192,9.5,0.19440743
3284,3284,Brent Ashton,1980-81,20.0,2,19,47,47,5,14,19,69.0,,47,5,14,19,69.0,80,7.03,61,280,2352,12.0,0.4015516
3285,3285,Brent Ashton,1981-82,21.0,3,29,77,77,18,11,29,111.0,,124,23,25,48,180.0,80,7.69,77,340,2441,12.6,0.5037942
3286,3286,Brent Ashton,1982-83,22.0,4,60,80,80,24,36,60,182.0,,204,47,61,108,362.0,80,8.03,73,320,2489,12.9,0.7115354
3287,3287,Brent Ashton,1983-84,23.0,5,33,76,76,14,19,33,113.0,,280,61,80,141,475.0,80,7.73,71,310,2444,12.7,0.47328776
3288,3288,Brent Ashton,1984-85,24.0,6,17,68,68,7,10,17,82.0,,348,68,90,158,557.0,80,7.89,74,336,2448,12.9,0.43896845
3289,3289,Brent Ashton,1985-86,25.0,7,62,78,78,31,31,62,153.0,,426,99,121,220,710.0,80,7.77,71,321,2447,12.7,0.71720487
3290,3290,Brent Ashton,1986-87,26.0,8,58,77,77,26,32,58,207.0,,503,125,153,278,917.0,80,7.94,82,370,2484,12.8,0.68615544
3291,3291,Brent Ashton,1987-88,27.0,9,75,81,81,40,35,75,185.0,,584,165,188,353,1102.0,80,7.34,72,344,2400,12.2,0.8546512
3292,3292,Brent Ashton,1988-89,28.0,10,53,73,73,26,27,53,161.0,,657,191,215,406,1263.0,80,7.43,89,437,2435,12.2,0.71103734
3293,3293,Brent Ashton,1989-90,29.0,11,68,75,75,31,37,68,180.0,,732,222,252,474,1443.0,80,7.48,85,403,2430,12.3,0.7569579
3294,3294,Brent Ashton,1990-91,30.0,12,56,79,79,22,34,56,167.0,,811,244,286,530,1610.0,80,7.37,76,367,2421,12.2,0.5976845
3295,3295,Brent Ashton,1991-92,31.0,13,36,61,61,12,24,36,107.0,,872,256,310,566,1717.0,80,6.91,71,366,2385,11.6,0.4910313
3296,3296,Brent Ashton,1992-93,32.0,14,40,68,68,18,22,40,130.0,,940,274,332,606,1847.0,80,6.96,77,402,2440,11.4,0.4940956
3297,3297,Brent Ashton,1993-94,33.0,15,23,58,58,10,13,23,84.0,,998,284,345,629,1931.0,84,7.25,87,443,2603,11.7,0.32428473
3298,3298,Brent Burns,2004-05,19.0,2,6,36,36,1,5,6,34.0,485.0,36,1,5,6,34.0,82,5.14,57,348,2300,9.2,0.2632215
3299,3299,Brent Burns,2006-07,21.0,3,16,72,72,4,12,16,73.0,1016.0,108,5,17,22,107.0,82,6.05,85,480,2458,10.1,0.29454082
3300,3300,Brent Burns,2007-08,22.0,4,25,77,77,7,18,25,108.0,1216.0,185,12,35,47,215.0,82,5.76,70,398,2426,9.7,0.353854
3301,3301,Brent Burns,2008-09,23.0,5,43,82,82,15,28,43,158.0,1894.0,267,27,63,90,373.0,82,5.44,62,351,2383,9.4,0.541978
3302,3302,Brent Burns,2009-10,24.0,6,27,59,59,8,19,27,147.0,1323.0,326,35,82,117,520.0,82,5.7,65,341,2477,9.4,0.46635666
3303,3303,Brent Burns,2010-11,25.0,7,20,47,47,3,17,20,104.0,1052.0,373,38,99,137,624.0,82,5.53,56,304,2486,9.1,0.38098204
3304,3304,Brent Burns,2011-12,26.0,8,46,80,80,17,29,46,170.0,2004.0,453,55,128,183,794.0,82,5.46,52,291,2492,9.0,0.56779265
3305,3305,Brent Burns,2012-13,27.0,9,37,81,81,11,26,37,201.0,1826.0,534,66,154,220,995.0,82,5.32,47,271,2439,8.9,0.49360126
3306,3306,Brent Burns,2013-14,28.0,10,20,30,30,9,11,20,81.0,488.0,564,75,165,240,1076.0,48,5.31,29,160,1399,9.1,0.614569
3307,3307,Brent Burns,2014-15,29.0,11,48,69,69,22,26,48,245.0,1160.0,633,97,191,288,1321.0,82,5.34,48,269,2463,8.9,0.63636535
3308,3308,Brent Burns,2015-16,30.0,12,60,82,82,17,43,60,245.0,1964.0,715,114,234,348,1566.0,82,5.32,47,251,2453,8.9,0.68264264
3309,3309,Brent Burns,2016-17,31.0,13,75,82,82,27,48,75,353.0,2121.0,797,141,282,423,1919.0,82,5.34,48,255,2438,9.0,0.8223103
3310,3310,Brent Burns,2017-18,32.0,14,76,82,82,29,47,76,320.0,2039.0,879,170,329,499,2239.0,82,5.45,47,245,2478,9.0,0.8141155
3311,3311,Brent Burns,2018-19,33.0,15,67,82,82,12,55,67,332.0,2070.0,961,182,384,566,2571.0,82,5.86,50,250,2620,9.2,0.77520776
3312,3312,Brent Burns,2019-20,34.0,16,83,82,82,16,67,83,300.0,2058.0,1043,198,451,649,2871.0,82,5.96,47,239,2579,9.5,0.7387229
3313,3313,Brent Burns,2020-21,35.0,17,45,70,70,12,33,45,225.0,1779.0,1113,210,484,694,3096.0,70,5.96,42,208,2192,9.5,0.6021607
3314,3314,Brent Fedyk,1988-89,21.0,2,1,2,2,0,1,1,2.0,,2,0,1,1,2.0,80,7.43,89,437,2435,12.2,0.28862292
3315,3315,Brent Fedyk,1989-90,22.0,3,2,5,5,2,0,2,6.0,,7,2,1,3,8.0,80,7.48,85,403,2430,12.3,0.3146831
3316,3316,Brent Fedyk,1990-91,23.0,4,5,27,27,1,4,5,28.0,,34,3,5,8,36.0,80,7.37,76,367,2421,12.2,0.24910012
3317,3317,Brent Fedyk,1991-92,24.0,5,35,67,67,16,19,35,74.0,,101,19,24,43,110.0,80,6.91,71,366,2385,11.6,0.4342453
3318,3318,Brent Fedyk,1992-93,25.0,6,13,61,61,5,8,13,60.0,,162,24,32,56,170.0,80,6.96,77,402,2440,11.4,0.31018305
3319,3319,Brent Fedyk,1993-94,26.0,7,59,74,74,21,38,59,167.0,,236,45,70,115,337.0,84,7.25,87,443,2603,11.7,0.601158
3320,3320,Brent Fedyk,1994-95,27.0,8,38,72,72,20,18,38,104.0,,308,65,88,153,441.0,84,6.48,76,407,2545,10.7,0.4171872
3321,3321,Brent Fedyk,1995-96,28.0,9,12,30,30,8,4,12,41.0,,338,73,92,165,482.0,48,5.97,37,209,1408,10.2,0.39990616
3322,3322,Brent Fedyk,1996-97,29.0,10,34,65,65,20,14,34,113.0,,403,93,106,199,595.0,82,6.29,74,413,2481,10.4,0.40990603
3323,3323,Brent Fedyk,1999-00,32.0,11,10,67,67,4,6,10,47.0,744.0,470,97,112,209,642.0,82,5.27,57,359,2285,9.4,0.18394032
3324,3324,Brent Gilchrist,1989-90,22.0,2,24,49,49,8,16,24,68.0,,49,8,16,24,68.0,80,7.48,85,403,2430,12.3,0.43630093
3325,3325,Brent Gilchrist,1990-91,23.0,3,24,57,57,9,15,24,80.0,,106,17,31,48,148.0,80,7.37,76,367,2421,12.2,0.40927488
3326,3326,Brent Gilchrist,1991-92,24.0,4,15,51,51,6,9,15,81.0,,157,23,40,63,229.0,80,6.91,71,366,2385,11.6,0.38113424
3327,3327,Brent Gilchrist,1992-93,25.0,5,50,79,79,23,27,50,146.0,,236,46,67,113,375.0,80,6.96,77,402,2440,11.4,0.59509206
3328,3328,Brent Gilchrist,1993-94,26.0,6,21,68,68,10,11,21,106.0,,304,56,78,134,481.0,84,7.25,87,443,2603,11.7,0.318389
3329,3329,Brent Gilchrist,1994-95,27.0,7,31,76,76,17,14,31,103.0,,380,73,92,165,584.0,84,6.48,76,407,2545,10.7,0.42646992
3330,3330,Brent Gilchrist,1995-96,28.0,8,13,32,32,9,4,13,70.0,,412,82,96,178,654.0,48,5.97,37,209,1408,10.2,0.3982178
3331,3331,Brent Gilchrist,1996-97,29.0,9,42,77,77,20,22,42,164.0,,489,102,118,220,818.0,82,6.29,74,413,2481,10.4,0.46478826
3332,3332,Brent Gilchrist,1997-98,30.0,10,30,67,67,10,20,30,116.0,,556,112,138,250,934.0,82,5.83,55,336,2444,9.8,0.38009447
3333,3333,Brent Gilchrist,1998-99,31.0,11,27,61,61,13,14,27,124.0,,617,125,152,277,1058.0,82,5.28,57,380,2242,9.6,0.40298668
3334,3334,Brent Gilchrist,1999-00,32.0,12,1,5,5,1,0,1,4.0,60.0,622,126,152,278,1062.0,82,5.27,57,359,2285,9.4,0.21318102
3335,3335,Brent Gilchrist,2000-01,33.0,13,6,24,24,4,2,6,33.0,272.0,646,130,154,284,1095.0,82,5.49,53,331,2294,9.8,0.25410593
3336,3336,Brent Gilchrist,2001-02,34.0,14,9,60,60,1,8,9,75.0,701.0,706,131,162,293,1170.0,82,5.51,63,376,2272,9.9,0.16986957
3337,3337,Brent Gilchrist,2002-03,35.0,15,9,45,45,3,6,9,53.0,505.0,751,134,168,302,1223.0,82,5.24,53,338,2262,9.5,0.156856
3338,3338,Brent Gilchrist,2003-04,36.0,16,3,41,41,1,2,3,41.0,441.0,792,135,170,305,1264.0,82,5.31,60,363,2326,9.4,0.15081134
3339,3339,Brent Gretzky,1994-95,22.0,2,3,10,10,1,2,3,14.0,,10,1,2,3,14.0,84,6.48,76,407,2545,10.7,0.2450124
3340,3340,Brent Gretzky,1995-96,23.0,3,1,3,3,0,1,1,1.0,,13,1,3,4,15.0,48,5.97,37,209,1408,10.2,0.21790448
3341,3341,Brent Grieve,1994-95,25.0,2,18,27,27,13,5,18,54.0,,27,13,5,18,54.0,84,6.48,76,407,2545,10.7,0.4686144
3342,3342,Brent Grieve,1995-96,26.0,3,6,24,24,1,5,6,30.0,,51,14,10,24,84.0,48,5.97,37,209,1408,10.2,0.24088126
3343,3343,Brent Grieve,1996-97,27.0,4,6,28,28,2,4,6,22.0,,79,16,14,30,106.0,82,6.29,74,413,2481,10.4,0.21969253
3344,3344,Brent Grieve,1997-98,28.0,5,6,18,18,4,2,6,50.0,,97,20,16,36,156.0,82,5.83,55,336,2444,9.8,0.25742093
3345,3345,Brent Hughes,1989-90,23.0,2,5,28,28,3,2,5,37.0,,28,3,2,5,37.0,80,7.48,85,403,2430,12.3,0.31770533
3346,3346,Brent Hughes,1990-91,24.0,3,3,11,11,1,2,3,7.0,,39,4,4,8,44.0,80,7.37,76,367,2421,12.2,0.22967333
3347,3347,Brent Hughes,1992-93,26.0,4,2,8,8,1,1,2,10.0,,47,5,5,10,54.0,80,6.96,77,402,2440,11.4,0.22743031
3348,3348,Brent Hughes,1993-94,27.0,5,9,62,62,5,4,9,54.0,,109,10,9,19,108.0,84,7.25,87,443,2603,11.7,0.18395436
3349,3349,Brent Hughes,1994-95,28.0,6,24,77,77,13,11,24,100.0,,186,23,20,43,208.0,84,6.48,76,407,2545,10.7,0.28231883
3350,3350,Brent Hughes,1995-96,29.0,7,12,44,44,6,6,12,75.0,,230,29,26,55,283.0,48,5.97,37,209,1408,10.2,0.2930364
3351,3351,Brent Hughes,1996-97,30.0,8,15,76,76,5,10,15,56.0,,306,34,36,70,339.0,82,6.29,74,413,2481,10.4,0.15842253
3352,3352,Brent Hughes,1997-98,31.0,9,10,51,51,7,3,10,47.0,,357,41,39,80,386.0,82,5.83,55,336,2444,9.8,0.20947284
3353,3353,Brent Peterson,1997-98,25.0,2,2,17,17,2,0,2,11.0,,17,2,0,2,11.0,82,5.83,55,336,2444,9.8,0.20434412
3354,3354,Brent Peterson,1998-99,26.0,3,5,19,19,5,0,5,15.0,,36,7,0,7,26.0,82,5.28,57,380,2242,9.6,0.21180627
3355,3355,Brent Peterson,1999-00,27.0,4,3,20,20,2,1,3,16.0,179.0,56,9,1,10,42.0,82,5.27,57,359,2285,9.4,0.1784764
3356,3356,Brent Regner,2016-17,27.0,2,0,7,7,0,0,0,7.0,81.0,7,0,0,0,7.0,82,5.34,48,255,2438,9.0,0.17943743
3357,3357,Brent Seabrook,2006-07,21.0,2,32,69,69,5,27,32,114.0,1382.0,69,5,27,32,114.0,82,6.05,85,480,2458,10.1,0.47049266
3358,3358,Brent Seabrook,2007-08,22.0,3,24,81,81,4,20,24,144.0,1683.0,150,9,47,56,258.0,82,5.76,70,398,2426,9.7,0.3341754
3359,3359,Brent Seabrook,2008-09,23.0,4,32,82,82,9,23,32,152.0,1763.0,232,18,70,88,410.0,82,5.44,62,351,2383,9.4,0.46098268
3360,3360,Brent Seabrook,2009-10,24.0,5,26,82,82,8,18,26,132.0,1912.0,314,26,88,114,542.0,82,5.7,65,341,2477,9.4,0.40353933
3361,3361,Brent Seabrook,2010-11,25.0,6,30,78,78,4,26,30,129.0,1811.0,392,30,114,144,671.0,82,5.53,56,304,2486,9.1,0.41091755
3362,3362,Brent Seabrook,2011-12,26.0,7,48,82,82,9,39,48,135.0,2000.0,474,39,153,192,806.0,82,5.46,52,291,2492,9.0,0.5755341
3363,3363,Brent Seabrook,2012-13,27.0,8,34,78,78,9,25,34,156.0,1929.0,552,48,178,226,962.0,82,5.32,47,271,2439,8.9,0.44523478
3364,3364,Brent Seabrook,2013-14,28.0,9,20,47,47,8,12,20,65.0,1034.0,599,56,190,246,1027.0,48,5.31,29,160,1399,9.1,0.42048836
3365,3365,Brent Seabrook,2014-15,29.0,10,41,82,82,7,34,41,149.0,1826.0,681,63,224,287,1176.0,82,5.34,48,269,2463,8.9,0.48804945
3366,3366,Brent Seabrook,2015-16,30.0,11,31,82,82,8,23,31,181.0,1819.0,763,71,247,318,1357.0,82,5.32,47,251,2453,8.9,0.44245592
3367,3367,Brent Seabrook,2016-17,31.0,12,49,81,81,14,35,49,167.0,1849.0,844,85,282,367,1524.0,82,5.34,48,255,2438,9.0,0.54586685
3368,3368,Brent Seabrook,2017-18,32.0,13,39,79,79,3,36,39,131.0,1729.0,923,88,318,406,1655.0,82,5.45,47,245,2478,9.0,0.417673
3369,3369,Brent Seabrook,2018-19,33.0,14,26,81,81,7,19,26,136.0,1636.0,1004,95,337,432,1791.0,82,5.86,50,250,2620,9.2,0.30514976
3370,3370,Brent Seabrook,2019-20,34.0,15,28,78,78,5,23,28,165.0,1490.0,1082,100,360,460,1956.0,82,5.96,47,239,2579,9.5,0.3133555
3371,3371,Brent Seabrook,2020-21,35.0,16,4,32,32,3,1,4,40.0,581.0,1114,103,361,464,1996.0,70,5.96,42,208,2192,9.5,0.21999156
3372,3372,Brent Severyn,1990-91,24.0,2,2,35,35,0,2,2,28.0,,35,0,2,2,28.0,80,7.37,76,367,2421,12.2,0.19268206
3373,3373,Brent Severyn,1994-95,28.0,3,11,67,67,4,7,11,93.0,,102,4,9,13,121.0,84,6.48,76,407,2545,10.7,0.20503834
3374,3374,Brent Severyn,1995-96,29.0,4,6,28,28,2,4,6,32.0,,130,6,13,19,153.0,48,5.97,37,209,1408,10.2,0.2181055
3375,3375,Brent Severyn,1996-97,30.0,5,9,65,65,1,8,9,40.0,,195,7,21,28,193.0,82,6.29,74,413,2481,10.4,0.12710443
3376,3376,Brent Severyn,1997-98,31.0,6,5,66,66,1,4,5,55.0,,261,8,25,33,248.0,82,5.83,55,336,2444,9.8,0.1273357
3377,3377,Brent Severyn,1998-99,32.0,7,4,37,37,1,3,4,27.0,,298,9,28,37,275.0,82,5.28,57,380,2242,9.6,0.117491156
3378,3378,Brent Severyn,1999-00,33.0,8,3,30,30,1,2,3,22.0,154.0,328,10,30,40,297.0,82,5.27,57,359,2285,9.4,0.12946117
3379,3379,Brent Sopel,1999-00,23.0,2,1,5,5,1,0,1,5.0,60.0,5,1,0,1,5.0,82,5.27,57,359,2285,9.4,0.22954798
3380,3380,Brent Sopel,2000-01,24.0,3,6,18,18,2,4,6,11.0,189.0,23,3,4,7,16.0,82,5.49,53,331,2294,9.8,0.225292
3381,3381,Brent Sopel,2001-02,25.0,4,14,52,52,4,10,14,57.0,833.0,75,7,14,21,73.0,82,5.51,63,376,2272,9.9,0.22443435
3382,3382,Brent Sopel,2002-03,26.0,5,25,66,66,8,17,25,116.0,1255.0,141,15,31,46,189.0,82,5.24,53,338,2262,9.5,0.3369409
3383,3383,Brent Sopel,2003-04,27.0,6,37,81,81,7,30,37,167.0,1758.0,222,22,61,83,356.0,82,5.31,60,363,2326,9.4,0.46294653
3384,3384,Brent Sopel,2004-05,28.0,7,42,80,80,10,32,42,173.0,1754.0,302,32,93,125,529.0,82,5.14,57,348,2300,9.2,0.5361192
3385,3385,Brent Sopel,2006-07,30.0,8,28,68,68,2,26,28,133.0,1586.0,370,34,119,153,662.0,82,6.05,85,480,2458,10.1,0.36043218
3386,3386,Brent Sopel,2007-08,31.0,9,28,64,64,5,23,28,131.0,1297.0,434,39,142,181,793.0,82,5.76,70,398,2426,9.7,0.38540462
3387,3387,Brent Sopel,2008-09,32.0,10,20,58,58,1,19,20,56.0,1178.0,492,40,161,201,849.0,82,5.44,62,351,2383,9.4,0.26299578
3388,3388,Brent Sopel,2009-10,33.0,11,2,23,23,1,1,2,15.0,318.0,515,41,162,203,864.0,82,5.7,65,341,2477,9.4,0.12830499
3389,3389,Brent Sopel,2010-11,34.0,12,8,73,73,1,7,8,48.0,1085.0,588,42,169,211,912.0,82,5.53,56,304,2486,9.1,0.13094532
3390,3390,Brent Sopel,2011-12,35.0,13,7,71,71,2,5,7,44.0,1160.0,659,44,174,218,956.0,82,5.46,52,291,2492,9.0,0.13595918
3391,3391,Brent Sutter,1981-82,19.0,2,4,3,3,2,2,4,2.0,,3,2,2,4,2.0,80,7.69,77,340,2441,12.6,0.53966594
3392,3392,Brent Sutter,1982-83,20.0,3,43,43,43,21,22,43,93.0,,46,23,24,47,95.0,80,8.03,73,320,2489,12.9,0.72500205
3393,3393,Brent Sutter,1983-84,21.0,4,40,80,80,21,19,40,149.0,,126,44,43,87,244.0,80,7.73,71,310,2444,12.7,0.6018789
3394,3394,Brent Sutter,1984-85,22.0,5,49,69,69,34,15,49,156.0,,195,78,58,136,400.0,80,7.89,74,336,2448,12.9,0.82366794
3395,3395,Brent Sutter,1985-86,23.0,6,102,72,72,42,60,102,195.0,,267,120,118,238,595.0,80,7.77,71,321,2447,12.7,1.2142692
3396,3396,Brent Sutter,1986-87,24.0,7,55,61,61,24,31,55,135.0,,328,144,149,293,730.0,80,7.94,82,370,2484,12.8,0.8533899
3397,3397,Brent Sutter,1987-88,25.0,8,63,69,69,27,36,63,177.0,,397,171,185,356,907.0,80,7.34,72,344,2400,12.2,0.8556956
3398,3398,Brent Sutter,1988-89,26.0,9,60,70,70,29,31,60,162.0,,467,200,216,416,1069.0,80,7.43,89,437,2435,12.2,0.8888606
3399,3399,Brent Sutter,1989-90,27.0,10,63,77,77,29,34,63,187.0,,544,229,250,479,1256.0,80,7.48,85,403,2430,12.3,0.8126719
3400,3400,Brent Sutter,1990-91,28.0,11,68,67,67,33,35,68,198.0,,611,262,285,547,1454.0,80,7.37,76,367,2421,12.2,0.8008054
3401,3401,Brent Sutter,1991-92,29.0,12,53,75,75,21,32,53,186.0,,686,283,317,600,1640.0,80,6.91,71,366,2385,11.6,0.6735085
3402,3402,Brent Sutter,1992-93,30.0,13,60,69,69,22,38,60,206.0,,755,305,355,660,1846.0,80,6.96,77,402,2440,11.4,0.8260964
3403,3403,Brent Sutter,1993-94,31.0,14,54,65,65,20,34,54,151.0,,820,325,389,714,1997.0,84,7.25,87,443,2603,11.7,0.67194104
3404,3404,Brent Sutter,1994-95,32.0,15,38,73,73,9,29,38,127.0,,893,334,418,752,2124.0,84,6.48,76,407,2545,10.7,0.4015952
3405,3405,Brent Sutter,1995-96,33.0,16,15,47,47,7,8,15,65.0,,940,341,426,767,2189.0,48,5.97,37,209,1408,10.2,0.42350435
3406,3406,Brent Sutter,1996-97,34.0,17,40,80,80,13,27,40,102.0,,1020,354,453,807,2291.0,82,6.29,74,413,2481,10.4,0.41475293
3407,3407,Brent Sutter,1997-98,35.0,18,14,39,39,7,7,14,62.0,,1059,361,460,821,2353.0,82,5.83,55,336,2444,9.8,0.3472418
3408,3408,Brent Sutter,1998-99,36.0,19,8,52,52,2,6,8,43.0,,1111,363,466,829,2396.0,82,5.28,57,380,2242,9.6,0.26313162
3409,3409,Brent Thompson,1992-93,22.0,2,5,27,27,0,5,5,18.0,,27,0,5,5,18.0,80,6.96,77,402,2440,11.4,0.20198256
3410,3410,Brent Thompson,1993-94,23.0,3,4,30,30,0,4,4,18.0,,57,0,9,9,36.0,84,7.25,87,443,2603,11.7,0.1692284
3411,3411,Brent Thompson,1994-95,24.0,4,1,24,24,1,0,1,9.0,,81,1,9,10,45.0,84,6.48,76,407,2545,10.7,0.1267631
3412,3412,Brent Thompson,1995-96,25.0,5,0,29,29,0,0,0,16.0,,110,1,9,10,61.0,48,5.97,37,209,1408,10.2,0.13317746
3413,3413,Brent Thompson,1996-97,26.0,6,1,10,10,0,1,1,7.0,,120,1,10,11,68.0,82,6.29,74,413,2481,10.4,0.13420486
3414,3414,Brent Thompson,1997-98,27.0,7,0,1,1,0,0,0,0.0,,121,1,10,11,68.0,82,5.83,55,336,2444,9.8,0.122951984
3415,3415,Bret Hedican,1992-93,22.0,2,1,4,4,1,0,1,1.0,,4,1,0,1,1.0,80,6.96,77,402,2440,11.4,0.26788548
3416,3416,Bret Hedican,1993-94,23.0,3,8,42,42,0,8,8,40.0,,46,1,8,9,41.0,84,7.25,87,443,2603,11.7,0.1820083
3417,3417,Bret Hedican,1994-95,24.0,4,12,69,69,0,12,12,88.0,,115,1,20,21,129.0,84,6.48,76,407,2545,10.7,0.19135231
3418,3418,Bret Hedican,1995-96,25.0,5,13,45,45,2,11,13,56.0,,160,3,31,34,185.0,48,5.97,37,209,1408,10.2,0.26439255
3419,3419,Bret Hedican,1996-97,26.0,6,29,77,77,6,23,29,113.0,,237,9,54,63,298.0,82,6.29,74,413,2481,10.4,0.34773034
3420,3420,Bret Hedican,1997-98,27.0,7,19,67,67,4,15,19,93.0,,304,13,69,82,391.0,82,5.83,55,336,2444,9.8,0.24864599
3421,3421,Bret Hedican,1998-99,28.0,8,27,71,71,3,24,27,84.0,,375,16,93,109,475.0,82,5.28,57,380,2242,9.6,0.31390986
3422,3422,Bret Hedican,1999-00,29.0,9,23,67,67,5,18,23,90.0,1344.0,442,21,111,132,565.0,82,5.27,57,359,2285,9.4,0.29152712
3423,3423,Bret Hedican,2000-01,30.0,10,25,76,76,6,19,25,58.0,1489.0,518,27,130,157,623.0,82,5.49,53,331,2294,9.8,0.2686322
3424,3424,Bret Hedican,2001-02,31.0,11,20,70,70,5,15,20,104.0,1527.0,588,32,145,177,727.0,82,5.51,63,376,2272,9.9,0.2633987
3425,3425,Bret Hedican,2002-03,32.0,12,16,57,57,5,11,16,85.0,1355.0,645,37,156,193,812.0,82,5.24,53,338,2262,9.5,0.2632516
3426,3426,Bret Hedican,2003-04,33.0,13,17,72,72,3,14,17,113.0,1658.0,717,40,170,210,925.0,82,5.31,60,363,2326,9.4,0.22433883
3427,3427,Bret Hedican,2004-05,34.0,14,24,81,81,7,17,24,112.0,1829.0,798,47,187,234,1037.0,82,5.14,57,348,2300,9.2,0.29102296
3428,3428,Bret Hedican,2006-07,36.0,15,27,74,74,5,22,27,73.0,1503.0,872,52,209,261,1110.0,82,6.05,85,480,2458,10.1,0.23185077
3429,3429,Bret Hedican,2007-08,37.0,16,10,50,50,0,10,10,44.0,998.0,922,52,219,271,1154.0,82,5.76,70,398,2426,9.7,0.14335164
3430,3430,Bret Hedican,2008-09,38.0,17,17,66,66,2,15,17,80.0,1273.0,988,54,234,288,1234.0,82,5.44,62,351,2383,9.4,0.1960133
3431,3431,Bret Hedican,2009-10,39.0,18,6,51,51,1,5,6,40.0,832.0,1039,55,239,294,1274.0,82,5.7,65,341,2477,9.4,0.12822449
3432,3432,Brett Bellemore,2013-14,25.0,2,2,8,8,0,2,2,3.0,110.0,8,0,2,2,3.0,48,5.31,29,160,1399,9.1,0.21030977
3433,3433,Brett Bellemore,2014-15,26.0,3,8,64,64,2,6,8,54.0,1118.0,72,2,8,10,57.0,82,5.34,48,269,2463,8.9,0.1505931
3434,3434,Brett Bellemore,2015-16,27.0,4,10,49,49,2,8,10,26.0,802.0,121,4,16,20,83.0,82,5.32,47,251,2453,8.9,0.16181332
3435,3435,Brett Bulmer,2012-13,20.0,2,3,9,9,0,3,3,7.0,99.0,9,0,3,3,7.0,82,5.32,47,271,2439,8.9,0.26818722
3436,3436,Brett Bulmer,2014-15,22.0,3,0,5,5,0,0,0,7.0,53.0,14,0,3,3,14.0,82,5.34,48,269,2463,8.9,0.16842514
3437,3437,Brett Bulmer,2016-17,24.0,4,0,3,3,0,0,0,2.0,20.0,17,0,3,3,16.0,82,5.34,48,255,2438,9.0,0.15033841
3438,3438,Brett Callighen,1980-81,27.0,2,58,59,59,23,35,58,159.0,,59,23,35,58,159.0,80,7.03,61,280,2352,12.0,0.8661013
3439,3439,Brett Callighen,1981-82,28.0,3,60,55,55,25,35,60,127.0,,114,48,70,118,286.0,80,7.69,77,340,2441,12.6,0.77695954
3440,3440,Brett Callighen,1982-83,29.0,4,27,46,46,8,19,27,87.0,,160,56,89,145,373.0,80,8.03,73,320,2489,12.9,0.5553901
3441,3441,Brett Carson,2009-10,24.0,2,0,5,5,0,0,0,2.0,79.0,5,0,0,0,2.0,82,5.7,65,341,2477,9.4,0.16960749
3442,3442,Brett Carson,2010-11,25.0,3,12,54,54,2,10,12,42.0,938.0,59,2,10,12,44.0,82,5.53,56,304,2486,9.1,0.18414631
3443,3443,Brett Carson,2011-12,26.0,4,0,19,19,0,0,0,12.0,217.0,78,2,10,12,56.0,82,5.46,52,291,2492,9.0,0.10770118
3444,3444,Brett Carson,2012-13,27.0,5,0,2,2,0,0,0,1.0,23.0,80,2,10,12,57.0,82,5.32,47,271,2439,8.9,0.12404317
3445,3445,Brett Carson,2013-14,28.0,6,1,10,10,0,1,1,8.0,109.0,90,2,11,13,65.0,48,5.31,29,160,1399,9.1,0.13840333
3446,3446,Brett Clark,1998-99,22.0,2,1,41,41,1,0,1,26.0,,41,1,0,1,26.0,82,5.28,57,380,2242,9.6,0.15487704
3447,3447,Brett Clark,1999-00,23.0,3,4,61,61,2,2,4,36.0,804.0,102,3,2,5,62.0,82,5.27,57,359,2285,9.4,0.16930068
3448,3448,Brett Clark,2000-01,24.0,4,1,14,14,0,1,1,13.0,236.0,116,3,3,6,75.0,82,5.49,53,331,2294,9.8,0.17453903
3449,3449,Brett Clark,2001-02,25.0,5,3,28,28,1,2,3,35.0,505.0,144,4,5,9,110.0,82,5.51,63,376,2272,9.9,0.15194201
3450,3450,Brett Clark,2002-03,26.0,6,0,2,2,0,0,0,0.0,31.0,146,4,5,9,110.0,82,5.24,53,338,2262,9.5,0.12888274
3451,3451,Brett Clark,2004-05,28.0,7,2,12,12,1,1,2,14.0,125.0,158,5,6,11,124.0,82,5.14,57,348,2300,9.2,0.20972407
3452,3452,Brett Clark,2006-07,30.0,8,36,80,80,9,27,36,148.0,1572.0,238,14,33,47,272.0,82,6.05,85,480,2458,10.1,0.37685812
3453,3453,Brett Clark,2007-08,31.0,9,39,82,82,10,29,39,140.0,1942.0,320,24,62,86,412.0,82,5.76,70,398,2426,9.7,0.39022928
3454,3454,Brett Clark,2008-09,32.0,10,21,57,57,5,16,21,87.0,1320.0,377,29,78,107,499.0,82,5.44,62,351,2383,9.4,0.2984621
3455,3455,Brett Clark,2009-10,33.0,11,12,76,76,2,10,12,97.0,1697.0,453,31,88,119,596.0,82,5.7,65,341,2477,9.4,0.18748921
3456,3456,Brett Clark,2010-11,34.0,12,20,64,64,3,17,20,75.0,1225.0,517,34,105,139,671.0,82,5.53,56,304,2486,9.1,0.2319468
3457,3457,Brett Clark,2011-12,35.0,13,31,82,82,9,22,31,87.0,1548.0,599,43,127,170,758.0,82,5.46,52,291,2492,9.0,0.29677048
3458,3458,Brett Clark,2012-13,36.0,14,15,82,82,2,13,15,61.0,1507.0,681,45,140,185,819.0,82,5.32,47,271,2439,8.9,0.14761177
3459,3459,Brett Clark,2013-14,37.0,15,1,8,8,0,1,1,6.0,113.0,689,45,141,186,825.0,48,5.31,29,160,1399,9.1,0.11286193
3460,3460,Brett Connolly,2012-13,20.0,2,15,68,68,4,11,15,94.0,780.0,68,4,11,15,94.0,82,5.32,47,271,2439,8.9,0.27483648
3461,3461,Brett Connolly,2013-14,21.0,3,1,5,5,1,0,1,10.0,51.0,73,5,11,16,104.0,48,5.31,29,160,1399,9.1,0.30886075
3462,3462,Brett Connolly,2014-15,22.0,4,1,11,11,1,0,1,12.0,132.0,84,6,11,17,116.0,82,5.34,48,269,2463,8.9,0.25188768
3463,3463,Brett Connolly,2015-16,23.0,5,17,55,55,12,5,17,83.0,668.0,139,18,16,34,199.0,82,5.32,47,251,2453,8.9,0.31497902
3464,3464,Brett Connolly,2016-17,24.0,6,25,71,71,9,16,25,95.0,920.0,210,27,32,59,294.0,82,5.34,48,255,2438,9.0,0.332855
3465,3465,Brett Connolly,2017-18,25.0,7,23,66,66,15,8,23,81.0,706.0,276,42,40,82,375.0,82,5.45,47,245,2478,9.0,0.33641055
3466,3466,Brett Connolly,2018-19,26.0,8,27,70,70,15,12,27,67.0,840.0,346,57,52,109,442.0,82,5.86,50,250,2620,9.2,0.34270027
3467,3467,Brett Connolly,2019-20,27.0,9,46,81,81,22,24,46,139.0,1080.0,427,79,76,155,581.0,82,5.96,47,239,2579,9.5,0.4972558
3468,3468,Brett Connolly,2020-21,28.0,10,33,69,69,19,14,33,117.0,1000.0,496,98,90,188,698.0,70,5.96,42,208,2192,9.5,0.4217961
3469,3469,Brett Festerling,2009-10,23.0,2,5,40,40,0,5,5,15.0,667.0,40,0,5,5,15.0,82,5.7,65,341,2477,9.4,0.12479162
3470,3470,Brett Festerling,2010-11,24.0,3,3,42,42,0,3,3,25.0,525.0,82,0,8,8,40.0,82,5.53,56,304,2486,9.1,0.11691433
3471,3471,Brett Festerling,2011-12,25.0,4,0,1,1,0,0,0,0.0,15.0,83,0,8,8,40.0,82,5.46,52,291,2492,9.0,0.1272004
3472,3472,Brett Festerling,2012-13,26.0,5,0,5,5,0,0,0,2.0,66.0,88,0,8,8,42.0,82,5.32,47,271,2439,8.9,0.13560846
3473,3473,Brett Gallant,2014-15,26.0,2,0,4,4,0,0,0,3.0,28.0,4,0,0,0,3.0,82,5.34,48,269,2463,8.9,0.16342145
3474,3474,Brett Harkins,1995-96,25.0,2,1,1,1,0,1,1,1.0,,1,0,1,1,1.0,48,5.97,37,209,1408,10.2,0.2115035
3475,3475,Brett Harkins,1996-97,26.0,3,3,8,8,0,3,3,4.0,,9,0,4,4,5.0,82,6.29,74,413,2481,10.4,0.18665013
3476,3476,Brett Harkins,1997-98,27.0,4,18,44,44,4,14,18,52.0,,53,4,18,22,57.0,82,5.83,55,336,2444,9.8,0.29095587
3477,3477,Brett Harkins,2002-03,32.0,5,14,25,25,2,12,14,9.0,316.0,78,6,30,36,66.0,82,5.24,53,338,2262,9.5,0.20778379
3478,3478,Brett Hauer,1996-97,25.0,2,6,29,29,4,2,6,53.0,,29,4,2,6,53.0,82,6.29,74,413,2481,10.4,0.2411904
3479,3479,Brett Hauer,2000-01,29.0,3,2,5,5,0,2,2,8.0,74.0,34,4,4,8,61.0,82,5.49,53,331,2294,9.8,0.15360525
3480,3480,Brett Hauer,2002-03,31.0,4,0,3,3,0,0,0,2.0,31.0,37,4,4,8,63.0,82,5.24,53,338,2262,9.5,0.14267358
3481,3481,Brett Howden,2019-20,21.0,2,23,66,66,6,17,23,74.0,986.0,66,6,17,23,74.0,82,5.96,47,239,2579,9.5,0.38181618
3482,3482,Brett Howden,2020-21,22.0,3,19,70,70,9,10,19,64.0,920.0,136,15,27,42,138.0,70,5.96,42,208,2192,9.5,0.3336169
3483,3483,Brett Hull,1987-88,23.0,2,1,5,5,1,0,1,5.0,,5,1,0,1,5.0,80,7.34,72,344,2400,12.2,0.27644014
3484,3484,Brett Hull,1988-89,24.0,3,64,65,65,32,32,64,211.0,,70,33,32,65,216.0,80,7.43,89,437,2435,12.2,0.91228557
3485,3485,Brett Hull,1989-90,25.0,4,84,78,78,41,43,84,305.0,,148,74,75,149,521.0,80,7.48,85,403,2430,12.3,1.0554149
3486,3486,Brett Hull,1990-91,26.0,5,113,80,80,72,41,113,385.0,,228,146,116,262,906.0,80,7.37,76,367,2421,12.2,1.3308692
3487,3487,Brett Hull,1991-92,27.0,6,131,78,78,86,45,131,389.0,,306,232,161,393,1295.0,80,6.91,71,366,2385,11.6,1.4248779
3488,3488,Brett Hull,1992-93,28.0,7,109,73,73,70,39,109,408.0,,379,302,200,502,1703.0,80,6.96,77,402,2440,11.4,1.262189
3489,3489,Brett Hull,1993-94,29.0,8,101,80,80,54,47,101,390.0,,459,356,247,603,2093.0,84,7.25,87,443,2603,11.7,1.0364201
3490,3490,Brett Hull,1994-95,30.0,9,97,81,81,57,40,97,392.0,,540,413,287,700,2485.0,84,6.48,76,407,2545,10.7,0.9906746
3491,3491,Brett Hull,1995-96,31.0,10,50,48,48,29,21,50,200.0,,588,442,308,750,2685.0,48,5.97,37,209,1408,10.2,1.020449
3492,3492,Brett Hull,1996-97,32.0,11,83,70,70,43,40,83,327.0,,658,485,348,833,3012.0,82,6.29,74,413,2481,10.4,0.9243226
3493,3493,Brett Hull,1997-98,33.0,12,82,77,77,42,40,82,302.0,,735,527,388,915,3314.0,82,5.83,55,336,2444,9.8,1.0082362
3494,3494,Brett Hull,1998-99,34.0,13,72,66,66,27,45,72,211.0,,801,554,433,987,3525.0,82,5.28,57,380,2242,9.6,0.9263021
3495,3495,Brett Hull,1999-00,35.0,14,58,60,60,32,26,58,192.0,1044.0,861,586,459,1045,3717.0,82,5.27,57,359,2285,9.4,0.9118805
3496,3496,Brett Hull,2000-01,36.0,15,59,79,79,24,35,59,223.0,1470.0,940,610,494,1104,3940.0,82,5.49,53,331,2294,9.8,0.7227305
3497,3497,Brett Hull,2001-02,37.0,16,79,79,79,39,40,79,219.0,1413.0,1019,649,534,1183,4159.0,82,5.51,63,376,2272,9.9,0.7906637
3498,3498,Brett Hull,2002-03,38.0,17,63,82,82,30,33,63,247.0,1543.0,1101,679,567,1246,4406.0,82,5.24,53,338,2262,9.5,0.7001865
3499,3499,Brett Hull,2003-04,39.0,18,76,82,82,37,39,76,262.0,1486.0,1183,716,606,1322,4668.0,82,5.31,60,363,2326,9.4,0.7884275
3500,3500,Brett Hull,2004-05,40.0,19,68,81,81,25,43,68,200.0,1369.0,1264,741,649,1390,4868.0,82,5.14,57,348,2300,9.2,0.5694968
3501,3501,Brett Hull,2006-07,42.0,20,1,5,5,0,1,1,8.0,69.0,1269,741,650,1391,4876.0,82,6.05,85,480,2458,10.1,0.2738859
3502,3502,Brett Kulak,2015-16,22.0,2,0,1,1,0,0,0,0.0,20.0,1,0,0,0,0.0,82,5.32,47,251,2453,8.9,0.14922687
3503,3503,Brett Kulak,2016-17,23.0,3,0,8,8,0,0,0,9.0,99.0,9,0,0,0,9.0,82,5.34,48,255,2438,9.0,0.1788753
3504,3504,Brett Kulak,2017-18,24.0,4,3,21,21,0,3,3,19.0,299.0,30,0,3,3,28.0,82,5.45,47,245,2478,9.0,0.15405107
3505,3505,Brett Kulak,2018-19,25.0,5,8,71,71,2,6,8,73.0,922.0,101,2,9,11,101.0,82,5.86,50,250,2620,9.2,0.18010876
3506,3506,Brett Kulak,2019-20,26.0,6,17,57,57,6,11,17,102.0,1017.0,158,8,20,28,203.0,82,5.96,47,239,2579,9.5,0.26824465
3507,3507,Brett Kulak,2020-21,27.0,7,7,56,56,0,7,7,101.0,960.0,214,8,27,35,304.0,70,5.96,42,208,2192,9.5,0.17442742
3508,3508,Brett Lebda,2006-07,25.0,2,12,46,46,3,9,12,50.0,581.0,46,3,9,12,50.0,82,6.05,85,480,2458,10.1,0.20336834
3509,3509,Brett Lebda,2007-08,26.0,3,18,74,74,5,13,18,107.0,1103.0,120,8,22,30,157.0,82,5.76,70,398,2426,9.7,0.25948772
3510,3510,Brett Lebda,2008-09,27.0,4,14,78,78,3,11,14,110.0,1285.0,198,11,33,44,267.0,82,5.44,62,351,2383,9.4,0.208702
3511,3511,Brett Lebda,2009-10,28.0,5,16,65,65,6,10,16,69.0,887.0,263,17,43,60,336.0,82,5.7,65,341,2477,9.4,0.22115085
3512,3512,Brett Lebda,2010-11,29.0,6,8,63,63,1,7,8,61.0,944.0,326,18,50,68,397.0,82,5.53,56,304,2486,9.1,0.15075114
3513,3513,Brett Lebda,2011-12,30.0,7,4,41,41,1,3,4,34.0,547.0,367,19,53,72,431.0,82,5.46,52,291,2492,9.0,0.14521793
3514,3514,Brett Lebda,2012-13,31.0,8,4,30,30,1,3,4,36.0,494.0,397,20,56,76,467.0,82,5.32,47,271,2439,8.9,0.15680203
3515,3515,Brett Lernout,2016-17,21.0,2,0,1,1,0,0,0,0.0,7.0,1,0,0,0,0.0,82,5.34,48,255,2438,9.0,0.19211695
3516,3516,Brett Lernout,2017-18,22.0,3,0,2,2,0,0,0,3.0,38.0,3,0,0,0,3.0,82,5.45,47,245,2478,9.0,0.18688416
3517,3517,Brett Lernout,2018-19,23.0,4,1,18,18,0,1,1,14.0,301.0,21,0,1,1,17.0,82,5.86,50,250,2620,9.2,0.17596534
3518,3518,Brett Lindros,1995-96,20.0,2,4,33,33,1,3,4,35.0,,33,1,3,4,35.0,48,5.97,37,209,1408,10.2,0.255287
3519,3519,Brett Lindros,1996-97,21.0,3,3,18,18,1,2,3,10.0,,51,2,5,7,45.0,82,6.29,74,413,2481,10.4,0.25710356
3520,3520,Brett Lysak,2004-05,24.0,2,0,2,2,0,0,0,0.0,7.0,2,0,0,0,0.0,82,5.14,57,348,2300,9.2,0.19176829
3521,3521,Brett MacDonald,1988-89,23.0,2,0,1,1,0,0,0,0.0,,1,0,0,0,0.0,80,7.43,89,437,2435,12.2,0.18171716
3522,3522,Brett Maclean,2011-12,23.0,2,3,13,13,2,1,3,16.0,114.0,13,2,1,3,16.0,82,5.46,52,291,2492,9.0,0.25042948
3523,3523,Brett Maclean,2012-13,24.0,3,2,5,5,0,2,2,6.0,42.0,18,2,3,5,22.0,82,5.32,47,271,2439,8.9,0.16668138
3524,3524,Brett McLean,2003-04,25.0,2,0,2,2,0,0,0,1.0,22.0,2,0,0,0,1.0,82,5.31,60,363,2326,9.4,0.1731137
3525,3525,Brett McLean,2004-05,26.0,3,31,76,76,11,20,31,125.0,1334.0,78,11,20,31,126.0,82,5.14,57,348,2300,9.2,0.44918138
3526,3526,Brett McLean,2006-07,28.0,4,40,82,82,9,31,40,115.0,1001.0,160,20,51,71,241.0,82,6.05,85,480,2458,10.1,0.4057725
3527,3527,Brett McLean,2007-08,29.0,5,35,78,78,15,20,35,134.0,1063.0,238,35,71,106,375.0,82,5.76,70,398,2426,9.7,0.43765032
3528,3528,Brett McLean,2008-09,30.0,6,37,67,67,14,23,37,140.0,1088.0,305,49,94,143,515.0,82,5.44,62,351,2383,9.4,0.48988652
3529,3529,Brett McLean,2009-10,31.0,7,19,80,80,7,12,19,114.0,994.0,385,56,106,162,629.0,82,5.7,65,341,2477,9.4,0.29941192
3530,3530,Brett Pesce,2016-17,22.0,2,16,69,69,4,12,16,85.0,1295.0,69,4,12,16,85.0,82,5.34,48,255,2438,9.0,0.25748304
3531,3531,Brett Pesce,2017-18,23.0,3,20,82,82,2,18,20,109.0,1739.0,151,6,30,36,194.0,82,5.45,47,245,2478,9.0,0.28029817
3532,3532,Brett Pesce,2018-19,24.0,4,19,65,65,3,16,19,88.0,1359.0,216,9,46,55,282.0,82,5.86,50,250,2620,9.2,0.26770675
3533,3533,Brett Pesce,2019-20,25.0,5,29,73,73,7,22,29,98.0,1496.0,289,16,68,84,380.0,82,5.96,47,239,2579,9.5,0.35413152
3534,3534,Brett Pesce,2020-21,26.0,6,18,61,61,4,14,18,104.0,1335.0,350,20,82,102,484.0,70,5.96,42,208,2192,9.5,0.3438061
3535,3535,Brett Ritchie,2015-16,22.0,2,9,31,31,6,3,9,78.0,434.0,31,6,3,9,78.0,82,5.32,47,251,2453,8.9,0.34154582
3536,3536,Brett Ritchie,2016-17,23.0,3,1,8,8,0,1,1,15.0,93.0,39,6,4,10,93.0,82,5.34,48,255,2438,9.0,0.23343676
3537,3537,Brett Ritchie,2017-18,24.0,4,24,78,78,16,8,24,167.0,1006.0,117,22,12,34,260.0,82,5.45,47,245,2478,9.0,0.39395398
3538,3538,Brett Ritchie,2018-19,25.0,5,14,71,71,7,7,14,117.0,770.0,188,29,19,48,377.0,82,5.86,50,250,2620,9.2,0.23124593
3539,3539,Brett Ritchie,2019-20,26.0,6,6,53,53,4,2,6,57.0,509.0,241,33,21,54,434.0,82,5.96,47,239,2579,9.5,0.18086848
3540,3540,Brett Ritchie,2020-21,27.0,7,6,27,27,2,4,6,34.0,281.0,268,35,25,60,468.0,70,5.96,42,208,2192,9.5,0.24123031
3541,3541,Brett Seney,2019-20,23.0,2,13,51,51,5,8,13,49.0,527.0,51,5,8,13,49.0,82,5.96,47,239,2579,9.5,0.27107784
3542,3542,Brett Seney,2020-21,24.0,3,0,2,2,0,0,0,1.0,20.0,53,5,8,13,50.0,70,5.96,42,208,2192,9.5,0.18756402
3543,3543,Brett Skinner,2009-10,26.0,2,0,11,11,0,0,0,5.0,129.0,11,0,0,0,5.0,82,5.7,65,341,2477,9.4,0.16107228
3544,3544,Brett Sterling,2008-09,24.0,2,3,13,13,1,2,3,14.0,161.0,13,1,2,3,14.0,82,5.44,62,351,2383,9.4,0.22361878
3545,3545,Brett Sterling,2009-10,25.0,3,1,6,6,1,0,1,11.0,83.0,19,2,2,4,25.0,82,5.7,65,341,2477,9.4,0.19540057
3546,3546,Brett Sterling,2011-12,27.0,4,5,7,7,3,2,5,14.0,106.0,26,5,4,9,39.0,82,5.46,52,291,2492,9.0,0.22313264
3547,3547,Brett Sterling,2012-13,28.0,5,0,4,4,0,0,0,5.0,30.0,30,5,4,9,44.0,82,5.32,47,271,2439,8.9,0.13368377
3548,3548,Brett Sutter,2009-10,22.0,2,1,4,4,1,0,1,6.0,32.0,4,1,0,1,6.0,82,5.7,65,341,2477,9.4,0.2379362
3549,3549,Brett Sutter,2010-11,23.0,3,0,10,10,0,0,0,9.0,97.0,14,1,0,1,15.0,82,5.53,56,304,2486,9.1,0.1679978
3550,3550,Brett Sutter,2011-12,24.0,4,1,5,5,0,1,1,3.0,45.0,19,1,1,2,18.0,82,5.46,52,291,2492,9.0,0.16005749
3551,3551,Brett Sutter,2012-13,25.0,5,3,15,15,0,3,3,11.0,114.0,34,1,4,5,29.0,82,5.32,47,271,2439,8.9,0.1680741
3552,3552,Brett Sutter,2013-14,26.0,6,0,3,3,0,0,0,2.0,25.0,37,1,4,5,31.0,48,5.31,29,160,1399,9.1,0.15409091
3553,3553,Brett Sutter,2014-15,27.0,7,2,17,17,1,1,2,16.0,129.0,54,2,5,7,47.0,82,5.34,48,269,2463,8.9,0.16001102
3554,3554,Brett Sutter,2015-16,28.0,8,3,6,6,0,3,3,6.0,56.0,60,2,8,10,53.0,82,5.32,47,251,2453,8.9,0.14719182
3555,3555,Brian Bellows,1983-84,19.0,2,65,78,78,35,30,65,184.0,,78,35,30,65,184.0,80,7.73,71,310,2444,12.7,0.8970536
3556,3556,Brian Bellows,1984-85,20.0,3,83,78,78,41,42,83,236.0,,156,76,72,148,420.0,80,7.89,74,336,2448,12.9,0.9884215
3557,3557,Brian Bellows,1985-86,21.0,4,62,78,78,26,36,62,210.0,,234,102,108,210,630.0,80,7.77,71,321,2447,12.7,0.8996943
3558,3558,Brian Bellows,1986-87,22.0,5,79,77,77,31,48,79,256.0,,311,133,156,289,886.0,80,7.94,82,370,2484,12.8,0.9348533
3559,3559,Brian Bellows,1987-88,23.0,6,53,65,65,26,27,53,200.0,,376,159,183,342,1086.0,80,7.34,72,344,2400,12.2,0.88984084
3560,3560,Brian Bellows,1988-89,24.0,7,81,77,77,40,41,81,283.0,,453,199,224,423,1369.0,80,7.43,89,437,2435,12.2,1.0608013
3561,3561,Brian Bellows,1989-90,25.0,8,50,60,60,23,27,50,196.0,,513,222,251,473,1565.0,80,7.48,85,403,2430,12.3,0.9373076
3562,3562,Brian Bellows,1990-91,26.0,9,99,80,80,55,44,99,300.0,,593,277,295,572,1865.0,80,7.37,76,367,2421,12.2,1.0682089
3563,3563,Brian Bellows,1991-92,27.0,10,75,80,80,35,40,75,296.0,,673,312,335,647,2161.0,80,6.91,71,366,2385,11.6,0.888679
3564,3564,Brian Bellows,1992-93,28.0,11,75,80,80,30,45,75,255.0,,753,342,380,722,2416.0,80,6.96,77,402,2440,11.4,0.96392083
3565,3565,Brian Bellows,1993-94,29.0,12,88,82,82,40,48,88,260.0,,835,382,428,810,2676.0,84,7.25,87,443,2603,11.7,0.91923237
3566,3566,Brian Bellows,1994-95,30.0,13,71,77,77,33,38,71,251.0,,912,415,466,881,2927.0,84,6.48,76,407,2545,10.7,0.7624843
3567,3567,Brian Bellows,1995-96,31.0,14,16,41,41,8,8,16,110.0,,953,423,474,897,3037.0,48,5.97,37,209,1408,10.2,0.54148424
3568,3568,Brian Bellows,1996-97,32.0,15,49,79,79,23,26,49,190.0,,1032,446,500,946,3227.0,82,6.29,74,413,2481,10.4,0.58534753
3569,3569,Brian Bellows,1997-98,33.0,16,31,69,69,16,15,31,168.0,,1101,462,515,977,3395.0,82,5.83,55,336,2444,9.8,0.56487495
3570,3570,Brian Bellows,1998-99,34.0,17,9,11,11,6,3,9,26.0,,1112,468,518,986,3421.0,82,5.28,57,380,2242,9.6,0.5611635
3571,3571,Brian Bellows,1999-00,35.0,18,36,76,76,17,19,36,166.0,1158.0,1188,485,537,1022,3587.0,82,5.27,57,359,2285,9.4,0.5617706
3572,3572,Brian Benning,1985-86,19.0,2,2,4,4,0,2,2,2.0,,4,0,2,2,2.0,80,7.77,71,321,2447,12.7,0.3362171
3573,3573,Brian Benning,1987-88,21.0,3,49,78,78,13,36,49,144.0,,82,13,38,51,146.0,80,7.34,72,344,2400,12.2,0.6733185
3574,3574,Brian Benning,1988-89,22.0,4,37,77,77,8,29,37,130.0,,159,21,67,88,276.0,80,7.43,89,437,2435,12.2,0.51432955
3575,3575,Brian Benning,1989-90,23.0,5,34,66,66,8,26,34,91.0,,225,29,93,122,367.0,80,7.48,85,403,2430,12.3,0.5066262
3576,3576,Brian Benning,1990-91,24.0,6,25,55,55,6,19,25,122.0,,280,35,112,147,489.0,80,7.37,76,367,2421,12.2,0.4849989
3577,3577,Brian Benning,1991-92,25.0,7,31,61,61,7,24,31,120.0,,341,42,136,178,609.0,80,6.91,71,366,2385,11.6,0.5849581
3578,3578,Brian Benning,1992-93,26.0,8,46,75,75,4,42,46,152.0,,416,46,178,224,761.0,80,6.96,77,402,2440,11.4,0.51281255
3579,3579,Brian Benning,1993-94,27.0,9,34,55,55,10,24,34,115.0,,471,56,202,258,876.0,84,7.25,87,443,2603,11.7,0.5193129
3580,3580,Brian Benning,1994-95,28.0,10,30,73,73,6,24,30,112.0,,544,62,226,288,988.0,84,6.48,76,407,2545,10.7,0.39703423
3581,3581,Brian Benning,1995-96,29.0,11,8,24,24,1,7,8,26.0,,568,63,233,296,1014.0,48,5.97,37,209,1408,10.2,0.2660914
3582,3582,Brian Bonin,1999-00,26.0,2,0,5,5,0,0,0,2.0,62.0,5,0,0,0,2.0,82,5.27,57,359,2285,9.4,0.16484177
3583,3583,Brian Bonin,2001-02,28.0,3,0,7,7,0,0,0,7.0,68.0,12,0,0,0,9.0,82,5.51,63,376,2272,9.9,0.1603961
3584,3584,Brian Boyle,2008-09,24.0,2,5,8,8,4,1,5,19.0,109.0,8,4,1,5,19.0,82,5.44,62,351,2383,9.4,0.28451428
3585,3585,Brian Boyle,2009-10,25.0,3,5,28,28,4,1,5,36.0,284.0,36,8,2,10,55.0,82,5.7,65,341,2477,9.4,0.21377763
3586,3586,Brian Boyle,2010-11,26.0,4,6,71,71,4,2,6,73.0,598.0,107,12,4,16,128.0,82,5.53,56,304,2486,9.1,0.19603837
3587,3587,Brian Boyle,2011-12,27.0,5,35,82,82,21,14,35,218.0,1291.0,189,33,18,51,346.0,82,5.46,52,291,2492,9.0,0.44876283
3588,3588,Brian Boyle,2012-13,28.0,6,26,82,82,11,15,26,165.0,1250.0,271,44,33,77,511.0,82,5.32,47,271,2439,8.9,0.3180173
3589,3589,Brian Boyle,2013-14,29.0,7,5,38,38,2,3,5,56.0,540.0,309,46,36,82,567.0,48,5.31,29,160,1399,9.1,0.20032945
3590,3590,Brian Boyle,2014-15,30.0,8,18,82,82,6,12,18,137.0,1047.0,391,52,48,100,704.0,82,5.34,48,269,2463,8.9,0.27605456
3591,3591,Brian Boyle,2015-16,31.0,9,24,82,82,15,9,24,140.0,1065.0,473,67,57,124,844.0,82,5.32,47,251,2453,8.9,0.2940895
3592,3592,Brian Boyle,2016-17,32.0,10,20,76,76,13,7,20,117.0,981.0,549,80,64,144,961.0,82,5.34,48,255,2438,9.0,0.25920457
3593,3593,Brian Boyle,2017-18,33.0,11,25,75,75,13,12,25,131.0,977.0,624,93,76,169,1092.0,82,5.45,47,245,2478,9.0,0.29638904
3594,3594,Brian Boyle,2018-19,34.0,12,23,69,69,13,10,23,120.0,917.0,693,106,86,192,1212.0,82,5.86,50,250,2620,9.2,0.29886407
3595,3595,Brian Boyle,2019-20,35.0,13,24,73,73,18,6,24,123.0,981.0,766,124,92,216,1335.0,82,5.96,47,239,2579,9.5,0.2859658
3596,3596,Brian Boyle,2020-21,36.0,14,15,39,39,6,9,15,56.0,483.0,805,130,101,231,1391.0,70,5.96,42,208,2192,9.5,0.3218509
3597,3597,Brian Bradley,1986-87,22.0,2,1,5,5,0,1,1,4.0,,5,0,1,1,4.0,80,7.94,82,370,2484,12.8,0.2450163
3598,3598,Brian Bradley,1987-88,23.0,3,28,40,40,10,18,28,64.0,,45,10,19,29,68.0,80,7.34,72,344,2400,12.2,0.5418273
3599,3599,Brian Bradley,1988-89,24.0,4,8,11,11,3,5,8,26.0,,56,13,24,37,94.0,80,7.43,89,437,2435,12.2,0.4721868
3600,3600,Brian Bradley,1989-90,25.0,5,45,71,71,18,27,45,151.0,,127,31,51,82,245.0,80,7.48,85,403,2430,12.3,0.5617785
3601,3601,Brian Bradley,1990-91,26.0,6,48,67,67,19,29,48,121.0,,194,50,80,130,366.0,80,7.37,76,367,2421,12.2,0.644495
3602,3602,Brian Bradley,1991-92,27.0,7,42,70,70,11,31,42,116.0,,264,61,111,172,482.0,80,6.91,71,366,2385,11.6,0.54129356
3603,3603,Brian Bradley,1992-93,28.0,8,31,59,59,10,21,31,78.0,,323,71,132,203,560.0,80,6.96,77,402,2440,11.4,0.5755519
3604,3604,Brian Bradley,1993-94,29.0,9,86,80,80,42,44,86,205.0,,403,113,176,289,765.0,84,7.25,87,443,2603,11.7,0.8995547
3605,3605,Brian Bradley,1994-95,30.0,10,64,78,78,24,40,64,180.0,,481,137,216,353,945.0,84,6.48,76,407,2545,10.7,0.68413544
3606,3606,Brian Bradley,1995-96,31.0,11,40,46,46,13,27,40,111.0,,527,150,243,393,1056.0,48,5.97,37,209,1408,10.2,0.7563795
3607,3607,Brian Bradley,1996-97,32.0,12,79,75,75,23,56,79,189.0,,602,173,299,472,1245.0,82,6.29,74,413,2481,10.4,0.7226749
3608,3608,Brian Bradley,1997-98,33.0,13,24,35,35,7,17,24,93.0,,637,180,316,496,1338.0,82,5.83,55,336,2444,9.8,0.53395164
3609,3609,Brian Bradley,1998-99,34.0,14,7,14,14,2,5,7,24.0,,651,182,321,503,1362.0,82,5.28,57,380,2242,9.6,0.35449177
3610,3610,Brian Campbell,2000-01,21.0,2,5,12,12,1,4,5,10.0,190.0,12,1,4,5,10.0,82,5.49,53,331,2294,9.8,0.25708735
3611,3611,Brian Campbell,2001-02,22.0,3,0,8,8,0,0,0,7.0,125.0,20,1,4,5,17.0,82,5.51,63,376,2272,9.9,0.15751225
3612,3612,Brian Campbell,2002-03,23.0,4,6,29,29,3,3,6,30.0,444.0,49,4,7,11,47.0,82,5.24,53,338,2262,9.5,0.2523209
3613,3613,Brian Campbell,2003-04,24.0,5,19,65,65,2,17,19,90.0,1213.0,114,6,24,30,137.0,82,5.31,60,363,2326,9.4,0.27267265
3614,3614,Brian Campbell,2004-05,25.0,6,11,53,53,3,8,11,45.0,850.0,167,9,32,41,182.0,82,5.14,57,348,2300,9.2,0.21601689
3615,3615,Brian Campbell,2006-07,27.0,7,44,79,79,12,32,44,105.0,1399.0,246,21,64,85,287.0,82,6.05,85,480,2458,10.1,0.44094196
3616,3616,Brian Campbell,2007-08,28.0,8,48,82,82,6,42,48,92.0,1794.0,328,27,106,133,379.0,82,5.76,70,398,2426,9.7,0.5324249
3617,3617,Brian Campbell,2008-09,29.0,9,62,83,83,8,54,62,142.0,2084.0,411,35,160,195,521.0,82,5.44,62,351,2383,9.4,0.6447723
3618,3618,Brian Campbell,2009-10,30.0,10,52,82,82,7,45,52,108.0,1851.0,493,42,205,247,629.0,82,5.7,65,341,2477,9.4,0.55918485
3619,3619,Brian Campbell,2010-11,31.0,11,38,68,68,7,31,38,131.0,1579.0,561,49,236,285,760.0,82,5.53,56,304,2486,9.1,0.4565934
3620,3620,Brian Campbell,2011-12,32.0,12,27,65,65,5,22,27,84.0,1494.0,626,54,258,312,844.0,82,5.46,52,291,2492,9.0,0.3286283
3621,3621,Brian Campbell,2012-13,33.0,13,53,82,82,4,49,53,131.0,2206.0,708,58,307,365,975.0,82,5.32,47,271,2439,8.9,0.5638688
3622,3622,Brian Campbell,2013-14,34.0,14,27,48,48,8,19,27,70.0,1268.0,756,66,326,392,1045.0,48,5.31,29,160,1399,9.1,0.43857902
3623,3623,Brian Campbell,2014-15,35.0,15,37,82,82,7,30,37,116.0,2211.0,838,73,356,429,1161.0,82,5.34,48,269,2463,8.9,0.3727657
3624,3624,Brian Campbell,2015-16,36.0,16,27,82,82,3,24,27,118.0,1903.0,920,76,380,456,1279.0,82,5.32,47,251,2453,8.9,0.28215095
3625,3625,Brian Campbell,2016-17,37.0,17,31,82,82,6,25,31,99.0,1827.0,1002,82,405,487,1378.0,82,5.34,48,255,2438,9.0,0.3261615
3626,3626,Brian Campbell,2017-18,38.0,18,17,80,80,5,12,17,74.0,1474.0,1082,87,417,504,1452.0,82,5.45,47,245,2478,9.0,0.21853799
3627,3627,Brian Chapman,1991-92,23.0,2,0,3,3,0,0,0,0.0,,3,0,0,0,0.0,80,6.91,71,366,2385,11.6,0.18703356
3628,3628,Brian Curran,1984-85,21.0,2,2,16,16,1,1,2,6.0,,16,1,1,2,6.0,80,7.89,74,336,2448,12.9,0.30035955
3629,3629,Brian Curran,1985-86,22.0,3,1,56,56,0,1,1,17.0,,72,1,2,3,23.0,80,7.77,71,321,2447,12.7,0.13993615
3630,3630,Brian Curran,1986-87,23.0,4,7,43,43,2,5,7,23.0,,115,3,7,10,46.0,80,7.94,82,370,2484,12.8,0.16162267
3631,3631,Brian Curran,1987-88,24.0,5,10,68,68,0,10,10,34.0,,183,3,17,20,80.0,80,7.34,72,344,2400,12.2,0.16087356
3632,3632,Brian Curran,1988-89,25.0,6,2,29,29,0,2,2,13.0,,212,3,19,22,93.0,80,7.43,89,437,2435,12.2,0.127094
3633,3633,Brian Curran,1989-90,26.0,7,5,47,47,1,4,5,18.0,,259,4,23,27,111.0,80,7.48,85,403,2430,12.3,0.11911744
3634,3634,Brian Curran,1990-91,27.0,8,11,72,72,2,9,11,21.0,,331,6,32,38,132.0,80,7.37,76,367,2421,12.2,0.14467427
3635,3635,Brian Curran,1991-92,28.0,9,1,21,21,0,1,1,7.0,,352,6,33,39,139.0,80,6.91,71,366,2385,11.6,0.08847782
3636,3636,Brian Curran,1992-93,29.0,10,0,3,3,0,0,0,1.0,,355,6,33,39,140.0,80,6.96,77,402,2440,11.4,0.11840892
3637,3637,Brian Curran,1994-95,31.0,11,1,26,26,1,0,1,11.0,,381,7,33,40,151.0,84,6.48,76,407,2545,10.7,0.07234076
3638,3638,Brian Dobbin,1987-88,21.0,2,3,12,12,2,1,3,13.0,,12,2,1,3,13.0,80,7.34,72,344,2400,12.2,0.35863072
3639,3639,Brian Dobbin,1988-89,22.0,3,8,21,21,3,5,8,15.0,,33,5,6,11,28.0,80,7.43,89,437,2435,12.2,0.32044196
3640,3640,Brian Dobbin,1989-90,23.0,4,1,14,14,0,1,1,13.0,,47,5,7,12,41.0,80,7.48,85,403,2430,12.3,0.23743647
3641,3641,Brian Dobbin,1990-91,24.0,5,2,9,9,1,1,2,11.0,,56,6,8,14,52.0,80,7.37,76,367,2421,12.2,0.23750776
3642,3642,Brian Dobbin,1992-93,26.0,6,1,7,7,1,0,1,4.0,,63,7,8,15,56.0,80,6.96,77,402,2440,11.4,0.21163425
3643,3643,Brian Dumoulin,2014-15,23.0,2,1,6,6,0,1,1,3.0,115.0,6,0,1,1,3.0,82,5.34,48,269,2463,8.9,0.19220155
3644,3644,Brian Dumoulin,2015-16,24.0,3,1,8,8,1,0,1,4.0,125.0,14,1,1,2,7.0,82,5.32,47,251,2453,8.9,0.18098512
3645,3645,Brian Dumoulin,2016-17,25.0,4,16,79,79,0,16,16,101.0,1492.0,93,1,17,18,108.0,82,5.34,48,255,2438,9.0,0.20954442
3646,3646,Brian Dumoulin,2017-18,26.0,5,15,70,70,1,14,15,78.0,1438.0,163,2,31,33,186.0,82,5.45,47,245,2478,9.0,0.1970838
3647,3647,Brian Dumoulin,2018-19,27.0,6,18,80,80,5,13,18,102.0,1649.0,243,7,44,51,288.0,82,5.86,50,250,2620,9.2,0.22378018
3648,3648,Brian Dumoulin,2019-20,28.0,7,23,76,76,3,20,23,99.0,1598.0,319,10,64,74,387.0,82,5.96,47,239,2579,9.5,0.25405312
3649,3649,Brian Dumoulin,2020-21,29.0,8,8,28,28,1,7,8,35.0,590.0,347,11,71,82,422.0,70,5.96,42,208,2192,9.5,0.22574925
3650,3650,Brian Fahey,2011-12,30.0,2,1,7,7,0,1,1,4.0,83.0,7,0,1,1,4.0,82,5.46,52,291,2492,9.0,0.14281368
3651,3651,Brian Felsner,1998-99,26.0,2,4,12,12,1,3,4,14.0,,12,1,3,4,14.0,82,5.28,57,380,2242,9.6,0.21111283
3652,3652,Brian Ferlin,2015-16,23.0,2,1,7,7,0,1,1,6.0,62.0,7,0,1,1,6.0,82,5.32,47,251,2453,8.9,0.19220155
3653,3653,Brian Flynn,2013-14,25.0,2,11,26,26,6,5,11,49.0,382.0,26,6,5,11,49.0,48,5.31,29,160,1399,9.1,0.33914655
3654,3654,Brian Flynn,2014-15,26.0,3,13,79,79,6,7,13,102.0,1139.0,105,12,12,24,151.0,82,5.34,48,269,2463,8.9,0.23073691
3655,3655,Brian Flynn,2015-16,27.0,4,17,63,63,5,12,17,82.0,939.0,168,17,24,41,233.0,82,5.32,47,251,2453,8.9,0.21984926
3656,3656,Brian Flynn,2016-17,28.0,5,10,56,56,4,6,10,73.0,657.0,224,21,30,51,306.0,82,5.34,48,255,2438,9.0,0.220198
3657,3657,Brian Flynn,2017-18,29.0,6,10,51,51,6,4,10,47.0,615.0,275,27,34,61,353.0,82,5.45,47,245,2478,9.0,0.22197744
3658,3658,Brian Gibbons,2014-15,26.0,2,17,41,41,5,12,17,29.0,490.0,41,5,12,17,29.0,82,5.34,48,269,2463,8.9,0.28330493
3659,3659,Brian Gibbons,2015-16,27.0,3,5,25,25,0,5,5,21.0,346.0,66,5,17,22,50.0,82,5.32,47,251,2453,8.9,0.1642349
3660,3660,Brian Gibbons,2018-19,30.0,4,26,59,59,12,14,26,72.0,851.0,125,17,31,48,122.0,82,5.86,50,250,2620,9.2,0.31080246
3661,3661,Brian Gibbons,2019-20,31.0,5,19,64,64,8,11,19,50.0,699.0,189,25,42,67,172.0,82,5.96,47,239,2579,9.5,0.2546012
3662,3662,Brian Gibbons,2020-21,32.0,6,0,15,15,0,0,0,9.0,146.0,204,25,42,67,181.0,70,5.96,42,208,2192,9.5,0.22245711
3663,3663,Brian Gionta,2002-03,24.0,2,11,33,33,4,7,11,58.0,443.0,33,4,7,11,58.0,82,5.24,53,338,2262,9.5,0.26327717
3664,3664,Brian Gionta,2003-04,25.0,3,25,58,58,12,13,25,129.0,858.0,91,16,20,36,187.0,82,5.31,60,363,2326,9.4,0.44042912
3665,3665,Brian Gionta,2004-05,26.0,4,29,75,75,21,8,29,174.0,1105.0,166,37,28,65,361.0,82,5.14,57,348,2300,9.2,0.6433474
3666,3666,Brian Gionta,2006-07,28.0,5,89,82,82,48,41,89,291.0,1625.0,248,85,69,154,652.0,82,6.05,85,480,2458,10.1,0.93635094
3667,3667,Brian Gionta,2007-08,29.0,6,45,62,62,25,20,45,194.0,1167.0,310,110,89,199,846.0,82,5.76,70,398,2426,9.7,0.66567725
3668,3668,Brian Gionta,2008-09,30.0,7,53,82,82,22,31,53,257.0,1498.0,392,132,120,252,1103.0,82,5.44,62,351,2383,9.4,0.6473544
3669,3669,Brian Gionta,2009-10,31.0,8,60,81,81,20,40,60,248.0,1374.0,473,152,160,312,1351.0,82,5.7,65,341,2477,9.4,0.64107907
3670,3670,Brian Gionta,2010-11,32.0,9,46,61,61,28,18,46,237.0,1266.0,534,180,178,358,1588.0,82,5.53,56,304,2486,9.1,0.6506491
3671,3671,Brian Gionta,2011-12,33.0,10,46,82,82,29,17,46,298.0,1609.0,616,209,195,404,1886.0,82,5.46,52,291,2492,9.0,0.5804884
3672,3672,Brian Gionta,2012-13,34.0,11,15,31,31,8,7,15,75.0,602.0,647,217,202,419,1961.0,82,5.32,47,271,2439,8.9,0.40116432
3673,3673,Brian Gionta,2013-14,35.0,12,26,48,48,14,12,26,112.0,870.0,695,231,214,445,2073.0,48,5.31,29,160,1399,9.1,0.5486122
3674,3674,Brian Gionta,2014-15,36.0,13,40,81,81,18,22,40,184.0,1446.0,776,249,236,485,2257.0,82,5.34,48,269,2463,8.9,0.4887219
3675,3675,Brian Gionta,2015-16,37.0,14,35,69,69,13,22,35,153.0,1246.0,845,262,258,520,2410.0,82,5.32,47,251,2453,8.9,0.41558978
3676,3676,Brian Gionta,2016-17,38.0,15,33,79,79,12,21,33,169.0,1401.0,924,274,279,553,2579.0,82,5.34,48,255,2438,9.0,0.38758808
3677,3677,Brian Gionta,2017-18,39.0,16,35,82,82,15,20,35,149.0,1362.0,1006,289,299,588,2728.0,82,5.45,47,245,2478,9.0,0.364612
3678,3678,Brian Gionta,2018-19,40.0,17,7,20,20,2,5,7,42.0,261.0,1026,291,304,595,2770.0,82,5.86,50,250,2620,9.2,0.37976485
3679,3679,Brian Glynn,1988-89,21.0,2,19,67,67,5,14,19,84.0,,67,5,14,19,84.0,80,7.43,89,437,2435,12.2,0.3420921
3680,3680,Brian Glynn,1989-90,22.0,3,1,9,9,0,1,1,4.0,,76,5,15,20,88.0,80,7.48,85,403,2430,12.3,0.25758642
3681,3681,Brian Glynn,1990-91,23.0,4,0,1,1,0,0,0,0.0,,77,5,15,20,88.0,80,7.37,76,367,2421,12.2,0.22342882
3682,3682,Brian Glynn,1991-92,24.0,5,19,66,66,8,11,19,111.0,,143,13,26,39,199.0,80,6.91,71,366,2385,11.6,0.30934072
3683,3683,Brian Glynn,1992-93,25.0,6,22,62,62,4,18,22,82.0,,205,17,44,61,281.0,80,6.96,77,402,2440,11.4,0.2820969
3684,3684,Brian Glynn,1993-94,26.0,7,16,64,64,4,12,16,80.0,,269,21,56,77,361.0,84,7.25,87,443,2603,11.7,0.24377576
3685,3685,Brian Glynn,1994-95,27.0,8,15,64,64,2,13,15,71.0,,333,23,69,92,432.0,84,6.48,76,407,2545,10.7,0.20011887
3686,3686,Brian Glynn,1995-96,28.0,9,7,43,43,1,6,7,35.0,,376,24,75,99,467.0,48,5.97,37,209,1408,10.2,0.16672996
3687,3687,Brian Glynn,1996-97,29.0,10,4,54,54,0,4,4,46.0,,430,24,79,103,513.0,82,6.29,74,413,2481,10.4,0.16954541
3688,3688,Brian Glynn,1997-98,30.0,11,1,1,1,1,0,1,2.0,,431,25,79,104,515.0,82,5.83,55,336,2444,9.8,0.1712828
3689,3689,Brian Hill,1980-81,24.0,2,2,19,19,1,1,2,17.0,,19,1,1,2,17.0,80,7.03,61,280,2352,12.0,0.22169125
3690,3690,Brian Holzinger,1995-96,23.0,2,3,4,4,0,3,3,3.0,,4,0,3,3,3.0,48,5.97,37,209,1408,10.2,0.24748829
3691,3691,Brian Holzinger,1996-97,24.0,3,20,58,58,10,10,20,71.0,,62,10,13,23,74.0,82,6.29,74,413,2481,10.4,0.30530828
3692,3692,Brian Holzinger,1997-98,25.0,4,51,81,81,22,29,51,142.0,,143,32,42,74,216.0,82,5.83,55,336,2444,9.8,0.5532243
3693,3693,Brian Holzinger,1998-99,26.0,5,35,69,69,14,21,35,116.0,,212,46,63,109,332.0,82,5.28,57,380,2242,9.6,0.49239677
3694,3694,Brian Holzinger,1999-00,27.0,6,34,81,81,17,17,34,143.0,1338.0,293,63,80,143,475.0,82,5.27,57,359,2285,9.4,0.46082956
3695,3695,Brian Holzinger,2000-01,28.0,7,30,73,73,10,20,30,104.0,1090.0,366,73,100,173,579.0,82,5.49,53,331,2294,9.8,0.44085565
3696,3696,Brian Holzinger,2001-02,29.0,8,36,70,70,11,25,36,87.0,1123.0,436,84,125,209,666.0,82,5.51,63,376,2272,9.9,0.40901423
3697,3697,Brian Holzinger,2002-03,30.0,9,3,23,23,1,2,3,20.0,214.0,459,85,127,212,686.0,82,5.24,53,338,2262,9.5,0.28425634
3698,3698,Brian Holzinger,2003-04,31.0,10,4,14,14,1,3,4,23.0,193.0,473,86,130,216,709.0,82,5.31,60,363,2326,9.4,0.31949425
3699,3699,Brian Holzinger,2004-05,32.0,11,22,74,74,7,15,22,96.0,1226.0,547,93,145,238,805.0,82,5.14,57,348,2300,9.2,0.3116688
3700,3700,Brian Johnson,1984-85,24.0,2,0,3,3,0,0,0,4.0,,3,0,0,0,4.0,80,7.89,74,336,2448,12.9,0.22581163
3701,3701,Brian Lashoff,2013-14,23.0,2,5,31,31,1,4,5,26.0,551.0,31,1,4,5,26.0,48,5.31,29,160,1399,9.1,0.21884242
3702,3702,Brian Lashoff,2014-15,24.0,3,6,75,75,1,5,6,38.0,1082.0,106,2,9,11,64.0,82,5.34,48,269,2463,8.9,0.1520603
3703,3703,Brian Lashoff,2015-16,25.0,4,2,11,11,0,2,2,7.0,146.0,117,2,11,13,71.0,82,5.32,47,251,2453,8.9,0.15075445
3704,3704,Brian Lashoff,2017-18,27.0,5,0,5,5,0,0,0,1.0,63.0,122,2,11,13,72.0,82,5.45,47,245,2478,9.0,0.12533376
3705,3705,Brian Lashoff,2018-19,28.0,6,0,1,1,0,0,0,0.0,4.0,123,2,11,13,72.0,82,5.86,50,250,2620,9.2,0.12652105
3706,3706,Brian Lashoff,2019-20,29.0,7,1,4,4,0,1,1,2.0,55.0,127,2,12,14,74.0,82,5.96,47,239,2579,9.5,0.11938968
3707,3707,Brian Lashoff,2020-21,30.0,8,1,9,9,0,1,1,6.0,131.0,136,2,13,15,80.0,70,5.96,42,208,2192,9.5,0.13429636
3708,3708,Brian Lawton,1984-85,19.0,2,31,58,58,10,21,31,74.0,,58,10,21,31,74.0,80,7.89,74,336,2448,12.9,0.550071
3709,3709,Brian Lawton,1985-86,20.0,3,11,40,40,5,6,11,40.0,,98,15,27,42,114.0,80,7.77,71,321,2447,12.7,0.37652063
3710,3710,Brian Lawton,1986-87,21.0,4,35,65,65,18,17,35,98.0,,163,33,44,77,212.0,80,7.94,82,370,2484,12.8,0.5734161
3711,3711,Brian Lawton,1987-88,22.0,5,44,66,66,21,23,44,125.0,,229,54,67,121,337.0,80,7.34,72,344,2400,12.2,0.65990067
3712,3712,Brian Lawton,1988-89,23.0,6,41,74,74,17,24,41,155.0,,303,71,91,162,492.0,80,7.43,89,437,2435,12.2,0.59095305
3713,3713,Brian Lawton,1989-90,24.0,7,43,65,65,17,26,43,128.0,,368,88,117,205,620.0,80,7.48,85,403,2430,12.3,0.59555393
3714,3714,Brian Lawton,1990-91,25.0,8,14,35,35,7,7,14,52.0,,403,95,124,219,672.0,80,7.37,76,367,2421,12.2,0.4532627
3715,3715,Brian Lawton,1992-93,27.0,9,37,59,59,15,22,37,131.0,,462,110,146,256,803.0,80,6.96,77,402,2440,11.4,0.55581427
3716,3716,Brian Lawton,1993-94,28.0,10,10,21,21,2,8,10,29.0,,483,112,154,266,832.0,84,7.25,87,443,2603,11.7,0.35380632
3717,3717,Brian Lee,2008-09,21.0,2,1,6,6,0,1,1,6.0,101.0,6,0,1,1,6.0,82,5.44,62,351,2383,9.4,0.241801
3718,3718,Brian Lee,2009-10,22.0,3,13,53,53,2,11,13,51.0,1001.0,59,2,12,14,57.0,82,5.7,65,341,2477,9.4,0.22821897
3719,3719,Brian Lee,2010-11,23.0,4,3,23,23,2,1,3,22.0,358.0,82,4,13,17,79.0,82,5.53,56,304,2486,9.1,0.2521286
3720,3720,Brian Lee,2011-12,24.0,5,3,50,50,0,3,3,35.0,865.0,132,4,16,20,114.0,82,5.46,52,291,2492,9.0,0.13515738
3721,3721,Brian Lee,2012-13,25.0,6,16,55,55,1,15,16,32.0,854.0,187,5,31,36,146.0,82,5.32,47,271,2439,8.9,0.19150528
3722,3722,Brian Lee,2013-14,26.0,7,0,22,22,0,0,0,13.0,306.0,209,5,31,36,159.0,48,5.31,29,160,1399,9.1,0.11780879
3723,3723,Brian Leetch,1988-89,20.0,2,14,17,17,2,12,14,40.0,,17,2,12,14,40.0,80,7.43,89,437,2435,12.2,0.54856384
3724,3724,Brian Leetch,1989-90,21.0,3,71,68,68,23,48,71,268.0,,85,25,60,85,308.0,80,7.48,85,403,2430,12.3,0.95929253
3725,3725,Brian Leetch,1990-91,22.0,4,56,72,72,11,45,56,222.0,,157,36,105,141,530.0,80,7.37,76,367,2421,12.2,0.851496
3726,3726,Brian Leetch,1991-92,23.0,5,88,80,80,16,72,88,206.0,,237,52,177,229,736.0,80,6.91,71,366,2385,11.6,1.120296
3727,3727,Brian Leetch,1992-93,24.0,6,102,80,80,22,80,102,245.0,,317,74,257,331,981.0,80,6.96,77,402,2440,11.4,1.296014
3728,3728,Brian Leetch,1993-94,25.0,7,36,36,36,6,30,36,150.0,,353,80,287,367,1131.0,84,7.25,87,443,2603,11.7,0.8421142
3729,3729,Brian Leetch,1994-95,26.0,8,79,84,84,23,56,79,328.0,,437,103,343,446,1459.0,84,6.48,76,407,2545,10.7,0.86913323
3730,3730,Brian Leetch,1995-96,27.0,9,41,48,48,9,32,41,182.0,,485,112,375,487,1641.0,48,5.97,37,209,1408,10.2,1.0123932
3731,3731,Brian Leetch,1996-97,28.0,10,85,82,82,15,70,85,276.0,,567,127,445,572,1917.0,82,6.29,74,413,2481,10.4,0.9265555
3732,3732,Brian Leetch,1997-98,29.0,11,78,82,82,20,58,78,256.0,,649,147,503,650,2173.0,82,5.83,55,336,2444,9.8,0.8635284
3733,3733,Brian Leetch,1998-99,30.0,12,50,76,76,17,33,50,230.0,,725,164,536,700,2403.0,82,5.28,57,380,2242,9.6,0.6901816
3734,3734,Brian Leetch,1999-00,31.0,13,55,82,82,13,42,55,184.0,2449.0,807,177,578,755,2587.0,82,5.27,57,359,2285,9.4,0.71780944
3735,3735,Brian Leetch,2000-01,32.0,14,26,50,50,7,19,26,124.0,1347.0,857,184,597,781,2711.0,82,5.49,53,331,2294,9.8,0.57238835
3736,3736,Brian Leetch,2001-02,33.0,15,79,82,82,21,58,79,241.0,2407.0,939,205,655,860,2952.0,82,5.51,63,376,2272,9.9,0.79348874
3737,3737,Brian Leetch,2002-03,34.0,16,55,82,82,10,45,55,202.0,2121.0,1021,215,700,915,3154.0,82,5.24,53,338,2262,9.5,0.66603863
3738,3738,Brian Leetch,2003-04,35.0,17,30,51,51,12,18,30,150.0,1331.0,1072,227,718,945,3304.0,82,5.31,60,363,2326,9.4,0.6219598
3739,3739,Brian Leetch,2004-05,36.0,18,51,72,72,15,36,51,206.0,1893.0,1144,242,754,996,3510.0,82,5.14,57,348,2300,9.2,0.6331767
3740,3740,Brian Leetch,2006-07,38.0,19,32,61,61,5,27,32,130.0,1435.0,1205,247,781,1028,3640.0,82,6.05,85,480,2458,10.1,0.5027157
3741,3741,Brian Loney,1996-97,24.0,2,5,12,12,2,3,5,19.0,,12,2,3,5,19.0,82,6.29,74,413,2481,10.4,0.25365865
3742,3742,Brian Lundberg,1983-84,23.0,2,0,1,1,0,0,0,0.0,,1,0,0,0,0.0,80,7.73,71,310,2444,12.7,0.19256687
3743,3743,Brian MacLellan,1983-84,25.0,2,3,8,8,0,3,3,5.0,,8,0,3,3,5.0,80,7.73,71,310,2444,12.7,0.23609766
3744,3744,Brian MacLellan,1984-85,26.0,3,54,72,72,25,29,54,106.0,,80,25,32,57,111.0,80,7.89,74,336,2448,12.9,0.6551368
3745,3745,Brian MacLellan,1985-86,27.0,4,85,80,80,31,54,85,171.0,,160,56,86,142,282.0,80,7.77,71,321,2447,12.7,0.967255
3746,3746,Brian MacLellan,1986-87,28.0,5,45,78,78,16,29,45,166.0,,238,72,115,187,448.0,80,7.94,82,370,2484,12.8,0.61526453
3747,3747,Brian MacLellan,1987-88,29.0,6,63,76,76,32,31,63,146.0,,314,104,146,250,594.0,80,7.34,72,344,2400,12.2,0.7230463
3748,3748,Brian MacLellan,1988-89,30.0,7,48,75,75,16,32,48,194.0,,389,120,178,298,788.0,80,7.43,89,437,2435,12.2,0.6319196
3749,3749,Brian MacLellan,1989-90,31.0,8,44,72,72,18,26,44,137.0,,461,138,204,342,925.0,80,7.48,85,403,2430,12.3,0.55551016
3750,3750,Brian MacLellan,1990-91,32.0,9,38,65,65,20,18,38,127.0,,526,158,222,380,1052.0,80,7.37,76,367,2421,12.2,0.4677571
3751,3751,Brian MacLellan,1991-92,33.0,10,27,57,57,13,14,27,74.0,,583,171,236,407,1126.0,80,6.91,71,366,2385,11.6,0.39541414
3752,3752,Brian MacLellan,1992-93,34.0,11,6,23,23,1,5,6,17.0,,606,172,241,413,1143.0,80,6.96,77,402,2440,11.4,0.2900344
3753,3753,Brian McGrattan,2006-07,25.0,2,5,60,60,2,3,5,36.0,254.0,60,2,3,5,36.0,82,6.05,85,480,2458,10.1,0.14452815
3754,3754,Brian McGrattan,2007-08,26.0,3,2,45,45,0,2,2,22.0,174.0,105,2,5,7,58.0,82,5.76,70,398,2426,9.7,0.104157984
3755,3755,Brian McGrattan,2008-09,27.0,4,3,38,38,0,3,3,11.0,109.0,143,2,8,10,69.0,82,5.44,62,351,2383,9.4,0.08249098
3756,3756,Brian McGrattan,2009-10,28.0,5,0,5,5,0,0,0,2.0,28.0,148,2,8,10,71.0,82,5.7,65,341,2477,9.4,0.12507275
3757,3757,Brian McGrattan,2010-11,29.0,6,4,34,34,1,3,4,19.0,117.0,182,3,11,14,90.0,82,5.53,56,304,2486,9.1,0.11811474
3758,3758,Brian McGrattan,2012-13,31.0,7,2,30,30,0,2,2,10.0,160.0,212,3,13,16,100.0,82,5.32,47,271,2439,8.9,0.07452065
3759,3759,Brian McGrattan,2013-14,32.0,8,3,21,21,3,0,3,18.0,149.0,233,6,13,19,118.0,48,5.31,29,160,1399,9.1,0.19434848
3760,3760,Brian McGrattan,2014-15,33.0,9,8,76,76,4,4,8,79.0,511.0,309,10,17,27,197.0,82,5.34,48,269,2463,8.9,0.13832518
3761,3761,Brian McGrattan,2015-16,34.0,10,0,8,8,0,0,0,10.0,53.0,317,10,17,27,207.0,82,5.32,47,251,2453,8.9,0.12266594
3762,3762,Brian McReynolds,1990-91,26.0,2,2,9,9,0,2,2,11.0,,9,0,2,2,11.0,80,7.37,76,367,2421,12.2,0.23146635
3763,3763,Brian McReynolds,1991-92,27.0,3,0,1,1,0,0,0,0.0,,10,0,2,2,11.0,80,6.91,71,366,2385,11.6,0.17545217
3764,3764,Brian McReynolds,1994-95,30.0,4,4,20,20,1,3,4,10.0,,30,1,5,6,21.0,84,6.48,76,407,2545,10.7,0.12432334
3765,3765,Brian Mullen,1983-84,21.0,2,50,80,80,24,26,50,194.0,,80,24,26,50,194.0,80,7.73,71,310,2444,12.7,0.74427885
3766,3766,Brian Mullen,1984-85,22.0,3,62,75,75,21,41,62,164.0,,155,45,67,112,358.0,80,7.89,74,336,2448,12.9,0.7526171
3767,3767,Brian Mullen,1985-86,23.0,4,71,69,69,32,39,71,189.0,,224,77,106,183,547.0,80,7.77,71,321,2447,12.7,0.9712429
3768,3768,Brian Mullen,1986-87,24.0,5,62,79,79,28,34,62,211.0,,303,105,140,245,758.0,80,7.94,82,370,2484,12.8,0.81326395
3769,3769,Brian Mullen,1987-88,25.0,6,51,69,69,19,32,51,185.0,,372,124,172,296,943.0,80,7.34,72,344,2400,12.2,0.72841054
3770,3770,Brian Mullen,1988-89,26.0,7,54,74,74,25,29,54,147.0,,446,149,201,350,1090.0,80,7.43,89,437,2435,12.2,0.7322424
3771,3771,Brian Mullen,1989-90,27.0,8,64,78,78,29,35,64,217.0,,524,178,236,414,1307.0,80,7.48,85,403,2430,12.3,0.81666446
3772,3772,Brian Mullen,1990-91,28.0,9,68,76,76,27,41,68,186.0,,600,205,277,482,1493.0,80,7.37,76,367,2421,12.2,0.7683345
3773,3773,Brian Mullen,1991-92,29.0,10,62,79,79,19,43,62,188.0,,679,224,320,544,1681.0,80,6.91,71,366,2385,11.6,0.73204875
3774,3774,Brian Mullen,1992-93,30.0,11,46,72,72,18,28,46,168.0,,751,242,348,590,1849.0,80,6.96,77,402,2440,11.4,0.5565667
3775,3775,Brian Mullen,1993-94,31.0,12,32,81,81,18,14,32,126.0,,832,260,362,622,1975.0,84,7.25,87,443,2603,11.7,0.40739858
3776,3776,Brian Noonan,1988-89,23.0,2,30,77,77,10,20,30,87.0,,77,10,20,30,87.0,80,7.43,89,437,2435,12.2,0.43743968
3777,3777,Brian Noonan,1989-90,24.0,3,16,45,45,4,12,16,84.0,,122,14,32,46,171.0,80,7.48,85,403,2430,12.3,0.3552884
3778,3778,Brian Noonan,1990-91,25.0,4,2,8,8,0,2,2,13.0,,130,14,34,48,184.0,80,7.37,76,367,2421,12.2,0.28025317
3779,3779,Brian Noonan,1991-92,26.0,5,4,7,7,0,4,4,12.0,,137,14,38,52,196.0,80,6.91,71,366,2385,11.6,0.2869584
3780,3780,Brian Noonan,1992-93,27.0,6,31,65,65,19,12,31,154.0,,202,33,50,83,350.0,80,6.96,77,402,2440,11.4,0.4782263
3781,3781,Brian Noonan,1993-94,28.0,7,30,63,63,16,14,30,129.0,,265,49,64,113,479.0,84,7.25,87,443,2603,11.7,0.47372538
3782,3782,Brian Noonan,1994-95,29.0,8,41,76,76,18,23,41,160.0,,341,67,87,154,639.0,84,6.48,76,407,2545,10.7,0.4542291
3783,3783,Brian Noonan,1995-96,30.0,9,27,45,45,14,13,27,95.0,,386,81,100,181,734.0,48,5.97,37,209,1408,10.2,0.537762
3784,3784,Brian Noonan,1996-97,31.0,10,35,81,81,13,22,35,131.0,,467,94,122,216,865.0,82,6.29,74,413,2481,10.4,0.36713365
3785,3785,Brian Noonan,1997-98,32.0,11,34,73,73,12,22,34,100.0,,540,106,144,250,965.0,82,5.83,55,336,2444,9.8,0.34443045
3786,3786,Brian Noonan,1998-99,33.0,12,25,82,82,10,15,25,87.0,,622,116,159,275,1052.0,82,5.28,57,380,2242,9.6,0.25911194
3787,3787,Brian Noonan,1999-00,34.0,13,0,7,7,0,0,0,1.0,58.0,629,116,159,275,1053.0,82,5.27,57,359,2285,9.4,0.20644549
3788,3788,Brian O'Neill,2016-17,28.0,2,2,22,22,0,2,2,14.0,228.0,22,0,2,2,14.0,82,5.34,48,255,2438,9.0,0.11406651
3789,3789,Brian Pothier,2001-02,24.0,2,0,3,3,0,0,0,0.0,62.0,3,0,0,0,0.0,82,5.51,63,376,2272,9.9,0.14676258
3790,3790,Brian Pothier,2002-03,25.0,3,9,33,33,3,6,9,65.0,716.0,36,3,6,9,65.0,82,5.24,53,338,2262,9.5,0.23777667
3791,3791,Brian Pothier,2003-04,26.0,4,6,14,14,2,4,6,23.0,215.0,50,5,10,15,88.0,82,5.31,60,363,2326,9.4,0.26063707
3792,3792,Brian Pothier,2004-05,27.0,5,8,55,55,2,6,8,78.0,920.0,105,7,16,23,166.0,82,5.14,57,348,2300,9.2,0.21302333
3793,3793,Brian Pothier,2006-07,29.0,6,35,77,77,5,30,35,133.0,1291.0,182,12,46,58,299.0,82,6.05,85,480,2458,10.1,0.37454277
3794,3794,Brian Pothier,2007-08,30.0,7,28,72,72,3,25,28,118.0,1727.0,254,15,71,86,417.0,82,5.76,70,398,2426,9.7,0.3301068
3795,3795,Brian Pothier,2008-09,31.0,8,14,38,38,5,9,14,65.0,710.0,292,20,80,100,482.0,82,5.44,62,351,2383,9.4,0.28966516
3796,3796,Brian Pothier,2009-10,32.0,9,3,9,9,1,2,3,8.0,149.0,301,21,82,103,490.0,82,5.7,65,341,2477,9.4,0.21127704
3797,3797,Brian Pothier,2010-11,33.0,10,15,61,61,5,10,15,81.0,1160.0,362,26,92,118,571.0,82,5.53,56,304,2486,9.1,0.23726669
3798,3798,Brian Propp,1980-81,21.0,2,75,80,80,34,41,75,209.0,,80,34,41,75,209.0,80,7.03,61,280,2352,12.0,0.9715756
3799,3799,Brian Propp,1981-82,22.0,3,66,79,79,26,40,66,194.0,,159,60,81,141,403.0,80,7.69,77,340,2441,12.6,0.9110911
3800,3800,Brian Propp,1982-83,23.0,4,91,80,80,44,47,91,290.0,,239,104,128,232,693.0,80,8.03,73,320,2489,12.9,1.1155156
3801,3801,Brian Propp,1983-84,24.0,5,82,80,80,40,42,82,250.0,,319,144,170,314,943.0,80,7.73,71,310,2444,12.7,1.033859
3802,3802,Brian Propp,1984-85,25.0,6,92,79,79,39,53,92,301.0,,398,183,223,406,1244.0,80,7.89,74,336,2448,12.9,1.1866488
3803,3803,Brian Propp,1985-86,26.0,7,97,76,76,43,54,97,266.0,,474,226,277,503,1510.0,80,7.77,71,321,2447,12.7,1.145535
3804,3804,Brian Propp,1986-87,27.0,8,97,72,72,40,57,97,317.0,,546,266,334,600,1827.0,80,7.94,82,370,2484,12.8,1.145757
3805,3805,Brian Propp,1987-88,28.0,9,67,53,53,31,36,67,208.0,,599,297,370,667,2035.0,80,7.34,72,344,2400,12.2,1.1302501
3806,3806,Brian Propp,1988-89,29.0,10,76,74,74,27,49,76,257.0,,673,324,419,743,2292.0,80,7.43,89,437,2435,12.2,0.9059231
3807,3807,Brian Propp,1989-90,30.0,11,78,77,77,32,46,78,245.0,,750,356,465,821,2537.0,80,7.48,85,403,2430,12.3,0.89112437
3808,3808,Brian Propp,1990-91,31.0,12,40,54,54,16,24,40,153.0,,804,372,489,861,2690.0,80,7.37,76,367,2421,12.2,0.8086885
3809,3809,Brian Propp,1991-92,32.0,13,73,79,79,26,47,73,171.0,,883,398,536,934,2861.0,80,6.91,71,366,2385,11.6,0.8775792
3810,3810,Brian Propp,1992-93,33.0,14,35,51,51,12,23,35,115.0,,934,410,559,969,2976.0,80,6.96,77,402,2440,11.4,0.64057803
3811,3811,Brian Propp,1993-94,34.0,15,6,17,17,3,3,6,35.0,,951,413,562,975,3011.0,84,7.25,87,443,2603,11.7,0.46650112
3812,3812,Brian Propp,1994-95,35.0,16,29,65,65,12,17,29,108.0,,1016,425,579,1004,3119.0,84,6.48,76,407,2545,10.7,0.38473797
3813,3813,Brian Rafalski,2000-01,27.0,2,32,75,75,5,27,32,128.0,1414.0,75,5,27,32,128.0,82,5.49,53,331,2294,9.8,0.40837184
3814,3814,Brian Rafalski,2001-02,28.0,3,52,78,78,9,43,52,142.0,1691.0,153,14,70,84,270.0,82,5.51,63,376,2272,9.9,0.5457718
3815,3815,Brian Rafalski,2002-03,29.0,4,47,76,76,7,40,47,125.0,1682.0,229,21,110,131,395.0,82,5.24,53,338,2262,9.5,0.5718121
3816,3816,Brian Rafalski,2003-04,30.0,5,40,79,79,3,37,40,178.0,1829.0,308,24,147,171,573.0,82,5.31,60,363,2326,9.4,0.5382971
3817,3817,Brian Rafalski,2004-05,31.0,6,36,69,69,6,30,36,130.0,1573.0,377,30,177,207,703.0,82,5.14,57,348,2300,9.2,0.5307273
3818,3818,Brian Rafalski,2006-07,33.0,7,49,82,82,6,43,49,126.0,2093.0,459,36,220,256,829.0,82,6.05,85,480,2458,10.1,0.525082
3819,3819,Brian Rafalski,2007-08,34.0,8,55,82,82,8,47,55,148.0,2090.0,541,44,267,311,977.0,82,5.76,70,398,2426,9.7,0.6119764
3820,3820,Brian Rafalski,2008-09,35.0,9,55,73,73,13,42,55,175.0,1757.0,614,57,309,366,1152.0,82,5.44,62,351,2383,9.4,0.65815204
3821,3821,Brian Rafalski,2009-10,36.0,10,59,78,78,10,49,59,141.0,1808.0,692,67,358,425,1293.0,82,5.7,65,341,2477,9.4,0.5980333
3822,3822,Brian Rafalski,2010-11,37.0,11,42,78,78,8,34,42,134.0,1890.0,770,75,392,467,1427.0,82,5.53,56,304,2486,9.1,0.48854575
3823,3823,Brian Rafalski,2011-12,38.0,12,48,63,63,4,44,48,106.0,1287.0,833,79,436,515,1533.0,82,5.46,52,291,2492,9.0,0.5745599
3824,3824,Brian Rolston,1995-96,22.0,2,18,40,40,7,11,18,92.0,,40,7,11,18,92.0,48,5.97,37,209,1408,10.2,0.5077269
3825,3825,Brian Rolston,1996-97,23.0,3,24,58,58,13,11,24,139.0,,98,20,22,42,231.0,82,6.29,74,413,2481,10.4,0.46479613
3826,3826,Brian Rolston,1997-98,24.0,4,45,81,81,18,27,45,237.0,,179,38,49,87,468.0,82,5.83,55,336,2444,9.8,0.56060255
3827,3827,Brian Rolston,1998-99,25.0,5,30,76,76,16,14,30,185.0,,255,54,63,117,653.0,82,5.28,57,380,2242,9.6,0.5051841
3828,3828,Brian Rolston,1999-00,26.0,6,57,82,82,24,33,57,210.0,1543.0,337,78,96,174,863.0,82,5.27,57,359,2285,9.4,0.68556607
3829,3829,Brian Rolston,2000-01,27.0,7,31,77,77,16,15,31,206.0,1381.0,414,94,111,205,1069.0,82,5.49,53,331,2294,9.8,0.5320911
3830,3830,Brian Rolston,2001-02,28.0,8,58,77,77,19,39,58,286.0,1488.0,491,113,150,263,1355.0,82,5.51,63,376,2272,9.9,0.704072
3831,3831,Brian Rolston,2002-03,29.0,9,62,82,82,31,31,62,331.0,1673.0,573,144,181,325,1686.0,82,5.24,53,338,2262,9.5,0.7395024
3832,3832,Brian Rolston,2003-04,30.0,10,59,81,81,27,32,59,281.0,1657.0,654,171,213,384,1967.0,82,5.31,60,363,2326,9.4,0.7078082
3833,3833,Brian Rolston,2004-05,31.0,11,48,82,82,19,29,48,257.0,1609.0,736,190,242,432,2224.0,82,5.14,57,348,2300,9.2,0.7005498
3834,3834,Brian Rolston,2006-07,33.0,12,79,82,82,34,45,79,293.0,1669.0,818,224,287,511,2517.0,82,6.05,85,480,2458,10.1,0.8301883
3835,3835,Brian Rolston,2007-08,34.0,13,64,78,78,31,33,64,305.0,1659.0,896,255,320,575,2822.0,82,5.76,70,398,2426,9.7,0.67411274
3836,3836,Brian Rolston,2008-09,35.0,14,59,81,81,31,28,59,289.0,1626.0,977,286,348,634,3111.0,82,5.44,62,351,2383,9.4,0.6176759
3837,3837,Brian Rolston,2009-10,36.0,15,32,64,64,15,17,32,174.0,967.0,1041,301,365,666,3285.0,82,5.7,65,341,2477,9.4,0.48465192
3838,3838,Brian Rolston,2010-11,37.0,16,37,80,80,20,17,37,232.0,1354.0,1121,321,382,703,3517.0,82,5.53,56,304,2486,9.1,0.45172817
3839,3839,Brian Rolston,2011-12,38.0,17,34,65,65,14,20,34,168.0,1144.0,1186,335,402,737,3685.0,82,5.46,52,291,2492,9.0,0.40347987
3840,3840,Brian Rolston,2012-13,39.0,18,24,70,70,7,17,24,151.0,1000.0,1256,342,419,761,3836.0,82,5.32,47,271,2439,8.9,0.3154515
3841,3841,Brian Salcido,2009-10,24.0,2,1,2,2,0,1,1,1.0,25.0,2,0,1,1,1.0,82,5.7,65,341,2477,9.4,0.19386071
3842,3842,Brian Savage,1994-95,23.0,2,1,3,3,1,0,1,3.0,,3,1,0,1,3.0,84,6.48,76,407,2545,10.7,0.2408298
3843,3843,Brian Savage,1995-96,24.0,3,19,37,37,12,7,19,64.0,,40,13,7,20,67.0,48,5.97,37,209,1408,10.2,0.45580974
3844,3844,Brian Savage,1996-97,25.0,4,33,75,75,25,8,33,150.0,,115,38,15,53,217.0,82,6.29,74,413,2481,10.4,0.49076232
3845,3845,Brian Savage,1997-98,26.0,5,60,81,81,23,37,60,219.0,,196,61,52,113,436.0,82,5.83,55,336,2444,9.8,0.65257615
3846,3846,Brian Savage,1998-99,27.0,6,43,64,64,26,17,43,152.0,,260,87,69,156,588.0,82,5.28,57,380,2242,9.6,0.62632704
3847,3847,Brian Savage,1999-00,28.0,7,26,54,54,16,10,26,124.0,891.0,314,103,79,182,712.0,82,5.27,57,359,2285,9.4,0.61991507
3848,3848,Brian Savage,2000-01,29.0,8,29,38,38,17,12,29,107.0,682.0,352,120,91,211,819.0,82,5.49,53,331,2294,9.8,0.6274184
3849,3849,Brian Savage,2001-02,30.0,9,45,62,62,21,24,45,172.0,1168.0,414,141,115,256,991.0,82,5.51,63,376,2272,9.9,0.6009239
3850,3850,Brian Savage,2002-03,31.0,10,41,77,77,20,21,41,164.0,1306.0,491,161,136,297,1155.0,82,5.24,53,338,2262,9.5,0.47450846
3851,3851,Brian Savage,2003-04,32.0,11,16,43,43,6,10,16,68.0,575.0,534,167,146,313,1223.0,82,5.31,60,363,2326,9.4,0.33357614
3852,3852,Brian Savage,2004-05,33.0,12,32,74,74,16,16,32,124.0,1084.0,608,183,162,345,1347.0,82,5.14,57,348,2300,9.2,0.36173755
3853,3853,Brian Savage,2006-07,35.0,13,14,66,66,9,5,14,102.0,879.0,674,192,167,359,1449.0,82,6.05,85,480,2458,10.1,0.220741
3854,3854,Brian Skrudland,1986-87,23.0,2,22,65,65,9,13,22,62.0,,65,9,13,22,62.0,80,7.94,82,370,2484,12.8,0.34442312
3855,3855,Brian Skrudland,1987-88,24.0,3,28,79,79,11,17,28,72.0,,144,20,30,50,134.0,80,7.34,72,344,2400,12.2,0.37226576
3856,3856,Brian Skrudland,1988-89,25.0,4,36,79,79,12,24,36,96.0,,223,32,54,86,230.0,80,7.43,89,437,2435,12.2,0.43943474
3857,3857,Brian Skrudland,1989-90,26.0,5,41,71,71,12,29,41,98.0,,294,44,83,127,328.0,80,7.48,85,403,2430,12.3,0.5235984
3858,3858,Brian Skrudland,1990-91,27.0,6,42,59,59,11,31,42,70.0,,353,55,114,169,398.0,80,7.37,76,367,2421,12.2,0.5200362
3859,3859,Brian Skrudland,1991-92,28.0,7,34,57,57,15,19,34,71.0,,410,70,133,203,469.0,80,6.91,71,366,2385,11.6,0.4617077
3860,3860,Brian Skrudland,1992-93,29.0,8,6,42,42,3,3,6,51.0,,452,73,136,209,520.0,80,6.96,77,402,2440,11.4,0.279494
3861,3861,Brian Skrudland,1993-94,30.0,9,14,39,39,7,7,14,51.0,,491,80,143,223,571.0,84,7.25,87,443,2603,11.7,0.3395971
3862,3862,Brian Skrudland,1994-95,31.0,10,40,79,79,15,25,40,110.0,,570,95,168,263,681.0,84,6.48,76,407,2545,10.7,0.4069634
3863,3863,Brian Skrudland,1995-96,32.0,11,14,47,47,5,9,14,44.0,,617,100,177,277,725.0,48,5.97,37,209,1408,10.2,0.29784113
3864,3864,Brian Skrudland,1996-97,33.0,12,27,79,79,7,20,27,90.0,,696,107,197,304,815.0,82,6.29,74,413,2481,10.4,0.28290302
3865,3865,Brian Skrudland,1997-98,34.0,13,18,51,51,5,13,18,57.0,,747,112,210,322,872.0,82,5.83,55,336,2444,9.8,0.27567327
3866,3866,Brian Skrudland,1998-99,35.0,14,13,72,72,7,6,13,55.0,,819,119,216,335,927.0,82,5.28,57,380,2242,9.6,0.16061383
3867,3867,Brian Skrudland,1999-00,36.0,15,5,40,40,4,1,5,33.0,377.0,859,123,217,340,960.0,82,5.27,57,359,2285,9.4,0.16255778
3868,3868,Brian Skrudland,2000-01,37.0,16,3,22,22,1,2,3,16.0,185.0,881,124,219,343,976.0,82,5.49,53,331,2294,9.8,0.16219825
3869,3869,Brian Strait,2011-12,24.0,2,0,3,3,0,0,0,0.0,41.0,3,0,0,0,0.0,82,5.46,52,291,2492,9.0,0.14061391
3870,3870,Brian Strait,2012-13,25.0,3,1,9,9,0,1,1,4.0,116.0,12,0,1,1,4.0,82,5.32,47,271,2439,8.9,0.17085361
3871,3871,Brian Strait,2013-14,26.0,4,4,19,19,0,4,4,13.0,326.0,31,0,5,5,17.0,48,5.31,29,160,1399,9.1,0.15314072
3872,3872,Brian Strait,2014-15,27.0,5,9,47,47,3,6,9,40.0,844.0,78,3,11,14,57.0,82,5.34,48,269,2463,8.9,0.13928738
3873,3873,Brian Strait,2015-16,28.0,6,7,52,52,2,5,7,59.0,955.0,130,5,16,21,116.0,82,5.32,47,251,2453,8.9,0.14221746
3874,3874,Brian Strait,2016-17,29.0,7,6,52,52,1,5,6,43.0,803.0,182,6,21,27,159.0,82,5.34,48,255,2438,9.0,0.12419227
3875,3875,Brian Strait,2017-18,30.0,8,2,5,5,0,2,2,3.0,80.0,187,6,23,29,162.0,82,5.45,47,245,2478,9.0,0.12158558
3876,3876,Brian Sullivan,1993-94,24.0,2,1,2,2,0,1,1,2.0,,2,0,1,1,2.0,84,7.25,87,443,2603,11.7,0.21476078
3877,3877,Brian Sutherby,2002-03,20.0,2,0,7,7,0,0,0,3.0,51.0,7,0,0,0,3.0,82,5.24,53,338,2262,9.5,0.21441007
3878,3878,Brian Sutherby,2003-04,21.0,3,11,72,72,2,9,11,38.0,701.0,79,2,9,11,41.0,82,5.31,60,363,2326,9.4,0.21250397
3879,3879,Brian Sutherby,2004-05,22.0,4,2,30,30,2,0,2,24.0,308.0,109,4,9,13,65.0,82,5.14,57,348,2300,9.2,0.24907756
3880,3880,Brian Sutherby,2006-07,24.0,5,30,76,76,14,16,30,85.0,1044.0,185,18,25,43,150.0,82,6.05,85,480,2458,10.1,0.3706857
3881,3881,Brian Sutherby,2007-08,25.0,6,17,69,69,7,10,17,87.0,945.0,254,25,35,60,237.0,82,5.76,70,398,2426,9.7,0.2600833
3882,3882,Brian Sutherby,2008-09,26.0,7,2,50,50,1,1,2,49.0,429.0,304,26,36,62,286.0,82,5.44,62,351,2383,9.4,0.16588387
3883,3883,Brian Sutherby,2009-10,27.0,8,15,59,59,8,7,15,67.0,644.0,363,34,43,77,353.0,82,5.7,65,341,2477,9.4,0.22047353
3884,3884,Brian Sutherby,2010-11,28.0,9,9,46,46,5,4,9,49.0,396.0,409,39,47,86,402.0,82,5.53,56,304,2486,9.1,0.17895743
3885,3885,Brian Sutherby,2011-12,29.0,10,4,51,51,2,2,4,32.0,378.0,460,41,49,90,434.0,82,5.46,52,291,2492,9.0,0.13766572
3886,3886,Brian Swanson,2001-02,25.0,2,2,16,16,1,1,2,8.0,175.0,16,1,1,2,8.0,82,5.51,63,376,2272,9.9,0.16718477
3887,3887,Brian Swanson,2002-03,26.0,3,2,8,8,1,1,2,7.0,81.0,24,2,2,4,15.0,82,5.24,53,338,2262,9.5,0.18006676
3888,3888,Brian Swanson,2003-04,27.0,4,12,44,44,2,10,12,67.0,524.0,68,4,12,16,82.0,82,5.31,60,363,2326,9.4,0.22426125
3889,3889,Brian Swanson,2004-05,28.0,5,1,2,2,0,1,1,0.0,13.0,70,4,13,17,82.0,82,5.14,57,348,2300,9.2,0.193661
3890,3890,Brian Tutt,1990-91,28.0,2,1,7,7,1,0,1,5.0,,7,1,0,1,5.0,80,7.37,76,367,2421,12.2,0.24996471
3891,3891,Brian Wesenberg,1999-00,22.0,2,0,1,1,0,0,0,0.0,1.0,1,0,0,0,0.0,82,5.27,57,359,2285,9.4,0.17280087
3892,3892,Brian White,1999-00,23.0,2,0,2,2,0,0,0,0.0,1.0,2,0,0,0,0.0,82,5.27,57,359,2285,9.4,0.17438605
3893,3893,Brian Wilks,1985-86,19.0,2,0,2,2,0,0,0,3.0,,2,0,0,0,3.0,80,7.77,71,321,2447,12.7,0.27032173
3894,3894,Brian Wilks,1986-87,20.0,3,12,43,43,4,8,12,31.0,,45,4,8,12,34.0,80,7.94,82,370,2484,12.8,0.2917786
3895,3895,Brian Wilks,1987-88,21.0,4,0,1,1,0,0,0,0.0,,46,4,8,12,34.0,80,7.34,72,344,2400,12.2,0.27992785
3896,3896,Brian Wilks,1989-90,23.0,5,0,2,2,0,0,0,2.0,,48,4,8,12,36.0,80,7.48,85,403,2430,12.3,0.21062526
3897,3897,Brian Willsie,2000-01,22.0,2,0,1,1,0,0,0,1.0,8.0,1,0,0,0,1.0,82,5.49,53,331,2294,9.8,0.1675331
3898,3898,Brian Willsie,2002-03,24.0,3,14,56,56,7,7,14,66.0,638.0,57,7,7,14,67.0,82,5.24,53,338,2262,9.5,0.2419408
3899,3899,Brian Willsie,2003-04,25.0,4,1,12,12,0,1,1,12.0,115.0,69,7,8,15,79.0,82,5.31,60,363,2326,9.4,0.20048478
3900,3900,Brian Willsie,2004-05,26.0,5,15,49,49,10,5,15,85.0,622.0,118,17,13,30,164.0,82,5.14,57,348,2300,9.2,0.3259971
3901,3901,Brian Willsie,2006-07,28.0,6,41,82,82,19,22,41,185.0,1366.0,200,36,35,71,349.0,82,6.05,85,480,2458,10.1,0.48642775
3902,3902,Brian Willsie,2007-08,29.0,7,21,81,81,11,10,21,131.0,1084.0,281,47,45,92,480.0,82,5.76,70,398,2426,9.7,0.27120796
3903,3903,Brian Willsie,2008-09,30.0,8,12,53,53,4,8,12,62.0,563.0,334,51,53,104,542.0,82,5.44,62,351,2383,9.4,0.21245506
3904,3904,Brian Willsie,2009-10,31.0,9,4,42,42,1,3,4,59.0,495.0,376,52,56,108,601.0,82,5.7,65,341,2477,9.4,0.17667654
3905,3905,Brian Willsie,2010-11,32.0,10,0,4,4,0,0,0,2.0,44.0,380,52,56,108,603.0,82,5.53,56,304,2486,9.1,0.25291866
3906,3906,Brian Willsie,2011-12,33.0,11,1,1,1,0,1,1,0.0,6.0,381,52,57,109,603.0,82,5.46,52,291,2492,9.0,0.24428192
3907,3907,Brian Wiseman,1997-98,26.0,2,0,3,3,0,0,0,1.0,,3,0,0,0,1.0,82,5.83,55,336,2444,9.8,0.1533815
3908,3908,Brian Young,1981-82,23.0,2,2,8,8,0,2,2,5.0,,8,0,2,2,5.0,80,7.69,77,340,2441,12.6,0.2525605
3909,3909,Brock Boeser,2017-18,20.0,2,5,9,9,4,1,5,25.0,146.0,9,4,1,5,25.0,82,5.45,47,245,2478,9.0,0.3877251
3910,3910,Brock Boeser,2018-19,21.0,3,55,62,62,29,26,55,179.0,1085.0,71,33,27,60,204.0,82,5.86,50,250,2620,9.2,0.8832047
3911,3911,Brock Boeser,2019-20,22.0,4,56,69,69,26,30,56,209.0,1322.0,140,59,57,116,413.0,82,5.96,47,239,2579,9.5,0.8165358
3912,3912,Brock Boeser,2020-21,23.0,5,45,57,57,16,29,45,169.0,1059.0,197,75,86,161,582.0,70,5.96,42,208,2192,9.5,0.78858364
3913,3913,Brock McGinn,2016-17,22.0,2,4,21,21,3,1,4,25.0,235.0,21,3,1,4,25.0,82,5.34,48,255,2438,9.0,0.26259702
3914,3914,Brock McGinn,2017-18,23.0,3,16,57,57,7,9,16,74.0,684.0,78,10,10,20,99.0,82,5.45,47,245,2478,9.0,0.30717307
3915,3915,Brock McGinn,2018-19,24.0,4,30,80,80,16,14,30,159.0,1160.0,158,26,24,50,258.0,82,5.86,50,250,2620,9.2,0.43368676
3916,3916,Brock McGinn,2019-20,25.0,5,26,82,82,10,16,26,123.0,1173.0,240,36,40,76,381.0,82,5.96,47,239,2579,9.5,0.3378479
3917,3917,Brock McGinn,2020-21,26.0,6,17,68,68,7,10,17,93.0,898.0,308,43,50,93,474.0,70,5.96,42,208,2192,9.5,0.28070247
3918,3918,Brock Nelson,2014-15,23.0,2,26,72,72,14,12,26,132.0,1027.0,72,14,12,26,132.0,82,5.34,48,269,2463,8.9,0.4183583
3919,3919,Brock Nelson,2015-16,24.0,3,42,82,82,20,22,42,190.0,1302.0,154,34,34,68,322.0,82,5.32,47,251,2453,8.9,0.5251961
3920,3920,Brock Nelson,2016-17,25.0,4,40,81,81,26,14,40,165.0,1280.0,235,60,48,108,487.0,82,5.34,48,255,2438,9.0,0.55574185
3921,3921,Brock Nelson,2017-18,26.0,5,45,81,81,20,25,45,173.0,1268.0,316,80,73,153,660.0,82,5.45,47,245,2478,9.0,0.5716373
3922,3922,Brock Nelson,2018-19,27.0,6,35,82,82,19,16,35,138.0,1208.0,398,99,89,188,798.0,82,5.86,50,250,2620,9.2,0.45555764
3923,3923,Brock Nelson,2019-20,28.0,7,53,82,82,25,28,53,181.0,1474.0,480,124,117,241,979.0,82,5.96,47,239,2579,9.5,0.6027647
3924,3924,Brock Nelson,2020-21,29.0,8,54,68,68,26,28,54,175.0,1282.0,548,150,145,295,1154.0,70,5.96,42,208,2192,9.5,0.72607684
3925,3925,Brock Trotter,2010-11,23.0,2,0,2,2,0,0,0,6.0,18.0,2,0,0,0,6.0,82,5.53,56,304,2486,9.1,0.17674801
3926,3926,Brodie Dupont,2011-12,24.0,2,0,1,1,0,0,0,1.0,6.0,1,0,0,0,1.0,82,5.46,52,291,2492,9.0,0.16175261
3927,3927,Brody Sutter,2015-16,24.0,2,0,4,4,0,0,0,0.0,30.0,4,0,0,0,0.0,82,5.32,47,251,2453,8.9,0.13244578
3928,3928,Brody Sutter,2016-17,25.0,3,0,8,8,0,0,0,7.0,72.0,12,0,0,0,7.0,82,5.34,48,255,2438,9.0,0.16127622
3929,3929,Brogan Rafferty,2019-20,24.0,2,0,2,2,0,0,0,3.0,27.0,2,0,0,0,3.0,82,5.96,47,239,2579,9.5,0.1744509
3930,3930,Brooks Laich,2004-05,21.0,2,1,5,5,0,1,1,3.0,53.0,5,0,1,1,3.0,82,5.14,57,348,2300,9.2,0.2731913
3931,3931,Brooks Laich,2006-07,23.0,3,21,73,73,7,14,21,118.0,819.0,78,7,15,22,121.0,82,6.05,85,480,2458,10.1,0.34067875
3932,3932,Brooks Laich,2007-08,24.0,4,18,73,73,8,10,18,119.0,993.0,151,15,25,40,240.0,82,5.76,70,398,2426,9.7,0.2931493
3933,3933,Brooks Laich,2008-09,25.0,5,37,82,82,21,16,37,122.0,1152.0,233,36,41,77,362.0,82,5.44,62,351,2383,9.4,0.466821
3934,3934,Brooks Laich,2009-10,26.0,6,53,82,82,23,30,53,185.0,1417.0,315,59,71,130,547.0,82,5.7,65,341,2477,9.4,0.60561407
3935,3935,Brooks Laich,2010-11,27.0,7,59,78,78,25,34,59,222.0,1426.0,393,84,105,189,769.0,82,5.53,56,304,2486,9.1,0.64167136
3936,3936,Brooks Laich,2011-12,28.0,8,48,82,82,16,32,48,207.0,1511.0,475,100,137,237,976.0,82,5.46,52,291,2492,9.0,0.58319694
3937,3937,Brooks Laich,2012-13,29.0,9,41,82,82,16,25,41,191.0,1517.0,557,116,162,278,1167.0,82,5.32,47,271,2439,8.9,0.54444796
3938,3938,Brooks Laich,2013-14,30.0,10,4,9,9,1,3,4,10.0,149.0,566,117,165,282,1177.0,48,5.31,29,160,1399,9.1,0.36632878
3939,3939,Brooks Laich,2014-15,31.0,11,15,51,51,8,7,15,75.0,880.0,617,125,172,297,1252.0,82,5.34,48,269,2463,8.9,0.32208368
3940,3940,Brooks Laich,2015-16,32.0,12,20,66,66,7,13,20,106.0,972.0,683,132,185,317,1358.0,82,5.32,47,251,2453,8.9,0.2814923
3941,3941,Brooks Laich,2016-17,33.0,13,14,81,81,2,12,14,101.0,926.0,764,134,197,331,1459.0,82,5.34,48,255,2438,9.0,0.21633664
3942,3942,Brooks Laich,2018-19,35.0,14,1,12,12,0,1,1,10.0,134.0,776,134,198,332,1469.0,82,5.86,50,250,2620,9.2,0.18132919
3943,3943,Brooks Orpik,2003-04,23.0,2,0,6,6,0,0,0,2.0,110.0,6,0,0,0,2.0,82,5.31,60,363,2326,9.4,0.17296138
3944,3944,Brooks Orpik,2004-05,24.0,3,10,79,79,1,9,10,56.0,1455.0,85,1,9,10,58.0,82,5.14,57,348,2300,9.2,0.17079228
3945,3945,Brooks Orpik,2006-07,26.0,4,9,64,64,2,7,9,32.0,1206.0,149,3,16,19,90.0,82,6.05,85,480,2458,10.1,0.12231353
3946,3946,Brooks Orpik,2007-08,27.0,5,6,70,70,0,6,6,59.0,1163.0,219,3,22,25,149.0,82,5.76,70,398,2426,9.7,0.12601098
3947,3947,Brooks Orpik,2008-09,28.0,6,11,78,78,1,10,11,50.0,1323.0,297,4,32,36,199.0,82,5.44,62,351,2383,9.4,0.13256696
3948,3948,Brooks Orpik,2009-10,29.0,7,19,79,79,2,17,19,39.0,1606.0,376,6,49,55,238.0,82,5.7,65,341,2477,9.4,0.19064146
3949,3949,Brooks Orpik,2010-11,30.0,8,25,73,73,2,23,25,61.0,1467.0,449,8,72,80,299.0,82,5.53,56,304,2486,9.1,0.26460165
3950,3950,Brooks Orpik,2011-12,31.0,9,13,63,63,1,12,13,56.0,1316.0,512,9,84,93,355.0,82,5.46,52,291,2492,9.0,0.15075627
3951,3951,Brooks Orpik,2012-13,32.0,10,18,73,73,2,16,18,44.0,1646.0,585,11,100,111,399.0,82,5.32,47,271,2439,8.9,0.19848987
3952,3952,Brooks Orpik,2013-14,33.0,11,8,46,46,0,8,8,32.0,1025.0,631,11,108,119,431.0,48,5.31,29,160,1399,9.1,0.1315105
3953,3953,Brooks Orpik,2014-15,34.0,12,13,72,72,2,11,13,50.0,1526.0,703,13,119,132,481.0,82,5.34,48,269,2463,8.9,0.13100266
3954,3954,Brooks Orpik,2015-16,35.0,13,19,78,78,0,19,19,66.0,1700.0,781,13,138,151,547.0,82,5.32,47,251,2453,8.9,0.18584883
3955,3955,Brooks Orpik,2016-17,36.0,14,10,41,41,3,7,10,31.0,812.0,822,16,145,161,578.0,82,5.34,48,255,2438,9.0,0.1537098
3956,3956,Brooks Orpik,2017-18,37.0,15,14,79,79,0,14,14,93.0,1405.0,901,16,159,175,671.0,82,5.45,47,245,2478,9.0,0.13247925
3957,3957,Brooks Orpik,2018-19,38.0,16,10,81,81,0,10,10,54.0,1569.0,982,16,169,185,725.0,82,5.86,50,250,2620,9.2,0.10585582
3958,3958,Brooks Orpik,2019-20,39.0,17,9,53,53,2,7,9,43.0,830.0,1035,18,176,194,768.0,82,5.96,47,239,2579,9.5,0.110862195
3959,3959,Bruce Bell,1985-86,20.0,2,37,75,75,6,31,37,117.0,,75,6,31,37,117.0,80,7.77,71,321,2447,12.7,0.51238114
3960,3960,Bruce Bell,1986-87,21.0,3,20,75,75,2,18,20,95.0,,150,8,49,57,212.0,80,7.94,82,370,2484,12.8,0.37235487
3961,3961,Bruce Bell,1987-88,22.0,4,16,45,45,3,13,16,50.0,,195,11,62,73,262.0,80,7.34,72,344,2400,12.2,0.37653163
3962,3962,Bruce Bell,1988-89,23.0,5,3,13,13,1,2,3,12.0,,208,12,64,76,274.0,80,7.43,89,437,2435,12.2,0.33173615
3963,3963,Bruce Bell,1990-91,25.0,6,0,1,1,0,0,0,1.0,,209,12,64,76,275.0,80,7.37,76,367,2421,12.2,0.28046486
3964,3964,Bruce Cassidy,1984-85,19.0,2,0,1,1,0,0,0,1.0,,1,0,0,0,1.0,80,7.89,74,336,2448,12.9,0.27397004
3965,3965,Bruce Cassidy,1986-87,21.0,3,0,1,1,0,0,0,2.0,,2,0,0,0,3.0,80,7.94,82,370,2484,12.8,0.22838777
3966,3966,Bruce Cassidy,1987-88,22.0,4,0,2,2,0,0,0,0.0,,4,0,0,0,3.0,80,7.34,72,344,2400,12.2,0.21421888
3967,3967,Bruce Cassidy,1988-89,23.0,5,13,21,21,3,10,13,46.0,,25,3,10,13,49.0,80,7.43,89,437,2435,12.2,0.42705667
3968,3968,Bruce Cassidy,1989-90,24.0,6,2,9,9,0,2,2,12.0,,34,3,12,15,61.0,80,7.48,85,403,2430,12.3,0.2735833
3969,3969,Bruce Cassidy,1990-91,25.0,7,2,2,2,1,1,2,3.0,,36,4,13,17,64.0,80,7.37,76,367,2421,12.2,0.23343977
3970,3970,Bruce Crowder,1982-83,25.0,2,27,63,63,16,11,27,84.0,,63,16,11,27,84.0,80,8.03,73,320,2489,12.9,0.43647844
3971,3971,Bruce Crowder,1983-84,26.0,3,40,80,80,21,19,40,148.0,,143,37,30,67,232.0,80,7.73,71,310,2444,12.7,0.46523678
3972,3972,Bruce Crowder,1984-85,27.0,4,20,74,74,6,14,20,65.0,,217,43,44,87,297.0,80,7.89,74,336,2448,12.9,0.32934806
3973,3973,Bruce Crowder,1985-86,28.0,5,11,26,26,4,7,11,36.0,,243,47,51,98,333.0,80,7.77,71,321,2447,12.7,0.38246804
3974,3974,Bruce Driver,1984-85,22.0,2,2,4,4,0,2,2,5.0,,4,0,2,2,5.0,80,7.89,74,336,2448,12.9,0.28638977
3975,3975,Bruce Driver,1985-86,23.0,3,32,67,67,9,23,32,143.0,,71,9,25,34,148.0,80,7.77,71,321,2447,12.7,0.54640055
3976,3976,Bruce Driver,1986-87,24.0,4,18,40,40,3,15,18,64.0,,111,12,40,52,212.0,80,7.94,82,370,2484,12.8,0.4283325
3977,3977,Bruce Driver,1987-88,25.0,5,34,74,74,6,28,34,134.0,,185,18,68,86,346.0,80,7.34,72,344,2400,12.2,0.46858525
3978,3978,Bruce Driver,1988-89,26.0,6,55,74,74,15,40,55,190.0,,259,33,108,141,536.0,80,7.43,89,437,2435,12.2,0.6958444
3979,3979,Bruce Driver,1989-90,27.0,7,16,27,27,1,15,16,69.0,,286,34,123,157,605.0,80,7.48,85,403,2430,12.3,0.47506195
3980,3980,Bruce Driver,1990-91,28.0,8,53,75,75,7,46,53,185.0,,361,41,169,210,790.0,80,7.37,76,367,2421,12.2,0.65496755
3981,3981,Bruce Driver,1991-92,29.0,9,45,73,73,9,36,45,195.0,,434,50,205,255,985.0,80,6.91,71,366,2385,11.6,0.56807125
3982,3982,Bruce Driver,1992-93,30.0,10,42,78,78,7,35,42,205.0,,512,57,240,297,1190.0,80,6.96,77,402,2440,11.4,0.57338643
3983,3983,Bruce Driver,1993-94,31.0,11,54,83,83,14,40,54,177.0,,595,71,280,351,1367.0,84,7.25,87,443,2603,11.7,0.5540574
3984,3984,Bruce Driver,1994-95,32.0,12,32,66,66,8,24,32,109.0,,661,79,304,383,1476.0,84,6.48,76,407,2545,10.7,0.39226553
3985,3985,Bruce Driver,1995-96,33.0,13,16,41,41,4,12,16,62.0,,702,83,316,399,1538.0,48,5.97,37,209,1408,10.2,0.38135004
3986,3986,Bruce Driver,1996-97,34.0,14,37,66,66,3,34,37,140.0,,768,86,350,436,1678.0,82,6.29,74,413,2481,10.4,0.40345976
3987,3987,Bruce Driver,1997-98,35.0,15,30,79,79,5,25,30,154.0,,847,91,375,466,1832.0,82,5.83,55,336,2444,9.8,0.33621988
3988,3988,Bruce Driver,1998-99,36.0,16,20,75,75,5,15,20,116.0,,922,96,390,486,1948.0,82,5.28,57,380,2242,9.6,0.23703319
3989,3989,Bruce Eakin,1982-83,20.0,2,0,1,1,0,0,0,0.0,,1,0,0,0,0.0,80,8.03,73,320,2489,12.9,0.27148372
3990,3990,Bruce Eakin,1984-85,22.0,3,3,7,7,2,1,3,8.0,,8,2,1,3,8.0,80,7.89,74,336,2448,12.9,0.34752506
3991,3991,Bruce Eakin,1985-86,23.0,4,0,1,1,0,0,0,0.0,,9,2,1,3,8.0,80,7.77,71,321,2447,12.7,0.21925
3992,3992,Bruce Eakin,1986-87,24.0,5,1,4,4,0,1,1,1.0,,13,2,2,4,9.0,80,7.94,82,370,2484,12.8,0.21094644
3993,3993,Bruce Gardiner,1997-98,25.0,2,21,67,67,11,10,21,94.0,,67,11,10,21,94.0,82,5.83,55,336,2444,9.8,0.29100263
3994,3994,Bruce Gardiner,1998-99,26.0,3,18,55,55,7,11,18,64.0,,122,18,21,39,158.0,82,5.28,57,380,2242,9.6,0.31930876
3995,3995,Bruce Gardiner,1999-00,27.0,4,12,59,59,4,8,12,70.0,759.0,181,22,29,51,228.0,82,5.27,57,359,2285,9.4,0.22871587
3996,3996,Bruce Gardiner,2000-01,28.0,5,12,51,51,3,9,12,48.0,691.0,232,25,38,63,276.0,82,5.49,53,331,2294,9.8,0.22877893
3997,3997,Bruce Gardiner,2001-02,29.0,6,22,73,73,7,15,22,60.0,1066.0,305,32,53,85,336.0,82,5.51,63,376,2272,9.9,0.24692631
3998,3998,Bruce Gardiner,2002-03,30.0,7,3,7,7,2,1,3,10.0,93.0,312,34,54,88,346.0,82,5.24,53,338,2262,9.5,0.24927843
3999,3999,Bruce Holloway,1985-86,22.0,2,0,2,2,0,0,0,0.0,,2,0,0,0,0.0,80,7.77,71,321,2447,12.7,0.19461161
4000,4000,Bruce Major,1991-92,25.0,2,0,4,4,0,0,0,0.0,,4,0,0,0,0.0,80,6.91,71,366,2385,11.6,0.17548954
4001,4001,Bruce Shoebottom,1988-89,23.0,2,1,3,3,0,1,1,2.0,,3,0,1,1,2.0,80,7.43,89,437,2435,12.2,0.2401796
4002,4002,Bruce Shoebottom,1989-90,24.0,3,4,29,29,1,3,4,19.0,,32,1,4,5,21.0,80,7.48,85,403,2430,12.3,0.17990437
4003,4003,Bruce Shoebottom,1990-91,25.0,4,0,2,2,0,0,0,3.0,,34,1,4,5,24.0,80,7.37,76,367,2421,12.2,0.18819824
4004,4004,Bruce Shoebottom,1991-92,26.0,5,0,1,1,0,0,0,0.0,,35,1,4,5,24.0,80,6.91,71,366,2385,11.6,0.16780663
4005,4005,Bruno Gervais,2006-07,22.0,2,7,27,27,3,4,7,21.0,453.0,27,3,4,7,21.0,82,6.05,85,480,2458,10.1,0.27216357
4006,4006,Bruno Gervais,2007-08,23.0,3,6,51,51,0,6,6,47.0,784.0,78,3,10,13,68.0,82,5.76,70,398,2426,9.7,0.17696235
4007,4007,Bruno Gervais,2008-09,24.0,4,13,60,60,0,13,13,59.0,1200.0,138,3,23,26,127.0,82,5.44,62,351,2383,9.4,0.17175364
4008,4008,Bruno Gervais,2009-10,25.0,5,19,69,69,3,16,19,82.0,1490.0,207,6,39,45,209.0,82,5.7,65,341,2477,9.4,0.24941605
4009,4009,Bruno Gervais,2010-11,26.0,6,17,71,71,3,14,17,83.0,1421.0,278,9,53,62,292.0,82,5.53,56,304,2486,9.1,0.21916604
4010,4010,Bruno Gervais,2011-12,27.0,7,6,53,53,0,6,6,43.0,831.0,331,9,59,68,335.0,82,5.46,52,291,2492,9.0,0.13817191
4011,4011,Bruno Gervais,2012-13,28.0,8,13,50,50,6,7,13,57.0,713.0,381,15,66,81,392.0,82,5.32,47,271,2439,8.9,0.21699065
4012,4012,Bruno Gervais,2013-14,29.0,9,6,37,37,1,5,6,49.0,634.0,418,16,71,87,441.0,48,5.31,29,160,1399,9.1,0.1889599
4013,4013,Bruno St. Jacques,2002-03,22.0,2,0,7,7,0,0,0,4.0,97.0,7,0,0,0,4.0,82,5.24,53,338,2262,9.5,0.17593211
4014,4014,Bruno St. Jacques,2003-04,23.0,3,7,24,24,2,5,7,19.0,416.0,31,2,5,7,23.0,82,5.31,60,363,2326,9.4,0.23207688
4015,4015,Bruno St. Jacques,2004-05,24.0,4,2,35,35,0,2,2,16.0,414.0,66,2,7,9,39.0,82,5.14,57,348,2300,9.2,0.15249872
4016,4016,Bruno St. Jacques,2006-07,26.0,5,1,1,1,1,0,1,2.0,14.0,67,3,7,10,41.0,82,6.05,85,480,2458,10.1,0.16661194
4017,4017,Bryan Adams,2000-01,23.0,2,0,2,2,0,0,0,1.0,22.0,2,0,0,0,1.0,82,5.49,53,331,2294,9.8,0.17198798
4018,4018,Bryan Adams,2001-02,24.0,3,1,9,9,0,1,1,3.0,87.0,11,0,1,1,4.0,82,5.51,63,376,2272,9.9,0.1652785
4019,4019,Bryan Allen,2001-02,21.0,2,0,6,6,0,0,0,2.0,56.0,6,0,0,0,2.0,82,5.51,63,376,2272,9.9,0.17977896
4020,4020,Bryan Allen,2002-03,22.0,3,0,11,11,0,0,0,4.0,119.0,17,0,0,0,6.0,82,5.24,53,338,2262,9.5,0.14386123
4021,4021,Bryan Allen,2003-04,23.0,4,8,48,48,5,3,8,43.0,621.0,65,5,3,8,49.0,82,5.31,60,363,2326,9.4,0.22518659
4022,4022,Bryan Allen,2004-05,24.0,5,7,74,74,2,5,7,70.0,1247.0,139,7,8,15,119.0,82,5.14,57,348,2300,9.2,0.18863693
4023,4023,Bryan Allen,2006-07,26.0,6,17,77,77,7,10,17,88.0,1574.0,216,14,18,32,207.0,82,6.05,85,480,2458,10.1,0.22338107
4024,4024,Bryan Allen,2007-08,27.0,7,25,82,82,4,21,25,99.0,1771.0,298,18,39,57,306.0,82,5.76,70,398,2426,9.7,0.26102242
4025,4025,Bryan Allen,2008-09,28.0,8,16,73,73,2,14,16,67.0,1554.0,371,20,53,73,373.0,82,5.44,62,351,2383,9.4,0.2066879
4026,4026,Bryan Allen,2009-10,29.0,9,1,2,2,0,1,1,5.0,54.0,373,20,54,74,378.0,82,5.7,65,341,2477,9.4,0.17820716
4027,4027,Bryan Allen,2010-11,30.0,10,13,74,74,4,9,13,78.0,1418.0,447,24,63,87,456.0,82,5.53,56,304,2486,9.1,0.18057844
4028,4028,Bryan Allen,2011-12,31.0,11,17,72,72,4,13,17,58.0,1319.0,519,28,76,104,514.0,82,5.46,52,291,2492,9.0,0.17591056
4029,4029,Bryan Allen,2012-13,32.0,12,14,82,82,1,13,14,87.0,1571.0,601,29,89,118,601.0,82,5.32,47,271,2439,8.9,0.14173064
4030,4030,Bryan Allen,2013-14,33.0,13,6,41,41,0,6,6,25.0,768.0,642,29,95,124,626.0,48,5.31,29,160,1399,9.1,0.12871376
4031,4031,Bryan Allen,2014-15,34.0,14,10,68,68,0,10,10,60.0,1193.0,710,29,105,134,686.0,82,5.34,48,269,2463,8.9,0.116401404
4032,4032,Bryan Allen,2015-16,35.0,15,2,11,11,0,2,2,6.0,173.0,721,29,107,136,692.0,82,5.32,47,251,2453,8.9,0.093489885
4033,4033,Bryan Berard,1997-98,20.0,2,48,82,82,8,40,48,172.0,,82,8,40,48,172.0,82,5.83,55,336,2444,9.8,0.60050714
4034,4034,Bryan Berard,1998-99,21.0,3,46,75,75,14,32,46,192.0,,157,22,72,94,364.0,82,5.28,57,380,2242,9.6,0.6153299
4035,4035,Bryan Berard,1999-00,22.0,4,34,69,69,9,25,34,135.0,1627.0,226,31,97,128,499.0,82,5.27,57,359,2285,9.4,0.5166767
4036,4036,Bryan Berard,2000-01,23.0,5,30,64,64,3,27,30,98.0,1253.0,290,34,124,158,597.0,82,5.49,53,331,2294,9.8,0.47851923
4037,4037,Bryan Berard,2002-03,25.0,6,23,82,82,2,21,23,132.0,1610.0,372,36,145,181,729.0,82,5.24,53,338,2262,9.5,0.3751003
4038,4038,Bryan Berard,2003-04,26.0,7,38,80,80,10,28,38,205.0,1709.0,452,46,173,219,934.0,82,5.31,60,363,2326,9.4,0.53832716
4039,4039,Bryan Berard,2004-05,27.0,8,47,58,58,13,34,47,203.0,1263.0,510,59,207,266,1137.0,82,5.14,57,348,2300,9.2,0.7883305
4040,4040,Bryan Berard,2006-07,29.0,9,32,44,44,12,20,32,126.0,997.0,554,71,227,298,1263.0,82,6.05,85,480,2458,10.1,0.6140315
4041,4041,Bryan Berard,2007-08,30.0,10,3,11,11,0,3,3,22.0,209.0,565,71,230,301,1285.0,82,5.76,70,398,2426,9.7,0.3582939
4042,4042,Bryan Berard,2008-09,31.0,11,22,54,54,5,17,22,87.0,953.0,619,76,247,323,1372.0,82,5.44,62,351,2383,9.4,0.38651034
4043,4043,Bryan Bickell,2007-08,21.0,2,2,3,3,2,0,2,10.0,35.0,3,2,0,2,10.0,82,5.76,70,398,2426,9.7,0.2785641
4044,4044,Bryan Bickell,2008-09,22.0,3,0,4,4,0,0,0,3.0,37.0,7,2,0,2,13.0,82,5.44,62,351,2383,9.4,0.20167157
4045,4045,Bryan Bickell,2010-11,24.0,4,4,16,16,3,1,4,20.0,154.0,23,5,1,6,33.0,82,5.53,56,304,2486,9.1,0.26170436
4046,4046,Bryan Bickell,2011-12,25.0,5,37,78,78,17,20,37,130.0,1079.0,101,22,21,43,163.0,82,5.46,52,291,2492,9.0,0.4598049
4047,4047,Bryan Bickell,2012-13,26.0,6,24,71,71,9,15,24,84.0,862.0,172,31,36,67,247.0,82,5.32,47,271,2439,8.9,0.30021384
4048,4048,Bryan Bickell,2013-14,27.0,7,23,48,48,9,14,23,82.0,615.0,220,40,50,90,329.0,48,5.31,29,160,1399,9.1,0.41493395
4049,4049,Bryan Bickell,2014-15,28.0,8,15,59,59,11,4,15,93.0,670.0,279,51,54,105,422.0,82,5.34,48,269,2463,8.9,0.2561168
4050,4050,Bryan Bickell,2015-16,29.0,9,28,80,80,14,14,28,113.0,966.0,359,65,68,133,535.0,82,5.32,47,251,2453,8.9,0.32737392
4051,4051,Bryan Bickell,2016-17,30.0,10,2,25,25,0,2,2,21.0,245.0,384,65,70,135,556.0,82,5.34,48,255,2438,9.0,0.21105659
4052,4052,Bryan Bickell,2017-18,31.0,11,1,11,11,1,0,1,8.0,115.0,395,66,70,136,564.0,82,5.45,47,245,2478,9.0,0.17470527
4053,4053,Bryan Erickson,1984-85,24.0,2,29,45,45,12,17,29,66.0,,45,12,17,29,66.0,80,7.89,74,336,2448,12.9,0.48713994
4054,4054,Bryan Erickson,1985-86,25.0,3,28,57,57,15,13,28,79.0,,102,27,30,57,145.0,80,7.77,71,321,2447,12.7,0.4715359
4055,4055,Bryan Erickson,1986-87,26.0,4,43,55,55,20,23,43,108.0,,157,47,53,100,253.0,80,7.94,82,370,2484,12.8,0.6068452
4056,4056,Bryan Erickson,1987-88,27.0,5,50,68,68,20,30,50,142.0,,225,67,83,150,395.0,80,7.34,72,344,2400,12.2,0.6352975
4057,4057,Bryan Erickson,1988-89,28.0,6,26,53,53,7,19,26,81.0,,278,74,102,176,476.0,80,7.43,89,437,2435,12.2,0.58604777
4058,4058,Bryan Erickson,1991-92,31.0,7,7,6,6,0,7,7,16.0,,284,74,109,183,492.0,80,6.91,71,366,2385,11.6,0.5325679
4059,4059,Bryan Erickson,1992-93,32.0,8,6,10,10,2,4,6,16.0,,294,76,113,189,508.0,80,6.96,77,402,2440,11.4,0.39971173
4060,4060,Bryan Erickson,1993-94,33.0,9,16,41,41,4,12,16,45.0,,335,80,125,205,553.0,84,7.25,87,443,2603,11.7,0.34336278
4061,4061,Bryan Erickson,1994-95,34.0,10,0,16,16,0,0,0,8.0,,351,80,125,205,561.0,84,6.48,76,407,2545,10.7,0.26073796
4062,4062,Bryan Fogarty,1990-91,21.0,2,14,45,45,4,10,14,93.0,,45,4,10,14,93.0,80,7.37,76,367,2421,12.2,0.37720537
4063,4063,Bryan Fogarty,1991-92,22.0,3,31,45,45,9,22,31,107.0,,90,13,32,45,200.0,80,6.91,71,366,2385,11.6,0.57318616
4064,4064,Bryan Fogarty,1992-93,23.0,4,15,20,20,3,12,15,30.0,,110,16,44,60,230.0,80,6.96,77,402,2440,11.4,0.47594526
4065,4065,Bryan Fogarty,1993-94,24.0,5,4,12,12,0,4,4,11.0,,122,16,48,64,241.0,84,7.25,87,443,2603,11.7,0.29303578
4066,4066,Bryan Fogarty,1994-95,25.0,6,3,13,13,1,2,3,22.0,,135,17,50,67,263.0,84,6.48,76,407,2545,10.7,0.26034063
4067,4067,Bryan Fogarty,1995-96,26.0,7,7,21,21,5,2,7,41.0,,156,22,52,74,304.0,48,5.97,37,209,1408,10.2,0.35211998
4068,4068,Bryan Helmer,1999-00,27.0,2,4,40,40,0,4,4,49.0,640.0,40,0,4,4,49.0,82,5.27,57,359,2285,9.4,0.15801546
4069,4069,Bryan Helmer,2000-01,28.0,3,2,15,15,1,1,2,19.0,244.0,55,1,5,6,68.0,82,5.49,53,331,2294,9.8,0.16471988
4070,4070,Bryan Helmer,2001-02,29.0,4,6,20,20,2,4,6,28.0,337.0,75,3,9,12,96.0,82,5.51,63,376,2272,9.9,0.20404333
4071,4071,Bryan Helmer,2002-03,30.0,5,10,40,40,5,5,10,43.0,483.0,115,8,14,22,139.0,82,5.24,53,338,2262,9.5,0.19912547
4072,4072,Bryan Helmer,2003-04,31.0,6,0,2,2,0,0,0,2.0,27.0,117,8,14,22,141.0,82,5.31,60,363,2326,9.4,0.15318632
4073,4073,Bryan Helmer,2004-05,32.0,7,1,17,17,0,1,1,10.0,217.0,134,8,15,23,151.0,82,5.14,57,348,2300,9.2,0.162599
4074,4074,Bryan Helmer,2009-10,37.0,8,3,12,12,0,3,3,8.0,199.0,146,8,18,26,159.0,82,5.7,65,341,2477,9.4,0.15297022
4075,4075,Bryan Lerg,2015-16,30.0,2,1,2,2,1,0,1,8.0,25.0,2,1,0,1,8.0,82,5.32,47,251,2453,8.9,0.1923809
4076,4076,Bryan Lerg,2016-17,31.0,3,0,6,6,0,0,0,4.0,53.0,8,1,0,1,12.0,82,5.34,48,255,2438,9.0,0.14749521
4077,4077,Bryan Little,2008-09,21.0,2,16,48,48,6,10,16,76.0,749.0,48,6,10,16,76.0,82,5.44,62,351,2383,9.4,0.38418034
4078,4078,Bryan Little,2009-10,22.0,3,51,79,79,31,20,51,172.0,1337.0,127,37,30,67,248.0,82,5.7,65,341,2477,9.4,0.6600825
4079,4079,Bryan Little,2010-11,23.0,4,34,79,79,13,21,34,165.0,1244.0,206,50,51,101,413.0,82,5.53,56,304,2486,9.1,0.51017267
4080,4080,Bryan Little,2011-12,24.0,5,48,76,76,18,30,48,158.0,1403.0,282,68,81,149,571.0,82,5.46,52,291,2492,9.0,0.60440147
4081,4081,Bryan Little,2012-13,25.0,6,46,74,74,24,22,46,162.0,1496.0,356,92,103,195,733.0,82,5.32,47,271,2439,8.9,0.5898355
4082,4082,Bryan Little,2013-14,26.0,7,32,48,48,7,25,32,84.0,950.0,404,99,128,227,817.0,48,5.31,29,160,1399,9.1,0.6423794
4083,4083,Bryan Little,2014-15,27.0,8,64,82,82,23,41,64,170.0,1640.0,486,122,169,291,987.0,82,5.34,48,269,2463,8.9,0.7006242
4084,4084,Bryan Little,2015-16,28.0,9,52,70,70,24,28,52,148.0,1394.0,556,146,197,343,1135.0,82,5.32,47,251,2453,8.9,0.6434915
4085,4085,Bryan Little,2016-17,29.0,10,42,57,57,17,25,42,127.0,1117.0,613,163,222,385,1262.0,82,5.34,48,255,2438,9.0,0.64273393
4086,4086,Bryan Little,2017-18,30.0,11,47,59,59,21,26,47,119.0,1036.0,672,184,248,432,1381.0,82,5.45,47,245,2478,9.0,0.64730924
4087,4087,Bryan Little,2018-19,31.0,12,43,82,82,16,27,43,129.0,1389.0,754,200,275,475,1510.0,82,5.86,50,250,2620,9.2,0.49349153
4088,4088,Bryan Little,2019-20,32.0,13,41,82,82,15,26,41,126.0,1298.0,836,215,301,516,1636.0,82,5.96,47,239,2579,9.5,0.4946375
4089,4089,Bryan Little,2020-21,33.0,14,5,7,7,2,3,5,13.0,113.0,843,217,304,521,1649.0,70,5.96,42,208,2192,9.5,0.39661714
4090,4090,Bryan Marchment,1989-90,20.0,2,0,2,2,0,0,0,1.0,,2,0,0,0,1.0,80,7.48,85,403,2430,12.3,0.27996272
4091,4091,Bryan Marchment,1990-91,21.0,3,2,7,7,0,2,2,5.0,,9,0,2,2,6.0,80,7.37,76,367,2421,12.2,0.27947253
4092,4092,Bryan Marchment,1991-92,22.0,4,4,28,28,2,2,4,24.0,,37,2,4,6,30.0,80,6.91,71,366,2385,11.6,0.2734795
4093,4093,Bryan Marchment,1992-93,23.0,5,15,58,58,5,10,15,55.0,,95,7,14,21,85.0,80,6.96,77,402,2440,11.4,0.27730405
4094,4094,Bryan Marchment,1993-94,24.0,6,20,78,78,5,15,20,75.0,,173,12,29,41,160.0,84,7.25,87,443,2603,11.7,0.23530176
4095,4095,Bryan Marchment,1994-95,25.0,7,15,55,55,4,11,15,92.0,,228,16,40,56,252.0,84,6.48,76,407,2545,10.7,0.24998486
4096,4096,Bryan Marchment,1995-96,26.0,8,6,40,40,1,5,6,57.0,,268,17,45,62,309.0,48,5.97,37,209,1408,10.2,0.20373315
4097,4097,Bryan Marchment,1996-97,27.0,9,18,78,78,3,15,18,96.0,,346,20,60,80,405.0,82,6.29,74,413,2481,10.4,0.22775221
4098,4098,Bryan Marchment,1997-98,28.0,10,16,71,71,3,13,16,89.0,,417,23,73,96,494.0,82,5.83,55,336,2444,9.8,0.2170164
4099,4099,Bryan Marchment,1998-99,29.0,11,13,61,61,2,11,13,56.0,,478,25,84,109,550.0,82,5.28,57,380,2242,9.6,0.18237904
4100,4100,Bryan Marchment,1999-00,30.0,12,8,59,59,2,6,8,49.0,1045.0,537,27,90,117,599.0,82,5.27,57,359,2285,9.4,0.15604141
4101,4101,Bryan Marchment,2000-01,31.0,13,4,49,49,0,4,4,51.0,927.0,586,27,94,121,650.0,82,5.49,53,331,2294,9.8,0.14779705
4102,4102,Bryan Marchment,2001-02,32.0,14,18,75,75,7,11,18,73.0,1365.0,661,34,105,139,723.0,82,5.51,63,376,2272,9.9,0.21798456
4103,4103,Bryan Marchment,2002-03,33.0,15,22,72,72,2,20,22,68.0,1353.0,733,36,125,161,791.0,82,5.24,53,338,2262,9.5,0.21016067
4104,4104,Bryan Marchment,2003-04,34.0,16,14,81,81,2,12,14,84.0,1528.0,814,38,137,175,875.0,82,5.31,60,363,2326,9.4,0.14203605
4105,4105,Bryan Marchment,2004-05,35.0,17,4,75,75,1,3,4,56.0,1142.0,889,39,140,179,931.0,82,5.14,57,348,2300,9.2,0.10726634
4106,4106,Bryan Marchment,2006-07,37.0,18,3,37,37,1,2,3,16.0,485.0,926,40,142,182,947.0,82,6.05,85,480,2458,10.1,0.098822504
4107,4107,Bryan McCabe,1996-97,21.0,2,23,82,82,7,16,23,130.0,,82,7,16,23,130.0,82,6.29,74,413,2481,10.4,0.37160102
4108,4108,Bryan McCabe,1997-98,22.0,3,28,82,82,8,20,28,117.0,,164,15,36,51,247.0,82,5.83,55,336,2444,9.8,0.38079187
4109,4109,Bryan McCabe,1998-99,23.0,4,24,82,82,4,20,24,123.0,,246,19,56,75,370.0,82,5.28,57,380,2242,9.6,0.32008386
4110,4110,Bryan McCabe,1999-00,24.0,5,21,69,69,7,14,21,98.0,1671.0,315,26,70,96,468.0,82,5.27,57,359,2285,9.4,0.3409137
4111,4111,Bryan McCabe,2000-01,25.0,6,25,79,79,6,19,25,119.0,1848.0,394,32,89,121,587.0,82,5.49,53,331,2294,9.8,0.3735515
4112,4112,Bryan McCabe,2001-02,26.0,7,29,82,82,5,24,29,159.0,1953.0,476,37,113,150,746.0,82,5.51,63,376,2272,9.9,0.41661903
4113,4113,Bryan McCabe,2002-03,27.0,8,43,82,82,17,26,43,157.0,2015.0,558,54,139,193,903.0,82,5.24,53,338,2262,9.5,0.52590644
4114,4114,Bryan McCabe,2003-04,28.0,9,24,75,75,6,18,24,149.0,1773.0,633,60,157,217,1052.0,82,5.31,60,363,2326,9.4,0.3338311
4115,4115,Bryan McCabe,2004-05,29.0,10,53,75,75,16,37,53,168.0,1930.0,708,76,194,270,1220.0,82,5.14,57,348,2300,9.2,0.7371635
4116,4116,Bryan McCabe,2006-07,31.0,11,68,73,73,19,49,68,207.0,2066.0,781,95,243,338,1427.0,82,6.05,85,480,2458,10.1,0.77374303
4117,4117,Bryan McCabe,2007-08,32.0,12,57,82,82,15,42,57,207.0,2200.0,863,110,285,395,1634.0,82,5.76,70,398,2426,9.7,0.6235227
4118,4118,Bryan McCabe,2008-09,33.0,13,23,54,54,5,18,23,107.0,1400.0,917,115,303,418,1741.0,82,5.44,62,351,2383,9.4,0.39575797
4119,4119,Bryan McCabe,2009-10,34.0,14,39,69,69,15,24,39,153.0,1596.0,986,130,327,457,1894.0,82,5.7,65,341,2477,9.4,0.47940645
4120,4120,Bryan McCabe,2010-11,35.0,15,43,82,82,8,35,43,169.0,1913.0,1068,138,362,500,2063.0,82,5.53,56,304,2486,9.1,0.45928648
4121,4121,Bryan McCabe,2011-12,36.0,16,28,67,67,7,21,28,122.0,1311.0,1135,145,383,528,2185.0,82,5.46,52,291,2492,9.0,0.33316353
4122,4122,Bryan Muir,1996-97,23.0,2,0,5,5,0,0,0,4.0,,5,0,0,0,4.0,82,6.29,74,413,2481,10.4,0.17841864
4123,4123,Bryan Muir,1998-99,25.0,3,0,7,7,0,0,0,6.0,,12,0,0,0,10.0,82,5.28,57,380,2242,9.6,0.16363478
4124,4124,Bryan Muir,1999-00,26.0,4,5,54,54,1,4,5,82.0,1007.0,66,1,4,5,92.0,82,5.27,57,359,2285,9.4,0.18183133
4125,4125,Bryan Muir,2000-01,27.0,5,7,41,41,3,4,7,51.0,781.0,107,4,8,12,143.0,82,5.49,53,331,2294,9.8,0.17669606
4126,4126,Bryan Muir,2001-02,28.0,6,3,18,18,0,3,3,17.0,252.0,125,4,11,15,160.0,82,5.51,63,376,2272,9.9,0.14397007
4127,4127,Bryan Muir,2002-03,29.0,7,2,22,22,1,1,2,26.0,227.0,147,5,12,17,186.0,82,5.24,53,338,2262,9.5,0.15307069
4128,4128,Bryan Muir,2003-04,30.0,8,2,32,32,0,2,2,9.0,209.0,179,5,14,19,195.0,82,5.31,60,363,2326,9.4,0.093997836
4129,4129,Bryan Muir,2004-05,31.0,9,1,2,2,0,1,1,2.0,36.0,181,5,15,20,197.0,82,5.14,57,348,2300,9.2,0.17957911
4130,4130,Bryan Muir,2006-07,33.0,10,26,72,72,8,18,26,136.0,1524.0,253,13,33,46,333.0,82,6.05,85,480,2458,10.1,0.29084384
4131,4131,Bryan Muir,2007-08,34.0,11,7,26,26,3,4,7,28.0,380.0,279,16,37,53,361.0,82,5.76,70,398,2426,9.7,0.17620918
4132,4132,Bryan Rodney,2009-10,25.0,2,2,8,8,0,2,2,3.0,101.0,8,0,2,2,3.0,82,5.7,65,341,2477,9.4,0.18279117
4133,4133,Bryan Rodney,2010-11,26.0,3,11,22,22,1,10,11,24.0,368.0,30,1,12,13,27.0,82,5.53,56,304,2486,9.1,0.2466723
4134,4134,Bryan Rodney,2011-12,27.0,4,0,3,3,0,0,0,3.0,26.0,33,1,12,13,30.0,82,5.46,52,291,2492,9.0,0.1662252
4135,4135,Bryan Rodney,2012-13,28.0,5,0,1,1,0,0,0,0.0,13.0,34,1,12,13,30.0,82,5.32,47,271,2439,8.9,0.15749496
4136,4136,Bryan Rust,2015-16,23.0,2,2,14,14,1,1,2,34.0,168.0,14,1,1,2,34.0,82,5.32,47,251,2453,8.9,0.24249712
4137,4137,Bryan Rust,2016-17,24.0,3,11,41,41,4,7,11,68.0,512.0,55,5,8,13,102.0,82,5.34,48,255,2438,9.0,0.2524838
4138,4138,Bryan Rust,2017-18,25.0,4,28,57,57,15,13,28,110.0,777.0,112,20,21,41,212.0,82,5.45,47,245,2478,9.0,0.45522967
4139,4139,Bryan Rust,2018-19,26.0,5,38,69,69,13,25,38,123.0,1107.0,181,33,46,79,335.0,82,5.86,50,250,2620,9.2,0.47424197
4140,4140,Bryan Rust,2019-20,27.0,6,35,72,72,18,17,35,141.0,1145.0,253,51,63,114,476.0,82,5.96,47,239,2579,9.5,0.453493
4141,4141,Bryan Rust,2020-21,28.0,7,56,55,55,27,29,56,151.0,1087.0,308,78,92,170,627.0,70,5.96,42,208,2192,9.5,0.8287324
4142,4142,Bryan Smolinski,1993-94,22.0,2,4,9,9,1,3,4,10.0,,9,1,3,4,10.0,84,7.25,87,443,2603,11.7,0.27325857
4143,4143,Bryan Smolinski,1994-95,23.0,3,51,83,83,31,20,51,179.0,,92,32,23,55,189.0,84,6.48,76,407,2545,10.7,0.62104464
4144,4144,Bryan Smolinski,1995-96,24.0,4,31,44,44,18,13,31,121.0,,136,50,36,86,310.0,48,5.97,37,209,1408,10.2,0.65363675
4145,4145,Bryan Smolinski,1996-97,25.0,5,64,81,81,24,40,64,229.0,,217,74,76,150,539.0,82,6.29,74,413,2481,10.4,0.6888665
4146,4146,Bryan Smolinski,1997-98,26.0,6,56,64,64,28,28,56,183.0,,281,102,104,206,722.0,82,5.83,55,336,2444,9.8,0.76643205
4147,4147,Bryan Smolinski,1998-99,27.0,7,43,81,81,13,30,43,203.0,,362,115,134,249,925.0,82,5.28,57,380,2242,9.6,0.569149
4148,4148,Bryan Smolinski,1999-00,28.0,8,40,82,82,16,24,40,223.0,1584.0,444,131,158,289,1148.0,82,5.27,57,359,2285,9.4,0.5926888
4149,4149,Bryan Smolinski,2000-01,29.0,9,56,79,79,20,36,56,160.0,1468.0,523,151,194,345,1308.0,82,5.49,53,331,2294,9.8,0.69655436
4150,4150,Bryan Smolinski,2001-02,30.0,10,59,78,78,27,32,59,183.0,1445.0,601,178,226,404,1491.0,82,5.51,63,376,2272,9.9,0.6608089
4151,4151,Bryan Smolinski,2002-03,31.0,11,38,80,80,13,25,38,187.0,1551.0,681,191,251,442,1678.0,82,5.24,53,338,2262,9.5,0.54665047
4152,4152,Bryan Smolinski,2003-04,32.0,12,46,68,68,21,25,46,176.0,1261.0,749,212,276,488,1854.0,82,5.31,60,363,2326,9.4,0.61486995
4153,4153,Bryan Smolinski,2004-05,33.0,13,46,80,80,19,27,46,182.0,1332.0,829,231,303,534,2036.0,82,5.14,57,348,2300,9.2,0.62049633
4154,4154,Bryan Smolinski,2006-07,35.0,14,48,81,81,17,31,48,178.0,1199.0,910,248,334,582,2214.0,82,6.05,85,480,2458,10.1,0.5095675
4155,4155,Bryan Smolinski,2007-08,36.0,15,44,82,82,18,26,44,163.0,1475.0,992,266,360,626,2377.0,82,5.76,70,398,2426,9.7,0.46089283
4156,4156,Bryan Smolinski,2008-09,37.0,16,25,64,64,8,17,25,89.0,840.0,1056,274,377,651,2466.0,82,5.44,62,351,2383,9.4,0.3125542
4157,4157,Bryan Young,2007-08,21.0,2,0,15,15,0,0,0,2.0,152.0,15,0,0,0,2.0,82,5.76,70,398,2426,9.7,0.14158398
4158,4158,Bryan Young,2008-09,22.0,3,0,2,2,0,0,0,0.0,4.0,17,0,0,0,2.0,82,5.44,62,351,2383,9.4,0.15709585
4159,4159,Bryce Lampman,2004-05,22.0,2,0,8,8,0,0,0,7.0,156.0,8,0,0,0,7.0,82,5.14,57,348,2300,9.2,0.19016725
4160,4160,Bryce Lampman,2006-07,24.0,3,0,1,1,0,0,0,1.0,14.0,9,0,0,0,8.0,82,6.05,85,480,2458,10.1,0.16463631
4161,4161,Bryce Lampman,2007-08,25.0,4,0,1,1,0,0,0,0.0,12.0,10,0,0,0,8.0,82,5.76,70,398,2426,9.7,0.15585825
4162,4162,Bryce Salvador,2001-02,25.0,2,10,75,75,2,8,10,60.0,1247.0,75,2,8,10,60.0,82,5.51,63,376,2272,9.9,0.15188673
4163,4163,Bryce Salvador,2002-03,26.0,3,12,66,66,5,7,12,37.0,1117.0,141,7,15,22,97.0,82,5.24,53,338,2262,9.5,0.16818643
4164,4164,Bryce Salvador,2003-04,27.0,4,10,71,71,2,8,10,73.0,1346.0,212,9,23,32,170.0,82,5.31,60,363,2326,9.4,0.181382
4165,4165,Bryce Salvador,2004-05,28.0,5,8,69,69,3,5,8,60.0,1206.0,281,12,28,40,230.0,82,5.14,57,348,2300,9.2,0.1618298
4166,4166,Bryce Salvador,2006-07,30.0,6,5,46,46,1,4,5,23.0,911.0,327,13,32,45,253.0,82,6.05,85,480,2458,10.1,0.10768375
4167,4167,Bryce Salvador,2007-08,31.0,7,7,64,64,2,5,7,40.0,1263.0,391,15,37,52,293.0,82,5.76,70,398,2426,9.7,0.13649064
4168,4168,Bryce Salvador,2008-09,32.0,8,11,64,64,1,10,11,29.0,1267.0,455,16,47,63,322.0,82,5.44,62,351,2383,9.4,0.124642015
4169,4169,Bryce Salvador,2009-10,33.0,9,16,76,76,3,13,16,68.0,1481.0,531,19,60,79,390.0,82,5.7,65,341,2477,9.4,0.1721763
4170,4170,Bryce Salvador,2010-11,34.0,10,14,79,79,4,10,14,47.0,1490.0,610,23,70,93,437.0,82,5.53,56,304,2486,9.1,0.14191827
4171,4171,Bryce Salvador,2012-13,36.0,11,9,82,82,0,9,9,52.0,1657.0,692,23,79,102,489.0,82,5.32,47,271,2439,8.9,0.12232229
4172,4172,Bryce Salvador,2013-14,37.0,12,2,39,39,0,2,2,29.0,832.0,731,23,81,104,518.0,48,5.31,29,160,1399,9.1,0.10157123
4173,4173,Bryce Salvador,2014-15,38.0,13,4,40,40,1,3,4,24.0,812.0,771,24,84,108,542.0,82,5.34,48,269,2463,8.9,0.10877299
4174,4174,Bryce Salvador,2015-16,39.0,14,2,15,15,0,2,2,13.0,278.0,786,24,86,110,555.0,82,5.32,47,251,2453,8.9,0.12036303
4175,4175,Bryce Van Brabant,2014-15,23.0,2,0,6,6,0,0,0,4.0,55.0,6,0,0,0,4.0,82,5.34,48,269,2463,8.9,0.17318648
4176,4176,Bryon Baltimore,1980-81,28.0,2,0,2,2,0,0,0,2.0,,2,0,0,0,2.0,80,7.03,61,280,2352,12.0,0.21353826
4177,4177,Bubba Berenzweig,2000-01,23.0,2,0,2,2,0,0,0,3.0,35.0,2,0,0,0,3.0,82,5.49,53,331,2294,9.8,0.17768398
4178,4178,Bubba Berenzweig,2001-02,24.0,3,0,5,5,0,0,0,0.0,60.0,7,0,0,0,3.0,82,5.51,63,376,2272,9.9,0.14691606
4179,4179,Bubba Berenzweig,2002-03,25.0,4,10,26,26,3,7,10,27.0,357.0,33,3,7,10,30.0,82,5.24,53,338,2262,9.5,0.23394546
4180,4180,Bubba Berenzweig,2003-04,26.0,5,0,4,4,0,0,0,5.0,71.0,37,3,7,10,35.0,82,5.31,60,363,2326,9.4,0.15735376
4181,4181,Bud Holloway,2016-17,28.0,2,0,1,1,0,0,0,1.0,7.0,1,0,0,0,1.0,82,5.34,48,255,2438,9.0,0.15240568
4182,4182,Buddy Robinson,2016-17,25.0,2,2,3,3,1,1,2,5.0,26.0,3,1,1,2,5.0,82,5.34,48,255,2438,9.0,0.19910476
4183,4183,Buddy Robinson,2017-18,26.0,3,0,4,4,0,0,0,4.0,28.0,7,1,1,2,9.0,82,5.45,47,245,2478,9.0,0.16948527
4184,4184,Buddy Robinson,2020-21,29.0,4,1,5,5,1,0,1,6.0,61.0,12,2,1,3,15.0,70,5.96,42,208,2192,9.5,0.20321724
4185,4185,Burke Henry,2003-04,25.0,2,2,16,16,0,2,2,25.0,297.0,16,0,2,2,25.0,82,5.31,60,363,2326,9.4,0.20896262
4186,4186,Burke Henry,2004-05,26.0,3,6,23,23,2,4,6,31.0,392.0,39,2,6,8,56.0,82,5.14,57,348,2300,9.2,0.23731807
4187,4187,Byron Bitz,2009-10,25.0,2,7,35,35,4,3,7,31.0,363.0,35,4,3,7,31.0,82,5.7,65,341,2477,9.4,0.22376627
4188,4188,Byron Bitz,2010-11,26.0,3,11,52,52,5,6,11,58.0,574.0,87,9,9,18,89.0,82,5.53,56,304,2486,9.1,0.22451094
4189,4189,Byron Bitz,2012-13,28.0,4,4,10,10,1,3,4,6.0,105.0,97,10,12,22,95.0,82,5.32,47,271,2439,8.9,0.18784446
4190,4190,Byron Froese,2016-17,25.0,2,5,56,56,2,3,5,64.0,707.0,56,2,3,5,64.0,82,5.34,48,255,2438,9.0,0.16006708
4191,4191,Byron Froese,2017-18,26.0,3,0,6,6,0,0,0,6.0,63.0,62,2,3,5,70.0,82,5.45,47,245,2478,9.0,0.14468348
4192,4192,Byron Froese,2018-19,27.0,4,11,48,48,3,8,11,49.0,556.0,110,5,11,16,119.0,82,5.86,50,250,2620,9.2,0.19822478
4193,4193,Byron Ritchie,1999-00,22.0,2,0,3,3,0,0,0,0.0,10.0,3,0,0,0,0.0,82,5.27,57,359,2285,9.4,0.16821095
4194,4194,Byron Ritchie,2000-01,23.0,3,2,26,26,0,2,2,13.0,193.0,29,0,2,2,13.0,82,5.49,53,331,2294,9.8,0.12423208
4195,4195,Byron Ritchie,2002-03,25.0,4,11,35,35,5,6,11,60.0,431.0,64,5,8,13,73.0,82,5.24,53,338,2262,9.5,0.24233398
4196,4196,Byron Ritchie,2003-04,26.0,5,3,30,30,0,3,3,29.0,279.0,94,5,11,16,102.0,82,5.31,60,363,2326,9.4,0.17684484
4197,4197,Byron Ritchie,2004-05,27.0,6,11,50,50,5,6,11,65.0,695.0,144,10,17,27,167.0,82,5.14,57,348,2300,9.2,0.22861582
4198,4198,Byron Ritchie,2006-07,29.0,7,6,45,45,4,2,6,34.0,444.0,189,14,19,33,201.0,82,6.05,85,480,2458,10.1,0.13226306
4199,4199,Byron Ritchie,2007-08,30.0,8,14,64,64,8,6,14,46.0,625.0,253,22,25,47,247.0,82,5.76,70,398,2426,9.7,0.16477042
4200,4200,Byron Ritchie,2008-09,31.0,9,11,71,71,3,8,11,73.0,875.0,324,25,33,58,320.0,82,5.44,62,351,2383,9.4,0.16810772
4201,4201,C.J. Smith,2017-18,23.0,2,1,2,2,0,1,1,2.0,23.0,2,0,1,1,2.0,82,5.45,47,245,2478,9.0,0.2067815
4202,4202,C.J. Smith,2019-20,25.0,3,2,11,11,2,0,2,18.0,117.0,13,2,1,3,20.0,82,5.96,47,239,2579,9.5,0.21732968
4203,4203,C.J. Suess,2020-21,26.0,2,0,1,1,0,0,0,0.0,6.0,1,0,0,0,0.0,70,5.96,42,208,2192,9.5,0.18012562
4204,4204,C.J. Young,1993-94,26.0,2,14,43,43,7,7,14,43.0,,43,7,7,14,43.0,84,7.25,87,443,2603,11.7,0.2646135
4205,4205,Cade Fairchild,2012-13,24.0,2,1,5,5,0,1,1,1.0,48.0,5,0,1,1,1.0,82,5.32,47,271,2439,8.9,0.1822609
4206,4206,Cal Clutterbuck,2008-09,21.0,2,0,2,2,0,0,0,0.0,14.0,2,0,0,0,0.0,82,5.44,62,351,2383,9.4,0.20099464
4207,4207,Cal Clutterbuck,2009-10,22.0,3,18,78,78,11,7,18,136.0,1014.0,80,11,7,18,136.0,82,5.7,65,341,2477,9.4,0.35025096
4208,4208,Cal Clutterbuck,2010-11,23.0,4,21,74,74,13,8,21,136.0,1057.0,154,24,15,39,272.0,82,5.53,56,304,2486,9.1,0.36460817
4209,4209,Cal Clutterbuck,2011-12,24.0,5,34,76,76,19,15,34,191.0,1204.0,230,43,30,73,463.0,82,5.46,52,291,2492,9.0,0.46701503
4210,4210,Cal Clutterbuck,2012-13,25.0,6,27,74,74,15,12,27,161.0,1210.0,304,58,42,100,624.0,82,5.32,47,271,2439,8.9,0.3901653
4211,4211,Cal Clutterbuck,2013-14,26.0,7,10,42,42,4,6,10,87.0,577.0,346,62,48,110,711.0,48,5.31,29,160,1399,9.1,0.29632258
4212,4212,Cal Clutterbuck,2014-15,27.0,8,19,73,73,12,7,19,172.0,1046.0,419,74,55,129,883.0,82,5.34,48,269,2463,8.9,0.2792009
4213,4213,Cal Clutterbuck,2015-16,28.0,9,16,76,76,7,9,16,124.0,967.0,495,81,64,145,1007.0,82,5.32,47,251,2453,8.9,0.23472089
4214,4214,Cal Clutterbuck,2016-17,29.0,10,23,77,77,15,8,23,80.0,918.0,572,96,72,168,1087.0,82,5.34,48,255,2438,9.0,0.29120946
4215,4215,Cal Clutterbuck,2017-18,30.0,11,20,66,66,5,15,20,115.0,924.0,638,101,87,188,1202.0,82,5.45,47,245,2478,9.0,0.28292933
4216,4216,Cal Clutterbuck,2018-19,31.0,12,18,76,76,8,10,18,101.0,972.0,714,109,97,206,1303.0,82,5.86,50,250,2620,9.2,0.24742499
4217,4217,Cal Clutterbuck,2019-20,32.0,13,23,73,73,8,15,23,95.0,1020.0,787,117,112,229,1398.0,82,5.96,47,239,2579,9.5,0.26464415
4218,4218,Cal Clutterbuck,2020-21,33.0,14,7,37,37,3,4,7,35.0,497.0,824,120,116,236,1433.0,70,5.96,42,208,2192,9.5,0.21363366
4219,4219,Cal O'Reilly,2009-10,23.0,2,5,11,11,3,2,5,6.0,139.0,11,3,2,5,6.0,82,5.7,65,341,2477,9.4,0.27144837
4220,4220,Cal O'Reilly,2010-11,24.0,3,11,31,31,2,9,11,23.0,423.0,42,5,11,16,29.0,82,5.53,56,304,2486,9.1,0.23832768
4221,4221,Cal O'Reilly,2011-12,25.0,4,18,38,38,6,12,18,44.0,642.0,80,11,23,34,73.0,82,5.46,52,291,2492,9.0,0.3635677
4222,4222,Cal O'Reilly,2012-13,26.0,5,7,33,33,2,5,7,17.0,421.0,113,13,28,41,90.0,82,5.32,47,271,2439,8.9,0.21117318
4223,4223,Cal O'Reilly,2016-17,30.0,6,7,20,20,3,4,7,10.0,224.0,133,16,32,48,100.0,82,5.34,48,255,2438,9.0,0.2082527
4224,4224,Cal O'Reilly,2017-18,31.0,7,1,11,11,0,1,1,3.0,87.0,144,16,33,49,103.0,82,5.45,47,245,2478,9.0,0.13592383
4225,4225,Cal O'Reilly,2018-19,32.0,8,0,1,1,0,0,0,1.0,8.0,145,16,33,49,104.0,82,5.86,50,250,2620,9.2,0.15506488
4226,4226,Cale Fleury,2020-21,22.0,2,1,41,41,1,0,1,45.0,588.0,41,1,0,1,45.0,70,5.96,42,208,2192,9.5,0.19019279
4227,4227,Cale Hulse,1996-97,23.0,2,0,11,11,0,0,0,9.0,,11,0,0,0,9.0,82,6.29,74,413,2481,10.4,0.17472386
4228,4228,Cale Hulse,1997-98,24.0,3,7,63,63,1,6,7,58.0,,74,1,6,7,67.0,82,5.83,55,336,2444,9.8,0.15457463
4229,4229,Cale Hulse,1998-99,25.0,4,27,79,79,5,22,27,117.0,,153,6,28,34,184.0,82,5.28,57,380,2242,9.6,0.29185605
4230,4230,Cale Hulse,1999-00,26.0,5,12,73,73,3,9,12,83.0,1214.0,226,9,37,46,267.0,82,5.27,57,359,2285,9.4,0.21822289
4231,4231,Cale Hulse,2000-01,27.0,6,7,47,47,1,6,7,41.0,594.0,273,10,43,53,308.0,82,5.49,53,331,2294,9.8,0.16237006
4232,4232,Cale Hulse,2001-02,28.0,7,8,82,82,1,7,8,93.0,1647.0,355,11,50,61,401.0,82,5.51,63,376,2272,9.9,0.16420475
4233,4233,Cale Hulse,2002-03,29.0,8,2,63,63,0,2,2,70.0,1188.0,418,11,52,63,471.0,82,5.24,53,338,2262,9.5,0.14279744
4234,4234,Cale Hulse,2003-04,30.0,9,8,80,80,2,6,8,82.0,1527.0,498,13,58,71,553.0,82,5.31,60,363,2326,9.4,0.16305995
4235,4235,Cale Hulse,2004-05,31.0,10,20,82,82,3,17,20,115.0,1760.0,580,16,75,91,668.0,82,5.14,57,348,2300,9.2,0.21615216
4236,4236,Cale Hulse,2006-07,33.0,11,4,39,39,0,4,4,34.0,596.0,619,16,79,95,702.0,82,6.05,85,480,2458,10.1,0.11608252
4237,4237,Cale Makar,2020-21,22.0,2,50,57,57,12,38,50,121.0,1198.0,57,12,38,50,121.0,70,5.96,42,208,2192,9.5,0.7786145
4238,4238,Caleb Jones,2019-20,22.0,2,6,17,17,1,5,6,21.0,337.0,17,1,5,6,21.0,82,5.96,47,239,2579,9.5,0.25864232
4239,4239,Caleb Jones,2020-21,23.0,3,9,43,43,4,5,9,38.0,608.0,60,5,10,15,59.0,70,5.96,42,208,2192,9.5,0.22441989
4240,4240,Calle Jarnkrok,2014-15,23.0,2,9,12,12,2,7,9,13.0,169.0,12,2,7,9,13.0,82,5.34,48,269,2463,8.9,0.26124611
4241,4241,Calle Jarnkrok,2015-16,24.0,3,18,74,74,7,11,18,95.0,951.0,86,9,18,27,108.0,82,5.32,47,251,2453,8.9,0.31267637
4242,4242,Calle Jarnkrok,2016-17,25.0,4,30,81,81,16,14,30,125.0,1307.0,167,25,32,57,233.0,82,5.34,48,255,2438,9.0,0.40312135
4243,4243,Calle Jarnkrok,2017-18,26.0,5,31,81,81,15,16,31,134.0,1274.0,248,40,48,88,367.0,82,5.45,47,245,2478,9.0,0.44715893
4244,4244,Calle Jarnkrok,2018-19,27.0,6,35,68,68,16,19,35,105.0,1080.0,316,56,67,123,472.0,82,5.86,50,250,2620,9.2,0.4203806
4245,4245,Calle Jarnkrok,2019-20,28.0,7,26,79,79,10,16,26,106.0,1219.0,395,66,83,149,578.0,82,5.96,47,239,2579,9.5,0.34830505
4246,4246,Calle Jarnkrok,2020-21,29.0,8,34,64,64,15,19,34,136.0,1020.0,459,81,102,183,714.0,70,5.96,42,208,2192,9.5,0.4949176
4247,4247,Calle Johansson,1988-89,21.0,2,42,71,71,4,38,42,93.0,,71,4,38,42,93.0,80,7.43,89,437,2435,12.2,0.51447034
4248,4248,Calle Johansson,1989-90,22.0,3,21,59,59,3,18,21,75.0,,130,7,56,63,168.0,80,7.48,85,403,2430,12.3,0.3740037
4249,4249,Calle Johansson,1990-91,23.0,4,39,70,70,8,31,39,103.0,,200,15,87,102,271.0,80,7.37,76,367,2421,12.2,0.548839
4250,4250,Calle Johansson,1991-92,24.0,5,52,80,80,11,41,52,128.0,,280,26,128,154,399.0,80,6.91,71,366,2385,11.6,0.610945
4251,4251,Calle Johansson,1992-93,25.0,6,56,80,80,14,42,56,119.0,,360,40,170,210,518.0,80,6.96,77,402,2440,11.4,0.654847
4252,4252,Calle Johansson,1993-94,26.0,7,45,77,77,7,38,45,133.0,,437,47,208,255,651.0,84,7.25,87,443,2603,11.7,0.52765006
4253,4253,Calle Johansson,1994-95,27.0,8,42,84,84,9,33,42,141.0,,521,56,241,297,792.0,84,6.48,76,407,2545,10.7,0.48524696
4254,4254,Calle Johansson,1995-96,28.0,9,31,46,46,5,26,31,112.0,,567,61,267,328,904.0,48,5.97,37,209,1408,10.2,0.58136445
4255,4255,Calle Johansson,1996-97,29.0,10,35,78,78,10,25,35,182.0,,645,71,292,363,1086.0,82,6.29,74,413,2481,10.4,0.44203085
4256,4256,Calle Johansson,1997-98,30.0,11,17,65,65,6,11,17,133.0,,710,77,303,380,1219.0,82,5.83,55,336,2444,9.8,0.32631892
4257,4257,Calle Johansson,1998-99,31.0,12,35,73,73,15,20,35,163.0,,783,92,323,415,1382.0,82,5.28,57,380,2242,9.6,0.46026015
4258,4258,Calle Johansson,1999-00,32.0,13,29,67,67,8,21,29,145.0,1606.0,850,100,344,444,1527.0,82,5.27,57,359,2285,9.4,0.39770925
4259,4259,Calle Johansson,2000-01,33.0,14,32,82,82,7,25,32,138.0,1961.0,932,107,369,476,1665.0,82,5.49,53,331,2294,9.8,0.38568747
4260,4260,Calle Johansson,2001-02,34.0,15,36,76,76,7,29,36,154.0,1804.0,1008,114,398,512,1819.0,82,5.51,63,376,2272,9.9,0.37117773
4261,4261,Calle Johansson,2002-03,35.0,16,2,11,11,2,0,2,18.0,233.0,1019,116,398,514,1837.0,82,5.24,53,338,2262,9.5,0.22805789
4262,4262,Calle Johansson,2003-04,36.0,17,15,82,82,3,12,15,77.0,1784.0,1101,119,410,529,1914.0,82,5.31,60,363,2326,9.4,0.22720328
4263,4263,Calle Johansson,2004-05,37.0,18,6,8,8,0,6,6,8.0,140.0,1109,119,416,535,1922.0,82,5.14,57,348,2300,9.2,0.32077843
4264,4264,Calle Rosen,2018-19,24.0,2,1,4,4,0,1,1,5.0,51.0,4,0,1,1,5.0,82,5.86,50,250,2620,9.2,0.18815872
4265,4265,Calle Rosen,2019-20,25.0,3,1,4,4,1,0,1,5.0,67.0,8,1,1,2,10.0,82,5.96,47,239,2579,9.5,0.19794387
4266,4266,Calle Rosen,2020-21,26.0,4,3,12,12,0,3,3,14.0,163.0,20,1,4,5,24.0,70,5.96,42,208,2192,9.5,0.21590379
4267,4267,Calvin Thurkauf,2020-21,23.0,2,0,3,3,0,0,0,1.0,25.0,3,0,0,0,1.0,70,5.96,42,208,2192,9.5,0.19198176
4268,4268,Calvin de Haan,2012-13,21.0,2,0,1,1,0,0,0,2.0,13.0,1,0,0,0,2.0,82,5.32,47,271,2439,8.9,0.21160346
4269,4269,Calvin de Haan,2014-15,23.0,3,16,51,51,3,13,16,71.0,1072.0,52,3,13,16,73.0,82,5.34,48,269,2463,8.9,0.30267027
4270,4270,Calvin de Haan,2015-16,24.0,4,12,65,65,1,11,12,92.0,1236.0,117,4,24,28,165.0,82,5.32,47,251,2453,8.9,0.21270126
4271,4271,Calvin de Haan,2016-17,25.0,5,16,72,72,2,14,16,102.0,1486.0,189,6,38,44,267.0,82,5.34,48,255,2438,9.0,0.23895803
4272,4272,Calvin de Haan,2017-18,26.0,6,25,82,82,5,20,25,116.0,1628.0,271,11,58,69,383.0,82,5.45,47,245,2478,9.0,0.29925755
4273,4273,Calvin de Haan,2018-19,27.0,7,12,33,33,1,11,12,44.0,619.0,304,12,69,81,427.0,82,5.86,50,250,2620,9.2,0.19990498
4274,4274,Calvin de Haan,2019-20,28.0,8,14,74,74,1,13,14,102.0,1370.0,378,13,82,95,529.0,82,5.96,47,239,2579,9.5,0.2161591
4275,4275,Calvin de Haan,2020-21,29.0,9,6,29,29,1,5,6,42.0,577.0,407,14,87,101,571.0,70,5.96,42,208,2192,9.5,0.19829163
4276,4276,Cam Atkinson,2012-13,23.0,2,14,27,27,7,7,14,66.0,415.0,27,7,7,14,66.0,82,5.32,47,271,2439,8.9,0.36032945
4277,4277,Cam Atkinson,2013-14,24.0,3,18,35,35,9,9,18,91.0,546.0,62,16,16,32,157.0,48,5.31,29,160,1399,9.1,0.4836033
4278,4278,Cam Atkinson,2014-15,25.0,4,40,79,79,21,19,40,216.0,1247.0,141,37,35,72,373.0,82,5.34,48,269,2463,8.9,0.5362071
4279,4279,Cam Atkinson,2015-16,26.0,5,40,78,78,22,18,40,212.0,1325.0,219,59,53,112,585.0,82,5.32,47,251,2453,8.9,0.5404823
4280,4280,Cam Atkinson,2016-17,27.0,6,53,81,81,27,26,53,226.0,1442.0,300,86,79,165,811.0,82,5.34,48,255,2438,9.0,0.6433284
4281,4281,Cam Atkinson,2017-18,28.0,7,62,82,82,35,27,62,240.0,1483.0,382,121,106,227,1051.0,82,5.45,47,245,2478,9.0,0.7084119
4282,4282,Cam Atkinson,2018-19,29.0,8,46,65,65,24,22,46,231.0,1229.0,447,145,128,273,1282.0,82,5.86,50,250,2620,9.2,0.654585
4283,4283,Cam Atkinson,2019-20,30.0,9,69,80,80,41,28,69,295.0,1550.0,527,186,156,342,1577.0,82,5.96,47,239,2579,9.5,0.77489233
4284,4284,Cam Atkinson,2020-21,31.0,10,26,44,44,12,14,26,148.0,785.0,571,198,170,368,1725.0,70,5.96,42,208,2192,9.5,0.5831258
4285,4285,Cam Barker,2006-07,20.0,2,0,1,1,0,0,0,1.0,11.0,1,0,0,0,1.0,82,6.05,85,480,2458,10.1,0.2363117
4286,4286,Cam Barker,2007-08,21.0,3,8,35,35,1,7,8,38.0,676.0,36,1,7,8,39.0,82,5.76,70,398,2426,9.7,0.25148052
4287,4287,Cam Barker,2008-09,22.0,4,18,45,45,6,12,18,42.0,774.0,81,7,19,26,81.0,82,5.44,62,351,2383,9.4,0.37528086
4288,4288,Cam Barker,2009-10,23.0,5,40,68,68,6,34,40,101.0,1247.0,149,13,53,66,182.0,82,5.7,65,341,2477,9.4,0.49152878
4289,4289,Cam Barker,2010-11,24.0,6,21,70,70,5,16,21,105.0,1086.0,219,18,69,87,287.0,82,5.53,56,304,2486,9.1,0.29156733
4290,4290,Cam Barker,2011-12,25.0,7,5,52,52,1,4,5,44.0,853.0,271,19,73,92,331.0,82,5.46,52,291,2492,9.0,0.18965816
4291,4291,Cam Barker,2012-13,26.0,8,2,25,25,2,0,2,35.0,459.0,296,21,73,94,366.0,82,5.32,47,271,2439,8.9,0.21251774
4292,4292,Cam Barker,2013-14,27.0,9,2,14,14,0,2,2,19.0,199.0,310,21,75,96,385.0,48,5.31,29,160,1399,9.1,0.23744851
4293,4293,Cam Brown,1991-92,22.0,2,0,1,1,0,0,0,0.0,,1,0,0,0,0.0,80,6.91,71,366,2385,11.6,0.19527435
4294,4294,Cam Fowler,2011-12,20.0,2,40,76,76,10,30,40,123.0,1682.0,76,10,30,40,123.0,82,5.46,52,291,2492,9.0,0.4967697
4295,4295,Cam Fowler,2012-13,21.0,3,29,82,82,5,24,29,123.0,1907.0,158,15,54,69,246.0,82,5.32,47,271,2439,8.9,0.40460023
4296,4296,Cam Fowler,2013-14,22.0,4,11,37,37,1,10,11,50.0,756.0,195,16,64,80,296.0,48,5.31,29,160,1399,9.1,0.3584731
4297,4297,Cam Fowler,2014-15,23.0,5,36,70,70,6,30,36,100.0,1670.0,265,22,94,116,396.0,82,5.34,48,269,2463,8.9,0.4854157
4298,4298,Cam Fowler,2015-16,24.0,6,34,80,80,7,27,34,87.0,1692.0,345,29,121,150,483.0,82,5.32,47,251,2453,8.9,0.43814912
4299,4299,Cam Fowler,2016-17,25.0,7,28,69,69,5,23,28,113.0,1572.0,414,34,144,178,596.0,82,5.34,48,255,2438,9.0,0.43252364
4300,4300,Cam Fowler,2017-18,26.0,8,39,80,80,11,28,39,186.0,1988.0,494,45,172,217,782.0,82,5.45,47,245,2478,9.0,0.5435866
4301,4301,Cam Fowler,2018-19,27.0,9,32,67,67,8,24,32,122.0,1665.0,561,53,196,249,904.0,82,5.86,50,250,2620,9.2,0.4333198
4302,4302,Cam Fowler,2019-20,28.0,10,23,59,59,5,18,23,88.0,1379.0,620,58,214,272,992.0,82,5.96,47,239,2579,9.5,0.3452988
4303,4303,Cam Fowler,2020-21,29.0,11,29,59,59,9,20,29,117.0,1297.0,679,67,234,301,1109.0,70,5.96,42,208,2192,9.5,0.4590596
4304,4304,Cam Janssen,2006-07,22.0,2,0,47,47,0,0,0,10.0,222.0,47,0,0,0,10.0,82,6.05,85,480,2458,10.1,0.105451465
4305,4305,Cam Janssen,2007-08,23.0,3,1,48,48,1,0,1,9.0,197.0,95,1,0,1,19.0,82,5.76,70,398,2426,9.7,0.11325374
4306,4306,Cam Janssen,2008-09,24.0,4,1,12,12,0,1,1,9.0,85.0,107,1,1,2,28.0,82,5.44,62,351,2383,9.4,0.14874685
4307,4307,Cam Janssen,2009-10,25.0,5,4,56,56,1,3,4,22.0,281.0,163,2,4,6,50.0,82,5.7,65,341,2477,9.4,0.088039696
4308,4308,Cam Janssen,2010-11,26.0,6,0,43,43,0,0,0,11.0,203.0,206,2,4,6,61.0,82,5.53,56,304,2486,9.1,0.07576656
4309,4309,Cam Janssen,2011-12,27.0,7,4,54,54,1,3,4,16.0,263.0,260,3,7,10,77.0,82,5.46,52,291,2492,9.0,0.07638025
4310,4310,Cam Janssen,2012-13,28.0,8,1,48,48,0,1,1,17.0,225.0,308,3,8,11,94.0,82,5.32,47,271,2439,8.9,0.0687809
4311,4311,Cam Janssen,2013-14,29.0,9,0,4,4,0,0,0,0.0,16.0,312,3,8,11,94.0,48,5.31,29,160,1399,9.1,0.106995374
4312,4312,Cam Janssen,2014-15,30.0,10,3,24,24,3,0,3,11.0,118.0,336,6,8,14,105.0,82,5.34,48,269,2463,8.9,0.13508794
4313,4313,Cam Neely,1984-85,19.0,2,31,56,56,16,15,31,87.0,,56,16,15,31,87.0,80,7.89,74,336,2448,12.9,0.58166045
4314,4314,Cam Neely,1985-86,20.0,3,39,72,72,21,18,39,140.0,,128,37,33,70,227.0,80,7.77,71,321,2447,12.7,0.59624034
4315,4315,Cam Neely,1986-87,21.0,4,34,73,73,14,20,34,113.0,,201,51,53,104,340.0,80,7.94,82,370,2484,12.8,0.5996533
4316,4316,Cam Neely,1987-88,22.0,5,72,75,75,36,36,72,206.0,,276,87,89,176,546.0,80,7.34,72,344,2400,12.2,0.91815305
4317,4317,Cam Neely,1988-89,23.0,6,69,69,69,42,27,69,207.0,,345,129,116,245,753.0,80,7.43,89,437,2435,12.2,0.95388734
4318,4318,Cam Neely,1989-90,24.0,7,75,74,74,37,38,75,235.0,,419,166,154,320,988.0,80,7.48,85,403,2430,12.3,0.9173207
4319,4319,Cam Neely,1990-91,25.0,8,92,76,76,55,37,92,271.0,,495,221,191,412,1259.0,80,7.37,76,367,2421,12.2,1.1205311
4320,4320,Cam Neely,1991-92,26.0,9,91,69,69,51,40,91,262.0,,564,272,231,503,1521.0,80,6.91,71,366,2385,11.6,1.1610305
4321,4321,Cam Neely,1992-93,27.0,10,12,9,9,9,3,12,30.0,,573,281,234,515,1551.0,80,6.96,77,402,2440,11.4,1.0434182
4322,4322,Cam Neely,1993-94,28.0,11,18,13,13,11,7,18,45.0,,586,292,241,533,1596.0,84,7.25,87,443,2603,11.7,1.1695313
4323,4323,Cam Neely,1994-95,29.0,12,74,49,49,50,24,74,185.0,,635,342,265,607,1781.0,84,6.48,76,407,2545,10.7,1.0185703
4324,4324,Cam Neely,1995-96,30.0,13,41,42,42,27,14,41,178.0,,677,369,279,648,1959.0,48,5.97,37,209,1408,10.2,0.8858096
4325,4325,Cam Neely,1996-97,31.0,14,46,49,49,26,20,46,191.0,,726,395,299,694,2150.0,82,6.29,74,413,2481,10.4,0.7920822
4326,4326,Cam Paddock,2009-10,26.0,2,3,16,16,2,1,3,17.0,171.0,16,2,1,3,17.0,82,5.7,65,341,2477,9.4,0.22123289
4327,4327,Cam Plante,1985-86,21.0,2,0,2,2,0,0,0,0.0,,2,0,0,0,0.0,80,7.77,71,321,2447,12.7,0.21353588
4328,4328,Cam Russell,1990-91,22.0,2,1,19,19,0,1,1,10.0,,19,0,1,1,10.0,80,7.37,76,367,2421,12.2,0.1733548
4329,4329,Cam Russell,1991-92,23.0,3,0,3,3,0,0,0,0.0,,22,0,1,1,10.0,80,6.91,71,366,2385,11.6,0.17258349
4330,4330,Cam Russell,1992-93,24.0,4,0,19,19,0,0,0,9.0,,41,0,1,1,19.0,80,6.96,77,402,2440,11.4,0.15405694
4331,4331,Cam Russell,1993-94,25.0,5,6,67,67,2,4,6,49.0,,108,2,5,7,68.0,84,7.25,87,443,2603,11.7,0.16436228
4332,4332,Cam Russell,1994-95,26.0,6,8,67,67,1,7,8,41.0,,175,3,12,15,109.0,84,6.48,76,407,2545,10.7,0.13183358
4333,4333,Cam Russell,1995-96,27.0,7,4,33,33,1,3,4,18.0,,208,4,15,19,127.0,48,5.97,37,209,1408,10.2,0.12486577
4334,4334,Cam Russell,1996-97,28.0,8,4,61,61,2,2,4,22.0,,269,6,17,23,149.0,82,6.29,74,413,2481,10.4,0.09472734
4335,4335,Cam Russell,1997-98,29.0,9,2,44,44,1,1,2,19.0,,313,7,18,25,168.0,82,5.83,55,336,2444,9.8,0.08338228
4336,4336,Cam Russell,1998-99,30.0,10,2,41,41,1,1,2,18.0,,354,8,19,27,186.0,82,5.28,57,380,2242,9.6,0.08287433
4337,4337,Cam Russell,1999-00,31.0,11,3,42,42,1,2,3,15.0,479.0,396,9,21,30,201.0,82,5.27,57,359,2285,9.4,0.077571064
4338,4338,Cam Severson,2003-04,26.0,2,0,2,2,0,0,0,1.0,13.0,2,0,0,0,1.0,82,5.31,60,363,2326,9.4,0.18017924
4339,4339,Cam Severson,2004-05,27.0,3,3,31,31,3,0,3,24.0,228.0,33,3,0,3,25.0,82,5.14,57,348,2300,9.2,0.21491438
4340,4340,Cam Severson,2006-07,29.0,4,0,4,4,0,0,0,2.0,12.0,37,3,0,3,27.0,82,6.05,85,480,2458,10.1,0.13725013
4341,4341,Cam Stewart,1994-95,23.0,2,9,57,57,3,6,9,55.0,,57,3,6,9,55.0,84,6.48,76,407,2545,10.7,0.19558087
4342,4342,Cam Stewart,1995-96,24.0,3,0,5,5,0,0,0,2.0,,62,3,6,9,57.0,48,5.97,37,209,1408,10.2,0.17621332
4343,4343,Cam Stewart,1996-97,25.0,4,0,6,6,0,0,0,2.0,,68,3,6,9,59.0,82,6.29,74,413,2481,10.4,0.14744565
4344,4344,Cam Stewart,1997-98,26.0,5,1,15,15,0,1,1,21.0,,83,3,7,10,80.0,82,5.83,55,336,2444,9.8,0.18080315
4345,4345,Cam Stewart,2000-01,29.0,6,16,65,65,9,7,16,52.0,589.0,148,12,14,26,132.0,82,5.49,53,331,2294,9.8,0.18057847
4346,4346,Cam Stewart,2001-02,30.0,7,13,54,54,4,9,13,61.0,713.0,202,16,23,39,193.0,82,5.51,63,376,2272,9.9,0.179232
4347,4347,Cameron Gaunce,2011-12,21.0,2,1,11,11,1,0,1,4.0,140.0,11,1,0,1,4.0,82,5.46,52,291,2492,9.0,0.21564358
4348,4348,Cameron Gaunce,2014-15,24.0,3,0,9,9,0,0,0,9.0,125.0,20,1,0,1,13.0,82,5.34,48,269,2463,8.9,0.16518694
4349,4349,Cameron Gaunce,2017-18,27.0,4,4,12,12,1,3,4,8.0,150.0,32,2,3,5,21.0,82,5.45,47,245,2478,9.0,0.17514202
4350,4350,Cameron Gaunce,2019-20,29.0,5,0,2,2,0,0,0,2.0,31.0,34,2,3,5,23.0,82,5.96,47,239,2579,9.5,0.22386152
4351,4351,Cameron Gaunce,2020-21,30.0,6,4,3,3,1,3,4,5.0,36.0,37,3,6,9,28.0,70,5.96,42,208,2192,9.5,0.20690301
4352,4352,Cameron Hughes,2020-21,24.0,2,0,1,1,0,0,0,0.0,10.0,1,0,0,0,0.0,70,5.96,42,208,2192,9.5,0.18837601
4353,4353,Cameron Mann,1998-99,21.0,2,1,9,9,0,1,1,6.0,,9,0,1,1,6.0,82,5.28,57,380,2242,9.6,0.22187129
4354,4354,Cameron Mann,1999-00,22.0,3,7,33,33,5,2,7,42.0,352.0,42,5,3,8,48.0,82,5.27,57,359,2285,9.4,0.28202328
4355,4355,Cameron Mann,2000-01,23.0,4,12,32,32,8,4,12,48.0,411.0,74,13,7,20,96.0,82,5.49,53,331,2294,9.8,0.31736538
4356,4356,Cameron Mann,2001-02,24.0,5,4,15,15,1,3,4,17.0,127.0,89,14,10,24,113.0,82,5.51,63,376,2272,9.9,0.22833434
4357,4357,Cameron Mann,2003-04,26.0,6,0,4,4,0,0,0,5.0,24.0,93,14,10,24,118.0,82,5.31,60,363,2326,9.4,0.17735976
4358,4358,Cameron Schilling,2013-14,25.0,2,0,1,1,0,0,0,0.0,12.0,1,0,0,0,0.0,48,5.31,29,160,1399,9.1,0.18009916
4359,4359,Cameron Schilling,2014-15,26.0,3,0,1,1,0,0,0,2.0,18.0,2,0,0,0,2.0,82,5.34,48,269,2463,8.9,0.16056308
4360,4360,Cameron Schilling,2015-16,27.0,4,0,4,4,0,0,0,2.0,46.0,6,0,0,0,4.0,82,5.32,47,251,2453,8.9,0.14226812
4361,4361,Cameron Schilling,2019-20,31.0,5,1,4,4,0,1,1,2.0,48.0,10,0,1,1,6.0,82,5.96,47,239,2579,9.5,0.21955225
4362,4362,Carey Wilson,1984-85,22.0,2,7,15,15,2,5,7,11.0,,15,2,5,7,11.0,80,7.89,74,336,2448,12.9,0.36290938
4363,4363,Carey Wilson,1985-86,23.0,3,72,74,74,24,48,72,128.0,,89,26,53,79,139.0,80,7.77,71,321,2447,12.7,0.83861965
4364,4364,Carey Wilson,1986-87,24.0,4,58,76,76,29,29,58,149.0,,165,55,82,137,288.0,80,7.94,82,370,2484,12.8,0.7363422
4365,4365,Carey Wilson,1987-88,25.0,5,56,80,80,20,36,56,140.0,,245,75,118,193,428.0,80,7.34,72,344,2400,12.2,0.76075447
4366,4366,Carey Wilson,1988-89,26.0,6,68,70,70,27,41,68,138.0,,315,102,159,261,566.0,80,7.43,89,437,2435,12.2,0.86467505
4367,4367,Carey Wilson,1989-90,27.0,7,77,75,75,32,45,77,164.0,,390,134,204,338,730.0,80,7.48,85,403,2430,12.3,0.8314697
4368,4368,Carey Wilson,1990-91,28.0,8,26,41,41,9,17,26,64.0,,431,143,221,364,794.0,80,7.37,76,367,2421,12.2,0.62389
4369,4369,Carey Wilson,1991-92,29.0,9,29,57,57,11,18,29,79.0,,488,154,239,393,873.0,80,6.91,71,366,2385,11.6,0.47251883
4370,4370,Carey Wilson,1992-93,30.0,10,23,42,42,11,12,23,74.0,,530,165,251,416,947.0,80,6.96,77,402,2440,11.4,0.5544026
4371,4371,Carey Wilson,1993-94,31.0,11,11,22,22,4,7,11,30.0,,552,169,258,427,977.0,84,7.25,87,443,2603,11.7,0.40196946
4372,4372,Carl Corazzini,2004-05,25.0,2,2,12,12,2,0,2,16.0,128.0,12,2,0,2,16.0,82,5.14,57,348,2300,9.2,0.21966079
4373,4373,Carl Corazzini,2007-08,28.0,3,1,7,7,0,1,1,5.0,76.0,19,2,1,3,21.0,82,5.76,70,398,2426,9.7,0.17084742
4374,4374,Carl Dahlstrom,2018-19,24.0,2,3,11,11,0,3,3,12.0,193.0,11,0,3,3,12.0,82,5.86,50,250,2620,9.2,0.2020885
4375,4375,Carl Dahlstrom,2019-20,25.0,3,6,38,38,0,6,6,42.0,707.0,49,0,9,9,54.0,82,5.96,47,239,2579,9.5,0.15867493
4376,4376,Carl Dahlstrom,2020-21,26.0,4,1,15,15,0,1,1,9.0,221.0,64,0,10,10,63.0,70,5.96,42,208,2192,9.5,0.16730079
4377,4377,Carl Grundstrom,2019-20,22.0,2,6,15,15,5,1,6,26.0,225.0,15,5,1,6,26.0,82,5.96,47,239,2579,9.5,0.33649042
4378,4378,Carl Grundstrom,2020-21,23.0,3,4,13,13,0,4,4,16.0,166.0,28,5,5,10,42.0,70,5.96,42,208,2192,9.5,0.25319982
4379,4379,Carl Gunnarsson,2010-11,24.0,2,15,43,43,3,12,15,45.0,922.0,43,3,12,15,45.0,82,5.53,56,304,2486,9.1,0.24976522
4380,4380,Carl Gunnarsson,2011-12,25.0,3,20,68,68,4,16,20,69.0,1240.0,111,7,28,35,114.0,82,5.46,52,291,2492,9.0,0.26013985
4381,4381,Carl Gunnarsson,2012-13,26.0,4,19,76,76,4,15,19,89.0,1649.0,187,11,43,54,203.0,82,5.32,47,271,2439,8.9,0.24883765
4382,4382,Carl Gunnarsson,2013-14,27.0,5,15,37,37,1,14,15,28.0,787.0,224,12,57,69,231.0,48,5.31,29,160,1399,9.1,0.27880114
4383,4383,Carl Gunnarsson,2014-15,28.0,6,17,80,80,3,14,17,48.0,1553.0,304,15,71,86,279.0,82,5.34,48,269,2463,8.9,0.18582487
4384,4384,Carl Gunnarsson,2015-16,29.0,7,12,61,61,2,10,12,54.0,1102.0,365,17,81,98,333.0,82,5.32,47,251,2453,8.9,0.19900158
4385,4385,Carl Gunnarsson,2016-17,30.0,8,9,72,72,3,6,9,51.0,1251.0,437,20,87,107,384.0,82,5.34,48,255,2438,9.0,0.16425905
4386,4386,Carl Gunnarsson,2017-18,31.0,9,6,56,56,0,6,6,32.0,761.0,493,20,93,113,416.0,82,5.45,47,245,2478,9.0,0.12933084
4387,4387,Carl Gunnarsson,2018-19,32.0,10,9,63,63,5,4,9,59.0,1018.0,556,25,97,122,475.0,82,5.86,50,250,2620,9.2,0.17248473
4388,4388,Carl Gunnarsson,2019-20,33.0,11,7,25,25,3,4,7,21.0,398.0,581,28,101,129,496.0,82,5.96,47,239,2579,9.5,0.19552279
4389,4389,Carl Gunnarsson,2020-21,34.0,12,7,36,36,2,5,7,31.0,568.0,617,30,106,136,527.0,70,5.96,42,208,2192,9.5,0.17190674
4390,4390,Carl Hagelin,2012-13,24.0,2,38,64,64,14,24,38,131.0,963.0,64,14,24,38,131.0,82,5.32,47,271,2439,8.9,0.532584
4391,4391,Carl Hagelin,2013-14,25.0,3,24,48,48,10,14,24,132.0,831.0,112,24,38,62,263.0,48,5.31,29,160,1399,9.1,0.5345324
4392,4392,Carl Hagelin,2014-15,26.0,4,33,72,72,17,16,33,144.0,1117.0,184,41,54,95,407.0,82,5.34,48,269,2463,8.9,0.47694123
4393,4393,Carl Hagelin,2015-16,27.0,5,35,82,82,17,18,35,185.0,1249.0,266,58,72,130,592.0,82,5.32,47,251,2453,8.9,0.46131843
4394,4394,Carl Hagelin,2016-17,28.0,6,39,80,80,14,25,39,178.0,1257.0,346,72,97,169,770.0,82,5.34,48,255,2438,9.0,0.52640873
4395,4395,Carl Hagelin,2017-18,29.0,7,22,61,61,6,16,22,128.0,945.0,407,78,113,191,898.0,82,5.45,47,245,2478,9.0,0.37470043
4396,4396,Carl Hagelin,2018-19,30.0,8,31,81,81,10,21,31,169.0,1291.0,488,88,134,222,1067.0,82,5.86,50,250,2620,9.2,0.42905167
4397,4397,Carl Hagelin,2019-20,31.0,9,19,58,58,5,14,19,99.0,854.0,546,93,148,241,1166.0,82,5.96,47,239,2579,9.5,0.3126196
4398,4398,Carl Hagelin,2020-21,32.0,10,25,58,58,8,17,25,107.0,831.0,604,101,165,266,1273.0,70,5.96,42,208,2192,9.5,0.3638615
4399,4399,Carl Klingberg,2011-12,21.0,2,0,1,1,0,0,0,0.0,10.0,1,0,0,0,0.0,82,5.46,52,291,2492,9.0,0.19211695
4400,4400,Carl Klingberg,2012-13,22.0,3,0,6,6,0,0,0,7.0,33.0,7,0,0,0,7.0,82,5.32,47,271,2439,8.9,0.1791952
4401,4401,Carl Klingberg,2014-15,24.0,4,1,3,3,1,0,1,3.0,27.0,10,1,0,1,10.0,82,5.34,48,269,2463,8.9,0.1960803
4402,4402,Carl Klingberg,2015-16,25.0,5,0,2,2,0,0,0,0.0,7.0,12,1,0,1,10.0,82,5.32,47,251,2453,8.9,0.14097658
4403,4403,Carl Mokosak,1982-83,20.0,2,1,1,1,0,1,1,0.0,,1,0,1,1,0.0,80,8.03,73,320,2489,12.9,0.29398775
4404,4404,Carl Mokosak,1983-84,21.0,3,13,41,41,7,6,13,38.0,,42,7,7,14,38.0,80,7.73,71,310,2444,12.7,0.3533612
4405,4405,Carl Mokosak,1985-86,23.0,4,12,30,30,4,8,12,29.0,,72,11,15,26,67.0,80,7.77,71,321,2447,12.7,0.33914822
4406,4406,Carl Mokosak,1986-87,24.0,5,0,1,1,0,0,0,0.0,,73,11,15,26,67.0,80,7.94,82,370,2484,12.8,0.21697894
4407,4407,Carl Mokosak,1987-88,25.0,6,0,3,3,0,0,0,3.0,,76,11,15,26,70.0,80,7.34,72,344,2400,12.2,0.21611834
4408,4408,Carl Mokosak,1989-90,27.0,7,0,7,7,0,0,0,3.0,,83,11,15,26,73.0,80,7.48,85,403,2430,12.3,0.2030741
4409,4409,Carl Sneep,2012-13,25.0,2,1,1,1,0,1,1,0.0,16.0,1,0,1,1,0.0,82,5.32,47,271,2439,8.9,0.16760567
4410,4410,Carl Soderberg,2013-14,28.0,2,2,6,6,0,2,2,6.0,88.0,6,0,2,2,6.0,48,5.31,29,160,1399,9.1,0.20810875
4411,4411,Carl Soderberg,2014-15,29.0,3,48,73,73,16,32,48,129.0,1041.0,79,16,34,50,135.0,82,5.34,48,269,2463,8.9,0.542992
4412,4412,Carl Soderberg,2015-16,30.0,4,44,82,82,13,31,44,163.0,1378.0,161,29,65,94,298.0,82,5.32,47,251,2453,8.9,0.48495254
4413,4413,Carl Soderberg,2016-17,31.0,5,51,82,82,12,39,51,163.0,1477.0,243,41,104,145,461.0,82,5.34,48,255,2438,9.0,0.5579774
4414,4414,Carl Soderberg,2017-18,32.0,6,14,80,80,6,8,14,128.0,1076.0,323,47,112,159,589.0,82,5.45,47,245,2478,9.0,0.2970792
4415,4415,Carl Soderberg,2018-19,33.0,7,37,77,77,16,21,37,150.0,1336.0,400,63,133,196,739.0,82,5.86,50,250,2620,9.2,0.4761751
4416,4416,Carl Soderberg,2019-20,34.0,8,49,82,82,23,26,49,188.0,1431.0,482,86,159,245,927.0,82,5.96,47,239,2579,9.5,0.5392006
4417,4417,Carl Soderberg,2020-21,35.0,9,35,70,70,17,18,35,135.0,1113.0,552,103,177,280,1062.0,70,5.96,42,208,2192,9.5,0.40255418
4418,4418,Carlo Colaiacovo,2003-04,21.0,2,1,2,2,0,1,1,1.0,27.0,2,0,1,1,1.0,82,5.31,60,363,2326,9.4,0.24627036
4419,4419,Carlo Colaiacovo,2004-05,22.0,3,1,2,2,0,1,1,0.0,28.0,4,0,2,2,1.0,82,5.14,57,348,2300,9.2,0.23072326
4420,4420,Carlo Colaiacovo,2006-07,24.0,4,7,21,21,2,5,7,21.0,324.0,25,2,7,9,22.0,82,6.05,85,480,2458,10.1,0.23220119
4421,4421,Carlo Colaiacovo,2007-08,25.0,5,17,48,48,8,9,17,60.0,862.0,73,10,16,26,82.0,82,5.76,70,398,2426,9.7,0.30608344
4422,4422,Carlo Colaiacovo,2008-09,26.0,6,6,28,28,2,4,6,30.0,488.0,101,12,20,32,112.0,82,5.44,62,351,2383,9.4,0.24540019
4423,4423,Carlo Colaiacovo,2009-10,27.0,7,30,73,73,3,27,30,87.0,1333.0,174,15,47,62,199.0,82,5.7,65,341,2477,9.4,0.34403032
4424,4424,Carlo Colaiacovo,2010-11,28.0,8,32,67,67,7,25,32,74.0,1159.0,241,22,72,94,273.0,82,5.53,56,304,2486,9.1,0.3876643
4425,4425,Carlo Colaiacovo,2011-12,29.0,9,26,65,65,6,20,26,81.0,1179.0,306,28,92,120,354.0,82,5.46,52,291,2492,9.0,0.32199198
4426,4426,Carlo Colaiacovo,2012-13,30.0,10,19,64,64,2,17,19,68.0,1216.0,370,30,109,139,422.0,82,5.32,47,271,2439,8.9,0.24713215
4427,4427,Carlo Colaiacovo,2013-14,31.0,11,1,6,6,0,1,1,12.0,113.0,376,30,110,140,434.0,48,5.31,29,160,1399,9.1,0.20496914
4428,4428,Carlo Colaiacovo,2014-15,32.0,12,4,25,25,1,3,4,18.0,379.0,401,31,113,144,452.0,82,5.34,48,269,2463,8.9,0.13937283
4429,4429,Carlo Colaiacovo,2015-16,33.0,13,8,33,33,2,6,8,42.0,544.0,434,33,119,152,494.0,82,5.32,47,251,2453,8.9,0.19660026
4430,4430,Carlo Colaiacovo,2016-17,34.0,14,5,36,36,1,4,5,29.0,521.0,470,34,123,157,523.0,82,5.34,48,255,2438,9.0,0.13891229
4431,4431,Carsen Germyn,2006-07,24.0,2,0,2,2,0,0,0,2.0,10.0,2,0,0,0,2.0,82,6.05,85,480,2458,10.1,0.16396457
4432,4432,Carsen Germyn,2007-08,25.0,3,0,2,2,0,0,0,3.0,17.0,4,0,0,0,5.0,82,5.76,70,398,2426,9.7,0.1646193
4433,4433,Carsen Twarynski,2020-21,23.0,2,1,15,15,1,0,1,14.0,160.0,15,1,0,1,14.0,70,5.96,42,208,2192,9.5,0.22367272
4434,4434,Carson McMillan,2011-12,23.0,2,2,4,4,1,1,2,5.0,37.0,4,1,1,2,5.0,82,5.46,52,291,2492,9.0,0.22500464
4435,4435,Carson McMillan,2012-13,24.0,3,3,11,11,1,2,3,8.0,122.0,15,2,3,5,13.0,82,5.32,47,271,2439,8.9,0.18732497
4436,4436,Carson McMillan,2014-15,26.0,4,0,1,1,0,0,0,0.0,8.0,16,2,3,5,13.0,82,5.34,48,269,2463,8.9,0.14263901
4437,4437,Carson Soucy,2018-19,24.0,2,0,3,3,0,0,0,4.0,45.0,3,0,0,0,4.0,82,5.86,50,250,2620,9.2,0.16909173
4438,4438,Carson Soucy,2020-21,26.0,3,14,55,55,7,7,14,61.0,860.0,58,7,7,14,65.0,70,5.96,42,208,2192,9.5,0.27529076
4439,4439,Carter Ashton,2012-13,21.0,2,0,15,15,0,0,0,22.0,156.0,15,0,0,0,22.0,82,5.32,47,271,2439,8.9,0.20990542
4440,4440,Carter Ashton,2014-15,23.0,3,3,32,32,0,3,3,23.0,201.0,47,0,3,3,45.0,82,5.34,48,269,2463,8.9,0.17707205
4441,4441,Carter Ashton,2015-16,24.0,4,0,7,7,0,0,0,4.0,44.0,54,0,3,3,49.0,82,5.32,47,251,2453,8.9,0.14017084
4442,4442,Carter Bancks,2013-14,24.0,2,0,2,2,0,0,0,0.0,29.0,2,0,0,0,0.0,48,5.31,29,160,1399,9.1,0.18834955
4443,4443,Carter Camper,2012-13,24.0,2,1,3,3,1,0,1,1.0,20.0,3,1,0,1,1.0,82,5.32,47,271,2439,8.9,0.26250827
4444,4444,Carter Rowney,2017-18,28.0,2,7,27,27,3,4,7,24.0,296.0,27,3,4,7,24.0,82,5.45,47,245,2478,9.0,0.2222037
4445,4445,Carter Rowney,2018-19,29.0,3,5,44,44,2,3,5,21.0,411.0,71,5,7,12,45.0,82,5.86,50,250,2620,9.2,0.110590816
4446,4446,Carter Rowney,2019-20,30.0,4,20,62,62,7,13,20,53.0,778.0,133,12,20,32,98.0,82,5.96,47,239,2579,9.5,0.24641895
4447,4447,Carter Rowney,2020-21,31.0,5,19,71,71,8,11,19,63.0,910.0,204,20,31,51,161.0,70,5.96,42,208,2192,9.5,0.2703307
4448,4448,Carter Verhaeghe,2020-21,25.0,2,13,52,52,9,4,13,57.0,487.0,52,9,4,13,57.0,70,5.96,42,208,2192,9.5,0.3150676
4449,4449,Casey Bailey,2015-16,24.0,2,1,6,6,1,0,1,9.0,54.0,6,1,0,1,9.0,82,5.32,47,251,2453,8.9,0.20799357
4450,4450,Casey Bailey,2017-18,26.0,3,0,7,7,0,0,0,10.0,56.0,13,1,0,1,19.0,82,5.45,47,245,2478,9.0,0.17812097
4451,4451,Casey Borer,2008-09,23.0,2,3,11,11,1,2,3,5.0,168.0,11,1,2,3,5.0,82,5.44,62,351,2383,9.4,0.22484243
4452,4452,Casey Borer,2009-10,24.0,3,0,3,3,0,0,0,0.0,33.0,14,1,2,3,5.0,82,5.7,65,341,2477,9.4,0.15121076
4453,4453,Casey Borer,2010-11,25.0,4,0,2,2,0,0,0,0.0,22.0,16,1,2,3,5.0,82,5.53,56,304,2486,9.1,0.14941108
4454,4454,Casey Cizikas,2012-13,21.0,2,4,15,15,0,4,4,12.0,159.0,15,0,4,4,12.0,82,5.32,47,271,2439,8.9,0.2477963
4455,4455,Casey Cizikas,2013-14,22.0,3,15,45,45,6,9,15,45.0,485.0,60,6,13,19,57.0,48,5.31,29,160,1399,9.1,0.33332938
4456,4456,Casey Cizikas,2014-15,23.0,4,16,80,80,6,10,16,79.0,1070.0,140,12,23,35,136.0,82,5.34,48,269,2463,8.9,0.26317137
4457,4457,Casey Cizikas,2015-16,24.0,5,18,70,70,9,9,18,90.0,876.0,210,21,32,53,226.0,82,5.32,47,251,2453,8.9,0.2888504
4458,4458,Casey Cizikas,2016-17,25.0,6,29,80,80,8,21,29,84.0,1015.0,290,29,53,82,310.0,82,5.34,48,255,2438,9.0,0.332182
4459,4459,Casey Cizikas,2017-18,26.0,7,25,59,59,8,17,25,82.0,821.0,349,37,70,107,392.0,82,5.45,47,245,2478,9.0,0.34899363
4460,4460,Casey Cizikas,2018-19,27.0,8,17,64,64,7,10,17,74.0,846.0,413,44,80,124,466.0,82,5.86,50,250,2620,9.2,0.28126043
4461,4461,Casey Cizikas,2019-20,28.0,9,33,73,73,20,13,33,111.0,1024.0,486,64,93,157,577.0,82,5.96,47,239,2579,9.5,0.39351884
4462,4462,Casey Cizikas,2020-21,29.0,10,14,48,48,10,4,14,67.0,686.0,534,74,97,171,644.0,70,5.96,42,208,2192,9.5,0.31541938
4463,4463,Casey Hankinson,2001-02,25.0,2,1,11,11,0,1,1,15.0,107.0,11,0,1,1,15.0,82,5.51,63,376,2272,9.9,0.17755345
4464,4464,Casey Hankinson,2002-03,26.0,3,0,3,3,0,0,0,1.0,26.0,14,0,1,1,16.0,82,5.24,53,338,2262,9.5,0.14457843
4465,4465,Casey Hankinson,2004-05,28.0,4,0,4,4,0,0,0,0.0,25.0,18,0,1,1,16.0,82,5.14,57,348,2300,9.2,0.14702642
4466,4466,Casey Mittelstadt,2018-19,20.0,2,5,6,6,1,4,5,9.0,84.0,6,1,4,5,9.0,82,5.86,50,250,2620,9.2,0.28829187
4467,4467,Casey Mittelstadt,2019-20,21.0,3,25,77,77,12,13,25,118.0,1036.0,83,13,17,30,127.0,82,5.96,47,239,2579,9.5,0.40135464
4468,4468,Casey Mittelstadt,2020-21,22.0,4,9,31,31,4,5,9,34.0,396.0,114,17,22,39,161.0,70,5.96,42,208,2192,9.5,0.35317865
4469,4469,Casey Nelson,2016-17,24.0,2,4,7,7,0,4,4,5.0,104.0,7,0,4,4,5.0,82,5.34,48,255,2438,9.0,0.19477683
4470,4470,Casey Nelson,2017-18,25.0,3,0,11,11,0,0,0,10.0,139.0,18,0,4,4,15.0,82,5.45,47,245,2478,9.0,0.1712074
4471,4471,Casey Nelson,2018-19,26.0,4,8,37,37,3,5,8,48.0,695.0,55,3,9,12,63.0,82,5.86,50,250,2620,9.2,0.20874536
4472,4472,Casey Nelson,2019-20,27.0,5,6,38,38,1,5,6,37.0,586.0,93,4,14,18,100.0,82,5.96,47,239,2579,9.5,0.16087005
4473,4473,Casey Wellman,2010-11,23.0,2,4,12,12,1,3,4,18.0,145.0,12,1,3,4,18.0,82,5.53,56,304,2486,9.1,0.24104074
4474,4474,Casey Wellman,2011-12,24.0,3,2,15,15,1,1,2,20.0,160.0,27,2,4,6,38.0,82,5.46,52,291,2492,9.0,0.19765508
4475,4475,Casey Wellman,2012-13,25.0,4,7,14,14,2,5,7,25.0,178.0,41,4,9,13,63.0,82,5.32,47,271,2439,8.9,0.23068687
4476,4476,Casey Wellman,2014-15,27.0,5,3,13,13,2,1,3,15.0,122.0,54,6,10,16,78.0,82,5.34,48,269,2463,8.9,0.21387741
4477,4477,Cedric Paquette,2014-15,21.0,2,1,2,2,0,1,1,1.0,29.0,2,0,1,1,1.0,82,5.34,48,269,2463,8.9,0.24301797
4478,4478,Cedric Paquette,2015-16,22.0,3,19,64,64,12,7,19,91.0,871.0,66,12,8,20,92.0,82,5.32,47,251,2453,8.9,0.32485628
4479,4479,Cedric Paquette,2016-17,23.0,4,11,56,56,6,5,11,50.0,713.0,122,18,13,31,142.0,82,5.34,48,255,2438,9.0,0.24509263
4480,4480,Cedric Paquette,2017-18,24.0,5,10,58,58,4,6,10,68.0,668.0,180,22,19,41,210.0,82,5.45,47,245,2478,9.0,0.24016613
4481,4481,Cedric Paquette,2018-19,25.0,6,9,56,56,5,4,9,64.0,572.0,236,27,23,50,274.0,82,5.86,50,250,2620,9.2,0.2084313
4482,4482,Cedric Paquette,2019-20,26.0,7,17,80,80,13,4,17,87.0,960.0,316,40,27,67,361.0,82,5.96,47,239,2579,9.5,0.24189243
4483,4483,Cedric Paquette,2020-21,27.0,8,18,61,61,7,11,18,78.0,796.0,377,47,38,85,439.0,70,5.96,42,208,2192,9.5,0.29443312
4484,4484,Chad Billins,2014-15,25.0,2,3,10,10,0,3,3,3.0,122.0,10,0,3,3,3.0,82,5.34,48,269,2463,8.9,0.18079254
4485,4485,Chad Kilger,1996-97,20.0,2,17,74,74,7,10,17,57.0,,74,7,10,17,57.0,82,6.29,74,413,2481,10.4,0.28645998
4486,4486,Chad Kilger,1997-98,21.0,3,7,24,24,4,3,7,30.0,,98,11,13,24,87.0,82,5.83,55,336,2444,9.8,0.34501508
4487,4487,Chad Kilger,1998-99,22.0,4,12,32,32,3,9,12,32.0,,130,14,22,36,119.0,82,5.28,57,380,2242,9.6,0.276241
4488,4488,Chad Kilger,1999-00,23.0,5,27,77,77,15,12,27,81.0,1047.0,207,29,34,63,200.0,82,5.27,57,359,2285,9.4,0.38191044
4489,4489,Chad Kilger,2000-01,24.0,6,5,40,40,3,2,5,32.0,342.0,247,32,36,68,232.0,82,5.49,53,331,2294,9.8,0.24590755
4490,4490,Chad Kilger,2001-02,25.0,7,32,77,77,14,18,32,103.0,1054.0,324,46,54,100,335.0,82,5.51,63,376,2272,9.9,0.3966114
4491,4491,Chad Kilger,2002-03,26.0,8,23,75,75,8,15,23,87.0,993.0,399,54,69,123,422.0,82,5.24,53,338,2262,9.5,0.2968731
4492,4492,Chad Kilger,2003-04,27.0,9,16,60,60,9,7,16,60.0,642.0,459,63,76,139,482.0,82,5.31,60,363,2326,9.4,0.2640313
4493,4493,Chad Kilger,2004-05,28.0,10,6,41,41,3,3,6,35.0,437.0,500,66,79,145,517.0,82,5.14,57,348,2300,9.2,0.25616586
4494,4494,Chad Kilger,2006-07,30.0,11,28,79,79,17,11,28,103.0,980.0,579,83,90,173,620.0,82,6.05,85,480,2458,10.1,0.33119273
4495,4495,Chad Kilger,2007-08,31.0,12,28,82,82,14,14,28,141.0,1189.0,661,97,104,201,761.0,82,5.76,70,398,2426,9.7,0.31745833
4496,4496,Chad Kilger,2008-09,32.0,13,17,53,53,10,7,17,74.0,617.0,714,107,111,218,835.0,82,5.44,62,351,2383,9.4,0.32126576
4497,4497,Chad Kolarik,2010-11,25.0,2,0,2,2,0,0,0,2.0,13.0,2,0,0,0,2.0,82,5.53,56,304,2486,9.1,0.16698298
4498,4498,Chad Kolarik,2011-12,26.0,3,1,4,4,0,1,1,4.0,37.0,6,0,1,1,6.0,82,5.46,52,291,2492,9.0,0.17625573
4499,4499,Chad Larose,2006-07,24.0,2,13,49,49,1,12,13,62.0,518.0,49,1,12,13,62.0,82,6.05,85,480,2458,10.1,0.20026013
4500,4500,Chad Larose,2007-08,25.0,3,18,80,80,6,12,18,94.0,817.0,129,7,24,31,156.0,82,5.76,70,398,2426,9.7,0.2596994
4501,4501,Chad Larose,2008-09,26.0,4,23,58,58,11,12,23,117.0,815.0,187,18,36,54,273.0,82,5.44,62,351,2383,9.4,0.37142825
4502,4502,Chad Larose,2009-10,27.0,5,31,81,81,19,12,31,171.0,1226.0,268,37,48,85,444.0,82,5.7,65,341,2477,9.4,0.44483793
4503,4503,Chad Larose,2010-11,28.0,6,28,56,56,11,17,28,138.0,879.0,324,48,65,113,582.0,82,5.53,56,304,2486,9.1,0.4409251
4504,4504,Chad Larose,2011-12,29.0,7,31,82,82,16,15,31,176.0,1313.0,406,64,80,144,758.0,82,5.46,52,291,2492,9.0,0.4379819
4505,4505,Chad Larose,2012-13,30.0,8,32,67,67,19,13,32,199.0,1123.0,473,83,93,176,957.0,82,5.32,47,271,2439,8.9,0.43640387
4506,4506,Chad Larose,2013-14,31.0,9,4,35,35,2,2,4,65.0,450.0,508,85,95,180,1022.0,48,5.31,29,160,1399,9.1,0.2628703
4507,4507,Chad Penney,1994-95,21.0,2,0,3,3,0,0,0,2.0,,3,0,0,0,2.0,84,6.48,76,407,2545,10.7,0.20190695
4508,4508,Chad Rau,2012-13,26.0,2,2,9,9,2,0,2,7.0,98.0,9,2,0,2,7.0,82,5.32,47,271,2439,8.9,0.20569715
4509,4509,Chad Ruhwedel,2013-14,23.0,2,0,7,7,0,0,0,8.0,99.0,7,0,0,0,8.0,48,5.31,29,160,1399,9.1,0.19438097
4510,4510,Chad Ruhwedel,2014-15,24.0,3,1,21,21,0,1,1,35.0,375.0,28,0,1,1,43.0,82,5.34,48,269,2463,8.9,0.17387325
4511,4511,Chad Ruhwedel,2015-16,25.0,4,1,4,4,0,1,1,4.0,50.0,32,0,2,2,47.0,82,5.32,47,251,2453,8.9,0.1622133
4512,4512,Chad Ruhwedel,2016-17,26.0,5,0,1,1,0,0,0,1.0,16.0,33,0,2,2,48.0,82,5.34,48,255,2438,9.0,0.1405347
4513,4513,Chad Ruhwedel,2017-18,27.0,6,10,34,34,2,8,10,45.0,589.0,67,2,10,12,93.0,82,5.45,47,245,2478,9.0,0.19119567
4514,4514,Chad Ruhwedel,2018-19,28.0,7,5,44,44,2,3,5,67.0,692.0,111,4,13,17,160.0,82,5.86,50,250,2620,9.2,0.17854962
4515,4515,Chad Ruhwedel,2019-20,29.0,8,2,18,18,1,1,2,22.0,293.0,129,5,14,19,182.0,82,5.96,47,239,2579,9.5,0.16321063
4516,4516,Chad Ruhwedel,2020-21,30.0,9,6,41,41,2,4,6,44.0,606.0,170,7,18,25,226.0,70,5.96,42,208,2192,9.5,0.1578126
4517,4517,Chad Wiseman,2003-04,22.0,2,0,4,4,0,0,0,1.0,37.0,4,0,0,0,1.0,82,5.31,60,363,2326,9.4,0.17139593
4518,4518,Chad Wiseman,2004-05,23.0,3,1,4,4,1,0,1,3.0,35.0,8,1,0,1,4.0,82,5.14,57,348,2300,9.2,0.32351112
4519,4519,Chad Wiseman,2006-07,25.0,4,1,1,1,0,1,1,1.0,9.0,9,1,1,2,5.0,82,6.05,85,480,2458,10.1,0.17855322
4520,4520,Chandler Stephenson,2016-17,22.0,2,0,9,9,0,0,0,2.0,71.0,9,0,0,0,2.0,82,5.34,48,255,2438,9.0,0.16056916
4521,4521,Chandler Stephenson,2017-18,23.0,3,0,4,4,0,0,0,3.0,36.0,13,0,0,0,5.0,82,5.45,47,245,2478,9.0,0.17054349
4522,4522,Chandler Stephenson,2018-19,24.0,4,18,67,67,6,12,18,36.0,795.0,80,6,12,18,41.0,82,5.86,50,250,2620,9.2,0.23463115
4523,4523,Chandler Stephenson,2019-20,25.0,5,11,64,64,5,6,11,36.0,775.0,144,11,18,29,77.0,82,5.96,47,239,2579,9.5,0.17086202
4524,4524,Chandler Stephenson,2020-21,26.0,6,26,65,65,11,15,26,73.0,931.0,209,22,33,55,150.0,70,5.96,42,208,2192,9.5,0.34514177
4525,4525,Charles Hudon,2016-17,22.0,2,2,3,3,0,2,2,3.0,32.0,3,0,2,2,3.0,82,5.34,48,255,2438,9.0,0.21650848
4526,4526,Charles Hudon,2017-18,23.0,3,2,3,3,0,2,2,3.0,36.0,6,0,4,4,6.0,82,5.45,47,245,2478,9.0,0.21124119
4527,4527,Charles Hudon,2018-19,24.0,4,30,72,72,10,20,30,179.0,1010.0,78,10,24,34,185.0,82,5.86,50,250,2620,9.2,0.4567134
4528,4528,Charles Hudon,2019-20,25.0,5,5,32,32,3,2,5,50.0,374.0,110,13,26,39,235.0,82,5.96,47,239,2579,9.5,0.24646625
4529,4529,Charles Hudon,2020-21,26.0,6,2,15,15,1,1,2,22.0,173.0,125,14,27,41,257.0,70,5.96,42,208,2192,9.5,0.21608707
4530,4530,Charles Linglet,2010-11,28.0,2,0,5,5,0,0,0,7.0,51.0,5,0,0,0,7.0,82,5.53,56,304,2486,9.1,0.18110988
4531,4531,Charlie Bourgeois,1982-83,23.0,2,15,54,54,2,13,15,33.0,,54,2,13,15,33.0,80,8.03,73,320,2489,12.9,0.30478656
4532,4532,Charlie Bourgeois,1983-84,24.0,3,5,15,15,2,3,5,11.0,,69,4,16,20,44.0,80,7.73,71,310,2444,12.7,0.29191488
4533,4533,Charlie Bourgeois,1984-85,25.0,4,4,17,17,1,3,4,20.0,,86,5,19,24,64.0,80,7.89,74,336,2448,12.9,0.25459158
4534,4534,Charlie Bourgeois,1985-86,26.0,5,12,47,47,2,10,12,38.0,,133,7,29,36,102.0,80,7.77,71,321,2447,12.7,0.24024183
4535,4535,Charlie Bourgeois,1986-87,27.0,6,19,60,60,7,12,19,64.0,,193,14,41,55,166.0,80,7.94,82,370,2484,12.8,0.26944456
4536,4536,Charlie Bourgeois,1987-88,28.0,7,14,66,66,2,12,14,53.0,,259,16,53,69,219.0,80,7.34,72,344,2400,12.2,0.22036335
4537,4537,Charlie Bourgeois,1988-89,29.0,8,1,31,31,0,1,1,9.0,,290,16,54,70,228.0,80,7.43,89,437,2435,12.2,0.14910403
4538,4538,Charlie Coyle,2013-14,21.0,2,14,37,37,8,6,14,50.0,557.0,37,8,6,14,50.0,48,5.31,29,160,1399,9.1,0.3970099
4539,4539,Charlie Coyle,2014-15,22.0,3,30,70,70,12,18,30,135.0,1196.0,107,20,24,44,185.0,82,5.34,48,269,2463,8.9,0.46367115
4540,4540,Charlie Coyle,2015-16,23.0,4,35,82,82,11,24,35,120.0,1193.0,189,31,48,79,305.0,82,5.32,47,251,2453,8.9,0.44542873
4541,4541,Charlie Coyle,2016-17,24.0,5,42,82,82,21,21,42,140.0,1419.0,271,52,69,121,445.0,82,5.34,48,255,2438,9.0,0.5216198
4542,4542,Charlie Coyle,2017-18,25.0,6,56,82,82,18,38,56,159.0,1370.0,353,70,107,177,604.0,82,5.45,47,245,2478,9.0,0.6868764
4543,4543,Charlie Coyle,2018-19,26.0,7,37,66,66,11,26,37,117.0,1091.0,419,81,133,214,721.0,82,5.86,50,250,2620,9.2,0.50173515
4544,4544,Charlie Coyle,2019-20,27.0,8,34,81,81,12,22,34,155.0,1359.0,500,93,155,248,876.0,82,5.96,47,239,2579,9.5,0.45288047
4545,4545,Charlie Coyle,2020-21,28.0,9,37,70,70,16,21,37,145.0,1175.0,570,109,176,285,1021.0,70,5.96,42,208,2192,9.5,0.50929457
4546,4546,Charlie Huddy,1981-82,22.0,2,7,12,12,2,5,7,23.0,,12,2,5,7,23.0,80,7.69,77,340,2441,12.6,0.4068851
4547,4547,Charlie Huddy,1982-83,23.0,3,15,41,41,4,11,15,84.0,,53,6,16,22,107.0,80,8.03,73,320,2489,12.9,0.4168753
4548,4548,Charlie Huddy,1983-84,24.0,4,57,76,76,20,37,57,151.0,,129,26,53,79,258.0,80,7.73,71,310,2444,12.7,0.6759386
4549,4549,Charlie Huddy,1984-85,25.0,5,42,75,75,8,34,42,163.0,,204,34,87,121,421.0,80,7.89,74,336,2448,12.9,0.5742794
4550,4550,Charlie Huddy,1985-86,26.0,6,51,80,80,7,44,51,145.0,,284,41,131,172,566.0,80,7.77,71,321,2447,12.7,0.6198081
4551,4551,Charlie Huddy,1986-87,27.0,7,41,76,76,6,35,41,149.0,,360,47,166,213,715.0,80,7.94,82,370,2484,12.8,0.5057782
4552,4552,Charlie Huddy,1987-88,28.0,8,19,58,58,4,15,19,75.0,,418,51,181,232,790.0,80,7.34,72,344,2400,12.2,0.34026635
4553,4553,Charlie Huddy,1988-89,29.0,9,41,77,77,13,28,41,163.0,,495,64,209,273,953.0,80,7.43,89,437,2435,12.2,0.517616
4554,4554,Charlie Huddy,1989-90,30.0,10,44,76,76,11,33,44,178.0,,571,75,242,317,1131.0,80,7.48,85,403,2430,12.3,0.54197735
4555,4555,Charlie Huddy,1990-91,31.0,11,24,70,70,1,23,24,119.0,,641,76,265,341,1250.0,80,7.37,76,367,2421,12.2,0.3387257
4556,4556,Charlie Huddy,1991-92,32.0,12,27,53,53,5,22,27,90.0,,694,81,287,368,1340.0,80,6.91,71,366,2385,11.6,0.4475697
4557,4557,Charlie Huddy,1992-93,33.0,13,23,56,56,4,19,23,109.0,,750,85,306,391,1449.0,80,6.96,77,402,2440,11.4,0.40900815
4558,4558,Charlie Huddy,1993-94,34.0,14,27,82,82,2,25,27,106.0,,832,87,331,418,1555.0,84,7.25,87,443,2603,11.7,0.28026044
4559,4559,Charlie Huddy,1994-95,35.0,15,18,79,79,5,13,18,134.0,,911,92,344,436,1689.0,84,6.48,76,407,2545,10.7,0.22389114
4560,4560,Charlie Huddy,1995-96,36.0,16,7,41,41,2,5,7,51.0,,952,94,349,443,1740.0,48,5.97,37,209,1408,10.2,0.1842261
4561,4561,Charlie Huddy,1996-97,37.0,17,10,64,64,5,5,10,70.0,,1016,99,354,453,1810.0,82,6.29,74,413,2481,10.4,0.15646598
4562,4562,Charlie Huddy,1997-98,38.0,18,0,1,1,0,0,0,0.0,,1017,99,354,453,1810.0,82,5.83,55,336,2444,9.8,0.27969414
4563,4563,Charlie Luksa,1980-81,26.0,2,1,8,8,0,1,1,3.0,,8,0,1,1,3.0,80,7.03,61,280,2352,12.0,0.2215442
4564,4564,Charlie McAvoy,2018-19,21.0,2,32,63,63,7,25,32,77.0,1395.0,63,7,25,32,77.0,82,5.86,50,250,2620,9.2,0.51603913
4565,4565,Charlie McAvoy,2019-20,22.0,3,28,54,54,7,21,28,79.0,1197.0,117,14,46,60,156.0,82,5.96,47,239,2579,9.5,0.4803008
4566,4566,Charlie McAvoy,2020-21,23.0,4,32,67,67,5,27,32,101.0,1552.0,184,19,73,92,257.0,70,5.96,42,208,2192,9.5,0.47704798
4567,4567,Charlie Stephens,2003-04,22.0,2,0,2,2,0,0,0,1.0,11.0,2,0,0,0,1.0,82,5.31,60,363,2326,9.4,0.18129355
4568,4568,Charlie Stephens,2004-05,23.0,3,2,6,6,0,2,2,1.0,37.0,8,0,2,2,2.0,82,5.14,57,348,2300,9.2,0.20106477
4569,4569,Chase Balisy,2018-19,26.0,2,0,8,8,0,0,0,6.0,79.0,8,0,0,0,6.0,82,5.86,50,250,2620,9.2,0.16531053
4570,4570,Chase De Leo,2016-17,21.0,2,0,2,2,0,0,0,2.0,19.0,2,0,0,0,2.0,82,5.34,48,255,2438,9.0,0.20420474
4571,4571,Chase De Leo,2019-20,24.0,3,0,1,1,0,0,0,4.0,13.0,3,0,0,0,6.0,82,5.96,47,239,2579,9.5,0.1704166
4572,4572,Chase De Leo,2020-21,25.0,4,0,1,1,0,0,0,1.0,15.0,4,0,0,0,7.0,70,5.96,42,208,2192,9.5,0.17868754
4573,4573,Chay Genoway,2012-13,26.0,2,1,1,1,0,1,1,1.0,18.0,1,0,1,1,1.0,82,5.32,47,271,2439,8.9,0.18072432
4574,4574,Chris Allen,1998-99,20.0,2,0,1,1,0,0,0,1.0,,1,0,0,0,1.0,82,5.28,57,380,2242,9.6,0.21657851
4575,4575,Chris Allen,1999-00,21.0,3,0,1,1,0,0,0,0.0,13.0,2,0,0,0,1.0,82,5.27,57,359,2285,9.4,0.18526909
4576,4576,Chris Armstrong,2001-02,26.0,2,0,3,3,0,0,0,4.0,54.0,3,0,0,0,4.0,82,5.51,63,376,2272,9.9,0.15821433
4577,4577,Chris Armstrong,2004-05,29.0,3,1,4,4,0,1,1,8.0,50.0,7,0,1,1,12.0,82,5.14,57,348,2300,9.2,0.18064076
4578,4578,Chris Bala,2002-03,24.0,2,1,6,6,0,1,1,2.0,34.0,6,0,1,1,2.0,82,5.24,53,338,2262,9.5,0.18390617
4579,4579,Chris Bigras,2016-17,21.0,2,3,31,31,1,2,3,21.0,414.0,31,1,2,3,21.0,82,5.34,48,255,2438,9.0,0.23238349
4580,4580,Chris Bigras,2018-19,23.0,3,1,15,15,0,1,1,8.0,208.0,46,1,3,4,29.0,82,5.86,50,250,2620,9.2,0.16068864
4581,4581,Chris Bourque,2008-09,23.0,2,0,4,4,0,0,0,4.0,35.0,4,0,0,0,4.0,82,5.44,62,351,2383,9.4,0.17979303
4582,4582,Chris Bourque,2009-10,24.0,3,1,8,8,1,0,1,11.0,78.0,12,1,0,1,15.0,82,5.7,65,341,2477,9.4,0.2070275
4583,4583,Chris Bourque,2010-11,25.0,4,3,21,21,0,3,3,21.0,201.0,33,1,3,4,36.0,82,5.53,56,304,2486,9.1,0.16943479
4584,4584,Chris Bourque,2013-14,28.0,5,4,18,18,1,3,4,24.0,217.0,51,2,6,8,60.0,48,5.31,29,160,1399,9.1,0.23290005
4585,4585,Chris Brown,2013-14,22.0,2,0,5,5,0,0,0,6.0,38.0,5,0,0,0,6.0,48,5.31,29,160,1399,9.1,0.2058757
4586,4586,Chris Brown,2014-15,23.0,3,2,12,12,1,1,2,8.0,104.0,17,1,1,2,14.0,82,5.34,48,269,2463,8.9,0.19868678
4587,4587,Chris Brown,2015-16,24.0,4,1,5,5,1,0,1,4.0,32.0,22,2,1,3,18.0,82,5.32,47,251,2453,8.9,0.17867932
4588,4588,Chris Brown,2016-17,25.0,5,0,1,1,0,0,0,1.0,8.0,23,2,1,3,19.0,82,5.34,48,255,2438,9.0,0.14079171
4589,4589,Chris Butler,2009-10,23.0,2,6,47,47,2,4,6,36.0,786.0,47,2,4,6,36.0,82,5.7,65,341,2477,9.4,0.21205097
4590,4590,Chris Butler,2010-11,24.0,3,21,59,59,1,20,21,61.0,1181.0,106,3,24,27,97.0,82,5.53,56,304,2486,9.1,0.28406188
4591,4591,Chris Butler,2011-12,25.0,4,9,49,49,2,7,9,52.0,890.0,155,5,31,36,149.0,82,5.46,52,291,2492,9.0,0.18490705
4592,4592,Chris Butler,2012-13,26.0,5,15,68,68,2,13,15,62.0,1469.0,223,7,44,51,211.0,82,5.32,47,271,2439,8.9,0.19276378
4593,4593,Chris Butler,2013-14,27.0,6,8,44,44,1,7,8,40.0,750.0,267,8,51,59,251.0,48,5.31,29,160,1399,9.1,0.18925348
4594,4594,Chris Butler,2014-15,28.0,7,16,82,82,2,14,16,83.0,1662.0,349,10,65,75,334.0,82,5.34,48,269,2463,8.9,0.20677772
4595,4595,Chris Butler,2015-16,29.0,8,9,33,33,3,6,9,54.0,567.0,382,13,71,84,388.0,82,5.32,47,251,2453,8.9,0.22799587
4596,4596,Chris Butler,2016-17,30.0,9,0,5,5,0,0,0,4.0,58.0,387,13,71,84,392.0,82,5.34,48,255,2438,9.0,0.15477586
4597,4597,Chris Butler,2017-18,31.0,10,0,1,1,0,0,0,1.0,21.0,388,13,71,84,393.0,82,5.45,47,245,2478,9.0,0.16401163
4598,4598,Chris Butler,2018-19,32.0,11,0,6,6,0,0,0,2.0,80.0,394,13,71,84,395.0,82,5.86,50,250,2620,9.2,0.11921799
4599,4599,Chris Butler,2019-20,33.0,12,2,13,13,1,1,2,10.0,183.0,407,14,72,86,405.0,82,5.96,47,239,2579,9.5,0.14953098
4600,4600,Chris Campoli,2006-07,22.0,2,34,80,80,9,25,34,123.0,1483.0,80,9,25,34,123.0,82,6.05,85,480,2458,10.1,0.4500627
4601,4601,Chris Campoli,2007-08,23.0,3,14,51,51,1,13,14,41.0,756.0,131,10,38,48,164.0,82,5.76,70,398,2426,9.7,0.29917988
4602,4602,Chris Campoli,2008-09,24.0,4,18,46,46,4,14,18,68.0,881.0,177,14,52,66,232.0,82,5.44,62,351,2383,9.4,0.3587707
4603,4603,Chris Campoli,2009-10,25.0,5,30,76,76,11,19,30,91.0,1485.0,253,25,71,96,323.0,82,5.7,65,341,2477,9.4,0.36057055
4604,4604,Chris Campoli,2010-11,26.0,6,18,67,67,4,14,18,71.0,1196.0,320,29,85,114,394.0,82,5.53,56,304,2486,9.1,0.29011628
4605,4605,Chris Campoli,2011-12,27.0,7,21,77,77,4,17,21,84.0,1474.0,397,33,102,135,478.0,82,5.46,52,291,2492,9.0,0.2659627
4606,4606,Chris Campoli,2012-13,28.0,8,11,43,43,2,9,11,43.0,740.0,440,35,111,146,521.0,82,5.32,47,271,2439,8.9,0.21997917
4607,4607,Chris Chelios,1984-85,23.0,2,2,12,12,0,2,2,23.0,,12,0,2,2,23.0,80,7.89,74,336,2448,12.9,0.32115844
4608,4608,Chris Chelios,1985-86,24.0,3,64,74,74,9,55,64,200.0,,86,9,57,66,223.0,80,7.77,71,321,2447,12.7,0.74831545
4609,4609,Chris Chelios,1986-87,25.0,4,34,41,41,8,26,34,101.0,,127,17,83,100,324.0,80,7.94,82,370,2484,12.8,0.64288193
4610,4610,Chris Chelios,1987-88,26.0,5,44,71,71,11,33,44,141.0,,198,28,116,144,465.0,80,7.34,72,344,2400,12.2,0.6480081
4611,4611,Chris Chelios,1988-89,27.0,6,61,71,71,20,41,61,199.0,,269,48,157,205,664.0,80,7.43,89,437,2435,12.2,0.7857977
4612,4612,Chris Chelios,1989-90,28.0,7,73,80,80,15,58,73,206.0,,349,63,215,278,870.0,80,7.48,85,403,2430,12.3,0.8178582
4613,4613,Chris Chelios,1990-91,29.0,8,31,53,53,9,22,31,123.0,,402,72,237,309,993.0,80,7.37,76,367,2421,12.2,0.61422473
4614,4614,Chris Chelios,1991-92,30.0,9,64,77,77,12,52,64,187.0,,479,84,289,373,1180.0,80,6.91,71,366,2385,11.6,0.74047947
4615,4615,Chris Chelios,1992-93,31.0,10,56,80,80,9,47,56,239.0,,559,93,336,429,1419.0,80,6.96,77,402,2440,11.4,0.8024155
4616,4616,Chris Chelios,1993-94,32.0,11,73,84,84,15,58,73,290.0,,643,108,394,502,1709.0,84,7.25,87,443,2603,11.7,0.75494206
4617,4617,Chris Chelios,1994-95,33.0,12,60,76,76,16,44,60,219.0,,719,124,438,562,1928.0,84,6.48,76,407,2545,10.7,0.66010845
4618,4618,Chris Chelios,1995-96,34.0,13,38,48,48,5,33,38,166.0,,767,129,471,600,2094.0,48,5.97,37,209,1408,10.2,0.80935025
4619,4619,Chris Chelios,1996-97,35.0,14,72,81,81,14,58,72,219.0,,848,143,529,672,2313.0,82,6.29,74,413,2481,10.4,0.7291633
4620,4620,Chris Chelios,1997-98,36.0,15,48,72,72,10,38,48,194.0,,920,153,567,720,2507.0,82,5.83,55,336,2444,9.8,0.58514833
4621,4621,Chris Chelios,1998-99,37.0,16,42,81,81,3,39,42,205.0,,1001,156,606,762,2712.0,82,5.28,57,380,2242,9.6,0.49617523
4622,4622,Chris Chelios,1999-00,38.0,17,36,75,75,9,27,36,187.0,1999.0,1076,165,633,798,2899.0,82,5.27,57,359,2285,9.4,0.49545735
4623,4623,Chris Chelios,2000-01,39.0,18,34,81,81,3,31,34,135.0,2047.0,1157,168,664,832,3034.0,82,5.49,53,331,2294,9.8,0.36670125
4624,4624,Chris Chelios,2001-02,40.0,19,3,24,24,0,3,3,26.0,548.0,1181,168,667,835,3060.0,82,5.51,63,376,2272,9.9,0.30088717
4625,4625,Chris Chelios,2002-03,41.0,20,39,79,79,6,33,39,128.0,1999.0,1260,174,700,874,3188.0,82,5.24,53,338,2262,9.5,0.4002974
4626,4626,Chris Chelios,2003-04,42.0,21,19,66,66,2,17,19,92.0,1600.0,1326,176,717,893,3280.0,82,5.31,60,363,2326,9.4,0.24962088
4627,4627,Chris Chelios,2004-05,43.0,22,21,69,69,2,19,21,113.0,1473.0,1395,178,736,914,3393.0,82,5.14,57,348,2300,9.2,0.2742108
4628,4628,Chris Chelios,2006-07,45.0,23,11,81,81,4,7,11,83.0,1497.0,1476,182,743,925,3476.0,82,6.05,85,480,2458,10.1,0.1911312
4629,4629,Chris Chelios,2007-08,46.0,24,11,71,71,0,11,11,72.0,1287.0,1547,182,754,936,3548.0,82,5.76,70,398,2426,9.7,0.20263481
4630,4630,Chris Chelios,2008-09,47.0,25,12,69,69,3,9,12,60.0,1170.0,1616,185,763,948,3608.0,82,5.44,62,351,2383,9.4,0.16894051
4631,4631,Chris Chelios,2009-10,48.0,26,0,28,28,0,0,0,14.0,327.0,1644,185,763,948,3622.0,82,5.7,65,341,2477,9.4,0.20001698
4632,4632,Chris Chelios,2010-11,49.0,27,0,7,7,0,0,0,5.0,78.0,1651,185,763,948,3627.0,82,5.53,56,304,2486,9.1,0.27892804
4633,4633,Chris Cichocki,1986-87,23.0,2,21,59,59,10,11,21,76.0,,59,10,11,21,76.0,80,7.94,82,370,2484,12.8,0.36629653
4634,4634,Chris Cichocki,1987-88,24.0,3,0,2,2,0,0,0,0.0,,61,10,11,21,76.0,80,7.34,72,344,2400,12.2,0.23635134
4635,4635,Chris Cichocki,1988-89,25.0,4,1,5,5,1,0,1,2.0,,66,11,11,22,78.0,80,7.43,89,437,2435,12.2,0.27313328
4636,4636,Chris Cichocki,1989-90,26.0,5,1,2,2,0,1,1,2.0,,68,11,12,23,80.0,80,7.48,85,403,2430,12.3,0.24162075
4637,4637,Chris Clark,2000-01,24.0,2,1,22,22,0,1,1,17.0,199.0,22,0,1,1,17.0,82,5.49,53,331,2294,9.8,0.14070675
4638,4638,Chris Clark,2001-02,25.0,3,6,29,29,5,1,6,43.0,346.0,51,5,2,7,60.0,82,5.51,63,376,2272,9.9,0.22436753
4639,4639,Chris Clark,2002-03,26.0,4,17,64,64,10,7,17,109.0,893.0,115,15,9,24,169.0,82,5.24,53,338,2262,9.5,0.2715907
4640,4640,Chris Clark,2003-04,27.0,5,22,81,81,10,12,22,156.0,1166.0,196,25,21,46,325.0,82,5.31,60,363,2326,9.4,0.2963735
4641,4641,Chris Clark,2004-05,28.0,6,25,82,82,10,15,25,137.0,1154.0,278,35,36,71,462.0,82,5.14,57,348,2300,9.2,0.38771096
4642,4642,Chris Clark,2006-07,30.0,7,39,78,78,20,19,39,144.0,1202.0,356,55,55,110,606.0,82,6.05,85,480,2458,10.1,0.43219274
4643,4643,Chris Clark,2007-08,31.0,8,54,74,74,30,24,54,164.0,1363.0,430,85,79,164,770.0,82,5.76,70,398,2426,9.7,0.5699242
4644,4644,Chris Clark,2008-09,32.0,9,9,18,18,5,4,9,29.0,304.0,448,90,83,173,799.0,82,5.44,62,351,2383,9.4,0.30618012
4645,4645,Chris Clark,2009-10,33.0,10,6,32,32,1,5,6,36.0,370.0,480,91,88,179,835.0,82,5.7,65,341,2477,9.4,0.23371318
4646,4646,Chris Clark,2010-11,34.0,11,20,74,74,7,13,20,105.0,878.0,554,98,101,199,940.0,82,5.53,56,304,2486,9.1,0.27055347
4647,4647,Chris Clark,2011-12,35.0,12,15,53,53,5,10,15,83.0,776.0,607,103,111,214,1023.0,82,5.46,52,291,2492,9.0,0.27008635
4648,4648,Chris Conner,2007-08,24.0,2,3,11,11,1,2,3,18.0,124.0,11,1,2,3,18.0,82,5.76,70,398,2426,9.7,0.2191965
4649,4649,Chris Conner,2008-09,25.0,3,5,22,22,3,2,5,27.0,264.0,33,4,4,8,45.0,82,5.44,62,351,2383,9.4,0.24636406
4650,4650,Chris Conner,2009-10,26.0,4,13,38,38,3,10,13,34.0,415.0,71,7,14,21,79.0,82,5.7,65,341,2477,9.4,0.23684052
4651,4651,Chris Conner,2010-11,27.0,5,3,8,8,2,1,3,11.0,77.0,79,9,15,24,90.0,82,5.53,56,304,2486,9.1,0.22534028
4652,4652,Chris Conner,2011-12,28.0,6,16,60,60,7,9,16,91.0,709.0,139,16,24,40,181.0,82,5.46,52,291,2492,9.0,0.23391744
4653,4653,Chris Conner,2012-13,29.0,7,3,8,8,1,2,3,10.0,85.0,147,17,26,43,191.0,82,5.32,47,271,2439,8.9,0.19067389
4654,4654,Chris Conner,2013-14,30.0,8,2,12,12,1,1,2,15.0,137.0,159,18,27,45,206.0,48,5.31,29,160,1399,9.1,0.21489727
4655,4655,Chris Conner,2014-15,31.0,9,5,19,19,4,1,5,17.0,224.0,178,22,28,50,223.0,82,5.34,48,269,2463,8.9,0.19059107
4656,4656,Chris Conner,2015-16,32.0,10,0,2,2,0,0,0,3.0,18.0,180,22,28,50,226.0,82,5.32,47,251,2453,8.9,0.16681787
4657,4657,Chris Corrinet,2002-03,24.0,2,1,8,8,0,1,1,8.0,81.0,8,0,1,1,8.0,82,5.24,53,338,2262,9.5,0.18390617
4658,4658,Chris Dahlquist,1986-87,24.0,2,3,5,5,1,2,3,5.0,,5,1,2,3,5.0,80,7.94,82,370,2484,12.8,0.26231968
4659,4659,Chris Dahlquist,1987-88,25.0,3,1,19,19,0,1,1,15.0,,24,1,3,4,20.0,80,7.34,72,344,2400,12.2,0.1777755
4660,4660,Chris Dahlquist,1988-89,26.0,4,9,44,44,3,6,9,35.0,,68,4,9,13,55.0,80,7.43,89,437,2435,12.2,0.18134171
4661,4661,Chris Dahlquist,1989-90,27.0,5,6,43,43,1,5,6,27.0,,111,5,14,19,82.0,80,7.48,85,403,2430,12.3,0.16295731
4662,4662,Chris Dahlquist,1990-91,28.0,6,14,62,62,4,10,14,57.0,,173,9,24,33,139.0,80,7.37,76,367,2421,12.2,0.20208228
4663,4663,Chris Dahlquist,1991-92,29.0,7,11,64,64,3,8,11,52.0,,237,12,32,44,191.0,80,6.91,71,366,2385,11.6,0.20533067
4664,4664,Chris Dahlquist,1992-93,30.0,8,14,74,74,1,13,14,63.0,,311,13,45,58,254.0,80,6.96,77,402,2440,11.4,0.16179606
4665,4665,Chris Dahlquist,1993-94,31.0,9,10,74,74,3,7,10,64.0,,385,16,52,68,318.0,84,7.25,87,443,2603,11.7,0.14839563
4666,4666,Chris Dahlquist,1994-95,32.0,10,12,77,77,1,11,12,57.0,,462,17,63,80,375.0,84,6.48,76,407,2545,10.7,0.13497913
4667,4667,Chris Dahlquist,1995-96,33.0,11,8,46,46,1,7,8,45.0,,508,18,70,88,420.0,48,5.97,37,209,1408,10.2,0.15735903
4668,4668,Chris Dahlquist,1996-97,34.0,12,2,24,24,1,1,2,13.0,,532,19,71,90,433.0,82,6.29,74,413,2481,10.4,0.09137863
4669,4669,Chris Dingman,1998-99,22.0,2,6,70,70,3,3,6,47.0,,70,3,3,6,47.0,82,5.28,57,380,2242,9.6,0.17451227
4670,4670,Chris Dingman,1999-00,23.0,3,0,3,3,0,0,0,1.0,17.0,73,3,3,6,48.0,82,5.27,57,359,2285,9.4,0.15972614
4671,4671,Chris Dingman,2000-01,24.0,4,11,68,68,8,3,11,54.0,441.0,141,11,6,17,102.0,82,5.49,53,331,2294,9.8,0.18404362
4672,4672,Chris Dingman,2001-02,25.0,5,2,41,41,1,1,2,33.0,264.0,182,12,7,19,135.0,82,5.51,63,376,2272,9.9,0.13610908
4673,4673,Chris Dingman,2002-03,26.0,6,5,44,44,0,5,5,41.0,357.0,226,12,12,24,176.0,82,5.24,53,338,2262,9.5,0.13910502
4674,4674,Chris Dingman,2003-04,27.0,7,3,51,51,2,1,3,41.0,488.0,277,14,13,27,217.0,82,5.31,60,363,2326,9.4,0.13363463
4675,4675,Chris Dingman,2004-05,28.0,8,6,74,74,1,5,6,65.0,612.0,351,15,18,33,282.0,82,5.14,57,348,2300,9.2,0.15080822
4676,4676,Chris Dingman,2006-07,30.0,9,1,34,34,0,1,1,24.0,187.0,385,15,19,34,306.0,82,6.05,85,480,2458,10.1,0.10605252
4677,4677,Chris Drury,1999-00,23.0,2,44,79,79,20,24,44,138.0,1047.0,79,20,24,44,138.0,82,5.27,57,359,2285,9.4,0.5629991
4678,4678,Chris Drury,2000-01,24.0,3,67,82,82,20,47,67,213.0,1521.0,161,40,71,111,351.0,82,5.49,53,331,2294,9.8,0.8425568
4679,4679,Chris Drury,2001-02,25.0,4,65,71,71,24,41,65,204.0,1281.0,232,64,112,176,555.0,82,5.51,63,376,2272,9.9,0.8205999
4680,4680,Chris Drury,2002-03,26.0,5,46,82,82,21,25,46,236.0,1471.0,314,85,137,222,791.0,82,5.24,53,338,2262,9.5,0.6739239
4681,4681,Chris Drury,2003-04,27.0,6,53,80,80,23,30,53,224.0,1484.0,394,108,167,275,1015.0,82,5.31,60,363,2326,9.4,0.6465461
4682,4682,Chris Drury,2004-05,28.0,7,53,76,76,18,35,53,152.0,1373.0,470,126,202,328,1167.0,82,5.14,57,348,2300,9.2,0.7774178
4683,4683,Chris Drury,2006-07,30.0,8,67,81,81,30,37,67,172.0,1466.0,551,156,239,395,1339.0,82,6.05,85,480,2458,10.1,0.78805673
4684,4684,Chris Drury,2007-08,31.0,9,69,77,77,37,32,69,199.0,1446.0,628,193,271,464,1538.0,82,5.76,70,398,2426,9.7,0.7334124
4685,4685,Chris Drury,2008-09,32.0,10,58,82,82,25,33,58,220.0,1623.0,710,218,304,522,1758.0,82,5.44,62,351,2383,9.4,0.6688332
4686,4686,Chris Drury,2009-10,33.0,11,56,81,81,22,34,56,219.0,1640.0,791,240,338,578,1977.0,82,5.7,65,341,2477,9.4,0.636095
4687,4687,Chris Drury,2010-11,34.0,12,32,77,77,14,18,32,148.0,1369.0,868,254,356,610,2125.0,82,5.53,56,304,2486,9.1,0.398453
4688,4688,Chris Drury,2011-12,35.0,13,5,24,24,1,4,5,26.0,288.0,892,255,360,615,2151.0,82,5.46,52,291,2492,9.0,0.36669666
4689,4689,Chris Durno,2009-10,29.0,2,0,2,2,0,0,0,3.0,12.0,2,0,0,0,3.0,82,5.7,65,341,2477,9.4,0.16938677
4690,4690,Chris Durno,2010-11,30.0,3,8,41,41,4,4,8,27.0,306.0,43,4,4,8,30.0,82,5.53,56,304,2486,9.1,0.1401009
4691,4691,Chris Felix,1989-90,25.0,2,8,21,21,0,8,8,18.0,,21,0,8,8,18.0,80,7.48,85,403,2430,12.3,0.22272408
4692,4692,Chris Felix,1990-91,26.0,3,1,6,6,1,0,1,3.0,,27,1,8,9,21.0,80,7.37,76,367,2421,12.2,0.2118243
4693,4693,Chris Felix,1991-92,27.0,4,4,8,8,0,4,4,7.0,,35,1,12,13,28.0,80,6.91,71,366,2385,11.6,0.22481048
4694,4694,Chris Ferraro,1996-97,24.0,2,1,2,2,1,0,1,4.0,,2,1,0,1,4.0,82,6.29,74,413,2481,10.4,0.21913391
4695,4695,Chris Ferraro,1997-98,25.0,3,2,12,12,1,1,2,23.0,,14,2,1,3,27.0,82,5.83,55,336,2444,9.8,0.2316393
4696,4696,Chris Ferraro,1998-99,26.0,4,7,46,46,3,4,7,42.0,,60,5,5,10,69.0,82,5.28,57,380,2242,9.6,0.1578426
4697,4697,Chris Ferraro,1999-00,27.0,5,1,2,2,1,0,1,1.0,17.0,62,6,5,11,70.0,82,5.27,57,359,2285,9.4,0.16047743
4698,4698,Chris Ferraro,2000-01,28.0,6,4,11,11,1,3,4,15.0,105.0,73,7,8,15,85.0,82,5.49,53,331,2294,9.8,0.20493594
4699,4699,Chris Ferraro,2002-03,30.0,7,1,1,1,0,1,1,4.0,15.0,74,7,9,16,89.0,82,5.24,53,338,2262,9.5,0.16500789
4700,4700,Chris Govedaris,1990-91,20.0,2,1,12,12,0,1,1,13.0,,12,0,1,1,13.0,80,7.37,76,367,2421,12.2,0.29304957
4701,4701,Chris Govedaris,1991-92,21.0,3,4,14,14,1,3,4,10.0,,26,1,4,5,23.0,80,6.91,71,366,2385,11.6,0.2937255
4702,4702,Chris Govedaris,1993-94,23.0,4,1,7,7,1,0,1,6.0,,33,2,4,6,29.0,84,7.25,87,443,2603,11.7,0.23645267
4703,4703,Chris Govedaris,1994-95,24.0,5,4,12,12,2,2,4,16.0,,45,4,6,10,45.0,84,6.48,76,407,2545,10.7,0.23686978
4704,4704,Chris Gratton,1994-95,19.0,2,42,84,84,13,29,42,161.0,,84,13,29,42,161.0,84,6.48,76,407,2545,10.7,0.59119296
4705,4705,Chris Gratton,1995-96,20.0,3,27,46,46,7,20,27,91.0,,130,20,49,69,252.0,48,5.97,37,209,1408,10.2,0.5797098
4706,4706,Chris Gratton,1996-97,21.0,4,38,82,82,17,21,38,183.0,,212,37,70,107,435.0,82,6.29,74,413,2481,10.4,0.57989943
4707,4707,Chris Gratton,1997-98,22.0,5,62,82,82,30,32,62,230.0,,294,67,102,169,665.0,82,5.83,55,336,2444,9.8,0.7618508
4708,4708,Chris Gratton,1998-99,23.0,6,62,82,82,22,40,62,182.0,,376,89,142,231,847.0,82,5.28,57,380,2242,9.6,0.7622237
4709,4709,Chris Gratton,1999-00,24.0,7,34,78,78,8,26,34,181.0,1328.0,454,97,168,265,1028.0,82,5.27,57,359,2285,9.4,0.5248229
4710,4710,Chris Gratton,2000-01,25.0,8,49,72,72,15,34,49,202.0,1396.0,526,112,202,314,1230.0,82,5.49,53,331,2294,9.8,0.6918015
4711,4711,Chris Gratton,2001-02,26.0,9,40,82,82,19,21,40,156.0,1199.0,608,131,223,354,1386.0,82,5.51,63,376,2272,9.9,0.5308904
4712,4712,Chris Gratton,2002-03,27.0,10,39,82,82,15,24,39,139.0,1226.0,690,146,247,393,1525.0,82,5.24,53,338,2262,9.5,0.52139264
4713,4713,Chris Gratton,2003-04,28.0,11,45,80,80,15,30,45,215.0,1325.0,770,161,277,438,1740.0,82,5.31,60,363,2326,9.4,0.5842414
4714,4714,Chris Gratton,2004-05,29.0,12,32,81,81,13,19,32,150.0,1218.0,851,174,296,470,1890.0,82,5.14,57,348,2300,9.2,0.5041604
4715,4715,Chris Gratton,2006-07,31.0,13,39,76,76,17,22,39,135.0,1195.0,927,191,318,509,2025.0,82,6.05,85,480,2458,10.1,0.435908
4716,4716,Chris Gratton,2007-08,32.0,14,35,81,81,13,22,35,131.0,980.0,1008,204,340,544,2156.0,82,5.76,70,398,2426,9.7,0.37205192
4717,4717,Chris Gratton,2008-09,33.0,15,21,60,60,10,11,21,92.0,762.0,1068,214,351,565,2248.0,82,5.44,62,351,2383,9.4,0.3028065
4718,4718,Chris Gratton,2009-10,34.0,16,3,24,24,0,3,3,20.0,253.0,1092,214,354,568,2268.0,82,5.7,65,341,2477,9.4,0.243272
4719,4719,Chris Hajt,2001-02,23.0,2,0,1,1,0,0,0,0.0,8.0,1,0,0,0,0.0,82,5.51,63,376,2272,9.9,0.16257238
4720,4720,Chris Hajt,2004-05,26.0,3,0,5,5,0,0,0,1.0,54.0,6,0,0,0,1.0,82,5.14,57,348,2300,9.2,0.15919992
4721,4721,Chris Herperger,2000-01,26.0,2,0,9,9,0,0,0,2.0,69.0,9,0,0,0,2.0,82,5.49,53,331,2294,9.8,0.16268289
4722,4722,Chris Herperger,2001-02,27.0,3,25,61,61,10,15,25,76.0,800.0,70,10,15,25,78.0,82,5.51,63,376,2272,9.9,0.31696522
4723,4723,Chris Herperger,2002-03,28.0,4,13,72,72,4,9,13,81.0,815.0,142,14,24,38,159.0,82,5.24,53,338,2262,9.5,0.18966642
4724,4724,Chris Herperger,2003-04,29.0,5,5,27,27,4,1,5,26.0,338.0,169,18,25,43,185.0,82,5.31,60,363,2326,9.4,0.20750263
4725,4725,Chris Higgins,2004-05,21.0,2,0,2,2,0,0,0,0.0,13.0,2,0,0,0,0.0,82,5.14,57,348,2300,9.2,0.24485323
4726,4726,Chris Higgins,2006-07,23.0,3,38,80,80,23,15,38,148.0,1153.0,82,23,15,38,148.0,82,6.05,85,480,2458,10.1,0.5204504
4727,4727,Chris Higgins,2007-08,24.0,4,38,61,61,22,16,38,159.0,1092.0,143,45,31,76,307.0,82,5.76,70,398,2426,9.7,0.60237455
4728,4728,Chris Higgins,2008-09,25.0,5,52,82,82,27,25,52,241.0,1472.0,225,72,56,128,548.0,82,5.44,62,351,2383,9.4,0.6508775
4729,4729,Chris Higgins,2009-10,26.0,6,23,57,57,12,11,23,151.0,969.0,282,84,67,151,699.0,82,5.7,65,341,2477,9.4,0.4119758
4730,4730,Chris Higgins,2010-11,27.0,7,17,67,67,8,9,17,165.0,1175.0,349,92,76,168,864.0,82,5.53,56,304,2486,9.1,0.3219027
4731,4731,Chris Higgins,2011-12,28.0,8,28,62,62,13,15,28,160.0,1011.0,411,105,91,196,1024.0,82,5.46,52,291,2492,9.0,0.45477775
4732,4732,Chris Higgins,2012-13,29.0,9,43,71,71,18,25,43,165.0,1158.0,482,123,116,239,1189.0,82,5.32,47,271,2439,8.9,0.5129354
4733,4733,Chris Higgins,2013-14,30.0,10,15,41,41,10,5,15,77.0,673.0,523,133,121,254,1266.0,48,5.31,29,160,1399,9.1,0.42654997
4734,4734,Chris Higgins,2014-15,31.0,11,39,78,78,17,22,39,216.0,1496.0,601,150,143,293,1482.0,82,5.34,48,269,2463,8.9,0.4935251
4735,4735,Chris Higgins,2015-16,32.0,12,36,77,77,12,24,36,171.0,1216.0,678,162,167,329,1653.0,82,5.32,47,251,2453,8.9,0.40256715
4736,4736,Chris Higgins,2016-17,33.0,13,4,33,33,3,1,4,51.0,455.0,711,165,168,333,1704.0,82,5.34,48,255,2438,9.0,0.24585333
4737,4737,Chris Jensen,1986-87,23.0,2,4,9,9,1,3,4,18.0,,9,1,3,4,18.0,80,7.94,82,370,2484,12.8,0.27565265
4738,4738,Chris Jensen,1987-88,24.0,3,13,36,36,6,7,13,70.0,,45,7,10,17,88.0,80,7.34,72,344,2400,12.2,0.36561096
4739,4739,Chris Jensen,1988-89,25.0,4,1,7,7,0,1,1,11.0,,52,7,11,18,99.0,80,7.43,89,437,2435,12.2,0.24035949
4740,4740,Chris Jensen,1990-91,27.0,5,0,1,1,0,0,0,0.0,,53,7,11,18,99.0,80,7.37,76,367,2421,12.2,0.19700804
4741,4741,Chris Jensen,1991-92,28.0,6,3,18,18,2,1,3,22.0,,71,9,12,21,121.0,80,6.91,71,366,2385,11.6,0.25050282
4742,4742,Chris Jensen,1992-93,29.0,7,0,2,2,0,0,0,2.0,,73,9,12,21,123.0,80,6.96,77,402,2440,11.4,0.18433493
4743,4743,Chris Joseph,1988-89,19.0,2,8,24,24,0,8,8,14.0,,24,0,8,8,14.0,80,7.43,89,437,2435,12.2,0.27984947
4744,4744,Chris Joseph,1989-90,20.0,3,9,44,44,4,5,9,36.0,,68,4,13,17,50.0,80,7.48,85,403,2430,12.3,0.2572363
4745,4745,Chris Joseph,1990-91,21.0,4,2,4,4,0,2,2,5.0,,72,4,15,19,55.0,80,7.37,76,367,2421,12.2,0.3259275
4746,4746,Chris Joseph,1991-92,22.0,5,22,49,49,5,17,22,74.0,,121,9,32,41,129.0,80,6.91,71,366,2385,11.6,0.3928564
4747,4747,Chris Joseph,1992-93,23.0,6,0,7,7,0,0,0,5.0,,128,9,32,41,134.0,80,6.96,77,402,2440,11.4,0.2589849
4748,4748,Chris Joseph,1993-94,24.0,7,12,33,33,2,10,12,49.0,,161,11,42,53,183.0,84,7.25,87,443,2603,11.7,0.29519692
4749,4749,Chris Joseph,1994-95,25.0,8,31,76,76,11,20,31,179.0,,237,22,62,84,362.0,84,6.48,76,407,2545,10.7,0.4297761
4750,4750,Chris Joseph,1995-96,26.0,9,15,33,33,5,10,15,73.0,,270,27,72,99,435.0,48,5.97,37,209,1408,10.2,0.37279883
4751,4751,Chris Joseph,1996-97,27.0,10,19,70,70,5,14,19,94.0,,340,32,86,118,529.0,82,6.29,74,413,2481,10.4,0.26469088
4752,4752,Chris Joseph,1997-98,28.0,11,16,63,63,3,13,16,99.0,,403,35,99,134,628.0,82,5.83,55,336,2444,9.8,0.24221599
4753,4753,Chris Joseph,1998-99,29.0,12,1,15,15,1,0,1,20.0,,418,36,99,135,648.0,82,5.28,57,380,2242,9.6,0.19384593
4754,4754,Chris Joseph,1999-00,30.0,13,0,2,2,0,0,0,1.0,19.0,420,36,99,135,649.0,82,5.27,57,359,2285,9.4,0.15558687
4755,4755,Chris Joseph,2000-01,31.0,14,11,47,47,2,9,11,86.0,775.0,467,38,108,146,735.0,82,5.49,53,331,2294,9.8,0.19798535
4756,4756,Chris Joseph,2001-02,32.0,15,5,43,43,1,4,5,58.0,707.0,510,39,112,151,793.0,82,5.51,63,376,2272,9.9,0.13903967
4757,4757,Chris Kelleher,2002-03,27.0,2,0,1,1,0,0,0,0.0,6.0,1,0,0,0,0.0,82,5.24,53,338,2262,9.5,0.1569908
4758,4758,Chris Kelly,2004-05,24.0,2,0,4,4,0,0,0,4.0,38.0,4,0,0,0,4.0,82,5.14,57,348,2300,9.2,0.23041743
4759,4759,Chris Kelly,2006-07,26.0,3,30,82,82,10,20,30,112.0,1011.0,86,10,20,30,116.0,82,6.05,85,480,2458,10.1,0.37384388
4760,4760,Chris Kelly,2007-08,27.0,4,38,82,82,15,23,38,131.0,1255.0,168,25,43,68,247.0,82,5.76,70,398,2426,9.7,0.45607305
4761,4761,Chris Kelly,2008-09,28.0,5,30,75,75,11,19,30,124.0,1245.0,243,36,62,98,371.0,82,5.44,62,351,2383,9.4,0.38365215
4762,4762,Chris Kelly,2009-10,29.0,6,23,82,82,12,11,23,118.0,1279.0,325,48,73,121,489.0,82,5.7,65,341,2477,9.4,0.28666788
4763,4763,Chris Kelly,2010-11,30.0,7,32,81,81,15,17,32,112.0,1212.0,406,63,90,153,601.0,82,5.53,56,304,2486,9.1,0.37910724
4764,4764,Chris Kelly,2011-12,31.0,8,28,81,81,14,14,28,113.0,1249.0,487,77,104,181,714.0,82,5.46,52,291,2492,9.0,0.348378
4765,4765,Chris Kelly,2012-13,32.0,9,39,82,82,20,19,39,122.0,1208.0,569,97,123,220,836.0,82,5.32,47,271,2439,8.9,0.39841762
4766,4766,Chris Kelly,2013-14,33.0,10,9,34,34,3,6,9,40.0,509.0,603,100,129,229,876.0,48,5.31,29,160,1399,9.1,0.2744797
4767,4767,Chris Kelly,2014-15,34.0,11,18,57,57,9,9,18,69.0,838.0,660,109,138,247,945.0,82,5.34,48,269,2463,8.9,0.25338966
4768,4768,Chris Kelly,2015-16,35.0,12,28,80,80,7,21,28,112.0,1211.0,740,116,159,275,1057.0,82,5.32,47,251,2453,8.9,0.28751695
4769,4769,Chris Kelly,2016-17,36.0,13,2,11,11,2,0,2,8.0,144.0,751,118,159,277,1065.0,82,5.34,48,255,2438,9.0,0.21176648
4770,4770,Chris Kelly,2017-18,37.0,14,12,82,82,5,7,12,85.0,979.0,833,123,166,289,1150.0,82,5.45,47,245,2478,9.0,0.17710695
4771,4771,Chris Kelly,2018-19,38.0,15,2,12,12,0,2,2,5.0,92.0,845,123,168,291,1155.0,82,5.86,50,250,2620,9.2,0.13277248
4772,4772,Chris Kenady,1998-99,25.0,2,2,5,5,0,2,2,3.0,,5,0,2,2,3.0,82,5.28,57,380,2242,9.6,0.18463397
4773,4773,Chris Kenady,2000-01,27.0,3,0,2,2,0,0,0,1.0,15.0,7,0,2,2,4.0,82,5.49,53,331,2294,9.8,0.13845512
4774,4774,Chris Kontos,1983-84,20.0,2,15,44,44,8,7,15,63.0,,44,8,7,15,63.0,80,7.73,71,310,2444,12.7,0.4077017
4775,4775,Chris Kontos,1984-85,21.0,3,1,6,6,0,1,1,1.0,,50,8,8,16,64.0,80,7.89,74,336,2448,12.9,0.3486839
4776,4776,Chris Kontos,1985-86,22.0,4,12,28,28,4,8,12,51.0,,78,12,16,28,115.0,80,7.77,71,321,2447,12.7,0.41140854
4777,4777,Chris Kontos,1987-88,24.0,5,17,31,31,8,9,17,38.0,,109,20,25,45,153.0,80,7.34,72,344,2400,12.2,0.44170883
4778,4778,Chris Kontos,1988-89,25.0,6,20,42,42,3,17,20,36.0,,151,23,42,65,189.0,80,7.43,89,437,2435,12.2,0.37260926
4779,4779,Chris Kontos,1989-90,26.0,7,3,7,7,2,1,3,9.0,,158,25,43,68,198.0,80,7.48,85,403,2430,12.3,0.33453268
4780,4780,Chris Kontos,1990-91,27.0,8,4,6,6,2,2,4,9.0,,164,27,45,72,207.0,80,7.37,76,367,2421,12.2,0.3659952
4781,4781,Chris Kontos,1993-94,30.0,9,51,66,66,27,24,51,136.0,,230,54,69,123,343.0,84,7.25,87,443,2603,11.7,0.6067121
4782,4782,Chris Kotsopoulos,1981-82,23.0,2,16,54,54,4,12,16,104.0,,54,4,12,16,104.0,80,7.69,77,340,2441,12.6,0.39190364
4783,4783,Chris Kotsopoulos,1982-83,24.0,3,33,68,68,13,20,33,152.0,,122,17,32,49,256.0,80,8.03,73,320,2489,12.9,0.47656214
4784,4784,Chris Kotsopoulos,1983-84,25.0,4,30,68,68,6,24,30,122.0,,190,23,56,79,378.0,80,7.73,71,310,2444,12.7,0.44426593
4785,4785,Chris Kotsopoulos,1984-85,26.0,5,18,72,72,5,13,18,96.0,,262,28,69,97,474.0,80,7.89,74,336,2448,12.9,0.3117299
4786,4786,Chris Kotsopoulos,1985-86,27.0,6,8,33,33,5,3,8,42.0,,295,33,72,105,516.0,80,7.77,71,321,2447,12.7,0.3078701
4787,4787,Chris Kotsopoulos,1986-87,28.0,7,17,61,61,6,11,17,69.0,,356,39,83,122,585.0,80,7.94,82,370,2484,12.8,0.30539
4788,4788,Chris Kotsopoulos,1987-88,29.0,8,12,43,43,2,10,12,43.0,,399,41,93,134,628.0,80,7.34,72,344,2400,12.2,0.25214437
4789,4789,Chris Kotsopoulos,1988-89,30.0,9,4,21,21,2,2,4,22.0,,420,43,95,138,650.0,80,7.43,89,437,2435,12.2,0.2312406
4790,4790,Chris Kotsopoulos,1989-90,31.0,10,15,57,57,1,14,15,66.0,,477,44,109,153,716.0,80,7.48,85,403,2430,12.3,0.22041789
4791,4791,Chris Kotsopoulos,1990-91,32.0,11,0,2,2,0,0,0,0.0,,479,44,109,153,716.0,80,7.37,76,367,2421,12.2,0.32799414
4792,4792,Chris Kreider,2013-14,22.0,2,3,23,23,2,1,3,19.0,233.0,23,2,1,3,19.0,48,5.31,29,160,1399,9.1,0.26250803
4793,4793,Chris Kreider,2014-15,23.0,3,37,66,66,17,20,37,136.0,1038.0,89,19,21,40,155.0,82,5.34,48,269,2463,8.9,0.5330095
4794,4794,Chris Kreider,2015-16,24.0,4,46,80,80,21,25,46,180.0,1257.0,169,40,46,86,335.0,82,5.32,47,251,2453,8.9,0.5681055
4795,4795,Chris Kreider,2016-17,25.0,5,43,79,79,21,22,43,158.0,1261.0,248,61,68,129,493.0,82,5.34,48,255,2438,9.0,0.54360396
4796,4796,Chris Kreider,2017-18,26.0,6,53,75,75,28,25,53,186.0,1275.0,323,89,93,182,679.0,82,5.45,47,245,2478,9.0,0.68094677
4797,4797,Chris Kreider,2018-19,27.0,7,37,58,58,16,21,37,137.0,906.0,381,105,114,219,816.0,82,5.86,50,250,2620,9.2,0.6172831
4798,4798,Chris Kreider,2019-20,28.0,8,52,79,79,28,24,52,201.0,1375.0,460,133,138,271,1017.0,82,5.96,47,239,2579,9.5,0.6113395
4799,4799,Chris Kreider,2020-21,29.0,9,45,63,63,24,21,45,156.0,1087.0,523,157,159,316,1173.0,70,5.96,42,208,2192,9.5,0.6527656
4800,4800,Chris Kunitz,2004-05,25.0,2,6,21,21,0,6,6,31.0,191.0,21,0,6,6,31.0,82,5.14,57,348,2300,9.2,0.2291663
4801,4801,Chris Kunitz,2006-07,27.0,3,41,69,69,19,22,41,149.0,959.0,90,19,28,47,180.0,82,6.05,85,480,2458,10.1,0.53219396
4802,4802,Chris Kunitz,2007-08,28.0,4,60,81,81,25,35,60,180.0,1381.0,171,44,63,107,360.0,82,5.76,70,398,2426,9.7,0.64173925
4803,4803,Chris Kunitz,2008-09,29.0,5,50,82,82,21,29,50,196.0,1386.0,253,65,92,157,556.0,82,5.44,62,351,2383,9.4,0.5988035
4804,4804,Chris Kunitz,2009-10,30.0,6,53,82,82,23,30,53,178.0,1348.0,335,88,122,210,734.0,82,5.7,65,341,2477,9.4,0.5817043
4805,4805,Chris Kunitz,2010-11,31.0,7,32,50,50,13,19,32,131.0,822.0,385,101,141,242,865.0,82,5.53,56,304,2486,9.1,0.59565705
4806,4806,Chris Kunitz,2011-12,32.0,8,48,66,66,23,25,48,133.0,1206.0,451,124,166,290,998.0,82,5.46,52,291,2492,9.0,0.62392485
4807,4807,Chris Kunitz,2012-13,33.0,9,61,82,82,26,35,61,230.0,1502.0,533,150,201,351,1228.0,82,5.32,47,271,2439,8.9,0.73302794
4808,4808,Chris Kunitz,2013-14,34.0,10,52,48,48,22,30,52,113.0,865.0,581,172,231,403,1341.0,48,5.31,29,160,1399,9.1,0.8607391
4809,4809,Chris Kunitz,2014-15,35.0,11,68,78,78,35,33,68,218.0,1494.0,659,207,264,471,1559.0,82,5.34,48,269,2463,8.9,0.68120396
4810,4810,Chris Kunitz,2015-16,36.0,12,40,74,74,17,23,40,170.0,1324.0,733,224,287,511,1729.0,82,5.32,47,251,2453,8.9,0.49604252
4811,4811,Chris Kunitz,2016-17,37.0,13,40,80,80,17,23,40,150.0,1346.0,813,241,310,551,1879.0,82,5.34,48,255,2438,9.0,0.4720268
4812,4812,Chris Kunitz,2017-18,38.0,14,29,71,71,9,20,29,134.0,1101.0,884,250,330,580,2013.0,82,5.45,47,245,2478,9.0,0.35584894
4813,4813,Chris Kunitz,2018-19,39.0,15,29,82,82,13,16,29,81.0,980.0,966,263,346,609,2094.0,82,5.86,50,250,2620,9.2,0.30077684
4814,4814,Chris Kunitz,2019-20,40.0,16,10,56,56,5,5,10,44.0,507.0,1022,268,351,619,2138.0,82,5.96,47,239,2579,9.5,0.2273086
4815,4815,Chris Langevin,1984-85,25.0,2,1,6,6,1,0,1,4.0,,6,1,0,1,4.0,80,7.89,74,336,2448,12.9,0.25881976
4816,4816,Chris Langevin,1986-87,27.0,3,3,16,16,2,1,3,10.0,,22,3,1,4,14.0,80,7.94,82,370,2484,12.8,0.26161236
4817,4817,Chris Lindberg,1992-93,25.0,2,7,17,17,2,5,7,19.0,,17,2,5,7,19.0,80,6.96,77,402,2440,11.4,0.3151583
4818,4818,Chris Lindberg,1993-94,26.0,3,21,62,62,9,12,21,74.0,,79,11,17,28,93.0,84,7.25,87,443,2603,11.7,0.31295723
4819,4819,Chris Lindberg,1994-95,27.0,4,14,37,37,6,8,14,42.0,,116,17,25,42,135.0,84,6.48,76,407,2545,10.7,0.29207528
4820,4820,Chris Lipuma,1993-94,22.0,2,5,15,15,0,5,5,17.0,,15,0,5,5,17.0,84,7.25,87,443,2603,11.7,0.2332451
4821,4821,Chris Lipuma,1994-95,23.0,3,4,27,27,0,4,4,20.0,,42,0,9,9,37.0,84,6.48,76,407,2545,10.7,0.17708203
4822,4822,Chris Lipuma,1995-96,24.0,4,0,1,1,0,0,0,1.0,,43,0,9,9,38.0,48,5.97,37,209,1408,10.2,0.17444438
4823,4823,Chris Lipuma,1996-97,25.0,5,0,21,21,0,0,0,8.0,,64,0,9,9,46.0,82,6.29,74,413,2481,10.4,0.10700694
4824,4824,Chris Lipuma,1997-98,26.0,6,0,8,8,0,0,0,4.0,,72,0,9,9,50.0,82,5.83,55,336,2444,9.8,0.13658318
4825,4825,Chris Luongo,1991-92,24.0,2,1,4,4,0,1,1,4.0,,4,0,1,1,4.0,80,6.91,71,366,2385,11.6,0.21625996
4826,4826,Chris Luongo,1993-94,26.0,3,12,76,76,3,9,12,76.0,,80,3,10,13,80.0,84,7.25,87,443,2603,11.7,0.20398587
4827,4827,Chris Luongo,1994-95,27.0,4,4,17,17,1,3,4,16.0,,97,4,13,17,96.0,84,6.48,76,407,2545,10.7,0.193153
4828,4828,Chris Luongo,1995-96,28.0,5,4,47,47,1,3,4,44.0,,144,5,16,21,140.0,48,5.97,37,209,1408,10.2,0.14712533
4829,4829,Chris Luongo,1996-97,29.0,6,10,74,74,3,7,10,46.0,,218,8,23,31,186.0,82,6.29,74,413,2481,10.4,0.15235466
4830,4830,Chris Marinucci,1995-96,24.0,2,5,12,12,1,4,5,11.0,,12,1,4,5,11.0,48,5.97,37,209,1408,10.2,0.2550617
4831,4831,Chris Marinucci,1997-98,26.0,3,0,1,1,0,0,0,1.0,,13,1,4,5,12.0,82,5.83,55,336,2444,9.8,0.15511805
4832,4832,Chris McAllister,1998-99,23.0,2,3,36,36,1,2,3,15.0,,36,1,2,3,15.0,82,5.28,57,380,2242,9.6,0.16012964
4833,4833,Chris McAllister,1999-00,24.0,3,4,48,48,1,3,4,18.0,444.0,84,2,5,7,33.0,82,5.27,57,359,2285,9.4,0.117898494
4834,4834,Chris McAllister,2000-01,25.0,4,3,36,36,0,3,3,12.0,433.0,120,2,8,10,45.0,82,5.49,53,331,2294,9.8,0.099095166
4835,4835,Chris McAllister,2001-02,26.0,5,4,60,60,2,2,4,33.0,696.0,180,4,10,14,78.0,82,5.51,63,376,2272,9.9,0.12663671
4836,4836,Chris McAllister,2002-03,27.0,6,5,42,42,0,5,5,26.0,386.0,222,4,15,19,104.0,82,5.24,53,338,2262,9.5,0.098793566
4837,4837,Chris McAllister,2003-04,28.0,7,1,33,33,0,1,1,13.0,294.0,255,4,16,20,117.0,82,5.31,60,363,2326,9.4,0.097842515
4838,4838,Chris McAllister,2004-05,29.0,8,1,46,46,0,1,1,19.0,343.0,301,4,17,21,136.0,82,5.14,57,348,2300,9.2,0.10218519
4839,4839,Chris McAlpine,1995-96,24.0,2,3,24,24,0,3,3,19.0,,24,0,3,3,19.0,48,5.97,37,209,1408,10.2,0.16742045
4840,4840,Chris McAlpine,1997-98,26.0,3,0,15,15,0,0,0,3.0,,39,0,3,3,22.0,82,5.83,55,336,2444,9.8,0.13173026
4841,4841,Chris McAlpine,1998-99,27.0,4,10,54,54,3,7,10,35.0,,93,3,10,13,57.0,82,5.28,57,380,2242,9.6,0.16611326
4842,4842,Chris McAlpine,1999-00,28.0,5,2,51,51,1,1,2,56.0,655.0,144,4,11,15,113.0,82,5.27,57,359,2285,9.4,0.13497153
4843,4843,Chris McAlpine,2000-01,29.0,6,4,34,34,2,2,4,34.0,488.0,178,6,13,19,147.0,82,5.49,53,331,2294,9.8,0.15513387
4844,4844,Chris McAlpine,2001-02,30.0,7,6,50,50,0,6,6,61.0,884.0,228,6,19,25,208.0,82,5.51,63,376,2272,9.9,0.12529805
4845,4845,Chris McAlpine,2002-03,31.0,8,3,40,40,0,3,3,40.0,614.0,268,6,22,28,248.0,82,5.24,53,338,2262,9.5,0.11619547
4846,4846,Chris McAlpine,2003-04,32.0,9,2,21,21,0,2,2,15.0,267.0,289,6,24,30,263.0,82,5.31,60,363,2326,9.4,0.09587464
4847,4847,Chris McRae,1988-89,23.0,2,0,11,11,0,0,0,0.0,,11,0,0,0,0.0,80,7.43,89,437,2435,12.2,0.16935381
4848,4848,Chris McRae,1989-90,24.0,3,0,3,3,0,0,0,0.0,,14,0,0,0,0.0,80,7.48,85,403,2430,12.3,0.15589839
4849,4849,Chris McRae,1990-91,25.0,4,1,7,7,1,0,1,1.0,,21,1,0,1,1.0,80,7.37,76,367,2421,12.2,0.20796764
4850,4850,Chris Minard,2008-09,27.0,2,2,15,15,1,1,2,9.0,58.0,15,1,1,2,9.0,82,5.44,62,351,2383,9.4,0.19888419
4851,4851,Chris Minard,2009-10,28.0,3,3,20,20,1,2,3,33.0,188.0,35,2,3,5,42.0,82,5.7,65,341,2477,9.4,0.1895543
4852,4852,Chris Minard,2010-11,29.0,4,1,5,5,0,1,1,4.0,49.0,40,2,4,6,46.0,82,5.53,56,304,2486,9.1,0.13661078
4853,4853,Chris Mueller,2011-12,25.0,2,3,15,15,0,3,3,7.0,130.0,15,0,3,3,7.0,82,5.46,52,291,2492,9.0,0.16516423
4854,4854,Chris Mueller,2012-13,26.0,3,0,4,4,0,0,0,4.0,37.0,19,0,3,3,11.0,82,5.32,47,271,2439,8.9,0.14952618
4855,4855,Chris Mueller,2013-14,27.0,4,5,18,18,2,3,5,22.0,193.0,37,2,6,8,33.0,48,5.31,29,160,1399,9.1,0.2371993
4856,4856,Chris Mueller,2014-15,28.0,5,0,9,9,0,0,0,8.0,83.0,46,2,6,8,41.0,82,5.34,48,269,2463,8.9,0.1341478
4857,4857,Chris Mueller,2015-16,29.0,6,2,7,7,1,1,2,10.0,73.0,53,3,7,10,51.0,82,5.32,47,251,2453,8.9,0.16176108
4858,4858,Chris Murray,1995-96,21.0,2,0,3,3,0,0,0,0.0,,3,0,0,0,0.0,48,5.97,37,209,1408,10.2,0.19404134
4859,4859,Chris Murray,1996-97,22.0,3,7,48,48,3,4,7,32.0,,51,3,4,7,32.0,82,6.29,74,413,2481,10.4,0.19057974
4860,4860,Chris Murray,1997-98,23.0,4,8,64,64,5,3,8,41.0,,115,8,7,15,73.0,82,5.83,55,336,2444,9.8,0.21572265
4861,4861,Chris Murray,1998-99,24.0,5,9,53,53,5,4,9,51.0,,168,13,11,24,124.0,82,5.28,57,380,2242,9.6,0.18669423
4862,4862,Chris Murray,1999-00,25.0,6,7,42,42,1,6,7,37.0,299.0,210,14,17,31,161.0,82,5.27,57,359,2285,9.4,0.15593806
4863,4863,Chris Murray,2000-01,26.0,7,3,32,32,2,1,3,25.0,170.0,242,16,18,34,186.0,82,5.49,53,331,2294,9.8,0.1844829
4864,4864,Chris Neil,2002-03,23.0,2,17,72,72,10,7,17,56.0,602.0,72,10,7,17,56.0,82,5.24,53,338,2262,9.5,0.24521908
4865,4865,Chris Neil,2003-04,24.0,3,10,68,68,6,4,10,62.0,521.0,140,16,11,27,118.0,82,5.31,60,363,2326,9.4,0.1951837
4866,4866,Chris Neil,2004-05,25.0,4,16,82,82,8,8,16,76.0,726.0,222,24,19,43,194.0,82,5.14,57,348,2300,9.2,0.25654662
4867,4867,Chris Neil,2006-07,27.0,5,33,79,79,16,17,33,126.0,972.0,301,40,36,76,320.0,82,6.05,85,480,2458,10.1,0.39448765
4868,4868,Chris Neil,2007-08,28.0,6,28,82,82,12,16,28,139.0,1076.0,383,52,52,104,459.0,82,5.76,70,398,2426,9.7,0.34780717
4869,4869,Chris Neil,2008-09,29.0,7,20,68,68,6,14,20,78.0,868.0,451,58,66,124,537.0,82,5.44,62,351,2383,9.4,0.2772193
4870,4870,Chris Neil,2009-10,30.0,8,10,60,60,3,7,10,59.0,658.0,511,61,73,134,596.0,82,5.7,65,341,2477,9.4,0.2234182
4871,4871,Chris Neil,2010-11,31.0,9,22,68,68,10,12,22,100.0,815.0,579,71,85,156,696.0,82,5.53,56,304,2486,9.1,0.2868902
4872,4872,Chris Neil,2011-12,32.0,10,16,80,80,6,10,16,105.0,1021.0,659,77,95,172,801.0,82,5.46,52,291,2492,9.0,0.23880747
4873,4873,Chris Neil,2012-13,33.0,11,28,72,72,13,15,28,127.0,921.0,731,90,110,200,928.0,82,5.32,47,271,2439,8.9,0.31214458
4874,4874,Chris Neil,2013-14,34.0,12,12,48,48,4,8,12,87.0,665.0,779,94,118,212,1015.0,48,5.31,29,160,1399,9.1,0.2612852
4875,4875,Chris Neil,2014-15,35.0,13,14,76,76,8,6,14,99.0,897.0,855,102,124,226,1114.0,82,5.34,48,269,2463,8.9,0.18417019
4876,4876,Chris Neil,2015-16,36.0,14,7,38,38,4,3,7,23.0,370.0,893,106,127,233,1137.0,82,5.32,47,251,2453,8.9,0.1623992
4877,4877,Chris Neil,2016-17,37.0,15,13,80,80,5,8,13,70.0,744.0,973,111,135,246,1207.0,82,5.34,48,255,2438,9.0,0.1513052
4878,4878,Chris Neil,2017-18,38.0,16,4,53,53,1,3,4,42.0,401.0,1026,112,138,250,1249.0,82,5.45,47,245,2478,9.0,0.133497
4879,4879,Chris Nielsen,2001-02,21.0,2,9,29,29,4,5,9,36.0,305.0,29,4,5,9,36.0,82,5.51,63,376,2272,9.9,0.2959375
4880,4880,Chris Nielsen,2002-03,22.0,3,5,23,23,2,3,5,28.0,248.0,52,6,8,14,64.0,82,5.24,53,338,2262,9.5,0.26522344
4881,4881,Chris Nilan,1980-81,22.0,2,2,15,15,0,2,2,8.0,,15,0,2,2,8.0,80,7.03,61,280,2352,12.0,0.23531872
4882,4882,Chris Nilan,1981-82,23.0,3,15,57,57,7,8,15,69.0,,72,7,10,17,77.0,80,7.69,77,340,2441,12.6,0.3052553
4883,4883,Chris Nilan,1982-83,24.0,4,11,49,49,7,4,11,45.0,,121,14,14,28,122.0,80,8.03,73,320,2489,12.9,0.30541736
4884,4884,Chris Nilan,1983-84,25.0,5,14,66,66,6,8,14,67.0,,187,20,22,42,189.0,80,7.73,71,310,2444,12.7,0.2752261
4885,4885,Chris Nilan,1984-85,26.0,6,26,76,76,16,10,26,98.0,,263,36,32,68,287.0,80,7.89,74,336,2448,12.9,0.37618423
4886,4886,Chris Nilan,1985-86,27.0,7,37,77,77,21,16,37,98.0,,340,57,48,105,385.0,80,7.77,71,321,2447,12.7,0.43857387
4887,4887,Chris Nilan,1986-87,28.0,8,34,72,72,19,15,34,120.0,,412,76,63,139,505.0,80,7.94,82,370,2484,12.8,0.38689685
4888,4888,Chris Nilan,1987-88,29.0,9,20,44,44,4,16,20,68.0,,456,80,79,159,573.0,80,7.34,72,344,2400,12.2,0.3696924
4889,4889,Chris Nilan,1988-89,30.0,10,20,72,72,10,10,20,88.0,,528,90,89,179,661.0,80,7.43,89,437,2435,12.2,0.27967805
4890,4890,Chris Nilan,1989-90,31.0,11,14,38,38,7,7,14,39.0,,566,97,96,193,700.0,80,7.48,85,403,2430,12.3,0.30448908
4891,4891,Chris Nilan,1990-91,32.0,12,3,25,25,1,2,3,24.0,,591,98,98,196,724.0,80,7.37,76,367,2421,12.2,0.24588913
4892,4892,Chris Nilan,1991-92,33.0,13,15,41,41,6,9,15,41.0,,632,104,107,211,765.0,80,6.91,71,366,2385,11.6,0.31821245
4893,4893,Chris Nilan,1992-93,34.0,14,14,56,56,6,8,14,55.0,,688,110,115,225,820.0,80,6.96,77,402,2440,11.4,0.2572896
4894,4894,Chris O'Sullivan,1997-98,23.0,2,10,27,27,2,8,10,41.0,,27,2,8,10,41.0,82,5.83,55,336,2444,9.8,0.26498502
4895,4895,Chris O'Sullivan,1998-99,24.0,3,2,12,12,0,2,2,12.0,,39,2,10,12,53.0,82,5.28,57,380,2242,9.6,0.18489593
4896,4896,Chris O'Sullivan,1999-00,25.0,4,1,10,10,0,1,1,10.0,91.0,49,2,11,13,63.0,82,5.27,57,359,2285,9.4,0.17630604
4897,4897,Chris O'Sullivan,2000-01,26.0,5,5,11,11,0,5,5,16.0,196.0,60,2,16,18,79.0,82,5.49,53,331,2294,9.8,0.19262263
4898,4898,Chris O'Sullivan,2003-04,29.0,6,1,2,2,0,1,1,3.0,26.0,62,2,17,19,82.0,82,5.31,60,363,2326,9.4,0.16596243
4899,4899,Chris Phillips,1998-99,20.0,2,16,72,72,5,11,16,107.0,,72,5,11,16,107.0,82,5.28,57,380,2242,9.6,0.3140459
4900,4900,Chris Phillips,1999-00,21.0,3,6,34,34,3,3,6,51.0,615.0,106,8,14,22,158.0,82,5.27,57,359,2285,9.4,0.30885857
4901,4901,Chris Phillips,2000-01,22.0,4,19,65,65,5,14,19,96.0,1094.0,171,13,28,41,254.0,82,5.49,53,331,2294,9.8,0.2987917
4902,4902,Chris Phillips,2001-02,23.0,5,14,73,73,2,12,14,77.0,1567.0,244,15,40,55,331.0,82,5.51,63,376,2272,9.9,0.25613427
4903,4903,Chris Phillips,2002-03,24.0,6,22,63,63,6,16,22,103.0,1229.0,307,21,56,77,434.0,82,5.24,53,338,2262,9.5,0.33419678
4904,4904,Chris Phillips,2003-04,25.0,7,19,78,78,3,16,19,97.0,1577.0,385,24,72,96,531.0,82,5.31,60,363,2326,9.4,0.2637667
4905,4905,Chris Phillips,2004-05,26.0,8,23,82,82,7,16,23,93.0,1709.0,467,31,88,119,624.0,82,5.14,57,348,2300,9.2,0.3280359
4906,4906,Chris Phillips,2006-07,28.0,9,19,69,69,1,18,19,79.0,1440.0,536,32,106,138,703.0,82,6.05,85,480,2458,10.1,0.24361312
4907,4907,Chris Phillips,2007-08,29.0,10,26,82,82,8,18,26,94.0,1833.0,618,40,124,164,797.0,82,5.76,70,398,2426,9.7,0.2920822
4908,4908,Chris Phillips,2008-09,30.0,11,18,81,81,5,13,18,80.0,1821.0,699,45,137,182,877.0,82,5.44,62,351,2383,9.4,0.2354613
4909,4909,Chris Phillips,2009-10,31.0,12,22,82,82,6,16,22,88.0,1793.0,781,51,153,204,965.0,82,5.7,65,341,2477,9.4,0.2452186
4910,4910,Chris Phillips,2010-11,32.0,13,24,82,82,8,16,24,82.0,1833.0,863,59,169,228,1047.0,82,5.53,56,304,2486,9.1,0.24708223
4911,4911,Chris Phillips,2011-12,33.0,14,9,82,82,1,8,9,81.0,1765.0,945,60,177,237,1128.0,82,5.46,52,291,2492,9.0,0.16264099
4912,4912,Chris Phillips,2012-13,34.0,15,19,80,80,5,14,19,85.0,1529.0,1025,65,191,256,1213.0,82,5.32,47,271,2439,8.9,0.20568231
4913,4913,Chris Phillips,2013-14,35.0,16,14,48,48,5,9,14,89.0,1010.0,1073,70,200,270,1302.0,48,5.31,29,160,1399,9.1,0.26165354
4914,4914,Chris Phillips,2014-15,36.0,17,15,70,70,1,14,15,90.0,1346.0,1143,71,214,285,1392.0,82,5.34,48,269,2463,8.9,0.19087857
4915,4915,Chris Phillips,2015-16,37.0,18,3,36,36,0,3,3,29.0,752.0,1179,71,217,288,1421.0,82,5.32,47,251,2453,8.9,0.14171016
4916,4916,Chris Porter,2009-10,25.0,2,2,6,6,1,1,2,7.0,63.0,6,1,1,2,7.0,82,5.7,65,341,2477,9.4,0.20802072
4917,4917,Chris Porter,2011-12,27.0,3,7,45,45,3,4,7,55.0,467.0,51,4,5,9,62.0,82,5.46,52,291,2492,9.0,0.15647018
4918,4918,Chris Porter,2012-13,28.0,4,7,47,47,4,3,7,61.0,488.0,98,8,8,16,123.0,82,5.32,47,271,2439,8.9,0.1767137
4919,4919,Chris Porter,2013-14,29.0,5,8,29,29,2,6,8,46.0,337.0,127,10,14,24,169.0,48,5.31,29,160,1399,9.1,0.23262373
4920,4920,Chris Porter,2014-15,30.0,6,1,22,22,0,1,1,24.0,228.0,149,10,15,25,193.0,82,5.34,48,269,2463,8.9,0.13139677
4921,4921,Chris Porter,2015-16,31.0,7,2,24,24,1,1,2,24.0,229.0,173,11,16,27,217.0,82,5.32,47,251,2453,8.9,0.13474494
4922,4922,Chris Porter,2016-17,32.0,8,7,61,61,4,3,7,45.0,588.0,234,15,19,34,262.0,82,5.34,48,255,2438,9.0,0.12150025
4923,4923,Chris Pronger,1994-95,20.0,2,30,81,81,5,25,30,174.0,,81,5,25,30,174.0,84,6.48,76,407,2545,10.7,0.45066687
4924,4924,Chris Pronger,1995-96,21.0,3,14,43,43,5,9,14,94.0,,124,10,34,44,268.0,48,5.97,37,209,1408,10.2,0.3969779
4925,4925,Chris Pronger,1996-97,22.0,4,25,78,78,7,18,25,138.0,,202,17,52,69,406.0,82,6.29,74,413,2481,10.4,0.3740577
4926,4926,Chris Pronger,1997-98,23.0,5,35,79,79,11,24,35,147.0,,281,28,76,104,553.0,82,5.83,55,336,2444,9.8,0.44381052
4927,4927,Chris Pronger,1998-99,24.0,6,36,81,81,9,27,36,145.0,,362,37,103,140,698.0,82,5.28,57,380,2242,9.6,0.48891428
4928,4928,Chris Pronger,1999-00,25.0,7,46,67,67,13,33,46,172.0,2050.0,429,50,136,186,870.0,82,5.27,57,359,2285,9.4,0.62002903
4929,4929,Chris Pronger,2000-01,26.0,8,62,79,79,14,48,62,192.0,2389.0,508,64,184,248,1062.0,82,5.49,53,331,2294,9.8,0.74386024
4930,4930,Chris Pronger,2001-02,27.0,9,47,51,51,8,39,47,121.0,1415.0,559,72,223,295,1183.0,82,5.51,63,376,2272,9.9,0.75444186
4931,4931,Chris Pronger,2002-03,28.0,10,47,78,78,7,40,47,204.0,2299.0,637,79,263,342,1387.0,82,5.24,53,338,2262,9.5,0.5943639
4932,4932,Chris Pronger,2003-04,29.0,11,4,5,5,1,3,4,11.0,108.0,642,80,266,346,1398.0,82,5.31,60,363,2326,9.4,0.34080017
4933,4933,Chris Pronger,2004-05,30.0,12,54,80,80,14,40,54,203.0,2197.0,722,94,306,400,1601.0,82,5.14,57,348,2300,9.2,0.743839
4934,4934,Chris Pronger,2006-07,32.0,13,56,80,80,12,44,56,155.0,2239.0,802,106,350,456,1756.0,82,6.05,85,480,2458,10.1,0.61685944
4935,4935,Chris Pronger,2007-08,33.0,14,59,66,66,13,46,59,166.0,1789.0,868,119,396,515,1922.0,82,5.76,70,398,2426,9.7,0.733218
4936,4936,Chris Pronger,2008-09,34.0,15,43,72,72,12,31,43,182.0,1872.0,940,131,427,558,2104.0,82,5.44,62,351,2383,9.4,0.5418927
4937,4937,Chris Pronger,2009-10,35.0,16,48,82,82,11,37,48,196.0,2209.0,1022,142,464,606,2300.0,82,5.7,65,341,2477,9.4,0.5594512
4938,4938,Chris Pronger,2010-11,36.0,17,55,82,82,10,45,55,175.0,2126.0,1104,152,509,661,2475.0,82,5.53,56,304,2486,9.1,0.585981
4939,4939,Chris Pronger,2011-12,37.0,18,25,50,50,4,21,25,112.0,1125.0,1154,156,530,686,2587.0,82,5.46,52,291,2492,9.0,0.4581163
4940,4940,Chris Pronger,2012-13,38.0,19,12,13,13,1,11,12,23.0,292.0,1167,157,541,698,2610.0,82,5.32,47,271,2439,8.9,0.38151067
4941,4941,Chris Pryor,1985-86,25.0,2,0,4,4,0,0,0,2.0,,4,0,0,0,2.0,80,7.77,71,321,2447,12.7,0.21756122
4942,4942,Chris Pryor,1986-87,26.0,3,1,7,7,0,1,1,8.0,,11,0,1,1,10.0,80,7.94,82,370,2484,12.8,0.1996639
4943,4943,Chris Pryor,1987-88,27.0,4,4,50,50,1,3,4,20.0,,61,1,4,5,30.0,80,7.34,72,344,2400,12.2,0.12643054
4944,4944,Chris Pryor,1988-89,28.0,5,0,4,4,0,0,0,4.0,,65,1,4,5,34.0,80,7.43,89,437,2435,12.2,0.14333582
4945,4945,Chris Pryor,1989-90,29.0,6,0,7,7,0,0,0,2.0,,72,1,4,5,36.0,80,7.48,85,403,2430,12.3,0.13667098
4946,4946,Chris Pryor,1990-91,30.0,7,0,10,10,0,0,0,2.0,,82,1,4,5,38.0,80,7.37,76,367,2421,12.2,0.12277171
4947,4947,Chris Schmidt,2003-04,27.0,2,2,10,10,0,2,2,10.0,100.0,10,0,2,2,10.0,82,5.31,60,363,2326,9.4,0.19933206
4948,4948,Chris Simon,1993-94,22.0,2,2,16,16,1,1,2,15.0,,16,1,1,2,15.0,84,7.25,87,443,2603,11.7,0.24650767
4949,4949,Chris Simon,1994-95,23.0,3,8,37,37,4,4,8,39.0,,53,5,5,10,54.0,84,6.48,76,407,2545,10.7,0.25203222
4950,4950,Chris Simon,1995-96,24.0,4,12,29,29,3,9,12,33.0,,82,8,14,22,87.0,48,5.97,37,209,1408,10.2,0.31910717
4951,4951,Chris Simon,1996-97,25.0,5,34,64,64,16,18,34,105.0,,146,24,32,56,192.0,82,6.29,74,413,2481,10.4,0.44240224
4952,4952,Chris Simon,1997-98,26.0,6,22,42,42,9,13,22,89.0,,188,33,45,78,281.0,82,5.83,55,336,2444,9.8,0.42067915
4953,4953,Chris Simon,1998-99,27.0,7,17,28,28,7,10,17,71.0,,216,40,55,95,352.0,82,5.28,57,380,2242,9.6,0.40924284
4954,4954,Chris Simon,1999-00,28.0,8,10,23,23,3,7,10,29.0,279.0,239,43,62,105,381.0,82,5.27,57,359,2285,9.4,0.32683104
4955,4955,Chris Simon,2000-01,29.0,9,49,75,75,29,20,49,201.0,1165.0,314,72,82,154,582.0,82,5.49,53,331,2294,9.8,0.60983294
4956,4956,Chris Simon,2001-02,30.0,10,20,60,60,10,10,20,123.0,874.0,374,82,92,174,705.0,82,5.51,63,376,2272,9.9,0.3391043
4957,4957,Chris Simon,2002-03,31.0,11,31,82,82,14,17,31,121.0,1000.0,456,96,109,205,826.0,82,5.24,53,338,2262,9.5,0.36080745
4958,4958,Chris Simon,2003-04,32.0,12,20,71,71,12,8,20,88.0,765.0,527,108,117,225,914.0,82,5.31,60,363,2326,9.4,0.28326434
4959,4959,Chris Simon,2004-05,33.0,13,28,78,78,17,11,28,147.0,992.0,605,125,128,253,1061.0,82,5.14,57,348,2300,9.2,0.39629155
4960,4960,Chris Simon,2006-07,35.0,14,22,72,72,8,14,22,76.0,751.0,677,133,142,275,1137.0,82,6.05,85,480,2458,10.1,0.24144137
4961,4961,Chris Simon,2007-08,36.0,15,27,67,67,10,17,27,82.0,737.0,744,143,159,302,1219.0,82,5.76,70,398,2426,9.7,0.2576326
4962,4962,Chris Simon,2008-09,37.0,16,3,38,38,1,2,3,27.0,273.0,782,144,161,305,1246.0,82,5.44,62,351,2383,9.4,0.14325169
4963,4963,Chris Snell,1994-95,23.0,2,0,2,2,0,0,0,4.0,,2,0,0,0,4.0,84,6.48,76,407,2545,10.7,0.18269011
4964,4964,Chris Snell,1995-96,24.0,3,9,32,32,2,7,9,45.0,,34,2,7,9,49.0,48,5.97,37,209,1408,10.2,0.26167607
4965,4965,Chris Stewart,2009-10,22.0,2,19,53,53,11,8,19,98.0,653.0,53,11,8,19,98.0,82,5.7,65,341,2477,9.4,0.42956436
4966,4966,Chris Stewart,2010-11,23.0,3,64,77,77,28,36,64,221.0,1286.0,130,39,44,83,319.0,82,5.53,56,304,2486,9.1,0.74528635
4967,4967,Chris Stewart,2011-12,24.0,4,53,62,62,28,25,53,162.0,1084.0,192,67,69,136,481.0,82,5.46,52,291,2492,9.0,0.7706176
4968,4968,Chris Stewart,2012-13,25.0,5,30,79,79,15,15,30,166.0,1220.0,271,82,84,166,647.0,82,5.32,47,271,2439,8.9,0.51209015
4969,4969,Chris Stewart,2013-14,26.0,6,36,48,48,18,18,36,97.0,759.0,319,100,102,202,744.0,48,5.31,29,160,1399,9.1,0.6706069
4970,4970,Chris Stewart,2014-15,27.0,7,26,63,63,15,11,26,110.0,862.0,382,115,113,228,854.0,82,5.34,48,269,2463,8.9,0.45622227
4971,4971,Chris Stewart,2015-16,28.0,8,36,81,81,14,22,36,155.0,1286.0,463,129,135,264,1009.0,82,5.32,47,251,2453,8.9,0.46188244
4972,4972,Chris Stewart,2016-17,29.0,9,20,56,56,8,12,20,78.0,605.0,519,137,147,284,1087.0,82,5.34,48,255,2438,9.0,0.41172957
4973,4973,Chris Stewart,2017-18,30.0,10,21,79,79,13,8,21,82.0,821.0,598,150,155,305,1169.0,82,5.45,47,245,2478,9.0,0.31313193
4974,4974,Chris Stewart,2018-19,31.0,11,16,54,54,10,6,16,68.0,580.0,652,160,161,321,1237.0,82,5.86,50,250,2620,9.2,0.30672595
4975,4975,Chris Stewart,2020-21,33.0,12,1,16,16,0,1,1,5.0,124.0,668,160,162,322,1242.0,70,5.96,42,208,2192,9.5,0.19010907
4976,4976,Chris Summers,2011-12,23.0,2,0,2,2,0,0,0,0.0,28.0,2,0,0,0,0.0,82,5.46,52,291,2492,9.0,0.15535027
4977,4977,Chris Summers,2012-13,24.0,3,3,21,21,0,3,3,10.0,261.0,23,0,3,3,10.0,82,5.32,47,271,2439,8.9,0.11864981
4978,4978,Chris Summers,2013-14,25.0,4,0,6,6,0,0,0,5.0,76.0,29,0,3,3,15.0,48,5.31,29,160,1399,9.1,0.16964856
4979,4979,Chris Summers,2014-15,26.0,5,3,18,18,2,1,3,17.0,269.0,47,2,4,6,32.0,82,5.34,48,269,2463,8.9,0.18917331
4980,4980,Chris Summers,2015-16,27.0,6,3,20,20,0,3,3,15.0,285.0,67,2,7,9,47.0,82,5.32,47,251,2453,8.9,0.11853379
4981,4981,Chris Summers,2016-17,28.0,7,0,3,3,0,0,0,5.0,46.0,70,2,7,9,52.0,82,5.34,48,255,2438,9.0,0.12950417
4982,4982,Chris Tamer,1994-95,24.0,2,0,12,12,0,0,0,10.0,,12,0,0,0,10.0,84,6.48,76,407,2545,10.7,0.18137819
4983,4983,Chris Tamer,1995-96,25.0,3,2,36,36,2,0,2,26.0,,48,2,0,2,36.0,48,5.97,37,209,1408,10.2,0.1811741
4984,4984,Chris Tamer,1996-97,26.0,4,14,70,70,4,10,14,75.0,,118,6,10,16,111.0,82,6.29,74,413,2481,10.4,0.21692401
4985,4985,Chris Tamer,1997-98,27.0,5,6,45,45,2,4,6,56.0,,163,8,14,22,167.0,82,5.83,55,336,2444,9.8,0.15253705
4986,4986,Chris Tamer,1998-99,28.0,6,7,79,79,0,7,7,55.0,,242,8,21,29,222.0,82,5.28,57,380,2242,9.6,0.13135666
4987,4987,Chris Tamer,1999-00,29.0,7,6,63,63,1,5,6,48.0,867.0,305,9,26,35,270.0,82,5.27,57,359,2285,9.4,0.13030502
4988,4988,Chris Tamer,2000-01,30.0,8,10,69,69,2,8,10,61.0,1275.0,374,11,34,45,331.0,82,5.49,53,331,2294,9.8,0.14960575
4989,4989,Chris Tamer,2001-02,31.0,9,17,82,82,4,13,17,90.0,1615.0,456,15,47,62,421.0,82,5.51,63,376,2272,9.9,0.18876567
4990,4990,Chris Tamer,2002-03,32.0,10,6,78,78,3,3,6,66.0,1442.0,534,18,50,68,487.0,82,5.24,53,338,2262,9.5,0.1470995
4991,4991,Chris Tamer,2003-04,33.0,11,10,72,72,1,9,10,53.0,1129.0,606,19,59,78,540.0,82,5.31,60,363,2326,9.4,0.12724337
4992,4992,Chris Tamer,2004-05,34.0,12,7,38,38,2,5,7,40.0,683.0,644,21,64,85,580.0,82,5.14,57,348,2300,9.2,0.15786478
4993,4993,Chris Tancill,1991-92,23.0,2,2,9,9,1,1,2,6.0,,9,1,1,2,6.0,80,6.91,71,366,2385,11.6,0.26092464
4994,4994,Chris Tancill,1992-93,24.0,3,0,11,11,0,0,0,13.0,,20,1,1,2,19.0,80,6.96,77,402,2440,11.4,0.20286494
4995,4995,Chris Tancill,1993-94,25.0,4,1,4,4,1,0,1,3.0,,24,2,1,3,22.0,84,7.25,87,443,2603,11.7,0.20384216
4996,4996,Chris Tancill,1994-95,26.0,5,4,12,12,1,3,4,18.0,,36,3,4,7,40.0,84,6.48,76,407,2545,10.7,0.20218089
4997,4997,Chris Tancill,1995-96,27.0,6,14,26,26,3,11,14,39.0,,62,6,15,21,79.0,48,5.97,37,209,1408,10.2,0.30542886
4998,4998,Chris Tancill,1996-97,28.0,7,23,45,45,7,16,23,93.0,,107,13,31,44,172.0,82,6.29,74,413,2481,10.4,0.34639692
4999,4999,Chris Tancill,1997-98,29.0,8,4,25,25,4,0,4,20.0,,132,17,31,48,192.0,82,5.83,55,336,2444,9.8,0.19760251
5000,5000,Chris Tancill,1998-99,30.0,9,1,2,2,0,1,1,1.0,,134,17,32,49,193.0,82,5.28,57,380,2242,9.6,0.19031891
5001,5001,Chris Tanev,2011-12,22.0,2,1,29,29,0,1,1,15.0,400.0,29,0,1,1,15.0,82,5.46,52,291,2492,9.0,0.1345129
5002,5002,Chris Tanev,2012-13,23.0,3,2,25,25,0,2,2,15.0,418.0,54,0,3,3,30.0,82,5.32,47,271,2439,8.9,0.13334176
5003,5003,Chris Tanev,2013-14,24.0,4,7,38,38,2,5,7,20.0,657.0,92,2,8,10,50.0,48,5.31,29,160,1399,9.1,0.17594871
5004,5004,Chris Tanev,2014-15,25.0,5,17,64,64,6,11,17,65.0,1327.0,156,8,19,27,115.0,82,5.34,48,269,2463,8.9,0.2135289
5005,5005,Chris Tanev,2015-16,26.0,6,20,70,70,2,18,20,53.0,1476.0,226,10,37,47,168.0,82,5.32,47,251,2453,8.9,0.22123113
5006,5006,Chris Tanev,2016-17,27.0,7,18,69,69,4,14,18,42.0,1501.0,295,14,51,65,210.0,82,5.34,48,255,2438,9.0,0.19029734
5007,5007,Chris Tanev,2017-18,28.0,8,10,53,53,2,8,10,39.0,1078.0,348,16,59,75,249.0,82,5.45,47,245,2478,9.0,0.1749546
5008,5008,Chris Tanev,2018-19,29.0,9,11,42,42,2,9,11,31.0,831.0,390,18,68,86,280.0,82,5.86,50,250,2620,9.2,0.18140775
5009,5009,Chris Tanev,2019-20,30.0,10,12,55,55,2,10,12,51.0,1109.0,445,20,78,98,331.0,82,5.96,47,239,2579,9.5,0.18827143
5010,5010,Chris Tanev,2020-21,31.0,11,20,69,69,2,18,20,45.0,1348.0,514,22,96,118,376.0,70,5.96,42,208,2192,9.5,0.23274636
5011,5011,Chris Taylor,1995-96,23.0,2,3,10,10,0,3,3,13.0,,10,0,3,3,13.0,48,5.97,37,209,1408,10.2,0.24811408
5012,5012,Chris Taylor,1996-97,24.0,3,1,11,11,0,1,1,4.0,,21,0,4,4,17.0,82,6.29,74,413,2481,10.4,0.1596249
5013,5013,Chris Taylor,1997-98,25.0,4,0,1,1,0,0,0,1.0,,22,0,4,4,18.0,82,5.83,55,336,2444,9.8,0.14589867
5014,5014,Chris Taylor,1999-00,27.0,5,8,37,37,3,5,8,60.0,533.0,59,3,9,12,78.0,82,5.27,57,359,2285,9.4,0.21308503
5015,5015,Chris Taylor,2000-01,28.0,6,2,11,11,1,1,2,15.0,120.0,70,4,10,14,93.0,82,5.49,53,331,2294,9.8,0.18700859
5016,5016,Chris Taylor,2001-02,29.0,7,2,14,14,0,2,2,21.0,156.0,84,4,12,16,114.0,82,5.51,63,376,2272,9.9,0.19329557
5017,5017,Chris Taylor,2003-04,31.0,8,4,11,11,1,3,4,10.0,153.0,95,5,15,20,124.0,82,5.31,60,363,2326,9.4,0.21336931
5018,5018,Chris Taylor,2004-05,32.0,9,12,54,54,6,6,12,50.0,549.0,149,11,21,32,174.0,82,5.14,57,348,2300,9.2,0.20131016
5019,5019,Chris Terry,2013-14,24.0,2,1,3,3,1,0,1,1.0,29.0,3,1,0,1,1.0,48,5.31,29,160,1399,9.1,0.23609313
5020,5020,Chris Terry,2014-15,25.0,3,2,10,10,0,2,2,13.0,121.0,13,1,2,3,14.0,82,5.34,48,269,2463,8.9,0.18649456
5021,5021,Chris Terry,2015-16,26.0,4,20,57,57,11,9,20,71.0,725.0,70,12,11,23,85.0,82,5.32,47,251,2453,8.9,0.27580363
5022,5022,Chris Terry,2016-17,27.0,5,11,68,68,8,3,11,78.0,767.0,138,20,14,34,163.0,82,5.34,48,255,2438,9.0,0.21402219
5023,5023,Chris Terry,2017-18,28.0,6,4,14,14,2,2,4,15.0,138.0,152,22,16,38,178.0,82,5.45,47,245,2478,9.0,0.20848286
5024,5024,Chris Therien,1995-96,24.0,2,13,48,48,3,10,13,53.0,,48,3,10,13,53.0,48,5.97,37,209,1408,10.2,0.27973503
5025,5025,Chris Therien,1996-97,25.0,3,23,82,82,6,17,23,123.0,,130,9,27,36,176.0,82,6.29,74,413,2481,10.4,0.2721383
5026,5026,Chris Therien,1997-98,26.0,4,24,71,71,2,22,24,107.0,,201,11,49,60,283.0,82,5.83,55,336,2444,9.8,0.29358864
5027,5027,Chris Therien,1998-99,27.0,5,19,78,78,3,16,19,102.0,,279,14,65,79,385.0,82,5.28,57,380,2242,9.6,0.25110775
5028,5028,Chris Therien,1999-00,28.0,6,18,74,74,3,15,18,115.0,1536.0,353,17,80,97,500.0,82,5.27,57,359,2285,9.4,0.30513513
5029,5029,Chris Therien,2000-01,29.0,7,13,80,80,4,9,13,126.0,1617.0,433,21,89,110,626.0,82,5.49,53,331,2294,9.8,0.23131013
5030,5030,Chris Therien,2001-02,30.0,8,14,73,73,2,12,14,103.0,1507.0,506,23,101,124,729.0,82,5.51,63,376,2272,9.9,0.21244937
5031,5031,Chris Therien,2002-03,31.0,9,14,77,77,4,10,14,105.0,1439.0,583,27,111,138,834.0,82,5.24,53,338,2262,9.5,0.18385026
5032,5032,Chris Therien,2003-04,32.0,10,7,67,67,1,6,7,93.0,1166.0,650,28,117,145,927.0,82,5.31,60,363,2326,9.4,0.183925
5033,5033,Chris Therien,2004-05,33.0,11,10,67,67,1,9,10,68.0,1237.0,717,29,126,155,995.0,82,5.14,57,348,2300,9.2,0.13423121
5034,5034,Chris Therien,2006-07,35.0,12,4,47,47,0,4,4,16.0,647.0,764,29,130,159,1011.0,82,6.05,85,480,2458,10.1,0.09566963
5035,5035,Chris Thorburn,2006-07,23.0,2,1,2,2,0,1,1,1.0,14.0,2,0,1,1,1.0,82,6.05,85,480,2458,10.1,0.19365245
5036,5036,Chris Thorburn,2007-08,24.0,3,5,39,39,3,2,5,40.0,308.0,41,3,3,6,41.0,82,5.76,70,398,2426,9.7,0.18469805
5037,5037,Chris Thorburn,2008-09,25.0,4,18,73,73,5,13,18,72.0,652.0,114,8,16,24,113.0,82,5.44,62,351,2383,9.4,0.2638443
5038,5038,Chris Thorburn,2009-10,26.0,5,15,82,82,7,8,15,85.0,786.0,196,15,24,39,198.0,82,5.7,65,341,2477,9.4,0.21193266
5039,5039,Chris Thorburn,2010-11,27.0,6,13,76,76,4,9,13,63.0,759.0,272,19,33,52,261.0,82,5.53,56,304,2486,9.1,0.18835783
5040,5040,Chris Thorburn,2011-12,28.0,7,19,82,82,9,10,19,114.0,1131.0,354,28,43,71,375.0,82,5.46,52,291,2492,9.0,0.237212
5041,5041,Chris Thorburn,2012-13,29.0,8,11,72,72,4,7,11,69.0,733.0,426,32,50,82,444.0,82,5.32,47,271,2439,8.9,0.16327909
5042,5042,Chris Thorburn,2013-14,30.0,9,4,42,42,2,2,4,13.0,266.0,468,34,52,86,457.0,48,5.31,29,160,1399,9.1,0.12118137
5043,5043,Chris Thorburn,2014-15,31.0,10,11,55,55,2,9,11,26.0,492.0,523,36,61,97,483.0,82,5.34,48,269,2463,8.9,0.1435929
5044,5044,Chris Thorburn,2015-16,32.0,11,14,81,81,7,7,14,67.0,655.0,604,43,68,111,550.0,82,5.32,47,251,2453,8.9,0.15494034
5045,5045,Chris Thorburn,2016-17,33.0,12,12,82,82,6,6,12,70.0,830.0,686,49,74,123,620.0,82,5.34,48,255,2438,9.0,0.1510601
5046,5046,Chris Thorburn,2017-18,34.0,13,4,64,64,3,1,4,36.0,446.0,750,52,75,127,656.0,82,5.45,47,245,2478,9.0,0.12595731
5047,5047,Chris Thorburn,2018-19,35.0,14,7,50,50,1,6,7,35.0,352.0,800,53,81,134,691.0,82,5.86,50,250,2620,9.2,0.13007802
5048,5048,Chris Thorburn,2019-20,36.0,15,0,1,1,0,0,0,0.0,2.0,801,53,81,134,691.0,82,5.96,47,239,2579,9.5,0.28856504
5049,5049,Chris Tierney,2015-16,21.0,2,21,43,43,6,15,21,48.0,527.0,43,6,15,21,48.0,82,5.32,47,251,2453,8.9,0.38708386
5050,5050,Chris Tierney,2016-17,22.0,3,20,79,79,7,13,20,96.0,1042.0,122,13,28,41,144.0,82,5.34,48,255,2438,9.0,0.32206476
5051,5051,Chris Tierney,2017-18,23.0,4,23,80,80,11,12,23,90.0,1168.0,202,24,40,64,234.0,82,5.45,47,245,2478,9.0,0.34728536
5052,5052,Chris Tierney,2018-19,24.0,5,40,82,82,17,23,40,118.0,1312.0,284,41,63,104,352.0,82,5.86,50,250,2620,9.2,0.48341173
5053,5053,Chris Tierney,2019-20,25.0,6,48,81,81,9,39,48,116.0,1379.0,365,50,102,152,468.0,82,5.96,47,239,2579,9.5,0.5765582
5054,5054,Chris Tierney,2020-21,26.0,7,37,71,71,11,26,37,102.0,1220.0,436,61,128,189,570.0,70,5.96,42,208,2192,9.5,0.5037621
5055,5055,Chris Valentine,1982-83,21.0,2,67,60,60,30,37,67,154.0,,60,30,37,67,154.0,80,8.03,73,320,2489,12.9,0.9563757
5056,5056,Chris Valentine,1983-84,22.0,3,17,23,23,7,10,17,23.0,,83,37,47,84,177.0,80,7.73,71,310,2444,12.7,0.5942031
5057,5057,Chris Valentine,1984-85,23.0,4,11,22,22,6,5,11,33.0,,105,43,52,95,210.0,80,7.89,74,336,2448,12.9,0.5387671
5058,5058,Chris VandeVelde,2011-12,24.0,2,2,12,12,0,2,2,16.0,207.0,12,0,2,2,16.0,82,5.46,52,291,2492,9.0,0.19273973
5059,5059,Chris VandeVelde,2012-13,25.0,3,1,5,5,1,0,1,1.0,49.0,17,1,2,3,17.0,82,5.32,47,271,2439,8.9,0.17711169
5060,5060,Chris VandeVelde,2013-14,26.0,4,0,11,11,0,0,0,7.0,78.0,28,1,2,3,24.0,48,5.31,29,160,1399,9.1,0.17039022
5061,5061,Chris VandeVelde,2014-15,27.0,5,1,18,18,0,1,1,8.0,139.0,46,1,3,4,32.0,82,5.34,48,269,2463,8.9,0.119589865
5062,5062,Chris VandeVelde,2015-16,28.0,6,15,72,72,9,6,15,70.0,845.0,118,10,9,19,102.0,82,5.32,47,251,2453,8.9,0.19578207
5063,5063,Chris VandeVelde,2016-17,29.0,7,14,79,79,2,12,14,77.0,1071.0,197,12,21,33,179.0,82,5.34,48,255,2438,9.0,0.16781637
5064,5064,Chris VandeVelde,2017-18,30.0,8,15,81,81,6,9,15,69.0,936.0,278,18,30,48,248.0,82,5.45,47,245,2478,9.0,0.16064113
5065,5065,Chris Wagner,2015-16,24.0,2,0,9,9,0,0,0,7.0,79.0,9,0,0,0,7.0,82,5.32,47,251,2453,8.9,0.16720265
5066,5066,Chris Wagner,2016-17,25.0,3,6,43,43,4,2,6,55.0,394.0,52,4,2,6,62.0,82,5.34,48,255,2438,9.0,0.1717897
5067,5067,Chris Wagner,2017-18,26.0,4,7,43,43,6,1,7,40.0,402.0,95,10,3,13,102.0,82,5.45,47,245,2478,9.0,0.19683972
5068,5068,Chris Wagner,2018-19,27.0,5,16,79,79,7,9,16,93.0,1049.0,174,17,12,29,195.0,82,5.86,50,250,2620,9.2,0.21370679
5069,5069,Chris Wagner,2019-20,28.0,6,19,76,76,12,7,19,135.0,1022.0,250,29,19,48,330.0,82,5.96,47,239,2579,9.5,0.27988768
5070,5070,Chris Wagner,2020-21,29.0,7,10,67,67,6,4,10,78.0,834.0,317,35,23,58,408.0,70,5.96,42,208,2192,9.5,0.2341659
5071,5071,Chris Wells,1996-97,21.0,2,4,54,54,2,2,4,25.0,,54,2,2,4,25.0,82,6.29,74,413,2481,10.4,0.19118613
5072,5072,Chris Wells,1997-98,22.0,3,8,47,47,2,6,8,29.0,,101,4,8,12,54.0,82,5.83,55,336,2444,9.8,0.18303046
5073,5073,Chris Wells,1998-99,23.0,4,15,61,61,5,10,15,57.0,,162,9,18,27,111.0,82,5.28,57,380,2242,9.6,0.25920328
5074,5074,Chris Wells,1999-00,24.0,5,2,20,20,0,2,2,28.0,237.0,182,9,20,29,139.0,82,5.27,57,359,2285,9.4,0.17813727
5075,5075,Chris Wells,2000-01,25.0,6,0,13,13,0,0,0,5.0,109.0,195,9,20,29,144.0,82,5.49,53,331,2294,9.8,0.14109781
5076,5076,Chris Wideman,2016-17,27.0,2,13,64,64,6,7,13,87.0,893.0,64,6,7,13,87.0,82,5.34,48,255,2438,9.0,0.219554
5077,5077,Chris Wideman,2017-18,28.0,3,17,76,76,5,12,17,123.0,1061.0,140,11,19,30,210.0,82,5.45,47,245,2478,9.0,0.23362157
5078,5078,Chris Wideman,2018-19,29.0,4,8,16,16,3,5,8,24.0,185.0,156,14,24,38,234.0,82,5.86,50,250,2620,9.2,0.22811192
5079,5079,Chris Wideman,2019-20,30.0,5,7,25,25,2,5,7,27.0,326.0,181,16,29,45,261.0,82,5.96,47,239,2579,9.5,0.2002025
5080,5080,Chris Winnes,1992-93,24.0,2,4,24,24,1,3,4,20.0,,24,1,3,4,20.0,80,6.96,77,402,2440,11.4,0.22236988
5081,5081,Chris Winnes,1993-94,25.0,3,1,5,5,0,1,1,2.0,,29,1,4,5,22.0,84,7.25,87,443,2603,11.7,0.19012347
5082,5082,Chris Winnes,1994-95,26.0,4,2,4,4,0,2,2,4.0,,33,1,6,7,26.0,84,6.48,76,407,2545,10.7,0.18979251
5083,5083,Christer Kellgren,1982-83,24.0,2,0,5,5,0,0,0,4.0,,5,0,0,0,4.0,80,8.03,73,320,2489,12.9,0.2206254
5084,5084,Christer Olsson,1996-97,26.0,2,10,26,26,2,8,10,32.0,,26,2,8,10,32.0,82,6.29,74,413,2481,10.4,0.24363038
5085,5085,Christer Olsson,1997-98,27.0,3,6,30,30,2,4,6,26.0,,56,4,12,16,58.0,82,5.83,55,336,2444,9.8,0.1973409
5086,5086,Christian Backman,2003-04,23.0,2,0,4,4,0,0,0,4.0,49.0,4,0,0,0,4.0,82,5.31,60,363,2326,9.4,0.17814761
5087,5087,Christian Backman,2004-05,24.0,3,18,66,66,5,13,18,92.0,1276.0,70,5,13,18,96.0,82,5.14,57,348,2300,9.2,0.29512954
5088,5088,Christian Backman,2006-07,26.0,4,18,52,52,6,12,18,70.0,1290.0,122,11,25,36,166.0,82,6.05,85,480,2458,10.1,0.32862562
5089,5089,Christian Backman,2007-08,27.0,5,18,61,61,7,11,18,80.0,1352.0,183,18,36,54,246.0,82,5.76,70,398,2426,9.7,0.28126258
5090,5090,Christian Backman,2008-09,28.0,6,18,63,63,3,15,18,51.0,1210.0,246,21,51,72,297.0,82,5.44,62,351,2383,9.4,0.2595827
5091,5091,Christian Backman,2009-10,29.0,7,7,56,56,2,5,7,54.0,877.0,302,23,56,79,351.0,82,5.7,65,341,2477,9.4,0.16748455
5092,5092,Christian Berglund,2002-03,22.0,2,9,15,15,2,7,9,22.0,187.0,15,2,7,9,22.0,82,5.24,53,338,2262,9.5,0.2794978
5093,5093,Christian Berglund,2003-04,23.0,3,9,38,38,4,5,9,50.0,387.0,53,6,12,18,72.0,82,5.31,60,363,2326,9.4,0.26062518
5094,5094,Christian Berglund,2004-05,24.0,4,9,33,33,5,4,9,50.0,382.0,86,11,16,27,122.0,82,5.14,57,348,2300,9.2,0.29223984
5095,5095,Christian Djoos,2018-19,24.0,2,14,63,63,3,11,14,60.0,884.0,63,3,11,14,60.0,82,5.86,50,250,2620,9.2,0.18394923
5096,5096,Christian Djoos,2019-20,25.0,3,10,45,45,1,9,10,33.0,611.0,108,4,20,24,93.0,82,5.96,47,239,2579,9.5,0.20273376
5097,5097,Christian Djoos,2020-21,26.0,4,3,11,11,1,2,3,13.0,210.0,119,5,22,27,106.0,70,5.96,42,208,2192,9.5,0.24760011
5098,5098,Christian Dube,1997-98,20.0,2,2,27,27,1,1,2,14.0,,27,1,1,2,14.0,82,5.83,55,336,2444,9.8,0.201296
5099,5099,Christian Dube,1999-00,22.0,3,0,6,6,0,0,0,0.0,16.0,33,1,1,2,14.0,82,5.27,57,359,2285,9.4,0.15453652
5100,5100,Christian Dvorak,2017-18,21.0,2,33,78,78,15,18,33,88.0,1218.0,78,15,18,33,88.0,82,5.45,47,245,2478,9.0,0.476605
5101,5101,Christian Dvorak,2018-19,22.0,3,37,78,78,15,22,37,151.0,1282.0,156,30,40,70,239.0,82,5.86,50,250,2620,9.2,0.5211361
5102,5102,Christian Dvorak,2019-20,23.0,4,7,20,20,2,5,7,25.0,288.0,176,32,45,77,264.0,82,5.96,47,239,2579,9.5,0.37905845
5103,5103,Christian Dvorak,2020-21,24.0,5,38,70,70,18,20,38,134.0,1169.0,246,50,65,115,398.0,70,5.96,42,208,2192,9.5,0.5653739
5104,5104,Christian Ehrhoff,2004-05,22.0,2,12,41,41,1,11,12,58.0,630.0,41,1,11,12,58.0,82,5.14,57,348,2300,9.2,0.24169183
5105,5105,Christian Ehrhoff,2006-07,24.0,3,23,64,64,5,18,23,124.0,1140.0,105,6,29,35,182.0,82,6.05,85,480,2458,10.1,0.3304
5106,5106,Christian Ehrhoff,2007-08,25.0,4,33,82,82,10,23,33,164.0,1523.0,187,16,52,68,346.0,82,5.76,70,398,2426,9.7,0.42883715
5107,5107,Christian Ehrhoff,2008-09,26.0,5,22,77,77,1,21,22,97.0,1673.0,264,17,73,90,443.0,82,5.44,62,351,2383,9.4,0.290197
5108,5108,Christian Ehrhoff,2009-10,27.0,6,42,77,77,8,34,42,165.0,1635.0,341,25,107,132,608.0,82,5.7,65,341,2477,9.4,0.5034793
5109,5109,Christian Ehrhoff,2010-11,28.0,7,44,80,80,14,30,44,181.0,1823.0,421,39,137,176,789.0,82,5.53,56,304,2486,9.1,0.5241868
5110,5110,Christian Ehrhoff,2011-12,29.0,8,50,79,79,14,36,50,209.0,1895.0,500,53,173,226,998.0,82,5.46,52,291,2492,9.0,0.56177455
5111,5111,Christian Ehrhoff,2012-13,30.0,9,32,66,66,5,27,32,136.0,1522.0,566,58,200,258,1134.0,82,5.32,47,271,2439,8.9,0.41439041
5112,5112,Christian Ehrhoff,2013-14,31.0,10,22,47,47,5,17,22,102.0,1184.0,613,63,217,280,1236.0,48,5.31,29,160,1399,9.1,0.42386502
5113,5113,Christian Ehrhoff,2014-15,32.0,11,33,79,79,6,27,33,161.0,1889.0,692,69,244,313,1397.0,82,5.34,48,269,2463,8.9,0.38326883
5114,5114,Christian Ehrhoff,2015-16,33.0,12,14,49,49,3,11,14,110.0,1066.0,741,72,255,327,1507.0,82,5.32,47,251,2453,8.9,0.281084
5115,5115,Christian Ehrhoff,2016-17,34.0,13,12,48,48,2,10,12,80.0,743.0,789,74,265,339,1587.0,82,5.34,48,255,2438,9.0,0.23713297
5116,5116,Christian Fischer,2017-18,20.0,2,3,7,7,3,0,3,10.0,86.0,7,3,0,3,10.0,82,5.45,47,245,2478,9.0,0.34473
5117,5117,Christian Fischer,2018-19,21.0,3,33,79,79,15,18,33,154.0,1098.0,86,18,18,36,164.0,82,5.86,50,250,2620,9.2,0.49527156
5118,5118,Christian Fischer,2019-20,22.0,4,18,71,71,11,7,18,116.0,935.0,157,29,25,54,280.0,82,5.96,47,239,2579,9.5,0.31949303
5119,5119,Christian Fischer,2020-21,23.0,5,9,56,56,6,3,9,83.0,617.0,213,35,28,63,363.0,70,5.96,42,208,2192,9.5,0.3023381
5120,5120,Christian Folin,2014-15,23.0,2,1,1,1,0,1,1,0.0,19.0,1,0,1,1,0.0,82,5.34,48,269,2463,8.9,0.20911142
5121,5121,Christian Folin,2015-16,24.0,3,10,40,40,2,8,10,39.0,608.0,41,2,9,11,39.0,82,5.32,47,251,2453,8.9,0.19980597
5122,5122,Christian Folin,2016-17,25.0,4,4,26,26,0,4,4,14.0,379.0,67,2,13,15,53.0,82,5.34,48,255,2438,9.0,0.13106227
5123,5123,Christian Folin,2017-18,26.0,5,8,51,51,2,6,8,39.0,762.0,118,4,19,23,92.0,82,5.45,47,245,2478,9.0,0.18543908
5124,5124,Christian Folin,2018-19,27.0,6,13,65,65,3,10,13,58.0,1018.0,183,7,29,36,150.0,82,5.86,50,250,2620,9.2,0.15470895
5125,5125,Christian Folin,2019-20,28.0,7,6,45,45,0,6,6,47.0,705.0,228,7,35,42,197.0,82,5.96,47,239,2579,9.5,0.14048487
5126,5126,Christian Folin,2020-21,29.0,8,2,16,16,1,1,2,13.0,231.0,244,8,36,44,210.0,70,5.96,42,208,2192,9.5,0.20204535
5127,5127,Christian Hanson,2009-10,23.0,2,2,5,5,1,1,2,9.0,82.0,5,1,1,2,9.0,82,5.7,65,341,2477,9.4,0.24339771
5128,5128,Christian Hanson,2010-11,24.0,3,7,31,31,2,5,7,45.0,415.0,36,3,6,9,54.0,82,5.53,56,304,2486,9.1,0.22473672
5129,5129,Christian Hanson,2011-12,25.0,4,0,6,6,0,0,0,2.0,51.0,42,3,6,9,56.0,82,5.46,52,291,2492,9.0,0.14929965
5130,5130,Christian Jaros,2018-19,22.0,2,0,2,2,0,0,0,0.0,16.0,2,0,0,0,0.0,82,5.86,50,250,2620,9.2,0.15903813
5131,5131,Christian Jaros,2019-20,23.0,3,10,61,61,1,9,10,65.0,876.0,63,1,9,10,65.0,82,5.96,47,239,2579,9.5,0.20452651
5132,5132,Christian Jaros,2020-21,24.0,4,3,13,13,0,3,3,5.0,137.0,76,1,12,13,70.0,70,5.96,42,208,2192,9.5,0.19274747
5133,5133,Christian Laflamme,1997-98,21.0,2,1,4,4,0,1,1,3.0,,4,0,1,1,3.0,82,5.83,55,336,2444,9.8,0.24976227
5134,5134,Christian Laflamme,1998-99,22.0,3,11,72,72,0,11,11,75.0,,76,0,12,12,78.0,82,5.28,57,380,2242,9.6,0.18585518
5135,5135,Christian Laflamme,1999-00,23.0,4,14,73,73,2,12,14,68.0,1351.0,149,2,24,26,146.0,82,5.27,57,359,2285,9.4,0.20703492
5136,5136,Christian Laflamme,2000-01,24.0,5,7,65,65,0,7,7,24.0,902.0,214,2,31,33,170.0,82,5.49,53,331,2294,9.8,0.11626297
5137,5137,Christian Laflamme,2001-02,25.0,6,3,39,39,0,3,3,16.0,471.0,253,2,34,36,186.0,82,5.51,63,376,2272,9.9,0.11045933
5138,5138,Christian Laflamme,2002-03,26.0,7,1,8,8,0,1,1,6.0,111.0,261,2,35,37,192.0,82,5.24,53,338,2262,9.5,0.17138553
5139,5139,Christian Laflamme,2003-04,27.0,8,9,47,47,0,9,9,44.0,713.0,308,2,44,46,236.0,82,5.31,60,363,2326,9.4,0.1411767
5140,5140,Christian Laflamme,2004-05,28.0,9,1,16,16,0,1,1,9.0,208.0,324,2,45,47,245.0,82,5.14,57,348,2300,9.2,0.17462456
5141,5141,Christian Matte,1997-98,23.0,2,2,5,5,1,1,2,6.0,,5,1,1,2,6.0,82,5.83,55,336,2444,9.8,0.22031567
5142,5142,Christian Matte,1998-99,24.0,3,0,5,5,0,0,0,5.0,,10,1,1,2,11.0,82,5.28,57,380,2242,9.6,0.17029232
5143,5143,Christian Matte,1999-00,25.0,4,2,7,7,1,1,2,9.0,54.0,17,2,2,4,20.0,82,5.27,57,359,2285,9.4,0.19090942
5144,5144,Christian Matte,2000-01,26.0,5,1,5,5,0,1,1,1.0,43.0,22,2,3,5,21.0,82,5.49,53,331,2294,9.8,0.15222493
5145,5145,Christian Matte,2001-02,27.0,6,0,3,3,0,0,0,8.0,40.0,25,2,3,5,29.0,82,5.51,63,376,2272,9.9,0.14043
5146,5146,Christian Proulx,1994-95,21.0,2,3,7,7,1,2,3,11.0,,7,1,2,3,11.0,84,6.48,76,407,2545,10.7,0.28005865
5147,5147,Christian Ruuttu,1987-88,23.0,2,65,76,76,22,43,65,168.0,,76,22,43,65,168.0,80,7.34,72,344,2400,12.2,0.85283875
5148,5148,Christian Ruuttu,1988-89,24.0,3,71,73,73,26,45,71,185.0,,149,48,88,136,353.0,80,7.43,89,437,2435,12.2,0.87999153
5149,5149,Christian Ruuttu,1989-90,25.0,4,60,67,67,14,46,60,149.0,,216,62,134,196,502.0,80,7.48,85,403,2430,12.3,0.83241594
5150,5150,Christian Ruuttu,1990-91,26.0,5,60,75,75,19,41,60,160.0,,291,81,175,256,662.0,80,7.37,76,367,2421,12.2,0.74190664
5151,5151,Christian Ruuttu,1991-92,27.0,6,50,77,77,16,34,50,155.0,,368,97,209,306,817.0,80,6.91,71,366,2385,11.6,0.64534974
5152,5152,Christian Ruuttu,1992-93,28.0,7,25,70,70,4,21,25,108.0,,438,101,230,331,925.0,80,6.96,77,402,2440,11.4,0.3894442
5153,5153,Christian Ruuttu,1993-94,29.0,8,54,84,84,17,37,54,187.0,,522,118,267,385,1112.0,84,7.25,87,443,2603,11.7,0.6047988
5154,5154,Christian Ruuttu,1994-95,30.0,9,29,54,54,9,20,29,96.0,,576,127,287,414,1208.0,84,6.48,76,407,2545,10.7,0.5086595
5155,5155,Christian Ruuttu,1995-96,31.0,10,18,45,45,7,11,18,69.0,,621,134,298,432,1277.0,48,5.97,37,209,1408,10.2,0.45498574
5156,5156,Christian Tanguay,1982-83,20.0,2,0,2,2,0,0,0,0.0,,2,0,0,0,0.0,80,8.03,73,320,2489,12.9,0.27148372
5157,5157,Christian Thomas,2013-14,21.0,2,0,1,1,0,0,0,2.0,13.0,1,0,0,0,2.0,48,5.31,29,160,1399,9.1,0.20550153
5158,5158,Christian Thomas,2014-15,22.0,3,0,2,2,0,0,0,1.0,14.0,3,0,0,0,3.0,82,5.34,48,269,2463,8.9,0.17514232
5159,5159,Christian Thomas,2015-16,23.0,4,1,18,18,1,0,1,26.0,164.0,21,1,0,1,29.0,82,5.32,47,251,2453,8.9,0.23439318
5160,5160,Christian Thomas,2016-17,24.0,5,2,6,6,0,2,2,9.0,54.0,27,1,2,3,38.0,82,5.34,48,255,2438,9.0,0.16867447
5161,5161,Christian Wolanin,2018-19,23.0,2,3,10,10,1,2,3,14.0,146.0,10,1,2,3,14.0,82,5.86,50,250,2620,9.2,0.23750716
5162,5162,Christian Wolanin,2019-20,24.0,3,12,30,30,4,8,12,36.0,520.0,40,5,10,15,50.0,82,5.96,47,239,2579,9.5,0.25245655
5163,5163,Christian Wolanin,2020-21,25.0,4,0,3,3,0,0,0,4.0,53.0,43,5,10,15,54.0,70,5.96,42,208,2192,9.5,0.18104303
5164,5164,Christoffer Ehn,2019-20,23.0,2,9,60,60,3,6,9,49.0,637.0,60,3,6,9,49.0,82,5.96,47,239,2579,9.5,0.18611324
5165,5165,Christoffer Ehn,2020-21,24.0,3,4,54,54,2,2,4,36.0,562.0,114,5,8,13,85.0,70,5.96,42,208,2192,9.5,0.1959993
5166,5166,Christoph Bertschy,2016-17,22.0,2,0,3,3,0,0,0,3.0,21.0,3,0,0,0,3.0,82,5.34,48,255,2438,9.0,0.18558577
5167,5167,Christoph Bertschy,2017-18,23.0,3,1,5,5,0,1,1,5.0,41.0,8,0,1,1,8.0,82,5.45,47,245,2478,9.0,0.19538903
5168,5168,Christoph Bertschy,2018-19,24.0,4,0,1,1,0,0,0,0.0,5.0,9,0,1,1,8.0,82,5.86,50,250,2620,9.2,0.15110531
5169,5169,Christoph Brandner,2004-05,29.0,2,9,35,35,4,5,9,50.0,467.0,35,4,5,9,50.0,82,5.14,57,348,2300,9.2,0.24898279
5170,5170,Christoph Schubert,2006-07,24.0,2,10,56,56,4,6,10,72.0,622.0,56,4,6,10,72.0,82,6.05,85,480,2458,10.1,0.23637933
5171,5171,Christoph Schubert,2007-08,25.0,3,25,80,80,8,17,25,97.0,898.0,136,12,23,35,169.0,82,5.76,70,398,2426,9.7,0.30649698
5172,5172,Christoph Schubert,2008-09,26.0,4,24,82,82,8,16,24,137.0,1113.0,218,20,39,59,306.0,82,5.44,62,351,2383,9.4,0.33163366
5173,5173,Christoph Schubert,2009-10,27.0,5,6,50,50,3,3,6,57.0,680.0,268,23,42,65,363.0,82,5.7,65,341,2477,9.4,0.19138032
5174,5174,Christoph Schubert,2010-11,28.0,6,7,47,47,2,5,7,73.0,741.0,315,25,47,72,436.0,82,5.53,56,304,2486,9.1,0.19991168
5175,5175,Christopher Breen,2014-15,25.0,2,2,9,9,0,2,2,4.0,84.0,9,0,2,2,4.0,82,5.34,48,269,2463,8.9,0.17784086
5176,5176,Christopher Didomenico,2017-18,28.0,2,0,3,3,0,0,0,5.0,33.0,3,0,0,0,5.0,82,5.45,47,245,2478,9.0,0.18220589
5177,5177,Christopher Didomenico,2018-19,29.0,3,10,24,24,6,4,10,23.0,283.0,27,6,4,10,28.0,82,5.86,50,250,2620,9.2,0.2482749
5178,5178,Chuck Kobasew,2003-04,21.0,2,6,23,23,4,2,6,29.0,272.0,23,4,2,6,29.0,82,5.31,60,363,2326,9.4,0.35978985
5179,5179,Chuck Kobasew,2004-05,22.0,3,17,70,70,6,11,17,78.0,726.0,93,10,13,23,107.0,82,5.14,57,348,2300,9.2,0.40434128
5180,5180,Chuck Kobasew,2006-07,24.0,4,31,77,77,20,11,31,143.0,944.0,170,30,24,54,250.0,82,6.05,85,480,2458,10.1,0.4287279
5181,5181,Chuck Kobasew,2007-08,25.0,5,19,50,50,5,14,19,93.0,717.0,220,35,38,73,343.0,82,5.76,70,398,2426,9.7,0.38317594
5182,5182,Chuck Kobasew,2008-09,26.0,6,39,73,73,22,17,39,147.0,1290.0,293,57,55,112,490.0,82,5.44,62,351,2383,9.4,0.49785978
5183,5183,Chuck Kobasew,2009-10,27.0,7,42,68,68,21,21,42,129.0,999.0,361,78,76,154,619.0,82,5.7,65,341,2477,9.4,0.5379923
5184,5184,Chuck Kobasew,2010-11,28.0,8,15,49,49,9,6,15,71.0,682.0,410,87,82,169,690.0,82,5.53,56,304,2486,9.1,0.33226585
5185,5185,Chuck Kobasew,2011-12,29.0,9,16,63,63,9,7,16,74.0,746.0,473,96,89,185,764.0,82,5.46,52,291,2492,9.0,0.2858473
5186,5186,Chuck Kobasew,2012-13,30.0,10,14,58,58,7,7,14,65.0,687.0,531,103,96,199,829.0,82,5.32,47,271,2439,8.9,0.24075216
5187,5187,Chuck Kobasew,2013-14,31.0,11,9,37,37,5,4,9,43.0,417.0,568,108,100,208,872.0,48,5.31,29,160,1399,9.1,0.24832258
5188,5188,Chuck Kobasew,2014-15,32.0,12,2,33,33,2,0,2,37.0,370.0,601,110,100,210,909.0,82,5.34,48,269,2463,8.9,0.22239348
5189,5189,Clark Bishop,2019-20,23.0,2,3,20,20,1,2,3,16.0,189.0,20,1,2,3,16.0,82,5.96,47,239,2579,9.5,0.1942386
5190,5190,Clark Bishop,2020-21,24.0,3,1,5,5,0,1,1,4.0,38.0,25,1,3,4,20.0,70,5.96,42,208,2192,9.5,0.19268623
5191,5191,Clark Donatelli,1990-91,25.0,2,6,25,25,3,3,6,25.0,,25,3,3,6,25.0,80,7.37,76,367,2421,12.2,0.28973794
5192,5192,Clark Donatelli,1992-93,27.0,3,1,10,10,0,1,1,7.0,,35,3,4,7,32.0,80,6.96,77,402,2440,11.4,0.18422472
5193,5193,Clarke MacArthur,2007-08,22.0,2,7,19,19,3,4,7,16.0,169.0,19,3,4,7,16.0,82,5.76,70,398,2426,9.7,0.26797634
5194,5194,Clarke MacArthur,2008-09,23.0,3,15,37,37,8,7,15,51.0,539.0,56,11,11,22,67.0,82,5.44,62,351,2383,9.4,0.36876196
5195,5195,Clarke MacArthur,2009-10,24.0,4,31,71,71,17,14,31,108.0,982.0,127,28,25,53,175.0,82,5.7,65,341,2477,9.4,0.42245314
5196,5196,Clarke MacArthur,2010-11,25.0,5,35,81,81,16,19,35,129.0,1190.0,208,44,44,88,304.0,82,5.53,56,304,2486,9.1,0.43967667
5197,5197,Clarke MacArthur,2011-12,26.0,6,62,82,82,21,41,62,154.0,1403.0,290,65,85,150,458.0,82,5.46,52,291,2492,9.0,0.66959506
5198,5198,Clarke MacArthur,2012-13,27.0,7,43,73,73,20,23,43,148.0,1157.0,363,85,108,193,606.0,82,5.32,47,271,2439,8.9,0.5332669
5199,5199,Clarke MacArthur,2013-14,28.0,8,20,40,40,8,12,20,62.0,596.0,403,93,120,213,668.0,48,5.31,29,160,1399,9.1,0.5416512
5200,5200,Clarke MacArthur,2014-15,29.0,9,55,79,79,24,31,55,159.0,1393.0,482,117,151,268,827.0,82,5.34,48,269,2463,8.9,0.58572847
5201,5201,Clarke MacArthur,2015-16,30.0,10,36,62,62,16,20,36,140.0,1054.0,544,133,171,304,967.0,82,5.32,47,251,2453,8.9,0.49006662
5202,5202,Clarke MacArthur,2016-17,31.0,11,0,4,4,0,0,0,4.0,43.0,548,133,171,304,971.0,82,5.34,48,255,2438,9.0,0.21988776
5203,5203,Clarke MacArthur,2017-18,32.0,12,0,4,4,0,0,0,5.0,54.0,552,133,171,304,976.0,82,5.45,47,245,2478,9.0,0.20865455
5204,5204,Clarke Wilm,1999-00,23.0,2,18,78,78,10,8,18,94.0,900.0,78,10,8,18,94.0,82,5.27,57,359,2285,9.4,0.31094176
5205,5205,Clarke Wilm,2000-01,24.0,3,22,78,78,10,12,22,81.0,986.0,156,20,20,40,175.0,82,5.49,53,331,2294,9.8,0.30474293
5206,5206,Clarke Wilm,2001-02,25.0,4,15,81,81,7,8,15,85.0,1149.0,237,27,28,55,260.0,82,5.51,63,376,2272,9.9,0.2291533
5207,5207,Clarke Wilm,2002-03,26.0,5,18,66,66,4,14,18,83.0,990.0,303,31,42,73,343.0,82,5.24,53,338,2262,9.5,0.26152697
5208,5208,Clarke Wilm,2003-04,27.0,6,16,82,82,5,11,16,108.0,981.0,385,36,53,89,451.0,82,5.31,60,363,2326,9.4,0.23690712
5209,5209,Clarke Wilm,2004-05,28.0,7,0,10,10,0,0,0,10.0,117.0,395,36,53,89,461.0,82,5.14,57,348,2300,9.2,0.23764834
5210,5210,Clarke Wilm,2006-07,30.0,8,8,60,60,1,7,8,50.0,707.0,455,37,60,97,511.0,82,6.05,85,480,2458,10.1,0.14240155
5211,5211,Claude Boivin,1992-93,22.0,2,18,58,58,5,13,18,46.0,,58,5,13,18,46.0,80,6.96,77,402,2440,11.4,0.317113
5212,5212,Claude Boivin,1993-94,23.0,3,9,30,30,5,4,9,21.0,,88,10,17,27,67.0,84,7.25,87,443,2603,11.7,0.31368092
5213,5213,Claude Boivin,1994-95,24.0,4,3,41,41,2,1,3,17.0,,129,12,18,30,84.0,84,6.48,76,407,2545,10.7,0.15141672
5214,5214,Claude Boivin,1995-96,25.0,5,1,3,3,0,1,1,0.0,,132,12,19,31,84.0,48,5.97,37,209,1408,10.2,0.18521434
5215,5215,Claude Giroux,2008-09,21.0,2,0,2,2,0,0,0,2.0,19.0,2,0,0,0,2.0,82,5.44,62,351,2383,9.4,0.20789137
5216,5216,Claude Giroux,2009-10,22.0,3,27,42,42,9,18,27,67.0,637.0,44,9,18,27,69.0,82,5.7,65,341,2477,9.4,0.49800262
5217,5217,Claude Giroux,2010-11,23.0,4,47,82,82,16,31,47,145.0,1362.0,126,25,49,74,214.0,82,5.53,56,304,2486,9.1,0.5911944
5218,5218,Claude Giroux,2011-12,24.0,5,76,82,82,25,51,76,169.0,1591.0,208,50,100,150,383.0,82,5.46,52,291,2492,9.0,0.87465274
5219,5219,Claude Giroux,2012-13,25.0,6,93,77,77,28,65,93,242.0,1659.0,285,78,165,243,625.0,82,5.32,47,271,2439,8.9,1.0244756
5220,5220,Claude Giroux,2013-14,26.0,7,48,48,48,13,35,48,137.0,1016.0,333,91,200,291,762.0,48,5.31,29,160,1399,9.1,1.0048561
5221,5221,Claude Giroux,2014-15,27.0,8,86,82,82,28,58,86,223.0,1676.0,415,119,258,377,985.0,82,5.34,48,269,2463,8.9,0.96126056
5222,5222,Claude Giroux,2015-16,28.0,9,73,81,81,25,48,73,279.0,1666.0,496,144,306,450,1264.0,82,5.32,47,251,2453,8.9,0.89346254
5223,5223,Claude Giroux,2016-17,29.0,10,67,78,78,22,45,67,241.0,1603.0,574,166,351,517,1505.0,82,5.34,48,255,2438,9.0,0.81537855
5224,5224,Claude Giroux,2017-18,30.0,11,58,82,82,14,44,58,199.0,1568.0,656,180,395,575,1704.0,82,5.45,47,245,2478,9.0,0.71546984
5225,5225,Claude Giroux,2018-19,31.0,12,102,82,82,34,68,102,193.0,1670.0,738,214,463,677,1897.0,82,5.86,50,250,2620,9.2,1.0936675
5226,5226,Claude Giroux,2019-20,32.0,13,85,82,82,22,63,85,229.0,1759.0,820,236,526,762,2126.0,82,5.96,47,239,2579,9.5,0.9347558
5227,5227,Claude Giroux,2020-21,33.0,14,53,69,69,21,32,53,197.0,1310.0,889,257,558,815,2323.0,70,5.96,42,208,2192,9.5,0.7915441
5228,5228,Claude Julien,1985-86,25.0,2,0,1,1,0,0,0,0.0,,1,0,0,0,0.0,80,7.77,71,321,2447,12.7,0.17686021
5229,5229,Claude Julien,1986-87,26.0,3,1,13,13,0,1,1,4.0,,14,0,1,1,4.0,80,7.94,82,370,2484,12.8,0.18527526
5230,5230,Claude Lapointe,1991-92,23.0,2,4,13,13,2,2,4,7.0,,13,2,2,4,7.0,80,6.91,71,366,2385,11.6,0.29697853
5231,5231,Claude Lapointe,1992-93,24.0,3,33,78,78,13,20,33,95.0,,91,15,22,37,102.0,80,6.96,77,402,2440,11.4,0.43916872
5232,5232,Claude Lapointe,1993-94,25.0,4,36,74,74,10,26,36,91.0,,165,25,48,73,193.0,84,7.25,87,443,2603,11.7,0.41433457
5233,5233,Claude Lapointe,1994-95,26.0,5,28,59,59,11,17,28,73.0,,224,36,65,101,266.0,84,6.48,76,407,2545,10.7,0.38733304
5234,5234,Claude Lapointe,1995-96,27.0,6,12,29,29,4,8,12,40.0,,253,40,73,113,306.0,48,5.97,37,209,1408,10.2,0.34179464
5235,5235,Claude Lapointe,1996-97,28.0,7,9,35,35,4,5,9,44.0,,288,44,78,122,350.0,82,6.29,74,413,2481,10.4,0.25742513
5236,5236,Claude Lapointe,1997-98,29.0,8,18,73,73,13,5,18,80.0,,361,57,83,140,430.0,82,5.83,55,336,2444,9.8,0.32366824
5237,5237,Claude Lapointe,1998-99,30.0,9,20,78,78,10,10,20,82.0,,439,67,93,160,512.0,82,5.28,57,380,2242,9.6,0.27721477
5238,5238,Claude Lapointe,1999-00,31.0,10,37,82,82,14,23,37,134.0,1587.0,521,81,116,197,646.0,82,5.27,57,359,2285,9.4,0.4302284
5239,5239,Claude Lapointe,2000-01,32.0,11,31,76,76,15,16,31,129.0,1493.0,597,96,132,228,775.0,82,5.49,53,331,2294,9.8,0.36114
5240,5240,Claude Lapointe,2001-02,33.0,12,32,80,80,9,23,32,94.0,1494.0,677,105,155,260,869.0,82,5.51,63,376,2272,9.9,0.32605034
5241,5241,Claude Lapointe,2002-03,34.0,13,21,80,80,9,12,21,74.0,1047.0,757,114,167,281,943.0,82,5.24,53,338,2262,9.5,0.23255256
5242,5242,Claude Lapointe,2003-04,35.0,14,16,80,80,8,8,16,87.0,965.0,837,122,175,297,1030.0,82,5.31,60,363,2326,9.4,0.20080268
5243,5243,Claude Lapointe,2004-05,36.0,15,8,42,42,5,3,8,26.0,465.0,879,127,178,305,1056.0,82,5.14,57,348,2300,9.2,0.18730986
5244,5244,Claude Larose,1980-81,25.0,2,11,25,25,4,7,11,50.0,,25,4,7,11,50.0,80,7.03,61,280,2352,12.0,0.36561787
5245,5245,Claude Lemieux,1984-85,19.0,2,2,8,8,1,1,2,7.0,,8,1,1,2,7.0,80,7.89,74,336,2448,12.9,0.35163736
5246,5246,Claude Lemieux,1985-86,20.0,3,1,1,1,0,1,1,0.0,,9,1,2,3,7.0,80,7.77,71,321,2447,12.7,0.30540168
5247,5247,Claude Lemieux,1986-87,21.0,4,3,10,10,1,2,3,16.0,,19,2,4,6,23.0,80,7.94,82,370,2484,12.8,0.31520236
5248,5248,Claude Lemieux,1987-88,22.0,5,53,76,76,27,26,53,184.0,,95,29,30,59,207.0,80,7.34,72,344,2400,12.2,0.77791214
5249,5249,Claude Lemieux,1988-89,23.0,6,61,78,78,31,30,61,241.0,,173,60,60,120,448.0,80,7.43,89,437,2435,12.2,0.7742382
5250,5250,Claude Lemieux,1989-90,24.0,7,51,69,69,29,22,51,220.0,,242,89,82,171,668.0,80,7.48,85,403,2430,12.3,0.7132278
5251,5251,Claude Lemieux,1990-91,25.0,8,18,39,39,8,10,18,104.0,,281,97,92,189,772.0,80,7.37,76,367,2421,12.2,0.55839473
5252,5252,Claude Lemieux,1991-92,26.0,9,47,78,78,30,17,47,271.0,,359,127,109,236,1043.0,80,6.91,71,366,2385,11.6,0.72418165
5253,5253,Claude Lemieux,1992-93,27.0,10,68,74,74,41,27,68,296.0,,433,168,136,304,1339.0,80,6.96,77,402,2440,11.4,0.8695432
5254,5254,Claude Lemieux,1993-94,28.0,11,81,77,77,30,51,81,311.0,,510,198,187,385,1650.0,84,7.25,87,443,2603,11.7,0.81842643
5255,5255,Claude Lemieux,1994-95,29.0,12,44,79,79,18,26,44,181.0,,589,216,213,429,1831.0,84,6.48,76,407,2545,10.7,0.5215422
5256,5256,Claude Lemieux,1995-96,30.0,13,19,45,45,6,13,19,117.0,,634,222,226,448,1948.0,48,5.97,37,209,1408,10.2,0.5334451
5257,5257,Claude Lemieux,1996-97,31.0,14,71,79,79,39,32,71,315.0,,713,261,258,519,2263.0,82,6.29,74,413,2481,10.4,0.7405616
5258,5258,Claude Lemieux,1997-98,32.0,15,28,45,45,11,17,28,168.0,,758,272,275,547,2431.0,82,5.83,55,336,2444,9.8,0.54425573
5259,5259,Claude Lemieux,1998-99,33.0,16,53,78,78,26,27,53,261.0,,836,298,302,600,2692.0,82,5.28,57,380,2242,9.6,0.6523936
5260,5260,Claude Lemieux,1999-00,34.0,17,51,82,82,27,24,51,292.0,1741.0,918,325,326,651,2984.0,82,5.27,57,359,2285,9.4,0.5730945
5261,5261,Claude Lemieux,2000-01,35.0,18,47,83,83,20,27,47,257.0,1497.0,1001,345,353,698,3241.0,82,5.49,53,331,2294,9.8,0.54142344
5262,5262,Claude Lemieux,2001-02,36.0,19,26,46,46,10,16,26,99.0,791.0,1047,355,369,724,3340.0,82,5.51,63,376,2272,9.9,0.47847047
5263,5263,Claude Lemieux,2002-03,37.0,20,41,82,82,16,25,41,174.0,1411.0,1129,371,394,765,3514.0,82,5.24,53,338,2262,9.5,0.46573877
5264,5264,Claude Lemieux,2003-04,38.0,21,20,68,68,8,12,20,119.0,928.0,1197,379,406,785,3633.0,82,5.31,60,363,2326,9.4,0.3011845
5265,5265,Claude Lemieux,2009-10,44.0,22,1,18,18,0,1,1,17.0,138.0,1215,379,407,786,3650.0,82,5.7,65,341,2477,9.4,0.30571955
5266,5266,Claude Loiselle,1982-83,19.0,2,1,4,4,1,0,1,2.0,,4,1,0,1,2.0,80,8.03,73,320,2489,12.9,0.31028783
5267,5267,Claude Loiselle,1983-84,20.0,3,2,18,18,2,0,2,24.0,,22,3,0,3,26.0,80,7.73,71,310,2444,12.7,0.36861944
5268,5268,Claude Loiselle,1984-85,21.0,4,10,28,28,4,6,10,20.0,,50,7,6,13,46.0,80,7.89,74,336,2448,12.9,0.36693704
5269,5269,Claude Loiselle,1985-86,22.0,5,9,30,30,8,1,9,30.0,,80,15,7,22,76.0,80,7.77,71,321,2447,12.7,0.36150324
5270,5270,Claude Loiselle,1986-87,23.0,6,22,48,48,7,15,22,84.0,,128,22,22,44,160.0,80,7.94,82,370,2484,12.8,0.4476227
5271,5271,Claude Loiselle,1987-88,24.0,7,40,75,75,16,24,40,145.0,,203,38,46,84,305.0,80,7.34,72,344,2400,12.2,0.5231971
5272,5272,Claude Loiselle,1988-89,25.0,8,35,68,68,17,18,35,117.0,,271,55,64,119,422.0,80,7.43,89,437,2435,12.2,0.43570518
5273,5273,Claude Loiselle,1989-90,26.0,9,21,74,74,7,14,21,92.0,,345,62,78,140,514.0,80,7.48,85,403,2430,12.3,0.3001672
5274,5274,Claude Loiselle,1990-91,27.0,10,25,72,72,11,14,25,128.0,,417,73,92,165,642.0,80,7.37,76,367,2421,12.2,0.31798643
5275,5275,Claude Loiselle,1991-92,28.0,11,17,66,66,6,11,17,89.0,,483,79,103,182,731.0,80,6.91,71,366,2385,11.6,0.29093504
5276,5276,Claude Loiselle,1992-93,29.0,12,17,75,75,7,10,17,101.0,,558,86,113,199,832.0,80,6.96,77,402,2440,11.4,0.26009655
5277,5277,Claude Loiselle,1993-94,30.0,13,8,41,41,5,3,8,41.0,,599,91,116,207,873.0,84,7.25,87,443,2603,11.7,0.22853312
5278,5278,Claude Loiselle,1994-95,31.0,14,2,17,17,1,1,2,14.0,,616,92,117,209,887.0,84,6.48,76,407,2545,10.7,0.19635656
5279,5279,Claude Noel,1980-81,25.0,2,0,7,7,0,0,0,5.0,,7,0,0,0,5.0,80,7.03,61,280,2352,12.0,0.21139047
5280,5280,Claude Verret,1984-85,21.0,2,7,11,11,2,5,7,14.0,,11,2,5,7,14.0,80,7.89,74,336,2448,12.9,0.3876338
5281,5281,Claude Verret,1985-86,22.0,3,0,3,3,0,0,0,5.0,,14,2,5,7,19.0,80,7.77,71,321,2447,12.7,0.22800723
5282,5282,Claude Vilgrain,1988-89,25.0,2,2,6,6,1,1,2,7.0,,6,1,1,2,7.0,80,7.43,89,437,2435,12.2,0.25567845
5283,5283,Claude Vilgrain,1990-91,27.0,3,3,6,6,1,2,3,13.0,,12,2,3,5,20.0,80,7.37,76,367,2421,12.2,0.22604984
5284,5284,Claude Vilgrain,1992-93,29.0,4,46,71,71,19,27,46,88.0,,83,21,30,51,108.0,80,6.96,77,402,2440,11.4,0.4899628
5285,5285,Claude Vilgrain,1993-94,30.0,5,2,4,4,0,2,2,2.0,,87,21,32,53,110.0,84,7.25,87,443,2603,11.7,0.22774905
5286,5286,Claude Vilgrain,1994-95,31.0,6,0,2,2,0,0,0,0.0,,89,21,32,53,110.0,84,6.48,76,407,2545,10.7,0.20327947
5287,5287,Claudio Scremin,1992-93,24.0,2,0,13,13,0,0,0,18.0,,13,0,0,0,18.0,80,6.96,77,402,2440,11.4,0.2189877
5288,5288,Claudio Scremin,1993-94,25.0,3,1,4,4,0,1,1,4.0,,17,0,1,1,22.0,84,7.25,87,443,2603,11.7,0.1919361
5289,5289,Clay Wilson,2008-09,25.0,2,2,7,7,1,1,2,12.0,118.0,7,1,1,2,12.0,82,5.44,62,351,2383,9.4,0.21848297
5290,5290,Clay Wilson,2009-10,26.0,3,1,7,7,0,1,1,13.0,79.0,14,1,2,3,25.0,82,5.7,65,341,2477,9.4,0.18160173
5291,5291,Clay Wilson,2010-11,27.0,4,0,2,2,0,0,0,0.0,22.0,16,1,2,3,25.0,82,5.53,56,304,2486,9.1,0.15038475
5292,5292,Clay Wilson,2011-12,28.0,5,5,15,15,3,2,5,22.0,223.0,31,4,4,8,47.0,82,5.46,52,291,2492,9.0,0.20933458
5293,5293,Clay Wilson,2012-13,29.0,6,0,5,5,0,0,0,7.0,66.0,36,4,4,8,54.0,82,5.32,47,271,2439,8.9,0.12868103
5294,5294,Clayton Beddoes,1996-97,26.0,2,7,39,39,1,6,7,18.0,,39,1,6,7,18.0,82,6.29,74,413,2481,10.4,0.1440565
5295,5295,Clayton Beddoes,1997-98,27.0,3,3,21,21,1,2,3,11.0,,60,2,8,10,29.0,82,5.83,55,336,2444,9.8,0.122995585
5296,5296,Clayton Keller,2017-18,19.0,2,2,3,3,0,2,2,0.0,38.0,3,0,2,2,0.0,82,5.45,47,245,2478,9.0,0.30098206
5297,5297,Clayton Keller,2018-19,20.0,3,65,82,82,23,42,65,212.0,1483.0,85,23,44,67,212.0,82,5.86,50,250,2620,9.2,0.79635525
5298,5298,Clayton Keller,2019-20,21.0,4,47,82,82,14,33,47,200.0,1495.0,167,37,77,114,412.0,82,5.96,47,239,2579,9.5,0.670102
5299,5299,Clayton Keller,2020-21,22.0,5,44,70,70,17,27,44,184.0,1141.0,237,54,104,158,596.0,70,5.96,42,208,2192,9.5,0.7550525
5300,5300,Clayton Stoner,2010-11,25.0,2,2,8,8,0,2,2,5.0,107.0,8,0,2,2,5.0,82,5.53,56,304,2486,9.1,0.18394786
5301,5301,Clayton Stoner,2011-12,26.0,3,9,57,57,2,7,9,40.0,961.0,65,2,9,11,45.0,82,5.46,52,291,2492,9.0,0.14997876
5302,5302,Clayton Stoner,2012-13,27.0,4,5,51,51,1,4,5,47.0,897.0,116,3,13,16,92.0,82,5.32,47,271,2439,8.9,0.14687514
5303,5303,Clayton Stoner,2013-14,28.0,5,10,48,48,0,10,10,40.0,874.0,164,3,23,26,132.0,48,5.31,29,160,1399,9.1,0.16626829
5304,5304,Clayton Stoner,2014-15,29.0,6,5,63,63,1,4,5,48.0,840.0,227,4,27,31,180.0,82,5.34,48,269,2463,8.9,0.12998623
5305,5305,Clayton Stoner,2015-16,30.0,7,8,69,69,1,7,8,68.0,1217.0,296,5,34,39,248.0,82,5.32,47,251,2453,8.9,0.11598295
5306,5306,Clayton Stoner,2016-17,31.0,8,6,50,50,1,5,6,32.0,768.0,346,6,39,45,280.0,82,5.34,48,255,2438,9.0,0.10444224
5307,5307,Clayton Stoner,2017-18,32.0,9,3,14,14,1,2,3,16.0,246.0,360,7,41,48,296.0,82,5.45,47,245,2478,9.0,0.1780341
5308,5308,Cliff Ronning,1987-88,22.0,2,25,42,42,11,14,25,66.0,,42,11,14,25,66.0,80,7.34,72,344,2400,12.2,0.5115796
5309,5309,Cliff Ronning,1988-89,23.0,3,13,26,26,5,8,13,38.0,,68,16,22,38,104.0,80,7.43,89,437,2435,12.2,0.45136502
5310,5310,Cliff Ronning,1989-90,24.0,4,55,64,64,24,31,55,150.0,,132,40,53,93,254.0,80,7.48,85,403,2430,12.3,0.7832154
5311,5311,Cliff Ronning,1991-92,26.0,5,44,59,59,20,24,44,113.0,,191,60,77,137,367.0,80,6.91,71,366,2385,11.6,0.67120767
5312,5312,Cliff Ronning,1992-93,27.0,6,71,80,80,24,47,71,216.0,,271,84,124,208,583.0,80,6.96,77,402,2440,11.4,0.88454354
5313,5313,Cliff Ronning,1993-94,28.0,7,85,79,79,29,56,85,209.0,,350,113,180,293,792.0,84,7.25,87,443,2603,11.7,0.91449714
5314,5314,Cliff Ronning,1994-95,29.0,8,68,76,76,25,43,68,197.0,,426,138,223,361,989.0,84,6.48,76,407,2545,10.7,0.7341345
5315,5315,Cliff Ronning,1995-96,30.0,9,25,41,41,6,19,25,93.0,,467,144,242,386,1082.0,48,5.97,37,209,1408,10.2,0.65239197
5316,5316,Cliff Ronning,1996-97,31.0,10,67,79,79,22,45,67,187.0,,546,166,287,453,1269.0,82,6.29,74,413,2481,10.4,0.7233429
5317,5317,Cliff Ronning,1997-98,32.0,11,51,69,69,19,32,51,171.0,,615,185,319,504,1440.0,82,5.83,55,336,2444,9.8,0.61325854
5318,5318,Cliff Ronning,1998-99,33.0,12,55,80,80,11,44,55,197.0,,695,196,363,559,1637.0,82,5.28,57,380,2242,9.6,0.6480204
5319,5319,Cliff Ronning,1999-00,34.0,13,60,79,79,20,40,60,257.0,1526.0,774,216,403,619,1894.0,82,5.27,57,359,2285,9.4,0.7302599
5320,5320,Cliff Ronning,2000-01,35.0,14,62,82,82,26,36,62,248.0,1490.0,856,242,439,681,2142.0,82,5.49,53,331,2294,9.8,0.691662
5321,5321,Cliff Ronning,2001-02,36.0,15,62,80,80,19,43,62,237.0,1390.0,936,261,482,743,2379.0,82,5.51,63,376,2272,9.9,0.642482
5322,5322,Cliff Ronning,2002-03,37.0,16,54,81,81,19,35,54,199.0,1357.0,1017,280,517,797,2578.0,82,5.24,53,338,2262,9.5,0.6466632
5323,5323,Cliff Ronning,2003-04,38.0,17,48,80,80,17,31,48,171.0,1394.0,1097,297,548,845,2749.0,82,5.31,60,363,2326,9.4,0.56471527
5324,5324,Cliff Ronning,2004-05,39.0,18,24,40,40,9,15,24,55.0,477.0,1137,306,563,869,2804.0,82,5.14,57,348,2300,9.2,0.5789026
5325,5325,Cody Almond,2010-11,21.0,2,1,7,7,1,0,1,6.0,54.0,7,1,0,1,6.0,82,5.53,56,304,2486,9.1,0.23479044
5326,5326,Cody Almond,2011-12,22.0,3,0,8,8,0,0,0,3.0,56.0,15,1,0,1,9.0,82,5.46,52,291,2492,9.0,0.16490644
5327,5327,Cody Almond,2012-13,23.0,4,1,10,10,1,0,1,7.0,102.0,25,2,0,2,16.0,82,5.32,47,271,2439,8.9,0.19986326
5328,5328,Cody Bass,2008-09,22.0,2,4,21,21,2,2,4,12.0,112.0,21,2,2,4,12.0,82,5.44,62,351,2383,9.4,0.20910308
5329,5329,Cody Bass,2009-10,23.0,3,0,12,12,0,0,0,5.0,68.0,33,2,2,4,17.0,82,5.7,65,341,2477,9.4,0.1736424
5330,5330,Cody Bass,2011-12,25.0,4,0,1,1,0,0,0,0.0,7.0,34,2,2,4,17.0,82,5.46,52,291,2492,9.0,0.14170903
5331,5331,Cody Bass,2012-13,26.0,5,1,14,14,0,1,1,13.0,127.0,48,2,3,5,30.0,82,5.32,47,271,2439,8.9,0.15034887
5332,5332,Cody Bass,2014-15,28.0,6,0,1,1,0,0,0,0.0,3.0,49,2,3,5,30.0,82,5.34,48,269,2463,8.9,0.11721951
5333,5333,Cody Bass,2016-17,30.0,7,0,17,17,0,0,0,11.0,130.0,66,2,3,5,41.0,82,5.34,48,255,2438,9.0,0.11479604
5334,5334,Cody Bass,2017-18,31.0,8,0,9,9,0,0,0,1.0,61.0,75,2,3,5,42.0,82,5.45,47,245,2478,9.0,0.105700314
5335,5335,Cody Ceci,2014-15,21.0,2,9,49,49,3,6,9,82.0,843.0,49,3,6,9,82.0,82,5.34,48,269,2463,8.9,0.28109157
5336,5336,Cody Ceci,2015-16,22.0,3,21,81,81,5,16,21,130.0,1562.0,130,8,22,30,212.0,82,5.32,47,251,2453,8.9,0.32816803
5337,5337,Cody Ceci,2016-17,23.0,4,26,75,75,10,16,26,116.0,1448.0,205,18,38,56,328.0,82,5.34,48,255,2438,9.0,0.36803424
5338,5338,Cody Ceci,2017-18,24.0,5,17,79,79,2,15,17,143.0,1833.0,284,20,53,73,471.0,82,5.45,47,245,2478,9.0,0.27787125
5339,5339,Cody Ceci,2018-19,25.0,6,19,82,82,5,14,19,143.0,1914.0,366,25,67,92,614.0,82,5.86,50,250,2620,9.2,0.2919003
5340,5340,Cody Ceci,2019-20,26.0,7,26,74,74,7,19,26,132.0,1670.0,440,32,86,118,746.0,82,5.96,47,239,2579,9.5,0.3695532
5341,5341,Cody Ceci,2020-21,27.0,8,8,56,56,1,7,8,48.0,1150.0,496,33,93,126,794.0,70,5.96,42,208,2192,9.5,0.19039392
5342,5342,Cody Eakin,2012-13,21.0,2,8,30,30,4,4,8,31.0,278.0,30,4,4,8,31.0,82,5.32,47,271,2439,8.9,0.3099842
5343,5343,Cody Eakin,2013-14,22.0,3,24,48,48,7,17,24,67.0,724.0,78,11,21,32,98.0,48,5.31,29,160,1399,9.1,0.45587906
5344,5344,Cody Eakin,2014-15,23.0,4,35,81,81,16,19,35,161.0,1404.0,159,27,40,67,259.0,82,5.34,48,269,2463,8.9,0.46214938
5345,5345,Cody Eakin,2015-16,24.0,5,40,78,78,19,21,40,142.0,1341.0,237,46,61,107,401.0,82,5.32,47,251,2453,8.9,0.5010072
5346,5346,Cody Eakin,2016-17,25.0,6,35,82,82,16,19,35,132.0,1342.0,319,62,80,142,533.0,82,5.34,48,255,2438,9.0,0.45702022
5347,5347,Cody Eakin,2017-18,26.0,7,12,60,60,3,9,12,82.0,1009.0,379,65,89,154,615.0,82,5.45,47,245,2478,9.0,0.30991495
5348,5348,Cody Eakin,2018-19,27.0,8,27,80,80,11,16,27,107.0,1163.0,459,76,105,181,722.0,82,5.86,50,250,2620,9.2,0.35134703
5349,5349,Cody Eakin,2019-20,28.0,9,41,78,78,22,19,41,120.0,1200.0,537,98,124,222,842.0,82,5.96,47,239,2579,9.5,0.47146216
5350,5350,Cody Eakin,2020-21,29.0,10,15,49,49,5,10,15,61.0,714.0,586,103,134,237,903.0,70,5.96,42,208,2192,9.5,0.3464561
5351,5351,Cody Franson,2010-11,23.0,2,21,61,61,6,15,21,90.0,866.0,61,6,15,21,90.0,82,5.53,56,304,2486,9.1,0.3490501
5352,5352,Cody Franson,2011-12,24.0,3,29,80,80,8,21,29,156.0,1214.0,141,14,36,50,246.0,82,5.46,52,291,2492,9.0,0.37649414
5353,5353,Cody Franson,2012-13,25.0,4,21,57,57,5,16,21,65.0,923.0,198,19,52,71,311.0,82,5.32,47,271,2439,8.9,0.342762
5354,5354,Cody Franson,2013-14,26.0,5,29,45,45,4,25,29,70.0,845.0,243,23,77,100,381.0,48,5.31,29,160,1399,9.1,0.49563956
5355,5355,Cody Franson,2014-15,27.0,6,33,79,79,5,28,33,115.0,1635.0,322,28,105,133,496.0,82,5.34,48,269,2463,8.9,0.41240662
5356,5356,Cody Franson,2015-16,28.0,7,36,78,78,7,29,36,127.0,1531.0,400,35,134,169,623.0,82,5.32,47,251,2453,8.9,0.42960194
5357,5357,Cody Franson,2016-17,29.0,8,17,59,59,4,13,17,92.0,993.0,459,39,147,186,715.0,82,5.34,48,255,2438,9.0,0.31081572
5358,5358,Cody Franson,2017-18,30.0,9,19,68,68,3,16,19,93.0,1257.0,527,42,163,205,808.0,82,5.45,47,245,2478,9.0,0.28847867
5359,5359,Cody Franson,2018-19,31.0,10,7,23,23,1,6,7,51.0,382.0,550,43,169,212,859.0,82,5.86,50,250,2620,9.2,0.2652413
5360,5360,Cody Glass,2020-21,21.0,2,12,39,39,5,7,12,51.0,521.0,39,5,7,12,51.0,70,5.96,42,208,2192,9.5,0.3540819
5361,5361,Cody Goloubef,2012-13,23.0,2,0,1,1,0,0,0,0.0,6.0,1,0,0,0,0.0,82,5.32,47,271,2439,8.9,0.14553902
5362,5362,Cody Goloubef,2013-14,24.0,3,1,11,11,1,0,1,14.0,163.0,12,1,0,1,14.0,48,5.31,29,160,1399,9.1,0.22630042
5363,5363,Cody Goloubef,2014-15,25.0,4,0,5,5,0,0,0,4.0,49.0,17,1,0,1,18.0,82,5.34,48,269,2463,8.9,0.15428531
5364,5364,Cody Goloubef,2015-16,26.0,5,9,36,36,0,9,9,23.0,560.0,53,1,9,10,41.0,82,5.32,47,251,2453,8.9,0.14592808
5365,5365,Cody Goloubef,2016-17,27.0,6,8,43,43,1,7,8,40.0,650.0,96,2,16,18,81.0,82,5.34,48,255,2438,9.0,0.14740792
5366,5366,Cody Goloubef,2017-18,28.0,7,5,33,33,0,5,5,35.0,561.0,129,2,21,23,116.0,82,5.45,47,245,2478,9.0,0.13990027
5367,5367,Cody Goloubef,2019-20,30.0,8,0,5,5,0,0,0,3.0,54.0,134,2,21,23,119.0,82,5.96,47,239,2579,9.5,0.11325392
5368,5368,Cody Goloubef,2020-21,31.0,9,2,26,26,1,1,2,18.0,395.0,160,3,22,25,137.0,70,5.96,42,208,2192,9.5,0.11144456
5369,5369,Cody Hodgson,2011-12,21.0,2,2,8,8,1,1,2,9.0,62.0,8,1,1,2,9.0,82,5.46,52,291,2492,9.0,0.26181984
5370,5370,Cody Hodgson,2012-13,22.0,3,41,83,83,19,22,41,154.0,1147.0,91,20,23,43,163.0,82,5.32,47,271,2439,8.9,0.5655099
5371,5371,Cody Hodgson,2013-14,23.0,4,34,48,48,15,19,34,114.0,883.0,139,35,42,77,277.0,48,5.31,29,160,1399,9.1,0.60443103
5372,5372,Cody Hodgson,2014-15,24.0,5,44,72,72,20,24,44,182.0,1306.0,211,55,66,121,459.0,82,5.34,48,269,2463,8.9,0.59997284
5373,5373,Cody Hodgson,2015-16,25.0,6,13,78,78,6,7,13,127.0,1002.0,289,61,73,134,586.0,82,5.32,47,251,2453,8.9,0.31129587
5374,5374,Cody Hodgson,2016-17,26.0,7,8,39,39,3,5,8,65.0,419.0,328,64,78,142,651.0,82,5.34,48,255,2438,9.0,0.2965815
5375,5375,Cody Kunyk,2014-15,24.0,2,0,1,1,0,0,0,2.0,10.0,1,0,0,0,2.0,82,5.34,48,269,2463,8.9,0.16720265
5376,5376,Cody McCormick,2004-05,21.0,2,5,44,44,2,3,5,33.0,357.0,44,2,3,5,33.0,82,5.14,57,348,2300,9.2,0.22860885
5377,5377,Cody McCormick,2006-07,23.0,3,8,45,45,4,4,8,43.0,347.0,89,6,7,13,76.0,82,6.05,85,480,2458,10.1,0.21531469
5378,5378,Cody McCormick,2007-08,24.0,4,1,6,6,0,1,1,6.0,40.0,95,6,8,14,82.0,82,5.76,70,398,2426,9.7,0.18584025
5379,5379,Cody McCormick,2008-09,25.0,5,4,40,40,2,2,4,45.0,439.0,135,8,10,18,127.0,82,5.44,62,351,2383,9.4,0.16980863
5380,5380,Cody McCormick,2009-10,26.0,6,12,55,55,1,11,12,66.0,528.0,190,9,21,30,193.0,82,5.7,65,341,2477,9.4,0.18566018
5381,5381,Cody McCormick,2011-12,28.0,7,20,81,81,8,12,20,104.0,887.0,271,17,33,50,297.0,82,5.46,52,291,2492,9.0,0.22703907
5382,5382,Cody McCormick,2012-13,29.0,8,4,50,50,1,3,4,43.0,392.0,321,18,36,54,340.0,82,5.32,47,271,2439,8.9,0.13285655
5383,5383,Cody McCormick,2013-14,30.0,9,0,8,8,0,0,0,6.0,52.0,329,18,36,54,346.0,48,5.31,29,160,1399,9.1,0.1458886
5384,5384,Cody McCormick,2014-15,31.0,10,7,43,43,2,5,7,26.0,383.0,372,20,41,61,372.0,82,5.34,48,269,2463,8.9,0.12330338
5385,5385,Cody McCormick,2015-16,32.0,11,4,33,33,1,3,4,31.0,387.0,405,21,44,65,403.0,82,5.32,47,251,2453,8.9,0.14089236
5386,5386,Cody McLeod,2008-09,24.0,2,9,49,49,4,5,9,60.0,496.0,49,4,5,9,60.0,82,5.44,62,351,2383,9.4,0.21264017
5387,5387,Cody McLeod,2009-10,25.0,3,20,79,79,15,5,20,118.0,915.0,128,19,10,29,178.0,82,5.7,65,341,2477,9.4,0.32046154
5388,5388,Cody McLeod,2010-11,26.0,4,18,74,74,7,11,18,117.0,957.0,202,26,21,47,295.0,82,5.53,56,304,2486,9.1,0.2783488
5389,5389,Cody McLeod,2011-12,27.0,5,8,71,71,5,3,8,73.0,694.0,273,31,24,55,368.0,82,5.46,52,291,2492,9.0,0.20099926
5390,5390,Cody McLeod,2012-13,28.0,6,11,75,75,6,5,11,62.0,540.0,348,37,29,66,430.0,82,5.32,47,271,2439,8.9,0.17493561
5391,5391,Cody McLeod,2013-14,29.0,7,12,48,48,8,4,12,79.0,628.0,396,45,33,78,509.0,48,5.31,29,160,1399,9.1,0.274716
5392,5392,Cody McLeod,2014-15,30.0,8,13,71,71,5,8,13,76.0,733.0,467,50,41,91,585.0,82,5.34,48,269,2463,8.9,0.19775468
5393,5393,Cody McLeod,2015-16,31.0,9,12,82,82,7,5,12,94.0,917.0,549,57,46,103,679.0,82,5.32,47,251,2453,8.9,0.19541451
5394,5394,Cody McLeod,2016-17,32.0,10,13,82,82,8,5,13,73.0,864.0,631,65,51,116,752.0,82,5.34,48,255,2438,9.0,0.1918987
5395,5395,Cody McLeod,2017-18,33.0,11,6,59,59,5,1,6,30.0,423.0,690,70,52,122,782.0,82,5.45,47,245,2478,9.0,0.107714206
5396,5396,Cody McLeod,2018-19,34.0,12,4,48,48,1,3,4,36.0,354.0,738,71,55,126,818.0,82,5.86,50,250,2620,9.2,0.14040887
5397,5397,Cody McLeod,2019-20,35.0,13,1,38,38,1,0,1,22.0,246.0,776,72,55,127,840.0,82,5.96,47,239,2579,9.5,0.11610076
5398,5398,Colby Armstrong,2006-07,24.0,2,40,47,47,16,24,40,86.0,896.0,47,16,24,40,86.0,82,6.05,85,480,2458,10.1,0.63017297
5399,5399,Colby Armstrong,2007-08,25.0,3,34,80,80,12,22,34,145.0,1346.0,127,28,46,74,231.0,82,5.76,70,398,2426,9.7,0.44828188
5400,5400,Colby Armstrong,2008-09,26.0,4,35,72,72,13,22,35,113.0,1157.0,199,41,68,109,344.0,82,5.44,62,351,2383,9.4,0.49250683
5401,5401,Colby Armstrong,2009-10,27.0,5,40,82,82,22,18,40,141.0,1243.0,281,63,86,149,485.0,82,5.7,65,341,2477,9.4,0.47562292
5402,5402,Colby Armstrong,2010-11,28.0,6,29,79,79,15,14,29,101.0,1169.0,360,78,100,178,586.0,82,5.53,56,304,2486,9.1,0.4201165
5403,5403,Colby Armstrong,2011-12,29.0,7,23,50,50,8,15,23,69.0,806.0,410,86,115,201,655.0,82,5.46,52,291,2492,9.0,0.39126688
5404,5404,Colby Armstrong,2012-13,30.0,8,3,29,29,1,2,3,14.0,270.0,439,87,117,204,669.0,82,5.32,47,271,2439,8.9,0.24393451
5405,5405,Colby Armstrong,2013-14,31.0,9,5,37,37,2,3,5,33.0,414.0,476,89,120,209,702.0,48,5.31,29,160,1399,9.1,0.2543752
5406,5406,Colby Cave,2018-19,24.0,2,0,3,3,0,0,0,2.0,34.0,3,0,0,0,2.0,82,5.86,50,250,2620,9.2,0.16909173
5407,5407,Colby Cave,2019-20,25.0,3,8,53,53,3,5,8,58.0,653.0,56,3,5,8,60.0,82,5.96,47,239,2579,9.5,0.16842982
5408,5408,Colby Cave,2020-21,26.0,4,1,11,11,1,0,1,5.0,106.0,67,4,5,9,65.0,70,5.96,42,208,2192,9.5,0.18479642
5409,5409,Colby Cohen,2011-12,22.0,2,0,3,3,0,0,0,2.0,53.0,3,0,0,0,2.0,82,5.46,52,291,2492,9.0,0.1732291
5410,5410,Colby Robak,2012-13,22.0,2,0,3,3,0,0,0,1.0,38.0,3,0,0,0,1.0,82,5.32,47,271,2439,8.9,0.1610541
5411,5411,Colby Robak,2013-14,23.0,3,1,16,16,0,1,1,15.0,243.0,19,0,1,1,16.0,48,5.31,29,160,1399,9.1,0.2016888
5412,5412,Colby Robak,2014-15,24.0,4,2,16,16,0,2,2,15.0,297.0,35,0,3,3,31.0,82,5.34,48,269,2463,8.9,0.16973636
5413,5413,Colby Robak,2015-16,25.0,5,1,12,12,0,1,1,8.0,167.0,47,0,4,4,39.0,82,5.32,47,251,2453,8.9,0.1369113
5414,5414,Cole Bardreau,2020-21,27.0,2,2,10,10,1,1,2,10.0,89.0,10,1,1,2,10.0,70,5.96,42,208,2192,9.5,0.2545405
5415,5415,Cole Jarrett,2006-07,24.0,2,0,1,1,0,0,0,1.0,14.0,1,0,0,0,1.0,82,6.05,85,480,2458,10.1,0.16345963
5416,5416,Cole Schneider,2016-17,26.0,2,0,2,2,0,0,0,5.0,25.0,2,0,0,0,5.0,82,5.34,48,255,2438,9.0,0.16531053
5417,5417,Cole Schneider,2017-18,27.0,3,1,4,4,0,1,1,6.0,29.0,6,0,1,1,11.0,82,5.45,47,245,2478,9.0,0.18063876
5418,5418,Colin Blackwell,2019-20,26.0,2,0,6,6,0,0,0,5.0,58.0,6,0,0,0,5.0,82,5.96,47,239,2579,9.5,0.1706697
5419,5419,Colin Blackwell,2020-21,27.0,3,10,27,27,3,7,10,31.0,296.0,33,3,7,10,36.0,70,5.96,42,208,2192,9.5,0.27265707
5420,5420,Colin Chisholm,1987-88,24.0,2,0,1,1,0,0,0,0.0,,1,0,0,0,0.0,80,7.34,72,344,2400,12.2,0.1957523
5421,5421,Colin Forbes,1997-98,21.0,2,1,3,3,1,0,1,3.0,,3,1,0,1,3.0,82,5.83,55,336,2444,9.8,0.24363232
5422,5422,Colin Forbes,1998-99,22.0,3,19,63,63,12,7,19,93.0,,66,13,7,20,96.0,82,5.28,57,380,2242,9.6,0.33534706
5423,5423,Colin Forbes,1999-00,23.0,4,20,80,80,12,8,20,117.0,1076.0,146,25,15,40,213.0,82,5.27,57,359,2285,9.4,0.32478333
5424,5424,Colin Forbes,2000-01,24.0,5,7,53,53,2,5,7,57.0,457.0,199,27,20,47,270.0,82,5.49,53,331,2294,9.8,0.2040225
5425,5425,Colin Forbes,2001-02,25.0,6,6,58,58,1,5,6,46.0,390.0,257,28,25,53,316.0,82,5.51,63,376,2272,9.9,0.1813421
5426,5426,Colin Forbes,2002-03,26.0,7,8,38,38,5,3,8,49.0,419.0,295,33,28,61,365.0,82,5.24,53,338,2262,9.5,0.21855444
5427,5427,Colin Forbes,2003-04,27.0,8,0,5,5,0,0,0,3.0,48.0,300,33,28,61,368.0,82,5.31,60,363,2326,9.4,0.16210932
5428,5428,Colin Forbes,2004-05,28.0,9,0,2,2,0,0,0,2.0,18.0,302,33,28,61,370.0,82,5.14,57,348,2300,9.2,0.19750372
5429,5429,Colin Forbes,2006-07,30.0,10,0,9,9,0,0,0,10.0,74.0,311,33,28,61,380.0,82,6.05,85,480,2458,10.1,0.1789766
5430,5430,Colin Fraser,2007-08,23.0,2,0,1,1,0,0,0,0.0,3.0,1,0,0,0,0.0,82,5.76,70,398,2426,9.7,0.15239856
5431,5431,Colin Fraser,2008-09,24.0,3,0,5,5,0,0,0,4.0,52.0,6,0,0,0,4.0,82,5.44,62,351,2383,9.4,0.16378409
5432,5432,Colin Fraser,2009-10,25.0,4,17,81,81,6,11,17,67.0,883.0,87,6,11,17,71.0,82,5.7,65,341,2477,9.4,0.21660718
5433,5433,Colin Fraser,2010-11,26.0,5,19,70,70,7,12,19,92.0,672.0,157,13,23,36,163.0,82,5.53,56,304,2486,9.1,0.26246005
5434,5434,Colin Fraser,2011-12,27.0,6,5,67,67,3,2,5,57.0,688.0,224,16,25,41,220.0,82,5.46,52,291,2492,9.0,0.13361448
5435,5435,Colin Fraser,2012-13,28.0,7,8,67,67,2,6,8,54.0,652.0,291,18,31,49,274.0,82,5.32,47,271,2439,8.9,0.13717017
5436,5436,Colin Fraser,2013-14,29.0,8,7,34,34,2,5,7,19.0,319.0,325,20,36,56,293.0,48,5.31,29,160,1399,9.1,0.18157727
5437,5437,Colin Fraser,2014-15,30.0,9,2,33,33,0,2,2,22.0,297.0,358,20,38,58,315.0,82,5.34,48,269,2463,8.9,0.12964633
5438,5438,Colin Fraser,2015-16,31.0,10,0,1,1,0,0,0,1.0,5.0,359,20,38,58,316.0,82,5.32,47,251,2453,8.9,0.16713801
5439,5439,Colin Greening,2011-12,25.0,2,13,24,24,6,7,13,57.0,362.0,24,6,7,13,57.0,82,5.46,52,291,2492,9.0,0.32559907
5440,5440,Colin Greening,2012-13,26.0,3,37,82,82,17,20,37,184.0,1278.0,106,23,27,50,241.0,82,5.32,47,271,2439,8.9,0.5031936
5441,5441,Colin Greening,2013-14,27.0,4,19,47,47,8,11,19,80.0,692.0,153,31,38,69,321.0,48,5.31,29,160,1399,9.1,0.43169066
5442,5442,Colin Greening,2014-15,28.0,5,17,76,76,6,11,17,108.0,1045.0,229,37,49,86,429.0,82,5.34,48,269,2463,8.9,0.25803816
5443,5443,Colin Greening,2015-16,29.0,6,1,26,26,1,0,1,39.0,255.0,255,38,49,87,468.0,82,5.32,47,251,2453,8.9,0.2099647
5444,5444,Colin Greening,2016-17,30.0,7,15,31,31,7,8,15,58.0,437.0,286,45,57,102,526.0,82,5.34,48,255,2438,9.0,0.31104213
5445,5445,Colin Hemingway,2006-07,26.0,2,0,3,3,0,0,0,2.0,22.0,3,0,0,0,2.0,82,6.05,85,480,2458,10.1,0.16018337
5446,5446,Colin McDonald,2010-11,26.0,2,1,2,2,1,0,1,3.0,13.0,2,1,0,1,3.0,82,5.53,56,304,2486,9.1,0.19829145
5447,5447,Colin McDonald,2012-13,28.0,3,0,5,5,0,0,0,6.0,42.0,7,1,0,1,9.0,82,5.32,47,271,2439,8.9,0.16553703
5448,5448,Colin McDonald,2013-14,29.0,4,17,45,45,7,10,17,82.0,512.0,52,8,10,18,91.0,48,5.31,29,160,1399,9.1,0.35382375
5449,5449,Colin McDonald,2014-15,30.0,5,18,70,70,8,10,18,96.0,867.0,122,16,20,36,187.0,82,5.34,48,269,2463,8.9,0.24757549
5450,5450,Colin McDonald,2015-16,31.0,6,8,18,18,2,6,8,29.0,189.0,140,18,26,44,216.0,82,5.32,47,251,2453,8.9,0.2211943
5451,5451,Colin McDonald,2016-17,32.0,7,1,5,5,1,0,1,4.0,41.0,145,19,26,45,220.0,82,5.34,48,255,2438,9.0,0.16608045
5452,5452,Colin McDonald,2017-18,33.0,8,1,3,3,1,0,1,5.0,27.0,148,20,26,46,225.0,82,5.45,47,245,2478,9.0,0.16359922
5453,5453,Colin Miller,2016-17,24.0,2,16,42,42,3,13,16,59.0,663.0,42,3,13,16,59.0,82,5.34,48,255,2438,9.0,0.29274732
5454,5454,Colin Miller,2017-18,25.0,3,13,61,61,6,7,13,85.0,965.0,103,9,20,29,144.0,82,5.45,47,245,2478,9.0,0.2708046
5455,5455,Colin Miller,2018-19,26.0,4,41,82,82,10,31,41,177.0,1586.0,185,19,51,70,321.0,82,5.86,50,250,2620,9.2,0.49931857
5456,5456,Colin Miller,2019-20,27.0,5,29,65,65,3,26,29,131.0,1277.0,250,22,77,99,452.0,82,5.96,47,239,2579,9.5,0.397664
5457,5457,Colin Miller,2020-21,28.0,6,11,51,51,1,10,11,79.0,874.0,301,23,87,110,531.0,70,5.96,42,208,2192,9.5,0.26613572
5458,5458,Colin Patterson,1984-85,24.0,2,27,56,56,13,14,27,87.0,,56,13,14,27,87.0,80,7.89,74,336,2448,12.9,0.46268415
5459,5459,Colin Patterson,1985-86,25.0,3,43,57,57,22,21,43,104.0,,113,35,35,70,191.0,80,7.77,71,321,2447,12.7,0.6518344
5460,5460,Colin Patterson,1986-87,26.0,4,27,61,61,14,13,27,84.0,,174,49,48,97,275.0,80,7.94,82,370,2484,12.8,0.43317875
5461,5461,Colin Patterson,1987-88,27.0,5,26,68,68,13,13,26,78.0,,242,62,61,123,353.0,80,7.34,72,344,2400,12.2,0.40508932
5462,5462,Colin Patterson,1988-89,28.0,6,18,39,39,7,11,18,37.0,,281,69,72,141,390.0,80,7.43,89,437,2435,12.2,0.43632728
5463,5463,Colin Patterson,1989-90,29.0,7,38,74,74,14,24,38,103.0,,355,83,96,179,493.0,80,7.48,85,403,2430,12.3,0.44997782
5464,5464,Colin Patterson,1990-91,30.0,8,8,61,61,5,3,8,56.0,,416,88,99,187,549.0,80,7.37,76,367,2421,12.2,0.23149434
5465,5465,Colin Patterson,1992-93,32.0,9,12,52,52,4,8,12,33.0,,468,92,107,199,582.0,80,6.96,77,402,2440,11.4,0.28474534
5466,5466,Colin Patterson,1993-94,33.0,10,6,36,36,4,2,6,30.0,,504,96,109,205,612.0,84,7.25,87,443,2603,11.7,0.22339132
5467,5467,Colin Smith,2015-16,22.0,2,0,1,1,0,0,0,1.0,6.0,1,0,0,0,1.0,82,5.32,47,251,2453,8.9,0.16728714
5468,5468,Colin Stuart,2008-09,26.0,2,5,18,18,3,2,5,19.0,222.0,18,3,2,5,19.0,82,5.44,62,351,2383,9.4,0.23256949
5469,5469,Colin Stuart,2009-10,27.0,3,8,33,33,5,3,8,54.0,412.0,51,8,5,13,73.0,82,5.7,65,341,2477,9.4,0.25161242
5470,5470,Colin Stuart,2011-12,29.0,4,0,3,3,0,0,0,5.0,39.0,54,8,5,13,78.0,82,5.46,52,291,2492,9.0,0.15525013
5471,5471,Colin Stuart,2012-13,30.0,5,0,2,2,0,0,0,0.0,12.0,56,8,5,13,78.0,82,5.32,47,271,2439,8.9,0.13380048
5472,5472,Colin White,2000-01,23.0,2,3,21,21,2,1,3,29.0,310.0,21,2,1,3,29.0,82,5.49,53,331,2294,9.8,0.24275997
5473,5473,Colin White,2001-02,24.0,3,20,82,82,1,19,20,114.0,1567.0,103,3,20,23,143.0,82,5.51,63,376,2272,9.9,0.2614473
5474,5474,Colin White,2002-03,25.0,4,5,73,73,2,3,5,81.0,1467.0,176,5,23,28,224.0,82,5.24,53,338,2262,9.5,0.17810097
5475,5475,Colin White,2003-04,26.0,5,13,72,72,5,8,13,81.0,1417.0,248,10,31,41,305.0,82,5.31,60,363,2326,9.4,0.21453309
5476,5476,Colin White,2004-05,27.0,6,13,75,75,2,11,13,61.0,1577.0,323,12,42,54,366.0,82,5.14,57,348,2300,9.2,0.19196677
5477,5477,Colin White,2006-07,29.0,7,17,73,73,3,14,17,60.0,1591.0,396,15,56,71,426.0,82,6.05,85,480,2458,10.1,0.18274498
5478,5478,Colin White,2007-08,30.0,8,8,69,69,0,8,8,47.0,1550.0,465,15,64,79,473.0,82,5.76,70,398,2426,9.7,0.14307475
5479,5479,Colin White,2008-09,31.0,9,10,57,57,2,8,10,27.0,1121.0,522,17,72,89,500.0,82,5.44,62,351,2383,9.4,0.1589253
5480,5480,Colin White,2009-10,32.0,10,18,71,71,1,17,18,68.0,1350.0,593,18,89,107,568.0,82,5.7,65,341,2477,9.4,0.21539924
5481,5481,Colin White,2010-11,33.0,11,12,81,81,2,10,12,47.0,1626.0,674,20,99,119,615.0,82,5.53,56,304,2486,9.1,0.12806123
5482,5482,Colin White,2011-12,34.0,12,6,69,69,0,6,6,50.0,1301.0,743,20,105,125,665.0,82,5.46,52,291,2492,9.0,0.11652368
5483,5483,Colin White,2012-13,35.0,13,4,54,54,1,3,4,33.0,807.0,797,21,108,129,698.0,82,5.32,47,271,2439,8.9,0.11683658
5484,5484,Colin White0,2017-18,21.0,2,0,2,2,0,0,0,1.0,27.0,2,0,0,0,1.0,82,5.45,47,245,2478,9.0,0.23246074
5485,5485,Colin White0,2018-19,22.0,3,6,21,21,2,4,6,24.0,280.0,23,2,4,6,25.0,82,5.86,50,250,2620,9.2,0.26363483
5486,5486,Colin White0,2019-20,23.0,4,41,71,71,14,27,41,123.0,1150.0,94,16,31,47,148.0,82,5.96,47,239,2579,9.5,0.52440375
5487,5487,Colin White0,2020-21,24.0,5,23,61,61,7,16,23,83.0,958.0,155,23,47,70,231.0,70,5.96,42,208,2192,9.5,0.39089298
5488,5488,Colin Wilson,2010-11,21.0,2,15,35,35,8,7,15,58.0,531.0,35,8,7,15,58.0,82,5.53,56,304,2486,9.1,0.39198643
5489,5489,Colin Wilson,2011-12,22.0,3,34,82,82,16,18,34,101.0,1090.0,117,24,25,49,159.0,82,5.46,52,291,2492,9.0,0.45840704
5490,5490,Colin Wilson,2012-13,23.0,4,35,68,68,15,20,35,114.0,1097.0,185,39,45,84,273.0,82,5.32,47,271,2439,8.9,0.51729065
5491,5491,Colin Wilson,2013-14,24.0,5,19,25,25,7,12,19,26.0,414.0,210,46,57,103,299.0,48,5.31,29,160,1399,9.1,0.56762624
5492,5492,Colin Wilson,2014-15,25.0,6,33,81,81,11,22,33,112.0,1233.0,291,57,79,136,411.0,82,5.34,48,269,2463,8.9,0.42034116
5493,5493,Colin Wilson,2015-16,26.0,7,42,77,77,20,22,42,172.0,1248.0,368,77,101,178,583.0,82,5.32,47,251,2453,8.9,0.5571356
5494,5494,Colin Wilson,2016-17,27.0,8,24,64,64,6,18,24,108.0,925.0,432,83,119,202,691.0,82,5.34,48,255,2438,9.0,0.36451024
5495,5495,Colin Wilson,2017-18,28.0,9,35,70,70,12,23,35,113.0,1047.0,502,95,142,237,804.0,82,5.45,47,245,2478,9.0,0.43514523
5496,5496,Colin Wilson,2018-19,29.0,10,18,56,56,6,12,18,75.0,735.0,558,101,154,255,879.0,82,5.86,50,250,2620,9.2,0.3653631
5497,5497,Colin Wilson,2019-20,30.0,11,27,65,65,12,15,27,104.0,882.0,623,113,169,282,983.0,82,5.96,47,239,2579,9.5,0.35890138
5498,5498,Colin Wilson,2020-21,31.0,12,4,9,9,0,4,4,12.0,114.0,632,113,173,286,995.0,70,5.96,42,208,2192,9.5,0.29058608
5499,5499,Colten Teubert,2012-13,22.0,2,1,24,24,0,1,1,13.0,303.0,24,0,1,1,13.0,82,5.32,47,271,2439,8.9,0.12601179
5500,5500,Colton Gillies,2009-10,20.0,2,7,45,45,2,5,7,22.0,370.0,45,2,5,7,22.0,82,5.7,65,341,2477,9.4,0.20650145
5501,5501,Colton Gillies,2011-12,22.0,3,1,7,7,1,0,1,3.0,73.0,52,3,5,8,25.0,82,5.46,52,291,2492,9.0,0.21152064
5502,5502,Colton Gillies,2012-13,23.0,4,8,75,75,2,6,8,48.0,757.0,127,5,11,16,73.0,82,5.32,47,271,2439,8.9,0.17780185
5503,5503,Colton Gillies,2013-14,24.0,5,2,27,27,1,1,2,17.0,224.0,154,6,12,18,90.0,48,5.31,29,160,1399,9.1,0.15900326
5504,5504,Colton Orr,2004-05,22.0,2,0,1,1,0,0,0,0.0,2.0,1,0,0,0,0.0,82,5.14,57,348,2300,9.2,0.28400066
5505,5505,Colton Orr,2006-07,24.0,3,1,35,35,0,1,1,1.0,101.0,36,0,1,1,1.0,82,6.05,85,480,2458,10.1,0.11339828
5506,5506,Colton Orr,2007-08,25.0,4,3,53,53,2,1,3,23.0,282.0,89,2,2,4,24.0,82,5.76,70,398,2426,9.7,0.10405636
5507,5507,Colton Orr,2008-09,26.0,5,2,74,74,1,1,2,24.0,579.0,163,3,3,6,48.0,82,5.44,62,351,2383,9.4,0.0947071
5508,5508,Colton Orr,2009-10,27.0,6,5,82,82,1,4,5,40.0,532.0,245,4,7,11,88.0,82,5.7,65,341,2477,9.4,0.1222108
5509,5509,Colton Orr,2010-11,28.0,7,6,82,82,4,2,6,43.0,563.0,327,8,9,17,131.0,82,5.53,56,304,2486,9.1,0.11475116
5510,5510,Colton Orr,2011-12,29.0,8,2,46,46,2,0,2,14.0,233.0,373,10,9,19,145.0,82,5.46,52,291,2492,9.0,0.09129879
5511,5511,Colton Orr,2012-13,30.0,9,1,5,5,1,0,1,3.0,22.0,378,11,9,20,148.0,82,5.32,47,271,2439,8.9,0.11362526
5512,5512,Colton Orr,2013-14,31.0,10,4,44,44,1,3,4,13.0,281.0,422,12,12,24,161.0,48,5.31,29,160,1399,9.1,0.075493634
5513,5513,Colton Orr,2014-15,32.0,11,0,54,54,0,0,0,12.0,290.0,476,12,12,24,173.0,82,5.34,48,269,2463,8.9,0.03949994
5514,5514,Colton Orr,2015-16,33.0,12,0,1,1,0,0,0,0.0,6.0,477,12,12,24,173.0,82,5.32,47,251,2453,8.9,0.09894362
5515,5515,Colton Parayko,2016-17,23.0,2,33,79,79,9,24,33,165.0,1532.0,79,9,24,33,165.0,82,5.34,48,255,2438,9.0,0.45710576
5516,5516,Colton Parayko,2017-18,24.0,3,35,81,81,4,31,35,188.0,1717.0,160,13,55,68,353.0,82,5.45,47,245,2478,9.0,0.4213678
5517,5517,Colton Parayko,2018-19,25.0,4,35,82,82,6,29,35,212.0,1854.0,242,19,84,103,565.0,82,5.86,50,250,2620,9.2,0.48604268
5518,5518,Colton Parayko,2019-20,26.0,5,28,80,80,10,18,28,176.0,1823.0,322,29,102,131,741.0,82,5.96,47,239,2579,9.5,0.46477455
5519,5519,Colton Parayko,2020-21,27.0,6,28,64,64,10,18,28,162.0,1472.0,386,39,120,159,903.0,70,5.96,42,208,2192,9.5,0.47495034
5520,5520,Colton Sceviour,2011-12,22.0,2,0,1,1,0,0,0,0.0,5.0,1,0,0,0,0.0,82,5.46,52,291,2492,9.0,0.157395
5521,5521,Colton Sceviour,2013-14,24.0,3,1,1,1,0,1,1,0.0,5.0,2,0,1,1,0.0,48,5.31,29,160,1399,9.1,0.21218717
5522,5522,Colton Sceviour,2014-15,25.0,4,12,26,26,8,4,12,69.0,387.0,28,8,5,13,69.0,82,5.34,48,269,2463,8.9,0.2876025
5523,5523,Colton Sceviour,2015-16,26.0,5,26,71,71,9,17,26,113.0,903.0,99,17,22,39,182.0,82,5.32,47,251,2453,8.9,0.3240496
5524,5524,Colton Sceviour,2016-17,27.0,6,23,71,71,11,12,23,125.0,900.0,170,28,34,62,307.0,82,5.34,48,255,2438,9.0,0.2874884
5525,5525,Colton Sceviour,2017-18,28.0,7,24,80,80,9,15,24,172.0,1171.0,250,37,49,86,479.0,82,5.45,47,245,2478,9.0,0.33751294
5526,5526,Colton Sceviour,2018-19,29.0,8,24,76,76,11,13,24,141.0,1021.0,326,48,62,110,620.0,82,5.86,50,250,2620,9.2,0.2887855
5527,5527,Colton Sceviour,2019-20,30.0,9,15,59,59,5,10,15,116.0,725.0,385,53,72,125,736.0,82,5.96,47,239,2579,9.5,0.25901937
5528,5528,Colton Sceviour,2020-21,31.0,10,16,69,69,6,10,16,114.0,914.0,454,59,82,141,850.0,70,5.96,42,208,2192,9.5,0.2674452
5529,5529,Colton Sissons,2014-15,21.0,2,4,17,17,1,3,4,13.0,181.0,17,1,3,4,13.0,82,5.34,48,269,2463,8.9,0.25250512
5530,5530,Colton Sissons,2016-17,23.0,3,6,34,34,4,2,6,25.0,339.0,51,5,5,10,38.0,82,5.34,48,255,2438,9.0,0.23981762
5531,5531,Colton Sissons,2017-18,24.0,4,10,58,58,8,2,10,42.0,645.0,109,13,7,20,80.0,82,5.45,47,245,2478,9.0,0.22151205
5532,5532,Colton Sissons,2018-19,25.0,5,27,81,81,9,18,27,120.0,1304.0,190,22,25,47,200.0,82,5.86,50,250,2620,9.2,0.30398083
5533,5533,Colton Sissons,2019-20,26.0,6,30,75,75,15,15,30,110.0,1203.0,265,37,40,77,310.0,82,5.96,47,239,2579,9.5,0.39907825
5534,5534,Colton Sissons,2020-21,27.0,7,15,57,57,9,6,15,52.0,817.0,322,46,46,92,362.0,70,5.96,42,208,2192,9.5,0.25957504
5535,5535,Colton White,2019-20,22.0,2,0,3,3,0,0,0,1.0,43.0,3,0,0,0,1.0,82,5.96,47,239,2579,9.5,0.17780572
5536,5536,Colton White,2020-21,23.0,3,0,6,6,0,0,0,2.0,84.0,9,0,0,0,3.0,70,5.96,42,208,2192,9.5,0.19304231
5537,5537,Connor Brickley,2016-17,24.0,2,5,23,23,1,4,5,13.0,201.0,23,1,4,5,13.0,82,5.34,48,255,2438,9.0,0.16018426
5538,5538,Connor Brickley,2018-19,26.0,3,12,44,44,4,8,12,62.0,523.0,67,5,12,17,75.0,82,5.86,50,250,2620,9.2,0.21922272
5539,5539,Connor Brickley,2019-20,27.0,4,4,14,14,1,3,4,18.0,126.0,81,6,15,21,93.0,82,5.96,47,239,2579,9.5,0.20825323
5540,5540,Connor Brown,2016-17,23.0,2,6,7,7,1,5,6,11.0,105.0,7,1,5,6,11.0,82,5.34,48,255,2438,9.0,0.24579802
5541,5541,Connor Brown,2017-18,24.0,3,36,82,82,20,16,36,139.0,1329.0,89,21,21,42,150.0,82,5.45,47,245,2478,9.0,0.4550799
5542,5542,Connor Brown,2018-19,25.0,4,28,82,82,14,14,28,119.0,1231.0,171,35,35,70,269.0,82,5.86,50,250,2620,9.2,0.38090003
5543,5543,Connor Brown,2019-20,26.0,5,29,82,82,8,21,29,85.0,1131.0,253,43,56,99,354.0,82,5.96,47,239,2579,9.5,0.38229248
5544,5544,Connor Brown,2020-21,27.0,6,43,71,71,16,27,43,173.0,1428.0,324,59,83,142,527.0,70,5.96,42,208,2192,9.5,0.5458723
5545,5545,Connor Bunnaman,2020-21,22.0,2,2,21,21,1,1,2,18.0,195.0,21,1,1,2,18.0,70,5.96,42,208,2192,9.5,0.20672297
5546,5546,Connor Carrick,2014-15,20.0,2,6,34,34,1,5,6,26.0,543.0,34,1,5,6,26.0,82,5.34,48,269,2463,8.9,0.25425944
5547,5547,Connor Carrick,2016-17,22.0,3,4,19,19,2,2,4,21.0,295.0,53,3,7,10,47.0,82,5.34,48,255,2438,9.0,0.22963047
5548,5548,Connor Carrick,2017-18,23.0,4,8,67,67,2,6,8,89.0,1095.0,120,5,13,18,136.0,82,5.45,47,245,2478,9.0,0.21875939
5549,5549,Connor Carrick,2018-19,24.0,5,12,47,47,4,8,12,55.0,711.0,167,9,21,30,191.0,82,5.86,50,250,2620,9.2,0.21839255
5550,5550,Connor Carrick,2019-20,25.0,6,11,34,34,2,9,11,42.0,571.0,201,11,30,41,233.0,82,5.96,47,239,2579,9.5,0.1971964
5551,5551,Connor Carrick,2020-21,26.0,7,6,29,29,1,5,6,25.0,418.0,230,12,35,47,258.0,70,5.96,42,208,2192,9.5,0.1972056
5552,5552,Connor Clifton,2019-20,24.0,2,1,19,19,0,1,1,22.0,336.0,19,0,1,1,22.0,82,5.96,47,239,2579,9.5,0.16409609
5553,5553,Connor Clifton,2020-21,25.0,3,2,31,31,2,0,2,20.0,447.0,50,2,1,3,42.0,70,5.96,42,208,2192,9.5,0.20162252
5554,5554,Connor James,2006-07,24.0,2,0,2,2,0,0,0,1.0,15.0,2,0,0,0,1.0,82,6.05,85,480,2458,10.1,0.16345963
5555,5555,Connor James,2008-09,26.0,3,1,13,13,1,0,1,9.0,97.0,15,1,0,1,10.0,82,5.44,62,351,2383,9.4,0.18343002
5556,5556,Connor James,2009-10,27.0,4,0,1,1,0,0,0,0.0,8.0,16,1,0,1,10.0,82,5.7,65,341,2477,9.4,0.15469351
5557,5557,Connor Jones,2017-18,27.0,2,0,4,4,0,0,0,2.0,47.0,4,0,0,0,2.0,82,5.45,47,245,2478,9.0,0.16303438
5558,5558,Connor McDavid,2016-17,20.0,2,48,45,45,16,32,48,105.0,850.0,45,16,32,48,105.0,82,5.34,48,255,2438,9.0,0.96053296
5559,5559,Connor McDavid,2017-18,21.0,3,100,82,82,30,70,100,251.0,1733.0,127,46,102,148,356.0,82,5.45,47,245,2478,9.0,1.2605423
5560,5560,Connor McDavid,2018-19,22.0,4,108,82,82,41,67,108,274.0,1767.0,209,87,169,256,630.0,82,5.86,50,250,2620,9.2,1.4043872
5561,5561,Connor McDavid,2019-20,23.0,5,116,78,78,41,75,116,240.0,1781.0,287,128,244,372,870.0,82,5.96,47,239,2579,9.5,1.3259702
5562,5562,Connor McDavid,2020-21,24.0,6,97,64,64,34,63,97,212.0,1399.0,351,162,307,469,1082.0,70,5.96,42,208,2192,9.5,1.4714731
5563,5563,Connor Murphy,2014-15,21.0,2,8,30,30,1,7,8,30.0,539.0,30,1,7,8,30.0,82,5.34,48,269,2463,8.9,0.25690705
5564,5564,Connor Murphy,2015-16,22.0,3,7,73,73,4,3,7,72.0,1226.0,103,5,10,15,102.0,82,5.32,47,251,2453,8.9,0.22356692
5565,5565,Connor Murphy,2016-17,23.0,4,17,78,78,6,11,17,101.0,1599.0,181,11,21,32,203.0,82,5.34,48,255,2438,9.0,0.27500027
5566,5566,Connor Murphy,2017-18,24.0,5,17,77,77,2,15,17,81.0,1477.0,258,13,36,49,284.0,82,5.45,47,245,2478,9.0,0.2354472
5567,5567,Connor Murphy,2018-19,25.0,6,14,76,76,2,12,14,109.0,1244.0,334,15,48,63,393.0,82,5.86,50,250,2620,9.2,0.20625874
5568,5568,Connor Murphy,2019-20,26.0,7,13,52,52,5,8,13,84.0,1013.0,386,20,56,76,477.0,82,5.96,47,239,2579,9.5,0.25891605
5569,5569,Connor Murphy,2020-21,27.0,8,19,58,58,5,14,19,117.0,1233.0,444,25,70,95,594.0,70,5.96,42,208,2192,9.5,0.32160896
5570,5570,Conor Allen,2014-15,25.0,2,0,3,3,0,0,0,2.0,43.0,3,0,0,0,2.0,82,5.34,48,269,2463,8.9,0.16342145
5571,5571,Conor Allen,2015-16,26.0,3,0,4,4,0,0,0,2.0,49.0,7,0,0,0,4.0,82,5.32,47,251,2453,8.9,0.16056308
5572,5572,Conor Garland,2019-20,23.0,2,18,47,47,13,5,18,118.0,601.0,47,13,5,18,118.0,82,5.96,47,239,2579,9.5,0.43694627
5573,5573,Conor Garland,2020-21,24.0,3,39,68,68,22,17,39,158.0,962.0,115,35,22,57,276.0,70,5.96,42,208,2192,9.5,0.57873005
5574,5574,Conor Sheary,2016-17,24.0,2,10,44,44,7,3,10,51.0,429.0,44,7,3,10,51.0,82,5.34,48,255,2438,9.0,0.261112
5575,5575,Conor Sheary,2017-18,25.0,3,53,61,61,23,30,53,154.0,972.0,105,30,33,63,205.0,82,5.45,47,245,2478,9.0,0.69010556
5576,5576,Conor Sheary,2018-19,26.0,4,30,79,79,18,12,30,142.0,1102.0,184,48,45,93,347.0,82,5.86,50,250,2620,9.2,0.4490354
5577,5577,Conor Sheary,2019-20,27.0,5,34,78,78,14,20,34,147.0,1140.0,262,62,65,127,494.0,82,5.96,47,239,2579,9.5,0.45544127
5578,5578,Conor Sheary,2020-21,28.0,6,23,63,63,10,13,23,102.0,826.0,325,72,78,150,596.0,70,5.96,42,208,2192,9.5,0.36615878
5579,5579,Conor Timmins,2020-21,22.0,2,0,2,2,0,0,0,1.0,21.0,2,0,0,0,1.0,70,5.96,42,208,2192,9.5,0.19735286
5580,5580,Cooper Marody,2019-20,23.0,2,0,6,6,0,0,0,6.0,41.0,6,0,0,0,6.0,82,5.96,47,239,2579,9.5,0.18043473
5581,5581,Corban Knight,2014-15,24.0,2,1,7,7,1,0,1,4.0,56.0,7,1,0,1,4.0,82,5.34,48,269,2463,8.9,0.20015952
5582,5582,Corban Knight,2015-16,25.0,3,0,2,2,0,0,0,2.0,13.0,9,1,0,1,6.0,82,5.32,47,251,2453,8.9,0.16343942
5583,5583,Corban Knight,2016-17,26.0,4,7,20,20,2,5,7,11.0,193.0,29,3,5,8,17.0,82,5.34,48,255,2438,9.0,0.1934967
5584,5584,Corban Knight,2019-20,29.0,5,4,23,23,1,3,4,15.0,223.0,52,4,8,12,32.0,82,5.96,47,239,2579,9.5,0.13744965
5585,5585,Corey Elkins,2010-11,25.0,2,1,3,3,1,0,1,5.0,36.0,3,1,0,1,5.0,82,5.53,56,304,2486,9.1,0.19829145
5586,5586,Corey Foster,1989-90,20.0,2,0,2,2,0,0,0,2.0,,2,0,0,0,2.0,80,7.48,85,403,2430,12.3,0.28046766
5587,5587,Corey Foster,1992-93,23.0,3,7,25,25,3,4,7,67.0,,27,3,4,7,69.0,80,6.96,77,402,2440,11.4,0.34163308
5588,5588,Corey Foster,1996-97,27.0,4,4,11,11,2,2,4,8.0,,38,5,6,11,77.0,82,6.29,74,413,2481,10.4,0.22216654
5589,5589,Corey Foster,1997-98,28.0,5,0,7,7,0,0,0,1.0,,45,5,6,11,78.0,82,5.83,55,336,2444,9.8,0.13608125
5590,5590,Corey Locke,2008-09,24.0,2,0,1,1,0,0,0,1.0,6.0,1,0,0,0,1.0,82,5.44,62,351,2383,9.4,0.17854032
5591,5591,Corey Locke,2010-11,26.0,3,0,3,3,0,0,0,2.0,19.0,4,0,0,0,3.0,82,5.53,56,304,2486,9.1,0.1621441
5592,5592,Corey Locke,2011-12,27.0,4,1,5,5,0,1,1,6.0,46.0,9,0,1,1,9.0,82,5.46,52,291,2492,9.0,0.17392138
5593,5593,Corey Millen,1990-91,26.0,2,0,4,4,0,0,0,4.0,,4,0,0,0,4.0,80,7.37,76,367,2421,12.2,0.21491268
5594,5594,Corey Millen,1991-92,27.0,3,4,4,4,3,1,4,8.0,,8,3,1,4,12.0,80,6.91,71,366,2385,11.6,0.3036456
5595,5595,Corey Millen,1992-93,28.0,4,46,57,57,21,25,46,109.0,,65,24,26,50,121.0,80,6.96,77,402,2440,11.4,0.71191883
5596,5596,Corey Millen,1993-94,29.0,5,39,42,42,23,16,39,100.0,,107,47,42,89,221.0,84,7.25,87,443,2603,11.7,0.6432129
5597,5597,Corey Millen,1994-95,30.0,6,50,78,78,20,30,50,132.0,,185,67,72,139,353.0,84,6.48,76,407,2545,10.7,0.47309566
5598,5598,Corey Millen,1995-96,31.0,7,23,45,45,5,18,23,74.0,,230,72,90,162,427.0,48,5.97,37,209,1408,10.2,0.4951325
5599,5599,Corey Millen,1996-97,32.0,8,21,44,44,7,14,21,73.0,,274,79,104,183,500.0,82,6.29,74,413,2481,10.4,0.46948034
5600,5600,Corey Millen,1997-98,33.0,9,26,61,61,11,15,26,82.0,,335,90,119,209,582.0,82,5.83,55,336,2444,9.8,0.3743807
5601,5601,Corey Perry,2006-07,21.0,2,25,56,56,13,12,25,98.0,648.0,56,13,12,25,98.0,82,6.05,85,480,2458,10.1,0.47522193
5602,5602,Corey Perry,2007-08,22.0,3,44,82,82,17,27,44,194.0,1022.0,138,30,39,69,292.0,82,5.76,70,398,2426,9.7,0.6463025
5603,5603,Corey Perry,2008-09,23.0,4,54,70,70,29,25,54,200.0,1257.0,208,59,64,123,492.0,82,5.44,62,351,2383,9.4,0.76866007
5604,5604,Corey Perry,2009-10,24.0,5,72,78,78,32,40,72,283.0,1451.0,286,91,104,195,775.0,82,5.7,65,341,2477,9.4,0.8912902
5605,5605,Corey Perry,2010-11,25.0,6,76,82,82,27,49,76,270.0,1727.0,368,118,153,271,1045.0,82,5.53,56,304,2486,9.1,0.86262846
5606,5606,Corey Perry,2011-12,26.0,7,98,82,82,50,48,98,290.0,1830.0,450,168,201,369,1335.0,82,5.46,52,291,2492,9.0,1.0109829
5607,5607,Corey Perry,2012-13,27.0,8,60,80,80,37,23,60,277.0,1710.0,530,205,224,429,1612.0,82,5.32,47,271,2439,8.9,0.8050691
5608,5608,Corey Perry,2013-14,28.0,9,36,44,44,15,21,36,128.0,839.0,574,220,245,465,1740.0,48,5.31,29,160,1399,9.1,0.7622807
5609,5609,Corey Perry,2014-15,29.0,10,82,81,81,43,39,82,280.0,1578.0,655,263,284,547,2020.0,82,5.34,48,269,2463,8.9,0.88692635
5610,5610,Corey Perry,2015-16,30.0,11,55,67,67,33,22,55,193.0,1213.0,722,296,306,602,2213.0,82,5.32,47,251,2453,8.9,0.74078774
5611,5611,Corey Perry,2016-17,31.0,12,62,82,82,34,28,62,215.0,1452.0,804,330,334,664,2428.0,82,5.34,48,255,2438,9.0,0.7033156
5612,5612,Corey Perry,2017-18,32.0,13,53,82,82,19,34,53,215.0,1453.0,886,349,368,717,2643.0,82,5.45,47,245,2478,9.0,0.65891606
5613,5613,Corey Perry,2018-19,33.0,14,49,71,71,17,32,49,168.0,1262.0,957,366,400,766,2811.0,82,5.86,50,250,2620,9.2,0.5971841
5614,5614,Corey Perry,2019-20,34.0,15,10,31,31,6,4,10,59.0,460.0,988,372,404,776,2870.0,82,5.96,47,239,2579,9.5,0.35237682
5615,5615,Corey Perry,2020-21,35.0,16,21,57,57,5,16,21,77.0,782.0,1045,377,420,797,2947.0,70,5.96,42,208,2192,9.5,0.32978714
5616,5616,Corey Potter,2009-10,26.0,2,2,5,5,1,1,2,4.0,66.0,5,1,1,2,4.0,82,5.7,65,341,2477,9.4,0.20802072
5617,5617,Corey Potter,2010-11,27.0,3,0,3,3,0,0,0,2.0,36.0,8,1,1,2,6.0,82,5.53,56,304,2486,9.1,0.16174287
5618,5618,Corey Potter,2011-12,28.0,4,0,1,1,0,0,0,1.0,17.0,9,1,1,2,7.0,82,5.46,52,291,2492,9.0,0.15173501
5619,5619,Corey Potter,2012-13,29.0,5,21,62,62,4,17,21,98.0,1237.0,71,5,18,23,105.0,82,5.32,47,271,2439,8.9,0.26304284
5620,5620,Corey Potter,2013-14,30.0,6,4,33,33,3,1,4,36.0,576.0,104,8,19,27,141.0,48,5.31,29,160,1399,9.1,0.22850066
5621,5621,Corey Potter,2014-15,31.0,7,5,19,19,0,5,5,17.0,262.0,123,8,24,32,158.0,82,5.34,48,269,2463,8.9,0.1303766
5622,5622,Corey Potter,2015-16,32.0,8,0,6,6,0,0,0,2.0,58.0,129,8,24,32,160.0,82,5.32,47,251,2453,8.9,0.12128931
5623,5623,Corey Potter,2016-17,33.0,9,0,1,1,0,0,0,0.0,15.0,130,8,24,32,160.0,82,5.34,48,255,2438,9.0,0.1354424
5624,5624,Corey Spring,1998-99,27.0,2,1,8,8,1,0,1,12.0,,8,1,0,1,12.0,82,5.28,57,380,2242,9.6,0.2150361
5625,5625,Corey Spring,1999-00,28.0,3,1,8,8,0,1,1,6.0,44.0,16,1,1,2,18.0,82,5.27,57,359,2285,9.4,0.1707097
5626,5626,Corey Tropp,2012-13,23.0,2,8,34,34,3,5,8,32.0,343.0,34,3,5,8,32.0,82,5.32,47,271,2439,8.9,0.24729216
5627,5627,Corey Tropp,2014-15,25.0,3,11,53,53,2,9,11,35.0,474.0,87,5,14,19,67.0,82,5.34,48,269,2463,8.9,0.18539011
5628,5628,Corey Tropp,2015-16,26.0,4,8,61,61,1,7,8,22.0,534.0,148,6,21,27,89.0,82,5.32,47,251,2453,8.9,0.11221853
5629,5629,Corey Tropp,2017-18,28.0,5,0,1,1,0,0,0,0.0,9.0,149,6,21,27,89.0,82,5.45,47,245,2478,9.0,0.14133376
5630,5630,Cory Conacher,2013-14,24.0,2,29,47,47,11,18,29,67.0,657.0,47,11,18,29,67.0,48,5.31,29,160,1399,9.1,0.44245043
5631,5631,Cory Conacher,2014-15,25.0,3,26,79,79,7,19,26,100.0,1022.0,126,18,37,55,167.0,82,5.34,48,269,2463,8.9,0.316356
5632,5632,Cory Conacher,2015-16,26.0,4,3,15,15,1,2,3,23.0,202.0,141,19,39,58,190.0,82,5.32,47,251,2453,8.9,0.271581
5633,5633,Cory Conacher,2017-18,28.0,5,4,11,11,1,3,4,16.0,127.0,152,20,42,62,206.0,82,5.45,47,245,2478,9.0,0.24162313
5634,5634,Cory Conacher,2018-19,29.0,6,12,36,36,8,4,12,45.0,360.0,188,28,46,74,251.0,82,5.86,50,250,2620,9.2,0.25313747
5635,5635,Cory Conacher,2019-20,30.0,7,0,1,1,0,0,0,1.0,9.0,189,28,46,74,252.0,82,5.96,47,239,2579,9.5,0.25611162
5636,5636,Cory Conacher,2020-21,31.0,8,1,4,4,0,1,1,5.0,44.0,193,28,47,75,257.0,70,5.96,42,208,2192,9.5,0.24625677
5637,5637,Cory Cross,1994-95,24.0,2,0,5,5,0,0,0,5.0,,5,0,0,0,5.0,84,6.48,76,407,2545,10.7,0.17670628
5638,5638,Cory Cross,1995-96,25.0,3,6,43,43,1,5,6,35.0,,48,1,5,6,40.0,48,5.97,37,209,1408,10.2,0.17358044
5639,5639,Cory Cross,1996-97,26.0,4,16,75,75,2,14,16,57.0,,123,3,19,22,97.0,82,6.29,74,413,2481,10.4,0.17930526
5640,5640,Cory Cross,1997-98,27.0,5,9,72,72,4,5,9,75.0,,195,7,24,31,172.0,82,5.83,55,336,2444,9.8,0.16279936
5641,5641,Cory Cross,1998-99,28.0,6,9,74,74,3,6,9,72.0,,269,10,30,40,244.0,82,5.28,57,380,2242,9.6,0.16547316
5642,5642,Cory Cross,1999-00,29.0,7,18,67,67,2,16,18,96.0,1516.0,336,12,46,58,340.0,82,5.27,57,359,2285,9.4,0.24559173
5643,5643,Cory Cross,2000-01,30.0,8,15,71,71,4,11,15,60.0,1135.0,407,16,57,73,400.0,82,5.49,53,331,2294,9.8,0.16454425
5644,5644,Cory Cross,2001-02,31.0,9,8,41,41,3,5,8,34.0,738.0,448,19,62,81,434.0,82,5.51,63,376,2272,9.9,0.16090485
5645,5645,Cory Cross,2002-03,32.0,10,12,50,50,3,9,12,39.0,765.0,498,22,71,93,473.0,82,5.24,53,338,2262,9.5,0.17343095
5646,5646,Cory Cross,2003-04,33.0,11,9,37,37,2,7,9,29.0,644.0,535,24,78,102,502.0,82,5.31,60,363,2326,9.4,0.17188251
5647,5647,Cory Cross,2004-05,34.0,12,21,68,68,7,14,21,83.0,1308.0,603,31,92,123,585.0,82,5.14,57,348,2300,9.2,0.26826015
5648,5648,Cory Cross,2006-07,36.0,13,8,56,56,3,5,8,32.0,717.0,659,34,97,131,617.0,82,6.05,85,480,2458,10.1,0.115581125
5649,5649,Cory Emmerton,2011-12,23.0,2,1,2,2,1,0,1,3.0,17.0,2,1,0,1,3.0,82,5.46,52,291,2492,9.0,0.22251889
5650,5650,Cory Emmerton,2012-13,24.0,3,10,71,71,6,4,10,63.0,575.0,73,7,4,11,66.0,82,5.32,47,271,2439,8.9,0.1846087
5651,5651,Cory Emmerton,2013-14,25.0,4,8,48,48,5,3,8,55.0,519.0,121,12,7,19,121.0,48,5.31,29,160,1399,9.1,0.21071285
5652,5652,Cory Emmerton,2014-15,26.0,5,2,18,18,0,2,2,22.0,161.0,139,12,9,21,143.0,82,5.34,48,269,2463,8.9,0.16117206
5653,5653,Cory Larose,2004-05,29.0,2,1,7,7,0,1,1,10.0,80.0,7,0,1,1,10.0,82,5.14,57,348,2300,9.2,0.19992366
5654,5654,Cory Murphy,2008-09,30.0,2,17,47,47,2,15,17,65.0,723.0,47,2,15,17,65.0,82,5.44,62,351,2383,9.4,0.3004306
5655,5655,Cory Murphy,2009-10,31.0,3,16,32,32,5,11,16,55.0,575.0,79,7,26,33,120.0,82,5.7,65,341,2477,9.4,0.34013206
5656,5656,Cory Murphy,2010-11,32.0,4,3,12,12,2,1,3,9.0,149.0,91,9,27,36,129.0,82,5.53,56,304,2486,9.1,0.2187447
5657,5657,Cory Sarich,1999-00,21.0,2,0,4,4,0,0,0,2.0,53.0,4,0,0,0,2.0,82,5.27,57,359,2285,9.4,0.18750921
5658,5658,Cory Sarich,2000-01,22.0,3,6,59,59,0,6,6,69.0,1095.0,63,0,6,6,71.0,82,5.49,53,331,2294,9.8,0.1644736
5659,5659,Cory Sarich,2001-02,23.0,4,9,73,73,1,8,9,66.0,1368.0,136,1,14,15,137.0,82,5.51,63,376,2272,9.9,0.16622618
5660,5660,Cory Sarich,2002-03,24.0,5,11,72,72,0,11,11,55.0,1159.0,208,1,25,26,192.0,82,5.24,53,338,2262,9.5,0.1489284
5661,5661,Cory Sarich,2003-04,25.0,6,14,82,82,5,9,14,79.0,1607.0,290,6,34,40,271.0,82,5.31,60,363,2326,9.4,0.19563359
5662,5662,Cory Sarich,2004-05,26.0,7,19,82,82,3,16,19,93.0,1518.0,372,9,50,59,364.0,82,5.14,57,348,2300,9.2,0.24644911
5663,5663,Cory Sarich,2006-07,28.0,8,15,82,82,1,14,15,88.0,1523.0,454,10,64,74,452.0,82,6.05,85,480,2458,10.1,0.19164789
5664,5664,Cory Sarich,2007-08,29.0,9,15,82,82,0,15,15,64.0,1485.0,536,10,79,89,516.0,82,5.76,70,398,2426,9.7,0.1684092
5665,5665,Cory Sarich,2008-09,30.0,10,7,80,80,2,5,7,57.0,1506.0,616,12,84,96,573.0,82,5.44,62,351,2383,9.4,0.15273651
5666,5666,Cory Sarich,2009-10,31.0,11,20,76,76,2,18,20,57.0,1359.0,692,14,102,116,630.0,82,5.7,65,341,2477,9.4,0.19342911
5667,5667,Cory Sarich,2010-11,32.0,12,6,57,57,1,5,6,46.0,909.0,749,15,107,122,676.0,82,5.53,56,304,2486,9.1,0.12626126
5668,5668,Cory Sarich,2011-12,33.0,13,17,76,76,4,13,17,75.0,1359.0,825,19,120,139,751.0,82,5.46,52,291,2492,9.0,0.17402685
5669,5669,Cory Sarich,2012-13,34.0,14,7,62,62,1,6,7,36.0,999.0,887,20,126,146,787.0,82,5.32,47,271,2439,8.9,0.10999197
5670,5670,Cory Sarich,2013-14,35.0,15,2,28,28,0,2,2,14.0,416.0,915,20,128,148,801.0,48,5.31,29,160,1399,9.1,0.06782332
5671,5671,Cory Sarich,2014-15,36.0,16,10,54,54,1,9,10,48.0,923.0,969,21,137,158,849.0,82,5.34,48,269,2463,8.9,0.12962857
5672,5672,Cory Stillman,1995-96,22.0,2,2,10,10,0,2,2,7.0,,10,0,2,2,7.0,48,5.97,37,209,1408,10.2,0.22629285
5673,5673,Cory Stillman,1996-97,23.0,3,35,74,74,16,19,35,132.0,,84,16,21,37,139.0,82,6.29,74,413,2481,10.4,0.45503005
5674,5674,Cory Stillman,1997-98,24.0,4,26,58,58,6,20,26,112.0,,142,22,41,63,251.0,82,5.83,55,336,2444,9.8,0.42501432
5675,5675,Cory Stillman,1998-99,25.0,5,49,72,72,27,22,49,178.0,,214,49,63,112,429.0,82,5.28,57,380,2242,9.6,0.65295935
5676,5676,Cory Stillman,1999-00,26.0,6,57,76,76,27,30,57,175.0,1240.0,290,76,93,169,604.0,82,5.27,57,359,2285,9.4,0.6831249
5677,5677,Cory Stillman,2000-01,27.0,7,21,37,37,12,9,21,59.0,657.0,327,88,102,190,663.0,82,5.49,53,331,2294,9.8,0.5242615
5678,5678,Cory Stillman,2001-02,28.0,8,52,78,78,24,28,52,174.0,1467.0,405,112,130,242,837.0,82,5.51,63,376,2272,9.9,0.56486374
5679,5679,Cory Stillman,2002-03,29.0,9,45,80,80,23,22,45,140.0,1204.0,485,135,152,287,977.0,82,5.24,53,338,2262,9.5,0.5299929
5680,5680,Cory Stillman,2003-04,30.0,10,67,79,79,24,43,67,157.0,1448.0,564,159,195,354,1134.0,82,5.31,60,363,2326,9.4,0.7444071
5681,5681,Cory Stillman,2004-05,31.0,11,80,81,81,25,55,80,178.0,1582.0,645,184,250,434,1312.0,82,5.14,57,348,2300,9.2,0.919423
5682,5682,Cory Stillman,2006-07,33.0,12,76,72,72,21,55,76,177.0,1344.0,717,205,305,510,1489.0,82,6.05,85,480,2458,10.1,0.7998999
5683,5683,Cory Stillman,2007-08,34.0,13,27,43,43,5,22,27,85.0,749.0,760,210,327,537,1574.0,82,5.76,70,398,2426,9.7,0.5128523
5684,5684,Cory Stillman,2008-09,35.0,14,65,79,79,24,41,65,166.0,1500.0,839,234,368,602,1740.0,82,5.44,62,351,2383,9.4,0.6843199
5685,5685,Cory Stillman,2009-10,36.0,15,49,63,63,17,32,49,115.0,1045.0,902,251,400,651,1855.0,82,5.7,65,341,2477,9.4,0.611145
5686,5686,Cory Stillman,2010-11,37.0,16,37,58,58,15,22,37,126.0,1019.0,960,266,422,688,1981.0,82,5.53,56,304,2486,9.1,0.5205658
5687,5687,Cory Stillman,2011-12,38.0,17,39,65,65,12,27,39,116.0,1099.0,1025,278,449,727,2097.0,82,5.46,52,291,2492,9.0,0.47294798
5688,5688,Craig Adams,2001-02,24.0,2,1,44,44,1,0,1,15.0,198.0,44,1,0,1,15.0,82,5.51,63,376,2272,9.9,0.10544667
5689,5689,Craig Adams,2002-03,25.0,3,1,33,33,0,1,1,17.0,195.0,77,1,1,2,32.0,82,5.24,53,338,2262,9.5,0.11906153
5690,5690,Craig Adams,2003-04,26.0,4,18,81,81,6,12,18,107.0,988.0,158,7,13,20,139.0,82,5.31,60,363,2326,9.4,0.24086091
5691,5691,Craig Adams,2004-05,27.0,5,17,80,80,7,10,17,110.0,1095.0,238,14,23,37,249.0,82,5.14,57,348,2300,9.2,0.2652369
5692,5692,Craig Adams,2006-07,29.0,6,21,67,67,10,11,21,68.0,824.0,305,24,34,58,317.0,82,6.05,85,480,2458,10.1,0.23745069
5693,5693,Craig Adams,2007-08,30.0,7,14,82,82,7,7,14,71.0,826.0,387,31,41,72,388.0,82,5.76,70,398,2426,9.7,0.1743066
5694,5694,Craig Adams,2008-09,31.0,8,11,75,75,4,7,11,63.0,810.0,462,35,48,83,451.0,82,5.44,62,351,2383,9.4,0.15525603
5695,5695,Craig Adams,2009-10,32.0,9,7,45,45,2,5,7,47.0,391.0,507,37,53,90,498.0,82,5.7,65,341,2477,9.4,0.16184047
5696,5696,Craig Adams,2010-11,33.0,10,10,82,82,0,10,10,84.0,910.0,589,37,63,100,582.0,82,5.53,56,304,2486,9.1,0.14348072
5697,5697,Craig Adams,2011-12,34.0,11,15,80,80,4,11,15,90.0,975.0,669,41,74,115,672.0,82,5.46,52,291,2492,9.0,0.17757303
5698,5698,Craig Adams,2012-13,35.0,12,18,82,82,5,13,18,76.0,925.0,751,46,87,133,748.0,82,5.32,47,271,2439,8.9,0.1879139
5699,5699,Craig Adams,2013-14,36.0,13,9,48,48,3,6,9,46.0,536.0,799,49,93,142,794.0,48,5.31,29,160,1399,9.1,0.15251297
5700,5700,Craig Adams,2014-15,37.0,14,11,82,82,5,6,11,73.0,1022.0,881,54,99,153,867.0,82,5.34,48,269,2463,8.9,0.1512262
5701,5701,Craig Adams,2015-16,38.0,15,7,70,70,1,6,7,51.0,682.0,951,55,105,160,918.0,82,5.32,47,251,2453,8.9,0.11890504
5702,5702,Craig Berube,1987-88,22.0,2,0,7,7,0,0,0,4.0,,7,0,0,0,4.0,80,7.34,72,344,2400,12.2,0.22396013
5703,5703,Craig Berube,1988-89,23.0,3,5,27,27,3,2,5,13.0,,34,3,2,5,17.0,80,7.43,89,437,2435,12.2,0.2571366
5704,5704,Craig Berube,1989-90,24.0,4,2,53,53,1,1,2,31.0,,87,4,3,7,48.0,80,7.48,85,403,2430,12.3,0.15896183
5705,5705,Craig Berube,1990-91,25.0,5,18,74,74,4,14,18,52.0,,161,8,17,25,100.0,80,7.37,76,367,2421,12.2,0.21713057
5706,5706,Craig Berube,1991-92,26.0,6,17,74,74,8,9,17,46.0,,235,16,26,42,146.0,80,6.91,71,366,2385,11.6,0.21525586
5707,5707,Craig Berube,1992-93,27.0,7,17,76,76,6,11,17,69.0,,311,22,37,59,215.0,80,6.96,77,402,2440,11.4,0.22142112
5708,5708,Craig Berube,1993-94,28.0,8,12,77,77,4,8,12,58.0,,388,26,45,71,273.0,84,7.25,87,443,2603,11.7,0.16602293
5709,5709,Craig Berube,1994-95,29.0,9,14,84,84,7,7,14,48.0,,472,33,52,85,321.0,84,6.48,76,407,2545,10.7,0.16319442
5710,5710,Craig Berube,1995-96,30.0,10,6,43,43,2,4,6,22.0,,515,35,56,91,343.0,48,5.97,37,209,1408,10.2,0.13539976
5711,5711,Craig Berube,1996-97,31.0,11,12,50,50,2,10,12,28.0,,565,37,66,103,371.0,82,6.29,74,413,2481,10.4,0.1436587
5712,5712,Craig Berube,1997-98,32.0,12,7,80,80,4,3,7,55.0,,645,41,69,110,426.0,82,5.83,55,336,2444,9.8,0.12978026
5713,5713,Craig Berube,1998-99,33.0,13,15,74,74,6,9,15,68.0,,719,47,78,125,494.0,82,5.28,57,380,2242,9.6,0.17552832
5714,5714,Craig Berube,1999-00,34.0,14,9,77,77,5,4,9,52.0,538.0,796,52,82,134,546.0,82,5.27,57,359,2285,9.4,0.13508108
5715,5715,Craig Berube,2000-01,35.0,15,12,77,77,4,8,12,63.0,616.0,873,56,90,146,609.0,82,5.49,53,331,2294,9.8,0.13474429
5716,5716,Craig Berube,2001-02,36.0,16,3,60,60,0,3,3,35.0,352.0,933,56,93,149,644.0,82,5.51,63,376,2272,9.9,0.12414783
5717,5717,Craig Berube,2002-03,37.0,17,4,66,66,3,1,4,34.0,430.0,999,59,94,153,678.0,82,5.24,53,338,2262,9.5,0.12140733
5718,5718,Craig Berube,2003-04,38.0,18,6,55,55,2,4,6,21.0,289.0,1054,61,98,159,699.0,82,5.31,60,363,2326,9.4,0.11889708
5719,5719,Craig Conroy,1995-96,24.0,2,1,6,6,1,0,1,4.0,,6,1,0,1,4.0,48,5.97,37,209,1408,10.2,0.23781466
5720,5720,Craig Conroy,1996-97,25.0,3,0,7,7,0,0,0,1.0,,13,1,0,1,5.0,82,6.29,74,413,2481,10.4,0.15958971
5721,5721,Craig Conroy,1997-98,26.0,4,17,61,61,6,11,17,74.0,,74,7,11,18,79.0,82,5.83,55,336,2444,9.8,0.2698166
5722,5722,Craig Conroy,1998-99,27.0,5,43,81,81,14,29,43,118.0,,155,21,40,61,197.0,82,5.28,57,380,2242,9.6,0.4577657
5723,5723,Craig Conroy,1999-00,28.0,6,39,69,69,14,25,39,134.0,1149.0,224,35,65,100,331.0,82,5.27,57,359,2285,9.4,0.5057473
5724,5724,Craig Conroy,2000-01,29.0,7,27,79,79,12,15,27,98.0,1170.0,303,47,80,127,429.0,82,5.49,53,331,2294,9.8,0.33716267
5725,5725,Craig Conroy,2001-02,30.0,8,32,83,83,14,18,32,133.0,1221.0,386,61,98,159,562.0,82,5.51,63,376,2272,9.9,0.44872394
5726,5726,Craig Conroy,2002-03,31.0,9,75,81,81,27,48,75,146.0,1696.0,467,88,146,234,708.0,82,5.24,53,338,2262,9.5,0.78239024
5727,5727,Craig Conroy,2003-04,32.0,10,59,79,79,22,37,59,143.0,1563.0,546,110,183,293,851.0,82,5.31,60,363,2326,9.4,0.6472726
5728,5728,Craig Conroy,2004-05,33.0,11,47,63,63,8,39,47,112.0,1210.0,609,118,222,340,963.0,82,5.14,57,348,2300,9.2,0.6674724
5729,5729,Craig Conroy,2006-07,35.0,12,66,78,78,22,44,66,154.0,1499.0,687,140,266,406,1117.0,82,6.05,85,480,2458,10.1,0.6660695
5730,5730,Craig Conroy,2007-08,36.0,13,37,80,80,13,24,37,112.0,1253.0,767,153,290,443,1229.0,82,5.76,70,398,2426,9.7,0.41693833
5731,5731,Craig Conroy,2008-09,37.0,14,34,79,79,12,22,34,116.0,1355.0,846,165,312,477,1345.0,82,5.44,62,351,2383,9.4,0.36205372
5732,5732,Craig Conroy,2009-10,38.0,15,48,82,82,12,36,48,104.0,1261.0,928,177,348,525,1449.0,82,5.7,65,341,2477,9.4,0.4772084
5733,5733,Craig Conroy,2010-11,39.0,16,15,63,63,3,12,15,52.0,855.0,991,180,360,540,1501.0,82,5.53,56,304,2486,9.1,0.19016585
5734,5734,Craig Conroy,2011-12,40.0,17,2,18,18,2,0,2,11.0,167.0,1009,182,360,542,1512.0,82,5.46,52,291,2492,9.0,0.2333171
5735,5735,Craig Coxe,1985-86,22.0,2,0,9,9,0,0,0,1.0,,9,0,0,0,1.0,80,7.77,71,321,2447,12.7,0.20431778
5736,5736,Craig Coxe,1986-87,23.0,3,8,57,57,3,5,8,48.0,,66,3,5,8,49.0,80,7.94,82,370,2484,12.8,0.18615079
5737,5737,Craig Coxe,1987-88,24.0,4,1,15,15,1,0,1,7.0,,81,4,5,9,56.0,80,7.34,72,344,2400,12.2,0.21300402
5738,5738,Craig Coxe,1988-89,25.0,5,22,71,71,7,15,22,48.0,,152,11,20,31,104.0,80,7.43,89,437,2435,12.2,0.24963042
5739,5739,Craig Coxe,1989-90,26.0,6,7,41,41,0,7,7,15.0,,193,11,27,38,119.0,80,7.48,85,403,2430,12.3,0.14289555
5740,5740,Craig Coxe,1990-91,27.0,7,5,25,25,1,4,5,11.0,,218,12,31,43,130.0,80,7.37,76,367,2421,12.2,0.14658678
5741,5741,Craig Coxe,1991-92,28.0,8,0,7,7,0,0,0,5.0,,225,12,31,43,135.0,80,6.91,71,366,2385,11.6,0.14850307
5742,5742,Craig Coxe,1992-93,29.0,9,2,10,10,2,0,2,11.0,,235,14,31,45,146.0,80,6.96,77,402,2440,11.4,0.25741804
5743,5743,Craig Cunningham,2014-15,24.0,2,0,2,2,0,0,0,4.0,19.0,2,0,0,0,4.0,82,5.34,48,269,2463,8.9,0.16720265
5744,5744,Craig Cunningham,2015-16,25.0,3,7,51,51,3,4,7,54.0,534.0,53,3,4,7,58.0,82,5.32,47,251,2453,8.9,0.16397259
5745,5745,Craig Cunningham,2016-17,26.0,4,1,10,10,0,1,1,13.0,101.0,63,3,5,8,71.0,82,5.34,48,255,2438,9.0,0.16601798
5746,5746,Craig Darby,1995-96,23.0,2,2,13,13,0,2,2,5.0,,13,0,2,2,5.0,48,5.97,37,209,1408,10.2,0.2183772
5747,5747,Craig Darby,1996-97,24.0,3,2,10,10,0,2,2,1.0,,23,0,4,4,6.0,82,6.29,74,413,2481,10.4,0.16465613
5748,5748,Craig Darby,1997-98,25.0,4,5,9,9,1,4,5,13.0,,32,1,8,9,19.0,82,5.83,55,336,2444,9.8,0.20306832
5749,5749,Craig Darby,1998-99,26.0,5,1,3,3,1,0,1,3.0,,35,2,8,10,22.0,82,5.28,57,380,2242,9.6,0.18138534
5750,5750,Craig Darby,2000-01,28.0,6,17,76,76,7,10,17,90.0,1045.0,111,9,18,27,112.0,82,5.49,53,331,2294,9.8,0.22903481
5751,5751,Craig Darby,2001-02,29.0,7,28,78,78,12,16,28,97.0,1239.0,189,21,34,55,209.0,82,5.51,63,376,2272,9.9,0.30266398
5752,5752,Craig Darby,2002-03,30.0,8,0,2,2,0,0,0,0.0,11.0,191,21,34,55,209.0,82,5.24,53,338,2262,9.5,0.2295573
5753,5753,Craig Darby,2003-04,31.0,9,1,3,3,0,1,1,1.0,32.0,194,21,35,56,210.0,82,5.31,60,363,2326,9.4,0.19666341
5754,5754,Craig Darby,2004-05,32.0,10,0,2,2,0,0,0,0.0,14.0,196,21,35,56,210.0,82,5.14,57,348,2300,9.2,0.2456699
5755,5755,Craig Duncanson,1986-87,19.0,2,1,2,2,0,1,1,0.0,,2,0,1,1,0.0,80,7.94,82,370,2484,12.8,0.28783393
5756,5756,Craig Duncanson,1987-88,20.0,3,0,2,2,0,0,0,1.0,,4,0,1,1,1.0,80,7.34,72,344,2400,12.2,0.279733
5757,5757,Craig Duncanson,1988-89,21.0,4,0,9,9,0,0,0,8.0,,13,0,1,1,9.0,80,7.43,89,437,2435,12.2,0.25617075
5758,5758,Craig Duncanson,1989-90,22.0,5,0,5,5,0,0,0,1.0,,18,0,1,1,10.0,80,7.48,85,403,2430,12.3,0.20290524
5759,5759,Craig Duncanson,1990-91,23.0,6,5,10,10,3,2,5,12.0,,28,3,3,6,22.0,80,7.37,76,367,2421,12.2,0.31251544
5760,5760,Craig Duncanson,1991-92,24.0,7,2,7,7,2,0,2,6.0,,35,5,3,8,28.0,80,6.91,71,366,2385,11.6,0.25999218
5761,5761,Craig Duncanson,1993-94,26.0,8,1,3,3,0,1,1,1.0,,38,5,4,9,29.0,84,7.25,87,443,2603,11.7,0.18946323
5762,5762,Craig Endean,1987-88,19.0,2,1,2,2,0,1,1,0.0,,2,0,1,1,0.0,80,7.34,72,344,2400,12.2,0.28640527
5763,5763,Craig Ferguson,1994-95,24.0,2,1,2,2,0,1,1,0.0,,2,0,1,1,0.0,84,6.48,76,407,2545,10.7,0.17255178
5764,5764,Craig Ferguson,1995-96,25.0,3,0,1,1,0,0,0,3.0,,3,0,1,1,3.0,48,5.97,37,209,1408,10.2,0.1788291
5765,5765,Craig Ferguson,1996-97,26.0,4,1,18,18,1,0,1,20.0,,21,1,1,2,23.0,82,6.29,74,413,2481,10.4,0.19428745
5766,5766,Craig Ferguson,1997-98,27.0,5,0,3,3,0,0,0,5.0,,24,1,1,2,28.0,82,5.83,55,336,2444,9.8,0.14022729
5767,5767,Craig Ferguson,2000-01,30.0,6,0,3,3,0,0,0,2.0,17.0,27,1,1,2,30.0,82,5.49,53,331,2294,9.8,0.12406847
5768,5768,Craig Fisher,1990-91,20.0,2,0,2,2,0,0,0,5.0,,2,0,0,0,5.0,80,7.37,76,367,2421,12.2,0.28451562
5769,5769,Craig Fisher,1991-92,21.0,3,0,2,2,0,0,0,2.0,,4,0,0,0,7.0,80,6.91,71,366,2385,11.6,0.23129714
5770,5770,Craig Fisher,1994-95,24.0,4,0,4,4,0,0,0,5.0,,8,0,0,0,12.0,84,6.48,76,407,2545,10.7,0.17036617
5771,5771,Craig Fisher,1997-98,27.0,5,0,4,4,0,0,0,2.0,,12,0,0,0,14.0,82,5.83,55,336,2444,9.8,0.14801434
5772,5772,Craig Hartsburg,1980-81,21.0,2,44,79,79,14,30,44,202.0,,79,14,30,44,202.0,80,7.03,61,280,2352,12.0,0.64353454
5773,5773,Craig Hartsburg,1981-82,22.0,3,43,74,74,13,30,43,207.0,,153,27,60,87,409.0,80,7.69,77,340,2441,12.6,0.6533714
5774,5774,Craig Hartsburg,1982-83,23.0,4,77,76,76,17,60,77,204.0,,229,44,120,164,613.0,80,8.03,73,320,2489,12.9,0.8678243
5775,5775,Craig Hartsburg,1983-84,24.0,5,62,78,78,12,50,62,201.0,,307,56,170,226,814.0,80,7.73,71,310,2444,12.7,0.7860255
5776,5776,Craig Hartsburg,1984-85,25.0,6,14,26,26,7,7,14,54.0,,333,63,177,240,868.0,80,7.89,74,336,2448,12.9,0.618878
5777,5777,Craig Hartsburg,1985-86,26.0,7,18,32,32,7,11,18,94.0,,365,70,188,258,962.0,80,7.77,71,321,2447,12.7,0.6061307
5778,5778,Craig Hartsburg,1986-87,27.0,8,57,75,75,10,47,57,185.0,,440,80,235,315,1147.0,80,7.94,82,370,2484,12.8,0.6855961
5779,5779,Craig Hartsburg,1987-88,28.0,9,61,73,73,11,50,61,189.0,,513,91,285,376,1336.0,80,7.34,72,344,2400,12.2,0.7829143
5780,5780,Craig Hartsburg,1988-89,29.0,10,19,27,27,3,16,19,83.0,,540,94,301,395,1419.0,80,7.43,89,437,2435,12.2,0.63901895
5781,5781,Craig Hartsburg,1989-90,30.0,11,18,30,30,4,14,18,75.0,,570,98,315,413,1494.0,80,7.48,85,403,2430,12.3,0.6442832
5782,5782,Craig Janney,1988-89,21.0,2,16,15,15,7,9,16,29.0,,15,7,9,16,29.0,80,7.43,89,437,2435,12.2,0.7355391
5783,5783,Craig Janney,1989-90,22.0,3,62,62,62,16,46,62,95.0,,77,23,55,78,124.0,80,7.48,85,403,2430,12.3,0.9389437
5784,5784,Craig Janney,1990-91,23.0,4,62,55,55,24,38,62,105.0,,132,47,93,140,229.0,80,7.37,76,367,2421,12.2,0.9960268
5785,5785,Craig Janney,1991-92,24.0,5,92,77,77,26,66,92,133.0,,209,73,159,232,362.0,80,6.91,71,366,2385,11.6,1.04452
5786,5786,Craig Janney,1992-93,25.0,6,87,78,78,18,69,87,127.0,,287,91,228,319,489.0,80,6.96,77,402,2440,11.4,1.1314626
5787,5787,Craig Janney,1993-94,26.0,7,106,84,84,24,82,106,137.0,,371,115,310,425,626.0,84,7.25,87,443,2603,11.7,1.1440678
5788,5788,Craig Janney,1994-95,27.0,8,84,69,69,16,68,84,95.0,,440,131,378,509,721.0,84,6.48,76,407,2545,10.7,0.9550016
5789,5789,Craig Janney,1995-96,28.0,9,27,35,35,7,20,27,40.0,,475,138,398,536,761.0,48,5.97,37,209,1408,10.2,0.78138155
5790,5790,Craig Janney,1996-97,29.0,10,82,84,84,20,62,82,91.0,,559,158,460,618,852.0,82,6.29,74,413,2481,10.4,0.769441
5791,5791,Craig Janney,1997-98,30.0,11,53,77,77,15,38,53,88.0,,636,173,498,671,940.0,82,5.83,55,336,2444,9.8,0.6822791
5792,5792,Craig Janney,1998-99,31.0,12,53,68,68,10,43,53,72.0,,704,183,541,724,1012.0,82,5.28,57,380,2242,9.6,0.6842144
5793,5793,Craig Janney,1999-00,32.0,13,27,56,56,5,22,27,45.0,799.0,760,188,563,751,1057.0,82,5.27,57,359,2285,9.4,0.48321256
5794,5794,Craig Johnson,1995-96,23.0,2,6,15,15,3,3,6,19.0,,15,3,3,6,19.0,48,5.97,37,209,1408,10.2,0.3249405
5795,5795,Craig Johnson,1996-97,24.0,3,24,60,60,13,11,24,97.0,,75,16,14,30,116.0,82,6.29,74,413,2481,10.4,0.4025057
5796,5796,Craig Johnson,1997-98,25.0,4,7,31,31,4,3,7,30.0,,106,20,17,37,146.0,82,5.83,55,336,2444,9.8,0.25115433
5797,5797,Craig Johnson,1998-99,26.0,5,38,74,74,17,21,38,125.0,,180,37,38,75,271.0,82,5.28,57,380,2242,9.6,0.46638733
5798,5798,Craig Johnson,1999-00,27.0,6,19,69,69,7,12,19,94.0,830.0,249,44,50,94,365.0,82,5.27,57,359,2285,9.4,0.30415058
5799,5799,Craig Johnson,2000-01,28.0,7,23,76,76,9,14,23,106.0,1059.0,325,53,64,117,471.0,82,5.49,53,331,2294,9.8,0.28573734
5800,5800,Craig Johnson,2001-02,29.0,8,9,26,26,4,5,9,36.0,277.0,351,57,69,126,507.0,82,5.51,63,376,2272,9.9,0.28516912
5801,5801,Craig Johnson,2002-03,30.0,9,27,72,72,13,14,27,102.0,1026.0,423,70,83,153,609.0,82,5.24,53,338,2262,9.5,0.33740646
5802,5802,Craig Johnson,2003-04,31.0,10,9,70,70,3,6,9,87.0,986.0,493,73,89,162,696.0,82,5.31,60,363,2326,9.4,0.22829461
5803,5803,Craig Johnson,2004-05,32.0,11,11,64,64,2,9,11,77.0,802.0,557,75,98,173,773.0,82,5.14,57,348,2300,9.2,0.20333278
5804,5804,Craig Laughlin,1982-83,25.0,2,23,36,36,12,11,23,52.0,,36,12,11,23,52.0,80,8.03,73,320,2489,12.9,0.49123046
5805,5805,Craig Laughlin,1983-84,26.0,3,44,75,75,17,27,44,128.0,,111,29,38,67,180.0,80,7.73,71,310,2444,12.7,0.5442923
5806,5806,Craig Laughlin,1984-85,27.0,4,52,80,80,20,32,52,111.0,,191,49,70,119,291.0,80,7.89,74,336,2448,12.9,0.5565721
5807,5807,Craig Laughlin,1985-86,28.0,5,50,78,78,16,34,50,104.0,,269,65,104,169,395.0,80,7.77,71,321,2447,12.7,0.6328279
5808,5808,Craig Laughlin,1986-87,29.0,6,75,75,75,30,45,75,114.0,,344,95,149,244,509.0,80,7.94,82,370,2484,12.8,0.73820806
5809,5809,Craig Laughlin,1987-88,30.0,7,52,80,80,22,30,52,109.0,,424,117,179,296,618.0,80,7.34,72,344,2400,12.2,0.56908834
5810,5810,Craig Laughlin,1988-89,31.0,8,22,59,59,9,13,22,74.0,,483,126,192,318,692.0,80,7.43,89,437,2435,12.2,0.38829464
5811,5811,Craig Laughlin,1989-90,32.0,9,23,66,66,10,13,23,87.0,,549,136,205,341,779.0,80,7.48,85,403,2430,12.3,0.34667856
5812,5812,Craig Levie,1982-83,23.0,2,13,40,40,4,9,13,56.0,,40,4,9,13,56.0,80,8.03,73,320,2489,12.9,0.3310231
5813,5813,Craig Levie,1983-84,24.0,3,9,22,22,4,5,9,31.0,,62,8,14,22,87.0,80,7.73,71,310,2444,12.7,0.37858033
5814,5814,Craig Levie,1984-85,25.0,4,19,37,37,6,13,19,55.0,,99,14,27,41,142.0,80,7.89,74,336,2448,12.9,0.45487165
5815,5815,Craig Levie,1985-86,26.0,5,29,61,61,6,23,29,95.0,,160,20,50,70,237.0,80,7.77,71,321,2447,12.7,0.43245673
5816,5816,Craig Levie,1986-87,27.0,6,4,14,14,2,2,4,22.0,,174,22,52,74,259.0,80,7.94,82,370,2484,12.8,0.31122822
5817,5817,Craig Levie,1987-88,28.0,7,1,9,9,0,1,1,8.0,,183,22,53,75,267.0,80,7.34,72,344,2400,12.2,0.27078295
5818,5818,Craig Ludwig,1983-84,22.0,2,25,80,80,0,25,25,81.0,,80,0,25,25,81.0,80,7.73,71,310,2444,12.7,0.33947933
5819,5819,Craig Ludwig,1984-85,23.0,3,25,80,80,7,18,25,116.0,,160,7,43,50,197.0,80,7.89,74,336,2448,12.9,0.37247905
5820,5820,Craig Ludwig,1985-86,24.0,4,19,72,72,5,14,19,73.0,,232,12,57,69,270.0,80,7.77,71,321,2447,12.7,0.29846042
5821,5821,Craig Ludwig,1986-87,25.0,5,6,69,69,2,4,6,61.0,,301,14,61,75,331.0,80,7.94,82,370,2484,12.8,0.19957018
5822,5822,Craig Ludwig,1987-88,26.0,6,16,75,75,4,12,16,55.0,,376,18,73,91,386.0,80,7.34,72,344,2400,12.2,0.22636458
5823,5823,Craig Ludwig,1988-89,27.0,7,14,74,74,4,10,14,82.0,,450,22,83,105,468.0,80,7.43,89,437,2435,12.2,0.2537496
5824,5824,Craig Ludwig,1989-90,28.0,8,16,74,74,3,13,16,83.0,,524,25,96,121,551.0,80,7.48,85,403,2430,12.3,0.24697062
5825,5825,Craig Ludwig,1990-91,29.0,9,16,73,73,1,15,16,49.0,,597,26,111,137,600.0,80,7.37,76,367,2421,12.2,0.18645355
5826,5826,Craig Ludwig,1991-92,30.0,10,9,75,75,1,8,9,46.0,,672,27,119,146,646.0,80,6.91,71,366,2385,11.6,0.18306428
5827,5827,Craig Ludwig,1992-93,31.0,11,11,73,73,2,9,11,51.0,,745,29,128,157,697.0,80,6.96,77,402,2440,11.4,0.17935705
5828,5828,Craig Ludwig,1993-94,32.0,12,11,78,78,1,10,11,66.0,,823,30,138,168,763.0,84,7.25,87,443,2603,11.7,0.11657485
5829,5829,Craig Ludwig,1994-95,33.0,13,14,84,84,1,13,14,65.0,,907,31,151,182,828.0,84,6.48,76,407,2545,10.7,0.12154305
5830,5830,Craig Ludwig,1995-96,34.0,14,9,47,47,2,7,9,55.0,,954,33,158,191,883.0,48,5.97,37,209,1408,10.2,0.16358635
5831,5831,Craig Ludwig,1996-97,35.0,15,3,65,65,1,2,3,47.0,,1019,34,160,194,930.0,82,6.29,74,413,2481,10.4,0.10106775
5832,5832,Craig Ludwig,1997-98,36.0,16,13,77,77,2,11,13,59.0,,1096,36,171,207,989.0,82,5.83,55,336,2444,9.8,0.12741596
5833,5833,Craig Ludwig,1998-99,37.0,17,7,80,80,0,7,7,46.0,,1176,36,178,214,1035.0,82,5.28,57,380,2242,9.6,0.09845206
5834,5834,Craig Ludwig,1999-00,38.0,18,8,80,80,2,6,8,39.0,1161.0,1256,38,184,222,1074.0,82,5.27,57,359,2285,9.4,0.110604644
5835,5835,Craig MacDonald,1999-00,22.0,2,0,11,11,0,0,0,5.0,27.0,11,0,0,0,5.0,82,5.27,57,359,2285,9.4,0.15446472
5836,5836,Craig MacDonald,2002-03,25.0,3,2,12,12,1,1,2,15.0,122.0,23,1,1,2,20.0,82,5.24,53,338,2262,9.5,0.19151354
5837,5837,Craig MacDonald,2003-04,26.0,4,4,35,35,1,3,4,43.0,327.0,58,2,4,6,63.0,82,5.31,60,363,2326,9.4,0.16780508
5838,5838,Craig MacDonald,2004-05,27.0,5,6,52,52,0,6,6,59.0,582.0,110,2,10,12,122.0,82,5.14,57,348,2300,9.2,0.16497815
5839,5839,Craig MacDonald,2006-07,29.0,6,5,25,25,3,2,5,27.0,257.0,135,5,12,17,149.0,82,6.05,85,480,2458,10.1,0.18532103
5840,5840,Craig MacDonald,2007-08,30.0,7,5,25,25,3,2,5,30.0,280.0,160,8,14,22,179.0,82,5.76,70,398,2426,9.7,0.18198794
5841,5841,Craig MacDonald,2008-09,31.0,8,11,65,65,2,9,11,84.0,707.0,225,10,23,33,263.0,82,5.44,62,351,2383,9.4,0.17309341
5842,5842,Craig MacDonald,2009-10,32.0,9,2,8,8,1,1,2,6.0,85.0,233,11,24,35,269.0,82,5.7,65,341,2477,9.4,0.14734498
5843,5843,Craig MacTavish,1980-81,22.0,2,28,46,46,11,17,28,61.0,,46,11,17,28,61.0,80,7.03,61,280,2352,12.0,0.50351256
5844,5844,Craig MacTavish,1981-82,23.0,3,8,24,24,3,5,8,40.0,,70,14,22,36,101.0,80,7.69,77,340,2441,12.6,0.40660727
5845,5845,Craig MacTavish,1982-83,24.0,4,1,2,2,0,1,1,1.0,,72,14,23,37,102.0,80,8.03,73,320,2489,12.9,0.2728591
5846,5846,Craig MacTavish,1983-84,25.0,5,30,75,75,10,20,30,120.0,,147,24,43,67,222.0,80,7.73,71,310,2444,12.7,0.4038151
5847,5847,Craig MacTavish,1984-85,26.0,6,43,70,70,20,23,43,135.0,,217,44,66,110,357.0,80,7.89,74,336,2448,12.9,0.5768208
5848,5848,Craig MacTavish,1986-87,28.0,7,47,74,74,23,24,47,121.0,,291,67,90,157,478.0,80,7.94,82,370,2484,12.8,0.5346523
5849,5849,Craig MacTavish,1987-88,29.0,8,39,79,79,20,19,39,139.0,,370,87,109,196,617.0,80,7.34,72,344,2400,12.2,0.47716588
5850,5850,Craig MacTavish,1988-89,30.0,9,32,80,80,15,17,32,90.0,,450,102,126,228,707.0,80,7.43,89,437,2435,12.2,0.35900563
5851,5851,Craig MacTavish,1989-90,31.0,10,52,80,80,21,31,52,120.0,,530,123,157,280,827.0,80,7.48,85,403,2430,12.3,0.522063
5852,5852,Craig MacTavish,1990-91,32.0,11,43,80,80,21,22,43,109.0,,610,144,179,323,936.0,80,7.37,76,367,2421,12.2,0.44896078
5853,5853,Craig MacTavish,1991-92,33.0,12,32,80,80,17,15,32,113.0,,690,161,194,355,1049.0,80,6.91,71,366,2385,11.6,0.36608642
5854,5854,Craig MacTavish,1992-93,34.0,13,30,80,80,12,18,30,86.0,,770,173,212,385,1135.0,80,6.96,77,402,2440,11.4,0.32154495
5855,5855,Craig MacTavish,1993-94,35.0,14,30,82,82,10,20,30,101.0,,852,183,232,415,1236.0,84,7.25,87,443,2603,11.7,0.29893714
5856,5856,Craig MacTavish,1994-95,36.0,15,32,78,78,20,12,32,122.0,,930,203,244,447,1358.0,84,6.48,76,407,2545,10.7,0.30167687
5857,5857,Craig MacTavish,1995-96,37.0,16,12,45,45,3,9,12,38.0,,975,206,253,459,1396.0,48,5.97,37,209,1408,10.2,0.22269613
5858,5858,Craig MacTavish,1996-97,38.0,17,14,68,68,5,9,14,58.0,,1043,211,262,473,1454.0,82,6.29,74,413,2481,10.4,0.17029533
5859,5859,Craig MacTavish,1997-98,39.0,18,7,50,50,2,5,7,26.0,,1093,213,267,480,1480.0,82,5.83,55,336,2444,9.8,0.15931803
5860,5860,Craig Martin,1995-96,25.0,2,1,20,20,0,1,1,3.0,,20,0,1,1,3.0,48,5.97,37,209,1408,10.2,0.13694006
5861,5861,Craig Martin,1997-98,27.0,3,0,1,1,0,0,0,1.0,,21,0,1,1,4.0,82,5.83,55,336,2444,9.8,0.13259134
5862,5862,Craig Millar,1997-98,21.0,2,0,1,1,0,0,0,1.0,,1,0,0,0,1.0,82,5.83,55,336,2444,9.8,0.19497362
5863,5863,Craig Millar,1998-99,22.0,3,4,11,11,4,0,4,10.0,,12,4,0,4,11.0,82,5.28,57,380,2242,9.6,0.2900108
5864,5864,Craig Millar,1999-00,23.0,4,2,24,24,0,2,2,18.0,364.0,36,4,2,6,29.0,82,5.27,57,359,2285,9.4,0.19580546
5865,5865,Craig Millar,2000-01,24.0,5,14,57,57,3,11,14,50.0,962.0,93,7,13,20,79.0,82,5.49,53,331,2294,9.8,0.212517
5866,5866,Craig Millar,2001-02,25.0,6,2,21,21,1,1,2,12.0,301.0,114,8,14,22,91.0,82,5.51,63,376,2272,9.9,0.14641654
5867,5867,Craig Mills,1996-97,20.0,2,2,4,4,0,2,2,0.0,,4,0,2,2,0.0,82,6.29,74,413,2481,10.4,0.25919563
5868,5868,Craig Mills,1998-99,22.0,3,3,20,20,0,3,3,5.0,,24,0,5,5,5.0,82,5.28,57,380,2242,9.6,0.1255
5869,5869,Craig Mills,1999-00,23.0,4,0,7,7,0,0,0,1.0,41.0,31,0,5,5,6.0,82,5.27,57,359,2285,9.4,0.15361524
5870,5870,Craig Muni,1982-83,20.0,2,0,3,3,0,0,0,0.0,,3,0,0,0,0.0,80,8.03,73,320,2489,12.9,0.2668938
5871,5871,Craig Muni,1983-84,21.0,3,1,2,2,0,1,1,2.0,,5,0,1,1,2.0,80,7.73,71,310,2444,12.7,0.27453706
5872,5872,Craig Muni,1985-86,23.0,4,0,8,8,0,0,0,1.0,,13,0,1,1,3.0,80,7.77,71,321,2447,12.7,0.19366652
5873,5873,Craig Muni,1986-87,24.0,5,1,6,6,0,1,1,2.0,,19,0,2,2,5.0,80,7.94,82,370,2484,12.8,0.20059884
5874,5874,Craig Muni,1987-88,25.0,6,29,79,79,7,22,29,69.0,,98,7,24,31,74.0,80,7.34,72,344,2400,12.2,0.33919892
5875,5875,Craig Muni,1988-89,26.0,7,19,72,72,4,15,19,56.0,,170,11,39,50,130.0,80,7.43,89,437,2435,12.2,0.22971785
5876,5876,Craig Muni,1989-90,27.0,8,18,69,69,5,13,18,40.0,,239,16,52,68,170.0,80,7.48,85,403,2430,12.3,0.21813443
5877,5877,Craig Muni,1990-91,28.0,9,17,71,71,5,12,17,42.0,,310,21,64,85,212.0,80,7.37,76,367,2421,12.2,0.19219932
5878,5878,Craig Muni,1991-92,29.0,10,10,76,76,1,9,10,47.0,,386,22,73,95,259.0,80,6.91,71,366,2385,11.6,0.16714224
5879,5879,Craig Muni,1992-93,30.0,11,7,54,54,2,5,7,38.0,,440,24,78,102,297.0,80,6.96,77,402,2440,11.4,0.16730326
5880,5880,Craig Muni,1993-94,31.0,12,11,81,81,0,11,11,60.0,,521,24,89,113,357.0,84,7.25,87,443,2603,11.7,0.123904735
5881,5881,Craig Muni,1994-95,32.0,13,14,82,82,2,12,14,45.0,,603,26,101,127,402.0,84,6.48,76,407,2545,10.7,0.13933825
5882,5882,Craig Muni,1995-96,33.0,14,6,40,40,0,6,6,32.0,,643,26,107,133,434.0,48,5.97,37,209,1408,10.2,0.13426271
5883,5883,Craig Muni,1996-97,34.0,15,8,72,72,1,7,8,41.0,,715,27,114,141,475.0,82,6.29,74,413,2481,10.4,0.11231798
5884,5884,Craig Muni,1997-98,35.0,16,4,64,64,0,4,4,19.0,,779,27,118,145,494.0,82,5.83,55,336,2444,9.8,0.0869776
5885,5885,Craig Muni,1998-99,36.0,17,2,40,40,1,1,2,12.0,,819,28,119,147,506.0,82,5.28,57,380,2242,9.6,0.072597325
5886,5886,Craig Norwich,1980-81,25.0,2,45,70,70,10,35,45,218.0,,70,10,35,45,218.0,80,7.03,61,280,2352,12.0,0.66006577
5887,5887,Craig Norwich,1981-82,26.0,3,30,34,34,7,23,30,87.0,,104,17,58,75,305.0,80,7.69,77,340,2441,12.6,0.7713915
5888,5888,Craig Redmond,1985-86,20.0,2,39,79,79,6,33,39,110.0,,79,6,33,39,110.0,80,7.77,71,321,2447,12.7,0.49992812
5889,5889,Craig Redmond,1986-87,21.0,3,24,73,73,6,18,24,116.0,,152,12,51,63,226.0,80,7.94,82,370,2484,12.8,0.4040557
5890,5890,Craig Redmond,1987-88,22.0,4,8,16,16,1,7,8,18.0,,168,13,58,71,244.0,80,7.34,72,344,2400,12.2,0.38486573
5891,5891,Craig Redmond,1988-89,23.0,5,0,2,2,0,0,0,5.0,,170,13,58,71,249.0,80,7.43,89,437,2435,12.2,0.36890072
5892,5892,Craig Redmond,1989-90,24.0,6,13,21,21,3,10,13,29.0,,191,16,68,84,278.0,80,7.48,85,403,2430,12.3,0.42825577
5893,5893,Craig Reichert,1997-98,23.0,2,0,3,3,0,0,0,3.0,,3,0,0,0,3.0,82,5.83,55,336,2444,9.8,0.17343244
5894,5894,Craig Rivet,1995-96,21.0,2,1,5,5,0,1,1,2.0,,5,0,1,1,2.0,48,5.97,37,209,1408,10.2,0.24333015
5895,5895,Craig Rivet,1996-97,22.0,3,5,19,19,1,4,5,9.0,,24,1,5,6,11.0,82,6.29,74,413,2481,10.4,0.17983538
5896,5896,Craig Rivet,1997-98,23.0,4,4,35,35,0,4,4,24.0,,59,1,9,10,35.0,82,5.83,55,336,2444,9.8,0.16256645
5897,5897,Craig Rivet,1998-99,24.0,5,2,61,61,0,2,2,26.0,,120,1,11,12,61.0,82,5.28,57,380,2242,9.6,0.103496194
5898,5898,Craig Rivet,1999-00,25.0,6,10,66,66,2,8,10,39.0,946.0,186,3,19,22,100.0,82,5.27,57,359,2285,9.4,0.15993705
5899,5899,Craig Rivet,2000-01,26.0,7,17,61,61,3,14,17,71.0,1162.0,247,6,33,39,171.0,82,5.49,53,331,2294,9.8,0.21893185
5900,5900,Craig Rivet,2001-02,27.0,8,3,26,26,1,2,3,22.0,496.0,273,7,35,42,193.0,82,5.51,63,376,2272,9.9,0.15875605
5901,5901,Craig Rivet,2002-03,28.0,9,25,82,82,8,17,25,90.0,1558.0,355,15,52,67,283.0,82,5.24,53,338,2262,9.5,0.2708637
5902,5902,Craig Rivet,2003-04,29.0,10,22,82,82,7,15,22,118.0,1803.0,437,22,67,89,401.0,82,5.31,60,363,2326,9.4,0.24776113
5903,5903,Craig Rivet,2004-05,30.0,11,12,80,80,4,8,12,96.0,1557.0,517,26,75,101,497.0,82,5.14,57,348,2300,9.2,0.19596896
5904,5904,Craig Rivet,2006-07,32.0,12,34,82,82,7,27,34,122.0,1840.0,599,33,102,135,619.0,82,6.05,85,480,2458,10.1,0.32080162
5905,5905,Craig Rivet,2007-08,33.0,13,24,71,71,7,17,24,89.0,1537.0,670,40,119,159,708.0,82,5.76,70,398,2426,9.7,0.2706183
5906,5906,Craig Rivet,2008-09,34.0,14,35,74,74,5,30,35,105.0,1569.0,744,45,149,194,813.0,82,5.44,62,351,2383,9.4,0.30807048
5907,5907,Craig Rivet,2009-10,35.0,15,24,64,64,2,22,24,80.0,1295.0,808,47,171,218,893.0,82,5.7,65,341,2477,9.4,0.22857812
5908,5908,Craig Rivet,2010-11,36.0,16,15,78,78,1,14,15,63.0,1421.0,886,48,185,233,956.0,82,5.53,56,304,2486,9.1,0.14178568
5909,5909,Craig Rivet,2011-12,37.0,17,4,37,37,2,2,4,33.0,543.0,923,50,187,237,989.0,82,5.46,52,291,2492,9.0,0.1363846
5910,5910,Craig Simpson,1986-87,19.0,2,28,76,76,11,17,28,74.0,,76,11,17,28,74.0,80,7.94,82,370,2484,12.8,0.46299157
5911,5911,Craig Simpson,1987-88,20.0,3,51,72,72,26,25,51,133.0,,148,37,42,79,207.0,80,7.34,72,344,2400,12.2,0.81733453
5912,5912,Craig Simpson,1988-89,21.0,4,90,80,80,56,34,90,177.0,,228,93,76,169,384.0,80,7.43,89,437,2435,12.2,1.0577893
5913,5913,Craig Simpson,1989-90,22.0,5,76,66,66,35,41,76,121.0,,294,128,117,245,505.0,80,7.48,85,403,2430,12.3,0.92923474
5914,5914,Craig Simpson,1990-91,23.0,6,61,80,80,29,32,61,129.0,,374,157,149,306,634.0,80,7.37,76,367,2421,12.2,0.72424203
5915,5915,Craig Simpson,1991-92,24.0,7,57,75,75,30,27,57,143.0,,449,187,176,363,777.0,80,6.91,71,366,2385,11.6,0.7581133
5916,5916,Craig Simpson,1992-93,25.0,8,61,79,79,24,37,61,128.0,,528,211,213,424,905.0,80,6.96,77,402,2440,11.4,0.7490396
5917,5917,Craig Simpson,1993-94,26.0,9,46,60,60,24,22,46,91.0,,588,235,235,470,996.0,84,7.25,87,443,2603,11.7,0.66299385
5918,5918,Craig Simpson,1994-95,27.0,10,16,22,22,8,8,16,28.0,,610,243,243,486,1024.0,84,6.48,76,407,2545,10.7,0.6653559
5919,5919,Craig Simpson,1995-96,28.0,11,11,24,24,4,7,11,20.0,,634,247,250,497,1044.0,48,5.97,37,209,1408,10.2,0.5786222
5920,5920,Craig Smith,2012-13,23.0,2,36,72,72,14,22,36,172.0,1022.0,72,14,22,36,172.0,82,5.32,47,271,2439,8.9,0.5180829
5921,5921,Craig Smith,2013-14,24.0,3,12,44,44,4,8,12,83.0,610.0,116,18,30,48,255.0,48,5.31,29,160,1399,9.1,0.3433141
5922,5922,Craig Smith,2014-15,25.0,4,52,79,79,24,28,52,215.0,1296.0,195,42,58,100,470.0,82,5.34,48,269,2463,8.9,0.61577666
5923,5923,Craig Smith,2015-16,26.0,5,44,82,82,23,21,44,252.0,1291.0,277,65,79,144,722.0,82,5.32,47,251,2453,8.9,0.5720022
5924,5924,Craig Smith,2016-17,27.0,6,37,82,82,21,16,37,199.0,1245.0,359,86,95,181,921.0,82,5.34,48,255,2438,9.0,0.51061803
5925,5925,Craig Smith,2017-18,28.0,7,29,78,78,12,17,29,155.0,1078.0,437,98,112,210,1076.0,82,5.45,47,245,2478,9.0,0.39587963
5926,5926,Craig Smith,2018-19,29.0,8,51,79,79,25,26,51,229.0,1215.0,516,123,138,261,1305.0,82,5.86,50,250,2620,9.2,0.6012468
5927,5927,Craig Smith,2019-20,30.0,9,38,76,76,21,17,38,205.0,1150.0,592,144,155,299,1510.0,82,5.96,47,239,2579,9.5,0.52593327
5928,5928,Craig Smith,2020-21,31.0,10,31,69,69,18,13,31,184.0,926.0,661,162,168,330,1694.0,70,5.96,42,208,2192,9.5,0.4608223
5929,5929,Craig Weller,2008-09,28.0,2,11,59,59,3,8,11,72.0,613.0,59,3,8,11,72.0,82,5.44,62,351,2383,9.4,0.21949059
5930,5930,Craig Weller,2009-10,29.0,3,3,36,36,1,2,3,27.0,250.0,95,4,10,14,99.0,82,5.7,65,341,2477,9.4,0.15108517
5931,5931,Craig Wolanin,1986-87,19.0,2,18,44,44,2,16,18,45.0,,44,2,16,18,45.0,80,7.94,82,370,2484,12.8,0.3880256
5932,5932,Craig Wolanin,1987-88,20.0,3,10,68,68,4,6,10,68.0,,112,6,22,28,113.0,80,7.34,72,344,2400,12.2,0.29057568
5933,5933,Craig Wolanin,1988-89,21.0,4,31,78,78,6,25,31,113.0,,190,12,47,59,226.0,80,7.43,89,437,2435,12.2,0.43945634
5934,5934,Craig Wolanin,1989-90,22.0,5,11,56,56,3,8,11,70.0,,246,15,55,70,296.0,80,7.48,85,403,2430,12.3,0.31167832
5935,5935,Craig Wolanin,1990-91,23.0,6,11,50,50,1,10,11,60.0,,296,16,65,81,356.0,80,7.37,76,367,2421,12.2,0.28074265
5936,5936,Craig Wolanin,1991-92,24.0,7,18,80,80,5,13,18,109.0,,376,21,78,99,465.0,80,6.91,71,366,2385,11.6,0.30053777
5937,5937,Craig Wolanin,1992-93,25.0,8,13,69,69,2,11,13,71.0,,445,23,89,112,536.0,80,6.96,77,402,2440,11.4,0.23536766
5938,5938,Craig Wolanin,1993-94,26.0,9,5,24,24,1,4,5,17.0,,469,24,93,117,553.0,84,7.25,87,443,2603,11.7,0.20762989
5939,5939,Craig Wolanin,1994-95,27.0,10,16,63,63,6,10,16,78.0,,532,30,103,133,631.0,84,6.48,76,407,2545,10.7,0.2538858
5940,5940,Craig Wolanin,1995-96,28.0,11,9,40,40,3,6,9,36.0,,572,33,109,142,667.0,48,5.97,37,209,1408,10.2,0.20535827
5941,5941,Craig Wolanin,1996-97,29.0,12,27,75,75,7,20,27,73.0,,647,40,129,169,740.0,82,6.29,74,413,2481,10.4,0.28509447
5942,5942,Craig Wolanin,1997-98,30.0,13,4,38,38,0,4,4,43.0,,685,40,133,173,783.0,82,5.83,55,336,2444,9.8,0.15496388
5943,5943,Craig Wolanin,1998-99,31.0,14,0,10,10,0,0,0,5.0,,695,40,133,173,788.0,82,5.28,57,380,2242,9.6,0.111842304
5944,5944,Curt Brackenbury,1980-81,29.0,2,14,63,63,6,8,14,42.0,,63,6,8,14,42.0,80,7.03,61,280,2352,12.0,0.23904139
5945,5945,Curt Brackenbury,1981-82,30.0,3,9,58,58,2,7,9,20.0,,121,8,15,23,62.0,80,7.69,77,340,2441,12.6,0.15599144
5946,5946,Curt Brackenbury,1982-83,31.0,4,2,14,14,0,2,2,2.0,,135,8,17,25,64.0,80,8.03,73,320,2489,12.9,0.15773976
5947,5947,Curt Brackenbury,1983-84,32.0,5,1,6,6,1,0,1,2.0,,141,9,17,26,66.0,80,7.73,71,310,2444,12.7,0.17865145
5948,5948,Curt Giles,1980-81,22.0,2,9,37,37,2,7,9,48.0,,37,2,7,9,48.0,80,7.03,61,280,2352,12.0,0.28656775
5949,5949,Curt Giles,1981-82,23.0,3,27,67,67,5,22,27,82.0,,104,7,29,36,130.0,80,7.69,77,340,2441,12.6,0.38500422
5950,5950,Curt Giles,1982-83,24.0,4,15,74,74,3,12,15,65.0,,178,10,41,51,195.0,80,8.03,73,320,2489,12.9,0.2585699
5951,5951,Curt Giles,1983-84,25.0,5,23,76,76,2,21,23,78.0,,254,12,62,74,273.0,80,7.73,71,310,2444,12.7,0.2840846
5952,5952,Curt Giles,1984-85,26.0,6,28,70,70,6,22,28,78.0,,324,18,84,102,351.0,80,7.89,74,336,2448,12.9,0.40266582
5953,5953,Curt Giles,1985-86,27.0,7,30,77,77,5,25,30,98.0,,401,23,109,132,449.0,80,7.77,71,321,2447,12.7,0.39942992
5954,5954,Curt Giles,1986-87,28.0,8,27,69,69,6,21,27,59.0,,470,29,130,159,508.0,80,7.94,82,370,2484,12.8,0.3167475
5955,5955,Curt Giles,1987-88,29.0,9,22,72,72,2,20,22,57.0,,542,31,150,181,565.0,80,7.34,72,344,2400,12.2,0.26438603
5956,5956,Curt Giles,1988-89,30.0,10,13,72,72,1,12,13,72.0,,614,32,162,194,637.0,80,7.43,89,437,2435,12.2,0.19529241
5957,5957,Curt Giles,1989-90,31.0,11,15,76,76,5,10,15,64.0,,690,37,172,209,701.0,80,7.48,85,403,2430,12.3,0.21371046
5958,5958,Curt Giles,1990-91,32.0,12,13,74,74,1,12,13,55.0,,764,38,184,222,756.0,80,7.37,76,367,2421,12.2,0.15589458
5959,5959,Curt Giles,1991-92,33.0,13,14,70,70,4,10,14,53.0,,834,42,194,236,809.0,80,6.91,71,366,2385,11.6,0.19160399
5960,5960,Curt Giles,1992-93,34.0,14,2,13,13,1,1,2,4.0,,847,43,195,238,813.0,80,6.96,77,402,2440,11.4,0.15844262
5961,5961,Curt Giles,1993-94,35.0,15,4,48,48,0,4,4,23.0,,895,43,199,242,836.0,84,7.25,87,443,2603,11.7,0.11055219
5962,5962,Curtis Brown,1995-96,19.0,2,2,1,1,1,1,2,4.0,,1,1,1,2,4.0,48,5.97,37,209,1408,10.2,0.30431014
5963,5963,Curtis Brown,1996-97,20.0,3,0,4,4,0,0,0,1.0,,5,1,1,2,5.0,82,6.29,74,413,2481,10.4,0.24155074
5964,5964,Curtis Brown,1997-98,21.0,4,7,28,28,4,3,7,31.0,,33,5,4,9,36.0,82,5.83,55,336,2444,9.8,0.30471814
5965,5965,Curtis Brown,1998-99,22.0,5,24,63,63,12,12,24,91.0,,96,17,16,33,127.0,82,5.28,57,380,2242,9.6,0.37502727
5966,5966,Curtis Brown,1999-00,23.0,6,47,78,78,16,31,47,128.0,1365.0,174,33,47,80,255.0,82,5.27,57,359,2285,9.4,0.57317567
5967,5967,Curtis Brown,2000-01,24.0,7,51,74,74,22,29,51,149.0,1345.0,248,55,76,131,404.0,82,5.49,53,331,2294,9.8,0.6021285
5968,5968,Curtis Brown,2001-02,25.0,8,32,70,70,10,22,32,105.0,1160.0,318,65,98,163,509.0,82,5.51,63,376,2272,9.9,0.45638826
5969,5969,Curtis Brown,2002-03,26.0,9,37,82,82,20,17,37,171.0,1460.0,400,85,115,200,680.0,82,5.24,53,338,2262,9.5,0.5331474
5970,5970,Curtis Brown,2003-04,27.0,10,31,74,74,15,16,31,144.0,1249.0,474,100,131,231,824.0,82,5.31,60,363,2326,9.4,0.42995203
5971,5971,Curtis Brown,2004-05,28.0,11,25,80,80,11,14,25,138.0,1326.0,554,111,145,256,962.0,82,5.14,57,348,2300,9.2,0.36557645
5972,5972,Curtis Brown,2006-07,30.0,12,15,71,71,5,10,15,84.0,969.0,625,116,155,271,1046.0,82,6.05,85,480,2458,10.1,0.2504772
5973,5973,Curtis Brown,2007-08,31.0,13,20,78,78,8,12,20,84.0,1027.0,703,124,167,291,1130.0,82,5.76,70,398,2426,9.7,0.24344766
5974,5974,Curtis Brown,2008-09,32.0,14,9,33,33,5,4,9,38.0,357.0,736,129,171,300,1168.0,82,5.44,62,351,2383,9.4,0.26945084
5975,5975,Curtis Glencross,2007-08,25.0,2,1,9,9,1,0,1,8.0,82.0,9,1,0,1,8.0,82,5.76,70,398,2426,9.7,0.19151768
5976,5976,Curtis Glencross,2008-09,26.0,3,25,62,62,15,10,25,104.0,705.0,71,16,10,26,112.0,82,5.44,62,351,2383,9.4,0.4241711
5977,5977,Curtis Glencross,2009-10,27.0,4,40,74,74,13,27,40,152.0,1086.0,145,29,37,66,264.0,82,5.7,65,341,2477,9.4,0.47856364
5978,5978,Curtis Glencross,2010-11,28.0,5,33,67,67,15,18,33,117.0,1053.0,212,44,55,99,381.0,82,5.53,56,304,2486,9.1,0.43961453
5979,5979,Curtis Glencross,2011-12,29.0,6,43,79,79,24,19,43,149.0,1283.0,291,68,74,142,530.0,82,5.46,52,291,2492,9.0,0.50386417
5980,5980,Curtis Glencross,2012-13,30.0,7,48,67,67,26,22,48,110.0,1208.0,358,94,96,190,640.0,82,5.32,47,271,2439,8.9,0.5747568
5981,5981,Curtis Glencross,2013-14,31.0,8,26,40,40,15,11,26,92.0,729.0,398,109,107,216,732.0,48,5.31,29,160,1399,9.1,0.6073873
5982,5982,Curtis Glencross,2014-15,32.0,9,24,38,38,12,12,24,77.0,669.0,436,121,119,240,809.0,82,5.34,48,269,2463,8.9,0.4710765
5983,5983,Curtis Glencross,2015-16,33.0,10,35,71,71,13,22,35,108.0,1111.0,507,134,141,275,917.0,82,5.32,47,251,2453,8.9,0.38022292
5984,5984,Curtis Hamilton,2015-16,24.0,2,0,1,1,0,0,0,0.0,8.0,1,0,0,0,0.0,82,5.32,47,251,2453,8.9,0.1370357
5985,5985,Curtis Lazar,2015-16,20.0,2,15,67,67,6,9,15,92.0,864.0,67,6,9,15,92.0,82,5.32,47,251,2453,8.9,0.2872306
5986,5986,Curtis Lazar,2016-17,21.0,3,20,76,76,6,14,20,78.0,1053.0,143,12,23,35,170.0,82,5.34,48,255,2438,9.0,0.34326595
5987,5987,Curtis Lazar,2017-18,22.0,4,4,37,37,1,3,4,26.0,338.0,180,13,26,39,196.0,82,5.45,47,245,2478,9.0,0.24020076
5988,5988,Curtis Lazar,2018-19,23.0,5,12,65,65,2,10,12,65.0,641.0,245,15,36,51,261.0,82,5.86,50,250,2620,9.2,0.23132461
5989,5989,Curtis Lazar,2019-20,24.0,6,0,1,1,0,0,0,0.0,5.0,246,15,36,51,261.0,82,5.96,47,239,2579,9.5,0.20378208
5990,5990,Curtis Lazar,2020-21,25.0,7,10,38,38,5,5,10,33.0,450.0,284,20,41,61,294.0,70,5.96,42,208,2192,9.5,0.2666969
5991,5991,Curtis Leschyshyn,1989-90,20.0,2,13,71,71,4,9,13,58.0,,71,4,9,13,58.0,80,7.48,85,403,2430,12.3,0.26279053
5992,5992,Curtis Leschyshyn,1990-91,21.0,3,8,68,68,2,6,8,42.0,,139,6,15,21,100.0,80,7.37,76,367,2421,12.2,0.23419756
5993,5993,Curtis Leschyshyn,1991-92,22.0,4,10,55,55,3,7,10,57.0,,194,9,22,31,157.0,80,6.91,71,366,2385,11.6,0.2647473
5994,5994,Curtis Leschyshyn,1992-93,23.0,5,17,42,42,5,12,17,61.0,,236,14,34,48,218.0,80,6.96,77,402,2440,11.4,0.36044705
5995,5995,Curtis Leschyshyn,1993-94,24.0,6,32,82,82,9,23,32,73.0,,318,23,57,80,291.0,84,7.25,87,443,2603,11.7,0.37585032
5996,5996,Curtis Leschyshyn,1994-95,25.0,7,22,72,72,5,17,22,97.0,,390,28,74,102,388.0,84,6.48,76,407,2545,10.7,0.28166115
5997,5997,Curtis Leschyshyn,1995-96,26.0,8,15,44,44,2,13,15,43.0,,434,30,87,117,431.0,48,5.97,37,209,1408,10.2,0.277771
5998,5998,Curtis Leschyshyn,1996-97,27.0,9,19,77,77,4,15,19,76.0,,511,34,102,136,507.0,82,6.29,74,413,2481,10.4,0.23421416
5999,5999,Curtis Leschyshyn,1997-98,28.0,10,22,77,77,4,18,22,102.0,,588,38,120,158,609.0,82,5.83,55,336,2444,9.8,0.24422312
6000,6000,Curtis Leschyshyn,1998-99,29.0,11,12,73,73,2,10,12,53.0,,661,40,130,170,662.0,82,5.28,57,380,2242,9.6,0.17004797
6001,6001,Curtis Leschyshyn,1999-00,30.0,12,9,65,65,2,7,9,35.0,1255.0,726,42,137,179,697.0,82,5.27,57,359,2285,9.4,0.15599447
6002,6002,Curtis Leschyshyn,2000-01,31.0,13,2,53,53,0,2,2,31.0,943.0,779,42,139,181,728.0,82,5.49,53,331,2294,9.8,0.12461689
6003,6003,Curtis Leschyshyn,2001-02,32.0,14,9,65,65,2,7,9,51.0,1263.0,844,44,146,190,779.0,82,5.51,63,376,2272,9.9,0.1335476
6004,6004,Curtis Leschyshyn,2002-03,33.0,15,10,79,79,1,9,10,59.0,1459.0,923,45,155,200,838.0,82,5.24,53,338,2262,9.5,0.12453064
6005,6005,Curtis Leschyshyn,2003-04,34.0,16,7,54,54,1,6,7,30.0,822.0,977,46,161,207,868.0,82,5.31,60,363,2326,9.4,0.101843596
6006,6006,Curtis Leschyshyn,2004-05,35.0,17,5,56,56,1,4,5,30.0,778.0,1033,47,165,212,898.0,82,5.14,57,348,2300,9.2,0.10490149
6007,6007,Curtis McKenzie,2015-16,24.0,2,5,36,36,4,1,5,41.0,415.0,36,4,1,5,41.0,82,5.32,47,251,2453,8.9,0.21232429
6008,6008,Curtis McKenzie,2016-17,25.0,3,0,3,3,0,0,0,3.0,26.0,39,4,1,5,44.0,82,5.34,48,255,2438,9.0,0.15348104
6009,6009,Curtis McKenzie,2017-18,26.0,4,16,53,53,6,10,16,66.0,575.0,92,10,11,21,110.0,82,5.45,47,245,2478,9.0,0.30725196
6010,6010,Curtis McKenzie,2018-19,27.0,5,2,7,7,0,2,2,11.0,57.0,99,10,13,23,121.0,82,5.86,50,250,2620,9.2,0.1796307
6011,6011,Curtis Murphy,2003-04,28.0,2,0,1,1,0,0,0,0.0,9.0,1,0,0,0,0.0,82,5.31,60,363,2326,9.4,0.16756535
6012,6012,Curtis Valk,2018-19,25.0,2,0,1,1,0,0,0,0.0,3.0,1,0,0,0,0.0,82,5.86,50,250,2620,9.2,0.14306575
6013,6013,D.J. King,2007-08,23.0,2,2,27,27,1,1,2,12.0,149.0,27,1,1,2,12.0,82,5.76,70,398,2426,9.7,0.15590808
6014,6014,D.J. King,2008-09,24.0,3,6,61,61,3,3,6,36.0,342.0,88,4,4,8,48.0,82,5.44,62,351,2383,9.4,0.17392358
6015,6015,D.J. King,2009-10,25.0,4,1,1,1,0,1,1,0.0,8.0,89,4,5,9,48.0,82,5.7,65,341,2477,9.4,0.15602699
6016,6016,D.J. King,2010-11,26.0,5,0,12,12,0,0,0,5.0,54.0,101,4,5,9,53.0,82,5.53,56,304,2486,9.1,0.13656184
6017,6017,D.J. King,2011-12,27.0,6,2,16,16,0,2,2,6.0,91.0,117,4,7,11,59.0,82,5.46,52,291,2492,9.0,0.12935221
6018,6018,D.J. King,2012-13,28.0,7,0,1,1,0,0,0,1.0,7.0,118,4,7,11,60.0,82,5.32,47,271,2439,8.9,0.12430474
6019,6019,D.J. Smith,1997-98,20.0,2,1,8,8,0,1,1,4.0,,8,0,1,1,4.0,82,5.83,55,336,2444,9.8,0.24846098
6020,6020,D.J. Smith,2000-01,23.0,3,0,3,3,0,0,0,2.0,38.0,11,0,1,1,6.0,82,5.49,53,331,2294,9.8,0.16539419
6021,6021,D.J. Smith,2003-04,26.0,4,1,34,34,1,0,1,7.0,130.0,45,1,1,2,13.0,82,5.31,60,363,2326,9.4,0.10912755
6022,6022,Dainius Zubrus,1997-98,19.0,2,21,68,68,8,13,21,71.0,,68,8,13,21,71.0,82,5.83,55,336,2444,9.8,0.3355199
6023,6023,Dainius Zubrus,1998-99,20.0,3,33,69,69,8,25,33,101.0,,137,16,38,54,172.0,82,5.28,57,380,2242,9.6,0.48723438
6024,6024,Dainius Zubrus,1999-00,21.0,4,16,80,80,6,10,16,80.0,980.0,217,22,48,70,252.0,82,5.27,57,359,2285,9.4,0.3213153
6025,6025,Dainius Zubrus,2000-01,22.0,5,42,73,73,14,28,42,139.0,1286.0,290,36,76,112,391.0,82,5.49,53,331,2294,9.8,0.54131675
6026,6026,Dainius Zubrus,2001-02,23.0,6,26,61,61,13,13,26,83.0,1063.0,351,49,89,138,474.0,82,5.51,63,376,2272,9.9,0.478654
6027,6027,Dainius Zubrus,2002-03,24.0,7,43,71,71,17,26,43,138.0,1339.0,422,66,115,181,612.0,82,5.24,53,338,2262,9.5,0.5649813
6028,6028,Dainius Zubrus,2003-04,25.0,8,35,63,63,13,22,35,104.0,1035.0,485,79,137,216,716.0,82,5.31,60,363,2326,9.4,0.52378887
6029,6029,Dainius Zubrus,2004-05,26.0,9,27,54,54,12,15,27,115.0,1054.0,539,91,152,243,831.0,82,5.14,57,348,2300,9.2,0.57590795
6030,6030,Dainius Zubrus,2006-07,28.0,10,57,71,71,23,34,57,181.0,1446.0,610,114,186,300,1012.0,82,6.05,85,480,2458,10.1,0.714275
6031,6031,Dainius Zubrus,2007-08,29.0,11,60,79,79,24,36,60,158.0,1540.0,689,138,222,360,1170.0,82,5.76,70,398,2426,9.7,0.6600294
6032,6032,Dainius Zubrus,2008-09,30.0,12,38,82,82,13,25,38,128.0,1287.0,771,151,247,398,1298.0,82,5.44,62,351,2383,9.4,0.45573848
6033,6033,Dainius Zubrus,2009-10,31.0,13,40,82,82,15,25,40,130.0,1252.0,853,166,272,438,1428.0,82,5.7,65,341,2477,9.4,0.4503172
6034,6034,Dainius Zubrus,2010-11,32.0,14,27,51,51,10,17,27,86.0,840.0,904,176,289,465,1514.0,82,5.53,56,304,2486,9.1,0.44643262
6035,6035,Dainius Zubrus,2011-12,33.0,15,30,79,79,13,17,30,115.0,1355.0,983,189,306,495,1629.0,82,5.46,52,291,2492,9.0,0.33891904
6036,6036,Dainius Zubrus,2012-13,34.0,16,44,82,82,17,27,44,109.0,1532.0,1065,206,333,539,1738.0,82,5.32,47,271,2439,8.9,0.43753934
6037,6037,Dainius Zubrus,2013-14,35.0,17,9,22,22,2,7,9,22.0,369.0,1087,208,340,548,1760.0,48,5.31,29,160,1399,9.1,0.32616067
6038,6038,Dainius Zubrus,2014-15,36.0,18,26,82,82,13,13,26,121.0,1440.0,1169,221,353,574,1881.0,82,5.34,48,269,2463,8.9,0.3059628
6039,6039,Dainius Zubrus,2015-16,37.0,19,10,74,74,4,6,10,72.0,1085.0,1243,225,359,584,1953.0,82,5.32,47,251,2453,8.9,0.18456316
6040,6040,Dainius Zubrus,2016-17,38.0,20,7,50,50,3,4,7,33.0,579.0,1293,228,363,591,1986.0,82,5.34,48,255,2438,9.0,0.18403369
6041,6041,Dakota Mermis,2018-19,25.0,2,0,9,9,0,0,0,7.0,99.0,9,0,0,0,7.0,82,5.86,50,250,2620,9.2,0.16531053
6042,6042,Dakota Mermis,2019-20,26.0,3,0,1,1,0,0,0,0.0,11.0,10,0,0,0,7.0,82,5.96,47,239,2579,9.5,0.16284934
6043,6043,Dakota Mermis,2020-21,27.0,4,4,10,10,1,3,4,17.0,192.0,20,1,3,4,24.0,70,5.96,42,208,2192,9.5,0.22310495
6044,6044,Dale Clarke,2001-02,23.0,2,0,3,3,0,0,0,5.0,41.0,3,0,0,0,5.0,82,5.51,63,376,2272,9.9,0.16797936
6045,6045,Dale Craigwell,1992-93,21.0,2,16,32,32,5,11,16,38.0,,32,5,11,16,38.0,80,6.96,77,402,2440,11.4,0.43894455
6046,6046,Dale Craigwell,1993-94,22.0,3,4,8,8,3,1,4,7.0,,40,8,12,20,45.0,84,7.25,87,443,2603,11.7,0.29547188
6047,6047,Dale Craigwell,1994-95,23.0,4,9,58,58,3,6,9,35.0,,98,11,18,29,80.0,84,6.48,76,407,2545,10.7,0.22234526
6048,6048,Dale DeGray,1986-87,23.0,2,0,1,1,0,0,0,1.0,,1,0,0,0,1.0,80,7.94,82,370,2484,12.8,0.21676609
6049,6049,Dale DeGray,1987-88,24.0,3,13,27,27,6,7,13,57.0,,28,6,7,13,58.0,80,7.34,72,344,2400,12.2,0.39975688
6050,6050,Dale DeGray,1988-89,25.0,4,24,56,56,6,18,24,122.0,,84,12,25,37,180.0,80,7.43,89,437,2435,12.2,0.42284077
6051,6051,Dale DeGray,1989-90,26.0,5,28,63,63,6,22,28,87.0,,147,18,47,65,267.0,80,7.48,85,403,2430,12.3,0.38858348
6052,6052,Dale DeGray,1990-91,27.0,6,0,6,6,0,0,0,5.0,,153,18,47,65,272.0,80,7.37,76,367,2421,12.2,0.26929712
6053,6053,Dale Dunbar,1986-87,25.0,2,0,1,1,0,0,0,0.0,,1,0,0,0,0.0,80,7.94,82,370,2484,12.8,0.16502598
6054,6054,Dale Dunbar,1989-90,28.0,3,0,1,1,0,0,0,2.0,,2,0,0,0,2.0,80,7.48,85,403,2430,12.3,0.17417347
6055,6055,Dale Hawerchuk,1982-83,19.0,2,103,80,80,45,58,103,339.0,,80,45,58,103,339.0,80,8.03,73,320,2489,12.9,1.2570264
6056,6056,Dale Hawerchuk,1983-84,20.0,3,91,79,79,40,51,91,297.0,,159,85,109,194,636.0,80,7.73,71,310,2444,12.7,1.1769214
6057,6057,Dale Hawerchuk,1984-85,21.0,4,102,80,80,37,65,102,256.0,,239,122,174,296,892.0,80,7.89,74,336,2448,12.9,1.3386143
6058,6058,Dale Hawerchuk,1985-86,22.0,5,130,80,80,53,77,130,280.0,,319,175,251,426,1172.0,80,7.77,71,321,2447,12.7,1.4852302
6059,6059,Dale Hawerchuk,1986-87,23.0,6,105,80,80,46,59,105,313.0,,399,221,310,531,1485.0,80,7.94,82,370,2484,12.8,1.2779257
6060,6060,Dale Hawerchuk,1987-88,24.0,7,100,80,80,47,53,100,267.0,,479,268,363,631,1752.0,80,7.34,72,344,2400,12.2,1.3050511
6061,6061,Dale Hawerchuk,1988-89,25.0,8,121,80,80,44,77,121,292.0,,559,312,440,752,2044.0,80,7.43,89,437,2435,12.2,1.2634977
6062,6062,Dale Hawerchuk,1989-90,26.0,9,96,75,75,41,55,96,239.0,,634,353,495,848,2283.0,80,7.48,85,403,2430,12.3,1.1163867
6063,6063,Dale Hawerchuk,1990-91,27.0,10,81,79,79,26,55,81,211.0,,713,379,550,929,2494.0,80,7.37,76,367,2421,12.2,1.0008922
6064,6064,Dale Hawerchuk,1991-92,28.0,11,89,80,80,31,58,89,194.0,,793,410,608,1018,2688.0,80,6.91,71,366,2385,11.6,1.1241646
6065,6065,Dale Hawerchuk,1992-93,29.0,12,98,77,77,23,75,98,242.0,,870,433,683,1116,2930.0,80,6.96,77,402,2440,11.4,1.1785154
6066,6066,Dale Hawerchuk,1993-94,30.0,13,96,81,81,16,80,96,259.0,,951,449,763,1212,3189.0,84,7.25,87,443,2603,11.7,1.0170505
6067,6067,Dale Hawerchuk,1994-95,31.0,14,86,81,81,35,51,86,227.0,,1032,484,814,1298,3416.0,84,6.48,76,407,2545,10.7,0.9274454
6068,6068,Dale Hawerchuk,1995-96,32.0,15,16,23,23,5,11,16,56.0,,1055,489,825,1314,3472.0,48,5.97,37,209,1408,10.2,0.72098553
6069,6069,Dale Hawerchuk,1996-97,33.0,16,61,82,82,17,44,61,180.0,,1137,506,869,1375,3652.0,82,6.29,74,413,2481,10.4,0.710392
6070,6070,Dale Hawerchuk,1997-98,34.0,17,34,51,51,12,22,34,102.0,,1188,518,891,1409,3754.0,82,5.83,55,336,2444,9.8,0.6026429
6071,6071,Dale Henry,1985-86,21.0,2,3,16,16,2,1,3,9.0,,16,2,1,3,9.0,80,7.77,71,321,2447,12.7,0.36708915
6072,6072,Dale Henry,1986-87,22.0,3,4,7,7,1,3,4,5.0,,23,3,4,7,14.0,80,7.94,82,370,2484,12.8,0.27315974
6073,6073,Dale Henry,1987-88,23.0,4,6,19,19,3,3,6,14.0,,42,6,7,13,28.0,80,7.34,72,344,2400,12.2,0.28041458
6074,6074,Dale Henry,1988-89,24.0,5,20,48,48,5,15,20,53.0,,90,11,22,33,81.0,80,7.43,89,437,2435,12.2,0.35275012
6075,6075,Dale Henry,1989-90,25.0,6,4,22,22,2,2,4,20.0,,112,13,24,37,101.0,80,7.48,85,403,2430,12.3,0.28833807
6076,6076,Dale Henry,1990-91,26.0,7,2,20,20,0,2,2,6.0,,132,13,26,39,107.0,80,7.37,76,367,2421,12.2,0.17061225
6077,6077,Dale Hunter,1981-82,21.0,2,63,80,80,19,44,63,152.0,,80,19,44,63,152.0,80,7.69,77,340,2441,12.6,0.79265994
6078,6078,Dale Hunter,1982-83,22.0,3,72,80,80,22,50,72,124.0,,160,41,94,135,276.0,80,8.03,73,320,2489,12.9,0.8344895
6079,6079,Dale Hunter,1983-84,23.0,4,63,80,80,17,46,63,125.0,,240,58,140,198,401.0,80,7.73,71,310,2444,12.7,0.8388846
6080,6080,Dale Hunter,1984-85,24.0,5,79,77,77,24,55,79,123.0,,317,82,195,277,524.0,80,7.89,74,336,2448,12.9,0.9195188
6081,6081,Dale Hunter,1985-86,25.0,6,72,80,80,20,52,72,118.0,,397,102,247,349,642.0,80,7.77,71,321,2447,12.7,0.88158107
6082,6082,Dale Hunter,1986-87,26.0,7,70,80,80,28,42,70,151.0,,477,130,289,419,793.0,80,7.94,82,370,2484,12.8,0.84850085
6083,6083,Dale Hunter,1987-88,27.0,8,39,46,46,10,29,39,53.0,,523,140,318,458,846.0,80,7.34,72,344,2400,12.2,0.7319272
6084,6084,Dale Hunter,1988-89,28.0,9,59,79,79,22,37,59,126.0,,602,162,355,517,972.0,80,7.43,89,437,2435,12.2,0.72144496
6085,6085,Dale Hunter,1989-90,29.0,10,57,80,80,20,37,57,138.0,,682,182,392,574,1110.0,80,7.48,85,403,2430,12.3,0.73716795
6086,6086,Dale Hunter,1990-91,30.0,11,62,80,80,23,39,62,123.0,,762,205,431,636,1233.0,80,7.37,76,367,2421,12.2,0.7189781
6087,6087,Dale Hunter,1991-92,31.0,12,46,76,76,16,30,46,106.0,,838,221,461,682,1339.0,80,6.91,71,366,2385,11.6,0.6166551
6088,6088,Dale Hunter,1992-93,32.0,13,78,80,80,28,50,78,110.0,,918,249,511,760,1449.0,80,6.96,77,402,2440,11.4,0.8124288
6089,6089,Dale Hunter,1993-94,33.0,14,79,84,84,20,59,79,120.0,,1002,269,570,839,1569.0,84,7.25,87,443,2603,11.7,0.74876654
6090,6090,Dale Hunter,1994-95,34.0,15,38,52,52,9,29,38,61.0,,1054,278,599,877,1630.0,84,6.48,76,407,2545,10.7,0.52491987
6091,6091,Dale Hunter,1995-96,35.0,16,23,45,45,8,15,23,73.0,,1099,286,614,900,1703.0,48,5.97,37,209,1408,10.2,0.4455928
6092,6092,Dale Hunter,1996-97,36.0,17,37,82,82,13,24,37,128.0,,1181,299,638,937,1831.0,82,6.29,74,413,2481,10.4,0.44379634
6093,6093,Dale Hunter,1997-98,37.0,18,46,82,82,14,32,46,110.0,,1263,313,670,983,1941.0,82,5.83,55,336,2444,9.8,0.47894055
6094,6094,Dale Hunter,1998-99,38.0,19,26,82,82,8,18,26,82.0,,1345,321,688,1009,2023.0,82,5.28,57,380,2242,9.6,0.2878913
6095,6095,Dale Hunter,1999-00,39.0,20,11,62,62,2,9,11,24.0,563.0,1407,323,697,1020,2047.0,82,5.27,57,359,2285,9.4,0.27330863
6096,6096,Dale Krentz,1987-88,26.0,2,0,8,8,0,0,0,5.0,,8,0,0,0,5.0,80,7.34,72,344,2400,12.2,0.2113699
6097,6097,Dale Krentz,1988-89,27.0,3,2,6,6,2,0,2,5.0,,14,2,0,2,10.0,80,7.43,89,437,2435,12.2,0.27769944
6098,6098,Dale Krentz,1989-90,28.0,4,6,16,16,3,3,6,27.0,,30,5,3,8,37.0,80,7.48,85,403,2430,12.3,0.3099534
6099,6099,Dale Kushner,1990-91,24.0,2,0,2,2,0,0,0,0.0,,2,0,0,0,0.0,80,7.37,76,367,2421,12.2,0.1824621
6100,6100,Dale Kushner,1991-92,25.0,3,18,63,63,7,11,18,59.0,,65,7,11,18,59.0,80,6.91,71,366,2385,11.6,0.28187808
6101,6101,Dale Kushner,1992-93,26.0,4,5,19,19,3,2,5,19.0,,84,10,13,23,78.0,80,6.96,77,402,2440,11.4,0.29577726
6102,6102,Dale McTavish,1997-98,25.0,2,3,9,9,1,2,3,14.0,,9,1,2,3,14.0,82,5.83,55,336,2444,9.8,0.21192512
6103,6103,Dale Purinton,2000-01,24.0,2,0,1,1,0,0,0,1.0,13.0,1,0,0,0,1.0,82,5.49,53,331,2294,9.8,0.16600415
6104,6104,Dale Purinton,2001-02,25.0,3,2,42,42,0,2,2,13.0,401.0,43,0,2,2,14.0,82,5.51,63,376,2272,9.9,0.08299941
6105,6105,Dale Purinton,2002-03,26.0,4,4,40,40,0,4,4,11.0,305.0,83,0,6,6,25.0,82,5.24,53,338,2262,9.5,0.088091165
6106,6106,Dale Purinton,2003-04,27.0,5,12,58,58,3,9,12,50.0,872.0,141,3,15,18,75.0,82,5.31,60,363,2326,9.4,0.16439027
6107,6107,Dale Purinton,2004-05,28.0,6,2,40,40,1,1,2,31.0,511.0,181,4,16,20,106.0,82,5.14,57,348,2300,9.2,0.1408295
6108,6108,Dale Rominski,2000-01,25.0,2,1,3,3,0,1,1,0.0,25.0,3,0,1,1,0.0,82,5.49,53,331,2294,9.8,0.17149079
6109,6109,Dale Weise,2011-12,23.0,2,0,10,10,0,0,0,9.0,65.0,10,0,0,0,9.0,82,5.46,52,291,2492,9.0,0.17651251
6110,6110,Dale Weise,2012-13,24.0,3,8,68,68,4,4,8,48.0,555.0,78,4,4,8,57.0,82,5.32,47,271,2439,8.9,0.16294348
6111,6111,Dale Weise,2013-14,25.0,4,6,40,40,3,3,6,35.0,382.0,118,7,7,14,92.0,48,5.31,29,160,1399,9.1,0.21255085
6112,6112,Dale Weise,2014-15,26.0,5,16,61,61,6,10,16,41.0,513.0,179,13,17,30,133.0,82,5.34,48,269,2463,8.9,0.21924034
6113,6113,Dale Weise,2015-16,27.0,6,29,79,79,10,19,29,91.0,962.0,258,23,36,59,224.0,82,5.32,47,251,2453,8.9,0.29961544
6114,6114,Dale Weise,2016-17,28.0,7,27,71,71,14,13,27,136.0,952.0,329,37,49,86,360.0,82,5.34,48,255,2438,9.0,0.33744133
6115,6115,Dale Weise,2017-18,29.0,8,15,64,64,8,7,15,94.0,824.0,393,45,56,101,454.0,82,5.45,47,245,2478,9.0,0.22462246
6116,6116,Dale Weise,2018-19,30.0,9,8,46,46,4,4,8,44.0,486.0,439,49,60,109,498.0,82,5.86,50,250,2620,9.2,0.17241335
6117,6117,Dale Weise,2019-20,31.0,10,11,51,51,5,6,11,58.0,601.0,490,54,66,120,556.0,82,5.96,47,239,2579,9.5,0.19402406
6118,6118,Dale Weise,2020-21,32.0,11,5,23,23,1,4,5,15.0,213.0,513,55,70,125,571.0,70,5.96,42,208,2192,9.5,0.16547397
6119,6119,Dallas Drake,1993-94,24.0,2,44,72,72,18,26,44,89.0,,72,18,26,44,89.0,84,7.25,87,443,2603,11.7,0.5033382
6120,6120,Dallas Drake,1994-95,25.0,3,40,62,62,13,27,40,112.0,,134,31,53,84,201.0,84,6.48,76,407,2545,10.7,0.53457433
6121,6121,Dallas Drake,1995-96,26.0,4,26,43,43,8,18,26,66.0,,177,39,71,110,267.0,48,5.97,37,209,1408,10.2,0.54664767
6122,6122,Dallas Drake,1996-97,27.0,5,39,69,69,19,20,39,121.0,,246,58,91,149,388.0,82,6.29,74,413,2481,10.4,0.53321457
6123,6123,Dallas Drake,1997-98,28.0,6,36,63,63,17,19,36,113.0,,309,75,110,185,501.0,82,5.83,55,336,2444,9.8,0.5356671
6124,6124,Dallas Drake,1998-99,29.0,7,40,60,60,11,29,40,112.0,,369,86,139,225,613.0,82,5.28,57,380,2242,9.6,0.56478477
6125,6125,Dallas Drake,1999-00,30.0,8,31,53,53,9,22,31,105.0,829.0,422,95,161,256,718.0,82,5.27,57,359,2285,9.4,0.5561157
6126,6126,Dallas Drake,2000-01,31.0,9,45,79,79,15,30,45,127.0,1248.0,501,110,191,301,845.0,82,5.49,53,331,2294,9.8,0.51210546
6127,6127,Dallas Drake,2001-02,32.0,10,41,82,82,12,29,41,142.0,1208.0,583,122,220,342,987.0,82,5.51,63,376,2272,9.9,0.44899523
6128,6128,Dallas Drake,2002-03,33.0,11,26,80,80,11,15,26,116.0,1075.0,663,133,235,368,1103.0,82,5.24,53,338,2262,9.5,0.32101244
6129,6129,Dallas Drake,2003-04,34.0,12,30,80,80,20,10,30,113.0,1184.0,743,153,245,398,1216.0,82,5.31,60,363,2326,9.4,0.3725078
6130,6130,Dallas Drake,2004-05,35.0,13,35,79,79,13,22,35,121.0,1340.0,822,166,267,433,1337.0,82,5.14,57,348,2300,9.2,0.46061224
6131,6131,Dallas Drake,2006-07,37.0,14,26,62,62,2,24,26,88.0,1049.0,884,168,291,459,1425.0,82,6.05,85,480,2458,10.1,0.29691452
6132,6132,Dallas Drake,2007-08,38.0,15,12,60,60,6,6,12,74.0,773.0,944,174,297,471,1499.0,82,5.76,70,398,2426,9.7,0.19504696
6133,6133,Dallas Drake,2008-09,39.0,16,6,65,65,3,3,6,46.0,696.0,1009,177,300,477,1545.0,82,5.44,62,351,2383,9.4,0.15159434
6134,6134,Dallas Eakins,1993-94,26.0,2,2,14,14,0,2,2,9.0,,14,0,2,2,9.0,84,7.25,87,443,2603,11.7,0.20723698
6135,6135,Dallas Eakins,1994-95,27.0,3,0,1,1,0,0,0,2.0,,15,0,2,2,11.0,84,6.48,76,407,2545,10.7,0.16124025
6136,6136,Dallas Eakins,1995-96,28.0,4,1,17,17,0,1,1,3.0,,32,0,3,3,14.0,48,5.97,37,209,1408,10.2,0.14987001
6137,6137,Dallas Eakins,1996-97,29.0,5,1,18,18,0,1,1,6.0,,50,0,4,4,20.0,82,6.29,74,413,2481,10.4,0.112069994
6138,6138,Dallas Eakins,1997-98,30.0,6,0,7,7,0,0,0,4.0,,57,0,4,4,24.0,82,5.83,55,336,2444,9.8,0.10318819
6139,6139,Dallas Eakins,1998-99,31.0,7,1,23,23,0,1,1,16.0,,80,0,5,5,40.0,82,5.28,57,380,2242,9.6,0.10058749
6140,6140,Dallas Eakins,1999-00,32.0,8,2,18,18,0,2,2,11.0,296.0,98,0,7,7,51.0,82,5.27,57,359,2285,9.4,0.13884676
6141,6141,Dallas Eakins,2000-01,33.0,9,1,2,2,0,1,1,4.0,43.0,100,0,8,8,55.0,82,5.49,53,331,2294,9.8,0.13508764
6142,6142,Dallas Eakins,2001-02,34.0,10,1,17,17,0,1,1,4.0,209.0,117,0,9,9,59.0,82,5.51,63,376,2272,9.9,0.10392678
6143,6143,Dallas Eakins,2002-03,35.0,11,0,3,3,0,0,0,0.0,43.0,120,0,9,9,59.0,82,5.24,53,338,2262,9.5,0.116408974
6144,6144,Dallas Gaume,1989-90,26.0,2,2,4,4,1,1,2,5.0,,4,1,1,2,5.0,80,7.48,85,403,2430,12.3,0.26036745
6145,6145,Dalton Prout,2012-13,22.0,2,0,5,5,0,0,0,2.0,59.0,5,0,0,0,2.0,82,5.32,47,271,2439,8.9,0.17134002
6146,6146,Dalton Prout,2013-14,23.0,3,7,28,28,1,6,7,16.0,519.0,33,1,6,7,18.0,48,5.31,29,160,1399,9.1,0.20490989
6147,6147,Dalton Prout,2014-15,24.0,4,6,49,49,2,4,6,56.0,843.0,82,3,10,13,74.0,82,5.34,48,269,2463,8.9,0.1925815
6148,6148,Dalton Prout,2015-16,25.0,5,8,63,63,0,8,8,64.0,1160.0,145,3,18,21,138.0,82,5.32,47,251,2453,8.9,0.13365808
6149,6149,Dalton Prout,2016-17,26.0,6,9,64,64,3,6,9,69.0,1035.0,209,6,24,30,207.0,82,5.34,48,255,2438,9.0,0.16140562
6150,6150,Dalton Prout,2017-18,27.0,7,6,29,29,0,6,6,13.0,405.0,238,6,30,36,220.0,82,5.45,47,245,2478,9.0,0.1136218
6151,6151,Dalton Prout,2018-19,28.0,8,0,4,4,0,0,0,5.0,56.0,242,6,30,36,225.0,82,5.86,50,250,2620,9.2,0.13013771
6152,6152,Dalton Prout,2019-20,29.0,9,2,20,20,1,1,2,14.0,262.0,262,7,31,38,239.0,82,5.96,47,239,2579,9.5,0.100008726
6153,6153,Dalton Prout,2020-21,30.0,10,0,2,2,0,0,0,2.0,26.0,264,7,31,38,241.0,70,5.96,42,208,2192,9.5,0.1434842
6154,6154,Dalton Smith,2020-21,28.0,2,0,1,1,0,0,0,0.0,1.0,1,0,0,0,0.0,70,5.96,42,208,2192,9.5,0.16871157
6155,6155,Damian Surma,2003-04,23.0,2,1,1,1,1,0,1,1.0,7.0,1,1,0,1,1.0,82,5.31,60,363,2326,9.4,0.3327847
6156,6156,Damian Surma,2004-05,24.0,3,1,1,1,0,1,1,0.0,9.0,2,1,1,2,1.0,82,5.14,57,348,2300,9.2,0.20131844
6157,6157,Damien Brunner,2013-14,27.0,2,26,44,44,12,14,26,123.0,686.0,44,12,14,26,123.0,48,5.31,29,160,1399,9.1,0.53013647
6158,6158,Damien Brunner,2014-15,28.0,3,25,60,60,11,14,25,110.0,812.0,104,23,28,51,233.0,82,5.34,48,269,2463,8.9,0.3478002
6159,6159,Damien Brunner,2015-16,29.0,4,7,17,17,2,5,7,29.0,258.0,121,25,33,58,262.0,82,5.32,47,251,2453,8.9,0.26065385
6160,6160,Damon Severson,2015-16,21.0,2,17,51,51,5,12,17,93.0,1120.0,51,5,12,17,93.0,82,5.32,47,251,2453,8.9,0.37764817
6161,6161,Damon Severson,2016-17,22.0,3,21,72,72,1,20,21,94.0,1308.0,123,6,32,38,187.0,82,5.34,48,255,2438,9.0,0.30022517
6162,6162,Damon Severson,2017-18,23.0,4,31,80,80,3,28,31,125.0,1628.0,203,9,60,69,312.0,82,5.45,47,245,2478,9.0,0.38458562
6163,6163,Damon Severson,2018-19,24.0,5,24,76,76,9,15,24,121.0,1496.0,279,18,75,93,433.0,82,5.86,50,250,2620,9.2,0.31665802
6164,6164,Damon Severson,2019-20,25.0,6,39,82,82,11,28,39,146.0,1808.0,361,29,103,132,579.0,82,5.96,47,239,2579,9.5,0.5169685
6165,6165,Damon Severson,2020-21,26.0,7,31,69,69,8,23,31,114.0,1584.0,430,37,126,163,693.0,70,5.96,42,208,2192,9.5,0.4869381
6166,6166,Dan Bonar,1981-82,25.0,2,26,71,71,11,15,26,64.0,,71,11,15,26,64.0,80,7.69,77,340,2441,12.6,0.33849102
6167,6167,Dan Bonar,1982-83,26.0,3,36,79,79,13,23,36,123.0,,150,24,38,62,187.0,80,8.03,73,320,2489,12.9,0.42778906
6168,6168,Dan Bonar,1983-84,27.0,4,2,20,20,1,1,2,15.0,,170,25,39,64,202.0,80,7.73,71,310,2444,12.7,0.24552873
6169,6169,Dan Bourbonnais,1982-83,20.0,2,12,24,24,3,9,12,30.0,,24,3,9,12,30.0,80,8.03,73,320,2489,12.9,0.40014505
6170,6170,Dan Bourbonnais,1984-85,22.0,3,16,35,35,0,16,16,42.0,,59,3,25,28,72.0,80,7.89,74,336,2448,12.9,0.3624314
6171,6171,Dan Boyle,1999-00,23.0,2,8,22,22,3,5,8,31.0,414.0,22,3,5,8,31.0,82,5.27,57,359,2285,9.4,0.29577658
6172,6172,Dan Boyle,2000-01,24.0,3,3,13,13,0,3,3,9.0,220.0,35,3,8,11,40.0,82,5.49,53,331,2294,9.8,0.18758541
6173,6173,Dan Boyle,2001-02,25.0,4,22,69,69,4,18,22,83.0,1169.0,104,7,26,33,123.0,82,5.51,63,376,2272,9.9,0.26446944
6174,6174,Dan Boyle,2002-03,26.0,5,26,66,66,8,18,26,99.0,1313.0,170,15,44,59,222.0,82,5.24,53,338,2262,9.5,0.3616474
6175,6175,Dan Boyle,2003-04,27.0,6,53,77,77,13,40,53,136.0,1887.0,247,28,84,112,358.0,82,5.31,60,363,2326,9.4,0.60335284
6176,6176,Dan Boyle,2004-05,28.0,7,39,78,78,9,30,39,137.0,1776.0,325,37,114,151,495.0,82,5.14,57,348,2300,9.2,0.531906
6177,6177,Dan Boyle,2006-07,30.0,8,53,79,79,15,38,53,153.0,1851.0,404,52,152,204,648.0,82,6.05,85,480,2458,10.1,0.57667035
6178,6178,Dan Boyle,2007-08,31.0,9,63,82,82,20,43,63,203.0,2218.0,486,72,195,267,851.0,82,5.76,70,398,2426,9.7,0.67745584
6179,6179,Dan Boyle,2008-09,32.0,10,25,37,37,4,21,25,74.0,1014.0,523,76,216,292,925.0,82,5.44,62,351,2383,9.4,0.5057437
6180,6180,Dan Boyle,2009-10,33.0,11,57,77,77,16,41,57,213.0,1908.0,600,92,257,349,1138.0,82,5.7,65,341,2477,9.4,0.6565664
6181,6181,Dan Boyle,2010-11,34.0,12,58,76,76,15,43,58,180.0,1992.0,676,107,300,407,1318.0,82,5.53,56,304,2486,9.1,0.6441484
6182,6182,Dan Boyle,2011-12,35.0,13,50,76,76,9,41,50,199.0,1994.0,752,116,341,457,1517.0,82,5.46,52,291,2492,9.0,0.58905196
6183,6183,Dan Boyle,2012-13,36.0,14,48,81,81,9,39,48,252.0,2072.0,833,125,380,505,1769.0,82,5.32,47,271,2439,8.9,0.589159
6184,6184,Dan Boyle,2013-14,37.0,15,20,46,46,7,13,20,97.0,1049.0,879,132,393,525,1866.0,48,5.31,29,160,1399,9.1,0.44086012
6185,6185,Dan Boyle,2014-15,38.0,16,36,75,75,12,24,36,154.0,1596.0,954,144,417,561,2020.0,82,5.34,48,269,2463,8.9,0.39204228
6186,6186,Dan Boyle,2015-16,39.0,17,20,65,65,9,11,20,116.0,1316.0,1019,153,428,581,2136.0,82,5.32,47,251,2453,8.9,0.29032856
6187,6187,Dan Boyle,2016-17,40.0,18,24,74,74,10,14,24,95.0,1392.0,1093,163,442,605,2231.0,82,5.34,48,255,2438,9.0,0.28426307
6188,6188,Dan Brennan,1984-85,22.0,2,0,2,2,0,0,0,1.0,,2,0,0,0,1.0,80,7.89,74,336,2448,12.9,0.22839698
6189,6189,Dan Brennan,1986-87,24.0,3,1,6,6,0,1,1,6.0,,8,0,1,1,7.0,80,7.94,82,370,2484,12.8,0.21035871
6190,6190,Dan Bylsma,1996-97,26.0,2,0,4,4,0,0,0,6.0,,4,0,0,0,6.0,82,6.29,74,413,2481,10.4,0.1686536
6191,6191,Dan Bylsma,1997-98,27.0,3,9,79,79,3,6,9,86.0,,83,3,6,9,92.0,82,5.83,55,336,2444,9.8,0.17016238
6192,6192,Dan Bylsma,1998-99,28.0,4,12,65,65,3,9,12,57.0,,148,6,15,21,149.0,82,5.28,57,380,2242,9.6,0.15159026
6193,6193,Dan Bylsma,1999-00,29.0,5,0,8,8,0,0,0,3.0,79.0,156,6,15,21,152.0,82,5.27,57,359,2285,9.4,0.13015652
6194,6194,Dan Bylsma,2000-01,30.0,6,9,64,64,3,6,9,43.0,665.0,220,9,21,30,195.0,82,5.49,53,331,2294,9.8,0.13136739
6195,6195,Dan Bylsma,2001-02,31.0,7,10,82,82,1,9,10,50.0,963.0,302,10,30,40,245.0,82,5.51,63,376,2272,9.9,0.12100619
6196,6196,Dan Bylsma,2002-03,32.0,8,17,77,77,8,9,17,72.0,893.0,379,18,39,57,317.0,82,5.24,53,338,2262,9.5,0.1943759
6197,6197,Dan Bylsma,2003-04,33.0,9,5,39,39,1,4,5,23.0,370.0,418,19,43,62,340.0,82,5.31,60,363,2326,9.4,0.12045643
6198,6198,Dan Bylsma,2004-05,34.0,10,0,11,11,0,0,0,6.0,78.0,429,19,43,62,346.0,82,5.14,57,348,2300,9.2,0.16506681
6199,6199,Dan Cleary,1998-99,20.0,2,0,6,6,0,0,0,4.0,,6,0,0,0,4.0,82,5.28,57,380,2242,9.6,0.22605917
6200,6200,Dan Cleary,1999-00,21.0,3,9,35,35,4,5,9,49.0,502.0,41,4,5,9,53.0,82,5.27,57,359,2285,9.4,0.29561335
6201,6201,Dan Cleary,2000-01,22.0,4,5,17,17,3,2,5,18.0,166.0,58,7,7,14,71.0,82,5.49,53,331,2294,9.8,0.29386455
6202,6202,Dan Cleary,2001-02,23.0,5,35,81,81,14,21,35,107.0,1051.0,139,21,28,49,178.0,82,5.51,63,376,2272,9.9,0.4348339
6203,6203,Dan Cleary,2002-03,24.0,6,29,65,65,10,19,29,75.0,826.0,204,31,47,78,253.0,82,5.24,53,338,2262,9.5,0.3925622
6204,6204,Dan Cleary,2003-04,25.0,7,17,57,57,4,13,17,89.0,682.0,261,35,60,95,342.0,82,5.31,60,363,2326,9.4,0.27930576
6205,6205,Dan Cleary,2004-05,26.0,8,17,68,68,6,11,17,83.0,898.0,329,41,71,112,425.0,82,5.14,57,348,2300,9.2,0.29085717
6206,6206,Dan Cleary,2006-07,28.0,9,15,77,77,3,12,15,106.0,808.0,406,44,83,127,531.0,82,6.05,85,480,2458,10.1,0.23627368
6207,6207,Dan Cleary,2007-08,29.0,10,40,71,71,20,20,40,135.0,1098.0,477,64,103,167,666.0,82,5.76,70,398,2426,9.7,0.4614562
6208,6208,Dan Cleary,2008-09,30.0,11,42,63,63,20,22,42,177.0,1095.0,540,84,125,209,843.0,82,5.44,62,351,2383,9.4,0.6224266
6209,6209,Dan Cleary,2009-10,31.0,12,40,74,74,14,26,40,163.0,1253.0,614,98,151,249,1006.0,82,5.7,65,341,2477,9.4,0.45207664
6210,6210,Dan Cleary,2010-11,32.0,13,34,64,64,15,19,34,140.0,1103.0,678,113,170,283,1146.0,82,5.53,56,304,2486,9.1,0.4330169
6211,6211,Dan Cleary,2011-12,33.0,14,46,68,68,26,20,46,192.0,1131.0,746,139,190,329,1338.0,82,5.46,52,291,2492,9.0,0.58932674
6212,6212,Dan Cleary,2012-13,34.0,15,33,75,75,12,21,33,199.0,1199.0,821,151,211,362,1537.0,82,5.32,47,271,2439,8.9,0.4106582
6213,6213,Dan Cleary,2013-14,35.0,16,15,48,48,9,6,15,93.0,789.0,869,160,217,377,1630.0,48,5.31,29,160,1399,9.1,0.3086105
6214,6214,Dan Cleary,2014-15,36.0,17,8,52,52,4,4,8,64.0,723.0,921,164,221,385,1694.0,82,5.34,48,269,2463,8.9,0.15654564
6215,6215,Dan Cleary,2015-16,37.0,18,2,17,17,1,1,2,17.0,155.0,938,165,222,387,1711.0,82,5.32,47,251,2453,8.9,0.20293233
6216,6216,Dan Currie,1991-92,23.0,2,0,5,5,0,0,0,5.0,,5,0,0,0,5.0,80,6.91,71,366,2385,11.6,0.19708028
6217,6217,Dan Currie,1992-93,24.0,3,1,7,7,1,0,1,3.0,,12,1,0,1,8.0,80,6.96,77,402,2440,11.4,0.22305274
6218,6218,Dan Currie,1993-94,25.0,4,0,5,5,0,0,0,11.0,,17,1,0,1,19.0,84,7.25,87,443,2603,11.7,0.2006219
6219,6219,Dan Currie,1994-95,26.0,5,2,5,5,1,1,2,12.0,,22,2,1,3,31.0,84,6.48,76,407,2545,10.7,0.20270938
6220,6220,Dan Daoust,1983-84,23.0,2,52,52,52,18,34,52,123.0,,52,18,34,52,123.0,80,7.73,71,310,2444,12.7,0.7927594
6221,6221,Dan Daoust,1984-85,24.0,3,74,78,78,18,56,74,154.0,,130,36,90,126,277.0,80,7.89,74,336,2448,12.9,0.8333224
6222,6222,Dan Daoust,1985-86,25.0,4,54,79,79,17,37,54,142.0,,209,53,127,180,419.0,80,7.77,71,321,2447,12.7,0.7600827
6223,6223,Dan Daoust,1986-87,26.0,5,20,80,80,7,13,20,91.0,,289,60,140,200,510.0,80,7.94,82,370,2484,12.8,0.3475614
6224,6224,Dan Daoust,1987-88,27.0,6,7,33,33,4,3,7,25.0,,322,64,143,207,535.0,80,7.34,72,344,2400,12.2,0.4364776
6225,6225,Dan Daoust,1988-89,28.0,7,17,67,67,9,8,17,57.0,,389,73,151,224,592.0,80,7.43,89,437,2435,12.2,0.32756275
6226,6226,Dan Daoust,1989-90,29.0,8,12,68,68,7,5,12,66.0,,457,80,156,236,658.0,80,7.48,85,403,2430,12.3,0.270912
6227,6227,Dan Daoust,1990-91,30.0,9,18,65,65,7,11,18,53.0,,522,87,167,254,711.0,80,7.37,76,367,2421,12.2,0.29947454
6228,6228,Dan Dorion,1986-87,23.0,2,2,3,3,1,1,2,6.0,,3,1,1,2,6.0,80,7.94,82,370,2484,12.8,0.27279735
6229,6229,Dan Dorion,1988-89,25.0,3,0,1,1,0,0,0,0.0,,4,1,1,2,6.0,80,7.43,89,437,2435,12.2,0.1896635
6230,6230,Dan Focht,2002-03,25.0,2,0,8,8,0,0,0,5.0,99.0,8,0,0,0,5.0,82,5.24,53,338,2262,9.5,0.16574696
6231,6231,Dan Focht,2003-04,26.0,3,3,22,22,0,3,3,12.0,305.0,30,0,3,3,17.0,82,5.31,60,363,2326,9.4,0.12449348
6232,6232,Dan Focht,2004-05,27.0,4,5,52,52,2,3,5,56.0,863.0,82,2,6,8,73.0,82,5.14,57,348,2300,9.2,0.17068219
6233,6233,Dan Frawley,1984-85,22.0,2,0,3,3,0,0,0,2.0,,3,0,0,0,2.0,80,7.89,74,336,2448,12.9,0.22890192
6234,6234,Dan Frawley,1985-86,23.0,3,7,30,30,4,3,7,23.0,,33,4,3,7,25.0,80,7.77,71,321,2447,12.7,0.29937944
6235,6235,Dan Frawley,1986-87,24.0,4,21,69,69,10,11,21,80.0,,102,14,14,28,105.0,80,7.94,82,370,2484,12.8,0.31717533
6236,6236,Dan Frawley,1987-88,25.0,5,28,78,78,14,14,28,108.0,,180,28,28,56,213.0,80,7.34,72,344,2400,12.2,0.37640542
6237,6237,Dan Frawley,1988-89,26.0,6,14,47,47,6,8,14,66.0,,227,34,36,70,279.0,80,7.43,89,437,2435,12.2,0.33944315
6238,6238,Dan Frawley,1989-90,27.0,7,7,46,46,3,4,7,37.0,,273,37,40,77,316.0,80,7.48,85,403,2430,12.3,0.2030291
6239,6239,Dan Fridgen,1982-83,23.0,2,1,2,2,0,1,1,5.0,,2,0,1,1,5.0,80,8.03,73,320,2489,12.9,0.2510293
6240,6240,Dan Fridgen,1983-84,24.0,3,4,11,11,2,2,4,13.0,,13,2,3,5,18.0,80,7.73,71,310,2444,12.7,0.29356816
6241,6241,Dan Fritsche,2004-05,19.0,2,1,19,19,1,0,1,19.0,160.0,19,1,0,1,19.0,82,5.14,57,348,2300,9.2,0.22587505
6242,6242,Dan Fritsche,2006-07,21.0,3,13,59,59,6,7,13,93.0,607.0,78,7,7,14,112.0,82,6.05,85,480,2458,10.1,0.30699253
6243,6243,Dan Fritsche,2007-08,22.0,4,27,59,59,12,15,27,81.0,828.0,137,19,22,41,193.0,82,5.76,70,398,2426,9.7,0.40699643
6244,6244,Dan Fritsche,2008-09,23.0,5,22,69,69,10,12,22,109.0,852.0,206,29,34,63,302.0,82,5.44,62,351,2383,9.4,0.36412424
6245,6245,Dan Fritsche,2009-10,24.0,6,13,50,50,5,8,13,54.0,532.0,256,34,42,76,356.0,82,5.7,65,341,2477,9.4,0.27778196
6246,6246,Dan Girardi,2007-08,23.0,2,6,34,34,0,6,6,33.0,538.0,34,0,6,6,33.0,82,5.76,70,398,2426,9.7,0.19889486
6247,6247,Dan Girardi,2008-09,24.0,3,28,82,82,10,18,28,147.0,1738.0,116,10,24,34,180.0,82,5.44,62,351,2383,9.4,0.38233644
6248,6248,Dan Girardi,2009-10,25.0,4,22,82,82,4,18,22,122.0,1765.0,198,14,42,56,302.0,82,5.7,65,341,2477,9.4,0.25607356
6249,6249,Dan Girardi,2010-11,26.0,5,24,82,82,6,18,24,108.0,1762.0,280,20,60,80,410.0,82,5.53,56,304,2486,9.1,0.2997254
6250,6250,Dan Girardi,2011-12,27.0,6,31,80,80,4,27,31,110.0,1966.0,360,24,87,111,520.0,82,5.46,52,291,2492,9.0,0.39081728
6251,6251,Dan Girardi,2012-13,28.0,7,29,82,82,5,24,29,122.0,2152.0,442,29,111,140,642.0,82,5.32,47,271,2439,8.9,0.35339877
6252,6252,Dan Girardi,2013-14,29.0,8,14,46,46,2,12,14,81.0,1169.0,488,31,123,154,723.0,48,5.31,29,160,1399,9.1,0.26998556
6253,6253,Dan Girardi,2014-15,30.0,9,24,81,81,5,19,24,100.0,1873.0,569,36,142,178,823.0,82,5.34,48,269,2463,8.9,0.27414578
6254,6254,Dan Girardi,2015-16,31.0,10,20,82,82,4,16,20,111.0,1861.0,651,40,158,198,934.0,82,5.32,47,251,2453,8.9,0.25263333
6255,6255,Dan Girardi,2016-17,32.0,11,17,74,74,2,15,17,77.0,1504.0,725,42,173,215,1011.0,82,5.34,48,255,2438,9.0,0.20471656
6256,6256,Dan Girardi,2017-18,33.0,12,15,63,63,4,11,15,56.0,1203.0,788,46,184,230,1067.0,82,5.45,47,245,2478,9.0,0.18447018
6257,6257,Dan Girardi,2018-19,34.0,13,18,77,77,6,12,18,93.0,1339.0,865,52,196,248,1160.0,82,5.86,50,250,2620,9.2,0.23333567
6258,6258,Dan Girardi,2019-20,35.0,14,16,62,62,4,12,16,75.0,1104.0,927,56,208,264,1235.0,82,5.96,47,239,2579,9.5,0.19692242
6259,6259,Dan Gratton,1988-89,22.0,2,1,7,7,1,0,1,3.0,,7,1,0,1,3.0,80,7.43,89,437,2435,12.2,0.27111053
6260,6260,Dan Hamhuis,2004-05,22.0,2,26,80,80,7,19,26,115.0,1770.0,80,7,19,26,115.0,82,5.14,57,348,2300,9.2,0.532979
6261,6261,Dan Hamhuis,2006-07,24.0,3,38,82,82,7,31,38,135.0,1850.0,162,14,50,64,250.0,82,6.05,85,480,2458,10.1,0.43152285
6262,6262,Dan Hamhuis,2007-08,25.0,4,20,81,81,6,14,20,84.0,1728.0,243,20,64,84,334.0,82,5.76,70,398,2426,9.7,0.30121523
6263,6263,Dan Hamhuis,2008-09,26.0,5,27,80,80,4,23,27,127.0,1819.0,323,24,87,111,461.0,82,5.44,62,351,2383,9.4,0.37811056
6264,6264,Dan Hamhuis,2009-10,27.0,6,26,82,82,3,23,26,135.0,1873.0,405,27,110,137,596.0,82,5.7,65,341,2477,9.4,0.3558452
6265,6265,Dan Hamhuis,2010-11,28.0,7,24,78,78,5,19,24,115.0,1658.0,483,32,129,161,711.0,82,5.53,56,304,2486,9.1,0.29662728
6266,6266,Dan Hamhuis,2011-12,29.0,8,23,64,64,6,17,23,109.0,1451.0,547,38,146,184,820.0,82,5.46,52,291,2492,9.0,0.34917068
6267,6267,Dan Hamhuis,2012-13,30.0,9,37,82,82,4,33,37,140.0,1921.0,629,42,179,221,960.0,82,5.32,47,271,2439,8.9,0.4009372
6268,6268,Dan Hamhuis,2013-14,31.0,10,24,47,47,4,20,24,61.0,1099.0,676,46,199,245,1021.0,48,5.31,29,160,1399,9.1,0.3627627
6269,6269,Dan Hamhuis,2014-15,32.0,11,22,79,79,5,17,22,150.0,1893.0,755,51,216,267,1171.0,82,5.34,48,269,2463,8.9,0.2797103
6270,6270,Dan Hamhuis,2015-16,33.0,12,23,59,59,1,22,23,82.0,1270.0,814,52,238,290,1253.0,82,5.32,47,251,2453,8.9,0.2962493
6271,6271,Dan Hamhuis,2016-17,34.0,13,13,58,58,3,10,13,72.0,1242.0,872,55,248,303,1325.0,82,5.34,48,255,2438,9.0,0.20566985
6272,6272,Dan Hamhuis,2017-18,35.0,14,16,79,79,1,15,16,83.0,1529.0,951,56,263,319,1408.0,82,5.45,47,245,2478,9.0,0.18348819
6273,6273,Dan Hamhuis,2018-19,36.0,15,24,80,80,3,21,24,66.0,1615.0,1031,59,284,343,1474.0,82,5.86,50,250,2620,9.2,0.19941306
6274,6274,Dan Hamhuis,2019-20,37.0,16,5,57,57,0,5,5,39.0,915.0,1088,59,289,348,1513.0,82,5.96,47,239,2579,9.5,0.12518486
6275,6275,Dan Hamhuis,2020-21,38.0,17,8,60,60,0,8,8,44.0,871.0,1148,59,297,356,1557.0,70,5.96,42,208,2192,9.5,0.1295129
6276,6276,Dan Hinote,2000-01,24.0,2,4,27,27,1,3,4,14.0,212.0,27,1,3,4,14.0,82,5.49,53,331,2294,9.8,0.13849014
6277,6277,Dan Hinote,2001-02,25.0,3,15,76,76,5,10,15,69.0,787.0,103,6,13,19,83.0,82,5.51,63,376,2272,9.9,0.21490282
6278,6278,Dan Hinote,2002-03,26.0,4,12,58,58,6,6,12,75.0,722.0,161,12,19,31,158.0,82,5.24,53,338,2262,9.5,0.22585386
6279,6279,Dan Hinote,2003-04,27.0,5,10,60,60,6,4,10,65.0,636.0,221,18,23,41,223.0,82,5.31,60,363,2326,9.4,0.21343991
6280,6280,Dan Hinote,2004-05,28.0,6,11,59,59,4,7,11,53.0,750.0,280,22,30,52,276.0,82,5.14,57,348,2300,9.2,0.20697466
6281,6281,Dan Hinote,2006-07,30.0,7,13,73,73,5,8,13,70.0,780.0,353,27,38,65,346.0,82,6.05,85,480,2458,10.1,0.17700219
6282,6282,Dan Hinote,2007-08,31.0,8,10,41,41,5,5,10,37.0,536.0,394,32,43,75,383.0,82,5.76,70,398,2426,9.7,0.19057992
6283,6283,Dan Hinote,2008-09,32.0,9,10,58,58,5,5,10,42.0,610.0,452,37,48,85,425.0,82,5.44,62,351,2383,9.4,0.17150563
6284,6284,Dan Hinote,2009-10,33.0,10,5,51,51,1,4,5,24.0,556.0,503,38,52,90,449.0,82,5.7,65,341,2477,9.4,0.108941376
6285,6285,Dan Hodgson,1986-87,21.0,2,25,40,40,13,12,25,54.0,,40,13,12,25,54.0,80,7.94,82,370,2484,12.8,0.5607029
6286,6286,Dan Hodgson,1987-88,22.0,3,22,43,43,9,13,22,42.0,,83,22,25,47,96.0,80,7.34,72,344,2400,12.2,0.51296246
6287,6287,Dan Hodgson,1988-89,23.0,4,10,8,8,3,7,10,7.0,,91,25,32,57,103.0,80,7.43,89,437,2435,12.2,0.48585758
6288,6288,Dan Hodgson,1989-90,24.0,5,17,23,23,4,13,17,38.0,,114,29,45,74,141.0,80,7.48,85,403,2430,12.3,0.54331785
6289,6289,Dan Jancevski,2006-07,25.0,2,0,2,2,0,0,0,0.0,18.0,2,0,0,0,0.0,82,6.05,85,480,2458,10.1,0.14312965
6290,6290,Dan Jancevski,2008-09,27.0,3,0,4,4,0,0,0,3.0,23.0,6,0,0,0,3.0,82,5.44,62,351,2383,9.4,0.14500049
6291,6291,Dan Jancevski,2009-10,28.0,4,0,3,3,0,0,0,4.0,46.0,9,0,0,0,7.0,82,5.7,65,341,2477,9.4,0.15787938
6292,6292,Dan Keczmer,1991-92,23.0,2,1,9,9,0,1,1,6.0,,9,0,1,1,6.0,80,6.91,71,366,2385,11.6,0.21431547
6293,6293,Dan Keczmer,1992-93,24.0,3,0,1,1,0,0,0,2.0,,10,0,1,1,8.0,80,6.96,77,402,2440,11.4,0.20149282
6294,6294,Dan Keczmer,1993-94,25.0,4,8,23,23,4,4,8,38.0,,33,4,5,9,46.0,84,7.25,87,443,2603,11.7,0.28184462
6295,6295,Dan Keczmer,1994-95,26.0,5,22,69,69,1,21,22,116.0,,102,5,26,31,162.0,84,6.48,76,407,2545,10.7,0.26915905
6296,6296,Dan Keczmer,1995-96,27.0,6,5,28,28,2,3,5,33.0,,130,7,29,36,195.0,48,5.97,37,209,1408,10.2,0.22013634
6297,6297,Dan Keczmer,1996-97,28.0,7,0,13,13,0,0,0,13.0,,143,7,29,36,208.0,82,6.29,74,413,2481,10.4,0.1612953
6298,6298,Dan Keczmer,1997-98,29.0,8,1,13,13,0,1,1,10.0,,156,7,30,37,218.0,82,5.83,55,336,2444,9.8,0.1594781
6299,6299,Dan Keczmer,1998-99,30.0,9,3,17,17,1,2,3,9.0,,173,8,32,40,227.0,82,5.28,57,380,2242,9.6,0.15604123
6300,6300,Dan Keczmer,1999-00,31.0,10,1,38,38,0,1,1,24.0,418.0,211,8,33,41,251.0,82,5.27,57,359,2285,9.4,0.117619485
6301,6301,Dan Keczmer,2000-01,32.0,11,5,24,24,0,5,5,21.0,430.0,235,8,38,46,272.0,82,5.49,53,331,2294,9.8,0.14293379
6302,6302,Dan Kesa,1994-95,23.0,2,6,19,19,2,4,6,18.0,,19,2,4,6,18.0,84,6.48,76,407,2545,10.7,0.2564963
6303,6303,Dan Kesa,1996-97,25.0,3,0,3,3,0,0,0,0.0,,22,2,4,6,18.0,82,6.29,74,413,2481,10.4,0.15071785
6304,6304,Dan Kesa,1999-00,28.0,4,10,67,67,2,8,10,33.0,678.0,89,4,12,16,51.0,82,5.27,57,359,2285,9.4,0.15959173
6305,6305,Dan Kesa,2000-01,29.0,5,14,50,50,4,10,14,55.0,678.0,139,8,22,30,106.0,82,5.49,53,331,2294,9.8,0.19678068
6306,6306,Dan Kordic,1992-93,21.0,2,4,46,46,1,3,4,27.0,,46,1,3,4,27.0,80,6.96,77,402,2440,11.4,0.21372452
6307,6307,Dan Kordic,1994-95,23.0,3,0,4,4,0,0,0,0.0,,50,1,3,4,27.0,84,6.48,76,407,2545,10.7,0.15029696
6308,6308,Dan Kordic,1996-97,25.0,4,1,9,9,1,0,1,2.0,,59,2,3,5,29.0,82,6.29,74,413,2481,10.4,0.1551297
6309,6309,Dan Kordic,1997-98,26.0,5,5,75,75,1,4,5,21.0,,134,3,7,10,50.0,82,5.83,55,336,2444,9.8,0.08415386
6310,6310,Dan Kordic,1998-99,27.0,6,2,61,61,1,1,2,12.0,,195,4,8,12,62.0,82,5.28,57,380,2242,9.6,0.07242516
6311,6311,Dan Kordic,1999-00,28.0,7,0,2,2,0,0,0,0.0,5.0,197,4,8,12,62.0,82,5.27,57,359,2285,9.4,0.13269559
6312,6312,Dan LaCouture,1999-00,22.0,2,0,3,3,0,0,0,0.0,20.0,3,0,0,0,0.0,82,5.27,57,359,2285,9.4,0.16821095
6313,6313,Dan LaCouture,2000-01,23.0,3,0,5,5,0,0,0,2.0,35.0,8,0,0,0,2.0,82,5.49,53,331,2294,9.8,0.16841361
6314,6314,Dan LaCouture,2001-02,24.0,4,6,48,48,2,4,6,23.0,328.0,56,2,4,6,25.0,82,5.51,63,376,2272,9.9,0.13046479
6315,6315,Dan LaCouture,2002-03,25.0,5,17,82,82,6,11,17,77.0,1088.0,138,8,15,23,102.0,82,5.24,53,338,2262,9.5,0.21994123
6316,6316,Dan LaCouture,2003-04,26.0,6,9,68,68,3,6,9,47.0,653.0,206,11,21,32,149.0,82,5.31,60,363,2326,9.4,0.15473807
6317,6317,Dan LaCouture,2004-05,27.0,7,7,59,59,5,2,7,39.0,560.0,265,16,23,39,188.0,82,5.14,57,348,2300,9.2,0.16626081
6318,6318,Dan LaCouture,2006-07,29.0,8,4,55,55,2,2,4,37.0,344.0,320,18,25,43,225.0,82,6.05,85,480,2458,10.1,0.12652057
6319,6319,Dan LaCouture,2007-08,30.0,9,0,6,6,0,0,0,0.0,30.0,326,18,25,43,225.0,82,5.76,70,398,2426,9.7,0.1480524
6320,6320,Dan LaCouture,2009-10,32.0,10,2,11,11,2,0,2,4.0,47.0,337,20,25,45,229.0,82,5.7,65,341,2477,9.4,0.17582527
6321,6321,Dan Lambert,1991-92,22.0,2,0,1,1,0,0,0,0.0,,1,0,0,0,0.0,80,6.91,71,366,2385,11.6,0.19527435
6322,6322,Dan Lambert,1992-93,23.0,3,15,28,28,6,9,15,42.0,,29,6,9,15,42.0,80,6.96,77,402,2440,11.4,0.43124193
6323,6323,Dan Mandich,1983-84,23.0,2,7,67,67,3,4,7,49.0,,67,3,4,7,49.0,80,7.73,71,310,2444,12.7,0.20650095
6324,6324,Dan Mandich,1984-85,24.0,3,9,31,31,2,7,9,29.0,,98,5,11,16,78.0,80,7.89,74,336,2448,12.9,0.27838337
6325,6325,Dan Mandich,1985-86,25.0,4,0,10,10,0,0,0,4.0,,108,5,11,16,82.0,80,7.77,71,321,2447,12.7,0.20392296
6326,6326,Dan Mandich,1986-87,26.0,5,0,3,3,0,0,0,0.0,,111,5,11,16,82.0,80,7.94,82,370,2484,12.8,0.18948251
6327,6327,Dan McCarthy,1981-82,23.0,2,4,5,5,4,0,4,7.0,,5,4,0,4,7.0,80,7.69,77,340,2441,12.6,0.36798358
6328,6328,Dan McFall,1985-86,22.0,2,0,2,2,0,0,0,2.0,,2,0,0,0,2.0,80,7.77,71,321,2447,12.7,0.22890192
6329,6329,Dan McFall,1986-87,23.0,3,1,7,7,0,1,1,2.0,,9,0,1,1,4.0,80,7.94,82,370,2484,12.8,0.21828938
6330,6330,Dan McGillis,1997-98,25.0,2,22,73,73,6,16,22,139.0,,73,6,16,22,139.0,82,5.83,55,336,2444,9.8,0.31876737
6331,6331,Dan McGillis,1998-99,26.0,3,31,80,80,11,20,31,137.0,,153,17,36,53,276.0,82,5.28,57,380,2242,9.6,0.4081455
6332,6332,Dan McGillis,1999-00,27.0,4,45,78,78,8,37,45,164.0,1691.0,231,25,73,98,440.0,82,5.27,57,359,2285,9.4,0.5132174
6333,6333,Dan McGillis,2000-01,28.0,5,18,68,68,4,14,18,128.0,1365.0,299,29,87,116,568.0,82,5.49,53,331,2294,9.8,0.31945628
6334,6334,Dan McGillis,2001-02,29.0,6,49,82,82,14,35,49,207.0,1918.0,381,43,122,165,775.0,82,5.51,63,376,2272,9.9,0.54932505
6335,6335,Dan McGillis,2002-03,30.0,7,19,75,75,5,14,19,147.0,1580.0,456,48,136,184,922.0,82,5.24,53,338,2262,9.5,0.33087474
6336,6336,Dan McGillis,2003-04,31.0,8,20,71,71,3,17,20,130.0,1460.0,527,51,153,204,1052.0,82,5.31,60,363,2326,9.4,0.314353
6337,6337,Dan McGillis,2004-05,32.0,9,28,80,80,5,23,28,117.0,1577.0,607,56,176,232,1169.0,82,5.14,57,348,2300,9.2,0.33333978
6338,6338,Dan McGillis,2006-07,34.0,10,6,27,27,0,6,6,32.0,384.0,634,56,182,238,1201.0,82,6.05,85,480,2458,10.1,0.22955817
6339,6339,Dan Plante,1994-95,23.0,2,1,12,12,0,1,1,9.0,,12,0,1,1,9.0,84,6.48,76,407,2545,10.7,0.19801041
6340,6340,Dan Plante,1996-97,25.0,3,8,73,73,5,3,8,103.0,,85,5,4,9,112.0,82,6.29,74,413,2481,10.4,0.21006033
6341,6341,Dan Plante,1997-98,26.0,4,13,67,67,4,9,13,61.0,,152,9,13,22,173.0,82,5.83,55,336,2444,9.8,0.17001998
6342,6342,Dan Plante,1998-99,27.0,5,1,7,7,0,1,1,7.0,,159,9,14,23,180.0,82,5.28,57,380,2242,9.6,0.14568913
6343,6343,Dan Quinn,1984-85,19.0,2,52,54,54,19,33,52,103.0,,54,19,33,52,103.0,80,7.89,74,336,2448,12.9,0.82074
6344,6344,Dan Quinn,1985-86,20.0,3,58,74,74,20,38,58,143.0,,128,39,71,110,246.0,80,7.77,71,321,2447,12.7,0.764058
6345,6345,Dan Quinn,1986-87,21.0,4,72,78,78,30,42,72,191.0,,206,69,113,182,437.0,80,7.94,82,370,2484,12.8,0.91801286
6346,6346,Dan Quinn,1987-88,22.0,5,80,80,80,31,49,80,184.0,,286,100,162,262,621.0,80,7.34,72,344,2400,12.2,1.0384978
6347,6347,Dan Quinn,1988-89,23.0,6,79,70,70,40,39,79,235.0,,356,140,201,341,856.0,80,7.43,89,437,2435,12.2,1.0511595
6348,6348,Dan Quinn,1989-90,24.0,7,94,79,79,34,60,94,200.0,,435,174,261,435,1056.0,80,7.48,85,403,2430,12.3,1.0665257
6349,6349,Dan Quinn,1990-91,25.0,8,63,78,78,25,38,63,181.0,,513,199,299,498,1237.0,80,7.37,76,367,2421,12.2,0.81592387
6350,6350,Dan Quinn,1991-92,26.0,9,60,78,78,22,38,60,183.0,,591,221,337,558,1420.0,80,6.91,71,366,2385,11.6,0.7794816
6351,6351,Dan Quinn,1992-93,27.0,10,37,67,67,11,26,37,101.0,,658,232,363,595,1521.0,80,6.96,77,402,2440,11.4,0.5437984
6352,6352,Dan Quinn,1993-94,28.0,11,4,11,11,0,4,4,20.0,,669,232,367,599,1541.0,84,7.25,87,443,2603,11.7,0.5234595
6353,6353,Dan Quinn,1994-95,29.0,12,7,13,13,7,0,7,31.0,,682,239,367,606,1572.0,84,6.48,76,407,2545,10.7,0.7120503
6354,6354,Dan Quinn,1995-96,30.0,13,31,44,44,14,17,31,78.0,,726,253,384,637,1650.0,48,5.97,37,209,1408,10.2,0.6899282
6355,6355,Dan Quinn,1996-97,31.0,14,45,63,63,13,32,45,109.0,,789,266,416,682,1759.0,82,6.29,74,413,2481,10.4,0.5389221
6356,6356,Dan Quinn,1997-98,32.0,15,3,16,16,0,3,3,16.0,,805,266,419,685,1775.0,82,5.83,55,336,2444,9.8,0.46662354
6357,6357,Dan Ratushny,1993-94,23.0,2,1,1,1,0,1,1,2.0,,1,0,1,1,2.0,84,7.25,87,443,2603,11.7,0.2253817
6358,6358,Dan Renouf,2017-18,23.0,2,0,1,1,0,0,0,1.0,14.0,1,0,0,0,1.0,82,5.45,47,245,2478,9.0,0.18257251
6359,6359,Dan Sexton,2010-11,23.0,2,19,41,41,9,10,19,93.0,553.0,41,9,10,19,93.0,82,5.53,56,304,2486,9.1,0.43828046
6360,6360,Dan Sexton,2011-12,24.0,3,13,47,47,4,9,13,78.0,545.0,88,13,19,32,171.0,82,5.46,52,291,2492,9.0,0.28710067
6361,6361,Dan Smith,1999-00,23.0,2,0,12,12,0,0,0,6.0,147.0,12,0,0,0,6.0,82,5.27,57,359,2285,9.4,0.1668334
6362,6362,Dan Smith,2000-01,24.0,3,0,3,3,0,0,0,0.0,33.0,15,0,0,0,6.0,82,5.49,53,331,2294,9.8,0.13632584
6363,6363,Dan Smith,2006-07,30.0,4,0,7,7,0,0,0,1.0,79.0,22,0,0,0,7.0,82,6.05,85,480,2458,10.1,0.13122466
6364,6364,Dan Snyder,2001-02,23.0,2,0,2,2,0,0,0,2.0,14.0,2,0,0,0,2.0,82,5.51,63,376,2272,9.9,0.17321542
6365,6365,Dan Snyder,2002-03,24.0,3,2,11,11,1,1,2,7.0,120.0,13,1,1,2,9.0,82,5.24,53,338,2262,9.5,0.18955904
6366,6366,Dan Snyder,2003-04,25.0,4,14,36,36,10,4,14,41.0,392.0,49,11,5,16,50.0,82,5.31,60,363,2326,9.4,0.27352047
6367,6367,Dan Trebil,1997-98,23.0,2,6,29,29,3,3,6,30.0,,29,3,3,6,30.0,82,5.83,55,336,2444,9.8,0.24980322
6368,6368,Dan Trebil,1998-99,24.0,3,1,21,21,0,1,1,11.0,,50,3,4,7,41.0,82,5.28,57,380,2242,9.6,0.12994605
6369,6369,Dan Trebil,1999-00,25.0,4,0,6,6,0,0,0,1.0,90.0,56,3,4,7,42.0,82,5.27,57,359,2285,9.4,0.14664432
6370,6370,Dan Trebil,2000-01,26.0,5,1,3,3,1,0,1,2.0,38.0,59,4,4,8,44.0,82,5.49,53,331,2294,9.8,0.15266997
6371,6371,Dan Trebil,2001-02,27.0,6,0,26,26,0,0,0,26.0,350.0,85,4,4,8,70.0,82,5.51,63,376,2272,9.9,0.12372643
6372,6372,Dan Vincelette,1988-89,21.0,2,17,69,69,6,11,17,67.0,,69,6,11,17,67.0,80,7.43,89,437,2435,12.2,0.29520923
6373,6373,Dan Vincelette,1989-90,22.0,3,15,66,66,11,4,15,76.0,,135,17,15,32,143.0,80,7.48,85,403,2430,12.3,0.30398726
6374,6374,Dan Vincelette,1990-91,23.0,4,1,13,13,0,1,1,17.0,,148,17,16,33,160.0,80,7.37,76,367,2421,12.2,0.26957458
6375,6375,Dan Vincelette,1991-92,24.0,5,1,16,16,0,1,1,16.0,,164,17,17,34,176.0,80,6.91,71,366,2385,11.6,0.2030892
6376,6376,Dan Vincelette,1992-93,25.0,6,8,29,29,3,5,8,28.0,,193,20,22,42,204.0,80,6.96,77,402,2440,11.4,0.26623416
6377,6377,Dan Woodley,1988-89,21.0,2,2,5,5,2,0,2,3.0,,5,2,0,2,3.0,80,7.43,89,437,2435,12.2,0.321568
6378,6378,Dana Murzyn,1986-87,20.0,2,26,78,78,3,23,26,80.0,,78,3,23,26,80.0,80,7.94,82,370,2484,12.8,0.38683727
6379,6379,Dana Murzyn,1987-88,21.0,3,28,74,74,9,19,28,135.0,,152,12,42,54,215.0,80,7.34,72,344,2400,12.2,0.47130024
6380,6380,Dana Murzyn,1988-89,22.0,4,18,74,74,7,11,18,107.0,,226,19,53,72,322.0,80,7.43,89,437,2435,12.2,0.39603984
6381,6381,Dana Murzyn,1989-90,23.0,5,22,63,63,3,19,22,91.0,,289,22,72,94,413.0,80,7.48,85,403,2430,12.3,0.3282606
6382,6382,Dana Murzyn,1990-91,24.0,6,20,78,78,7,13,20,97.0,,367,29,85,114,510.0,80,7.37,76,367,2421,12.2,0.3378028
6383,6383,Dana Murzyn,1991-92,25.0,7,3,29,29,1,2,3,40.0,,396,30,87,117,550.0,80,6.91,71,366,2385,11.6,0.2319355
6384,6384,Dana Murzyn,1992-93,26.0,8,14,70,70,3,11,14,99.0,,466,33,98,131,649.0,80,6.96,77,402,2440,11.4,0.26423502
6385,6385,Dana Murzyn,1993-94,27.0,9,16,79,79,5,11,16,82.0,,545,38,109,147,731.0,84,7.25,87,443,2603,11.7,0.23506752
6386,6386,Dana Murzyn,1994-95,28.0,10,20,80,80,6,14,20,79.0,,625,44,123,167,810.0,84,6.48,76,407,2545,10.7,0.25717518
6387,6387,Dana Murzyn,1995-96,29.0,11,8,40,40,0,8,8,29.0,,665,44,131,175,839.0,48,5.97,37,209,1408,10.2,0.16873598
6388,6388,Dana Murzyn,1996-97,30.0,12,12,69,69,2,10,12,68.0,,734,46,141,187,907.0,82,6.29,74,413,2481,10.4,0.1549455
6389,6389,Dana Murzyn,1997-98,31.0,13,8,61,61,1,7,8,70.0,,795,47,148,195,977.0,82,5.83,55,336,2444,9.8,0.142248
6390,6390,Dana Murzyn,1998-99,32.0,14,7,31,31,5,2,7,29.0,,826,52,150,202,1006.0,82,5.28,57,380,2242,9.6,0.2228727
6391,6391,Dana Murzyn,1999-00,33.0,15,2,12,12,0,2,2,7.0,180.0,838,52,152,204,1013.0,82,5.27,57,359,2285,9.4,0.14469829
6392,6392,Dana Tyrell,2011-12,22.0,2,15,78,78,6,9,15,73.0,940.0,78,6,9,15,73.0,82,5.46,52,291,2492,9.0,0.2439687
6393,6393,Dana Tyrell,2012-13,23.0,3,5,26,26,0,5,5,23.0,273.0,104,6,14,20,96.0,82,5.32,47,271,2439,8.9,0.22371134
6394,6394,Dana Tyrell,2013-14,24.0,4,4,21,21,1,3,4,19.0,217.0,125,7,17,24,115.0,48,5.31,29,160,1399,9.1,0.19537279
6395,6395,Dana Tyrell,2014-15,25.0,5,0,7,7,0,0,0,4.0,65.0,132,7,17,24,119.0,82,5.34,48,269,2463,8.9,0.14170069
6396,6396,Dana Tyrell,2015-16,26.0,6,0,3,3,0,0,0,1.0,21.0,135,7,17,24,120.0,82,5.32,47,251,2453,8.9,0.13209766
6397,6397,Dane Byers,2008-09,22.0,2,0,1,1,0,0,0,0.0,5.0,1,0,0,0,0.0,82,5.44,62,351,2383,9.4,0.17280087
6398,6398,Dane Byers,2010-11,24.0,3,1,5,5,1,0,1,3.0,32.0,6,1,0,1,3.0,82,5.53,56,304,2486,9.1,0.19888216
6399,6399,Dane Byers,2012-13,26.0,4,0,8,8,0,0,0,8.0,65.0,14,1,0,1,11.0,82,5.32,47,271,2439,8.9,0.15264219
6400,6400,Dane Jackson,1994-95,24.0,2,6,12,12,5,1,6,18.0,,12,5,1,6,18.0,84,6.48,76,407,2545,10.7,0.2919487
6401,6401,Dane Jackson,1995-96,25.0,3,1,3,3,1,0,1,6.0,,15,6,1,7,24.0,48,5.97,37,209,1408,10.2,0.2110073
6402,6402,Dane Jackson,1996-97,26.0,4,9,22,22,5,4,9,20.0,,37,11,5,16,44.0,82,6.29,74,413,2481,10.4,0.25194013
6403,6403,Dane Jackson,1998-99,28.0,5,2,8,8,1,1,2,5.0,,45,12,6,18,49.0,82,5.28,57,380,2242,9.6,0.1743936
6404,6404,Danick Martel,2018-19,24.0,2,0,4,4,0,0,0,6.0,41.0,4,0,0,0,6.0,82,5.86,50,250,2620,9.2,0.16909173
6405,6405,Danick Martel,2019-20,25.0,3,2,9,9,0,2,2,16.0,92.0,13,0,2,2,22.0,82,5.96,47,239,2579,9.5,0.192236
6406,6406,Daniel Alfredsson,1996-97,24.0,2,61,82,82,26,35,61,212.0,,82,26,35,61,212.0,82,6.29,74,413,2481,10.4,0.6984117
6407,6407,Daniel Alfredsson,1997-98,25.0,3,71,76,76,24,47,71,247.0,,158,50,82,132,459.0,82,5.83,55,336,2444,9.8,0.85000753
6408,6408,Daniel Alfredsson,1998-99,26.0,4,45,55,55,17,28,45,149.0,,213,67,110,177,608.0,82,5.28,57,380,2242,9.6,0.77309525
6409,6409,Daniel Alfredsson,1999-00,27.0,5,33,58,58,11,22,33,163.0,1007.0,271,78,132,210,771.0,82,5.27,57,359,2285,9.4,0.68843776
6410,6410,Daniel Alfredsson,2000-01,28.0,6,59,57,57,21,38,59,164.0,1069.0,328,99,170,269,935.0,82,5.49,53,331,2294,9.8,0.916775
6411,6411,Daniel Alfredsson,2001-02,29.0,7,70,68,68,24,46,70,206.0,1277.0,396,123,216,339,1141.0,82,5.51,63,376,2272,9.9,0.85064006
6412,6412,Daniel Alfredsson,2002-03,30.0,8,71,78,78,37,34,71,243.0,1584.0,474,160,250,410,1384.0,82,5.24,53,338,2262,9.5,0.85269785
6413,6413,Daniel Alfredsson,2003-04,31.0,9,78,78,78,27,51,78,240.0,1524.0,552,187,301,488,1624.0,82,5.31,60,363,2326,9.4,0.85557204
6414,6414,Daniel Alfredsson,2004-05,32.0,10,80,77,77,32,48,80,230.0,1494.0,629,219,349,568,1854.0,82,5.14,57,348,2300,9.2,1.0154349
6415,6415,Daniel Alfredsson,2006-07,34.0,11,103,77,77,43,60,103,249.0,1670.0,706,262,409,671,2103.0,82,6.05,85,480,2458,10.1,1.0851355
6416,6416,Daniel Alfredsson,2007-08,35.0,12,87,77,77,29,58,87,240.0,1661.0,783,291,467,758,2343.0,82,5.76,70,398,2426,9.7,0.9939357
6417,6417,Daniel Alfredsson,2008-09,36.0,13,89,70,70,40,49,89,217.0,1560.0,853,331,516,847,2560.0,82,5.44,62,351,2383,9.4,1.0665447
6418,6418,Daniel Alfredsson,2009-10,37.0,14,74,79,79,24,50,74,204.0,1649.0,932,355,566,921,2764.0,82,5.7,65,341,2477,9.4,0.8359629
6419,6419,Daniel Alfredsson,2010-11,38.0,15,71,70,70,20,51,71,168.0,1377.0,1002,375,617,992,2932.0,82,5.53,56,304,2486,9.1,0.7476433
6420,6420,Daniel Alfredsson,2011-12,39.0,16,31,54,54,14,17,31,96.0,1041.0,1056,389,634,1023,3028.0,82,5.46,52,291,2492,9.0,0.56182057
6421,6421,Daniel Alfredsson,2012-13,40.0,17,59,75,75,27,32,59,191.0,1421.0,1131,416,666,1082,3219.0,82,5.32,47,271,2439,8.9,0.6468539
6422,6422,Daniel Alfredsson,2013-14,41.0,18,26,47,47,10,16,26,101.0,909.0,1178,426,682,1108,3320.0,48,5.31,29,160,1399,9.1,0.57092786
6423,6423,Daniel Alfredsson,2014-15,42.0,19,49,68,68,18,31,49,151.0,1151.0,1246,444,713,1157,3471.0,82,5.34,48,269,2463,8.9,0.57657003
6424,6424,Daniel Bang,2013-14,26.0,2,2,8,8,0,2,2,13.0,103.0,8,0,2,2,13.0,48,5.31,29,160,1399,9.1,0.22175655
6425,6425,Daniel Brickley,2018-19,23.0,2,1,1,1,0,1,1,0.0,11.0,1,0,1,1,0.0,82,5.86,50,250,2620,9.2,0.20757037
6426,6426,Daniel Brickley,2019-20,24.0,3,1,4,4,0,1,1,2.0,51.0,5,0,2,2,2.0,82,5.96,47,239,2579,9.5,0.19215277
6427,6427,Daniel Briere,1998-99,21.0,2,1,5,5,1,0,1,4.0,,5,1,0,1,4.0,82,5.28,57,380,2242,9.6,0.22750741
6428,6428,Daniel Briere,1999-00,22.0,3,22,64,64,8,14,22,90.0,718.0,69,9,14,23,94.0,82,5.27,57,359,2285,9.4,0.36359388
6429,6429,Daniel Briere,2000-01,23.0,4,2,13,13,1,1,2,9.0,100.0,82,10,15,25,103.0,82,5.49,53,331,2294,9.8,0.2719208
6430,6430,Daniel Briere,2001-02,24.0,5,15,30,30,11,4,15,43.0,325.0,112,21,19,40,146.0,82,5.51,63,376,2272,9.9,0.36050284
6431,6431,Daniel Briere,2002-03,25.0,6,60,78,78,32,28,60,149.0,1228.0,190,53,47,100,295.0,82,5.24,53,338,2262,9.5,0.6656572
6432,6432,Daniel Briere,2003-04,26.0,7,58,82,82,24,34,58,181.0,1407.0,272,77,81,158,476.0,82,5.31,60,363,2326,9.4,0.68597114
6433,6433,Daniel Briere,2004-05,27.0,8,65,82,82,28,37,65,194.0,1503.0,354,105,118,223,670.0,82,5.14,57,348,2300,9.2,0.87379825
6434,6434,Daniel Briere,2006-07,29.0,9,58,48,48,25,33,58,147.0,915.0,402,130,151,281,817.0,82,6.05,85,480,2458,10.1,0.9040408
6435,6435,Daniel Briere,2007-08,30.0,10,95,81,81,32,63,95,234.0,1564.0,483,162,214,376,1051.0,82,5.76,70,398,2426,9.7,0.9823104
6436,6436,Daniel Briere,2008-09,31.0,11,72,79,79,31,41,72,182.0,1490.0,562,193,255,448,1233.0,82,5.44,62,351,2383,9.4,0.8114931
6437,6437,Daniel Briere,2009-10,32.0,12,25,29,29,11,14,25,54.0,454.0,591,204,269,473,1287.0,82,5.7,65,341,2477,9.4,0.60902464
6438,6438,Daniel Briere,2010-11,33.0,13,53,75,75,26,27,53,193.0,1244.0,666,230,296,526,1480.0,82,5.53,56,304,2486,9.1,0.65799075
6439,6439,Daniel Briere,2011-12,34.0,14,68,77,77,34,34,68,246.0,1410.0,743,264,330,594,1726.0,82,5.46,52,291,2492,9.0,0.7223168
6440,6440,Daniel Briere,2012-13,35.0,15,49,70,70,16,33,49,174.0,1215.0,813,280,363,643,1900.0,82,5.32,47,271,2439,8.9,0.5956839
6441,6441,Daniel Briere,2013-14,36.0,16,16,34,34,6,10,16,87.0,546.0,847,286,373,659,1987.0,48,5.31,29,160,1399,9.1,0.43351024
6442,6442,Daniel Briere,2014-15,37.0,17,25,69,69,13,12,25,118.0,881.0,916,299,385,684,2105.0,82,5.34,48,269,2463,8.9,0.33651578
6443,6443,Daniel Briere,2015-16,38.0,18,12,57,57,8,4,12,69.0,691.0,973,307,389,696,2174.0,82,5.32,47,251,2453,8.9,0.28361982
6444,6444,Daniel Carcillo,2007-08,23.0,2,7,18,18,4,3,7,32.0,269.0,18,4,3,7,32.0,82,5.76,70,398,2426,9.7,0.31024933
6445,6445,Daniel Carcillo,2008-09,24.0,3,24,57,57,13,11,24,106.0,725.0,75,17,14,31,138.0,82,5.44,62,351,2383,9.4,0.4190354
6446,6446,Daniel Carcillo,2009-10,25.0,4,14,74,74,3,11,14,130.0,852.0,149,20,25,45,268.0,82,5.7,65,341,2477,9.4,0.2642612
6447,6447,Daniel Carcillo,2010-11,26.0,5,22,76,76,12,10,22,105.0,855.0,225,32,35,67,373.0,82,5.53,56,304,2486,9.1,0.28690505
6448,6448,Daniel Carcillo,2011-12,27.0,6,6,57,57,4,2,6,56.0,443.0,282,36,37,73,429.0,82,5.46,52,291,2492,9.0,0.16730249
6449,6449,Daniel Carcillo,2012-13,28.0,7,11,28,28,2,9,11,27.0,319.0,310,38,46,84,456.0,82,5.32,47,271,2439,8.9,0.22733411
6450,6450,Daniel Carcillo,2013-14,29.0,8,3,23,23,2,1,3,23.0,207.0,333,40,47,87,479.0,48,5.31,29,160,1399,9.1,0.24363711
6451,6451,Daniel Carcillo,2014-15,30.0,9,5,57,57,4,1,5,44.0,529.0,390,44,48,92,523.0,82,5.34,48,269,2463,8.9,0.16064802
6452,6452,Daniel Carcillo,2015-16,31.0,10,8,39,39,4,4,8,42.0,319.0,429,48,52,100,565.0,82,5.32,47,251,2453,8.9,0.16688612
6453,6453,Daniel Carr,2016-17,25.0,2,9,23,23,6,3,9,39.0,278.0,23,6,3,9,39.0,82,5.34,48,255,2438,9.0,0.2749632
6454,6454,Daniel Carr,2017-18,26.0,3,9,33,33,2,7,9,44.0,338.0,56,8,10,18,83.0,82,5.45,47,245,2478,9.0,0.24489376
6455,6455,Daniel Carr,2018-19,27.0,4,16,38,38,6,10,16,52.0,461.0,94,14,20,34,135.0,82,5.86,50,250,2620,9.2,0.3349387
6456,6456,Daniel Carr,2019-20,28.0,5,1,6,6,1,0,1,11.0,59.0,100,15,20,35,146.0,82,5.96,47,239,2579,9.5,0.19649813
6457,6457,Daniel Carr,2020-21,29.0,6,1,11,11,1,0,1,14.0,114.0,111,16,20,36,160.0,70,5.96,42,208,2192,9.5,0.21549657
6458,6458,Daniel Catenacci,2016-17,23.0,2,0,11,11,0,0,0,7.0,96.0,11,0,0,0,7.0,82,5.34,48,255,2438,9.0,0.16730216
6459,6459,Daniel Catenacci,2018-19,25.0,3,0,1,1,0,0,0,1.0,11.0,12,0,0,0,8.0,82,5.86,50,250,2620,9.2,0.15558022
6460,6460,Daniel Corso,2001-02,23.0,2,13,28,28,10,3,13,42.0,390.0,28,10,3,13,42.0,82,5.51,63,376,2272,9.9,0.35493332
6461,6461,Daniel Corso,2002-03,24.0,3,11,41,41,4,7,11,25.0,460.0,69,14,10,24,67.0,82,5.24,53,338,2262,9.5,0.22098163
6462,6462,Daniel Corso,2003-04,25.0,4,0,1,1,0,0,0,0.0,8.0,70,14,10,24,67.0,82,5.31,60,363,2326,9.4,0.17218477
6463,6463,Daniel Corso,2004-05,26.0,5,1,7,7,0,1,1,2.0,91.0,77,14,11,25,69.0,82,5.14,57,348,2300,9.2,0.20790091
6464,6464,Daniel Dore,1990-91,20.0,2,5,16,16,2,3,5,5.0,,16,2,3,5,5.0,80,7.37,76,367,2421,12.2,0.34964833
6465,6465,Daniel Dore,1991-92,21.0,3,0,1,1,0,0,0,0.0,,17,2,3,5,5.0,80,6.91,71,366,2385,11.6,0.255737
6466,6466,Daniel Gauthier,1995-96,25.0,2,0,5,5,0,0,0,4.0,,5,0,0,0,4.0,48,5.97,37,209,1408,10.2,0.18286341
6467,6467,Daniel Goneau,1997-98,22.0,2,13,41,41,10,3,13,44.0,,41,10,3,13,44.0,82,5.83,55,336,2444,9.8,0.29647177
6468,6468,Daniel Goneau,1998-99,23.0,3,2,11,11,2,0,2,13.0,,52,12,3,15,57.0,82,5.28,57,380,2242,9.6,0.28996706
6469,6469,Daniel Goneau,2000-01,25.0,4,0,1,1,0,0,0,3.0,14.0,53,12,3,15,60.0,82,5.49,53,331,2294,9.8,0.15965861
6470,6470,Daniel Guerard,1995-96,21.0,2,0,2,2,0,0,0,0.0,,2,0,0,0,0.0,48,5.97,37,209,1408,10.2,0.19863126
6471,6471,Daniel Lacroix,1994-95,25.0,2,0,4,4,0,0,0,0.0,,4,0,0,0,0.0,84,6.48,76,407,2545,10.7,0.14460874
6472,6472,Daniel Lacroix,1995-96,26.0,3,1,24,24,1,0,1,14.0,,28,1,0,1,14.0,48,5.97,37,209,1408,10.2,0.13518515
6473,6473,Daniel Lacroix,1996-97,27.0,4,4,25,25,2,2,4,14.0,,53,3,2,5,28.0,82,6.29,74,413,2481,10.4,0.15746063
6474,6474,Daniel Lacroix,1997-98,28.0,5,8,74,74,7,1,8,54.0,,127,10,3,13,82.0,82,5.83,55,336,2444,9.8,0.15367395
6475,6475,Daniel Lacroix,1998-99,29.0,6,5,56,56,1,4,5,28.0,,183,11,7,18,110.0,82,5.28,57,380,2242,9.6,0.103640705
6476,6476,Daniel Lacroix,1999-00,30.0,7,0,4,4,0,0,0,5.0,25.0,187,11,7,18,115.0,82,5.27,57,359,2285,9.4,0.12700036
6477,6477,Daniel Lacroix,2000-01,31.0,8,0,1,1,0,0,0,0.0,11.0,188,11,7,18,115.0,82,5.49,53,331,2294,9.8,0.125712
6478,6478,Daniel Laperriere,1993-94,24.0,2,1,5,5,0,1,1,7.0,,5,0,1,1,7.0,84,7.25,87,443,2603,11.7,0.2152828
6479,6479,Daniel Laperriere,1994-95,25.0,3,4,20,20,1,3,4,20.0,,25,1,4,5,27.0,84,6.48,76,407,2545,10.7,0.1851556
6480,6480,Daniel Laperriere,1995-96,26.0,4,2,17,17,1,1,2,18.0,,42,2,5,7,45.0,48,5.97,37,209,1408,10.2,0.2089768
6481,6481,Daniel Laperriere,1996-97,27.0,5,0,6,6,0,0,0,12.0,,48,2,5,7,57.0,82,6.29,74,413,2481,10.4,0.15163216
6482,6482,Daniel Marois,1989-90,21.0,2,54,76,76,31,23,54,146.0,,76,31,23,54,146.0,80,7.48,85,403,2430,12.3,0.8633801
6483,6483,Daniel Marois,1990-91,22.0,3,76,68,68,39,37,76,183.0,,144,70,60,130,329.0,80,7.37,76,367,2421,12.2,0.96473813
6484,6484,Daniel Marois,1991-92,23.0,4,30,78,78,21,9,30,152.0,,222,91,69,160,481.0,80,6.91,71,366,2385,11.6,0.572484
6485,6485,Daniel Marois,1992-93,24.0,5,33,75,75,17,16,33,159.0,,297,108,85,193,640.0,80,6.96,77,402,2440,11.4,0.50606066
6486,6486,Daniel Marois,1993-94,25.0,6,7,28,28,2,5,7,41.0,,325,110,90,200,681.0,84,7.25,87,443,2603,11.7,0.42478836
6487,6487,Daniel Marois,1994-95,26.0,7,10,22,22,7,3,10,32.0,,347,117,93,210,713.0,84,6.48,76,407,2545,10.7,0.41961718
6488,6488,Daniel Marois,1996-97,28.0,8,0,3,3,0,0,0,1.0,,350,117,93,210,714.0,82,6.29,74,413,2481,10.4,0.27780443
6489,6489,Daniel Paille,2006-07,22.0,2,3,14,14,1,2,3,15.0,145.0,14,1,2,3,15.0,82,6.05,85,480,2458,10.1,0.22607446
6490,6490,Daniel Paille,2007-08,23.0,3,11,29,29,3,8,11,45.0,371.0,43,4,10,14,60.0,82,5.76,70,398,2426,9.7,0.27885485
6491,6491,Daniel Paille,2008-09,24.0,4,35,77,77,19,16,35,110.0,1022.0,120,23,26,49,170.0,82,5.44,62,351,2383,9.4,0.42403653
6492,6492,Daniel Paille,2009-10,25.0,5,27,73,73,12,15,27,80.0,869.0,193,35,41,76,250.0,82,5.7,65,341,2477,9.4,0.3585869
6493,6493,Daniel Paille,2010-11,26.0,6,20,76,76,10,10,20,120.0,1043.0,269,45,51,96,370.0,82,5.53,56,304,2486,9.1,0.28009236
6494,6494,Daniel Paille,2011-12,27.0,7,13,43,43,6,7,13,48.0,486.0,312,51,58,109,418.0,82,5.46,52,291,2492,9.0,0.2676002
6495,6495,Daniel Paille,2012-13,28.0,8,15,69,69,9,6,15,86.0,793.0,381,60,64,124,504.0,82,5.32,47,271,2439,8.9,0.27654436
6496,6496,Daniel Paille,2013-14,29.0,9,17,46,46,10,7,17,70.0,583.0,427,70,71,141,574.0,48,5.31,29,160,1399,9.1,0.3395451
6497,6497,Daniel Paille,2014-15,30.0,10,18,72,72,9,9,18,71.0,789.0,499,79,80,159,645.0,82,5.34,48,269,2463,8.9,0.25803345
6498,6498,Daniel Paille,2015-16,31.0,11,13,71,71,6,7,13,66.0,817.0,570,85,87,172,711.0,82,5.32,47,251,2453,8.9,0.16728392
6499,6499,Daniel Paille,2016-17,32.0,12,0,12,12,0,0,0,11.0,137.0,582,85,87,172,722.0,82,5.34,48,255,2438,9.0,0.20056501
6500,6500,Daniel Poudrier,1986-87,22.0,2,6,13,13,1,5,6,6.0,,13,1,5,6,6.0,80,7.94,82,370,2484,12.8,0.24005306
6501,6501,Daniel Poudrier,1987-88,23.0,3,0,6,6,0,0,0,2.0,,19,1,5,6,8.0,80,7.34,72,344,2400,12.2,0.20463485
6502,6502,Daniel Poudrier,1988-89,24.0,4,0,6,6,0,0,0,0.0,,25,1,5,6,8.0,80,7.43,89,437,2435,12.2,0.18240544
6503,6503,Daniel Poulin,1982-83,25.0,2,2,3,3,1,1,2,8.0,,3,1,1,2,8.0,80,8.03,73,320,2489,12.9,0.27629048
6504,6504,Daniel Sedin,2001-02,21.0,2,34,75,75,20,14,34,127.0,975.0,75,20,14,34,127.0,82,5.51,63,376,2272,9.9,0.49936646
6505,6505,Daniel Sedin,2002-03,22.0,3,32,79,79,9,23,32,117.0,977.0,154,29,37,66,244.0,82,5.24,53,338,2262,9.5,0.44761148
6506,6506,Daniel Sedin,2003-04,23.0,4,31,79,79,14,17,31,134.0,983.0,233,43,54,97,378.0,82,5.31,60,363,2326,9.4,0.50227875
6507,6507,Daniel Sedin,2004-05,24.0,5,54,82,82,18,36,54,153.0,1111.0,315,61,90,151,531.0,82,5.14,57,348,2300,9.2,0.7789516
6508,6508,Daniel Sedin,2006-07,26.0,6,71,82,82,22,49,71,204.0,1366.0,397,83,139,222,735.0,82,6.05,85,480,2458,10.1,0.8360158
6509,6509,Daniel Sedin,2007-08,27.0,7,84,81,81,36,48,84,236.0,1463.0,478,119,187,306,971.0,82,5.76,70,398,2426,9.7,0.9073893
6510,6510,Daniel Sedin,2008-09,28.0,8,74,82,82,29,45,74,247.0,1562.0,560,148,232,380,1218.0,82,5.44,62,351,2383,9.4,0.8647593
6511,6511,Daniel Sedin,2009-10,29.0,9,82,82,82,31,51,82,285.0,1541.0,642,179,283,462,1503.0,82,5.7,65,341,2477,9.4,0.92679167
6512,6512,Daniel Sedin,2010-11,30.0,10,85,63,63,29,56,85,225.0,1206.0,705,208,339,547,1728.0,82,5.53,56,304,2486,9.1,1.1812313
6513,6513,Daniel Sedin,2011-12,31.0,11,104,82,82,41,63,104,266.0,1521.0,787,249,402,651,1994.0,82,5.46,52,291,2492,9.0,1.0946112
6514,6514,Daniel Sedin,2012-13,32.0,12,67,72,72,30,37,67,229.0,1355.0,859,279,439,718,2223.0,82,5.32,47,271,2439,8.9,0.7989161
6515,6515,Daniel Sedin,2013-14,33.0,13,40,47,47,12,28,40,138.0,894.0,906,291,467,758,2361.0,48,5.31,29,160,1399,9.1,0.78829813
6516,6516,Daniel Sedin,2014-15,34.0,14,47,73,73,16,31,47,224.0,1504.0,979,307,498,805,2585.0,82,5.34,48,269,2463,8.9,0.66272044
6517,6517,Daniel Sedin,2015-16,35.0,15,76,82,82,20,56,76,226.0,1505.0,1061,327,554,881,2811.0,82,5.32,47,251,2453,8.9,0.8006247
6518,6518,Daniel Sedin,2016-17,36.0,16,61,82,82,28,33,61,258.0,1503.0,1143,355,587,942,3069.0,82,5.34,48,255,2438,9.0,0.66020954
6519,6519,Daniel Sedin,2017-18,37.0,17,44,82,82,15,29,44,216.0,1508.0,1225,370,616,986,3285.0,82,5.45,47,245,2478,9.0,0.57026315
6520,6520,Daniel Sedin,2018-19,38.0,18,55,81,81,23,32,55,189.0,1237.0,1306,393,648,1041,3474.0,82,5.86,50,250,2620,9.2,0.61980414
6521,6521,Daniel Shank,1990-91,23.0,2,24,57,57,11,13,24,61.0,,57,11,13,24,61.0,80,7.37,76,367,2421,12.2,0.38608736
6522,6522,Daniel Shank,1991-92,24.0,3,1,7,7,0,1,1,4.0,,64,11,14,25,65.0,80,6.91,71,366,2385,11.6,0.22378466
6523,6523,Daniel Shank,1992-93,25.0,4,2,13,13,2,0,2,10.0,,77,13,14,27,75.0,80,6.96,77,402,2440,11.4,0.31848964
6524,6524,Daniel Sprong,2016-17,19.0,2,2,18,18,2,0,2,23.0,157.0,18,2,0,2,23.0,82,5.34,48,255,2438,9.0,0.2764876
6525,6525,Daniel Sprong,2018-19,21.0,3,3,8,8,2,1,3,22.0,112.0,26,4,1,5,45.0,82,5.86,50,250,2620,9.2,0.34193543
6526,6526,Daniel Sprong,2019-20,22.0,4,23,63,63,14,9,23,125.0,753.0,89,18,10,28,170.0,82,5.96,47,239,2579,9.5,0.3951438
6527,6527,Daniel Sprong,2020-21,23.0,5,2,8,8,1,1,2,17.0,113.0,97,19,11,30,187.0,70,5.96,42,208,2192,9.5,0.3101903
6528,6528,Daniel Tjarnqvist,2002-03,26.0,2,18,75,75,2,16,18,68.0,1614.0,75,2,16,18,68.0,82,5.24,53,338,2262,9.5,0.22952992
6529,6529,Daniel Tjarnqvist,2003-04,27.0,3,15,75,75,3,12,15,65.0,1642.0,150,5,28,33,133.0,82,5.31,60,363,2326,9.4,0.20039868
6530,6530,Daniel Tjarnqvist,2004-05,28.0,4,20,68,68,5,15,20,65.0,1515.0,218,10,43,53,198.0,82,5.14,57,348,2300,9.2,0.27207977
6531,6531,Daniel Tjarnqvist,2006-07,30.0,5,18,60,60,3,15,18,54.0,1186.0,278,13,58,71,252.0,82,6.05,85,480,2458,10.1,0.22956556
6532,6532,Daniel Tjarnqvist,2007-08,31.0,6,15,37,37,3,12,15,33.0,840.0,315,16,70,86,285.0,82,5.76,70,398,2426,9.7,0.24026373
6533,6533,Daniel Tjarnqvist,2009-10,33.0,7,4,37,37,2,2,4,19.0,542.0,352,18,72,90,304.0,82,5.7,65,341,2477,9.4,0.14970481
6534,6534,Daniel Tkaczuk,2001-02,22.0,2,11,19,19,4,7,11,34.0,233.0,19,4,7,11,34.0,82,5.51,63,376,2272,9.9,0.32421938
6535,6535,Daniel Winnik,2008-09,23.0,2,26,79,79,11,15,26,122.0,1114.0,79,11,15,26,122.0,82,5.44,62,351,2383,9.4,0.3720169
6536,6536,Daniel Winnik,2009-10,24.0,3,7,49,49,3,4,7,66.0,641.0,128,14,19,33,188.0,82,5.7,65,341,2477,9.4,0.22939667
6537,6537,Daniel Winnik,2010-11,25.0,4,19,74,74,4,15,19,83.0,973.0,202,18,34,52,271.0,82,5.53,56,304,2486,9.1,0.25980127
6538,6538,Daniel Winnik,2011-12,26.0,5,26,80,80,11,15,26,167.0,1324.0,282,29,49,78,438.0,82,5.46,52,291,2492,9.0,0.3483891
6539,6539,Daniel Winnik,2012-13,27.0,6,23,84,84,8,15,23,184.0,1402.0,366,37,64,101,622.0,82,5.32,47,271,2439,8.9,0.322569
6540,6540,Daniel Winnik,2013-14,28.0,7,19,48,48,6,13,19,95.0,808.0,414,43,77,120,717.0,48,5.31,29,160,1399,9.1,0.3842686
6541,6541,Daniel Winnik,2014-15,29.0,8,30,76,76,6,24,30,115.0,1170.0,490,49,101,150,832.0,82,5.34,48,269,2463,8.9,0.36042154
6542,6542,Daniel Winnik,2015-16,30.0,9,34,79,79,9,25,34,97.0,1315.0,569,58,126,184,929.0,82,5.32,47,251,2453,8.9,0.35890552
6543,6543,Daniel Winnik,2016-17,31.0,10,19,76,76,6,13,19,101.0,1042.0,645,64,139,203,1030.0,82,5.34,48,255,2438,9.0,0.26588646
6544,6544,Daniel Winnik,2017-18,32.0,11,25,72,72,12,13,25,82.0,930.0,717,76,152,228,1112.0,82,5.45,47,245,2478,9.0,0.27672207
6545,6545,Daniel Winnik,2018-19,33.0,12,23,81,81,6,17,23,82.0,1099.0,798,82,169,251,1194.0,82,5.86,50,250,2620,9.2,0.2443471
6546,6546,Daniil Tarasov,2015-16,24.0,2,1,5,5,0,1,1,5.0,38.0,5,0,1,1,5.0,82,5.32,47,251,2453,8.9,0.18158066
6547,6547,Danil Yurtaykin,2020-21,23.0,2,0,4,4,0,0,0,2.0,52.0,4,0,0,0,2.0,70,5.96,42,208,2192,9.5,0.19707662
6548,6548,Danny Biega,2015-16,24.0,2,2,10,10,0,2,2,7.0,161.0,10,0,2,2,7.0,82,5.32,47,251,2453,8.9,0.17931241
6549,6549,Danny Bois,2007-08,24.0,2,0,1,1,0,0,0,1.0,4.0,1,0,0,0,1.0,82,5.76,70,398,2426,9.7,0.1588009
6550,6550,Danny DeKeyser,2013-14,23.0,2,1,11,11,0,1,1,15.0,199.0,11,0,1,1,15.0,48,5.31,29,160,1399,9.1,0.22593564
6551,6551,Danny DeKeyser,2014-15,24.0,3,23,65,65,4,19,23,84.0,1407.0,76,4,20,24,99.0,82,5.34,48,269,2463,8.9,0.30482763
6552,6552,Danny DeKeyser,2015-16,25.0,4,31,80,80,2,29,31,89.0,1674.0,156,6,49,55,188.0,82,5.32,47,251,2453,8.9,0.35319996
6553,6553,Danny DeKeyser,2016-17,26.0,5,20,78,78,8,12,20,72.0,1701.0,234,14,61,75,260.0,82,5.34,48,255,2438,9.0,0.26639646
6554,6554,Danny DeKeyser,2017-18,27.0,6,12,82,82,4,8,12,85.0,1800.0,316,18,69,87,345.0,82,5.45,47,245,2478,9.0,0.20389509
6555,6555,Danny DeKeyser,2018-19,28.0,7,12,65,65,6,6,12,65.0,1321.0,381,24,75,99,410.0,82,5.86,50,250,2620,9.2,0.21492502
6556,6556,Danny DeKeyser,2019-20,29.0,8,20,52,52,5,15,20,59.0,1142.0,433,29,90,119,469.0,82,5.96,47,239,2579,9.5,0.3336384
6557,6557,Danny DeKeyser,2020-21,30.0,9,4,8,8,0,4,4,12.0,176.0,441,29,94,123,481.0,70,5.96,42,208,2192,9.5,0.23990563
6558,6558,Danny Geoffrion,1980-81,23.0,2,6,32,32,0,6,6,19.0,,32,0,6,6,19.0,80,7.03,61,280,2352,12.0,0.21183154
6559,6559,Danny Geoffrion,1981-82,24.0,3,46,78,78,20,26,46,142.0,,110,20,32,52,161.0,80,7.69,77,340,2441,12.6,0.5422938
6560,6560,Danny Geoffrion,1982-83,25.0,4,0,1,1,0,0,0,2.0,,111,20,32,52,163.0,80,8.03,73,320,2489,12.9,0.262434
6561,6561,Danny Irmen,2010-11,26.0,2,0,2,2,0,0,0,0.0,9.0,2,0,0,0,0.0,82,5.53,56,304,2486,9.1,0.14992926
6562,6562,Danny Markov,1998-99,22.0,2,7,25,25,2,5,7,15.0,,25,2,5,7,15.0,82,5.28,57,380,2242,9.6,0.23274931
6563,6563,Danny Markov,1999-00,23.0,3,12,57,57,4,8,12,34.0,1065.0,82,6,13,19,49.0,82,5.27,57,359,2285,9.4,0.21875978
6564,6564,Danny Markov,2000-01,24.0,4,10,59,59,0,10,10,38.0,1188.0,141,6,23,29,87.0,82,5.49,53,331,2294,9.8,0.16830125
6565,6565,Danny Markov,2001-02,25.0,5,16,59,59,3,13,16,49.0,1123.0,200,9,36,45,136.0,82,5.51,63,376,2272,9.9,0.23926932
6566,6566,Danny Markov,2002-03,26.0,6,36,72,72,6,30,36,103.0,1650.0,272,15,66,81,239.0,82,5.24,53,338,2262,9.5,0.42251462
6567,6567,Danny Markov,2003-04,27.0,7,20,64,64,4,16,20,105.0,1489.0,336,19,82,101,344.0,82,5.31,60,363,2326,9.4,0.3063934
6568,6568,Danny Markov,2004-05,28.0,8,19,78,78,6,13,19,100.0,1764.0,414,25,95,120,444.0,82,5.14,57,348,2300,9.2,0.30135107
6569,6569,Danny Markov,2006-07,30.0,9,11,58,58,0,11,11,59.0,1134.0,472,25,106,131,503.0,82,6.05,85,480,2458,10.1,0.1891594
6570,6570,Danny Markov,2007-08,31.0,10,16,66,66,4,12,16,66.0,1246.0,538,29,118,147,569.0,82,5.76,70,398,2426,9.7,0.19474411
6571,6571,Danny O'Regan,2017-18,24.0,2,1,3,3,1,0,1,5.0,35.0,3,1,0,1,5.0,82,5.45,47,245,2478,9.0,0.21207029
6572,6572,Danny O'Regan,2018-19,25.0,3,4,21,21,0,4,4,17.0,209.0,24,1,4,5,22.0,82,5.86,50,250,2620,9.2,0.14664525
6573,6573,Danny O'Regan,2019-20,26.0,4,0,1,1,0,0,0,2.0,12.0,25,1,4,5,24.0,82,5.96,47,239,2579,9.5,0.16564614
6574,6574,Danny Richmond,2006-07,22.0,2,1,20,20,0,1,1,13.0,226.0,20,0,1,1,13.0,82,6.05,85,480,2458,10.1,0.13558114
6575,6575,Danny Richmond,2007-08,23.0,3,2,22,22,0,2,2,13.0,271.0,42,0,3,3,26.0,82,5.76,70,398,2426,9.7,0.13491908
6576,6576,Danny Richmond,2008-09,24.0,4,0,7,7,0,0,0,2.0,66.0,49,0,3,3,28.0,82,5.44,62,351,2383,9.4,0.1455597
6577,6577,Danny Syvret,2006-07,21.0,2,0,10,10,0,0,0,8.0,123.0,10,0,0,0,8.0,82,6.05,85,480,2458,10.1,0.18798679
6578,6578,Danny Syvret,2007-08,22.0,3,1,16,16,0,1,1,15.0,296.0,26,0,1,1,23.0,82,5.76,70,398,2426,9.7,0.17536232
6579,6579,Danny Syvret,2009-10,24.0,4,0,2,2,0,0,0,0.0,19.0,28,0,1,1,23.0,82,5.7,65,341,2477,9.4,0.14875916
6580,6580,Danny Syvret,2010-11,25.0,5,4,21,21,2,2,4,14.0,262.0,49,2,3,5,37.0,82,5.53,56,304,2486,9.1,0.15912336
6581,6581,Danny Syvret,2011-12,26.0,6,2,10,10,1,1,2,11.0,151.0,59,3,4,7,48.0,82,5.46,52,291,2492,9.0,0.18089229
6582,6582,Dante Fabbro,2019-20,21.0,2,1,4,4,1,0,1,5.0,51.0,4,1,0,1,5.0,82,5.96,47,239,2579,9.5,0.2639979
6583,6583,Dante Fabbro,2020-21,22.0,3,11,64,64,5,6,11,92.0,1218.0,68,6,6,12,97.0,70,5.96,42,208,2192,9.5,0.26406813
6584,6584,Danton Cole,1990-91,24.0,2,2,2,2,1,1,2,2.0,,2,1,1,2,2.0,80,7.37,76,367,2421,12.2,0.27405238
6585,6585,Danton Cole,1991-92,25.0,3,24,66,66,13,11,24,109.0,,68,14,12,26,111.0,80,6.91,71,366,2385,11.6,0.37741333
6586,6586,Danton Cole,1992-93,26.0,4,12,52,52,7,5,12,65.0,,120,21,17,38,176.0,80,6.96,77,402,2440,11.4,0.34530634
6587,6587,Danton Cole,1993-94,27.0,5,27,67,67,12,15,27,100.0,,187,33,32,65,276.0,84,7.25,87,443,2603,11.7,0.32863694
6588,6588,Danton Cole,1994-95,28.0,6,43,81,81,20,23,43,149.0,,268,53,55,108,425.0,84,6.48,76,407,2545,10.7,0.433146
6589,6589,Danton Cole,1995-96,29.0,7,9,38,38,4,5,9,76.0,,306,57,60,117,501.0,48,5.97,37,209,1408,10.2,0.27240542
6590,6590,Danton Cole,1996-97,30.0,8,1,12,12,1,0,1,6.0,,318,58,60,118,507.0,82,6.29,74,413,2481,10.4,0.2081444
6591,6591,Danton Heinen,2017-18,22.0,2,0,8,8,0,0,0,7.0,106.0,8,0,0,0,7.0,82,5.45,47,245,2478,9.0,0.18290794
6592,6592,Danton Heinen,2018-19,23.0,3,47,77,77,16,31,47,135.0,1157.0,85,16,31,47,142.0,82,5.86,50,250,2620,9.2,0.59156364
6593,6593,Danton Heinen,2019-20,24.0,4,34,77,77,11,23,34,114.0,1076.0,162,27,54,81,256.0,82,5.96,47,239,2579,9.5,0.40664235
6594,6594,Danton Heinen,2020-21,25.0,5,26,67,67,10,16,26,109.0,969.0,229,37,70,107,365.0,70,5.96,42,208,2192,9.5,0.4122756
6595,6595,Dany Heatley,2002-03,22.0,2,67,82,82,26,41,67,202.0,1631.0,82,26,41,67,202.0,82,5.24,53,338,2262,9.5,0.8690969
6596,6596,Dany Heatley,2003-04,23.0,3,89,77,77,41,48,89,252.0,1690.0,159,67,89,156,454.0,82,5.31,60,363,2326,9.4,1.0531868
6597,6597,Dany Heatley,2004-05,24.0,4,25,31,31,13,12,25,83.0,616.0,190,80,101,181,537.0,82,5.14,57,348,2300,9.2,0.9412811
6598,6598,Dany Heatley,2006-07,26.0,5,103,82,82,50,53,103,300.0,1734.0,272,130,154,284,837.0,82,6.05,85,480,2458,10.1,1.152939
6599,6599,Dany Heatley,2007-08,27.0,6,105,82,82,50,55,105,310.0,1725.0,354,180,209,389,1147.0,82,5.76,70,398,2426,9.7,1.2069695
6600,6600,Dany Heatley,2008-09,28.0,7,82,71,71,41,41,82,224.0,1543.0,425,221,250,471,1371.0,82,5.44,62,351,2383,9.4,0.968806
6601,6601,Dany Heatley,2009-10,29.0,8,72,82,82,39,33,72,258.0,1649.0,507,260,283,543,1629.0,82,5.7,65,341,2477,9.4,0.90124744
6602,6602,Dany Heatley,2010-11,30.0,9,82,82,82,39,43,82,280.0,1659.0,589,299,326,625,1909.0,82,5.53,56,304,2486,9.1,0.8914285
6603,6603,Dany Heatley,2011-12,31.0,10,64,80,80,26,38,64,217.0,1572.0,669,325,364,689,2126.0,82,5.46,52,291,2492,9.0,0.7479931
6604,6604,Dany Heatley,2012-13,32.0,11,53,82,82,24,29,53,238.0,1717.0,751,349,393,742,2364.0,82,5.32,47,271,2439,8.9,0.6736609
6605,6605,Dany Heatley,2013-14,33.0,12,21,36,36,11,10,21,83.0,667.0,787,360,403,763,2447.0,48,5.31,29,160,1399,9.1,0.5531405
6606,6606,Dany Heatley,2014-15,34.0,13,28,76,76,12,16,28,110.0,1126.0,863,372,419,791,2557.0,82,5.34,48,269,2463,8.9,0.37043077
6607,6607,Dany Heatley,2015-16,35.0,14,0,6,6,0,0,0,8.0,73.0,869,372,419,791,2565.0,82,5.32,47,251,2453,8.9,0.34174144
6608,6608,Darby Hendrickson,1995-96,23.0,2,1,8,8,0,1,1,4.0,,8,0,1,1,4.0,48,5.97,37,209,1408,10.2,0.21753478
6609,6609,Darby Hendrickson,1996-97,24.0,3,17,62,62,7,10,17,73.0,,70,7,11,18,77.0,82,6.29,74,413,2481,10.4,0.28060743
6610,6610,Darby Hendrickson,1997-98,25.0,4,17,64,64,11,6,17,105.0,,134,18,17,35,182.0,82,5.83,55,336,2444,9.8,0.25083113
6611,6611,Darby Hendrickson,1998-99,26.0,5,12,80,80,8,4,12,115.0,,214,26,21,47,297.0,82,5.28,57,380,2242,9.6,0.22257549
6612,6612,Darby Hendrickson,1999-00,27.0,6,9,62,62,4,5,9,70.0,825.0,276,30,26,56,367.0,82,5.27,57,359,2285,9.4,0.19988903
6613,6613,Darby Hendrickson,2000-01,28.0,7,9,40,40,5,4,9,39.0,461.0,316,35,30,65,406.0,82,5.49,53,331,2294,9.8,0.18506211
6614,6614,Darby Hendrickson,2001-02,29.0,8,29,72,72,18,11,29,114.0,1140.0,388,53,41,94,520.0,82,5.51,63,376,2272,9.9,0.36021358
6615,6615,Darby Hendrickson,2002-03,30.0,9,24,68,68,9,15,24,79.0,1137.0,456,62,56,118,599.0,82,5.24,53,338,2262,9.5,0.29014352
6616,6616,Darby Hendrickson,2003-04,31.0,10,6,28,28,1,5,6,34.0,427.0,484,63,61,124,633.0,82,5.31,60,363,2326,9.4,0.22389883
6617,6617,Darby Hendrickson,2004-05,32.0,11,5,34,34,2,3,5,35.0,456.0,518,65,64,129,668.0,82,5.14,57,348,2300,9.2,0.2254824
6618,6618,Darcy Campbell,2007-08,23.0,2,0,1,1,0,0,0,0.0,6.0,1,0,0,0,0.0,82,5.76,70,398,2426,9.7,0.15239856
6619,6619,Darcy Hordichuk,2001-02,21.0,2,0,11,11,0,0,0,6.0,80.0,11,0,0,0,6.0,82,5.51,63,376,2272,9.9,0.14624122
6620,6620,Darcy Hordichuk,2002-03,22.0,3,2,34,34,1,1,2,8.0,207.0,45,1,1,2,14.0,82,5.24,53,338,2262,9.5,0.13086635
6621,6621,Darcy Hordichuk,2003-04,23.0,4,0,28,28,0,0,0,7.0,149.0,73,1,1,2,21.0,82,5.31,60,363,2326,9.4,0.10800329
6622,6622,Darcy Hordichuk,2004-05,24.0,5,4,57,57,3,1,4,27.0,386.0,130,4,2,6,48.0,82,5.14,57,348,2300,9.2,0.1216951
6623,6623,Darcy Hordichuk,2006-07,26.0,6,13,74,74,7,6,13,52.0,455.0,204,11,8,19,100.0,82,6.05,85,480,2458,10.1,0.17580077
6624,6624,Darcy Hordichuk,2007-08,27.0,7,4,53,53,1,3,4,22.0,255.0,257,12,11,23,122.0,82,5.76,70,398,2426,9.7,0.08718717
6625,6625,Darcy Hordichuk,2008-09,28.0,8,3,45,45,1,2,3,18.0,232.0,302,13,13,26,140.0,82,5.44,62,351,2383,9.4,0.09124181
6626,6626,Darcy Hordichuk,2009-10,29.0,9,5,73,73,4,1,5,26.0,404.0,375,17,14,31,166.0,82,5.7,65,341,2477,9.4,0.093171746
6627,6627,Darcy Hordichuk,2010-11,30.0,10,2,56,56,1,1,2,21.0,338.0,431,18,15,33,187.0,82,5.53,56,304,2486,9.1,0.070881635
6628,6628,Darcy Hordichuk,2011-12,31.0,11,5,64,64,1,4,5,32.0,324.0,495,19,19,38,219.0,82,5.46,52,291,2492,9.0,0.0841088
6629,6629,Darcy Hordichuk,2012-13,32.0,12,3,43,43,1,2,3,27.0,187.0,538,20,21,41,246.0,82,5.32,47,271,2439,8.9,0.081156015
6630,6630,Darcy Hordichuk,2013-14,33.0,13,0,4,4,0,0,0,0.0,8.0,542,20,21,41,246.0,48,5.31,29,160,1399,9.1,0.13309318
6631,6631,Darcy Loewen,1990-91,21.0,2,0,4,4,0,0,0,1.0,,4,0,0,0,1.0,80,7.37,76,367,2421,12.2,0.23798189
6632,6632,Darcy Loewen,1991-92,22.0,3,0,6,6,0,0,0,2.0,,10,0,0,0,3.0,80,6.91,71,366,2385,11.6,0.20129812
6633,6633,Darcy Loewen,1992-93,23.0,4,0,2,2,0,0,0,1.0,,12,0,0,0,4.0,80,6.96,77,402,2440,11.4,0.19895628
6634,6634,Darcy Loewen,1993-94,24.0,5,9,79,79,4,5,9,42.0,,91,4,5,9,46.0,84,7.25,87,443,2603,11.7,0.16606566
6635,6635,Darcy Loewen,1994-95,25.0,6,3,44,44,0,3,3,39.0,,135,4,8,12,85.0,84,6.48,76,407,2545,10.7,0.12391037
6636,6636,Darcy Martini,1994-95,26.0,2,0,2,2,0,0,0,0.0,,2,0,0,0,0.0,84,6.48,76,407,2545,10.7,0.14919865
6637,6637,Darcy Tucker,1996-97,21.0,2,0,3,3,0,0,0,1.0,,3,0,0,0,1.0,82,6.29,74,413,2481,10.4,0.18608436
6638,6638,Darcy Tucker,1997-98,22.0,3,20,73,73,7,13,20,62.0,,76,7,13,20,63.0,82,5.83,55,336,2444,9.8,0.29710823
6639,6639,Darcy Tucker,1998-99,23.0,4,20,74,74,7,13,20,63.0,,150,14,26,40,126.0,82,5.28,57,380,2242,9.6,0.3103901
6640,6640,Darcy Tucker,1999-00,24.0,5,43,82,82,21,22,43,178.0,1591.0,232,35,48,83,304.0,82,5.27,57,359,2285,9.4,0.5587234
6641,6641,Darcy Tucker,2000-01,25.0,6,51,77,77,21,30,51,138.0,1449.0,309,56,78,134,442.0,82,5.49,53,331,2294,9.8,0.6002915
6642,6642,Darcy Tucker,2001-02,26.0,7,37,82,82,16,21,37,122.0,1325.0,391,72,99,171,564.0,82,5.51,63,376,2272,9.9,0.50074005
6643,6643,Darcy Tucker,2002-03,27.0,8,59,77,77,24,35,59,124.0,1307.0,468,96,134,230,688.0,82,5.24,53,338,2262,9.5,0.6406402
6644,6644,Darcy Tucker,2003-04,28.0,9,36,77,77,10,26,36,108.0,1182.0,545,106,160,266,796.0,82,5.31,60,363,2326,9.4,0.41065636
6645,6645,Darcy Tucker,2004-05,29.0,10,32,64,64,21,11,32,146.0,1142.0,609,127,171,298,942.0,82,5.14,57,348,2300,9.2,0.61128443
6646,6646,Darcy Tucker,2006-07,31.0,11,61,74,74,28,33,61,189.0,1305.0,683,155,204,359,1131.0,82,6.05,85,480,2458,10.1,0.684324
6647,6647,Darcy Tucker,2007-08,32.0,12,43,56,56,24,19,43,143.0,996.0,739,179,223,402,1274.0,82,5.76,70,398,2426,9.7,0.65541846
6648,6648,Darcy Tucker,2008-09,33.0,13,34,74,74,18,16,34,152.0,1216.0,813,197,239,436,1426.0,82,5.44,62,351,2383,9.4,0.4143869
6649,6649,Darcy Tucker,2009-10,34.0,14,16,63,63,8,8,16,94.0,889.0,876,205,247,452,1520.0,82,5.7,65,341,2477,9.4,0.2505033
6650,6650,Darcy Tucker,2010-11,35.0,15,24,71,71,10,14,24,73.0,860.0,947,215,261,476,1593.0,82,5.53,56,304,2486,9.1,0.2747771
6651,6651,Darcy Verot,2004-05,28.0,2,2,37,37,0,2,2,11.0,326.0,37,0,2,2,11.0,82,5.14,57,348,2300,9.2,0.110820204
6652,6652,Darin Kimble,1989-90,21.0,2,4,26,26,3,1,4,21.0,,26,3,1,4,21.0,80,7.48,85,403,2430,12.3,0.34274092
6653,6653,Darin Kimble,1990-91,22.0,3,10,44,44,5,5,10,40.0,,70,8,6,14,61.0,80,7.37,76,367,2421,12.2,0.2675963
6654,6654,Darin Kimble,1991-92,23.0,4,9,61,61,3,6,9,28.0,,131,11,12,23,89.0,80,6.91,71,366,2385,11.6,0.15899494
6655,6655,Darin Kimble,1992-93,24.0,5,4,46,46,1,3,4,12.0,,177,12,15,27,101.0,80,6.96,77,402,2440,11.4,0.14727294
6656,6656,Darin Kimble,1993-94,25.0,6,10,55,55,7,3,10,20.0,,232,19,18,37,121.0,84,7.25,87,443,2603,11.7,0.2165645
6657,6657,Darin Kimble,1994-95,26.0,7,6,65,65,4,2,6,17.0,,297,23,20,43,138.0,84,6.48,76,407,2545,10.7,0.11330214
6658,6658,Darin Kimble,1995-96,27.0,8,0,14,14,0,0,0,2.0,,311,23,20,43,140.0,48,5.97,37,209,1408,10.2,0.14180279
6659,6659,Darin Sceviour,1987-88,22.0,2,0,1,1,0,0,0,1.0,,1,0,0,0,1.0,80,7.34,72,344,2400,12.2,0.23124611
6660,6660,Darius Kasparaitis,1993-94,21.0,2,21,79,79,4,17,21,92.0,,79,4,17,21,92.0,84,7.25,87,443,2603,11.7,0.3286662
6661,6661,Darius Kasparaitis,1994-95,22.0,3,11,76,76,1,10,11,81.0,,155,5,27,32,173.0,84,6.48,76,407,2545,10.7,0.23349911
6662,6662,Darius Kasparaitis,1995-96,23.0,4,1,13,13,0,1,1,8.0,,168,5,28,33,181.0,48,5.97,37,209,1408,10.2,0.21587506
6663,6663,Darius Kasparaitis,1996-97,24.0,5,8,46,46,1,7,8,34.0,,214,6,35,41,215.0,82,6.29,74,413,2481,10.4,0.18067384
6664,6664,Darius Kasparaitis,1997-98,25.0,6,23,75,75,2,21,23,58.0,,289,8,56,64,273.0,82,5.83,55,336,2444,9.8,0.23252895
6665,6665,Darius Kasparaitis,1998-99,26.0,7,12,81,81,4,8,12,71.0,,370,12,64,76,344.0,82,5.28,57,380,2242,9.6,0.186151
6666,6666,Darius Kasparaitis,1999-00,27.0,8,5,48,48,1,4,5,32.0,769.0,418,13,68,81,376.0,82,5.27,57,359,2285,9.4,0.14465883
6667,6667,Darius Kasparaitis,2000-01,28.0,9,15,73,73,3,12,15,76.0,1322.0,491,16,80,96,452.0,82,5.49,53,331,2294,9.8,0.21263537
6668,6668,Darius Kasparaitis,2001-02,29.0,10,19,77,77,3,16,19,81.0,1481.0,568,19,96,115,533.0,82,5.51,63,376,2272,9.9,0.21244073
6669,6669,Darius Kasparaitis,2002-03,30.0,11,14,80,80,2,12,14,81.0,1634.0,648,21,108,129,614.0,82,5.24,53,338,2262,9.5,0.16359001
6670,6670,Darius Kasparaitis,2003-04,31.0,12,14,80,80,3,11,14,84.0,1511.0,728,24,119,143,698.0,82,5.31,60,363,2326,9.4,0.15797451
6671,6671,Darius Kasparaitis,2004-05,32.0,13,10,44,44,1,9,10,29.0,721.0,772,25,128,153,727.0,82,5.14,57,348,2300,9.2,0.14576536
6672,6672,Darius Kasparaitis,2006-07,34.0,14,6,67,67,0,6,6,48.0,1171.0,839,25,134,159,775.0,82,6.05,85,480,2458,10.1,0.10883728
6673,6673,Darius Kasparaitis,2007-08,35.0,15,4,24,24,2,2,4,9.0,357.0,863,27,136,163,784.0,82,5.76,70,398,2426,9.7,0.12498775
6674,6674,Darnell Nurse,2015-16,20.0,2,0,2,2,0,0,0,2.0,34.0,2,0,0,0,2.0,82,5.32,47,251,2453,8.9,0.26383117
6675,6675,Darnell Nurse,2016-17,21.0,3,10,69,69,3,7,10,120.0,1396.0,71,3,7,10,122.0,82,5.34,48,255,2438,9.0,0.25949028
6676,6676,Darnell Nurse,2017-18,22.0,4,11,44,44,5,6,11,85.0,749.0,115,8,13,21,207.0,82,5.45,47,245,2478,9.0,0.31089783
6677,6677,Darnell Nurse,2018-19,23.0,5,26,82,82,6,20,26,194.0,1824.0,197,14,33,47,401.0,82,5.86,50,250,2620,9.2,0.40135202
6678,6678,Darnell Nurse,2019-20,24.0,6,41,82,82,10,31,41,196.0,1953.0,279,24,64,88,597.0,82,5.96,47,239,2579,9.5,0.48385096
6679,6679,Darnell Nurse,2020-21,25.0,7,33,71,71,5,28,33,170.0,1665.0,350,29,92,121,767.0,70,5.96,42,208,2192,9.5,0.50464135
6680,6680,Darrel Anholt,1984-85,22.0,2,0,1,1,0,0,0,0.0,,1,0,0,0,0.0,80,7.89,74,336,2448,12.9,0.20696738
6681,6681,Darrel Scoville,2000-01,25.0,2,0,6,6,0,0,0,1.0,56.0,6,0,0,0,1.0,82,5.49,53,331,2294,9.8,0.15239698
6682,6682,Darrel Scoville,2003-04,28.0,3,0,2,2,0,0,0,1.0,29.0,8,0,0,0,2.0,82,5.31,60,363,2326,9.4,0.14335507
6683,6683,Darrel Scoville,2004-05,29.0,4,1,8,8,0,1,1,5.0,154.0,16,0,1,1,7.0,82,5.14,57,348,2300,9.2,0.16559449
6684,6684,Darren Archibald,2014-15,24.0,2,3,16,16,1,2,3,11.0,125.0,16,1,2,3,11.0,82,5.34,48,269,2463,8.9,0.20055512
6685,6685,Darren Archibald,2018-19,28.0,3,9,27,27,4,5,9,28.0,401.0,43,5,7,12,39.0,82,5.86,50,250,2620,9.2,0.20376012
6686,6686,Darren Archibald,2019-20,29.0,4,2,12,12,1,1,2,10.0,89.0,55,6,8,14,49.0,82,5.96,47,239,2579,9.5,0.17558718
6687,6687,Darren Banks,1993-94,27.0,2,3,16,16,2,1,3,15.0,,16,2,1,3,15.0,84,7.25,87,443,2603,11.7,0.27197227
6688,6688,Darren Banks,1994-95,28.0,3,1,4,4,0,1,1,3.0,,20,2,2,4,18.0,84,6.48,76,407,2545,10.7,0.1681006
6689,6689,Darren Boyko,1989-90,26.0,2,0,1,1,0,0,0,0.0,,1,0,0,0,0.0,80,7.48,85,403,2430,12.3,0.1660105
6690,6690,Darren Dietz,2016-17,23.0,2,5,13,13,1,4,5,13.0,189.0,13,1,4,5,13.0,82,5.34,48,255,2438,9.0,0.24117127
6691,6691,Darren Haydar,2003-04,24.0,2,0,2,2,0,0,0,1.0,18.0,2,0,0,0,1.0,82,5.31,60,363,2326,9.4,0.1768949
6692,6692,Darren Haydar,2007-08,28.0,3,0,4,4,0,0,0,4.0,32.0,6,0,0,0,5.0,82,5.76,70,398,2426,9.7,0.16381708
6693,6693,Darren Haydar,2008-09,29.0,4,8,16,16,1,7,8,14.0,188.0,22,1,7,8,19.0,82,5.44,62,351,2383,9.4,0.19977534
6694,6694,Darren Haydar,2010-11,31.0,5,0,1,1,0,0,0,2.0,5.0,23,1,7,8,21.0,82,5.53,56,304,2486,9.1,0.15340501
6695,6695,Darren Helm,2008-09,22.0,2,0,7,7,0,0,0,7.0,49.0,7,0,0,0,7.0,82,5.44,62,351,2383,9.4,0.17565298
6696,6696,Darren Helm,2009-10,23.0,3,1,16,16,0,1,1,29.0,199.0,23,0,1,1,36.0,82,5.7,65,341,2477,9.4,0.22151679
6697,6697,Darren Helm,2010-11,24.0,4,24,75,75,11,13,24,165.0,1087.0,98,11,14,25,201.0,82,5.53,56,304,2486,9.1,0.3540638
6698,6698,Darren Helm,2011-12,25.0,5,32,82,82,12,20,32,177.0,1091.0,180,23,34,57,378.0,82,5.46,52,291,2492,9.0,0.43647143
6699,6699,Darren Helm,2012-13,26.0,6,26,68,68,9,17,26,124.0,987.0,248,32,51,83,502.0,82,5.32,47,271,2439,8.9,0.3406893
6700,6700,Darren Helm,2013-14,27.0,7,0,1,1,0,0,0,1.0,12.0,249,32,51,83,503.0,48,5.31,29,160,1399,9.1,0.27714634
6701,6701,Darren Helm,2014-15,28.0,8,20,42,42,12,8,20,83.0,637.0,291,44,59,103,586.0,82,5.34,48,269,2463,8.9,0.372966
6702,6702,Darren Helm,2015-16,29.0,9,33,75,75,15,18,33,160.0,1188.0,366,59,77,136,746.0,82,5.32,47,251,2453,8.9,0.38311222
6703,6703,Darren Helm,2016-17,30.0,10,26,77,77,13,13,26,165.0,1160.0,443,72,90,162,911.0,82,5.34,48,255,2438,9.0,0.3483945
6704,6704,Darren Helm,2017-18,31.0,11,17,50,50,8,9,17,98.0,768.0,493,80,99,179,1009.0,82,5.45,47,245,2478,9.0,0.3312344
6705,6705,Darren Helm,2018-19,32.0,12,31,75,75,13,18,31,141.0,1167.0,568,93,117,210,1150.0,82,5.86,50,250,2620,9.2,0.33518356
6706,6706,Darren Helm,2019-20,33.0,13,17,61,61,7,10,17,107.0,889.0,629,100,127,227,1257.0,82,5.96,47,239,2579,9.5,0.27179003
6707,6707,Darren Helm,2020-21,34.0,14,16,68,68,9,7,16,102.0,934.0,697,109,134,243,1359.0,70,5.96,42,208,2192,9.5,0.24765575
6708,6708,Darren Langdon,1995-96,25.0,2,2,18,18,1,1,2,6.0,,18,1,1,2,6.0,48,5.97,37,209,1408,10.2,0.21756685
6709,6709,Darren Langdon,1996-97,26.0,3,11,64,64,7,4,11,29.0,,82,8,5,13,35.0,82,6.29,74,413,2481,10.4,0.16166514
6710,6710,Darren Langdon,1997-98,27.0,4,9,60,60,3,6,9,24.0,,142,11,11,22,59.0,82,5.83,55,336,2444,9.8,0.10108715
6711,6711,Darren Langdon,1998-99,28.0,5,6,70,70,3,3,6,15.0,,212,14,14,28,74.0,82,5.28,57,380,2242,9.6,0.10758382
6712,6712,Darren Langdon,1999-00,29.0,6,0,44,44,0,0,0,8.0,156.0,256,14,14,28,82.0,82,5.27,57,359,2285,9.4,0.08599579
6713,6713,Darren Langdon,2000-01,30.0,7,1,21,21,0,1,1,13.0,118.0,277,14,15,29,95.0,82,5.49,53,331,2294,9.8,0.07591638
6714,6714,Darren Langdon,2001-02,31.0,8,2,54,54,0,2,2,6.0,181.0,331,14,17,31,101.0,82,5.51,63,376,2272,9.9,0.054882884
6715,6715,Darren Langdon,2002-03,32.0,9,3,58,58,2,1,3,12.0,242.0,389,16,18,34,113.0,82,5.24,53,338,2262,9.5,0.07690686
6716,6716,Darren Langdon,2003-04,33.0,10,1,54,54,0,1,1,19.0,269.0,443,16,19,35,132.0,82,5.31,60,363,2326,9.4,0.06740743
6717,6717,Darren Langdon,2004-05,34.0,11,3,64,64,0,3,3,22.0,401.0,507,16,22,38,154.0,82,5.14,57,348,2300,9.2,0.08206642
6718,6718,Darren Langdon,2006-07,36.0,12,1,14,14,0,1,1,2.0,46.0,521,16,23,39,156.0,82,6.05,85,480,2458,10.1,0.08710191
6719,6719,Darren Lowe,1984-85,24.0,2,3,8,8,1,2,3,14.0,,8,1,2,3,14.0,80,7.89,74,336,2448,12.9,0.28696853
6720,6720,Darren McCarty,1994-95,22.0,2,26,67,67,9,17,26,81.0,,67,9,17,26,81.0,84,6.48,76,407,2545,10.7,0.39596835
6721,6721,Darren McCarty,1995-96,23.0,3,13,31,31,5,8,13,27.0,,98,14,25,39,108.0,48,5.97,37,209,1408,10.2,0.38076395
6722,6722,Darren McCarty,1996-97,24.0,4,29,63,63,15,14,29,102.0,,161,29,39,68,210.0,82,6.29,74,413,2481,10.4,0.45447975
6723,6723,Darren McCarty,1997-98,25.0,5,49,68,68,19,30,49,171.0,,229,48,69,117,381.0,82,5.83,55,336,2444,9.8,0.6300456
6724,6724,Darren McCarty,1998-99,26.0,6,37,71,71,15,22,37,166.0,,300,63,91,154,547.0,82,5.28,57,380,2242,9.6,0.5408732
6725,6725,Darren McCarty,1999-00,27.0,7,40,69,69,14,26,40,140.0,1178.0,369,77,117,194,687.0,82,5.27,57,359,2285,9.4,0.53572935
6726,6726,Darren McCarty,2000-01,28.0,8,12,24,24,6,6,12,40.0,328.0,393,83,123,206,727.0,82,5.49,53,331,2294,9.8,0.40257806
6727,6727,Darren McCarty,2001-02,29.0,9,22,72,72,12,10,22,118.0,968.0,465,95,133,228,845.0,82,5.51,63,376,2272,9.9,0.3143003
6728,6728,Darren McCarty,2002-03,30.0,10,12,62,62,5,7,12,74.0,731.0,527,100,140,240,919.0,82,5.24,53,338,2262,9.5,0.29173625
6729,6729,Darren McCarty,2003-04,31.0,11,22,73,73,13,9,22,129.0,970.0,600,113,149,262,1048.0,82,5.31,60,363,2326,9.4,0.3240784
6730,6730,Darren McCarty,2004-05,32.0,12,11,43,43,6,5,11,61.0,530.0,643,119,154,273,1109.0,82,5.14,57,348,2300,9.2,0.24713379
6731,6731,Darren McCarty,2006-07,34.0,13,13,67,67,7,6,13,67.0,784.0,710,126,160,286,1176.0,82,6.05,85,480,2458,10.1,0.18136191
6732,6732,Darren McCarty,2007-08,35.0,14,0,32,32,0,0,0,15.0,173.0,742,126,160,286,1191.0,82,5.76,70,398,2426,9.7,0.15135002
6733,6733,Darren McCarty,2008-09,36.0,15,1,3,3,0,1,1,3.0,23.0,745,126,161,287,1194.0,82,5.44,62,351,2383,9.4,0.15048432
6734,6734,Darren McCarty,2009-10,37.0,16,1,13,13,1,0,1,6.0,69.0,758,127,161,288,1200.0,82,5.7,65,341,2477,9.4,0.16833109
6735,6735,Darren Reid,2006-07,23.0,2,1,7,7,0,1,1,3.0,40.0,7,0,1,1,3.0,82,6.05,85,480,2458,10.1,0.19417447
6736,6736,Darren Reid,2007-08,24.0,3,0,14,14,0,0,0,8.0,114.0,21,0,1,1,11.0,82,5.76,70,398,2426,9.7,0.15002337
6737,6737,Darren Rumble,1991-92,23.0,2,1,3,3,1,0,1,2.0,,3,1,0,1,2.0,80,6.91,71,366,2385,11.6,0.24882919
6738,6738,Darren Rumble,1993-94,25.0,3,16,69,69,3,13,16,92.0,,72,4,13,17,94.0,84,7.25,87,443,2603,11.7,0.25660002
6739,6739,Darren Rumble,1994-95,26.0,4,15,70,70,6,9,15,95.0,,142,10,22,32,189.0,84,6.48,76,407,2545,10.7,0.22142744
6740,6740,Darren Rumble,1996-97,28.0,5,0,5,5,0,0,0,7.0,,147,10,22,32,196.0,82,6.29,74,413,2481,10.4,0.14457878
6741,6741,Darren Rumble,1997-98,29.0,6,0,10,10,0,0,0,9.0,,157,10,22,32,205.0,82,5.83,55,336,2444,9.8,0.14948943
6742,6742,Darren Rumble,2001-02,33.0,7,4,12,12,0,4,4,11.0,219.0,169,10,26,36,216.0,82,5.51,63,376,2272,9.9,0.18446293
6743,6743,Darren Rumble,2003-04,35.0,8,0,19,19,0,0,0,10.0,211.0,188,10,26,36,226.0,82,5.31,60,363,2326,9.4,0.097175926
6744,6744,Darren Rumble,2004-05,36.0,9,0,5,5,0,0,0,5.0,58.0,193,10,26,36,231.0,82,5.14,57,348,2300,9.2,0.16738248
6745,6745,Darren Turcotte,1989-90,21.0,2,10,20,20,7,3,10,49.0,,20,7,3,10,49.0,80,7.48,85,403,2430,12.3,0.49604568
6746,6746,Darren Turcotte,1990-91,22.0,3,66,76,76,32,34,66,205.0,,96,39,37,76,254.0,80,7.37,76,367,2421,12.2,0.8971019
6747,6747,Darren Turcotte,1991-92,23.0,4,67,74,74,26,41,67,212.0,,170,65,78,143,466.0,80,6.91,71,366,2385,11.6,0.89724255
6748,6748,Darren Turcotte,1992-93,24.0,5,53,71,71,30,23,53,216.0,,241,95,101,196,682.0,80,6.96,77,402,2440,11.4,0.8332565
6749,6749,Darren Turcotte,1993-94,25.0,6,53,71,71,25,28,53,213.0,,312,120,129,249,895.0,84,7.25,87,443,2603,11.7,0.63166964
6750,6750,Darren Turcotte,1994-95,26.0,7,19,32,32,4,15,19,60.0,,344,124,144,268,955.0,84,6.48,76,407,2545,10.7,0.53362924
6751,6751,Darren Turcotte,1995-96,27.0,8,35,47,47,17,18,35,121.0,,391,141,162,303,1076.0,48,5.97,37,209,1408,10.2,0.7079518
6752,6752,Darren Turcotte,1996-97,28.0,9,43,68,68,22,21,43,167.0,,459,163,183,346,1243.0,82,6.29,74,413,2481,10.4,0.597972
6753,6753,Darren Turcotte,1997-98,29.0,10,37,65,65,16,21,37,126.0,,524,179,204,383,1369.0,82,5.83,55,336,2444,9.8,0.49250126
6754,6754,Darren Turcotte,1998-99,30.0,11,18,62,62,12,6,18,75.0,,586,191,210,401,1444.0,82,5.28,57,380,2242,9.6,0.31490737
6755,6755,Darren Turcotte,1999-00,31.0,12,9,40,40,4,5,9,73.0,634.0,626,195,215,410,1517.0,82,5.27,57,359,2285,9.4,0.26831645
6756,6756,Darren Turcotte,2000-01,32.0,13,1,9,9,0,1,1,13.0,83.0,635,195,216,411,1530.0,82,5.49,53,331,2294,9.8,0.3342049
6757,6757,Darren Van Impe,1995-96,22.0,2,1,1,1,0,1,1,0.0,,1,0,1,1,0.0,48,5.97,37,209,1408,10.2,0.21553603
6758,6758,Darren Van Impe,1996-97,23.0,3,3,16,16,1,2,3,13.0,,17,1,3,4,13.0,82,6.29,74,413,2481,10.4,0.21796745
6759,6759,Darren Van Impe,1997-98,24.0,4,23,74,74,4,19,23,107.0,,91,5,22,27,120.0,82,5.83,55,336,2444,9.8,0.28800845
6760,6760,Darren Van Impe,1998-99,25.0,5,14,69,69,3,11,14,71.0,,160,8,33,41,191.0,82,5.28,57,380,2242,9.6,0.19645622
6761,6761,Darren Van Impe,1999-00,26.0,6,20,60,60,5,15,20,92.0,1074.0,220,13,48,61,283.0,82,5.27,57,359,2285,9.4,0.28730315
6762,6762,Darren Van Impe,2000-01,27.0,7,28,79,79,5,23,28,97.0,1541.0,299,18,71,89,380.0,82,5.49,53,331,2294,9.8,0.3357886
6763,6763,Darren Van Impe,2001-02,28.0,8,13,31,31,3,10,13,40.0,626.0,330,21,81,102,420.0,82,5.51,63,376,2272,9.9,0.27303588
6764,6764,Darren Van Impe,2002-03,29.0,9,11,67,67,3,8,11,60.0,1237.0,397,24,89,113,480.0,82,5.24,53,338,2262,9.5,0.19768858
6765,6765,Darren Van Impe,2003-04,30.0,10,2,14,14,1,1,2,11.0,259.0,411,25,90,115,491.0,82,5.31,60,363,2326,9.4,0.20337501
6766,6766,Darren Veitch,1981-82,21.0,2,25,59,59,4,21,25,89.0,,59,4,21,25,89.0,80,7.69,77,340,2441,12.6,0.4602597
6767,6767,Darren Veitch,1982-83,22.0,3,53,67,67,9,44,53,203.0,,126,13,65,78,292.0,80,8.03,73,320,2489,12.9,0.74456567
6768,6768,Darren Veitch,1983-84,23.0,4,8,10,10,0,8,8,26.0,,136,13,73,86,318.0,80,7.73,71,310,2444,12.7,0.4708895
6769,6769,Darren Veitch,1984-85,24.0,5,24,46,46,6,18,24,120.0,,182,19,91,110,438.0,80,7.89,74,336,2448,12.9,0.500454
6770,6770,Darren Veitch,1985-86,25.0,6,21,75,75,3,18,21,126.0,,257,22,109,131,564.0,80,7.77,71,321,2447,12.7,0.35306382
6771,6771,Darren Veitch,1986-87,26.0,7,17,75,75,3,14,17,104.0,,332,25,123,148,668.0,80,7.94,82,370,2484,12.8,0.30418053
6772,6772,Darren Veitch,1987-88,27.0,8,58,77,77,13,45,58,164.0,,409,38,168,206,832.0,80,7.34,72,344,2400,12.2,0.6306017
6773,6773,Darren Veitch,1988-89,28.0,9,40,63,63,7,33,40,156.0,,472,45,201,246,988.0,80,7.43,89,437,2435,12.2,0.5587612
6774,6774,Darren Veitch,1989-90,29.0,10,10,37,37,3,7,10,69.0,,509,48,208,256,1057.0,80,7.48,85,403,2430,12.3,0.33004624
6775,6775,Darren Veitch,1991-92,31.0,11,1,2,2,0,1,1,2.0,,511,48,209,257,1059.0,80,6.91,71,366,2385,11.6,0.24979094
6776,6776,Darrin Shannon,1989-90,20.0,2,0,3,3,0,0,0,0.0,,3,0,0,0,0.0,80,7.48,85,403,2430,12.3,0.24533376
6777,6777,Darrin Shannon,1990-91,21.0,3,9,17,17,2,7,9,20.0,,20,2,7,9,20.0,80,7.37,76,367,2421,12.2,0.3809597
6778,6778,Darrin Shannon,1991-92,22.0,4,14,34,34,8,6,14,56.0,,54,10,13,23,76.0,80,6.91,71,366,2385,11.6,0.40209052
6779,6779,Darrin Shannon,1992-93,23.0,5,40,69,69,13,27,40,93.0,,123,23,40,63,169.0,80,6.96,77,402,2440,11.4,0.5392636
6780,6780,Darrin Shannon,1993-94,24.0,6,60,84,84,20,40,60,116.0,,207,43,80,123,285.0,84,7.25,87,443,2603,11.7,0.636262
6781,6781,Darrin Shannon,1994-95,25.0,7,58,77,77,21,37,58,124.0,,284,64,117,181,409.0,84,6.48,76,407,2545,10.7,0.61910033
6782,6782,Darrin Shannon,1995-96,26.0,8,8,19,19,5,3,8,26.0,,303,69,120,189,435.0,48,5.97,37,209,1408,10.2,0.49122292
6783,6783,Darrin Shannon,1996-97,27.0,9,23,63,63,5,18,23,74.0,,366,74,138,212,509.0,82,6.29,74,413,2481,10.4,0.33766845
6784,6784,Darrin Shannon,1997-98,28.0,10,24,82,82,11,13,24,104.0,,448,85,151,236,613.0,82,5.83,55,336,2444,9.8,0.32660037
6785,6785,Darrin Shannon,1998-99,29.0,11,14,58,58,2,12,14,57.0,,506,87,163,250,670.0,82,5.28,57,380,2242,9.6,0.23441026
6786,6786,Darroll Powe,2009-10,24.0,2,11,60,60,6,5,11,72.0,632.0,60,6,5,11,72.0,82,5.7,65,341,2477,9.4,0.25105703
6787,6787,Darroll Powe,2010-11,25.0,3,15,63,63,9,6,15,103.0,761.0,123,15,11,26,175.0,82,5.53,56,304,2486,9.1,0.25107694
6788,6788,Darroll Powe,2011-12,26.0,4,17,81,81,7,10,17,87.0,995.0,204,22,21,43,262.0,82,5.46,52,291,2492,9.0,0.23733002
6789,6789,Darroll Powe,2012-13,27.0,5,13,82,82,6,7,13,109.0,1147.0,286,28,28,56,371.0,82,5.32,47,271,2439,8.9,0.20589966
6790,6790,Darroll Powe,2013-14,28.0,6,0,42,42,0,0,0,23.0,378.0,328,28,28,56,394.0,48,5.31,29,160,1399,9.1,0.11353451
6791,6791,Darroll Powe,2014-15,29.0,7,0,1,1,0,0,0,0.0,9.0,329,28,28,56,394.0,82,5.34,48,269,2463,8.9,0.19535741
6792,6792,Darryl Bootland,2004-05,23.0,2,2,22,22,1,1,2,13.0,134.0,22,1,1,2,13.0,82,5.14,57,348,2300,9.2,0.17915013
6793,6793,Darryl Bootland,2007-08,26.0,3,0,6,6,0,0,0,4.0,25.0,28,1,1,2,17.0,82,5.76,70,398,2426,9.7,0.16064733
6794,6794,Darryl Bootland,2008-09,27.0,4,1,4,4,0,1,1,3.0,19.0,32,1,2,3,20.0,82,5.44,62,351,2383,9.4,0.15458629
6795,6795,Darryl Boyce,2008-09,24.0,2,0,1,1,0,0,0,0.0,3.0,1,0,0,0,0.0,82,5.44,62,351,2383,9.4,0.16840222
6796,6796,Darryl Boyce,2011-12,27.0,3,13,46,46,5,8,13,27.0,524.0,47,5,8,13,27.0,82,5.46,52,291,2492,9.0,0.19249868
6797,6797,Darryl Boyce,2012-13,28.0,4,5,37,37,1,4,5,25.0,369.0,84,6,12,18,52.0,82,5.32,47,271,2439,8.9,0.14227277
6798,6798,Darryl Laplante,1998-99,21.0,2,0,2,2,0,0,0,2.0,,2,0,0,0,2.0,82,5.28,57,380,2242,9.6,0.17610475
6799,6799,Darryl Laplante,1999-00,22.0,3,0,3,3,0,0,0,0.0,6.0,5,0,0,0,2.0,82,5.27,57,359,2285,9.4,0.16237363
6800,6800,Darryl Laplante,2000-01,23.0,4,6,30,30,0,6,6,19.0,287.0,35,0,6,6,21.0,82,5.49,53,331,2294,9.8,0.16480288
6801,6801,Darryl Olsen,1992-93,26.0,2,0,1,1,0,0,0,3.0,,1,0,0,0,3.0,80,6.96,77,402,2440,11.4,0.20945922
6802,6802,Darryl Shannon,1989-90,21.0,2,4,14,14,1,3,4,16.0,,14,1,3,4,16.0,80,7.48,85,403,2430,12.3,0.32107437
6803,6803,Darryl Shannon,1990-91,22.0,3,1,10,10,0,1,1,16.0,,24,1,4,5,32.0,80,7.37,76,367,2421,12.2,0.21921137
6804,6804,Darryl Shannon,1991-92,23.0,4,1,10,10,0,1,1,3.0,,34,1,5,6,35.0,80,6.91,71,366,2385,11.6,0.20377836
6805,6805,Darryl Shannon,1992-93,24.0,5,10,48,48,2,8,10,50.0,,82,3,13,16,85.0,80,6.96,77,402,2440,11.4,0.2615366
6806,6806,Darryl Shannon,1993-94,25.0,6,0,16,16,0,0,0,10.0,,98,3,13,16,95.0,84,7.25,87,443,2603,11.7,0.19878891
6807,6807,Darryl Shannon,1994-95,26.0,7,4,20,20,0,4,4,14.0,,118,3,17,20,109.0,84,6.48,76,407,2545,10.7,0.13603485
6808,6808,Darryl Shannon,1995-96,27.0,8,14,40,40,5,9,14,42.0,,158,8,26,34,151.0,48,5.97,37,209,1408,10.2,0.2644462
6809,6809,Darryl Shannon,1996-97,28.0,9,17,74,74,4,13,17,59.0,,232,12,39,51,210.0,82,6.29,74,413,2481,10.4,0.1786874
6810,6810,Darryl Shannon,1997-98,29.0,10,23,82,82,4,19,23,94.0,,314,16,58,74,304.0,82,5.83,55,336,2444,9.8,0.23626918
6811,6811,Darryl Shannon,1998-99,30.0,11,22,76,76,3,19,22,85.0,,390,19,77,96,389.0,82,5.28,57,380,2242,9.6,0.2381461
6812,6812,Darryl Shannon,1999-00,31.0,12,15,71,71,3,12,15,80.0,1432.0,461,22,89,111,469.0,82,5.27,57,359,2285,9.4,0.19784418
6813,6813,Darryl Shannon,2000-01,32.0,13,27,76,76,6,21,27,112.0,1682.0,537,28,110,138,581.0,82,5.49,53,331,2294,9.8,0.28693894
6814,6814,Darryl Shannon,2001-02,33.0,14,1,7,7,0,1,1,6.0,126.0,544,28,111,139,587.0,82,5.51,63,376,2272,9.9,0.11548254
6815,6815,Darryl Sutter,1980-81,22.0,2,2,8,8,2,0,2,3.0,,8,2,0,2,3.0,80,7.03,61,280,2352,12.0,0.36240438
6816,6816,Darryl Sutter,1981-82,23.0,3,62,76,76,40,22,62,179.0,,84,42,22,64,182.0,80,7.69,77,340,2441,12.6,0.78501296
6817,6817,Darryl Sutter,1982-83,24.0,4,35,40,40,23,12,35,100.0,,124,65,34,99,282.0,80,8.03,73,320,2489,12.9,0.7131458
6818,6818,Darryl Sutter,1983-84,25.0,5,61,80,80,31,30,61,168.0,,204,96,64,160,450.0,80,7.73,71,310,2444,12.7,0.69642735
6819,6819,Darryl Sutter,1984-85,26.0,6,40,59,59,20,20,40,134.0,,263,116,84,200,584.0,80,7.89,74,336,2448,12.9,0.6560146
6820,6820,Darryl Sutter,1985-86,27.0,7,38,49,49,20,18,38,91.0,,312,136,102,238,675.0,80,7.77,71,321,2447,12.7,0.67971754
6821,6821,Darryl Sutter,1986-87,28.0,8,27,50,50,17,10,27,89.0,,362,153,112,265,764.0,80,7.94,82,370,2484,12.8,0.54378676
6822,6822,Darryl Sutter,1987-88,29.0,9,14,44,44,8,6,14,62.0,,406,161,118,279,826.0,80,7.34,72,344,2400,12.2,0.4000185
6823,6823,Darryl Sydor,1992-93,20.0,2,6,18,18,1,5,6,18.0,,18,1,5,6,18.0,80,6.96,77,402,2440,11.4,0.33109313
6824,6824,Darryl Sydor,1993-94,21.0,3,29,80,80,6,23,29,112.0,,98,7,28,35,130.0,84,7.25,87,443,2603,11.7,0.41860622
6825,6825,Darryl Sydor,1994-95,22.0,4,35,84,84,8,27,35,146.0,,182,15,55,70,276.0,84,6.48,76,407,2545,10.7,0.43797123
6826,6826,Darryl Sydor,1995-96,23.0,5,23,48,48,4,19,23,96.0,,230,19,74,93,372.0,48,5.97,37,209,1408,10.2,0.45524752
6827,6827,Darryl Sydor,1996-97,24.0,6,20,84,84,3,17,20,117.0,,314,22,91,113,489.0,82,6.29,74,413,2481,10.4,0.28780574
6828,6828,Darryl Sydor,1997-98,25.0,7,48,82,82,8,40,48,142.0,,396,30,131,161,631.0,82,5.83,55,336,2444,9.8,0.5640079
6829,6829,Darryl Sydor,1998-99,26.0,8,46,79,79,11,35,46,166.0,,475,41,166,207,797.0,82,5.28,57,380,2242,9.6,0.5500659
6830,6830,Darryl Sydor,1999-00,27.0,9,48,74,74,14,34,48,163.0,1574.0,549,55,200,255,960.0,82,5.27,57,359,2285,9.4,0.59772146
6831,6831,Darryl Sydor,2000-01,28.0,10,34,74,74,8,26,34,132.0,1713.0,623,63,226,289,1092.0,82,5.49,53,331,2294,9.8,0.44065875
6832,6832,Darryl Sydor,2001-02,29.0,11,47,81,81,10,37,47,140.0,1735.0,704,73,263,336,1232.0,82,5.51,63,376,2272,9.9,0.5321157
6833,6833,Darryl Sydor,2002-03,30.0,12,33,78,78,4,29,33,183.0,1647.0,782,77,292,369,1415.0,82,5.24,53,338,2262,9.5,0.441922
6834,6834,Darryl Sydor,2003-04,31.0,13,36,81,81,5,31,36,132.0,1484.0,863,82,323,405,1547.0,82,5.31,60,363,2326,9.4,0.38074574
6835,6835,Darryl Sydor,2004-05,32.0,14,22,80,80,3,19,22,122.0,1665.0,943,85,342,427,1669.0,82,5.14,57,348,2300,9.2,0.31790045
6836,6836,Darryl Sydor,2006-07,34.0,15,23,80,80,4,19,23,64.0,1527.0,1023,89,361,450,1733.0,82,6.05,85,480,2458,10.1,0.18943575
6837,6837,Darryl Sydor,2007-08,35.0,16,21,74,74,5,16,21,75.0,1491.0,1097,94,377,471,1808.0,82,5.76,70,398,2426,9.7,0.22990495
6838,6838,Darryl Sydor,2008-09,36.0,17,13,74,74,1,12,13,59.0,1299.0,1171,95,389,484,1867.0,82,5.44,62,351,2383,9.4,0.16335103
6839,6839,Darryl Sydor,2009-10,37.0,18,15,73,73,3,12,15,73.0,1330.0,1244,98,401,499,1940.0,82,5.7,65,341,2477,9.4,0.21583405
6840,6840,Darryl Sydor,2010-11,38.0,19,8,47,47,0,8,8,26.0,785.0,1291,98,409,507,1966.0,82,5.53,56,304,2486,9.1,0.16468161
6841,6841,Darryl Williams,1993-94,25.0,2,0,2,2,0,0,0,1.0,,2,0,0,0,1.0,84,7.25,87,443,2603,11.7,0.19729981
6842,6842,Darwin McCutcheon,1982-83,20.0,2,0,1,1,0,0,0,0.0,,1,0,0,0,0.0,80,8.03,73,320,2489,12.9,0.27148372
6843,6843,Daryl Evans,1982-83,22.0,2,8,14,14,2,6,8,25.0,,14,2,6,8,25.0,80,8.03,73,320,2489,12.9,0.39676195
6844,6844,Daryl Evans,1983-84,23.0,3,40,80,80,18,22,40,243.0,,94,20,28,48,268.0,80,7.73,71,310,2444,12.7,0.5587215
6845,6845,Daryl Evans,1984-85,24.0,4,1,4,4,0,1,1,6.0,,98,20,29,49,274.0,80,7.89,74,336,2448,12.9,0.29103193
6846,6846,Daryl Evans,1985-86,25.0,5,1,7,7,1,0,1,13.0,,105,21,29,50,287.0,80,7.77,71,321,2447,12.7,0.28151727
6847,6847,Daryl Evans,1986-87,26.0,6,1,6,6,0,1,1,14.0,,111,21,30,51,301.0,80,7.94,82,370,2484,12.8,0.29535097
6848,6848,Daryl Evans,1987-88,27.0,7,1,2,2,1,0,1,2.0,,113,22,30,52,303.0,80,7.34,72,344,2400,12.2,0.25237292
6849,6849,Daryl Stanley,1984-85,22.0,2,5,23,23,1,4,5,14.0,,23,1,4,5,14.0,80,7.89,74,336,2448,12.9,0.23062286
6850,6850,Daryl Stanley,1986-87,24.0,3,2,33,33,0,2,2,7.0,,56,1,6,7,21.0,80,7.94,82,370,2484,12.8,0.14268908
6851,6851,Daryl Stanley,1987-88,25.0,4,3,33,33,1,2,3,20.0,,89,2,8,10,41.0,80,7.34,72,344,2400,12.2,0.18165416
6852,6852,Daryl Stanley,1988-89,26.0,5,9,57,57,2,7,9,27.0,,146,4,15,19,68.0,80,7.43,89,437,2435,12.2,0.14432824
6853,6853,Daryl Stanley,1989-90,27.0,6,4,20,20,3,1,4,12.0,,166,7,16,23,80.0,80,7.48,85,403,2430,12.3,0.21110475
6854,6854,Daryl Stanley,1990-91,28.0,7,2,23,23,1,1,2,7.0,,189,8,17,25,87.0,80,7.37,76,367,2421,12.2,0.14221784
6855,6855,Dave Allison,1984-85,25.0,2,0,3,3,0,0,0,2.0,,3,0,0,0,2.0,80,7.89,74,336,2448,12.9,0.21756122
6856,6856,Dave Andreychuk,1983-84,20.0,2,37,43,43,14,23,37,65.0,,43,14,23,37,65.0,80,7.73,71,310,2444,12.7,0.6971923
6857,6857,Dave Andreychuk,1984-85,21.0,3,80,78,78,38,42,80,179.0,,121,52,65,117,244.0,80,7.89,74,336,2448,12.9,0.97291446
6858,6858,Dave Andreychuk,1985-86,22.0,4,61,64,64,31,30,61,153.0,,185,83,95,178,397.0,80,7.77,71,321,2447,12.7,0.9374317
6859,6859,Dave Andreychuk,1986-87,23.0,5,87,80,80,36,51,87,226.0,,265,119,146,265,623.0,80,7.94,82,370,2484,12.8,0.9765599
6860,6860,Dave Andreychuk,1987-88,24.0,6,73,77,77,25,48,73,254.0,,342,144,194,338,877.0,80,7.34,72,344,2400,12.2,0.9949651
6861,6861,Dave Andreychuk,1988-89,25.0,7,78,80,80,30,48,78,253.0,,422,174,242,416,1130.0,80,7.43,89,437,2435,12.2,0.9460657
6862,6862,Dave Andreychuk,1989-90,26.0,8,52,56,56,28,24,52,145.0,,478,202,266,468,1275.0,80,7.48,85,403,2430,12.3,0.9941952
6863,6863,Dave Andreychuk,1990-91,27.0,9,82,73,73,40,42,82,206.0,,551,242,308,550,1481.0,80,7.37,76,367,2421,12.2,0.9411598
6864,6864,Dave Andreychuk,1991-92,28.0,10,69,80,80,36,33,69,234.0,,631,278,341,619,1715.0,80,6.91,71,366,2385,11.6,0.8511093
6865,6865,Dave Andreychuk,1992-93,29.0,11,91,80,80,41,50,91,337.0,,711,319,391,710,2052.0,80,6.96,77,402,2440,11.4,1.123893
6866,6866,Dave Andreychuk,1993-94,30.0,12,99,83,83,54,45,99,310.0,,794,373,436,809,2362.0,84,7.25,87,443,2603,11.7,0.9774424
6867,6867,Dave Andreychuk,1994-95,31.0,13,99,83,83,53,46,99,333.0,,877,426,482,908,2695.0,84,6.48,76,407,2545,10.7,0.96168125
6868,6868,Dave Andreychuk,1995-96,32.0,14,38,48,48,22,16,38,168.0,,925,448,498,946,2863.0,48,5.97,37,209,1408,10.2,0.8216015
6869,6869,Dave Andreychuk,1996-97,33.0,15,57,76,76,28,29,57,241.0,,1001,476,527,1003,3104.0,82,6.29,74,413,2481,10.4,0.7091475
6870,6870,Dave Andreychuk,1997-98,34.0,16,61,82,82,27,34,61,233.0,,1083,503,561,1064,3337.0,82,5.83,55,336,2444,9.8,0.6902986
6871,6871,Dave Andreychuk,1998-99,35.0,17,48,75,75,14,34,48,180.0,,1158,517,595,1112,3517.0,82,5.28,57,380,2242,9.6,0.62032837
6872,6872,Dave Andreychuk,1999-00,36.0,18,28,52,52,15,13,28,110.0,808.0,1210,532,608,1140,3627.0,82,5.27,57,359,2285,9.4,0.58884704
6873,6873,Dave Andreychuk,2000-01,37.0,19,36,77,77,20,16,36,233.0,1491.0,1287,552,624,1176,3860.0,82,5.49,53,331,2294,9.8,0.47377855
6874,6874,Dave Andreychuk,2001-02,38.0,20,33,74,74,20,13,33,119.0,887.0,1361,572,637,1209,3979.0,82,5.51,63,376,2272,9.9,0.3913675
6875,6875,Dave Andreychuk,2002-03,39.0,21,38,82,82,21,17,38,161.0,1347.0,1443,593,654,1247,4140.0,82,5.24,53,338,2262,9.5,0.49645194
6876,6876,Dave Andreychuk,2003-04,40.0,22,34,72,72,20,14,34,170.0,1184.0,1515,613,668,1281,4310.0,82,5.31,60,363,2326,9.4,0.47154406
6877,6877,Dave Andreychuk,2004-05,41.0,23,39,82,82,21,18,39,165.0,1403.0,1597,634,686,1320,4475.0,82,5.14,57,348,2300,9.2,0.4684924
6878,6878,Dave Andreychuk,2006-07,43.0,24,18,42,42,6,12,18,81.0,564.0,1639,640,698,1338,4556.0,82,6.05,85,480,2458,10.1,0.39795706
6879,6879,Dave Archibald,1988-89,19.0,2,33,78,78,13,20,33,96.0,,78,13,20,33,96.0,80,7.43,89,437,2435,12.2,0.55381775
6880,6880,Dave Archibald,1989-90,20.0,3,33,72,72,14,19,33,105.0,,150,27,39,66,201.0,80,7.48,85,403,2430,12.3,0.53507483
6881,6881,Dave Archibald,1990-91,21.0,4,11,31,31,3,8,11,56.0,,181,30,47,77,257.0,80,7.37,76,367,2421,12.2,0.43427896
6882,6882,Dave Archibald,1993-94,24.0,5,15,44,44,9,6,15,93.0,,225,39,53,92,350.0,84,7.25,87,443,2603,11.7,0.42799664
6883,6883,Dave Archibald,1994-95,25.0,6,18,33,33,10,8,18,65.0,,258,49,61,110,415.0,84,6.48,76,407,2545,10.7,0.40929532
6884,6884,Dave Archibald,1995-96,26.0,7,4,14,14,2,2,4,27.0,,272,51,63,114,442.0,48,5.97,37,209,1408,10.2,0.34366202
6885,6885,Dave Archibald,1996-97,27.0,8,10,44,44,6,4,10,56.0,,316,57,67,124,498.0,82,6.29,74,413,2481,10.4,0.25707227
6886,6886,Dave Archibald,1997-98,28.0,9,0,7,7,0,0,0,4.0,,323,57,67,124,502.0,82,5.83,55,336,2444,9.8,0.26129013
6887,6887,Dave Babych,1981-82,20.0,2,44,69,69,6,38,44,209.0,,69,6,38,44,209.0,80,7.69,77,340,2441,12.6,0.72635424
6888,6888,Dave Babych,1982-83,21.0,3,68,79,79,19,49,68,262.0,,148,25,87,112,471.0,80,8.03,73,320,2489,12.9,0.8735261
6889,6889,Dave Babych,1983-84,22.0,4,74,79,79,13,61,74,252.0,,227,38,148,186,723.0,80,7.73,71,310,2444,12.7,0.9423454
6890,6890,Dave Babych,1984-85,23.0,5,57,66,66,18,39,57,233.0,,293,56,187,243,956.0,80,7.89,74,336,2448,12.9,0.8304505
6891,6891,Dave Babych,1985-86,24.0,6,62,78,78,13,49,62,240.0,,371,69,236,305,1196.0,80,7.77,71,321,2447,12.7,0.83364636
6892,6892,Dave Babych,1986-87,25.0,7,69,81,81,14,55,69,205.0,,452,83,291,374,1401.0,80,7.94,82,370,2484,12.8,0.80093086
6893,6893,Dave Babych,1987-88,26.0,8,41,66,66,8,33,41,157.0,,518,91,324,415,1558.0,80,7.34,72,344,2400,12.2,0.6651265
6894,6894,Dave Babych,1988-89,27.0,9,50,71,71,14,36,50,233.0,,589,105,360,465,1791.0,80,7.43,89,437,2435,12.2,0.707615
6895,6895,Dave Babych,1989-90,28.0,10,47,70,70,6,41,47,172.0,,659,111,401,512,1963.0,80,7.48,85,403,2430,12.3,0.66273284
6896,6896,Dave Babych,1990-91,29.0,11,43,72,72,6,37,43,164.0,,731,117,438,555,2127.0,80,7.37,76,367,2421,12.2,0.5683622
6897,6897,Dave Babych,1991-92,30.0,12,6,8,8,0,6,6,15.0,,739,117,444,561,2142.0,80,6.91,71,366,2385,11.6,0.4741596
6898,6898,Dave Babych,1992-93,31.0,13,29,75,75,5,24,29,148.0,,814,122,468,590,2290.0,80,6.96,77,402,2440,11.4,0.40363044
6899,6899,Dave Babych,1993-94,32.0,14,19,43,43,3,16,19,78.0,,857,125,484,609,2368.0,84,7.25,87,443,2603,11.7,0.3995617
6900,6900,Dave Babych,1994-95,33.0,15,32,73,73,4,28,32,96.0,,930,129,512,641,2464.0,84,6.48,76,407,2545,10.7,0.33820125
6901,6901,Dave Babych,1995-96,34.0,16,14,40,40,3,11,14,58.0,,970,132,523,655,2522.0,48,5.97,37,209,1408,10.2,0.32490718
6902,6902,Dave Babych,1996-97,35.0,17,24,53,53,3,21,24,69.0,,1023,135,544,679,2591.0,82,6.29,74,413,2481,10.4,0.3401876
6903,6903,Dave Babych,1997-98,36.0,18,27,78,78,5,22,27,105.0,,1101,140,566,706,2696.0,82,5.83,55,336,2444,9.8,0.2993165
6904,6904,Dave Babych,1998-99,37.0,19,9,53,53,0,9,9,46.0,,1154,140,575,715,2742.0,82,5.28,57,380,2242,9.6,0.20258489
6905,6905,Dave Babych,1999-00,38.0,20,8,41,41,2,6,8,49.0,728.0,1195,142,581,723,2791.0,82,5.27,57,359,2285,9.4,0.22899291
6906,6906,Dave Barr,1982-83,22.0,2,0,2,2,0,0,0,1.0,,2,0,0,0,1.0,80,8.03,73,320,2489,12.9,0.22839698
6907,6907,Dave Barr,1983-84,23.0,3,2,10,10,1,1,2,11.0,,12,1,1,2,12.0,80,7.73,71,310,2444,12.7,0.25399405
6908,6908,Dave Barr,1984-85,24.0,4,0,7,7,0,0,0,9.0,,19,1,1,2,21.0,80,7.89,74,336,2448,12.9,0.2035363
6909,6909,Dave Barr,1985-86,25.0,5,34,75,75,16,18,34,75.0,,94,17,19,36,96.0,80,7.77,71,321,2447,12.7,0.43754452
6910,6910,Dave Barr,1986-87,26.0,6,51,72,72,13,38,51,107.0,,166,30,57,87,203.0,80,7.94,82,370,2484,12.8,0.56043035
6911,6911,Dave Barr,1987-88,27.0,7,32,69,69,15,17,32,83.0,,235,45,74,119,286.0,80,7.34,72,344,2400,12.2,0.44290045
6912,6912,Dave Barr,1988-89,28.0,8,40,51,51,14,26,40,64.0,,286,59,100,159,350.0,80,7.43,89,437,2435,12.2,0.60648036
6913,6913,Dave Barr,1989-90,29.0,9,59,73,73,27,32,59,140.0,,359,86,132,218,490.0,80,7.48,85,403,2430,12.3,0.7007925
6914,6914,Dave Barr,1990-91,30.0,10,35,62,62,10,25,35,96.0,,421,96,157,253,586.0,80,7.37,76,367,2421,12.2,0.44440472
6915,6915,Dave Barr,1991-92,31.0,11,40,70,70,18,22,40,98.0,,491,114,179,293,684.0,80,6.91,71,366,2385,11.6,0.48957273
6916,6916,Dave Barr,1992-93,32.0,12,18,41,41,6,12,18,49.0,,532,120,191,311,733.0,80,6.96,77,402,2440,11.4,0.4025294
6917,6917,Dave Barr,1993-94,33.0,13,14,62,62,6,8,14,41.0,,594,126,199,325,774.0,84,7.25,87,443,2603,11.7,0.20453903
6918,6918,Dave Barr,1994-95,34.0,14,7,20,20,2,5,7,20.0,,614,128,204,332,794.0,84,6.48,76,407,2545,10.7,0.24611518
6919,6919,Dave Bolland,2007-08,21.0,2,0,1,1,0,0,0,1.0,11.0,1,0,0,0,1.0,82,5.76,70,398,2426,9.7,0.19067428
6920,6920,Dave Bolland,2008-09,22.0,3,17,39,39,4,13,17,49.0,535.0,40,4,13,17,50.0,82,5.44,62,351,2383,9.4,0.36312187
6921,6921,Dave Bolland,2009-10,23.0,4,47,81,81,19,28,47,111.0,1333.0,121,23,41,64,161.0,82,5.7,65,341,2477,9.4,0.56696
6922,6922,Dave Bolland,2010-11,24.0,5,16,39,39,6,10,16,52.0,677.0,160,29,51,80,213.0,82,5.53,56,304,2486,9.1,0.39882907
6923,6923,Dave Bolland,2011-12,25.0,6,37,61,61,15,22,37,102.0,1076.0,221,44,73,117,315.0,82,5.46,52,291,2492,9.0,0.5131831
6924,6924,Dave Bolland,2012-13,26.0,7,37,76,76,19,18,37,126.0,1254.0,297,63,91,154,441.0,82,5.32,47,271,2439,8.9,0.45819303
6925,6925,Dave Bolland,2013-14,27.0,8,14,35,35,7,7,14,46.0,572.0,332,70,98,168,487.0,48,5.31,29,160,1399,9.1,0.4325692
6926,6926,Dave Bolland,2014-15,28.0,9,12,23,23,8,4,12,33.0,333.0,355,78,102,180,520.0,82,5.34,48,269,2463,8.9,0.4541331
6927,6927,Dave Bolland,2015-16,29.0,10,23,53,53,6,17,23,76.0,867.0,408,84,119,203,596.0,82,5.32,47,251,2453,8.9,0.39097708
6928,6928,Dave Bolland,2016-17,30.0,11,5,25,25,1,4,5,26.0,352.0,433,85,123,208,622.0,82,5.34,48,255,2438,9.0,0.2590865
6929,6929,Dave Brown,1983-84,21.0,2,0,2,2,0,0,0,2.0,,2,0,0,0,2.0,80,7.73,71,310,2444,12.7,0.24407983
6930,6930,Dave Brown,1984-85,22.0,3,6,19,19,1,5,6,9.0,,21,1,5,6,11.0,80,7.89,74,336,2448,12.9,0.2226223
6931,6931,Dave Brown,1985-86,23.0,4,9,57,57,3,6,9,53.0,,78,4,11,15,64.0,80,7.77,71,321,2447,12.7,0.20902953
6932,6932,Dave Brown,1986-87,24.0,5,17,76,76,10,7,17,74.0,,154,14,18,32,138.0,80,7.94,82,370,2484,12.8,0.24674335
6933,6933,Dave Brown,1987-88,25.0,6,10,62,62,7,3,10,53.0,,216,21,21,42,191.0,80,7.34,72,344,2400,12.2,0.24818802
6934,6934,Dave Brown,1988-89,26.0,7,17,47,47,12,5,17,41.0,,263,33,26,59,232.0,80,7.43,89,437,2435,12.2,0.31047058
6935,6935,Dave Brown,1989-90,27.0,8,5,72,72,0,5,5,42.0,,335,33,31,64,274.0,80,7.48,85,403,2430,12.3,0.14730579
6936,6936,Dave Brown,1990-91,28.0,9,6,60,60,0,6,6,32.0,,395,33,37,70,306.0,80,7.37,76,367,2421,12.2,0.15727055
6937,6937,Dave Brown,1991-92,29.0,10,7,58,58,3,4,7,32.0,,453,36,41,77,338.0,80,6.91,71,366,2385,11.6,0.13392344
6938,6938,Dave Brown,1992-93,30.0,11,6,70,70,4,2,6,50.0,,523,40,43,83,388.0,80,6.96,77,402,2440,11.4,0.14062959
6939,6939,Dave Brown,1993-94,31.0,12,2,70,70,0,2,2,19.0,,593,40,45,85,407.0,84,7.25,87,443,2603,11.7,0.07104772
6940,6940,Dave Brown,1994-95,32.0,13,5,71,71,1,4,5,16.0,,664,41,49,90,423.0,84,6.48,76,407,2545,10.7,0.081606984
6941,6941,Dave Brown,1995-96,33.0,14,3,28,28,1,2,3,8.0,,692,42,51,93,431.0,48,5.97,37,209,1408,10.2,0.09858945
6942,6942,Dave Brown,1996-97,34.0,15,4,37,37,3,1,4,8.0,,729,45,52,97,439.0,82,6.29,74,413,2481,10.4,0.11840874
6943,6943,Dave Cameron,1982-83,24.0,2,23,66,66,11,12,23,65.0,,66,11,12,23,65.0,80,8.03,73,320,2489,12.9,0.33337432
6944,6944,Dave Cameron,1983-84,25.0,3,9,35,35,5,4,9,31.0,,101,16,16,32,96.0,80,7.73,71,310,2444,12.7,0.30661115
6945,6945,Dave Cameron,1984-85,26.0,4,21,67,67,9,12,21,79.0,,168,25,28,53,175.0,80,7.89,74,336,2448,12.9,0.31676105
6946,6946,Dave Capuano,1990-91,22.0,2,8,33,33,3,5,8,26.0,,33,3,5,8,26.0,80,7.37,76,367,2421,12.2,0.30811802
6947,6947,Dave Capuano,1991-92,23.0,3,44,61,61,13,31,44,77.0,,94,16,36,52,103.0,80,6.91,71,366,2385,11.6,0.5797281
6948,6948,Dave Capuano,1993-94,25.0,4,2,6,6,1,1,2,10.0,,100,17,37,54,113.0,84,7.25,87,443,2603,11.7,0.28250045
6949,6949,Dave Capuano,1994-95,26.0,5,1,4,4,0,1,1,5.0,,104,17,38,55,118.0,84,6.48,76,407,2545,10.7,0.2287586
6950,6950,Dave Chartier,1981-82,20.0,2,0,1,1,0,0,0,0.0,,1,0,0,0,0.0,80,7.69,77,340,2441,12.6,0.2619771
6951,6951,Dave Christian,1980-81,21.0,2,18,15,15,8,10,18,34.0,,15,8,10,18,34.0,80,7.03,61,280,2352,12.0,0.80682164
6952,6952,Dave Christian,1981-82,22.0,3,71,80,80,28,43,71,185.0,,95,36,53,89,219.0,80,7.69,77,340,2441,12.6,0.9239768
6953,6953,Dave Christian,1982-83,23.0,4,76,80,80,25,51,76,218.0,,175,61,104,165,437.0,80,8.03,73,320,2489,12.9,0.90650403
6954,6954,Dave Christian,1983-84,24.0,5,44,55,55,18,26,44,133.0,,230,79,130,209,570.0,80,7.73,71,310,2444,12.7,0.8204088
6955,6955,Dave Christian,1984-85,25.0,6,81,80,80,29,52,81,164.0,,310,108,182,290,734.0,80,7.89,74,336,2448,12.9,0.902159
6956,6956,Dave Christian,1985-86,26.0,7,69,80,80,26,43,69,152.0,,390,134,225,359,886.0,80,7.77,71,321,2447,12.7,0.88482964
6957,6957,Dave Christian,1986-87,27.0,8,83,80,80,41,42,83,218.0,,470,175,267,442,1104.0,80,7.94,82,370,2484,12.8,0.88785285
6958,6958,Dave Christian,1987-88,28.0,9,50,76,76,23,27,50,150.0,,546,198,294,492,1254.0,80,7.34,72,344,2400,12.2,0.68654275
6959,6959,Dave Christian,1988-89,29.0,10,58,80,80,37,21,58,187.0,,626,235,315,550,1441.0,80,7.43,89,437,2435,12.2,0.7400191
6960,6960,Dave Christian,1989-90,30.0,11,65,80,80,34,31,65,177.0,,706,269,346,615,1618.0,80,7.48,85,403,2430,12.3,0.73831034
6961,6961,Dave Christian,1990-91,31.0,12,40,78,78,15,25,40,153.0,,784,284,371,655,1771.0,80,7.37,76,367,2421,12.2,0.5411599
6962,6962,Dave Christian,1991-92,32.0,13,53,78,78,32,21,53,173.0,,862,316,392,708,1944.0,80,6.91,71,366,2385,11.6,0.64998484
6963,6963,Dave Christian,1992-93,33.0,14,44,78,78,20,24,44,142.0,,940,336,416,752,2086.0,80,6.96,77,402,2440,11.4,0.51998997
6964,6964,Dave Christian,1993-94,34.0,15,18,60,60,4,14,18,75.0,,1000,340,430,770,2161.0,84,7.25,87,443,2603,11.7,0.2877866
6965,6965,Dave Christian,1994-95,35.0,16,3,9,9,0,3,3,6.0,,1009,340,433,773,2167.0,84,6.48,76,407,2545,10.7,0.32588023
6966,6966,Dave Chyzowski,1990-91,19.0,2,14,34,34,8,6,14,59.0,,34,8,6,14,59.0,80,7.37,76,367,2421,12.2,0.4054183
6967,6967,Dave Chyzowski,1991-92,20.0,3,14,56,56,5,9,14,66.0,,90,13,15,28,125.0,80,6.91,71,366,2385,11.6,0.32112673
6968,6968,Dave Chyzowski,1992-93,21.0,4,2,12,12,1,1,2,18.0,,102,14,16,30,143.0,80,6.96,77,402,2440,11.4,0.40742952
6969,6969,Dave Chyzowski,1994-95,23.0,5,1,3,3,1,0,1,4.0,,105,15,16,31,147.0,84,6.48,76,407,2545,10.7,0.26670337
6970,6970,Dave Chyzowski,1995-96,24.0,6,0,13,13,0,0,0,11.0,,118,15,16,31,158.0,48,5.97,37,209,1408,10.2,0.20443207
6971,6971,Dave Chyzowski,1997-98,26.0,7,0,8,8,0,0,0,6.0,,126,15,16,31,164.0,82,5.83,55,336,2444,9.8,0.14447814
6972,6972,Dave Debol,1980-81,24.0,2,26,48,48,12,14,26,96.0,,48,12,14,26,96.0,80,7.03,61,280,2352,12.0,0.506756
6973,6973,Dave Debol,1981-82,25.0,3,26,44,44,14,12,26,70.0,,92,26,26,52,166.0,80,7.69,77,340,2441,12.6,0.51610905
6974,6974,Dave Donnelly,1984-85,22.0,2,7,16,16,3,4,7,22.0,,16,3,4,7,22.0,80,7.89,74,336,2448,12.9,0.38524756
6975,6975,Dave Donnelly,1985-86,23.0,3,14,38,38,6,8,14,33.0,,54,9,12,21,55.0,80,7.77,71,321,2447,12.7,0.33182055
6976,6976,Dave Donnelly,1986-87,24.0,4,0,8,8,0,0,0,8.0,,62,9,12,21,63.0,80,7.94,82,370,2484,12.8,0.2046963
6977,6977,Dave Donnelly,1987-88,25.0,5,18,71,71,6,12,18,64.0,,133,15,24,39,127.0,80,7.34,72,344,2400,12.2,0.27030435
6978,6978,Dave Donnelly,1988-89,26.0,6,0,4,4,0,0,0,3.0,,137,15,24,39,130.0,80,7.43,89,437,2435,12.2,0.22892839
6979,6979,Dave Duerden,2000-01,23.0,2,0,2,2,0,0,0,1.0,3.0,2,0,0,0,1.0,82,5.49,53,331,2294,9.8,0.17198798
6980,6980,Dave Ellett,1985-86,21.0,2,38,80,80,11,27,38,152.0,,80,11,27,38,152.0,80,7.77,71,321,2447,12.7,0.54540324
6981,6981,Dave Ellett,1986-87,22.0,3,46,80,80,15,31,46,167.0,,160,26,58,84,319.0,80,7.94,82,370,2484,12.8,0.6031337
6982,6982,Dave Ellett,1987-88,23.0,4,44,78,78,13,31,44,159.0,,238,39,89,128,478.0,80,7.34,72,344,2400,12.2,0.62459147
6983,6983,Dave Ellett,1988-89,24.0,5,58,68,68,13,45,58,198.0,,306,52,134,186,676.0,80,7.43,89,437,2435,12.2,0.8109097
6984,6984,Dave Ellett,1989-90,25.0,6,56,75,75,22,34,56,209.0,,381,74,168,242,885.0,80,7.48,85,403,2430,12.3,0.72384876
6985,6985,Dave Ellett,1990-91,26.0,7,46,77,77,17,29,46,205.0,,458,91,197,288,1090.0,80,7.37,76,367,2421,12.2,0.6554712
6986,6986,Dave Ellett,1991-92,27.0,8,49,77,77,12,37,49,195.0,,535,103,234,337,1285.0,80,6.91,71,366,2385,11.6,0.64346874
6987,6987,Dave Ellett,1992-93,28.0,9,51,79,79,18,33,51,225.0,,614,121,267,388,1510.0,80,6.96,77,402,2440,11.4,0.6278399
6988,6988,Dave Ellett,1993-94,29.0,10,40,70,70,6,34,40,186.0,,684,127,301,428,1696.0,84,7.25,87,443,2603,11.7,0.5397757
6989,6989,Dave Ellett,1994-95,30.0,11,43,68,68,7,36,43,146.0,,752,134,337,471,1842.0,84,6.48,76,407,2545,10.7,0.5367042
6990,6990,Dave Ellett,1995-96,31.0,12,15,33,33,5,10,15,84.0,,785,139,347,486,1926.0,48,5.97,37,209,1408,10.2,0.44235373
6991,6991,Dave Ellett,1996-97,32.0,13,22,80,80,3,19,22,153.0,,865,142,366,508,2079.0,82,6.29,74,413,2481,10.4,0.28266585
6992,6992,Dave Ellett,1997-98,33.0,14,21,76,76,6,15,21,105.0,,941,148,381,529,2184.0,82,5.83,55,336,2444,9.8,0.28534925
6993,6993,Dave Ellett,1998-99,34.0,15,23,82,82,3,20,23,129.0,,1023,151,401,552,2313.0,82,5.28,57,380,2242,9.6,0.24793938
6994,6994,Dave Ellett,1999-00,35.0,16,6,54,54,0,6,6,45.0,799.0,1077,151,407,558,2358.0,82,5.27,57,359,2285,9.4,0.18348318
6995,6995,Dave Ellett,2000-01,36.0,17,10,52,52,2,8,10,41.0,701.0,1129,153,415,568,2399.0,82,5.49,53,331,2294,9.8,0.19734132
6996,6996,Dave Feamster,1982-83,24.0,2,2,29,29,0,2,2,25.0,,29,0,2,2,25.0,80,8.03,73,320,2489,12.9,0.21778288
6997,6997,Dave Feamster,1983-84,25.0,3,18,78,78,6,12,18,64.0,,107,6,14,20,89.0,80,7.73,71,310,2444,12.7,0.2777115
6998,6998,Dave Feamster,1984-85,26.0,4,13,46,46,6,7,13,44.0,,153,12,21,33,133.0,80,7.89,74,336,2448,12.9,0.30851197
6999,6999,Dave Feamster,1985-86,27.0,5,4,16,16,1,3,4,10.0,,169,13,24,37,143.0,80,7.77,71,321,2447,12.7,0.21592942
7000,7000,Dave Gagner,1985-86,21.0,2,12,38,38,6,6,12,52.0,,38,6,6,12,52.0,80,7.77,71,321,2447,12.7,0.36291993
7001,7001,Dave Gagner,1986-87,22.0,3,10,32,32,4,6,10,41.0,,70,10,12,22,93.0,80,7.94,82,370,2484,12.8,0.36137763
7002,7002,Dave Gagner,1987-88,23.0,4,5,10,10,1,4,5,16.0,,80,11,16,27,109.0,80,7.34,72,344,2400,12.2,0.34971255
7003,7003,Dave Gagner,1988-89,24.0,5,19,51,51,8,11,19,87.0,,131,19,27,46,196.0,80,7.43,89,437,2435,12.2,0.42423612
7004,7004,Dave Gagner,1989-90,25.0,6,78,75,75,35,43,78,183.0,,206,54,70,124,379.0,80,7.48,85,403,2430,12.3,0.87280583
7005,7005,Dave Gagner,1990-91,26.0,7,78,79,79,40,38,78,238.0,,285,94,108,202,617.0,80,7.37,76,367,2421,12.2,0.91747606
7006,7006,Dave Gagner,1991-92,27.0,8,82,73,73,40,42,82,223.0,,358,134,150,284,840.0,80,6.91,71,366,2385,11.6,0.9188597
7007,7007,Dave Gagner,1992-93,28.0,9,71,78,78,31,40,71,229.0,,436,165,190,355,1069.0,80,6.96,77,402,2440,11.4,0.85513604
7008,7008,Dave Gagner,1993-94,29.0,10,76,84,84,33,43,76,230.0,,520,198,233,431,1299.0,84,7.25,87,443,2603,11.7,0.7956182
7009,7009,Dave Gagner,1994-95,30.0,11,61,76,76,32,29,61,213.0,,596,230,262,492,1512.0,84,6.48,76,407,2545,10.7,0.67127204
7010,7010,Dave Gagner,1995-96,31.0,12,42,48,48,14,28,42,138.0,,644,244,290,534,1650.0,48,5.97,37,209,1408,10.2,0.81383073
7011,7011,Dave Gagner,1996-97,32.0,13,49,73,73,21,28,49,215.0,,717,265,318,583,1865.0,82,6.29,74,413,2481,10.4,0.62739164
7012,7012,Dave Gagner,1997-98,33.0,14,60,82,82,27,33,60,228.0,,799,292,351,643,2093.0,82,5.83,55,336,2444,9.8,0.6558545
7013,7013,Dave Gagner,1998-99,34.0,15,48,78,78,20,28,48,165.0,,877,312,379,691,2258.0,82,5.28,57,380,2242,9.6,0.5278165
7014,7014,Dave Gagner,1999-00,35.0,16,28,69,69,6,22,28,100.0,959.0,946,318,401,719,2358.0,82,5.27,57,359,2285,9.4,0.35742825
7015,7015,Dave Gans,1983-84,19.0,2,0,3,3,0,0,0,0.0,,3,0,0,0,0.0,80,7.73,71,310,2444,12.7,0.23934102
7016,7016,Dave Gans,1986-87,22.0,3,0,3,3,0,0,0,3.0,,6,0,0,0,3.0,80,7.94,82,370,2484,12.8,0.21156442
7017,7017,Dave Goertz,1988-89,23.0,2,0,2,2,0,0,0,2.0,,2,0,0,0,2.0,80,7.43,89,437,2435,12.2,0.22999275
7018,7018,Dave Gorman,1980-81,25.0,2,0,3,3,0,0,0,1.0,,3,0,0,0,1.0,80,7.03,61,280,2352,12.0,0.21148184
7019,7019,Dave Hannan,1982-83,21.0,2,0,1,1,0,0,0,0.0,,1,0,0,0,0.0,80,8.03,73,320,2489,12.9,0.22589162
7020,7020,Dave Hannan,1983-84,22.0,3,33,74,74,11,22,33,95.0,,75,11,22,33,95.0,80,7.73,71,310,2444,12.7,0.4668149
7021,7021,Dave Hannan,1984-85,23.0,4,5,24,24,2,3,5,20.0,,99,13,25,38,115.0,80,7.89,74,336,2448,12.9,0.33876073
7022,7022,Dave Hannan,1985-86,24.0,5,13,30,30,6,7,13,38.0,,129,19,32,51,153.0,80,7.77,71,321,2447,12.7,0.39486116
7023,7023,Dave Hannan,1986-87,25.0,6,35,75,75,17,18,35,100.0,,204,36,50,86,253.0,80,7.94,82,370,2484,12.8,0.42102075
7024,7024,Dave Hannan,1987-88,26.0,7,25,58,58,10,15,25,85.0,,262,46,65,111,338.0,80,7.34,72,344,2400,12.2,0.3731758
7025,7025,Dave Hannan,1988-89,27.0,8,27,72,72,13,14,27,96.0,,334,59,79,138,434.0,80,7.43,89,437,2435,12.2,0.34729004
7026,7026,Dave Hannan,1989-90,28.0,9,30,72,72,10,20,30,72.0,,406,69,99,168,506.0,80,7.48,85,403,2430,12.3,0.3951803
7027,7027,Dave Hannan,1990-91,29.0,10,15,39,39,6,9,15,39.0,,445,75,108,183,545.0,80,7.37,76,367,2421,12.2,0.35690248
7028,7028,Dave Hannan,1991-92,30.0,11,34,74,74,11,23,34,72.0,,519,86,131,217,617.0,80,6.91,71,366,2385,11.6,0.36867058
7029,7029,Dave Hannan,1992-93,31.0,12,10,47,47,4,6,10,32.0,,566,90,137,227,649.0,80,6.96,77,402,2440,11.4,0.26069677
7030,7030,Dave Hannan,1993-94,32.0,13,20,55,55,5,15,20,43.0,,621,95,152,247,692.0,84,7.25,87,443,2603,11.7,0.29124314
7031,7031,Dave Hannan,1994-95,33.0,14,21,83,83,6,15,21,40.0,,704,101,167,268,732.0,84,6.48,76,407,2545,10.7,0.21810064
7032,7032,Dave Hannan,1995-96,34.0,15,16,42,42,4,12,16,36.0,,746,105,179,284,768.0,48,5.97,37,209,1408,10.2,0.29985905
7033,7033,Dave Hannan,1996-97,35.0,16,17,61,61,7,10,17,41.0,,807,112,189,301,809.0,82,6.29,74,413,2481,10.4,0.21513009
7034,7034,Dave Hannan,1997-98,36.0,17,4,34,34,2,2,4,16.0,,841,114,191,305,825.0,82,5.83,55,336,2444,9.8,0.15656367
7035,7035,Dave Hindmarch,1981-82,23.0,2,1,1,1,1,0,1,1.0,,1,1,0,1,1.0,80,7.69,77,340,2441,12.6,0.27675617
7036,7036,Dave Hindmarch,1982-83,24.0,3,3,9,9,3,0,3,10.0,,10,4,0,4,11.0,80,8.03,73,320,2489,12.9,0.31277674
7037,7037,Dave Hindmarch,1983-84,25.0,4,23,60,60,11,12,23,86.0,,70,15,12,27,97.0,80,7.73,71,310,2444,12.7,0.35141706
7038,7038,Dave Hindmarch,1984-85,26.0,5,11,29,29,6,5,11,49.0,,99,21,17,38,146.0,80,7.89,74,336,2448,12.9,0.37787914
7039,7039,Dave Hunter,1980-81,23.0,2,43,80,80,12,31,43,109.0,,80,12,31,43,109.0,80,7.03,61,280,2352,12.0,0.531502
7040,7040,Dave Hunter,1981-82,24.0,3,28,78,78,12,16,28,104.0,,158,24,47,71,213.0,80,7.69,77,340,2441,12.6,0.42508596
7041,7041,Dave Hunter,1982-83,25.0,4,38,63,63,16,22,38,124.0,,221,40,69,109,337.0,80,8.03,73,320,2489,12.9,0.55734545
7042,7042,Dave Hunter,1983-84,26.0,5,31,80,80,13,18,31,113.0,,301,53,87,140,450.0,80,7.73,71,310,2444,12.7,0.43805498
7043,7043,Dave Hunter,1984-85,27.0,6,48,80,80,22,26,48,118.0,,381,75,113,188,568.0,80,7.89,74,336,2448,12.9,0.56044996
7044,7044,Dave Hunter,1985-86,28.0,7,36,80,80,17,19,36,119.0,,461,92,132,224,687.0,80,7.77,71,321,2447,12.7,0.45899704
7045,7045,Dave Hunter,1986-87,29.0,8,37,62,62,15,22,37,110.0,,523,107,154,261,797.0,80,7.94,82,370,2484,12.8,0.47867268
7046,7046,Dave Hunter,1987-88,30.0,9,15,77,77,6,9,15,86.0,,600,113,163,276,883.0,80,7.34,72,344,2400,12.2,0.305117
7047,7047,Dave Hunter,1988-89,31.0,10,35,80,80,14,21,35,133.0,,680,127,184,311,1016.0,80,7.43,89,437,2435,12.2,0.3941176
7048,7048,Dave Hunter,1989-90,32.0,11,12,66,66,6,6,12,87.0,,746,133,190,323,1103.0,80,7.48,85,403,2430,12.3,0.24428615
7049,7049,Dave Karpa,1992-93,21.0,2,0,4,4,0,0,0,2.0,,4,0,0,0,2.0,80,6.96,77,402,2440,11.4,0.23048055
7050,7050,Dave Karpa,1993-94,22.0,3,1,12,12,0,1,1,2.0,,16,0,1,1,4.0,84,7.25,87,443,2603,11.7,0.18317276
7051,7051,Dave Karpa,1994-95,23.0,4,17,60,60,5,12,17,48.0,,76,5,13,18,52.0,84,6.48,76,407,2545,10.7,0.24622458
7052,7052,Dave Karpa,1995-96,24.0,5,6,28,28,1,5,6,33.0,,104,6,18,24,85.0,48,5.97,37,209,1408,10.2,0.23651126
7053,7053,Dave Karpa,1996-97,25.0,6,19,72,72,3,16,19,62.0,,176,9,34,43,147.0,82,6.29,74,413,2481,10.4,0.22506544
7054,7054,Dave Karpa,1997-98,26.0,7,13,69,69,2,11,13,90.0,,245,11,45,56,237.0,82,5.83,55,336,2444,9.8,0.19434518
7055,7055,Dave Karpa,1998-99,27.0,8,12,78,78,1,11,12,64.0,,323,12,56,68,301.0,82,5.28,57,380,2242,9.6,0.1493558
7056,7056,Dave Karpa,1999-00,28.0,9,2,33,33,0,2,2,21.0,558.0,356,12,58,70,322.0,82,5.27,57,359,2285,9.4,0.16491449
7057,7057,Dave Karpa,2000-01,29.0,10,5,27,27,1,4,5,24.0,469.0,383,13,62,75,346.0,82,5.49,53,331,2294,9.8,0.18816403
7058,7058,Dave Karpa,2001-02,30.0,11,10,80,80,4,6,10,69.0,1601.0,463,17,68,85,415.0,82,5.51,63,376,2272,9.9,0.14960334
7059,7059,Dave Karpa,2002-03,31.0,12,11,75,75,1,10,11,53.0,1267.0,538,18,78,96,468.0,82,5.24,53,338,2262,9.5,0.14921835
7060,7060,Dave Karpa,2003-04,32.0,13,2,19,19,0,2,2,13.0,277.0,557,18,80,98,481.0,82,5.31,60,363,2326,9.4,0.10362381
7061,7061,Dave Langevin,1980-81,26.0,2,16,76,76,3,13,16,82.0,,76,3,13,16,82.0,80,7.03,61,280,2352,12.0,0.25667533
7062,7062,Dave Langevin,1981-82,27.0,3,17,75,75,1,16,17,68.0,,151,4,29,33,150.0,80,7.69,77,340,2441,12.6,0.21158296
7063,7063,Dave Langevin,1982-83,28.0,4,21,73,73,1,20,21,73.0,,224,5,49,54,223.0,80,8.03,73,320,2489,12.9,0.25655752
7064,7064,Dave Langevin,1983-84,29.0,5,21,73,73,4,17,21,107.0,,297,9,66,75,330.0,80,7.73,71,310,2444,12.7,0.28109688
7065,7065,Dave Langevin,1984-85,30.0,6,19,69,69,3,16,19,89.0,,366,12,82,94,419.0,80,7.89,74,336,2448,12.9,0.27713454
7066,7066,Dave Langevin,1985-86,31.0,7,13,56,56,0,13,13,33.0,,422,12,95,107,452.0,80,7.77,71,321,2447,12.7,0.19190183
7067,7067,Dave Langevin,1986-87,32.0,8,8,80,80,0,8,8,46.0,,502,12,103,115,498.0,80,7.94,82,370,2484,12.8,0.18105426
7068,7068,Dave Langevin,1987-88,33.0,9,4,11,11,0,4,4,5.0,,513,12,107,119,503.0,80,7.34,72,344,2400,12.2,0.19302258
7069,7069,Dave Lowry,1986-87,21.0,2,18,73,73,10,8,18,66.0,,73,10,8,18,66.0,80,7.94,82,370,2484,12.8,0.31095153
7070,7070,Dave Lowry,1987-88,22.0,3,18,70,70,8,10,18,74.0,,143,18,18,36,140.0,80,7.34,72,344,2400,12.2,0.35222918
7071,7071,Dave Lowry,1988-89,23.0,4,4,22,22,1,3,4,14.0,,165,19,21,40,154.0,80,7.43,89,437,2435,12.2,0.29454315
7072,7072,Dave Lowry,1989-90,24.0,5,6,21,21,3,3,6,22.0,,186,22,24,46,176.0,80,7.48,85,403,2430,12.3,0.32338342
7073,7073,Dave Lowry,1990-91,25.0,6,25,78,78,19,6,25,98.0,,264,41,30,71,274.0,80,7.37,76,367,2421,12.2,0.36578482
7074,7074,Dave Lowry,1991-92,26.0,7,40,79,79,19,21,40,123.0,,343,60,51,111,397.0,80,6.91,71,366,2385,11.6,0.45554277
7075,7075,Dave Lowry,1992-93,27.0,8,20,75,75,7,13,20,85.0,,418,67,64,131,482.0,80,6.96,77,402,2440,11.4,0.26026285
7076,7076,Dave Lowry,1993-94,28.0,9,13,58,58,5,8,13,59.0,,476,72,72,144,541.0,84,7.25,87,443,2603,11.7,0.27533978
7077,7077,Dave Lowry,1994-95,29.0,10,37,80,80,15,22,37,122.0,,556,87,94,181,663.0,84,6.48,76,407,2545,10.7,0.38945028
7078,7078,Dave Lowry,1995-96,30.0,11,20,45,45,10,10,20,70.0,,601,97,104,201,733.0,48,5.97,37,209,1408,10.2,0.4245939
7079,7079,Dave Lowry,1996-97,31.0,12,24,63,63,10,14,24,83.0,,664,107,118,225,816.0,82,6.29,74,413,2481,10.4,0.2878516
7080,7080,Dave Lowry,1997-98,32.0,13,29,77,77,15,14,29,96.0,,741,122,132,254,912.0,82,5.83,55,336,2444,9.8,0.31262863
7081,7081,Dave Lowry,1998-99,33.0,14,8,57,57,4,4,8,51.0,,798,126,136,262,963.0,82,5.28,57,380,2242,9.6,0.15437824
7082,7082,Dave Lowry,1999-00,34.0,15,15,61,61,6,9,15,58.0,563.0,859,132,145,277,1021.0,82,5.27,57,359,2285,9.4,0.20062962
7083,7083,Dave Lowry,2000-01,35.0,16,5,32,32,1,4,5,25.0,294.0,891,133,149,282,1046.0,82,5.49,53,331,2294,9.8,0.1863698
7084,7084,Dave Lowry,2001-02,36.0,17,35,79,79,18,17,35,108.0,1259.0,970,151,166,317,1154.0,82,5.51,63,376,2272,9.9,0.30434516
7085,7085,Dave Lowry,2002-03,37.0,18,13,62,62,7,6,13,74.0,928.0,1032,158,172,330,1228.0,82,5.24,53,338,2262,9.5,0.18102077
7086,7086,Dave Lowry,2003-04,38.0,19,19,34,34,5,14,19,40.0,486.0,1066,163,186,349,1268.0,82,5.31,60,363,2326,9.4,0.33055222
7087,7087,Dave Lowry,2004-05,39.0,20,2,18,18,1,1,2,9.0,166.0,1084,164,187,351,1277.0,82,5.14,57,348,2300,9.2,0.25419658
7088,7088,Dave Manson,1987-88,21.0,2,9,63,63,1,8,9,41.0,,63,1,8,9,41.0,80,7.34,72,344,2400,12.2,0.25590897
7089,7089,Dave Manson,1988-89,22.0,3,7,54,54,1,6,7,47.0,,117,2,14,16,88.0,80,7.43,89,437,2435,12.2,0.24159917
7090,7090,Dave Manson,1989-90,23.0,4,54,79,79,18,36,54,224.0,,196,20,50,70,312.0,80,7.48,85,403,2430,12.3,0.6722647
7091,7091,Dave Manson,1990-91,24.0,5,28,59,59,5,23,28,126.0,,255,25,73,98,438.0,80,7.37,76,367,2421,12.2,0.47662008
7092,7092,Dave Manson,1991-92,25.0,6,29,75,75,14,15,29,154.0,,330,39,88,127,592.0,80,6.91,71,366,2385,11.6,0.47142965
7093,7093,Dave Manson,1992-93,26.0,7,47,79,79,15,32,47,206.0,,409,54,120,174,798.0,80,6.96,77,402,2440,11.4,0.65467715
7094,7094,Dave Manson,1993-94,27.0,8,45,83,83,15,30,45,244.0,,492,69,150,219,1042.0,84,7.25,87,443,2603,11.7,0.48653615
7095,7095,Dave Manson,1994-95,28.0,9,21,70,70,4,17,21,180.0,,562,73,167,240,1222.0,84,6.48,76,407,2545,10.7,0.3521669
7096,7096,Dave Manson,1995-96,29.0,10,18,44,44,3,15,18,104.0,,606,76,182,258,1326.0,48,5.97,37,209,1408,10.2,0.41809458
7097,7097,Dave Manson,1996-97,30.0,11,30,82,82,7,23,30,189.0,,688,83,205,288,1515.0,82,6.29,74,413,2481,10.4,0.41052872
7098,7098,Dave Manson,1997-98,31.0,12,22,75,75,4,18,22,175.0,,763,87,223,310,1690.0,82,5.83,55,336,2444,9.8,0.3140449
7099,7099,Dave Manson,1998-99,32.0,13,34,81,81,4,30,34,148.0,,844,91,253,344,1838.0,82,5.28,57,380,2242,9.6,0.35841697
7100,7100,Dave Manson,1999-00,33.0,14,23,75,75,6,17,23,145.0,1638.0,919,97,270,367,1983.0,82,5.27,57,359,2285,9.4,0.27731776
7101,7101,Dave Manson,2000-01,34.0,15,10,63,63,1,9,10,66.0,992.0,982,98,279,377,2049.0,82,5.49,53,331,2294,9.8,0.14571491
7102,7102,Dave Manson,2001-02,35.0,16,11,74,74,4,7,11,70.0,1169.0,1056,102,286,388,2119.0,82,5.51,63,376,2272,9.9,0.14403045
7103,7103,Dave Manson,2002-03,36.0,17,2,47,47,0,2,2,36.0,604.0,1103,102,288,390,2155.0,82,5.24,53,338,2262,9.5,0.13143161
7104,7104,Dave Marcinyshyn,1991-92,24.0,2,1,9,9,0,1,1,4.0,,9,0,1,1,4.0,80,6.91,71,366,2385,11.6,0.20638475
7105,7105,Dave Marcinyshyn,1992-93,25.0,3,0,5,5,0,0,0,3.0,,14,0,1,1,7.0,80,6.96,77,402,2440,11.4,0.18764907
7106,7106,Dave Marcinyshyn,1993-94,26.0,4,0,2,2,0,0,0,1.0,,16,0,1,1,8.0,84,7.25,87,443,2603,11.7,0.17839488
7107,7107,Dave McLlwain,1988-89,22.0,2,19,66,66,11,8,19,65.0,,66,11,8,19,65.0,80,7.43,89,437,2435,12.2,0.30769226
7108,7108,Dave McLlwain,1989-90,23.0,3,3,24,24,1,2,3,14.0,,90,12,10,22,79.0,80,7.48,85,403,2430,12.3,0.2851468
7109,7109,Dave McLlwain,1990-91,24.0,4,51,80,80,25,26,51,180.0,,170,37,36,73,259.0,80,7.37,76,367,2421,12.2,0.6257047
7110,7110,Dave McLlwain,1991-92,25.0,5,25,60,60,14,11,25,104.0,,230,51,47,98,363.0,80,6.91,71,366,2385,11.6,0.45787716
7111,7111,Dave McLlwain,1992-93,26.0,6,28,73,73,10,18,28,91.0,,303,61,65,126,454.0,80,6.96,77,402,2440,11.4,0.34939694
7112,7112,Dave McLlwain,1993-94,27.0,7,18,66,66,14,4,18,85.0,,369,75,69,144,539.0,84,7.25,87,443,2603,11.7,0.307351
7113,7113,Dave McLlwain,1994-95,28.0,8,43,66,66,17,26,43,115.0,,435,92,95,187,654.0,84,6.48,76,407,2545,10.7,0.4541491
7114,7114,Dave McLlwain,1995-96,29.0,9,11,43,43,5,6,11,48.0,,478,97,101,198,702.0,48,5.97,37,209,1408,10.2,0.33573276
7115,7115,Dave McLlwain,1996-97,30.0,10,7,19,19,2,5,7,20.0,,497,99,106,205,722.0,82,6.29,74,413,2481,10.4,0.3062163
7116,7116,Dave McLlwain,1997-98,31.0,11,2,4,4,1,1,2,3.0,,501,100,107,207,725.0,82,5.83,55,336,2444,9.8,0.19544178
7117,7117,Dave Michayluk,1982-83,20.0,2,0,1,1,0,0,0,0.0,,1,0,0,0,0.0,80,8.03,73,320,2489,12.9,0.27148372
7118,7118,Dave Michayluk,1983-84,21.0,3,8,13,13,2,6,8,18.0,,14,2,6,8,18.0,80,7.73,71,310,2444,12.7,0.38309783
7119,7119,Dave Morisset,2002-03,21.0,2,0,4,4,0,0,0,2.0,45.0,4,0,0,0,2.0,82,5.24,53,338,2262,9.5,0.18559515
7120,7120,Dave Morissette,1999-00,28.0,2,0,10,10,0,0,0,2.0,22.0,10,0,0,0,2.0,82,5.27,57,359,2285,9.4,0.14110437
7121,7121,Dave Morissette,2000-01,29.0,3,0,1,1,0,0,0,0.0,4.0,11,0,0,0,2.0,82,5.49,53,331,2294,9.8,0.13428688
7122,7122,Dave Morrison,1981-82,19.0,2,0,3,3,0,0,0,2.0,,3,0,0,0,2.0,80,7.69,77,340,2441,12.6,0.27732408
7123,7123,Dave Morrison,1982-83,20.0,3,0,4,4,0,0,0,6.0,,7,0,0,0,8.0,80,8.03,73,320,2489,12.9,0.2720015
7124,7124,Dave Morrison,1983-84,21.0,4,6,24,24,3,3,6,16.0,,31,3,3,6,24.0,80,7.73,71,310,2444,12.7,0.32368904
7125,7125,Dave Morrison,1985-86,23.0,5,0,8,8,0,0,0,8.0,,39,3,3,6,32.0,80,7.77,71,321,2447,12.7,0.21138012
7126,7126,Dave Moss,2007-08,26.0,2,18,41,41,10,8,18,70.0,460.0,41,10,8,18,70.0,82,5.76,70,398,2426,9.7,0.34179157
7127,7127,Dave Moss,2008-09,27.0,3,11,41,41,4,7,11,60.0,508.0,82,14,15,29,130.0,82,5.44,62,351,2383,9.4,0.23777431
7128,7128,Dave Moss,2009-10,28.0,4,39,81,81,20,19,39,194.0,1101.0,163,34,34,68,324.0,82,5.7,65,341,2477,9.4,0.48555163
7129,7129,Dave Moss,2010-11,29.0,5,17,64,64,8,9,17,133.0,878.0,227,42,43,85,457.0,82,5.53,56,304,2486,9.1,0.30103648
7130,7130,Dave Moss,2011-12,30.0,6,30,58,58,17,13,30,127.0,794.0,285,59,56,115,584.0,82,5.46,52,291,2492,9.0,0.42863148
7131,7131,Dave Moss,2012-13,31.0,7,9,32,32,2,7,9,82.0,448.0,317,61,63,124,666.0,82,5.32,47,271,2439,8.9,0.27805036
7132,7132,Dave Moss,2013-14,32.0,8,20,45,45,5,15,20,82.0,700.0,362,66,78,144,748.0,48,5.31,29,160,1399,9.1,0.38989222
7133,7133,Dave Moss,2014-15,33.0,9,22,79,79,8,14,22,151.0,1158.0,441,74,92,166,899.0,82,5.34,48,269,2463,8.9,0.28648084
7134,7134,Dave Moss,2015-16,34.0,10,12,60,60,4,8,12,96.0,775.0,501,78,100,178,995.0,82,5.32,47,251,2453,8.9,0.23261863
7135,7135,Dave Orleski,1981-82,22.0,2,0,1,1,0,0,0,0.0,,1,0,0,0,0.0,80,7.69,77,340,2441,12.6,0.19746074
7136,7136,Dave Orleski,1982-83,23.0,3,0,1,1,0,0,0,0.0,,2,0,0,0,0.0,80,8.03,73,320,2489,12.9,0.19895822
7137,7137,Dave Pasin,1986-87,20.0,2,37,71,71,18,19,37,116.0,,71,18,19,37,116.0,80,7.94,82,370,2484,12.8,0.56479996
7138,7138,Dave Pasin,1989-90,23.0,3,0,5,5,0,0,0,2.0,,76,18,19,37,118.0,80,7.48,85,403,2430,12.3,0.30770206
7139,7139,Dave Pichette,1981-82,21.0,2,20,46,46,4,16,20,47.0,,46,4,16,20,47.0,80,7.69,77,340,2441,12.6,0.42127472
7140,7140,Dave Pichette,1982-83,22.0,3,37,67,67,7,30,37,84.0,,113,11,46,57,131.0,80,8.03,73,320,2489,12.9,0.50243294
7141,7141,Dave Pichette,1983-84,23.0,4,24,53,53,3,21,24,62.0,,166,14,67,81,193.0,80,7.73,71,310,2444,12.7,0.39711204
7142,7142,Dave Pichette,1984-85,24.0,5,20,46,46,2,18,20,71.0,,212,16,85,101,264.0,80,7.89,74,336,2448,12.9,0.419117
7143,7143,Dave Pichette,1985-86,25.0,6,57,71,71,17,40,57,144.0,,283,33,125,158,408.0,80,7.77,71,321,2447,12.7,0.7307771
7144,7144,Dave Pichette,1986-87,26.0,7,19,33,33,7,12,19,59.0,,316,40,137,177,467.0,80,7.94,82,370,2484,12.8,0.5674509
7145,7145,Dave Pichette,1988-89,28.0,8,4,6,6,1,3,4,7.0,,322,41,140,181,474.0,80,7.43,89,437,2435,12.2,0.32812977
7146,7146,Dave Poulin,1983-84,25.0,2,2,2,2,2,0,2,4.0,,2,2,0,2,4.0,80,7.73,71,310,2444,12.7,0.42083305
7147,7147,Dave Poulin,1984-85,26.0,3,76,73,73,31,45,76,185.0,,75,33,45,78,189.0,80,7.89,74,336,2448,12.9,0.85724866
7148,7148,Dave Poulin,1985-86,27.0,4,74,73,73,30,44,74,182.0,,148,63,89,152,371.0,80,7.77,71,321,2447,12.7,0.8397691
7149,7149,Dave Poulin,1986-87,28.0,5,69,79,79,27,42,69,181.0,,227,90,131,221,552.0,80,7.94,82,370,2484,12.8,0.7644887
7150,7150,Dave Poulin,1987-88,29.0,6,70,75,75,25,45,70,155.0,,302,115,176,291,707.0,80,7.34,72,344,2400,12.2,0.80423856
7151,7151,Dave Poulin,1988-89,30.0,7,51,68,68,19,32,51,125.0,,370,134,208,342,832.0,80,7.43,89,437,2435,12.2,0.61494136
7152,7152,Dave Poulin,1989-90,31.0,8,35,69,69,18,17,35,81.0,,439,152,225,377,913.0,80,7.48,85,403,2430,12.3,0.4415157
7153,7153,Dave Poulin,1990-91,32.0,9,42,60,60,15,27,42,88.0,,499,167,252,419,1001.0,80,7.37,76,367,2421,12.2,0.55436605
7154,7154,Dave Poulin,1991-92,33.0,10,20,31,31,8,12,20,60.0,,530,175,264,439,1061.0,80,6.91,71,366,2385,11.6,0.53326213
7155,7155,Dave Poulin,1992-93,34.0,11,8,18,18,4,4,8,31.0,,548,179,268,447,1092.0,80,6.96,77,402,2440,11.4,0.46426877
7156,7156,Dave Poulin,1993-94,35.0,12,49,84,84,16,33,49,112.0,,632,195,301,496,1204.0,84,7.25,87,443,2603,11.7,0.48862872
7157,7157,Dave Poulin,1994-95,36.0,13,25,63,63,6,19,25,64.0,,695,201,320,521,1268.0,84,6.48,76,407,2545,10.7,0.36087424
7158,7158,Dave Poulin,1995-96,37.0,14,9,29,29,4,5,9,30.0,,724,205,325,530,1298.0,48,5.97,37,209,1408,10.2,0.36615852
7159,7159,Dave Reid,1984-85,20.0,2,1,8,8,1,0,1,4.0,,8,1,0,1,4.0,80,7.89,74,336,2448,12.9,0.3226799
7160,7160,Dave Reid,1985-86,21.0,3,27,35,35,14,13,27,52.0,,43,15,13,28,56.0,80,7.77,71,321,2447,12.7,0.58450073
7161,7161,Dave Reid,1986-87,22.0,4,20,37,37,10,10,20,53.0,,80,25,23,48,109.0,80,7.94,82,370,2484,12.8,0.50634855
7162,7162,Dave Reid,1987-88,23.0,5,6,12,12,3,3,6,19.0,,92,28,26,54,128.0,80,7.34,72,344,2400,12.2,0.36961687
7163,7163,Dave Reid,1988-89,24.0,6,0,3,3,0,0,0,2.0,,95,28,26,54,130.0,80,7.43,89,437,2435,12.2,0.28490412
7164,7164,Dave Reid,1989-90,25.0,7,30,77,77,9,21,30,87.0,,172,37,47,84,217.0,80,7.48,85,403,2430,12.3,0.39539018
7165,7165,Dave Reid,1990-91,26.0,8,28,70,70,9,19,28,97.0,,242,46,66,112,314.0,80,7.37,76,367,2421,12.2,0.37026972
7166,7166,Dave Reid,1991-92,27.0,9,28,69,69,15,13,28,110.0,,311,61,79,140,424.0,80,6.91,71,366,2385,11.6,0.38461322
7167,7167,Dave Reid,1992-93,28.0,10,14,43,43,7,7,14,70.0,,354,68,86,154,494.0,80,6.96,77,402,2440,11.4,0.34879827
7168,7168,Dave Reid,1993-94,29.0,11,36,65,65,20,16,36,116.0,,419,88,102,190,610.0,84,7.25,87,443,2603,11.7,0.3991175
7169,7169,Dave Reid,1994-95,30.0,12,23,83,83,6,17,23,145.0,,502,94,119,213,755.0,84,6.48,76,407,2545,10.7,0.2886619
7170,7170,Dave Reid,1995-96,31.0,13,10,38,38,5,5,10,47.0,,540,99,124,223,802.0,48,5.97,37,209,1408,10.2,0.28631908
7171,7171,Dave Reid,1996-97,32.0,14,44,63,63,23,21,44,160.0,,603,122,145,267,962.0,82,6.29,74,413,2481,10.4,0.5179252
7172,7172,Dave Reid,1997-98,33.0,15,39,82,82,19,20,39,135.0,,685,141,165,306,1097.0,82,5.83,55,336,2444,9.8,0.38039052
7173,7173,Dave Reid,1998-99,34.0,16,18,65,65,6,12,18,90.0,,750,147,177,324,1187.0,82,5.28,57,380,2242,9.6,0.24232337
7174,7174,Dave Reid,1999-00,35.0,17,17,73,73,6,11,17,81.0,844.0,823,153,188,341,1268.0,82,5.27,57,359,2285,9.4,0.21638641
7175,7175,Dave Reid,2000-01,36.0,18,18,65,65,11,7,18,86.0,971.0,888,164,195,359,1354.0,82,5.49,53,331,2294,9.8,0.22758245
7176,7176,Dave Reid,2001-02,37.0,19,10,73,73,1,9,10,66.0,721.0,961,165,204,369,1420.0,82,5.51,63,376,2272,9.9,0.16332293
7177,7177,Dave Reierson,1989-90,25.0,2,0,2,2,0,0,0,1.0,,2,0,0,0,1.0,80,7.48,85,403,2430,12.3,0.20620656
7178,7178,Dave Richter,1982-83,22.0,2,0,3,3,0,0,0,1.0,,3,0,0,0,1.0,80,8.03,73,320,2489,12.9,0.22380707
7179,7179,Dave Richter,1983-84,23.0,3,0,6,6,0,0,0,3.0,,9,0,0,0,4.0,80,7.73,71,310,2444,12.7,0.20689765
7180,7180,Dave Richter,1984-85,24.0,4,5,42,42,2,3,5,22.0,,51,2,3,5,26.0,80,7.89,74,336,2448,12.9,0.15271437
7181,7181,Dave Richter,1985-86,25.0,5,10,55,55,2,8,10,29.0,,106,4,11,15,55.0,80,7.77,71,321,2447,12.7,0.22027323
7182,7182,Dave Richter,1986-87,26.0,6,5,64,64,0,5,5,22.0,,170,4,16,20,77.0,80,7.94,82,370,2484,12.8,0.09223196
7183,7183,Dave Richter,1987-88,27.0,7,17,78,78,2,15,17,35.0,,248,6,31,37,112.0,80,7.34,72,344,2400,12.2,0.16928247
7184,7184,Dave Richter,1988-89,28.0,8,6,49,49,2,4,6,18.0,,297,8,35,43,130.0,80,7.43,89,437,2435,12.2,0.13133407
7185,7185,Dave Richter,1989-90,29.0,9,6,66,66,1,5,6,23.0,,363,9,40,49,153.0,80,7.48,85,403,2430,12.3,0.114988804
7186,7186,Dave Richter,1990-91,30.0,10,0,2,2,0,0,0,3.0,,365,9,40,49,156.0,80,7.37,76,367,2421,12.2,0.18056682
7187,7187,Dave Roche,1996-97,21.0,2,14,71,71,7,7,14,65.0,,71,7,7,14,65.0,82,6.29,74,413,2481,10.4,0.25156277
7188,7188,Dave Roche,1997-98,22.0,3,10,61,61,5,5,10,53.0,,132,12,12,24,118.0,82,5.83,55,336,2444,9.8,0.23217863
7189,7189,Dave Roche,1999-00,24.0,4,6,36,36,3,3,6,30.0,261.0,168,15,15,30,148.0,82,5.27,57,359,2285,9.4,0.20107344
7190,7190,Dave Roche,2000-01,25.0,5,0,2,2,0,0,0,3.0,17.0,170,15,15,30,151.0,82,5.49,53,331,2294,9.8,0.14446032
7191,7191,Dave Roche,2002-03,27.0,6,0,1,1,0,0,0,0.0,3.0,171,15,15,30,151.0,82,5.24,53,338,2262,9.5,0.1360034
7192,7192,Dave Scatchard,1998-99,22.0,2,24,76,76,13,11,24,85.0,,76,13,11,24,85.0,82,5.28,57,380,2242,9.6,0.36356845
7193,7193,Dave Scatchard,1999-00,23.0,3,26,82,82,13,13,26,130.0,1129.0,158,26,24,50,215.0,82,5.27,57,359,2285,9.4,0.41185027
7194,7194,Dave Scatchard,2000-01,24.0,4,30,65,65,12,18,30,128.0,817.0,223,38,42,80,343.0,82,5.49,53,331,2294,9.8,0.48632783
7195,7195,Dave Scatchard,2001-02,25.0,5,45,81,81,21,24,45,176.0,1363.0,304,59,66,125,519.0,82,5.51,63,376,2272,9.9,0.5690022
7196,7196,Dave Scatchard,2002-03,26.0,6,27,80,80,12,15,27,117.0,1001.0,384,71,81,152,636.0,82,5.24,53,338,2262,9.5,0.4093598
7197,7197,Dave Scatchard,2003-04,27.0,7,45,81,81,27,18,45,165.0,1174.0,465,98,99,197,801.0,82,5.31,60,363,2326,9.4,0.5273951
7198,7198,Dave Scatchard,2004-05,28.0,8,25,61,61,9,16,25,111.0,989.0,526,107,115,222,912.0,82,5.14,57,348,2300,9.2,0.45371404
7199,7199,Dave Scatchard,2006-07,30.0,9,33,63,63,15,18,33,121.0,964.0,589,122,133,255,1033.0,82,6.05,85,480,2458,10.1,0.44169062
7200,7200,Dave Scatchard,2007-08,31.0,10,8,46,46,3,5,8,77.0,622.0,635,125,138,263,1110.0,82,5.76,70,398,2426,9.7,0.2711518
7201,7201,Dave Scatchard,2010-11,34.0,11,5,16,16,3,2,5,25.0,171.0,651,128,140,268,1135.0,82,5.53,56,304,2486,9.1,0.25222743
7202,7202,Dave Scatchard,2011-12,35.0,12,1,8,8,0,1,1,6.0,38.0,659,128,141,269,1141.0,82,5.46,52,291,2492,9.0,0.17108905
7203,7203,Dave Semenko,1980-81,23.0,2,13,67,67,6,7,13,43.0,,67,6,7,13,43.0,80,7.03,61,280,2352,12.0,0.25040263
7204,7204,Dave Semenko,1981-82,24.0,3,19,58,58,11,8,19,42.0,,125,17,15,32,85.0,80,7.69,77,340,2441,12.6,0.3145119
7205,7205,Dave Semenko,1982-83,25.0,4,24,59,59,12,12,24,54.0,,184,29,27,56,139.0,80,8.03,73,320,2489,12.9,0.39007053
7206,7206,Dave Semenko,1983-84,26.0,5,27,75,75,12,15,27,70.0,,259,41,42,83,209.0,80,7.73,71,310,2444,12.7,0.3612656
7207,7207,Dave Semenko,1984-85,27.0,6,17,52,52,6,11,17,36.0,,311,47,53,100,245.0,80,7.89,74,336,2448,12.9,0.33504263
7208,7208,Dave Semenko,1985-86,28.0,7,18,69,69,6,12,18,50.0,,380,53,65,118,295.0,80,7.77,71,321,2447,12.7,0.26659876
7209,7209,Dave Semenko,1986-87,29.0,8,18,69,69,6,12,18,51.0,,449,59,77,136,346.0,80,7.94,82,370,2484,12.8,0.24172604
7210,7210,Dave Semenko,1987-88,30.0,9,12,56,56,4,8,12,33.0,,505,63,85,148,379.0,80,7.34,72,344,2400,12.2,0.23498502
7211,7211,Dave Semenko,1988-89,31.0,10,5,70,70,2,3,5,12.0,,575,65,88,153,391.0,80,7.43,89,437,2435,12.2,0.15097958
7212,7212,Dave Silk,1980-81,23.0,2,0,2,2,0,0,0,4.0,,2,0,0,0,4.0,80,7.03,61,280,2352,12.0,0.2333568
7213,7213,Dave Silk,1981-82,24.0,3,26,59,59,14,12,26,124.0,,61,14,12,26,128.0,80,7.69,77,340,2441,12.6,0.4682351
7214,7214,Dave Silk,1982-83,25.0,4,35,64,64,15,20,35,111.0,,125,29,32,61,239.0,80,8.03,73,320,2489,12.9,0.4718185
7215,7215,Dave Silk,1983-84,26.0,5,2,16,16,1,1,2,10.0,,141,30,33,63,249.0,80,7.73,71,310,2444,12.7,0.30137867
7216,7216,Dave Silk,1984-85,27.0,6,30,35,35,13,17,30,62.0,,176,43,50,93,311.0,80,7.89,74,336,2448,12.9,0.52857465
7217,7217,Dave Silk,1985-86,28.0,7,14,41,41,9,5,14,47.0,,217,52,55,107,358.0,80,7.77,71,321,2447,12.7,0.3422991
7218,7218,Dave Silk,1986-87,29.0,8,6,32,32,2,4,6,30.0,,249,54,59,113,388.0,80,7.94,82,370,2484,12.8,0.2582086
7219,7219,Dave Snuggerud,1990-91,24.0,2,30,80,80,14,16,30,120.0,,80,14,16,30,120.0,80,7.37,76,367,2421,12.2,0.4173768
7220,7220,Dave Snuggerud,1991-92,25.0,3,24,80,80,9,15,24,128.0,,160,23,31,54,248.0,80,6.91,71,366,2385,11.6,0.32400385
7221,7221,Dave Snuggerud,1992-93,26.0,4,19,66,66,3,16,19,94.0,,226,26,47,73,342.0,80,6.96,77,402,2440,11.4,0.3109122
7222,7222,Dave Snuggerud,1993-94,27.0,5,11,39,39,4,7,11,61.0,,265,30,54,84,403.0,84,7.25,87,443,2603,11.7,0.27111346
7223,7223,Dave Thomlinson,1990-91,24.0,2,3,19,19,1,2,3,17.0,,19,1,2,3,17.0,80,7.37,76,367,2421,12.2,0.2103928
7224,7224,Dave Thomlinson,1991-92,25.0,3,0,3,3,0,0,0,0.0,,22,1,2,3,17.0,80,6.91,71,366,2385,11.6,0.17141393
7225,7225,Dave Thomlinson,1992-93,26.0,4,1,12,12,0,1,1,12.0,,34,1,3,4,29.0,80,6.96,77,402,2440,11.4,0.20810121
7226,7226,Dave Thomlinson,1994-95,28.0,5,0,7,7,0,0,0,6.0,,41,1,3,4,35.0,84,6.48,76,407,2545,10.7,0.12542337
7227,7227,Dave Thomlinson,1995-96,29.0,6,0,1,1,0,0,0,0.0,,42,1,3,4,35.0,48,5.97,37,209,1408,10.2,0.11952537
7228,7228,Dave Tippett,1984-85,23.0,2,6,17,17,4,2,6,25.0,,17,4,2,6,25.0,80,7.89,74,336,2448,12.9,0.36550564
7229,7229,Dave Tippett,1985-86,24.0,3,19,80,80,7,12,19,98.0,,97,11,14,25,123.0,80,7.77,71,321,2447,12.7,0.3221658
7230,7230,Dave Tippett,1986-87,25.0,4,34,80,80,14,20,34,117.0,,177,25,34,59,240.0,80,7.94,82,370,2484,12.8,0.405348
7231,7231,Dave Tippett,1987-88,26.0,5,31,80,80,9,22,31,120.0,,257,34,56,90,360.0,80,7.34,72,344,2400,12.2,0.41284996
7232,7232,Dave Tippett,1988-89,27.0,6,37,80,80,16,21,37,126.0,,337,50,77,127,486.0,80,7.43,89,437,2435,12.2,0.43827155
7233,7233,Dave Tippett,1989-90,28.0,7,41,80,80,17,24,41,165.0,,417,67,101,168,651.0,80,7.48,85,403,2430,12.3,0.508475
7234,7234,Dave Tippett,1990-91,29.0,8,27,66,66,8,19,27,91.0,,483,75,120,195,742.0,80,7.37,76,367,2421,12.2,0.33260345
7235,7235,Dave Tippett,1991-92,30.0,9,15,61,61,6,9,15,68.0,,544,81,129,210,810.0,80,6.91,71,366,2385,11.6,0.29303753
7236,7236,Dave Tippett,1992-93,31.0,10,12,30,30,2,10,12,26.0,,574,83,139,222,836.0,80,6.96,77,402,2440,11.4,0.30204663
7237,7237,Dave Tippett,1993-94,32.0,11,25,74,74,6,19,25,64.0,,648,89,158,247,900.0,84,7.25,87,443,2603,11.7,0.25860754
7238,7238,Dave Tippett,1994-95,33.0,12,15,73,73,4,11,15,45.0,,721,93,169,262,945.0,84,6.48,76,407,2545,10.7,0.17002824
7239,7239,Dave Tomlinson,1992-93,23.0,2,0,3,3,0,0,0,6.0,,3,0,0,0,6.0,80,6.96,77,402,2440,11.4,0.22100326
7240,7240,Dave Tomlinson,1993-94,24.0,3,0,3,3,0,0,0,1.0,,6,0,0,0,7.0,84,7.25,87,443,2603,11.7,0.1854853
7241,7241,Dave Tomlinson,1994-95,25.0,4,4,31,31,1,3,4,29.0,,37,1,3,4,36.0,84,6.48,76,407,2545,10.7,0.17546949
7242,7242,Dave Tomlinson,1995-96,26.0,5,0,5,5,0,0,0,0.0,,42,1,3,4,36.0,48,5.97,37,209,1408,10.2,0.1427691
7243,7243,Dave Watson,1980-81,22.0,2,0,5,5,0,0,0,1.0,,5,0,0,0,1.0,80,7.03,61,280,2352,12.0,0.21862084
7244,7244,Dave Watson,1981-82,23.0,3,1,13,13,0,1,1,6.0,,18,0,1,1,7.0,80,7.69,77,340,2441,12.6,0.21074548
7245,7245,David Backes,2007-08,23.0,2,23,49,49,10,13,23,89.0,657.0,49,10,13,23,89.0,82,5.76,70,398,2426,9.7,0.4339236
7246,7246,David Backes,2008-09,24.0,3,31,72,72,13,18,31,129.0,1057.0,121,23,31,54,218.0,82,5.44,62,351,2383,9.4,0.4578201
7247,7247,David Backes,2009-10,25.0,4,54,82,82,31,23,54,208.0,1451.0,203,54,54,108,426.0,82,5.7,65,341,2477,9.4,0.6437988
7248,7248,David Backes,2010-11,26.0,5,48,79,79,17,31,48,163.0,1446.0,282,71,85,156,589.0,82,5.53,56,304,2486,9.1,0.58596027
7249,7249,David Backes,2011-12,27.0,6,62,82,82,31,31,62,211.0,1616.0,364,102,116,218,800.0,82,5.46,52,291,2492,9.0,0.67890304
7250,7250,David Backes,2012-13,28.0,7,54,82,82,24,30,54,234.0,1640.0,446,126,146,272,1034.0,82,5.32,47,271,2439,8.9,0.641507
7251,7251,David Backes,2013-14,29.0,8,28,48,48,6,22,28,100.0,941.0,494,132,168,300,1134.0,48,5.31,29,160,1399,9.1,0.6058927
7252,7252,David Backes,2014-15,30.0,9,57,74,74,27,30,57,165.0,1447.0,568,159,198,357,1299.0,82,5.34,48,269,2463,8.9,0.6687435
7253,7253,David Backes,2015-16,31.0,10,58,80,80,26,32,58,183.0,1491.0,648,185,230,415,1482.0,82,5.32,47,251,2453,8.9,0.65300214
7254,7254,David Backes,2016-17,32.0,11,45,79,79,21,24,45,168.0,1519.0,727,206,254,460,1650.0,82,5.34,48,255,2438,9.0,0.525728
7255,7255,David Backes,2017-18,33.0,12,38,74,74,17,21,38,175.0,1267.0,801,223,275,498,1825.0,82,5.45,47,245,2478,9.0,0.522878
7256,7256,David Backes,2018-19,34.0,13,33,57,57,14,19,33,160.0,878.0,858,237,294,531,1985.0,82,5.86,50,250,2620,9.2,0.48716033
7257,7257,David Backes,2019-20,35.0,14,20,70,70,7,13,20,129.0,913.0,928,244,307,551,2114.0,82,5.96,47,239,2579,9.5,0.3055107
7258,7258,David Backes,2020-21,36.0,15,6,22,22,1,5,6,34.0,207.0,950,245,312,557,2148.0,70,5.96,42,208,2192,9.5,0.32519662
7259,7259,David Booth,2007-08,23.0,2,10,48,48,3,7,10,86.0,459.0,48,3,7,10,86.0,82,5.76,70,398,2426,9.7,0.2895255
7260,7260,David Booth,2008-09,24.0,3,40,73,73,22,18,40,228.0,1181.0,121,25,25,50,314.0,82,5.44,62,351,2383,9.4,0.5774986
7261,7261,David Booth,2009-10,25.0,4,60,72,72,31,29,60,246.0,1231.0,193,56,54,110,560.0,82,5.7,65,341,2477,9.4,0.71219176
7262,7262,David Booth,2010-11,26.0,5,16,28,28,8,8,16,95.0,508.0,221,64,62,126,655.0,82,5.53,56,304,2486,9.1,0.51478535
7263,7263,David Booth,2011-12,27.0,6,40,82,82,23,17,40,280.0,1550.0,303,87,79,166,935.0,82,5.46,52,291,2492,9.0,0.57196075
7264,7264,David Booth,2012-13,28.0,7,30,62,62,16,14,30,159.0,926.0,365,103,93,196,1094.0,82,5.32,47,271,2439,8.9,0.5158182
7265,7265,David Booth,2013-14,29.0,8,3,12,12,1,2,3,27.0,153.0,377,104,95,199,1121.0,48,5.31,29,160,1399,9.1,0.40816483
7266,7266,David Booth,2014-15,30.0,9,19,66,66,9,10,19,117.0,889.0,443,113,105,218,1238.0,82,5.34,48,269,2463,8.9,0.30029386
7267,7267,David Booth,2015-16,31.0,10,13,59,59,7,6,13,107.0,705.0,502,120,111,231,1345.0,82,5.32,47,251,2453,8.9,0.26256132
7268,7268,David Booth,2018-19,34.0,11,5,28,28,4,1,5,33.0,195.0,530,124,112,236,1378.0,82,5.86,50,250,2620,9.2,0.21800777
7269,7269,David Brine,2008-09,24.0,2,1,9,9,0,1,1,3.0,54.0,9,0,1,1,3.0,82,5.44,62,351,2383,9.4,0.18300098
7270,7270,David Broll,2014-15,22.0,2,1,5,5,0,1,1,3.0,41.0,5,0,1,1,3.0,82,5.34,48,269,2463,8.9,0.20271176
7271,7271,David Bruce,1986-87,22.0,2,1,12,12,0,1,1,17.0,,12,0,1,1,17.0,80,7.94,82,370,2484,12.8,0.22542402
7272,7272,David Bruce,1987-88,23.0,3,16,50,50,9,7,16,76.0,,62,9,8,17,93.0,80,7.34,72,344,2400,12.2,0.3945415
7273,7273,David Bruce,1988-89,24.0,4,10,28,28,7,3,10,46.0,,90,16,11,27,139.0,80,7.43,89,437,2435,12.2,0.39025593
7274,7274,David Bruce,1989-90,25.0,5,14,53,53,7,7,14,86.0,,143,23,18,41,225.0,80,7.48,85,403,2430,12.3,0.36106366
7275,7275,David Bruce,1991-92,27.0,6,3,12,12,1,2,3,23.0,,155,24,20,44,248.0,80,6.91,71,366,2385,11.6,0.31789213
7276,7276,David Bruce,1992-93,28.0,7,38,60,60,22,16,38,137.0,,215,46,36,82,385.0,80,6.96,77,402,2440,11.4,0.5559269
7277,7277,David Bruce,1993-94,29.0,8,5,17,17,2,3,5,36.0,,232,48,39,87,421.0,84,7.25,87,443,2603,11.7,0.27833605
7278,7278,David Bruce,1994-95,30.0,9,0,2,2,0,0,0,5.0,,234,48,39,87,426.0,84,6.48,76,407,2545,10.7,0.2591173
7279,7279,David Clarkson,2007-08,23.0,2,4,7,7,3,1,4,18.0,119.0,7,3,1,4,18.0,82,5.76,70,398,2426,9.7,0.27800223
7280,7280,David Clarkson,2008-09,24.0,3,22,81,81,9,13,22,151.0,975.0,88,12,14,26,169.0,82,5.44,62,351,2383,9.4,0.32972234
7281,7281,David Clarkson,2009-10,25.0,4,32,82,82,17,15,32,158.0,988.0,170,29,29,58,327.0,82,5.7,65,341,2477,9.4,0.4425535
7282,7282,David Clarkson,2010-11,26.0,5,24,46,46,11,13,24,106.0,664.0,216,40,42,82,433.0,82,5.53,56,304,2486,9.1,0.44177195
7283,7283,David Clarkson,2011-12,27.0,6,18,82,82,12,6,18,192.0,1117.0,298,52,48,100,625.0,82,5.46,52,291,2492,9.0,0.30869925
7284,7284,David Clarkson,2012-13,28.0,7,46,80,80,30,16,46,228.0,1309.0,378,82,64,146,853.0,82,5.32,47,271,2439,8.9,0.5260389
7285,7285,David Clarkson,2013-14,29.0,8,24,48,48,15,9,24,180.0,844.0,426,97,73,170,1033.0,48,5.31,29,160,1399,9.1,0.4512064
7286,7286,David Clarkson,2014-15,30.0,9,11,60,60,5,6,11,102.0,906.0,486,102,79,181,1135.0,82,5.34,48,269,2463,8.9,0.2820459
7287,7287,David Clarkson,2015-16,31.0,10,15,61,61,10,5,15,95.0,842.0,547,112,84,196,1230.0,82,5.32,47,251,2453,8.9,0.26034978
7288,7288,David Clarkson,2016-17,32.0,11,4,23,23,2,2,4,24.0,212.0,570,114,86,200,1254.0,82,5.34,48,255,2438,9.0,0.23427173
7289,7289,David Cooper,1997-98,24.0,2,6,19,19,3,3,6,23.0,,19,3,3,6,23.0,82,5.83,55,336,2444,9.8,0.24853235
7290,7290,David Cooper,1998-99,25.0,3,4,9,9,0,4,4,13.0,,28,3,7,10,36.0,82,5.28,57,380,2242,9.6,0.19141847
7291,7291,David Cooper,2001-02,28.0,4,0,2,2,0,0,0,3.0,23.0,30,3,7,10,39.0,82,5.51,63,376,2272,9.9,0.14036298
7292,7292,David Cullen,2001-02,25.0,2,0,2,2,0,0,0,0.0,25.0,2,0,0,0,0.0,82,5.51,63,376,2272,9.9,0.15280735
7293,7293,David Cullen,2002-03,26.0,3,0,17,17,0,0,0,3.0,215.0,19,0,0,0,3.0,82,5.24,53,338,2262,9.5,0.1469765
7294,7294,David Desharnais,2010-11,24.0,2,1,6,6,0,1,1,2.0,51.0,6,0,1,1,2.0,82,5.53,56,304,2486,9.1,0.18514219
7295,7295,David Desharnais,2011-12,25.0,3,22,43,43,8,14,22,55.0,553.0,49,8,15,23,57.0,82,5.46,52,291,2492,9.0,0.36720237
7296,7296,David Desharnais,2012-13,26.0,4,60,81,81,16,44,60,98.0,1490.0,130,24,59,83,155.0,82,5.32,47,271,2439,8.9,0.6174288
7297,7297,David Desharnais,2013-14,27.0,5,28,48,48,10,18,28,66.0,790.0,178,34,77,111,221.0,48,5.31,29,160,1399,9.1,0.4973378
7298,7298,David Desharnais,2014-15,28.0,6,52,79,79,16,36,52,96.0,1359.0,257,50,113,163,317.0,82,5.34,48,269,2463,8.9,0.6151476
7299,7299,David Desharnais,2015-16,29.0,7,48,82,82,14,34,48,90.0,1414.0,339,64,147,211,407.0,82,5.32,47,251,2453,8.9,0.5504251
7300,7300,David Desharnais,2016-17,30.0,8,29,65,65,11,18,29,90.0,1040.0,404,75,165,240,497.0,82,5.34,48,255,2438,9.0,0.38168052
7301,7301,David Desharnais,2017-18,31.0,9,14,49,49,6,8,14,46.0,610.0,453,81,173,254,543.0,82,5.45,47,245,2478,9.0,0.29593158
7302,7302,David Desharnais,2018-19,32.0,10,28,71,71,6,22,28,55.0,927.0,524,87,195,282,598.0,82,5.86,50,250,2620,9.2,0.34174195
7303,7303,David Dziurzynski,2013-14,24.0,2,2,12,12,2,0,2,20.0,151.0,12,2,0,2,20.0,48,5.31,29,160,1399,9.1,0.27483392
7304,7304,David Dziurzynski,2016-17,27.0,3,4,14,14,1,3,4,14.0,141.0,26,3,3,6,34.0,82,5.34,48,255,2438,9.0,0.18833464
7305,7305,David Emma,1993-94,25.0,2,0,2,2,0,0,0,2.0,,2,0,0,0,2.0,84,7.25,87,443,2603,11.7,0.20954195
7306,7306,David Emma,1994-95,26.0,3,10,15,15,5,5,10,24.0,,17,5,5,10,26.0,84,6.48,76,407,2545,10.7,0.3015741
7307,7307,David Emma,1995-96,27.0,4,1,6,6,0,1,1,4.0,,23,5,6,11,30.0,48,5.97,37,209,1408,10.2,0.17192057
7308,7308,David Emma,1997-98,29.0,5,0,5,5,0,0,0,3.0,,28,5,6,11,33.0,82,5.83,55,336,2444,9.8,0.13515374
7309,7309,David Emma,2001-02,33.0,6,0,6,6,0,0,0,6.0,44.0,34,5,6,11,39.0,82,5.51,63,376,2272,9.9,0.15030569
7310,7310,David Fenyves,1983-84,23.0,2,8,24,24,0,8,8,20.0,,24,0,8,8,20.0,80,7.73,71,310,2444,12.7,0.24880025
7311,7311,David Fenyves,1984-85,24.0,3,4,10,10,0,4,4,4.0,,34,0,12,12,24.0,80,7.89,74,336,2448,12.9,0.24451587
7312,7312,David Fenyves,1985-86,25.0,4,9,60,60,1,8,9,50.0,,94,1,20,21,74.0,80,7.77,71,321,2447,12.7,0.22192773
7313,7313,David Fenyves,1986-87,26.0,5,7,47,47,0,7,7,31.0,,141,1,27,28,105.0,80,7.94,82,370,2484,12.8,0.14557028
7314,7314,David Fenyves,1987-88,27.0,6,1,7,7,1,0,1,3.0,,148,2,27,29,108.0,80,7.34,72,344,2400,12.2,0.18430123
7315,7315,David Fenyves,1988-89,28.0,7,0,5,5,0,0,0,3.0,,153,2,27,29,111.0,80,7.43,89,437,2435,12.2,0.17186725
7316,7316,David Fenyves,1989-90,29.0,8,1,1,1,0,1,1,0.0,,154,2,28,30,111.0,80,7.48,85,403,2430,12.3,0.16705826
7317,7317,David Fenyves,1990-91,30.0,9,0,12,12,0,0,0,10.0,,166,2,28,30,121.0,80,7.37,76,367,2421,12.2,0.15534836
7318,7318,David Fenyves,1991-92,31.0,10,5,40,40,1,4,5,32.0,,206,3,32,35,153.0,80,6.91,71,366,2385,11.6,0.130591
7319,7319,David Gosselin,2000-01,23.0,2,3,10,10,2,1,3,14.0,93.0,10,2,1,3,14.0,82,5.49,53,331,2294,9.8,0.25246438
7320,7320,David Gosselin,2002-03,25.0,3,0,3,3,0,0,0,0.0,21.0,13,2,1,3,14.0,82,5.24,53,338,2262,9.5,0.1455417
7321,7321,David Gove,2006-07,28.0,2,1,1,1,0,1,1,0.0,7.0,1,0,1,1,0.0,82,6.05,85,480,2458,10.1,0.1520186
7322,7322,David Gove,2007-08,29.0,3,0,1,1,0,0,0,0.0,3.0,2,0,1,1,0.0,82,5.76,70,398,2426,9.7,0.13320318
7323,7323,David Gustafsson,2020-21,20.0,2,1,22,22,1,0,1,4.0,135.0,22,1,0,1,4.0,70,5.96,42,208,2192,9.5,0.20192286
7324,7324,David Haas,1991-92,23.0,2,1,5,5,1,0,1,4.0,,5,1,0,1,4.0,80,6.91,71,366,2385,11.6,0.24949762
7325,7325,David Haas,1994-95,26.0,3,2,2,2,1,1,2,3.0,,7,2,1,3,7.0,84,6.48,76,407,2545,10.7,0.21428373
7326,7326,David Hale,2004-05,23.0,2,4,65,65,0,4,4,45.0,976.0,65,0,4,4,45.0,82,5.14,57,348,2300,9.2,0.18257946
7327,7327,David Hale,2006-07,25.0,3,4,38,38,0,4,4,19.0,458.0,103,0,8,8,64.0,82,6.05,85,480,2458,10.1,0.10671371
7328,7328,David Hale,2007-08,26.0,4,1,54,54,0,1,1,33.0,590.0,157,0,9,9,97.0,82,5.76,70,398,2426,9.7,0.118250966
7329,7329,David Hale,2008-09,27.0,5,2,58,58,0,2,2,35.0,805.0,215,0,11,11,132.0,82,5.44,62,351,2383,9.4,0.11933565
7330,7330,David Hale,2009-10,28.0,6,9,48,48,3,6,9,22.0,727.0,263,3,17,20,154.0,82,5.7,65,341,2477,9.4,0.114759356
7331,7331,David Hale,2010-11,29.0,7,4,39,39,0,4,4,25.0,548.0,302,3,21,24,179.0,82,5.53,56,304,2486,9.1,0.09788591
7332,7332,David Hale,2011-12,30.0,8,5,25,25,1,4,5,20.0,408.0,327,4,25,29,199.0,82,5.46,52,291,2492,9.0,0.12598199
7333,7333,David Harlock,1994-95,23.0,2,0,6,6,0,0,0,2.0,,6,0,0,0,2.0,84,6.48,76,407,2545,10.7,0.1760174
7334,7334,David Harlock,1995-96,24.0,3,0,1,1,0,0,0,0.0,,7,0,0,0,2.0,48,5.97,37,209,1408,10.2,0.18329343
7335,7335,David Harlock,1996-97,25.0,4,0,1,1,0,0,0,0.0,,8,0,0,0,2.0,82,6.29,74,413,2481,10.4,0.14272928
7336,7336,David Harlock,1998-99,27.0,5,0,6,6,0,0,0,2.0,,14,0,0,0,4.0,82,5.28,57,380,2242,9.6,0.1356748
7337,7337,David Harlock,1999-00,28.0,6,8,70,70,2,6,8,35.0,1278.0,84,2,6,8,39.0,82,5.27,57,359,2285,9.4,0.14633146
7338,7338,David Harlock,2000-01,29.0,7,6,44,44,0,6,6,29.0,866.0,128,2,12,14,68.0,82,5.49,53,331,2294,9.8,0.09655717
7339,7339,David Harlock,2001-02,30.0,8,1,65,65,0,1,1,26.0,1109.0,193,2,13,15,94.0,82,5.51,63,376,2272,9.9,0.07569325
7340,7340,David Harlock,2002-03,31.0,9,1,19,19,0,1,1,12.0,283.0,212,2,14,16,106.0,82,5.24,53,338,2262,9.5,0.079696804
7341,7341,David Jensen,1984-85,23.0,2,1,8,8,0,1,1,5.0,,8,0,1,1,5.0,80,7.89,74,336,2448,12.9,0.24115407
7342,7342,David Jensen,1985-86,24.0,3,1,5,5,0,1,1,3.0,,13,0,2,2,8.0,80,7.77,71,321,2447,12.7,0.21037164
7343,7343,David Jensen,1986-87,25.0,4,0,5,5,0,0,0,1.0,,18,0,2,2,9.0,80,7.94,82,370,2484,12.8,0.17651618
7344,7344,David Jensen0,1985-86,20.0,2,4,13,13,0,4,4,11.0,,13,0,4,4,11.0,80,7.77,71,321,2447,12.7,0.31036085
7345,7345,David Jensen0,1986-87,21.0,3,1,5,5,1,0,1,5.0,,18,1,4,5,16.0,80,7.94,82,370,2484,12.8,0.27891707
7346,7346,David Jensen0,1987-88,22.0,4,16,46,46,8,8,16,48.0,,64,9,12,21,64.0,80,7.34,72,344,2400,12.2,0.36379144
7347,7347,David Jensen0,1988-89,23.0,5,1,5,5,0,1,1,1.0,,69,9,13,22,65.0,80,7.43,89,437,2435,12.2,0.26454946
7348,7348,David Jones,2008-09,24.0,2,6,27,27,2,4,6,37.0,307.0,27,2,4,6,37.0,82,5.44,62,351,2383,9.4,0.22865045
7349,7349,David Jones,2009-10,25.0,3,13,40,40,8,5,13,47.0,509.0,67,10,9,19,84.0,82,5.7,65,341,2477,9.4,0.28856614
7350,7350,David Jones,2010-11,26.0,4,16,23,23,10,6,16,39.0,412.0,90,20,15,35,123.0,82,5.53,56,304,2486,9.1,0.49679273
7351,7351,David Jones,2011-12,27.0,5,45,77,77,27,18,45,153.0,1361.0,167,47,33,80,276.0,82,5.46,52,291,2492,9.0,0.516329
7352,7352,David Jones,2012-13,28.0,6,37,72,72,20,17,37,136.0,1134.0,239,67,50,117,412.0,82,5.32,47,271,2439,8.9,0.460841
7353,7353,David Jones,2013-14,29.0,7,9,33,33,3,6,9,62.0,555.0,272,70,56,126,474.0,48,5.31,29,160,1399,9.1,0.35105354
7354,7354,David Jones,2014-15,30.0,8,17,48,48,9,8,17,104.0,742.0,320,79,64,143,578.0,82,5.34,48,269,2463,8.9,0.34027845
7355,7355,David Jones,2015-16,31.0,9,30,67,67,14,16,30,114.0,961.0,387,93,80,173,692.0,82,5.32,47,251,2453,8.9,0.36052614
7356,7356,David Jones,2016-17,32.0,10,18,75,75,11,7,18,84.0,933.0,462,104,87,191,776.0,82,5.34,48,255,2438,9.0,0.25258207
7357,7357,David Kampf,2018-19,24.0,2,11,46,46,4,7,11,46.0,589.0,46,4,7,11,46.0,82,5.86,50,250,2620,9.2,0.21835414
7358,7358,David Kampf,2019-20,25.0,3,19,63,63,4,15,19,72.0,877.0,109,8,22,30,118.0,82,5.96,47,239,2579,9.5,0.28485322
7359,7359,David Kampf,2020-21,26.0,4,16,70,70,8,8,16,90.0,957.0,179,16,30,46,208.0,70,5.96,42,208,2192,9.5,0.26843303
7360,7360,David Kase,2020-21,24.0,2,1,6,6,1,0,1,5.0,59.0,6,1,0,1,5.0,70,5.96,42,208,2192,9.5,0.22876143
7361,7361,David Koci,2007-08,26.0,2,0,9,9,0,0,0,3.0,43.0,9,0,0,0,3.0,82,5.76,70,398,2426,9.7,0.16489819
7362,7362,David Koci,2008-09,27.0,3,0,18,18,0,0,0,2.0,65.0,27,0,0,0,5.0,82,5.44,62,351,2383,9.4,0.13270304
7363,7363,David Koci,2009-10,28.0,4,2,37,37,1,1,2,13.0,220.0,64,1,1,2,18.0,82,5.7,65,341,2477,9.4,0.1079379
7364,7364,David Koci,2010-11,29.0,5,1,43,43,1,0,1,6.0,131.0,107,2,1,3,24.0,82,5.53,56,304,2486,9.1,0.086690515
7365,7365,David Koci,2011-12,30.0,6,1,35,35,1,0,1,9.0,143.0,142,3,1,4,33.0,82,5.46,52,291,2492,9.0,0.08595246
7366,7366,David Krejci,2007-08,21.0,2,0,6,6,0,0,0,2.0,26.0,6,0,0,0,2.0,82,5.76,70,398,2426,9.7,0.19117922
7367,7367,David Krejci,2008-09,22.0,3,27,56,56,6,21,27,73.0,835.0,62,6,21,27,75.0,82,5.44,62,351,2383,9.4,0.46401855
7368,7368,David Krejci,2009-10,23.0,4,73,82,82,22,51,73,146.0,1382.0,144,28,72,100,221.0,82,5.7,65,341,2477,9.4,0.8255601
7369,7369,David Krejci,2010-11,24.0,5,52,79,79,17,35,52,156.0,1441.0,223,45,107,152,377.0,82,5.53,56,304,2486,9.1,0.66034526
7370,7370,David Krejci,2011-12,25.0,6,62,75,75,13,49,62,157.0,1414.0,298,58,156,214,534.0,82,5.46,52,291,2492,9.0,0.7114574
7371,7371,David Krejci,2012-13,26.0,7,62,79,79,23,39,62,145.0,1455.0,377,81,195,276,679.0,82,5.32,47,271,2439,8.9,0.72668684
7372,7372,David Krejci,2013-14,27.0,8,33,47,47,10,23,33,93.0,870.0,424,91,218,309,772.0,48,5.31,29,160,1399,9.1,0.65153533
7373,7373,David Krejci,2014-15,28.0,9,69,80,80,19,50,69,169.0,1530.0,504,110,268,378,941.0,82,5.34,48,269,2463,8.9,0.81861925
7374,7374,David Krejci,2015-16,29.0,10,31,47,47,7,24,31,70.0,854.0,551,117,292,409,1011.0,82,5.32,47,251,2453,8.9,0.6102243
7375,7375,David Krejci,2016-17,30.0,11,63,72,72,17,46,63,143.0,1462.0,623,134,338,472,1154.0,82,5.34,48,255,2438,9.0,0.7627724
7376,7376,David Krejci,2017-18,31.0,12,54,82,82,23,31,54,158.0,1498.0,705,157,369,526,1312.0,82,5.45,47,245,2478,9.0,0.6226309
7377,7377,David Krejci,2018-19,32.0,13,44,64,64,17,27,44,119.0,1080.0,769,174,396,570,1431.0,82,5.86,50,250,2620,9.2,0.6073576
7378,7378,David Krejci,2019-20,33.0,14,73,81,81,20,53,73,139.0,1432.0,850,194,449,643,1570.0,82,5.96,47,239,2579,9.5,0.7830286
7379,7379,David Krejci,2020-21,34.0,15,43,61,61,13,30,43,83.0,1048.0,911,207,479,686,1653.0,70,5.96,42,208,2192,9.5,0.52322924
7380,7380,David Laliberte,2010-11,24.0,2,3,11,11,2,1,3,8.0,86.0,11,2,1,3,8.0,82,5.53,56,304,2486,9.1,0.22464806
7381,7381,David Latta,1986-87,20.0,2,0,1,1,0,0,0,1.0,,1,0,0,0,1.0,80,7.94,82,370,2484,12.8,0.27897823
7382,7382,David Latta,1988-89,22.0,3,0,10,10,0,0,0,13.0,,11,0,0,0,14.0,80,7.43,89,437,2435,12.2,0.22557572
7383,7383,David Latta,1989-90,23.0,4,12,24,24,4,8,12,30.0,,35,4,8,12,44.0,80,7.48,85,403,2430,12.3,0.35506937
7384,7384,David Latta,1991-92,25.0,5,0,1,1,0,0,0,1.0,,36,4,8,12,45.0,80,6.91,71,366,2385,11.6,0.18220103
7385,7385,David Legwand,1999-00,19.0,2,0,1,1,0,0,0,2.0,13.0,1,0,0,0,2.0,82,5.27,57,359,2285,9.4,0.2185986
7386,7386,David Legwand,2000-01,20.0,3,28,71,71,13,15,28,111.0,1045.0,72,13,15,28,113.0,82,5.49,53,331,2294,9.8,0.46896183
7387,7387,David Legwand,2001-02,21.0,4,41,81,81,13,28,41,172.0,1234.0,153,26,43,69,285.0,82,5.51,63,376,2272,9.9,0.5368461
7388,7388,David Legwand,2002-03,22.0,5,30,63,63,11,19,30,121.0,1034.0,216,37,62,99,406.0,82,5.24,53,338,2262,9.5,0.55706215
7389,7389,David Legwand,2003-04,23.0,6,48,64,64,17,31,48,167.0,1231.0,280,54,93,147,573.0,82,5.31,60,363,2326,9.4,0.68965244
7390,7390,David Legwand,2004-05,24.0,7,47,82,82,18,29,47,165.0,1417.0,362,72,122,194,738.0,82,5.14,57,348,2300,9.2,0.66403264
7391,7391,David Legwand,2006-07,26.0,8,26,44,44,7,19,26,109.0,741.0,406,79,141,220,847.0,82,6.05,85,480,2458,10.1,0.5619246
7392,7392,David Legwand,2007-08,27.0,9,63,78,78,27,36,63,153.0,1432.0,484,106,177,283,1000.0,82,5.76,70,398,2426,9.7,0.707893
7393,7393,David Legwand,2008-09,28.0,10,44,65,65,15,29,44,144.0,1171.0,549,121,206,327,1144.0,82,5.44,62,351,2383,9.4,0.61296344
7394,7394,David Legwand,2009-10,29.0,11,42,73,73,20,22,42,175.0,1419.0,622,141,228,369,1319.0,82,5.7,65,341,2477,9.4,0.5353596
7395,7395,David Legwand,2010-11,30.0,12,38,82,82,11,27,38,151.0,1534.0,704,152,255,407,1470.0,82,5.53,56,304,2486,9.1,0.48732743
7396,7396,David Legwand,2011-12,31.0,13,41,64,64,17,24,41,130.0,1204.0,768,169,279,448,1600.0,82,5.46,52,291,2492,9.0,0.57504684
7397,7397,David Legwand,2012-13,32.0,14,53,78,78,19,34,53,140.0,1445.0,846,188,313,501,1740.0,82,5.32,47,271,2439,8.9,0.5606017
7398,7398,David Legwand,2013-14,33.0,15,25,48,48,12,13,25,78.0,884.0,894,200,326,526,1818.0,48,5.31,29,160,1399,9.1,0.4590333
7399,7399,David Legwand,2014-15,34.0,16,51,83,83,14,37,51,146.0,1409.0,977,214,363,577,1964.0,82,5.34,48,269,2463,8.9,0.5104738
7400,7400,David Legwand,2015-16,35.0,17,27,80,80,9,18,27,91.0,1112.0,1057,223,381,604,2055.0,82,5.32,47,251,2453,8.9,0.2821564
7401,7401,David Legwand,2016-17,36.0,18,14,79,79,5,9,14,61.0,767.0,1136,228,390,618,2116.0,82,5.34,48,255,2438,9.0,0.21394664
7402,7402,David Liffiton,2006-07,22.0,2,0,1,1,0,0,0,0.0,9.0,1,0,0,0,0.0,82,6.05,85,480,2458,10.1,0.15910202
7403,7403,David Liffiton,2007-08,23.0,3,0,2,2,0,0,0,2.0,23.0,3,0,0,0,2.0,82,5.76,70,398,2426,9.7,0.16125536
7404,7404,David Liffiton,2011-12,27.0,4,1,4,4,1,0,1,2.0,30.0,7,1,0,1,4.0,82,5.46,52,291,2492,9.0,0.16590014
7405,7405,David Ling,1997-98,23.0,2,0,2,2,0,0,0,0.0,,2,0,0,0,0.0,82,5.83,55,336,2444,9.8,0.15535027
7406,7406,David Ling,1998-99,24.0,3,0,1,1,0,0,0,1.0,,3,0,0,0,1.0,82,5.28,57,380,2242,9.6,0.15378207
7407,7407,David Ling,2002-03,28.0,4,0,5,5,0,0,0,5.0,49.0,8,0,0,0,6.0,82,5.24,53,338,2262,9.5,0.17300466
7408,7408,David Ling,2003-04,29.0,5,5,35,35,3,2,5,37.0,278.0,43,3,2,5,43.0,82,5.31,60,363,2326,9.4,0.17169362
7409,7409,David Ling,2004-05,30.0,6,3,50,50,1,2,3,45.0,388.0,93,4,4,8,88.0,82,5.14,57,348,2300,9.2,0.16554233
7410,7410,David Mackey,1988-89,22.0,2,4,23,23,1,3,4,23.0,,23,1,3,4,23.0,80,7.43,89,437,2435,12.2,0.28137773
7411,7411,David Mackey,1989-90,23.0,3,3,23,23,1,2,3,15.0,,46,2,5,7,38.0,80,7.48,85,403,2430,12.3,0.22176963
7412,7412,David Mackey,1990-91,24.0,4,2,16,16,2,0,2,8.0,,62,4,5,9,46.0,80,7.37,76,367,2421,12.2,0.25374088
7413,7413,David Mackey,1992-93,26.0,5,1,19,19,1,0,1,12.0,,81,5,5,10,58.0,80,6.96,77,402,2440,11.4,0.16987658
7414,7414,David Mackey,1993-94,27.0,6,5,15,15,1,4,5,17.0,,96,6,9,15,75.0,84,7.25,87,443,2603,11.7,0.22182244
7415,7415,David Mackey,1994-95,28.0,7,5,30,30,2,3,5,21.0,,126,8,12,20,96.0,84,6.48,76,407,2545,10.7,0.16642904
7416,7416,David Maley,1986-87,23.0,2,0,3,3,0,0,0,0.0,,3,0,0,0,0.0,80,7.94,82,370,2484,12.8,0.17614272
7417,7417,David Maley,1987-88,24.0,3,18,48,48,6,12,18,44.0,,51,6,12,18,44.0,80,7.34,72,344,2400,12.2,0.36011937
7418,7418,David Maley,1988-89,25.0,4,6,44,44,4,2,6,44.0,,95,10,14,24,88.0,80,7.43,89,437,2435,12.2,0.22759348
7419,7419,David Maley,1989-90,26.0,5,11,68,68,5,6,11,63.0,,163,15,20,35,151.0,80,7.48,85,403,2430,12.3,0.22525898
7420,7420,David Maley,1990-91,27.0,6,25,67,67,8,17,25,82.0,,230,23,37,60,233.0,80,7.37,76,367,2421,12.2,0.30794466
7421,7421,David Maley,1991-92,28.0,7,22,64,64,8,14,22,67.0,,294,31,51,82,300.0,80,6.91,71,366,2385,11.6,0.26893568
7422,7422,David Maley,1992-93,29.0,8,27,60,60,10,17,27,73.0,,354,41,68,109,373.0,80,6.96,77,402,2440,11.4,0.31524777
7423,7423,David Maley,1993-94,30.0,9,9,56,56,2,7,9,57.0,,410,43,75,118,430.0,84,7.25,87,443,2603,11.7,0.19035834
7424,7424,David Maley,1994-95,31.0,10,6,56,56,0,6,6,23.0,,466,43,81,124,453.0,84,6.48,76,407,2545,10.7,0.123503506
7425,7425,David McIntyre,2012-13,25.0,2,2,7,7,1,1,2,6.0,76.0,7,1,1,2,6.0,82,5.32,47,271,2439,8.9,0.19088358
7426,7426,David Moravec,2000-01,27.0,2,0,1,1,0,0,0,2.0,15.0,1,0,0,0,2.0,82,5.49,53,331,2294,9.8,0.16119191
7427,7427,David Musil,2015-16,22.0,2,2,4,4,0,2,2,3.0,79.0,4,0,2,2,3.0,82,5.32,47,251,2453,8.9,0.2146194
7428,7428,David Nemirovsky,1996-97,20.0,2,2,9,9,0,2,2,6.0,,9,0,2,2,6.0,82,6.29,74,413,2481,10.4,0.2519763
7429,7429,David Nemirovsky,1997-98,21.0,3,14,39,39,7,7,14,53.0,,48,7,9,16,59.0,82,5.83,55,336,2444,9.8,0.35057783
7430,7430,David Nemirovsky,1998-99,22.0,4,21,41,41,9,12,21,62.0,,89,16,21,37,121.0,82,5.28,57,380,2242,9.6,0.43278706
7431,7431,David Nemirovsky,1999-00,23.0,5,1,2,2,0,1,1,2.0,18.0,91,16,22,38,123.0,82,5.27,57,359,2285,9.4,0.24473485
7432,7432,David Oliver,1995-96,24.0,2,30,44,44,16,14,30,79.0,,44,16,14,30,79.0,48,5.97,37,209,1408,10.2,0.54919237
7433,7433,David Oliver,1996-97,25.0,3,39,80,80,20,19,39,131.0,,124,36,33,69,210.0,82,6.29,74,413,2481,10.4,0.4401707
7434,7434,David Oliver,1997-98,26.0,4,6,31,31,3,3,6,35.0,,155,39,36,75,245.0,82,5.83,55,336,2444,9.8,0.3110888
7435,7435,David Oliver,1999-00,28.0,5,7,17,17,2,5,7,18.0,180.0,172,41,41,82,263.0,82,5.27,57,359,2285,9.4,0.30053443
7436,7436,David Oliver,2000-01,29.0,6,1,9,9,1,0,1,6.0,69.0,181,42,41,83,269.0,82,5.49,53,331,2294,9.8,0.24874768
7437,7437,David Oliver,2001-02,30.0,7,0,7,7,0,0,0,2.0,39.0,188,42,41,83,271.0,82,5.51,63,376,2272,9.9,0.25827953
7438,7438,David Oliver,2003-04,32.0,8,3,6,6,0,3,3,5.0,55.0,194,42,44,86,276.0,82,5.31,60,363,2326,9.4,0.27965808
7439,7439,David Oliver,2004-05,33.0,9,12,36,36,7,5,12,30.0,355.0,230,49,49,98,306.0,82,5.14,57,348,2300,9.2,0.25783223
7440,7440,David Oliver,2006-07,35.0,10,0,3,3,0,0,0,1.0,23.0,233,49,49,98,307.0,82,6.05,85,480,2458,10.1,0.25824612
7441,7441,David Pastrnak,2015-16,19.0,2,27,46,46,10,17,27,93.0,643.0,46,10,17,27,93.0,82,5.32,47,251,2453,8.9,0.5010328
7442,7442,David Pastrnak,2016-17,20.0,3,26,51,51,15,11,26,108.0,711.0,97,25,28,53,201.0,82,5.34,48,255,2438,9.0,0.535346
7443,7443,David Pastrnak,2017-18,21.0,4,70,75,75,34,36,70,262.0,1349.0,172,59,64,123,463.0,82,5.45,47,245,2478,9.0,0.9331604
7444,7444,David Pastrnak,2018-19,22.0,5,80,82,82,35,45,80,246.0,1473.0,254,94,109,203,709.0,82,5.86,50,250,2620,9.2,1.0522151
7445,7445,David Pastrnak,2019-20,23.0,6,81,66,66,38,43,81,235.0,1238.0,320,132,152,284,944.0,82,5.96,47,239,2579,9.5,1.1673415
7446,7446,David Pastrnak,2020-21,24.0,7,95,70,70,48,47,95,279.0,1327.0,390,180,199,379,1223.0,70,5.96,42,208,2192,9.5,1.1906505
7447,7447,David Perron,2008-09,20.0,2,27,62,62,13,14,27,68.0,778.0,62,13,14,27,68.0,82,5.44,62,351,2383,9.4,0.45142978
7448,7448,David Perron,2009-10,21.0,3,50,81,81,15,35,50,161.0,1177.0,143,28,49,77,229.0,82,5.7,65,341,2477,9.4,0.62246
7449,7449,David Perron,2010-11,22.0,4,47,82,82,20,27,47,166.0,1325.0,225,48,76,124,395.0,82,5.53,56,304,2486,9.1,0.63742447
7450,7450,David Perron,2011-12,23.0,5,7,10,10,5,2,7,29.0,184.0,235,53,78,131,424.0,82,5.46,52,291,2492,9.0,0.5725742
7451,7451,David Perron,2012-13,24.0,6,42,57,57,21,21,42,114.0,1042.0,292,74,99,173,538.0,82,5.32,47,271,2439,8.9,0.68974614
7452,7452,David Perron,2013-14,25.0,7,25,48,48,10,15,25,84.0,864.0,340,84,114,198,622.0,48,5.31,29,160,1399,9.1,0.60792375
7453,7453,David Perron,2014-15,26.0,8,57,78,78,28,29,57,220.0,1492.0,418,112,143,255,842.0,82,5.34,48,269,2463,8.9,0.6743299
7454,7454,David Perron,2015-16,27.0,9,41,81,81,17,24,41,196.0,1404.0,499,129,167,296,1038.0,82,5.32,47,251,2453,8.9,0.56114316
7455,7455,David Perron,2016-17,28.0,10,36,71,71,12,24,36,147.0,1080.0,570,141,191,332,1185.0,82,5.34,48,255,2438,9.0,0.48123842
7456,7456,David Perron,2017-18,29.0,11,46,82,82,18,28,46,151.0,1418.0,652,159,219,378,1336.0,82,5.45,47,245,2478,9.0,0.5297539
7457,7457,David Perron,2018-19,30.0,12,66,70,70,16,50,66,125.0,1247.0,722,175,269,444,1461.0,82,5.86,50,250,2620,9.2,0.7740562
7458,7458,David Perron,2019-20,31.0,13,46,57,57,23,23,46,112.0,974.0,779,198,292,490,1573.0,82,5.96,47,239,2579,9.5,0.63695407
7459,7459,David Perron,2020-21,32.0,14,60,71,71,25,35,60,166.0,1300.0,850,223,327,550,1739.0,70,5.96,42,208,2192,9.5,0.64454985
7460,7460,David Printz,2006-07,26.0,2,0,1,1,0,0,0,0.0,6.0,1,0,0,0,0.0,82,6.05,85,480,2458,10.1,0.14312965
7461,7461,David Printz,2007-08,27.0,3,0,12,12,0,0,0,1.0,79.0,13,0,0,0,1.0,82,5.76,70,398,2426,9.7,0.1239607
7462,7462,David Roberts,1994-95,24.0,2,0,1,1,0,0,0,1.0,,1,0,0,0,1.0,84,6.48,76,407,2545,10.7,0.16952863
7463,7463,David Roberts,1995-96,25.0,3,11,19,19,6,5,11,41.0,,20,6,5,11,42.0,48,5.97,37,209,1408,10.2,0.3611023
7464,7464,David Roberts,1996-97,26.0,4,13,34,34,3,10,13,47.0,,54,9,15,24,89.0,82,6.29,74,413,2481,10.4,0.2892292
7465,7465,David Roberts,1997-98,27.0,5,27,58,58,10,17,27,74.0,,112,19,32,51,163.0,82,5.83,55,336,2444,9.8,0.32552883
7466,7466,David Roberts,1998-99,28.0,6,2,13,13,1,1,2,14.0,,125,20,33,53,177.0,82,5.28,57,380,2242,9.6,0.24039865
7467,7467,David Rundblad,2012-13,22.0,2,7,30,30,1,6,7,34.0,450.0,30,1,6,7,34.0,82,5.32,47,271,2439,8.9,0.22018307
7468,7468,David Rundblad,2013-14,23.0,3,1,8,8,0,1,1,9.0,110.0,38,1,7,8,43.0,48,5.31,29,160,1399,9.1,0.21057174
7469,7469,David Rundblad,2014-15,24.0,4,1,17,17,0,1,1,21.0,234.0,55,1,8,9,64.0,82,5.34,48,269,2463,8.9,0.18140882
7470,7470,David Rundblad,2015-16,25.0,5,14,49,49,3,11,14,58.0,627.0,104,4,19,23,122.0,82,5.32,47,251,2453,8.9,0.23981386
7471,7471,David Rundblad,2016-17,26.0,6,2,9,9,0,2,2,13.0,129.0,113,4,21,25,135.0,82,5.34,48,255,2438,9.0,0.18981683
7472,7472,David Sacco,1994-95,24.0,2,2,4,4,1,1,2,4.0,,4,1,1,2,4.0,84,6.48,76,407,2545,10.7,0.22843665
7473,7473,David Sacco,1995-96,25.0,3,2,8,8,0,2,2,5.0,,12,1,3,4,9.0,48,5.97,37,209,1408,10.2,0.20917827
7474,7474,David Sacco,1996-97,26.0,4,14,23,23,4,10,14,26.0,,35,5,13,18,35.0,82,6.29,74,413,2481,10.4,0.32524914
7475,7475,David Saunders,1988-89,22.0,2,20,56,56,7,13,20,100.0,,56,7,13,20,100.0,80,7.43,89,437,2435,12.2,0.41932502
7476,7476,David Savard,2012-13,22.0,2,10,31,31,2,8,10,34.0,514.0,31,2,8,10,34.0,82,5.32,47,271,2439,8.9,0.25914043
7477,7477,David Savard,2013-14,23.0,3,0,4,4,0,0,0,1.0,53.0,35,2,8,10,35.0,48,5.31,29,160,1399,9.1,0.19525644
7478,7478,David Savard,2014-15,24.0,4,15,70,70,5,10,15,63.0,1248.0,105,7,18,25,98.0,82,5.34,48,269,2463,8.9,0.22167692
7479,7479,David Savard,2015-16,25.0,5,36,82,82,11,25,36,112.0,1881.0,187,18,43,61,210.0,82,5.32,47,251,2453,8.9,0.3895871
7480,7480,David Savard,2016-17,26.0,6,25,65,65,4,21,25,122.0,1506.0,252,22,64,86,332.0,82,5.34,48,255,2438,9.0,0.3245784
7481,7481,David Savard,2017-18,27.0,7,23,74,74,6,17,23,135.0,1616.0,326,28,81,109,467.0,82,5.45,47,245,2478,9.0,0.33299297
7482,7482,David Savard,2018-19,28.0,8,16,81,81,4,12,16,145.0,1570.0,407,32,93,125,612.0,82,5.86,50,250,2620,9.2,0.26865262
7483,7483,David Savard,2019-20,29.0,9,24,82,82,8,16,24,124.0,1619.0,489,40,109,149,736.0,82,5.96,47,239,2579,9.5,0.2883498
7484,7484,David Savard,2020-21,30.0,10,11,68,68,0,11,11,97.0,1407.0,557,40,120,160,833.0,70,5.96,42,208,2192,9.5,0.21736729
7485,7485,David Schlemko,2009-10,22.0,2,1,3,3,0,1,1,3.0,58.0,3,0,1,1,3.0,82,5.7,65,341,2477,9.4,0.2178615
7486,7486,David Schlemko,2010-11,23.0,3,5,17,17,1,4,5,19.0,303.0,20,1,5,6,22.0,82,5.53,56,304,2486,9.1,0.2282663
7487,7487,David Schlemko,2011-12,24.0,4,14,43,43,4,10,14,47.0,690.0,63,5,15,20,69.0,82,5.46,52,291,2492,9.0,0.23167509
7488,7488,David Schlemko,2012-13,25.0,5,11,46,46,1,10,11,58.0,844.0,109,6,25,31,127.0,82,5.32,47,271,2439,8.9,0.20322847
7489,7489,David Schlemko,2013-14,26.0,6,6,30,30,1,5,6,35.0,517.0,139,7,30,37,162.0,48,5.31,29,160,1399,9.1,0.19064826
7490,7490,David Schlemko,2014-15,27.0,7,9,48,48,1,8,9,61.0,787.0,187,8,38,46,223.0,82,5.34,48,269,2463,8.9,0.15595862
7491,7491,David Schlemko,2015-16,28.0,8,4,44,44,1,3,4,45.0,675.0,231,9,41,50,268.0,82,5.32,47,251,2453,8.9,0.14495668
7492,7492,David Schlemko,2016-17,29.0,9,19,67,67,6,13,19,104.0,1249.0,298,15,54,69,372.0,82,5.34,48,255,2438,9.0,0.24085766
7493,7493,David Schlemko,2017-18,30.0,10,18,62,62,2,16,18,118.0,1038.0,360,17,70,87,490.0,82,5.45,47,245,2478,9.0,0.26263246
7494,7494,David Schlemko,2018-19,31.0,11,5,37,37,1,4,5,38.0,668.0,397,18,74,92,528.0,82,5.86,50,250,2620,9.2,0.14927414
7495,7495,David Schlemko,2019-20,32.0,12,2,18,18,0,2,2,29.0,357.0,415,18,76,94,557.0,82,5.96,47,239,2579,9.5,0.16150066
7496,7496,David Shaw,1983-84,19.0,2,0,2,2,0,0,0,0.0,,2,0,0,0,0.0,80,7.73,71,310,2444,12.7,0.24393094
7497,7497,David Shaw,1984-85,20.0,3,0,3,3,0,0,0,3.0,,5,0,0,0,3.0,80,7.89,74,336,2448,12.9,0.2720015
7498,7498,David Shaw,1985-86,21.0,4,0,14,14,0,0,0,10.0,,19,0,0,0,13.0,80,7.77,71,321,2447,12.7,0.21143094
7499,7499,David Shaw,1986-87,22.0,5,26,73,73,7,19,26,128.0,,92,7,19,26,141.0,80,7.94,82,370,2484,12.8,0.38410193
7500,7500,David Shaw,1987-88,23.0,6,19,75,75,0,19,19,136.0,,167,7,38,45,277.0,80,7.34,72,344,2400,12.2,0.3151013
7501,7501,David Shaw,1988-89,24.0,7,32,68,68,7,25,32,141.0,,235,14,63,77,418.0,80,7.43,89,437,2435,12.2,0.45101646
7502,7502,David Shaw,1989-90,25.0,8,17,63,63,6,11,17,85.0,,298,20,74,94,503.0,80,7.48,85,403,2430,12.3,0.29280055
7503,7503,David Shaw,1990-91,26.0,9,12,22,22,2,10,12,24.0,,320,22,84,106,527.0,80,7.37,76,367,2421,12.2,0.31553972
7504,7504,David Shaw,1991-92,27.0,10,12,77,77,2,10,12,61.0,,397,24,94,118,588.0,80,6.91,71,366,2385,11.6,0.20652515
7505,7505,David Shaw,1992-93,28.0,11,10,59,59,1,9,10,70.0,,456,25,103,128,658.0,80,6.96,77,402,2440,11.4,0.2132735
7506,7506,David Shaw,1993-94,29.0,12,24,77,77,10,14,24,122.0,,533,35,117,152,780.0,84,7.25,87,443,2603,11.7,0.2686836
7507,7507,David Shaw,1994-95,30.0,13,10,55,55,1,9,10,107.0,,588,36,126,162,887.0,84,6.48,76,407,2545,10.7,0.1900841
7508,7508,David Shaw,1995-96,31.0,14,7,44,44,3,4,7,58.0,,632,39,130,169,945.0,48,5.97,37,209,1408,10.2,0.17634454
7509,7509,David Shaw,1996-97,32.0,15,12,66,66,1,11,12,90.0,,698,40,141,181,1035.0,82,6.29,74,413,2481,10.4,0.13525227
7510,7510,David Shaw,1997-98,33.0,16,11,57,57,1,10,11,59.0,,755,41,151,192,1094.0,82,5.83,55,336,2444,9.8,0.13900316
7511,7511,David Shaw,1998-99,34.0,17,2,14,14,0,2,2,12.0,,769,41,153,194,1106.0,82,5.28,57,380,2242,9.6,0.12907565
7512,7512,David Sloane,2009-10,24.0,2,0,1,1,0,0,0,0.0,7.0,1,0,0,0,0.0,82,5.7,65,341,2477,9.4,0.15774
7513,7513,David Steckel,2006-07,24.0,2,0,7,7,0,0,0,6.0,54.0,7,0,0,0,6.0,82,6.05,85,480,2458,10.1,0.16917557
7514,7514,David Steckel,2007-08,25.0,3,0,5,5,0,0,0,4.0,62.0,12,0,0,0,10.0,82,5.76,70,398,2426,9.7,0.1646193
7515,7515,David Steckel,2008-09,26.0,4,12,67,67,5,7,12,66.0,909.0,79,5,7,12,76.0,82,5.44,62,351,2383,9.4,0.20186993
7516,7516,David Steckel,2009-10,27.0,5,19,76,76,8,11,19,103.0,1050.0,155,13,18,31,179.0,82,5.7,65,341,2477,9.4,0.24597308
7517,7517,David Steckel,2010-11,28.0,6,16,79,79,5,11,16,90.0,980.0,234,18,29,47,269.0,82,5.53,56,304,2486,9.1,0.215595
7518,7518,David Steckel,2011-12,29.0,7,12,75,75,6,6,12,79.0,891.0,309,24,35,59,348.0,82,5.46,52,291,2492,9.0,0.19323632
7519,7519,David Steckel,2012-13,30.0,8,13,76,76,8,5,13,79.0,975.0,385,32,40,72,427.0,82,5.32,47,271,2439,8.9,0.18226418
7520,7520,David Steckel,2013-14,31.0,9,7,34,34,1,6,7,23.0,315.0,419,33,46,79,450.0,48,5.31,29,160,1399,9.1,0.15673321
7521,7521,David Steckel,2014-15,32.0,10,0,6,6,0,0,0,8.0,65.0,425,33,46,79,458.0,82,5.34,48,269,2463,8.9,0.15168828
7522,7522,David Struch,1994-95,23.0,2,0,4,4,0,0,0,3.0,,4,0,0,0,3.0,84,6.48,76,407,2545,10.7,0.18269011
7523,7523,David Tanabe,2000-01,20.0,2,4,31,31,4,0,4,28.0,400.0,31,4,0,4,28.0,82,5.49,53,331,2294,9.8,0.28736088
7524,7524,David Tanabe,2001-02,21.0,3,29,74,74,7,22,29,130.0,1326.0,105,11,22,33,158.0,82,5.51,63,376,2272,9.9,0.4167547
7525,7525,David Tanabe,2002-03,22.0,4,16,78,78,1,15,16,113.0,1439.0,183,12,37,49,271.0,82,5.24,53,338,2262,9.5,0.2762957
7526,7526,David Tanabe,2003-04,23.0,5,13,68,68,3,10,13,104.0,1237.0,251,15,47,62,375.0,82,5.31,60,363,2326,9.4,0.2507773
7527,7527,David Tanabe,2004-05,24.0,6,12,45,45,5,7,12,88.0,1037.0,296,20,54,74,463.0,82,5.14,57,348,2300,9.2,0.32843763
7528,7528,David Tanabe,2006-07,26.0,7,20,75,75,4,16,20,103.0,1531.0,371,24,70,94,566.0,82,6.05,85,480,2458,10.1,0.26416525
7529,7529,David Tanabe,2007-08,27.0,8,17,60,60,5,12,17,83.0,1068.0,431,29,82,111,649.0,82,5.76,70,398,2426,9.7,0.28061688
7530,7530,David Tanabe,2008-09,28.0,9,3,18,18,1,2,3,12.0,216.0,449,30,84,114,661.0,82,5.44,62,351,2383,9.4,0.22008884
7531,7531,David Ullstrom,2012-13,23.0,2,8,29,29,4,4,8,40.0,318.0,29,4,4,8,40.0,82,5.32,47,271,2439,8.9,0.2769121
7532,7532,David Ullstrom,2013-14,24.0,3,5,20,20,2,3,5,28.0,190.0,49,6,7,13,68.0,48,5.31,29,160,1399,9.1,0.27649704
7533,7533,David Van Der Gulik,2009-10,26.0,2,2,6,6,0,2,2,11.0,51.0,6,0,2,2,11.0,82,5.7,65,341,2477,9.4,0.19423795
7534,7534,David Van Der Gulik,2011-12,28.0,3,3,6,6,1,2,3,12.0,41.0,12,1,4,5,23.0,82,5.46,52,291,2492,9.0,0.2006379
7535,7535,David Van Der Gulik,2012-13,29.0,4,6,25,25,1,5,6,20.0,205.0,37,2,9,11,43.0,82,5.32,47,271,2439,8.9,0.16229239
7536,7536,David Van Der Gulik,2013-14,30.0,5,2,9,9,0,2,2,10.0,85.0,46,2,11,13,53.0,48,5.31,29,160,1399,9.1,0.17544293
7537,7537,David Van Der Gulik,2014-15,31.0,6,0,2,2,0,0,0,3.0,11.0,48,2,11,13,56.0,82,5.34,48,269,2463,8.9,0.1257942
7538,7538,David Van Der Gulik,2015-16,32.0,7,0,1,1,0,0,0,1.0,5.0,49,2,11,13,57.0,82,5.32,47,251,2453,8.9,0.12314862
7539,7539,David Van Drunen,2000-01,25.0,2,0,1,1,0,0,0,0.0,5.0,1,0,0,0,0.0,82,5.49,53,331,2294,9.8,0.15208486
7540,7540,David Volek,1989-90,23.0,2,59,77,77,25,34,59,229.0,,77,25,34,59,229.0,80,7.48,85,403,2430,12.3,0.7153745
7541,7541,David Volek,1990-91,24.0,3,39,80,80,17,22,39,181.0,,157,42,56,98,410.0,80,7.37,76,367,2421,12.2,0.55972606
7542,7542,David Volek,1991-92,25.0,4,56,77,77,22,34,56,224.0,,234,64,90,154,634.0,80,6.91,71,366,2385,11.6,0.7255354
7543,7543,David Volek,1992-93,26.0,5,60,74,74,18,42,60,167.0,,308,82,132,214,801.0,80,6.96,77,402,2440,11.4,0.7306683
7544,7544,David Volek,1993-94,27.0,6,21,56,56,8,13,21,118.0,,364,90,145,235,919.0,84,7.25,87,443,2603,11.7,0.45333758
7545,7545,David Volek,1994-95,28.0,7,14,32,32,5,9,14,56.0,,396,95,154,249,975.0,84,6.48,76,407,2545,10.7,0.40395975
7546,7546,David Vyborny,2001-02,27.0,2,32,79,79,13,19,32,125.0,1219.0,79,13,19,32,125.0,82,5.51,63,376,2272,9.9,0.39013863
7547,7547,David Vyborny,2002-03,28.0,3,31,75,75,13,18,31,103.0,1159.0,154,26,37,63,228.0,82,5.24,53,338,2262,9.5,0.4145303
7548,7548,David Vyborny,2003-04,29.0,4,46,79,79,20,26,46,125.0,1291.0,233,46,63,109,353.0,82,5.31,60,363,2326,9.4,0.49348387
7549,7549,David Vyborny,2004-05,30.0,5,53,82,82,22,31,53,158.0,1671.0,315,68,94,162,511.0,82,5.14,57,348,2300,9.2,0.7072135
7550,7550,David Vyborny,2006-07,32.0,6,65,80,80,22,43,65,145.0,1655.0,395,90,137,227,656.0,82,6.05,85,480,2458,10.1,0.6843821
7551,7551,David Vyborny,2007-08,33.0,7,64,82,82,16,48,64,158.0,1668.0,477,106,185,291,814.0,82,5.76,70,398,2426,9.7,0.69507754
7552,7552,David Vyborny,2008-09,34.0,8,26,66,66,7,19,26,106.0,1022.0,543,113,204,317,920.0,82,5.44,62,351,2383,9.4,0.34879434
7553,7553,David Warsofsky,2014-15,24.0,2,2,6,6,1,1,2,10.0,97.0,6,1,1,2,10.0,82,5.34,48,269,2463,8.9,0.21409205
7554,7554,David Warsofsky,2015-16,25.0,3,1,4,4,0,1,1,7.0,71.0,10,1,2,3,17.0,82,5.32,47,251,2453,8.9,0.17751658
7555,7555,David Warsofsky,2016-17,26.0,4,2,22,22,1,1,2,40.0,377.0,32,2,3,5,57.0,82,5.34,48,255,2438,9.0,0.18011239
7556,7556,David Warsofsky,2017-18,27.0,5,1,7,7,0,1,1,14.0,110.0,39,2,4,6,71.0,82,5.45,47,245,2478,9.0,0.15709743
7557,7557,David Warsofsky,2018-19,28.0,6,5,16,16,0,5,5,18.0,214.0,55,2,9,11,89.0,82,5.86,50,250,2620,9.2,0.17255616
7558,7558,David Wilkie,1995-96,21.0,2,0,1,1,0,0,0,0.0,,1,0,0,0,0.0,48,5.97,37,209,1408,10.2,0.19863126
7559,7559,David Wilkie,1996-97,22.0,3,6,24,24,1,5,6,39.0,,25,1,5,6,39.0,82,6.29,74,413,2481,10.4,0.22641352
7560,7560,David Wilkie,1997-98,23.0,4,15,61,61,6,9,15,65.0,,86,7,14,21,104.0,82,5.83,55,336,2444,9.8,0.2687898
7561,7561,David Wilkie,1998-99,24.0,5,7,34,34,2,5,7,48.0,,120,9,19,28,152.0,82,5.28,57,380,2242,9.6,0.23815978
7562,7562,David Wilkie,1999-00,25.0,6,8,46,46,1,7,8,35.0,566.0,166,10,26,36,187.0,82,5.27,57,359,2285,9.4,0.16292855
7563,7563,David Wilkie,2001-02,27.0,7,0,1,1,0,0,0,1.0,12.0,167,10,26,36,188.0,82,5.51,63,376,2272,9.9,0.14975998
7564,7564,David Williams,1992-93,25.0,2,28,56,56,3,25,28,91.0,,56,3,25,28,91.0,80,6.96,77,402,2440,11.4,0.44361556
7565,7565,David Williams,1993-94,26.0,3,12,40,40,1,11,12,60.0,,96,4,36,40,151.0,84,7.25,87,443,2603,11.7,0.23936865
7566,7566,David Williams,1994-95,27.0,4,20,56,56,5,15,20,74.0,,152,9,51,60,225.0,84,6.48,76,407,2545,10.7,0.3181829
7567,7567,David Williams,1995-96,28.0,5,4,21,21,2,2,4,30.0,,173,11,53,64,255.0,48,5.97,37,209,1408,10.2,0.28533965
7568,7568,David Wolf,2015-16,26.0,2,0,3,3,0,0,0,1.0,28.0,3,0,0,0,1.0,82,5.32,47,251,2453,8.9,0.15313554
7569,7569,Davis Drewiske,2009-10,25.0,2,3,17,17,0,3,3,21.0,294.0,17,0,3,3,21.0,82,5.7,65,341,2477,9.4,0.20979756
7570,7570,Davis Drewiske,2010-11,26.0,3,8,42,42,1,7,8,32.0,640.0,59,1,10,11,53.0,82,5.53,56,304,2486,9.1,0.1406166
7571,7571,Davis Drewiske,2011-12,27.0,4,5,38,38,0,5,5,27.0,545.0,97,1,15,16,80.0,82,5.46,52,291,2492,9.0,0.12750715
7572,7572,Davis Drewiske,2012-13,28.0,5,2,9,9,2,0,2,11.0,113.0,106,3,15,18,91.0,82,5.32,47,271,2439,8.9,0.20052493
7573,7573,Davis Drewiske,2013-14,29.0,6,7,29,29,2,5,7,28.0,441.0,135,5,20,25,119.0,48,5.31,29,160,1399,9.1,0.19817838
7574,7574,Davis Payne,1996-97,26.0,2,0,7,7,0,0,0,2.0,,7,0,0,0,2.0,82,6.29,74,413,2481,10.4,0.15552464
7575,7575,Davis Payne,1997-98,27.0,3,1,15,15,0,1,1,8.0,,22,0,1,1,10.0,82,5.83,55,336,2444,9.8,0.14978632
7576,7576,Daymond Langkow,1996-97,20.0,2,1,4,4,0,1,1,4.0,,4,0,1,1,4.0,82,6.29,74,413,2481,10.4,0.26479906
7577,7577,Daymond Langkow,1997-98,21.0,3,28,79,79,15,13,28,170.0,,83,15,14,29,174.0,82,5.83,55,336,2444,9.8,0.45673877
7578,7578,Daymond Langkow,1998-99,22.0,4,22,68,68,8,14,22,156.0,,151,23,28,51,330.0,82,5.28,57,380,2242,9.6,0.38164455
7579,7579,Daymond Langkow,1999-00,23.0,5,33,78,78,14,19,33,149.0,1229.0,229,37,47,84,479.0,82,5.27,57,359,2285,9.4,0.49483338
7580,7580,Daymond Langkow,2000-01,24.0,6,50,82,82,18,32,50,222.0,1390.0,311,55,79,134,701.0,82,5.49,53,331,2294,9.8,0.6282179
7581,7581,Daymond Langkow,2001-02,25.0,7,54,71,71,13,41,54,190.0,1323.0,382,68,120,188,891.0,82,5.51,63,376,2272,9.9,0.7110518
7582,7582,Daymond Langkow,2002-03,26.0,8,62,80,80,27,35,62,171.0,1534.0,462,95,155,250,1062.0,82,5.24,53,338,2262,9.5,0.7391078
7583,7583,Daymond Langkow,2003-04,27.0,9,52,82,82,20,32,52,196.0,1722.0,544,115,187,302,1258.0,82,5.31,60,363,2326,9.4,0.63129026
7584,7584,Daymond Langkow,2004-05,28.0,10,52,81,81,21,31,52,174.0,1711.0,625,136,218,354,1432.0,82,5.14,57,348,2300,9.2,0.6770237
7585,7585,Daymond Langkow,2006-07,30.0,11,59,82,82,25,34,59,171.0,1485.0,707,161,252,413,1603.0,82,6.05,85,480,2458,10.1,0.67151546
7586,7586,Daymond Langkow,2007-08,31.0,12,77,81,81,33,44,77,247.0,1630.0,788,194,296,490,1850.0,82,5.76,70,398,2426,9.7,0.79053754
7587,7587,Daymond Langkow,2008-09,32.0,13,65,80,80,30,35,65,201.0,1506.0,868,224,331,555,2051.0,82,5.44,62,351,2383,9.4,0.6983374
7588,7588,Daymond Langkow,2009-10,33.0,14,49,73,73,21,28,49,161.0,1255.0,941,245,359,604,2212.0,82,5.7,65,341,2477,9.4,0.5474752
7589,7589,Daymond Langkow,2010-11,34.0,15,37,72,72,14,23,37,126.0,1362.0,1013,259,382,641,2338.0,82,5.53,56,304,2486,9.1,0.41569546
7590,7590,Daymond Langkow,2011-12,35.0,16,1,4,4,0,1,1,6.0,59.0,1017,259,383,642,2344.0,82,5.46,52,291,2492,9.0,0.3003469
7591,7591,Daymond Langkow,2012-13,36.0,17,30,73,73,11,19,30,112.0,1150.0,1090,270,402,672,2456.0,82,5.32,47,271,2439,8.9,0.33307597
7592,7592,Dean Arsene,2010-11,30.0,2,0,13,13,0,0,0,4.0,168.0,13,0,0,0,4.0,82,5.53,56,304,2486,9.1,0.14868
7593,7593,Dean Chynoweth,1989-90,21.0,2,0,6,6,0,0,0,0.0,,6,0,0,0,0.0,80,7.48,85,403,2430,12.3,0.19974166
7594,7594,Dean Chynoweth,1990-91,22.0,3,2,20,20,0,2,2,8.0,,26,0,2,2,8.0,80,7.37,76,367,2421,12.2,0.16746959
7595,7595,Dean Chynoweth,1991-92,23.0,4,2,25,25,1,1,2,14.0,,51,1,3,4,22.0,80,6.91,71,366,2385,11.6,0.15050834
7596,7596,Dean Chynoweth,1992-93,24.0,5,1,11,11,1,0,1,6.0,,62,2,3,5,28.0,80,6.96,77,402,2440,11.4,0.1842215
7597,7597,Dean Chynoweth,1994-95,26.0,6,4,39,39,0,4,4,26.0,,101,2,7,9,54.0,84,6.48,76,407,2545,10.7,0.118701905
7598,7598,Dean Chynoweth,1995-96,27.0,7,2,32,32,0,2,2,22.0,,133,2,9,11,76.0,48,5.97,37,209,1408,10.2,0.10778949
7599,7599,Dean Chynoweth,1996-97,28.0,8,8,49,49,2,6,8,38.0,,182,4,15,19,114.0,82,6.29,74,413,2481,10.4,0.13063514
7600,7600,Dean Chynoweth,1997-98,29.0,9,3,57,57,0,3,3,30.0,,239,4,18,22,144.0,82,5.83,55,336,2444,9.8,0.084572494
7601,7601,Dean Chynoweth,1998-99,30.0,10,0,2,2,0,0,0,1.0,,241,4,18,22,145.0,82,5.28,57,380,2242,9.6,0.12318027
7602,7602,Dean Clark,1984-85,21.0,2,0,1,1,0,0,0,0.0,,1,0,0,0,0.0,80,7.89,74,336,2448,12.9,0.22589162
7603,7603,Dean Defazio,1984-85,21.0,2,2,22,22,0,2,2,12.0,,22,0,2,2,12.0,80,7.89,74,336,2448,12.9,0.24411976
7604,7604,Dean Evason,1984-85,20.0,2,0,2,2,0,0,0,0.0,,2,0,0,0,0.0,80,7.89,74,336,2448,12.9,0.27148372
7605,7605,Dean Evason,1985-86,21.0,3,7,17,17,3,4,7,21.0,,19,3,4,7,21.0,80,7.77,71,321,2447,12.7,0.41222996
7606,7606,Dean Evason,1986-87,22.0,4,48,55,55,20,28,48,101.0,,74,23,32,55,122.0,80,7.94,82,370,2484,12.8,0.6990576
7607,7607,Dean Evason,1987-88,23.0,5,59,80,80,22,37,59,123.0,,154,45,69,114,245.0,80,7.34,72,344,2400,12.2,0.69163173
7608,7608,Dean Evason,1988-89,24.0,6,28,77,77,10,18,28,126.0,,231,55,87,142,371.0,80,7.43,89,437,2435,12.2,0.4297533
7609,7609,Dean Evason,1989-90,25.0,7,28,67,67,11,17,28,95.0,,298,66,104,170,466.0,80,7.48,85,403,2430,12.3,0.45407742
7610,7610,Dean Evason,1990-91,26.0,8,43,78,78,18,25,43,150.0,,376,84,129,213,616.0,80,7.37,76,367,2421,12.2,0.54752654
7611,7611,Dean Evason,1991-92,27.0,9,29,75,75,6,23,29,85.0,,451,90,152,242,701.0,80,6.91,71,366,2385,11.6,0.37925348
7612,7612,Dean Evason,1992-93,28.0,10,26,74,74,11,15,26,88.0,,525,101,167,268,789.0,80,6.96,77,402,2440,11.4,0.33842397
7613,7613,Dean Evason,1993-94,29.0,11,31,84,84,12,19,31,107.0,,609,113,186,299,896.0,84,7.25,87,443,2603,11.7,0.3638462
7614,7614,Dean Evason,1994-95,30.0,12,44,80,80,11,33,44,118.0,,689,124,219,343,1014.0,84,6.48,76,407,2545,10.7,0.42500773
7615,7615,Dean Evason,1995-96,31.0,13,15,47,47,8,7,15,53.0,,736,132,226,358,1067.0,48,5.97,37,209,1408,10.2,0.33722973
7616,7616,Dean Evason,1996-97,32.0,14,14,67,67,7,7,14,68.0,,803,139,233,372,1135.0,82,6.29,74,413,2481,10.4,0.18965492
7617,7617,Dean Hopkins,1980-81,21.0,2,14,60,60,8,6,14,57.0,,60,8,6,14,57.0,80,7.03,61,280,2352,12.0,0.3116082
7618,7618,Dean Hopkins,1981-82,22.0,3,26,67,67,8,18,26,60.0,,127,16,24,40,117.0,80,7.69,77,340,2441,12.6,0.37673885
7619,7619,Dean Hopkins,1982-83,23.0,4,15,41,41,2,13,15,55.0,,168,18,37,55,172.0,80,8.03,73,320,2489,12.9,0.3688047
7620,7620,Dean Hopkins,1983-84,24.0,5,17,49,49,5,12,17,50.0,,217,23,49,72,222.0,80,7.73,71,310,2444,12.7,0.3594361
7621,7621,Dean Hopkins,1986-87,27.0,6,0,1,1,0,0,0,0.0,,218,23,49,72,222.0,80,7.94,82,370,2484,12.8,0.29268935
7622,7622,Dean Hopkins,1989-90,30.0,7,2,5,5,0,2,2,6.0,,223,23,51,74,228.0,80,7.48,85,403,2430,12.3,0.28333336
7623,7623,Dean Jenkins,1984-85,25.0,2,0,5,5,0,0,0,3.0,,5,0,0,0,3.0,80,7.89,74,336,2448,12.9,0.21237499
7624,7624,Dean Kennedy,1983-84,21.0,2,12,55,55,0,12,12,53.0,,55,0,12,12,53.0,80,7.73,71,310,2444,12.7,0.26893783
7625,7625,Dean Kennedy,1984-85,22.0,3,6,37,37,1,5,6,22.0,,92,1,17,18,75.0,80,7.89,74,336,2448,12.9,0.1921398
7626,7626,Dean Kennedy,1986-87,24.0,4,12,78,78,2,10,12,59.0,,170,3,27,30,134.0,80,7.94,82,370,2484,12.8,0.20810443
7627,7627,Dean Kennedy,1987-88,25.0,5,20,66,66,6,14,20,59.0,,236,9,41,50,193.0,80,7.34,72,344,2400,12.2,0.2822014
7628,7628,Dean Kennedy,1988-89,26.0,6,12,58,58,1,11,12,40.0,,294,10,52,62,233.0,80,7.43,89,437,2435,12.2,0.19790974
7629,7629,Dean Kennedy,1989-90,27.0,7,14,67,67,3,11,14,45.0,,361,13,63,76,278.0,80,7.48,85,403,2430,12.3,0.21339035
7630,7630,Dean Kennedy,1990-91,28.0,8,14,80,80,2,12,14,51.0,,441,15,75,90,329.0,80,7.37,76,367,2421,12.2,0.19968995
7631,7631,Dean Kennedy,1991-92,29.0,9,12,64,64,4,8,12,46.0,,505,19,83,102,375.0,80,6.91,71,366,2385,11.6,0.20503089
7632,7632,Dean Kennedy,1992-93,30.0,10,6,18,18,2,4,6,20.0,,523,21,87,108,395.0,80,6.96,77,402,2440,11.4,0.24955162
7633,7633,Dean Kennedy,1993-94,31.0,11,8,78,78,1,7,8,50.0,,601,22,94,116,445.0,84,7.25,87,443,2603,11.7,0.12758017
7634,7634,Dean Kennedy,1994-95,32.0,12,10,76,76,2,8,10,38.0,,677,24,102,126,483.0,84,6.48,76,407,2545,10.7,0.13389781
7635,7635,Dean Kennedy,1995-96,33.0,13,10,40,40,2,8,10,45.0,,717,26,110,136,528.0,48,5.97,37,209,1408,10.2,0.21290374
7636,7636,Dean Kolstad,1989-90,21.0,2,6,25,25,1,5,6,41.0,,25,1,5,6,41.0,80,7.48,85,403,2430,12.3,0.33384514
7637,7637,Dean Kolstad,1991-92,23.0,3,0,5,5,0,0,0,9.0,,30,1,5,6,50.0,80,6.91,71,366,2385,11.6,0.20143706
7638,7638,Dean Kolstad,1993-94,25.0,4,2,10,10,0,2,2,22.0,,40,1,7,8,72.0,84,7.25,87,443,2603,11.7,0.22480977
7639,7639,Dean Kukan,2016-17,23.0,2,0,8,8,0,0,0,3.0,139.0,8,0,0,0,3.0,82,5.34,48,255,2438,9.0,0.17507556
7640,7640,Dean Kukan,2018-19,25.0,3,4,11,11,0,4,4,12.0,136.0,19,0,4,4,15.0,82,5.86,50,250,2620,9.2,0.18322334
7641,7641,Dean Kukan,2019-20,26.0,4,5,25,25,0,5,5,16.0,337.0,44,0,9,9,31.0,82,5.96,47,239,2579,9.5,0.15430471
7642,7642,Dean Kukan,2020-21,27.0,5,5,33,33,1,4,5,51.0,527.0,77,1,13,14,82.0,70,5.96,42,208,2192,9.5,0.19545868
7643,7643,Dean Malkoc,1996-97,27.0,2,2,41,41,0,2,2,8.0,,41,0,2,2,8.0,82,6.29,74,413,2481,10.4,0.09451237
7644,7644,Dean Malkoc,1997-98,28.0,3,0,33,33,0,0,0,7.0,,74,0,2,2,15.0,82,5.83,55,336,2444,9.8,0.083052695
7645,7645,Dean Malkoc,1998-99,29.0,4,1,40,40,1,0,1,15.0,,114,1,2,3,30.0,82,5.28,57,380,2242,9.6,0.08760193
7646,7646,Dean Malkoc,1999-00,30.0,5,1,2,2,0,1,1,1.0,31.0,116,1,3,4,31.0,82,5.27,57,359,2285,9.4,0.13087061
7647,7647,Dean McAmmond,1992-93,19.0,2,2,5,5,0,2,2,4.0,,5,0,2,2,4.0,80,6.96,77,402,2440,11.4,0.30838978
7648,7648,Dean McAmmond,1994-95,21.0,3,27,45,45,6,21,27,52.0,,50,6,23,29,56.0,84,6.48,76,407,2545,10.7,0.47768074
7649,7649,Dean McAmmond,1995-96,22.0,4,0,6,6,0,0,0,3.0,,56,6,23,29,59.0,48,5.97,37,209,1408,10.2,0.23081347
7650,7650,Dean McAmmond,1996-97,23.0,5,30,53,53,15,15,30,79.0,,109,21,38,59,138.0,82,6.29,74,413,2481,10.4,0.49943173
7651,7651,Dean McAmmond,1997-98,24.0,6,29,57,57,12,17,29,106.0,,166,33,55,88,244.0,82,5.83,55,336,2444,9.8,0.4548601
7652,7652,Dean McAmmond,1998-99,25.0,7,50,77,77,19,31,50,128.0,,243,52,86,138,372.0,82,5.28,57,380,2242,9.6,0.57704896
7653,7653,Dean McAmmond,1999-00,26.0,8,30,77,77,10,20,30,138.0,1115.0,320,62,106,168,510.0,82,5.27,57,359,2285,9.4,0.47984028
7654,7654,Dean McAmmond,2000-01,27.0,9,32,76,76,14,18,32,118.0,1248.0,396,76,124,200,628.0,82,5.49,53,331,2294,9.8,0.4177819
7655,7655,Dean McAmmond,2001-02,28.0,10,28,71,71,11,17,28,112.0,1065.0,467,87,141,228,740.0,82,5.51,63,376,2272,9.9,0.37501514
7656,7656,Dean McAmmond,2002-03,29.0,11,51,73,73,21,30,51,152.0,1382.0,540,108,171,279,892.0,82,5.24,53,338,2262,9.5,0.5667991
7657,7657,Dean McAmmond,2003-04,30.0,12,18,41,41,10,8,18,72.0,591.0,581,118,179,297,964.0,82,5.31,60,363,2326,9.4,0.41869885
7658,7658,Dean McAmmond,2004-05,31.0,13,30,64,64,17,13,30,101.0,1080.0,645,135,192,327,1065.0,82,5.14,57,348,2300,9.2,0.5223727
7659,7659,Dean McAmmond,2006-07,33.0,14,37,78,78,15,22,37,116.0,1251.0,723,150,214,364,1181.0,82,6.05,85,480,2458,10.1,0.39477956
7660,7660,Dean McAmmond,2007-08,34.0,15,29,81,81,14,15,29,86.0,901.0,804,164,229,393,1267.0,82,5.76,70,398,2426,9.7,0.2967955
7661,7661,Dean McAmmond,2008-09,35.0,16,22,68,68,9,13,22,67.0,785.0,872,173,242,415,1334.0,82,5.44,62,351,2383,9.4,0.24215353
7662,7662,Dean McAmmond,2009-10,36.0,17,16,62,62,5,11,16,59.0,698.0,934,178,253,431,1393.0,82,5.7,65,341,2477,9.4,0.21681869
7663,7663,Dean McAmmond,2010-11,37.0,18,17,62,62,8,9,17,87.0,797.0,996,186,262,448,1480.0,82,5.53,56,304,2486,9.1,0.24261966
7664,7664,Dean Melanson,1995-96,22.0,2,0,5,5,0,0,0,1.0,,5,0,0,0,1.0,48,5.97,37,209,1408,10.2,0.19276294
7665,7665,Dean Melanson,2002-03,29.0,3,0,4,4,0,0,0,6.0,50.0,9,0,0,0,7.0,82,5.24,53,338,2262,9.5,0.17334622
7666,7666,Dean Morton,1990-91,22.0,2,1,1,1,1,0,1,2.0,,1,1,0,1,2.0,80,7.37,76,367,2421,12.2,0.2760867
7667,7667,Dean Sylvester,1999-00,27.0,2,0,1,1,0,0,0,1.0,15.0,1,0,0,0,1.0,82,5.27,57,359,2285,9.4,0.17560256
7668,7668,Dean Sylvester,2000-01,28.0,3,26,52,52,16,10,26,98.0,714.0,53,16,10,26,99.0,82,5.49,53,331,2294,9.8,0.4696232
7669,7669,Dean Sylvester,2001-02,29.0,4,11,43,43,5,6,11,82.0,605.0,96,21,16,37,181.0,82,5.51,63,376,2272,9.9,0.27995414
7670,7670,Denis Arkhipov,2001-02,22.0,2,13,40,40,6,7,13,42.0,397.0,40,6,7,13,42.0,82,5.51,63,376,2272,9.9,0.3113777
7671,7671,Denis Arkhipov,2002-03,23.0,3,42,82,82,20,22,42,118.0,1289.0,122,26,29,55,160.0,82,5.24,53,338,2262,9.5,0.49626258
7672,7672,Denis Arkhipov,2003-04,24.0,4,35,79,79,11,24,35,148.0,1196.0,201,37,53,90,308.0,82,5.31,60,363,2326,9.4,0.46987683
7673,7673,Denis Arkhipov,2004-05,25.0,5,21,72,72,9,12,21,91.0,1006.0,273,46,65,111,399.0,82,5.14,57,348,2300,9.2,0.36737764
7674,7674,Denis Arkhipov,2007-08,28.0,6,27,79,79,10,17,27,112.0,1241.0,352,56,82,138,511.0,82,5.76,70,398,2426,9.7,0.34378082
7675,7675,Denis Chasse,1994-95,24.0,2,1,3,3,0,1,1,5.0,,3,0,1,1,5.0,84,6.48,76,407,2545,10.7,0.19577327
7676,7676,Denis Chasse,1995-96,25.0,3,16,47,47,7,9,16,48.0,,50,7,10,17,53.0,48,5.97,37,209,1408,10.2,0.32918108
7677,7677,Denis Chasse,1996-97,26.0,4,3,60,60,3,0,3,31.0,,110,10,10,20,84.0,82,6.29,74,413,2481,10.4,0.15096769
7678,7678,Denis Chasse,1997-98,27.0,5,5,22,22,1,4,5,12.0,,132,11,14,25,96.0,82,5.83,55,336,2444,9.8,0.12291017
7679,7679,Denis Chervyakov,1993-94,23.0,2,0,2,2,0,0,0,2.0,,2,0,0,0,2.0,84,7.25,87,443,2603,11.7,0.21930698
7680,7680,Denis Cyr,1981-82,20.0,2,5,10,10,1,4,5,10.0,,10,1,4,5,10.0,80,7.69,77,340,2441,12.6,0.35327697
7681,7681,Denis Cyr,1982-83,21.0,3,22,45,45,12,10,22,71.0,,55,13,14,27,81.0,80,8.03,73,320,2489,12.9,0.4605552
7682,7682,Denis Cyr,1983-84,22.0,4,17,52,52,8,9,17,51.0,,107,21,23,44,132.0,80,7.73,71,310,2444,12.7,0.4259011
7683,7683,Denis Cyr,1984-85,23.0,5,25,46,46,12,13,25,72.0,,153,33,36,69,204.0,80,7.89,74,336,2448,12.9,0.5139622
7684,7684,Denis Cyr,1985-86,24.0,6,8,9,9,5,3,8,12.0,,162,38,39,77,216.0,80,7.77,71,321,2447,12.7,0.42707357
7685,7685,Denis Cyr,1986-87,25.0,7,7,31,31,3,4,7,21.0,,193,41,43,84,237.0,80,7.94,82,370,2484,12.8,0.2829838
7686,7686,Denis Gauthier,1998-99,22.0,2,0,10,10,0,0,0,3.0,,10,0,0,0,3.0,82,5.28,57,380,2242,9.6,0.17240891
7687,7687,Denis Gauthier,1999-00,23.0,3,7,55,55,3,4,7,40.0,698.0,65,3,4,7,43.0,82,5.27,57,359,2285,9.4,0.19044477
7688,7688,Denis Gauthier,2000-01,24.0,4,2,39,39,1,1,2,29.0,754.0,104,4,5,9,72.0,82,5.49,53,331,2294,9.8,0.14393017
7689,7689,Denis Gauthier,2001-02,25.0,5,8,62,62,2,6,8,33.0,1030.0,166,6,11,17,105.0,82,5.51,63,376,2272,9.9,0.14226124
7690,7690,Denis Gauthier,2002-03,26.0,6,13,66,66,5,8,13,76.0,1275.0,232,11,19,30,181.0,82,5.24,53,338,2262,9.5,0.20168996
7691,7691,Denis Gauthier,2003-04,27.0,7,12,72,72,1,11,12,50.0,1431.0,304,12,30,42,231.0,82,5.31,60,363,2326,9.4,0.13922542
7692,7692,Denis Gauthier,2004-05,28.0,8,16,80,80,1,15,16,90.0,1498.0,384,13,45,58,321.0,82,5.14,57,348,2300,9.2,0.2055985
7693,7693,Denis Gauthier,2006-07,30.0,9,11,62,62,2,9,11,56.0,1024.0,446,15,54,69,377.0,82,6.05,85,480,2458,10.1,0.15267321
7694,7694,Denis Gauthier,2007-08,31.0,10,4,43,43,0,4,4,23.0,716.0,489,15,58,73,400.0,82,5.76,70,398,2426,9.7,0.10264316
7695,7695,Denis Gauthier,2009-10,33.0,11,4,65,65,2,2,4,36.0,945.0,554,17,60,77,436.0,82,5.7,65,341,2477,9.4,0.11853483
7696,7696,Denis Grebeshkov,2004-05,21.0,2,1,4,4,0,1,1,5.0,74.0,4,0,1,1,5.0,82,5.14,57,348,2300,9.2,0.30835685
7697,7697,Denis Grebeshkov,2006-07,23.0,3,5,29,29,0,5,5,24.0,483.0,33,0,6,6,29.0,82,6.05,85,480,2458,10.1,0.2009925
7698,7698,Denis Grebeshkov,2008-09,25.0,4,18,71,71,3,15,18,34.0,1198.0,104,3,21,24,63.0,82,5.44,62,351,2383,9.4,0.22169209
7699,7699,Denis Grebeshkov,2009-10,26.0,5,39,72,72,7,32,39,62.0,1524.0,176,10,53,63,125.0,82,5.7,65,341,2477,9.4,0.43018168
7700,7700,Denis Grebeshkov,2010-11,27.0,6,21,51,51,7,14,21,47.0,1092.0,227,17,67,84,172.0,82,5.53,56,304,2486,9.1,0.32527226
7701,7701,Denis Grebeshkov,2014-15,31.0,7,1,7,7,0,1,1,3.0,96.0,234,17,68,85,175.0,82,5.34,48,269,2463,8.9,0.18565562
7702,7702,Denis Gurianov,2017-18,20.0,2,0,1,1,0,0,0,0.0,13.0,1,0,0,0,0.0,82,5.45,47,245,2478,9.0,0.2782966
7703,7703,Denis Gurianov,2019-20,22.0,3,4,21,21,1,3,4,23.0,228.0,22,1,3,4,23.0,82,5.96,47,239,2579,9.5,0.22131082
7704,7704,Denis Gurianov,2020-21,23.0,4,29,64,64,20,9,29,132.0,831.0,86,21,12,33,155.0,70,5.96,42,208,2192,9.5,0.4946257
7705,7705,Denis Hamel,2000-01,23.0,2,1,3,3,1,0,1,3.0,29.0,3,1,0,1,3.0,82,5.49,53,331,2294,9.8,0.22153437
7706,7706,Denis Hamel,2001-02,24.0,3,11,41,41,8,3,11,55.0,450.0,44,9,3,12,58.0,82,5.51,63,376,2272,9.9,0.28691542
7707,7707,Denis Hamel,2002-03,25.0,4,8,61,61,2,6,8,80.0,671.0,105,11,9,20,138.0,82,5.24,53,338,2262,9.5,0.19647428
7708,7708,Denis Hamel,2003-04,26.0,5,2,25,25,2,0,2,41.0,317.0,130,13,9,22,179.0,82,5.31,60,363,2326,9.4,0.19052541
7709,7709,Denis Hamel,2004-05,27.0,6,0,5,5,0,0,0,6.0,31.0,135,13,9,22,185.0,82,5.14,57,348,2300,9.2,0.17373607
7710,7710,Denis Hamel,2006-07,29.0,7,1,4,4,1,0,1,9.0,37.0,139,14,9,23,194.0,82,6.05,85,480,2458,10.1,0.16790944
7711,7711,Denis Hamel,2007-08,30.0,8,8,53,53,5,3,8,42.0,322.0,192,19,12,31,236.0,82,5.76,70,398,2426,9.7,0.14158374
7712,7712,Denis Larocque,1988-89,21.0,2,1,8,8,0,1,1,2.0,,8,0,1,1,2.0,80,7.43,89,437,2435,12.2,0.28029758
7713,7713,Denis Malgin,2017-18,21.0,2,10,47,47,6,4,10,67.0,528.0,47,6,4,10,67.0,82,5.45,47,245,2478,9.0,0.3292949
7714,7714,Denis Malgin,2018-19,22.0,3,22,51,51,11,11,22,79.0,707.0,98,17,15,32,146.0,82,5.86,50,250,2620,9.2,0.43013757
7715,7715,Denis Malgin,2019-20,23.0,4,16,50,50,7,9,16,66.0,644.0,148,24,24,48,212.0,82,5.96,47,239,2579,9.5,0.35750744
7716,7716,Denis Malgin,2020-21,24.0,5,12,44,44,4,8,12,50.0,528.0,192,28,32,60,262.0,70,5.96,42,208,2192,9.5,0.30876243
7717,7717,Denis Pederson,1996-97,21.0,2,4,10,10,3,1,4,6.0,,10,3,1,4,6.0,82,6.29,74,413,2481,10.4,0.3269347
7718,7718,Denis Pederson,1997-98,22.0,3,32,70,70,12,20,32,106.0,,80,15,21,36,112.0,82,5.83,55,336,2444,9.8,0.46475196
7719,7719,Denis Pederson,1998-99,23.0,4,28,80,80,15,13,28,135.0,,160,30,34,64,247.0,82,5.28,57,380,2242,9.6,0.43329343
7720,7720,Denis Pederson,1999-00,24.0,5,23,76,76,11,12,23,145.0,1164.0,236,41,46,87,392.0,82,5.27,57,359,2285,9.4,0.3784553
7721,7721,Denis Pederson,2000-01,25.0,6,11,47,47,6,5,11,56.0,527.0,283,47,51,98,448.0,82,5.49,53,331,2294,9.8,0.2734875
7722,7722,Denis Pederson,2001-02,26.0,7,12,61,61,4,8,12,70.0,713.0,344,51,59,110,518.0,82,5.51,63,376,2272,9.9,0.22766688
7723,7723,Denis Pederson,2002-03,27.0,8,8,48,48,2,6,8,42.0,441.0,392,53,65,118,560.0,82,5.24,53,338,2262,9.5,0.18825617
7724,7724,Denis Pederson,2003-04,28.0,9,10,43,43,4,6,10,64.0,551.0,435,57,71,128,624.0,82,5.31,60,363,2326,9.4,0.24159944
7725,7725,Denis Savard,1981-82,20.0,2,75,76,76,28,47,75,159.0,,76,28,47,75,159.0,80,7.69,77,340,2441,12.6,1.0495896
7726,7726,Denis Savard,1982-83,21.0,3,119,80,80,32,87,119,231.0,,156,60,134,194,390.0,80,8.03,73,320,2489,12.9,1.4100944
7727,7727,Denis Savard,1983-84,22.0,4,121,78,78,35,86,121,212.0,,234,95,220,315,602.0,80,7.73,71,310,2444,12.7,1.4319463
7728,7728,Denis Savard,1984-85,23.0,5,94,75,75,37,57,94,211.0,,309,132,277,409,813.0,80,7.89,74,336,2448,12.9,1.2139192
7729,7729,Denis Savard,1985-86,24.0,6,105,79,79,38,67,105,265.0,,388,170,344,514,1078.0,80,7.77,71,321,2447,12.7,1.3944533
7730,7730,Denis Savard,1986-87,25.0,7,116,80,80,47,69,116,281.0,,468,217,413,630,1359.0,80,7.94,82,370,2484,12.8,1.1943626
7731,7731,Denis Savard,1987-88,26.0,8,90,70,70,40,50,90,235.0,,538,257,463,720,1594.0,80,7.34,72,344,2400,12.2,1.339186
7732,7732,Denis Savard,1988-89,27.0,9,131,80,80,44,87,131,270.0,,618,301,550,851,1864.0,80,7.43,89,437,2435,12.2,1.5289096
7733,7733,Denis Savard,1989-90,28.0,10,82,58,58,23,59,82,182.0,,676,324,609,933,2046.0,80,7.48,85,403,2430,12.3,1.2976693
7734,7734,Denis Savard,1990-91,29.0,11,80,60,60,27,53,80,181.0,,736,351,662,1013,2227.0,80,7.37,76,367,2421,12.2,1.0377235
7735,7735,Denis Savard,1991-92,30.0,12,59,70,70,28,31,59,187.0,,806,379,693,1072,2414.0,80,6.91,71,366,2385,11.6,0.9374405
7736,7736,Denis Savard,1992-93,31.0,13,70,77,77,28,42,70,174.0,,883,407,735,1142,2588.0,80,6.96,77,402,2440,11.4,0.8663848
7737,7737,Denis Savard,1993-94,32.0,14,50,63,63,16,34,50,99.0,,946,423,769,1192,2687.0,84,7.25,87,443,2603,11.7,0.7265187
7738,7738,Denis Savard,1994-95,33.0,15,46,74,74,18,28,46,181.0,,1020,441,797,1238,2868.0,84,6.48,76,407,2545,10.7,0.61080134
7739,7739,Denis Savard,1995-96,34.0,16,25,43,43,10,15,25,82.0,,1063,451,812,1263,2950.0,48,5.97,37,209,1408,10.2,0.59808326
7740,7740,Denis Savard,1996-97,35.0,17,48,69,69,13,35,48,110.0,,1132,464,847,1311,3060.0,82,6.29,74,413,2481,10.4,0.6105658
7741,7741,Denis Savard,1997-98,36.0,18,27,64,64,9,18,27,82.0,,1196,473,865,1338,3142.0,82,5.83,55,336,2444,9.8,0.41961357
7742,7742,Denis Shvidki,2001-02,21.0,2,16,43,43,6,10,16,28.0,445.0,43,6,10,16,28.0,82,5.51,63,376,2272,9.9,0.3369106
7743,7743,Denis Shvidki,2002-03,22.0,3,3,8,8,1,2,3,11.0,96.0,51,7,12,19,39.0,82,5.24,53,338,2262,9.5,0.27860135
7744,7744,Denis Shvidki,2003-04,23.0,4,6,23,23,4,2,6,29.0,327.0,74,11,14,25,68.0,82,5.31,60,363,2326,9.4,0.29380554
7745,7745,Denis Shvidki,2004-05,24.0,5,0,2,2,0,0,0,4.0,28.0,76,11,14,25,72.0,82,5.14,57,348,2300,9.2,0.2177642
7746,7746,Denis Tolpeko,2008-09,24.0,2,6,26,26,1,5,6,24.0,215.0,26,1,5,6,24.0,82,5.44,62,351,2383,9.4,0.21360207
7747,7747,Denis Tsygurov,1994-95,23.0,2,0,8,8,0,0,0,3.0,,8,0,0,0,3.0,84,6.48,76,407,2545,10.7,0.1789347
7748,7748,Denis Tsygurov,1995-96,24.0,3,0,25,25,0,0,0,20.0,,33,0,0,0,23.0,48,5.97,37,209,1408,10.2,0.15951073
7749,7749,Denis Tsygurov,1996-97,25.0,4,6,18,18,1,5,6,21.0,,51,1,5,6,44.0,82,6.29,74,413,2481,10.4,0.21132085
7750,7750,Dennis Bonvie,1995-96,22.0,2,0,2,2,0,0,0,0.0,,2,0,0,0,0.0,48,5.97,37,209,1408,10.2,0.18721476
7751,7751,Dennis Bonvie,1996-97,23.0,3,0,8,8,0,0,0,0.0,,10,0,0,0,0.0,82,6.29,74,413,2481,10.4,0.14796212
7752,7752,Dennis Bonvie,1998-99,25.0,4,0,4,4,0,0,0,0.0,,14,0,0,0,0.0,82,5.28,57,380,2242,9.6,0.13030654
7753,7753,Dennis Bonvie,1999-00,26.0,5,0,11,11,0,0,0,1.0,44.0,25,0,0,0,1.0,82,5.27,57,359,2285,9.4,0.1324892
7754,7754,Dennis Bonvie,2000-01,27.0,6,0,28,28,0,0,0,6.0,91.0,53,0,0,0,7.0,82,5.49,53,331,2294,9.8,0.08386463
7755,7755,Dennis Bonvie,2001-02,28.0,7,0,3,3,0,0,0,1.0,10.0,56,0,0,0,8.0,82,5.51,63,376,2272,9.9,0.113660336
7756,7756,Dennis Bonvie,2002-03,29.0,8,3,23,23,1,2,3,5.0,117.0,79,1,2,3,13.0,82,5.24,53,338,2262,9.5,0.09450704
7757,7757,Dennis Bonvie,2003-04,30.0,9,0,12,12,0,0,0,3.0,37.0,91,1,2,3,16.0,82,5.31,60,363,2326,9.4,0.10431358
7758,7758,Dennis Bonvie,2004-05,31.0,10,0,1,1,0,0,0,1.0,7.0,92,1,2,3,17.0,82,5.14,57,348,2300,9.2,0.13629565
7759,7759,Dennis Cholowski,2019-20,21.0,2,16,52,52,7,9,16,71.0,949.0,52,7,9,16,71.0,82,5.96,47,239,2579,9.5,0.36172795
7760,7760,Dennis Cholowski,2020-21,22.0,3,8,36,36,2,6,8,51.0,692.0,88,9,15,24,122.0,70,5.96,42,208,2192,9.5,0.32998973
7761,7761,Dennis Everberg,2015-16,24.0,2,12,55,55,3,9,12,62.0,649.0,55,3,9,12,62.0,82,5.32,47,251,2453,8.9,0.19987321
7762,7762,Dennis Everberg,2016-17,25.0,3,0,15,15,0,0,0,9.0,134.0,70,3,9,12,71.0,82,5.34,48,255,2438,9.0,0.14338225
7763,7763,Dennis Gilbert,2019-20,23.0,2,0,1,1,0,0,0,0.0,13.0,1,0,0,0,0.0,82,5.96,47,239,2579,9.5,0.1702128
7764,7764,Dennis Gilbert,2020-21,24.0,3,3,21,21,1,2,3,12.0,330.0,22,1,2,3,12.0,70,5.96,42,208,2192,9.5,0.16951391
7765,7765,Dennis Rasmussen,2016-17,26.0,2,9,44,44,4,5,9,42.0,403.0,44,4,5,9,42.0,82,5.34,48,255,2438,9.0,0.16405657
7766,7766,Dennis Rasmussen,2017-18,27.0,3,8,68,68,4,4,8,77.0,804.0,112,8,9,17,119.0,82,5.45,47,245,2478,9.0,0.19152415
7767,7767,Dennis Rasmussen,2018-19,28.0,4,4,27,27,1,3,4,19.0,241.0,139,9,12,21,138.0,82,5.86,50,250,2620,9.2,0.13844723
7768,7768,Dennis Seidenberg,2003-04,22.0,2,13,58,58,4,9,13,123.0,976.0,58,4,9,13,123.0,82,5.31,60,363,2326,9.4,0.29157865
7769,7769,Dennis Seidenberg,2004-05,23.0,3,0,5,5,0,0,0,14.0,87.0,63,4,9,13,137.0,82,5.14,57,348,2300,9.2,0.24861598
7770,7770,Dennis Seidenberg,2006-07,25.0,4,18,63,63,3,15,18,83.0,1070.0,126,7,24,31,220.0,82,6.05,85,480,2458,10.1,0.23700127
7771,7771,Dennis Seidenberg,2007-08,26.0,5,8,52,52,2,6,8,83.0,841.0,178,9,30,39,303.0,82,5.76,70,398,2426,9.7,0.20814428
7772,7772,Dennis Seidenberg,2008-09,27.0,6,15,47,47,0,15,15,80.0,885.0,225,9,45,54,383.0,82,5.44,62,351,2383,9.4,0.25709593
7773,7773,Dennis Seidenberg,2009-10,28.0,7,30,70,70,5,25,30,129.0,1563.0,295,14,70,84,512.0,82,5.7,65,341,2477,9.4,0.3896476
7774,7774,Dennis Seidenberg,2010-11,29.0,8,32,79,79,4,28,32,153.0,1811.0,374,18,98,116,665.0,82,5.53,56,304,2486,9.1,0.3827784
7775,7775,Dennis Seidenberg,2011-12,30.0,9,32,81,81,7,25,32,166.0,1907.0,455,25,123,148,831.0,82,5.46,52,291,2492,9.0,0.3862467
7776,7776,Dennis Seidenberg,2012-13,31.0,10,23,80,80,5,18,23,174.0,1923.0,535,30,141,171,1005.0,82,5.32,47,271,2439,8.9,0.30381668
7777,7777,Dennis Seidenberg,2013-14,32.0,11,17,46,46,4,13,17,83.0,1094.0,581,34,154,188,1088.0,48,5.31,29,160,1399,9.1,0.3196349
7778,7778,Dennis Seidenberg,2014-15,33.0,12,10,34,34,1,9,10,53.0,742.0,615,35,163,198,1141.0,82,5.34,48,269,2463,8.9,0.18911272
7779,7779,Dennis Seidenberg,2015-16,34.0,13,14,82,82,3,11,14,103.0,1812.0,697,38,174,212,1244.0,82,5.32,47,251,2453,8.9,0.17435846
7780,7780,Dennis Seidenberg,2016-17,35.0,14,12,61,61,1,11,12,66.0,1183.0,758,39,185,224,1310.0,82,5.34,48,255,2438,9.0,0.13368043
7781,7781,Dennis Seidenberg,2017-18,36.0,15,22,73,73,5,17,22,89.0,1418.0,831,44,202,246,1399.0,82,5.45,47,245,2478,9.0,0.21596897
7782,7782,Dennis Seidenberg,2018-19,37.0,16,5,28,28,0,5,5,31.0,501.0,859,44,207,251,1430.0,82,5.86,50,250,2620,9.2,0.15095308
7783,7783,Dennis Smith,1990-91,26.0,2,0,4,4,0,0,0,0.0,,4,0,0,0,0.0,80,7.37,76,367,2421,12.2,0.16962177
7784,7784,Dennis Smith,1991-92,27.0,3,0,4,4,0,0,0,1.0,,8,0,0,0,1.0,80,6.91,71,366,2385,11.6,0.163456
7785,7785,Dennis Sobchuk,1980-81,27.0,2,10,33,33,4,6,10,47.0,,33,4,6,10,47.0,80,7.03,61,280,2352,12.0,0.31178233
7786,7786,Dennis Sobchuk,1983-84,30.0,3,1,2,2,1,0,1,2.0,,35,5,6,11,49.0,80,7.73,71,310,2444,12.7,0.20820644
7787,7787,Dennis Vaske,1991-92,24.0,2,0,5,5,0,0,0,3.0,,5,0,0,0,3.0,80,6.91,71,366,2385,11.6,0.19378665
7788,7788,Dennis Vaske,1992-93,25.0,3,1,39,39,0,1,1,26.0,,44,0,1,1,29.0,80,6.96,77,402,2440,11.4,0.13808942
7789,7789,Dennis Vaske,1993-94,26.0,4,6,27,27,1,5,6,15.0,,71,1,6,7,44.0,84,7.25,87,443,2603,11.7,0.16298866
7790,7790,Dennis Vaske,1994-95,27.0,5,13,65,65,2,11,13,71.0,,136,3,17,20,115.0,84,6.48,76,407,2545,10.7,0.15792325
7791,7791,Dennis Vaske,1995-96,28.0,6,12,41,41,1,11,12,48.0,,177,4,28,32,163.0,48,5.97,37,209,1408,10.2,0.20360139
7792,7792,Dennis Vaske,1996-97,29.0,7,7,19,19,1,6,7,19.0,,196,5,34,39,182.0,82,6.29,74,413,2481,10.4,0.17107758
7793,7793,Dennis Vaske,1997-98,30.0,8,4,17,17,0,4,4,19.0,,213,5,38,43,201.0,82,5.83,55,336,2444,9.8,0.16457865
7794,7794,Dennis Vaske,1998-99,31.0,9,3,19,19,0,3,3,16.0,,232,5,41,46,217.0,82,5.28,57,380,2242,9.6,0.1360302
7795,7795,Dennis Vaske,1999-00,32.0,10,0,3,3,0,0,0,0.0,25.0,235,5,41,46,217.0,82,5.27,57,359,2285,9.4,0.1914115
7796,7796,Dennis Vial,1991-92,22.0,2,0,30,30,0,0,0,8.0,,30,0,0,0,8.0,80,6.91,71,366,2385,11.6,0.1312351
7797,7797,Dennis Vial,1992-93,23.0,3,1,27,27,1,0,1,6.0,,57,1,0,1,14.0,80,6.96,77,402,2440,11.4,0.1615018
7798,7798,Dennis Vial,1993-94,24.0,4,1,9,9,0,1,1,5.0,,66,1,1,2,19.0,84,7.25,87,443,2603,11.7,0.16361216
7799,7799,Dennis Vial,1994-95,25.0,5,7,55,55,2,5,7,37.0,,121,3,6,9,56.0,84,6.48,76,407,2545,10.7,0.14712763
7800,7800,Dennis Vial,1995-96,26.0,6,4,27,27,0,4,4,9.0,,148,3,10,13,65.0,48,5.97,37,209,1408,10.2,0.10088301
7801,7801,Dennis Vial,1996-97,27.0,7,5,64,64,1,4,5,33.0,,212,4,14,18,98.0,82,6.29,74,413,2481,10.4,0.1115129
7802,7802,Dennis Vial,1997-98,28.0,8,1,11,11,0,1,1,4.0,,223,4,15,19,102.0,82,5.83,55,336,2444,9.8,0.11574155
7803,7803,Dennis Vial,1998-99,29.0,9,0,19,19,0,0,0,9.0,,242,4,15,19,111.0,82,5.28,57,380,2242,9.6,0.08725187
7804,7804,Dennis Wideman,2006-07,23.0,2,24,67,67,8,16,24,150.0,1453.0,67,8,16,24,150.0,82,6.05,85,480,2458,10.1,0.4043038
7805,7805,Dennis Wideman,2007-08,24.0,3,25,75,75,6,19,25,122.0,1458.0,142,14,35,49,272.0,82,5.76,70,398,2426,9.7,0.34185
7806,7806,Dennis Wideman,2008-09,25.0,4,36,81,81,13,23,36,171.0,2038.0,223,27,58,85,443.0,82,5.44,62,351,2383,9.4,0.48996174
7807,7807,Dennis Wideman,2009-10,26.0,5,50,79,79,13,37,50,169.0,1947.0,302,40,95,135,612.0,82,5.7,65,341,2477,9.4,0.61870867
7808,7808,Dennis Wideman,2010-11,27.0,6,30,76,76,6,24,30,146.0,1790.0,378,46,119,165,758.0,82,5.53,56,304,2486,9.1,0.46128893
7809,7809,Dennis Wideman,2011-12,28.0,7,40,75,75,10,30,40,160.0,1799.0,453,56,149,205,918.0,82,5.46,52,291,2492,9.0,0.4873516
7810,7810,Dennis Wideman,2012-13,29.0,8,46,82,82,11,35,46,175.0,1960.0,535,67,184,251,1093.0,82,5.32,47,271,2439,8.9,0.53081495
7811,7811,Dennis Wideman,2013-14,30.0,9,22,46,46,6,16,22,94.0,1151.0,581,73,200,273,1187.0,48,5.31,29,160,1399,9.1,0.4628099
7812,7812,Dennis Wideman,2014-15,31.0,10,21,46,46,4,17,21,102.0,1044.0,627,77,217,294,1289.0,82,5.34,48,269,2463,8.9,0.39121872
7813,7813,Dennis Wideman,2015-16,32.0,11,56,80,80,15,41,56,173.0,1971.0,707,92,258,350,1462.0,82,5.32,47,251,2453,8.9,0.6334082
7814,7814,Dennis Wideman,2016-17,33.0,12,19,51,51,2,17,19,75.0,1051.0,758,94,275,369,1537.0,82,5.34,48,255,2438,9.0,0.3598073
7815,7815,Dennis Wideman,2017-18,34.0,13,18,57,57,5,13,18,87.0,1153.0,815,99,288,387,1624.0,82,5.45,47,245,2478,9.0,0.27883917
7816,7816,Denny Felsner,1992-93,22.0,2,1,3,3,0,1,1,2.0,,3,0,1,1,2.0,80,6.96,77,402,2440,11.4,0.23751298
7817,7817,Denny Felsner,1993-94,23.0,3,3,6,6,0,3,3,4.0,,9,0,4,4,6.0,84,7.25,87,443,2603,11.7,0.2168602
7818,7818,Denny Felsner,1994-95,24.0,4,1,6,6,1,0,1,6.0,,15,1,4,5,12.0,84,6.48,76,407,2545,10.7,0.19066817
7819,7819,Denny Felsner,1995-96,25.0,5,0,3,3,0,0,0,2.0,,18,1,4,5,14.0,48,5.97,37,209,1408,10.2,0.23202407
7820,7820,Denny Lambert,1995-96,26.0,2,4,13,13,1,3,4,14.0,,13,1,3,4,14.0,48,5.97,37,209,1408,10.2,0.24181849
7821,7821,Denny Lambert,1996-97,27.0,3,8,33,33,0,8,8,28.0,,46,1,11,12,42.0,82,6.29,74,413,2481,10.4,0.1662426
7822,7822,Denny Lambert,1997-98,28.0,4,20,80,80,4,16,20,58.0,,126,5,27,32,100.0,82,5.83,55,336,2444,9.8,0.18595064
7823,7823,Denny Lambert,1998-99,29.0,5,19,72,72,9,10,19,76.0,,198,14,37,51,176.0,82,5.28,57,380,2242,9.6,0.2642415
7824,7824,Denny Lambert,1999-00,30.0,6,16,76,76,5,11,16,66.0,785.0,274,19,48,67,242.0,82,5.27,57,359,2285,9.4,0.22240496
7825,7825,Denny Lambert,2000-01,31.0,7,11,73,73,5,6,11,83.0,850.0,347,24,54,78,325.0,82,5.49,53,331,2294,9.8,0.1963318
7826,7826,Denny Lambert,2001-02,32.0,8,8,67,67,1,7,8,44.0,612.0,414,25,61,86,369.0,82,5.51,63,376,2272,9.9,0.1406537
7827,7827,Denny Lambert,2002-03,33.0,9,7,73,73,2,5,7,51.0,510.0,487,27,66,93,420.0,82,5.24,53,338,2262,9.5,0.15790391
7828,7828,Derek Armstrong,1994-95,21.0,2,0,1,1,0,0,0,2.0,,1,0,0,0,2.0,84,6.48,76,407,2545,10.7,0.20190695
7829,7829,Derek Armstrong,1996-97,23.0,3,4,19,19,1,3,4,23.0,,20,1,3,4,25.0,82,6.29,74,413,2481,10.4,0.22682998
7830,7830,Derek Armstrong,1997-98,24.0,4,13,50,50,6,7,13,36.0,,70,7,10,17,61.0,82,5.83,55,336,2444,9.8,0.23626235
7831,7831,Derek Armstrong,1998-99,25.0,5,2,9,9,2,0,2,8.0,,79,9,10,19,69.0,82,5.28,57,380,2242,9.6,0.20484772
7832,7832,Derek Armstrong,1999-00,26.0,6,0,3,3,0,0,0,1.0,9.0,82,9,10,19,70.0,82,5.27,57,359,2285,9.4,0.1556603
7833,7833,Derek Armstrong,2000-01,27.0,7,0,1,1,0,0,0,1.0,3.0,83,9,10,19,71.0,82,5.49,53,331,2294,9.8,0.14415029
7834,7834,Derek Armstrong,2001-02,28.0,8,0,3,3,0,0,0,6.0,34.0,86,9,10,19,77.0,82,5.51,63,376,2272,9.9,0.15075287
7835,7835,Derek Armstrong,2003-04,30.0,9,38,66,66,12,26,38,106.0,1034.0,152,21,36,57,183.0,82,5.31,60,363,2326,9.4,0.42458457
7836,7836,Derek Armstrong,2004-05,31.0,10,35,57,57,14,21,35,101.0,969.0,209,35,57,92,284.0,82,5.14,57,348,2300,9.2,0.51990575
7837,7837,Derek Armstrong,2006-07,33.0,11,41,62,62,13,28,41,100.0,962.0,271,48,85,133,384.0,82,6.05,85,480,2458,10.1,0.4800629
7838,7838,Derek Armstrong,2007-08,34.0,12,44,67,67,11,33,44,109.0,1009.0,338,59,118,177,493.0,82,5.76,70,398,2426,9.7,0.47161928
7839,7839,Derek Armstrong,2008-09,35.0,13,35,77,77,8,27,35,118.0,1023.0,415,67,145,212,611.0,82,5.44,62,351,2383,9.4,0.341452
7840,7840,Derek Armstrong,2009-10,36.0,14,9,56,56,5,4,9,42.0,475.0,471,72,149,221,653.0,82,5.7,65,341,2477,9.4,0.15585795
7841,7841,Derek Armstrong,2010-11,37.0,15,0,6,6,0,0,0,6.0,42.0,477,72,149,221,659.0,82,5.53,56,304,2486,9.1,0.1541869
7842,7842,Derek Bekar,2000-01,25.0,2,0,1,1,0,0,0,0.0,5.0,1,0,0,0,0.0,82,5.49,53,331,2294,9.8,0.15208486
7843,7843,Derek Bekar,2003-04,28.0,3,0,6,6,0,0,0,4.0,45.0,7,0,0,0,4.0,82,5.31,60,363,2326,9.4,0.1383929
7844,7844,Derek Bekar,2004-05,29.0,4,0,4,4,0,0,0,3.0,22.0,11,0,0,0,7.0,82,5.14,57,348,2300,9.2,0.17040646
7845,7845,Derek Boogaard,2006-07,24.0,2,6,65,65,2,4,6,15.0,350.0,65,2,4,6,15.0,82,6.05,85,480,2458,10.1,0.12684616
7846,7846,Derek Boogaard,2007-08,25.0,3,1,48,48,0,1,1,11.0,222.0,113,2,5,7,26.0,82,5.76,70,398,2426,9.7,0.09192294
7847,7847,Derek Boogaard,2008-09,26.0,4,0,34,34,0,0,0,6.0,134.0,147,2,5,7,32.0,82,5.44,62,351,2383,9.4,0.09662667
7848,7848,Derek Boogaard,2009-10,27.0,5,3,51,51,0,3,3,13.0,255.0,198,2,8,10,45.0,82,5.7,65,341,2477,9.4,0.07012108
7849,7849,Derek Boogaard,2010-11,28.0,6,4,57,57,0,4,4,26.0,351.0,255,2,12,14,71.0,82,5.53,56,304,2486,9.1,0.08523679
7850,7850,Derek Boogaard,2011-12,29.0,7,2,22,22,1,1,2,4.0,100.0,277,3,13,16,75.0,82,5.46,52,291,2492,9.0,0.077516496
7851,7851,Derek Dorsett,2009-10,23.0,2,5,52,52,4,1,5,59.0,462.0,52,4,1,5,59.0,82,5.7,65,341,2477,9.4,0.21363267
7852,7852,Derek Dorsett,2010-11,24.0,3,14,51,51,4,10,14,57.0,555.0,103,8,11,19,116.0,82,5.53,56,304,2486,9.1,0.24710312
7853,7853,Derek Dorsett,2011-12,25.0,4,17,76,76,4,13,17,112.0,1004.0,179,12,24,36,228.0,82,5.46,52,291,2492,9.0,0.22178984
7854,7854,Derek Dorsett,2012-13,26.0,5,20,77,77,12,8,20,137.0,1131.0,256,24,32,56,365.0,82,5.32,47,271,2439,8.9,0.29794586
7855,7855,Derek Dorsett,2013-14,27.0,6,9,24,24,3,6,9,38.0,384.0,280,27,38,65,403.0,48,5.31,29,160,1399,9.1,0.27764624
7856,7856,Derek Dorsett,2014-15,28.0,7,8,51,51,4,4,8,67.0,562.0,331,31,42,73,470.0,82,5.34,48,269,2463,8.9,0.18173778
7857,7857,Derek Dorsett,2015-16,29.0,8,25,79,79,7,18,25,89.0,952.0,410,38,60,98,559.0,82,5.32,47,251,2453,8.9,0.260613
7858,7858,Derek Dorsett,2016-17,30.0,9,16,71,71,5,11,16,91.0,894.0,481,43,71,114,650.0,82,5.34,48,255,2438,9.0,0.23485214
7859,7859,Derek Dorsett,2017-18,31.0,10,4,14,14,1,3,4,24.0,139.0,495,44,74,118,674.0,82,5.45,47,245,2478,9.0,0.2510496
7860,7860,Derek Dorsett,2018-19,32.0,11,9,20,20,7,2,9,26.0,306.0,515,51,76,127,700.0,82,5.86,50,250,2620,9.2,0.285375
7861,7861,Derek Forbort,2016-17,24.0,2,2,14,14,1,1,2,14.0,155.0,14,1,1,2,14.0,82,5.34,48,255,2438,9.0,0.20221058
7862,7862,Derek Forbort,2017-18,25.0,3,18,82,82,2,16,18,100.0,1650.0,96,3,17,20,114.0,82,5.45,47,245,2478,9.0,0.26701385
7863,7863,Derek Forbort,2018-19,26.0,4,18,78,78,1,17,18,78.0,1621.0,174,4,34,38,192.0,82,5.86,50,250,2620,9.2,0.22084227
7864,7864,Derek Forbort,2019-20,27.0,5,14,81,81,2,12,14,75.0,1680.0,255,6,46,52,267.0,82,5.96,47,239,2579,9.5,0.19136581
7865,7865,Derek Forbort,2020-21,28.0,6,1,20,20,0,1,1,22.0,356.0,275,6,47,53,289.0,70,5.96,42,208,2192,9.5,0.16023889
7866,7866,Derek Grant,2013-14,23.0,2,0,5,5,0,0,0,5.0,43.0,5,0,0,0,5.0,48,5.31,29,160,1399,9.1,0.19438097
7867,7867,Derek Grant,2014-15,24.0,3,2,20,20,0,2,2,31.0,191.0,25,0,2,2,36.0,82,5.34,48,269,2463,8.9,0.17272681
7868,7868,Derek Grant,2016-17,26.0,4,1,15,15,0,1,1,22.0,163.0,40,0,3,3,58.0,82,5.34,48,255,2438,9.0,0.17492363
7869,7869,Derek Grant,2017-18,27.0,5,4,46,46,0,4,4,40.0,449.0,86,0,7,7,98.0,82,5.45,47,245,2478,9.0,0.13661963
7870,7870,Derek Grant,2018-19,28.0,6,24,66,66,12,12,24,65.0,732.0,152,12,19,31,163.0,82,5.86,50,250,2620,9.2,0.25651222
7871,7871,Derek Grant,2019-20,29.0,7,14,56,56,4,10,14,74.0,654.0,208,16,29,45,237.0,82,5.96,47,239,2579,9.5,0.20695513
7872,7872,Derek Grant,2020-21,30.0,8,25,56,56,15,10,25,94.0,779.0,264,31,39,70,331.0,70,5.96,42,208,2192,9.5,0.3814623
7873,7873,Derek Joslin,2009-10,22.0,2,0,12,12,0,0,0,9.0,136.0,12,0,0,0,9.0,82,5.7,65,341,2477,9.4,0.17071748
7874,7874,Derek Joslin,2010-11,23.0,3,3,24,24,0,3,3,19.0,333.0,36,0,3,3,28.0,82,5.53,56,304,2486,9.1,0.16879964
7875,7875,Derek Joslin,2011-12,24.0,4,9,34,34,2,7,9,34.0,519.0,70,2,10,12,62.0,82,5.46,52,291,2492,9.0,0.19527254
7876,7876,Derek Joslin,2012-13,25.0,5,4,44,44,2,2,4,36.0,466.0,114,4,12,16,98.0,82,5.32,47,271,2439,8.9,0.16603488
7877,7877,Derek Joslin,2013-14,26.0,6,0,2,2,0,0,0,2.0,34.0,116,4,12,16,100.0,48,5.31,29,160,1399,9.1,0.17012683
7878,7878,Derek King,1987-88,20.0,2,0,2,2,0,0,0,5.0,,2,0,0,0,5.0,80,7.34,72,344,2400,12.2,0.2864361
7879,7879,Derek King,1988-89,21.0,3,36,55,55,12,24,36,94.0,,57,12,24,36,99.0,80,7.43,89,437,2435,12.2,0.61390287
7880,7880,Derek King,1989-90,22.0,4,43,60,60,14,29,43,103.0,,117,26,53,79,202.0,80,7.48,85,403,2430,12.3,0.6594527
7881,7881,Derek King,1990-91,23.0,5,40,46,46,13,27,40,91.0,,163,39,80,119,293.0,80,7.37,76,367,2421,12.2,0.7163687
7882,7882,Derek King,1991-92,24.0,6,45,66,66,19,26,45,130.0,,229,58,106,164,423.0,80,6.91,71,366,2385,11.6,0.6886555
7883,7883,Derek King,1992-93,25.0,7,78,80,80,40,38,78,189.0,,309,98,144,242,612.0,80,6.96,77,402,2440,11.4,0.9225966
7884,7884,Derek King,1993-94,26.0,8,76,77,77,38,38,76,201.0,,386,136,182,318,813.0,84,7.25,87,443,2603,11.7,0.83974373
7885,7885,Derek King,1994-95,27.0,9,70,78,78,30,40,70,171.0,,464,166,222,388,984.0,84,6.48,76,407,2545,10.7,0.77461517
7886,7886,Derek King,1995-96,28.0,10,26,43,43,10,16,26,118.0,,507,176,238,414,1102.0,48,5.97,37,209,1408,10.2,0.70257825
7887,7887,Derek King,1996-97,29.0,11,32,61,61,12,20,32,154.0,,568,188,258,446,1256.0,82,6.29,74,413,2481,10.4,0.58261544
7888,7888,Derek King,1997-98,30.0,12,59,82,82,26,33,59,181.0,,650,214,291,505,1437.0,82,5.83,55,336,2444,9.8,0.66540056
7889,7889,Derek King,1998-99,31.0,13,46,77,77,21,25,46,166.0,,727,235,316,551,1603.0,82,5.28,57,380,2242,9.6,0.54086083
7890,7890,Derek King,1999-00,32.0,14,52,81,81,24,28,52,150.0,1137.0,808,259,344,603,1753.0,82,5.27,57,359,2285,9.4,0.57612234
7891,7891,Derek King,2000-01,33.0,15,9,22,22,2,7,9,33.0,276.0,830,261,351,612,1786.0,82,5.49,53,331,2294,9.8,0.43118453
7892,7892,Derek Laxdal,1985-86,19.0,2,0,3,3,0,0,0,3.0,,3,0,0,0,3.0,80,7.77,71,321,2447,12.7,0.27032173
7893,7893,Derek Laxdal,1987-88,21.0,3,0,2,2,0,0,0,0.0,,5,0,0,0,3.0,80,7.34,72,344,2400,12.2,0.22833097
7894,7894,Derek Laxdal,1988-89,22.0,4,0,5,5,0,0,0,2.0,,10,0,0,0,5.0,80,7.43,89,437,2435,12.2,0.22719133
7895,7895,Derek Laxdal,1989-90,23.0,5,15,41,41,9,6,15,41.0,,51,9,6,15,46.0,80,7.48,85,403,2430,12.3,0.34919772
7896,7896,Derek Laxdal,1990-91,24.0,6,4,12,12,3,1,4,20.0,,63,12,7,19,66.0,80,7.37,76,367,2421,12.2,0.32148993
7897,7897,Derek Laxdal,1991-92,25.0,7,0,4,4,0,0,0,3.0,,67,12,7,19,69.0,80,6.91,71,366,2385,11.6,0.18158895
7898,7898,Derek MacKenzie,2002-03,21.0,2,0,1,1,0,0,0,1.0,14.0,1,0,0,0,1.0,82,5.24,53,338,2262,9.5,0.17989916
7899,7899,Derek MacKenzie,2004-05,23.0,3,1,12,12,0,1,1,7.0,80.0,13,0,1,1,8.0,82,5.14,57,348,2300,9.2,0.19695282
7900,7900,Derek MacKenzie,2006-07,25.0,4,1,11,11,0,1,1,11.0,72.0,24,0,2,2,19.0,82,6.05,85,480,2458,10.1,0.16969422
7901,7901,Derek MacKenzie,2007-08,26.0,5,0,4,4,0,0,0,3.0,20.0,28,0,2,2,22.0,82,5.76,70,398,2426,9.7,0.1566239
7902,7902,Derek MacKenzie,2008-09,27.0,6,2,17,17,2,0,2,19.0,132.0,45,2,2,4,41.0,82,5.44,62,351,2383,9.4,0.17521784
7903,7903,Derek MacKenzie,2009-10,28.0,7,0,1,1,0,0,0,1.0,7.0,46,2,2,4,42.0,82,5.7,65,341,2477,9.4,0.13050434
7904,7904,Derek MacKenzie,2010-11,29.0,8,4,18,18,1,3,4,14.0,156.0,64,3,5,8,56.0,82,5.53,56,304,2486,9.1,0.16850662
7905,7905,Derek MacKenzie,2011-12,30.0,9,23,63,63,9,14,23,76.0,683.0,127,12,19,31,132.0,82,5.46,52,291,2492,9.0,0.24363449
7906,7906,Derek MacKenzie,2012-13,31.0,10,14,66,66,7,7,14,61.0,693.0,193,19,26,45,193.0,82,5.32,47,271,2439,8.9,0.16701129
7907,7907,Derek MacKenzie,2013-14,32.0,11,8,43,43,3,5,8,33.0,445.0,236,22,31,53,226.0,48,5.31,29,160,1399,9.1,0.14259249
7908,7908,Derek MacKenzie,2014-15,33.0,12,18,71,71,9,9,18,70.0,800.0,307,31,40,71,296.0,82,5.34,48,269,2463,8.9,0.21208817
7909,7909,Derek MacKenzie,2015-16,34.0,13,11,82,82,5,6,11,72.0,1021.0,389,36,46,82,368.0,82,5.32,47,251,2453,8.9,0.15977958
7910,7910,Derek MacKenzie,2016-17,35.0,14,13,64,64,6,7,13,79.0,842.0,453,42,53,95,447.0,82,5.34,48,255,2438,9.0,0.16927186
7911,7911,Derek MacKenzie,2017-18,36.0,15,16,82,82,6,10,16,91.0,1030.0,535,48,63,111,538.0,82,5.45,47,245,2478,9.0,0.2101703
7912,7912,Derek MacKenzie,2018-19,37.0,16,14,75,75,3,11,14,86.0,848.0,610,51,74,125,624.0,82,5.86,50,250,2620,9.2,0.16362327
7913,7913,Derek MacKenzie,2019-20,38.0,17,0,1,1,0,0,0,0.0,3.0,611,51,74,125,624.0,82,5.96,47,239,2579,9.5,0.17405128
7914,7914,Derek Mayer,1994-95,27.0,2,4,17,17,2,2,4,29.0,,17,2,2,4,29.0,84,6.48,76,407,2545,10.7,0.2605428
7915,7915,Derek Meech,2007-08,23.0,2,0,4,4,0,0,0,3.0,23.0,4,0,0,0,3.0,82,5.76,70,398,2426,9.7,0.17841864
7916,7916,Derek Meech,2008-09,24.0,3,3,32,32,0,3,3,44.0,388.0,36,0,3,3,47.0,82,5.44,62,351,2383,9.4,0.17492533
7917,7917,Derek Meech,2009-10,25.0,4,7,41,41,2,5,7,44.0,412.0,77,2,8,10,91.0,82,5.7,65,341,2477,9.4,0.18396044
7918,7918,Derek Meech,2010-11,26.0,5,6,49,49,2,4,6,57.0,584.0,126,4,12,16,148.0,82,5.53,56,304,2486,9.1,0.15826023
7919,7919,Derek Meech,2012-13,28.0,6,0,2,2,0,0,0,2.0,23.0,128,4,12,16,150.0,82,5.32,47,271,2439,8.9,0.119475275
7920,7920,Derek Meech,2013-14,29.0,7,1,16,16,0,1,1,5.0,235.0,144,4,13,17,155.0,48,5.31,29,160,1399,9.1,0.12516585
7921,7921,Derek Morris,1998-99,20.0,2,29,82,82,9,20,29,120.0,,82,9,20,29,120.0,82,5.28,57,380,2242,9.6,0.4092412
7922,7922,Derek Morris,1999-00,21.0,3,34,71,71,7,27,34,150.0,1472.0,153,16,47,63,270.0,82,5.27,57,359,2285,9.4,0.4964582
7923,7923,Derek Morris,2000-01,22.0,4,38,78,78,9,29,38,193.0,1938.0,231,25,76,101,463.0,82,5.49,53,331,2294,9.8,0.5344359
7924,7924,Derek Morris,2001-02,23.0,5,28,51,51,5,23,28,142.0,1318.0,282,30,99,129,605.0,82,5.51,63,376,2272,9.9,0.59045035
7925,7925,Derek Morris,2002-03,24.0,6,34,61,61,4,30,34,166.0,1505.0,343,34,129,163,771.0,82,5.24,53,338,2262,9.5,0.6116611
7926,7926,Derek Morris,2003-04,25.0,7,48,75,75,11,37,48,191.0,1787.0,418,45,166,211,962.0,82,5.31,60,363,2326,9.4,0.6102205
7927,7927,Derek Morris,2004-05,26.0,8,32,83,83,6,26,32,167.0,1792.0,501,51,192,243,1129.0,82,5.14,57,348,2300,9.2,0.4967048
7928,7928,Derek Morris,2006-07,28.0,9,27,53,53,6,21,27,91.0,1106.0,554,57,213,270,1220.0,82,6.05,85,480,2458,10.1,0.46366674
7929,7929,Derek Morris,2007-08,29.0,10,25,82,82,6,19,25,129.0,1680.0,636,63,232,295,1349.0,82,5.76,70,398,2426,9.7,0.33636206
7930,7930,Derek Morris,2008-09,30.0,11,25,82,82,8,17,25,135.0,1781.0,718,71,249,320,1484.0,82,5.44,62,351,2383,9.4,0.3358245
7931,7931,Derek Morris,2009-10,31.0,12,20,75,75,5,15,20,120.0,1567.0,793,76,264,340,1604.0,82,5.7,65,341,2477,9.4,0.28332928
7932,7932,Derek Morris,2010-11,32.0,13,29,76,76,4,25,29,120.0,1630.0,869,80,289,369,1724.0,82,5.53,56,304,2486,9.1,0.3232537
7933,7933,Derek Morris,2011-12,33.0,14,16,77,77,5,11,16,83.0,1622.0,946,85,300,385,1807.0,82,5.46,52,291,2492,9.0,0.23385888
7934,7934,Derek Morris,2012-13,34.0,15,11,59,59,2,9,11,72.0,1120.0,1005,87,309,396,1879.0,82,5.32,47,271,2439,8.9,0.18158889
7935,7935,Derek Morris,2013-14,35.0,16,11,39,39,0,11,11,68.0,834.0,1044,87,320,407,1947.0,48,5.31,29,160,1399,9.1,0.21681955
7936,7936,Derek Morris,2014-15,36.0,17,17,63,63,5,12,17,82.0,1225.0,1107,92,332,424,2029.0,82,5.34,48,269,2463,8.9,0.22679639
7937,7937,Derek Peltier,2009-10,24.0,2,0,11,11,0,0,0,7.0,146.0,11,0,0,0,7.0,82,5.7,65,341,2477,9.4,0.16183406
7938,7938,Derek Peltier,2010-11,25.0,3,0,3,3,0,0,0,1.0,27.0,14,0,0,0,8.0,82,5.53,56,304,2486,9.1,0.15020093
7939,7939,Derek Plante,1994-95,24.0,2,56,77,77,21,35,56,147.0,,77,21,35,56,147.0,84,6.48,76,407,2545,10.7,0.56166935
7940,7940,Derek Plante,1995-96,25.0,3,22,47,47,3,19,22,94.0,,124,24,54,78,241.0,48,5.97,37,209,1408,10.2,0.43441975
7941,7941,Derek Plante,1996-97,26.0,4,56,76,76,23,33,56,203.0,,200,47,87,134,444.0,82,6.29,74,413,2481,10.4,0.65367776
7942,7942,Derek Plante,1997-98,27.0,5,53,82,82,27,26,53,191.0,,282,74,113,187,635.0,82,5.83,55,336,2444,9.8,0.6199333
7943,7943,Derek Plante,1998-99,28.0,6,34,72,72,13,21,34,150.0,,354,87,134,221,785.0,82,5.28,57,380,2242,9.6,0.5200054
7944,7944,Derek Plante,1999-00,29.0,7,20,51,51,6,14,20,90.0,773.0,405,93,148,241,875.0,82,5.27,57,359,2285,9.4,0.4367613
7945,7945,Derek Plante,2000-01,30.0,8,4,33,33,2,2,4,31.0,294.0,438,95,150,245,906.0,82,5.49,53,331,2294,9.8,0.32272938
7946,7946,Derek Plante,2001-02,31.0,9,3,12,12,1,2,3,20.0,198.0,450,96,152,248,926.0,82,5.51,63,376,2272,9.9,0.3249498
7947,7947,Derek Roy,2004-05,21.0,2,19,49,49,9,10,19,71.0,750.0,49,9,10,19,71.0,82,5.14,57,348,2300,9.2,0.54328793
7948,7948,Derek Roy,2006-07,23.0,3,46,70,70,18,28,46,151.0,1192.0,119,27,38,65,222.0,82,6.05,85,480,2458,10.1,0.6208066
7949,7949,Derek Roy,2007-08,24.0,4,63,75,75,21,42,63,130.0,1385.0,194,48,80,128,352.0,82,5.76,70,398,2426,9.7,0.7341825
7950,7950,Derek Roy,2008-09,25.0,5,81,78,78,32,49,81,218.0,1636.0,272,80,129,209,570.0,82,5.44,62,351,2383,9.4,0.9354744
7951,7951,Derek Roy,2009-10,26.0,6,70,82,82,28,42,70,221.0,1738.0,354,108,171,279,791.0,82,5.7,65,341,2477,9.4,0.8726264
7952,7952,Derek Roy,2010-11,27.0,7,69,80,80,26,43,69,215.0,1551.0,434,134,214,348,1006.0,82,5.53,56,304,2486,9.1,0.8052547
7953,7953,Derek Roy,2011-12,28.0,8,35,35,35,10,25,35,89.0,684.0,469,144,239,383,1095.0,82,5.46,52,291,2492,9.0,0.7109037
7954,7954,Derek Roy,2012-13,29.0,9,44,80,80,17,27,44,176.0,1546.0,549,161,266,427,1271.0,82,5.32,47,271,2439,8.9,0.5825703
7955,7955,Derek Roy,2013-14,30.0,10,28,42,42,7,21,28,85.0,781.0,591,168,287,455,1356.0,48,5.31,29,160,1399,9.1,0.6544866
7956,7956,Derek Roy,2014-15,31.0,11,37,75,75,9,28,37,114.0,1022.0,666,177,315,492,1470.0,82,5.34,48,269,2463,8.9,0.44307512
7957,7957,Derek Roy,2015-16,32.0,12,32,72,72,12,20,32,113.0,1128.0,738,189,335,524,1583.0,82,5.32,47,251,2453,8.9,0.4351126
7958,7958,Derek Ryan,2016-17,30.0,2,2,6,6,2,0,2,5.0,73.0,6,2,0,2,5.0,82,5.34,48,255,2438,9.0,0.21156928
7959,7959,Derek Ryan,2017-18,31.0,3,29,67,67,11,18,29,73.0,998.0,73,13,18,31,78.0,82,5.45,47,245,2478,9.0,0.34091413
7960,7960,Derek Ryan,2018-19,32.0,4,38,80,80,15,23,38,135.0,1248.0,153,28,41,69,213.0,82,5.86,50,250,2620,9.2,0.42993253
7961,7961,Derek Ryan,2019-20,33.0,5,38,81,81,13,25,38,103.0,1118.0,234,41,66,107,316.0,82,5.96,47,239,2579,9.5,0.43421102
7962,7962,Derek Ryan,2020-21,34.0,6,29,68,68,10,19,29,102.0,989.0,302,51,85,136,418.0,70,5.96,42,208,2192,9.5,0.38798708
7963,7963,Derek Smith,2010-11,26.0,2,0,2,2,0,0,0,4.0,25.0,2,0,0,0,4.0,82,5.53,56,304,2486,9.1,0.16698298
7964,7964,Derek Smith,2011-12,27.0,3,1,9,9,0,1,1,13.0,138.0,11,0,1,1,17.0,82,5.46,52,291,2492,9.0,0.18767396
7965,7965,Derek Smith,2012-13,28.0,4,11,47,47,2,9,11,44.0,749.0,58,2,10,12,61.0,82,5.32,47,271,2439,8.9,0.17210734
7966,7966,Derek Smith,2013-14,29.0,5,1,22,22,0,1,1,18.0,269.0,80,2,11,13,79.0,48,5.31,29,160,1399,9.1,0.14242023
7967,7967,Derek Smith,2014-15,30.0,6,1,14,14,0,1,1,12.0,133.0,94,2,12,14,91.0,82,5.34,48,269,2463,8.9,0.14003187
7968,7968,Derek Stepan,2011-12,21.0,2,45,82,82,21,24,45,166.0,1348.0,82,21,24,45,166.0,82,5.46,52,291,2492,9.0,0.6036243
7969,7969,Derek Stepan,2012-13,22.0,3,51,82,82,17,34,51,169.0,1554.0,164,38,58,96,335.0,82,5.32,47,271,2439,8.9,0.6543994
7970,7970,Derek Stepan,2013-14,23.0,4,44,48,48,18,26,44,108.0,1004.0,212,56,84,140,443.0,48,5.31,29,160,1399,9.1,0.7746079
7971,7971,Derek Stepan,2014-15,24.0,5,57,82,82,17,40,57,199.0,1481.0,294,73,124,197,642.0,82,5.34,48,269,2463,8.9,0.7187878
7972,7972,Derek Stepan,2015-16,25.0,6,55,68,68,16,39,55,155.0,1236.0,362,89,163,252,797.0,82,5.32,47,251,2453,8.9,0.7457135
7973,7973,Derek Stepan,2016-17,26.0,7,53,72,72,22,31,53,192.0,1278.0,434,111,194,305,989.0,82,5.34,48,255,2438,9.0,0.7308255
7974,7974,Derek Stepan,2017-18,27.0,8,55,81,81,17,38,55,209.0,1507.0,515,128,232,360,1198.0,82,5.45,47,245,2478,9.0,0.73531276
7975,7975,Derek Stepan,2018-19,28.0,9,56,82,82,14,42,56,209.0,1580.0,597,142,274,416,1407.0,82,5.86,50,250,2620,9.2,0.7102756
7976,7976,Derek Stepan,2019-20,29.0,10,35,72,72,15,20,35,195.0,1384.0,669,157,294,451,1602.0,82,5.96,47,239,2579,9.5,0.5315179
7977,7977,Derek Stepan,2020-21,30.0,11,28,70,70,10,18,28,158.0,1235.0,739,167,312,479,1760.0,70,5.96,42,208,2192,9.5,0.45882115
7978,7978,Derek Whitmore,2012-13,28.0,2,0,2,2,0,0,0,2.0,25.0,2,0,0,0,2.0,82,5.32,47,271,2439,8.9,0.15406454
7979,7979,Derian Hatcher,1992-93,20.0,2,12,43,43,8,4,12,51.0,,43,8,4,12,51.0,80,6.96,77,402,2440,11.4,0.35844302
7980,7980,Derian Hatcher,1993-94,21.0,3,19,67,67,4,15,19,73.0,,110,12,19,31,124.0,84,7.25,87,443,2603,11.7,0.36198568
7981,7981,Derian Hatcher,1994-95,22.0,4,31,83,83,12,19,31,132.0,,193,24,38,62,256.0,84,6.48,76,407,2545,10.7,0.4351055
7982,7982,Derian Hatcher,1995-96,23.0,5,16,43,43,5,11,16,74.0,,236,29,49,78,330.0,48,5.97,37,209,1408,10.2,0.4177956
7983,7983,Derian Hatcher,1996-97,24.0,6,31,79,79,8,23,31,125.0,,315,37,72,109,455.0,82,6.29,74,413,2481,10.4,0.3994071
7984,7984,Derian Hatcher,1997-98,25.0,7,22,63,63,3,19,22,96.0,,378,40,91,131,551.0,82,5.83,55,336,2444,9.8,0.32246298
7985,7985,Derian Hatcher,1998-99,26.0,8,31,70,70,6,25,31,74.0,,448,46,116,162,625.0,82,5.28,57,380,2242,9.6,0.4364164
7986,7986,Derian Hatcher,1999-00,27.0,9,30,80,80,9,21,30,125.0,1979.0,528,55,137,192,750.0,82,5.27,57,359,2285,9.4,0.41175306
7987,7987,Derian Hatcher,2000-01,28.0,10,24,57,57,2,22,24,90.0,1570.0,585,57,159,216,840.0,82,5.49,53,331,2294,9.8,0.34921986
7988,7988,Derian Hatcher,2001-02,29.0,11,23,80,80,2,21,23,97.0,2070.0,665,59,180,239,937.0,82,5.51,63,376,2272,9.9,0.27285016
7989,7989,Derian Hatcher,2002-03,30.0,12,25,80,80,4,21,25,111.0,2134.0,745,63,201,264,1048.0,82,5.24,53,338,2262,9.5,0.29718173
7990,7990,Derian Hatcher,2003-04,31.0,13,30,82,82,8,22,30,159.0,2120.0,827,71,223,294,1207.0,82,5.31,60,363,2326,9.4,0.36368227
7991,7991,Derian Hatcher,2004-05,32.0,14,4,15,15,0,4,4,18.0,295.0,842,71,227,298,1225.0,82,5.14,57,348,2300,9.2,0.2965057
7992,7992,Derian Hatcher,2006-07,34.0,15,17,77,77,4,13,17,98.0,1809.0,919,75,240,315,1323.0,82,6.05,85,480,2458,10.1,0.19654426
7993,7993,Derian Hatcher,2007-08,35.0,16,9,82,82,3,6,9,81.0,1941.0,1001,78,246,324,1404.0,82,5.76,70,398,2426,9.7,0.14858916
7994,7994,Derian Hatcher,2008-09,36.0,17,7,44,44,2,5,7,27.0,928.0,1045,80,251,331,1431.0,82,5.44,62,351,2383,9.4,0.13992363
7995,7995,Derick Brassard,2008-09,21.0,2,2,17,17,1,1,2,13.0,154.0,17,1,1,2,13.0,82,5.44,62,351,2383,9.4,0.2469053
7996,7996,Derick Brassard,2009-10,22.0,3,25,31,31,10,15,25,59.0,447.0,48,11,16,27,72.0,82,5.7,65,341,2477,9.4,0.5364477
7997,7997,Derick Brassard,2010-11,23.0,4,36,79,79,9,27,36,125.0,1180.0,127,20,43,63,197.0,82,5.53,56,304,2486,9.1,0.43098217
7998,7998,Derick Brassard,2011-12,24.0,5,47,74,74,17,30,47,183.0,1260.0,201,37,73,110,380.0,82,5.46,52,291,2492,9.0,0.6036917
7999,7999,Derick Brassard,2012-13,25.0,6,41,74,74,14,27,41,125.0,1209.0,275,51,100,151,505.0,82,5.32,47,271,2439,8.9,0.52387315
8000,8000,Derick Brassard,2013-14,26.0,7,29,47,47,12,17,29,88.0,778.0,322,63,117,180,593.0,48,5.31,29,160,1399,9.1,0.5875794
8001,8001,Derick Brassard,2014-15,27.0,8,45,81,81,18,27,45,159.0,1280.0,403,81,144,225,752.0,82,5.34,48,269,2463,8.9,0.535176
8002,8002,Derick Brassard,2015-16,28.0,9,60,80,80,19,41,60,168.0,1392.0,483,100,185,285,920.0,82,5.32,47,251,2453,8.9,0.6667919
8003,8003,Derick Brassard,2016-17,29.0,10,58,80,80,27,31,58,182.0,1431.0,563,127,216,343,1102.0,82,5.34,48,255,2438,9.0,0.69008756
8004,8004,Derick Brassard,2017-18,30.0,11,39,81,81,14,25,39,195.0,1408.0,644,141,241,382,1297.0,82,5.45,47,245,2478,9.0,0.5639008
8005,8005,Derick Brassard,2018-19,31.0,12,46,72,72,21,25,46,197.0,1277.0,716,162,266,428,1494.0,82,5.86,50,250,2620,9.2,0.58683527
8006,8006,Derick Brassard,2019-20,32.0,13,23,70,70,14,9,23,110.0,1050.0,786,176,275,451,1604.0,82,5.96,47,239,2579,9.5,0.35067865
8007,8007,Derick Brassard,2020-21,33.0,14,32,66,66,10,22,32,110.0,904.0,852,186,297,483,1714.0,70,5.96,42,208,2192,9.5,0.3941941
8008,8008,Deron Quint,1996-97,20.0,2,18,51,51,5,13,18,97.0,,51,5,13,18,97.0,82,6.29,74,413,2481,10.4,0.40047315
8009,8009,Deron Quint,1997-98,21.0,3,14,27,27,3,11,14,63.0,,78,8,24,32,160.0,82,5.83,55,336,2444,9.8,0.36279476
8010,8010,Deron Quint,1998-99,22.0,4,11,32,32,4,7,11,61.0,,110,12,31,43,221.0,82,5.28,57,380,2242,9.6,0.33094066
8011,8011,Deron Quint,1999-00,23.0,5,13,60,60,5,8,13,94.0,972.0,170,17,39,56,315.0,82,5.27,57,359,2285,9.4,0.29529932
8012,8012,Deron Quint,2000-01,24.0,6,11,54,54,4,7,11,94.0,898.0,224,21,46,67,409.0,82,5.49,53,331,2294,9.8,0.3081712
8013,8013,Deron Quint,2001-02,25.0,7,23,57,57,7,16,23,148.0,1373.0,281,28,62,90,557.0,82,5.51,63,376,2272,9.9,0.39257064
8014,8014,Deron Quint,2002-03,26.0,8,25,75,75,7,18,25,169.0,1651.0,356,35,80,115,726.0,82,5.24,53,338,2262,9.5,0.38431802
8015,8015,Deron Quint,2003-04,27.0,9,17,51,51,7,10,17,85.0,809.0,407,42,90,132,811.0,82,5.31,60,363,2326,9.4,0.35001725
8016,8016,Deron Quint,2004-05,28.0,10,11,51,51,4,7,11,72.0,925.0,458,46,97,143,883.0,82,5.14,57,348,2300,9.2,0.24547428
8017,8017,Deron Quint,2007-08,31.0,11,0,5,5,0,0,0,2.0,53.0,463,46,97,143,885.0,82,5.76,70,398,2426,9.7,0.14650634
8018,8018,Derrick Pouliot,2015-16,22.0,2,7,34,34,2,5,7,56.0,597.0,34,2,5,7,56.0,82,5.32,47,251,2453,8.9,0.26346618
8019,8019,Derrick Pouliot,2016-17,23.0,3,7,22,22,0,7,7,25.0,340.0,56,2,12,14,81.0,82,5.34,48,255,2438,9.0,0.23243201
8020,8020,Derrick Pouliot,2017-18,24.0,4,0,11,11,0,0,0,11.0,164.0,67,2,12,14,92.0,82,5.45,47,245,2478,9.0,0.18455392
8021,8021,Derrick Pouliot,2018-19,25.0,5,22,71,71,3,19,22,78.0,1267.0,138,5,31,36,170.0,82,5.86,50,250,2620,9.2,0.23084831
8022,8022,Derrick Pouliot,2019-20,26.0,6,12,62,62,3,9,12,58.0,1064.0,200,8,40,48,228.0,82,5.96,47,239,2579,9.5,0.17582467
8023,8023,Derrick Pouliot,2020-21,27.0,7,0,2,2,0,0,0,1.0,17.0,202,8,40,48,229.0,70,5.96,42,208,2192,9.5,0.2274063
8024,8024,Derrick Smith,1985-86,21.0,2,39,77,77,17,22,39,142.0,,77,17,22,39,142.0,80,7.77,71,321,2447,12.7,0.580105
8025,8025,Derrick Smith,1986-87,22.0,3,12,69,69,6,6,12,107.0,,146,23,28,51,249.0,80,7.94,82,370,2484,12.8,0.3342581
8026,8026,Derrick Smith,1987-88,23.0,4,32,71,71,11,21,32,150.0,,217,34,49,83,399.0,80,7.34,72,344,2400,12.2,0.5146748
8027,8027,Derrick Smith,1988-89,24.0,5,24,76,76,16,8,24,155.0,,293,50,57,107,554.0,80,7.43,89,437,2435,12.2,0.39022058
8028,8028,Derrick Smith,1989-90,25.0,6,30,74,74,16,14,30,115.0,,367,66,71,137,669.0,80,7.48,85,403,2430,12.3,0.42232573
8029,8029,Derrick Smith,1990-91,26.0,7,9,55,55,3,6,9,72.0,,422,69,77,146,741.0,80,7.37,76,367,2421,12.2,0.2721019
8030,8030,Derrick Smith,1991-92,27.0,8,21,72,72,11,10,21,100.0,,494,80,87,167,841.0,80,6.91,71,366,2385,11.6,0.30135447
8031,8031,Derrick Smith,1992-93,28.0,9,6,33,33,2,4,6,29.0,,527,82,91,173,870.0,80,6.96,77,402,2440,11.4,0.27005833
8032,8032,Derrick Smith,1993-94,29.0,10,1,9,9,0,1,1,3.0,,536,82,92,174,873.0,84,7.25,87,443,2603,11.7,0.20103213
8033,8033,Derrick Smith,1994-95,30.0,11,0,1,1,0,0,0,1.0,,537,82,92,174,874.0,84,6.48,76,407,2545,10.7,0.29774034
8034,8034,Derrick Walser,2002-03,24.0,2,1,2,2,1,0,1,2.0,33.0,2,1,0,1,2.0,82,5.24,53,338,2262,9.5,0.21693772
8035,8035,Derrick Walser,2003-04,25.0,3,17,53,53,4,13,17,86.0,788.0,55,5,13,18,88.0,82,5.31,60,363,2326,9.4,0.31401527
8036,8036,Derrick Walser,2004-05,26.0,4,9,27,27,1,8,9,35.0,496.0,82,6,21,27,123.0,82,5.14,57,348,2300,9.2,0.236788
8037,8037,Derrick Walser,2007-08,29.0,5,2,9,9,2,0,2,10.0,110.0,91,8,21,29,133.0,82,5.76,70,398,2426,9.7,0.21162125
8038,8038,Deryk Engelland,2010-11,28.0,2,2,9,9,0,2,2,4.0,145.0,9,0,2,2,4.0,82,5.53,56,304,2486,9.1,0.16340882
8039,8039,Deryk Engelland,2011-12,29.0,3,10,63,63,3,7,10,49.0,840.0,72,3,9,12,53.0,82,5.46,52,291,2492,9.0,0.14183319
8040,8040,Deryk Engelland,2012-13,30.0,4,17,73,73,4,13,17,86.0,1179.0,145,7,22,29,139.0,82,5.32,47,271,2439,8.9,0.19159049
8041,8041,Deryk Engelland,2013-14,31.0,5,6,42,42,0,6,6,31.0,585.0,187,7,28,35,170.0,48,5.31,29,160,1399,9.1,0.13113579
8042,8042,Deryk Engelland,2014-15,32.0,6,12,56,56,6,6,12,59.0,730.0,243,13,34,47,229.0,82,5.34,48,269,2463,8.9,0.1992361
8043,8043,Deryk Engelland,2015-16,33.0,7,11,76,76,2,9,11,51.0,1093.0,319,15,43,58,280.0,82,5.32,47,251,2453,8.9,0.13593796
8044,8044,Deryk Engelland,2016-17,34.0,8,12,69,69,3,9,12,71.0,1051.0,388,18,52,70,351.0,82,5.34,48,255,2438,9.0,0.14981371
8045,8045,Deryk Engelland,2017-18,35.0,9,16,81,81,4,12,16,107.0,1485.0,469,22,64,86,458.0,82,5.45,47,245,2478,9.0,0.2194489
8046,8046,Deryk Engelland,2018-19,36.0,10,23,79,79,5,18,23,108.0,1602.0,548,27,82,109,566.0,82,5.86,50,250,2620,9.2,0.24271315
8047,8047,Deryk Engelland,2019-20,37.0,11,12,74,74,2,10,12,105.0,1471.0,622,29,92,121,671.0,82,5.96,47,239,2579,9.5,0.17558908
8048,8048,Deryk Engelland,2020-21,38.0,12,6,49,49,1,5,6,59.0,860.0,671,30,97,127,730.0,70,5.96,42,208,2192,9.5,0.14977458
8049,8049,Devante Smith-Pelly,2012-13,20.0,2,13,49,49,7,6,13,66.0,590.0,49,7,6,13,66.0,82,5.32,47,271,2439,8.9,0.31968355
8050,8050,Devante Smith-Pelly,2013-14,21.0,3,0,7,7,0,0,0,5.0,63.0,56,7,6,13,71.0,48,5.31,29,160,1399,9.1,0.29751408
8051,8051,Devante Smith-Pelly,2014-15,22.0,4,10,19,19,2,8,10,23.0,240.0,75,9,14,23,94.0,82,5.34,48,269,2463,8.9,0.3309262
8052,8052,Devante Smith-Pelly,2015-16,23.0,5,20,74,74,6,14,20,104.0,1057.0,149,15,28,43,198.0,82,5.32,47,251,2453,8.9,0.2980341
8053,8053,Devante Smith-Pelly,2016-17,24.0,6,25,64,64,14,11,25,94.0,787.0,213,29,39,68,292.0,82,5.34,48,255,2438,9.0,0.3747095
8054,8054,Devante Smith-Pelly,2017-18,25.0,7,9,53,53,4,5,9,76.0,716.0,266,33,44,77,368.0,82,5.45,47,245,2478,9.0,0.22142696
8055,8055,Devante Smith-Pelly,2018-19,26.0,8,16,75,75,7,9,16,103.0,926.0,341,40,53,93,471.0,82,5.86,50,250,2620,9.2,0.24704966
8056,8056,Devante Smith-Pelly,2019-20,27.0,9,8,54,54,4,4,8,60.0,586.0,395,44,57,101,531.0,82,5.96,47,239,2579,9.5,0.17796716
8057,8057,Devin Setoguchi,2008-09,22.0,2,17,44,44,11,6,17,105.0,627.0,44,11,6,17,105.0,82,5.44,62,351,2383,9.4,0.4144203
8058,8058,Devin Setoguchi,2009-10,23.0,3,65,81,81,31,34,65,246.0,1313.0,125,42,40,82,351.0,82,5.7,65,341,2477,9.4,0.78437126
8059,8059,Devin Setoguchi,2010-11,24.0,4,36,70,70,20,16,36,165.0,1071.0,195,62,56,118,516.0,82,5.53,56,304,2486,9.1,0.52454865
8060,8060,Devin Setoguchi,2011-12,25.0,5,41,72,72,22,19,41,199.0,1095.0,267,84,75,159,715.0,82,5.46,52,291,2492,9.0,0.5698164
8061,8061,Devin Setoguchi,2012-13,26.0,6,36,69,69,19,17,36,174.0,1214.0,336,103,92,195,889.0,82,5.32,47,271,2439,8.9,0.5335275
8062,8062,Devin Setoguchi,2013-14,27.0,7,27,48,48,13,14,27,97.0,693.0,384,116,106,222,986.0,48,5.31,29,160,1399,9.1,0.56974447
8063,8063,Devin Setoguchi,2014-15,28.0,8,27,75,75,11,16,27,129.0,1129.0,459,127,122,249,1115.0,82,5.34,48,269,2463,8.9,0.3543698
8064,8064,Devin Setoguchi,2015-16,29.0,9,0,12,12,0,0,0,12.0,146.0,471,127,122,249,1127.0,82,5.32,47,251,2453,8.9,0.29556072
8065,8065,Devin Setoguchi,2017-18,31.0,10,12,45,45,4,8,12,60.0,560.0,516,131,130,261,1187.0,82,5.45,47,245,2478,9.0,0.26338166
8066,8066,Devin Shore,2016-17,22.0,2,0,3,3,0,0,0,1.0,36.0,3,0,0,0,1.0,82,5.34,48,255,2438,9.0,0.1645863
8067,8067,Devin Shore,2017-18,23.0,3,33,82,82,13,20,33,115.0,1159.0,85,13,20,33,116.0,82,5.45,47,245,2478,9.0,0.4714156
8068,8068,Devin Shore,2018-19,24.0,4,32,82,82,11,21,32,123.0,1265.0,167,24,41,65,239.0,82,5.86,50,250,2620,9.2,0.38264963
8069,8069,Devin Shore,2019-20,25.0,5,29,76,76,10,19,29,82.0,1084.0,243,34,60,94,321.0,82,5.96,47,239,2579,9.5,0.33557212
8070,8070,Devin Shore,2020-21,26.0,6,12,45,45,5,7,12,50.0,524.0,288,39,67,106,371.0,70,5.96,42,208,2192,9.5,0.30978793
8071,8071,Devon Toews,2019-20,25.0,2,18,48,48,5,13,18,81.0,859.0,48,5,13,18,81.0,82,5.96,47,239,2579,9.5,0.33650923
8072,8072,Devon Toews,2020-21,26.0,3,28,68,68,6,22,28,122.0,1395.0,116,11,35,46,203.0,70,5.96,42,208,2192,9.5,0.4182183
8073,8073,Dick Tarnstrom,2002-03,28.0,2,19,62,62,3,16,19,59.0,1094.0,62,3,16,19,59.0,82,5.24,53,338,2262,9.5,0.24901447
8074,8074,Dick Tarnstrom,2003-04,29.0,3,41,61,61,7,34,41,115.0,1458.0,123,10,50,60,174.0,82,5.31,60,363,2326,9.4,0.5353887
8075,8075,Dick Tarnstrom,2004-05,30.0,4,52,80,80,16,36,52,158.0,1924.0,203,26,86,112,332.0,82,5.14,57,348,2300,9.2,0.62527466
8076,8076,Dick Tarnstrom,2006-07,32.0,5,14,55,55,6,8,14,60.0,931.0,258,32,94,126,392.0,82,6.05,85,480,2458,10.1,0.29445034
8077,8077,Dick Tarnstrom,2008-09,34.0,6,14,48,48,3,11,14,44.0,930.0,306,35,105,140,436.0,82,5.44,62,351,2383,9.4,0.29775167
8078,8078,Dillon Dube,2019-20,21.0,2,5,25,25,1,4,5,22.0,252.0,25,1,4,5,22.0,82,5.96,47,239,2579,9.5,0.26687366
8079,8079,Dillon Dube,2020-21,22.0,3,16,45,45,6,10,16,60.0,571.0,70,7,14,21,82.0,70,5.96,42,208,2192,9.5,0.36372733
8080,8080,Dillon Heatherington,2018-19,23.0,2,1,6,6,0,1,1,6.0,65.0,6,0,1,1,6.0,82,5.86,50,250,2620,9.2,0.19409063
8081,8081,Dillon Heatherington,2019-20,24.0,3,1,5,5,0,1,1,5.0,51.0,11,0,2,2,11.0,82,5.96,47,239,2579,9.5,0.18177518
8082,8082,Dillon Simpson,2017-18,24.0,2,0,3,3,0,0,0,2.0,33.0,3,0,0,0,2.0,82,5.45,47,245,2478,9.0,0.17709363
8083,8083,Dino Ciccarelli,1981-82,21.0,2,30,32,32,18,12,30,126.0,,32,18,12,30,126.0,80,7.69,77,340,2441,12.6,1.0132694
8084,8084,Dino Ciccarelli,1982-83,22.0,3,106,76,76,55,51,106,289.0,,108,73,63,136,415.0,80,8.03,73,320,2489,12.9,1.1978338
8085,8085,Dino Ciccarelli,1983-84,23.0,4,75,77,77,37,38,75,210.0,,185,110,101,211,625.0,80,7.73,71,310,2444,12.7,0.95088863
8086,8086,Dino Ciccarelli,1984-85,24.0,5,71,79,79,38,33,71,211.0,,264,148,134,282,836.0,80,7.89,74,336,2448,12.9,0.9068612
8087,8087,Dino Ciccarelli,1985-86,25.0,6,32,51,51,15,17,32,133.0,,315,163,151,314,969.0,80,7.77,71,321,2447,12.7,0.83023477
8088,8088,Dino Ciccarelli,1986-87,26.0,7,89,75,75,44,45,89,262.0,,390,207,196,403,1231.0,80,7.94,82,370,2484,12.8,1.0980675
8089,8089,Dino Ciccarelli,1987-88,27.0,8,103,80,80,52,51,103,255.0,,470,259,247,506,1486.0,80,7.34,72,344,2400,12.2,1.185708
8090,8090,Dino Ciccarelli,1988-89,28.0,9,86,67,67,41,45,86,262.0,,537,300,292,592,1748.0,80,7.43,89,437,2435,12.2,1.1122369
8091,8091,Dino Ciccarelli,1989-90,29.0,10,74,76,76,44,30,74,247.0,,613,344,322,666,1995.0,80,7.48,85,403,2430,12.3,0.8892751
8092,8092,Dino Ciccarelli,1990-91,30.0,11,79,80,80,41,38,79,267.0,,693,385,360,745,2262.0,80,7.37,76,367,2421,12.2,0.83712995
8093,8093,Dino Ciccarelli,1991-92,31.0,12,39,54,54,21,18,39,186.0,,747,406,378,784,2448.0,80,6.91,71,366,2385,11.6,0.80177665
8094,8094,Dino Ciccarelli,1992-93,32.0,13,76,78,78,38,38,76,279.0,,825,444,416,860,2727.0,80,6.96,77,402,2440,11.4,0.9110689
8095,8095,Dino Ciccarelli,1993-94,33.0,14,97,82,82,41,56,97,200.0,,907,485,472,957,2927.0,84,7.25,87,443,2603,11.7,0.9358825
8096,8096,Dino Ciccarelli,1994-95,34.0,15,57,66,66,28,29,57,153.0,,973,513,501,1014,3080.0,84,6.48,76,407,2545,10.7,0.76695776
8097,8097,Dino Ciccarelli,1995-96,35.0,16,43,42,42,16,27,43,106.0,,1015,529,528,1057,3186.0,48,5.97,37,209,1408,10.2,0.80237174
8098,8098,Dino Ciccarelli,1996-97,36.0,17,43,64,64,22,21,43,107.0,,1079,551,549,1100,3293.0,82,6.29,74,413,2481,10.4,0.5813883
8099,8099,Dino Ciccarelli,1997-98,37.0,18,60,77,77,35,25,60,229.0,,1156,586,574,1160,3522.0,82,5.83,55,336,2444,9.8,0.6371691
8100,8100,Dino Ciccarelli,1998-99,38.0,19,33,62,62,16,17,33,161.0,,1218,602,591,1193,3683.0,82,5.28,57,380,2242,9.6,0.5686809
8101,8101,Dino Ciccarelli,1999-00,39.0,20,7,14,14,6,1,7,23.0,186.0,1232,608,592,1200,3706.0,82,5.27,57,359,2285,9.4,0.5442652
8102,8102,Dion Phaneuf,2006-07,21.0,2,49,82,82,20,29,49,242.0,1782.0,82,20,29,49,242.0,82,6.05,85,480,2458,10.1,0.6535371
8103,8103,Dion Phaneuf,2007-08,22.0,3,50,79,79,17,33,50,230.0,2027.0,161,37,62,99,472.0,82,5.76,70,398,2426,9.7,0.6627939
8104,8104,Dion Phaneuf,2008-09,23.0,4,60,82,82,17,43,60,263.0,2167.0,243,54,105,159,735.0,82,5.44,62,351,2383,9.4,0.7642685
8105,8105,Dion Phaneuf,2009-10,24.0,5,47,80,80,11,36,47,277.0,2122.0,323,65,141,206,1012.0,82,5.7,65,341,2477,9.4,0.6842443
8106,8106,Dion Phaneuf,2010-11,25.0,6,32,81,81,12,20,32,225.0,1964.0,404,77,161,238,1237.0,82,5.53,56,304,2486,9.1,0.5066957
8107,8107,Dion Phaneuf,2011-12,26.0,7,30,66,66,8,22,30,190.0,1670.0,470,85,183,268,1427.0,82,5.46,52,291,2492,9.0,0.52405614
8108,8108,Dion Phaneuf,2012-13,27.0,8,44,82,82,12,32,44,202.0,2074.0,552,97,215,312,1629.0,82,5.32,47,271,2439,8.9,0.5973833
8109,8109,Dion Phaneuf,2013-14,28.0,9,28,48,48,9,19,28,88.0,1209.0,600,106,234,340,1717.0,48,5.31,29,160,1399,9.1,0.5286516
8110,8110,Dion Phaneuf,2014-15,29.0,10,31,80,80,8,23,31,145.0,1885.0,680,114,257,371,1862.0,82,5.34,48,269,2463,8.9,0.41288072
8111,8111,Dion Phaneuf,2015-16,30.0,11,29,70,70,3,26,29,138.0,1660.0,750,117,283,400,2000.0,82,5.32,47,251,2453,8.9,0.3884478
8112,8112,Dion Phaneuf,2016-17,31.0,12,32,71,71,4,28,32,144.0,1587.0,821,121,311,432,2144.0,82,5.34,48,255,2438,9.0,0.39685756
8113,8113,Dion Phaneuf,2017-18,32.0,13,30,81,81,9,21,30,156.0,1866.0,902,130,332,462,2300.0,82,5.45,47,245,2478,9.0,0.38073188
8114,8114,Dion Phaneuf,2018-19,33.0,14,26,79,79,6,20,26,134.0,1580.0,981,136,352,488,2434.0,82,5.86,50,250,2620,9.2,0.31658834
8115,8115,Dion Phaneuf,2019-20,34.0,15,6,67,67,1,5,6,80.0,1005.0,1048,137,357,494,2514.0,82,5.96,47,239,2579,9.5,0.16937059
8116,8116,Dirk Graham,1984-85,25.0,2,2,6,6,1,1,2,10.0,,6,1,1,2,10.0,80,7.89,74,336,2448,12.9,0.2840675
8117,8117,Dirk Graham,1985-86,26.0,3,23,36,36,12,11,23,81.0,,42,13,12,25,91.0,80,7.77,71,321,2447,12.7,0.5133145
8118,8118,Dirk Graham,1986-87,27.0,4,55,80,80,22,33,55,173.0,,122,35,45,80,264.0,80,7.94,82,370,2484,12.8,0.5882883
8119,8119,Dirk Graham,1987-88,28.0,5,54,76,76,25,29,54,197.0,,198,60,74,134,461.0,80,7.34,72,344,2400,12.2,0.67644507
8120,8120,Dirk Graham,1988-89,29.0,6,48,70,70,24,24,48,173.0,,268,84,98,182,634.0,80,7.43,89,437,2435,12.2,0.67556745
8121,8121,Dirk Graham,1989-90,30.0,7,78,80,80,33,45,78,217.0,,348,117,143,260,851.0,80,7.48,85,403,2430,12.3,0.80384314
8122,8122,Dirk Graham,1990-91,31.0,8,54,73,73,22,32,54,180.0,,421,139,175,314,1031.0,80,7.37,76,367,2421,12.2,0.63756573
8123,8123,Dirk Graham,1991-92,32.0,9,45,80,80,24,21,45,189.0,,501,163,196,359,1220.0,80,6.91,71,366,2385,11.6,0.59373784
8124,8124,Dirk Graham,1992-93,33.0,10,47,80,80,17,30,47,222.0,,581,180,226,406,1442.0,80,6.96,77,402,2440,11.4,0.5766878
8125,8125,Dirk Graham,1993-94,34.0,11,37,84,84,20,17,37,187.0,,665,200,243,443,1629.0,84,7.25,87,443,2603,11.7,0.46071345
8126,8126,Dirk Graham,1994-95,35.0,12,33,67,67,15,18,33,122.0,,732,215,261,476,1751.0,84,6.48,76,407,2545,10.7,0.39331153
8127,8127,Dirk Graham,1995-96,36.0,13,13,40,40,4,9,13,68.0,,772,219,270,489,1819.0,48,5.97,37,209,1408,10.2,0.3442068
8128,8128,Dixon Ward,1993-94,25.0,2,52,70,70,22,30,52,111.0,,70,22,30,52,111.0,84,7.25,87,443,2603,11.7,0.56666017
8129,8129,Dixon Ward,1994-95,26.0,3,15,67,67,12,3,15,90.0,,137,34,33,67,201.0,84,6.48,76,407,2545,10.7,0.28829685
8130,8130,Dixon Ward,1995-96,27.0,4,3,22,22,0,3,3,15.0,,159,34,36,70,216.0,48,5.97,37,209,1408,10.2,0.27883893
8131,8131,Dixon Ward,1996-97,28.0,5,4,8,8,2,2,4,12.0,,167,36,38,74,228.0,82,6.29,74,413,2481,10.4,0.26622778
8132,8132,Dixon Ward,1997-98,29.0,6,45,79,79,13,32,45,93.0,,246,49,70,119,321.0,82,5.83,55,336,2444,9.8,0.45675868
8133,8133,Dixon Ward,1998-99,30.0,7,23,71,71,10,13,23,99.0,,317,59,83,142,420.0,82,5.28,57,380,2242,9.6,0.33361697
8134,8134,Dixon Ward,1999-00,31.0,8,44,78,78,20,24,44,101.0,1231.0,395,79,107,186,521.0,82,5.27,57,359,2285,9.4,0.4639887
8135,8135,Dixon Ward,2000-01,32.0,9,20,71,71,11,9,20,101.0,992.0,466,90,116,206,622.0,82,5.49,53,331,2294,9.8,0.2928663
8136,8136,Dixon Ward,2001-02,33.0,10,18,63,63,5,13,18,88.0,796.0,529,95,129,224,710.0,82,5.51,63,376,2272,9.9,0.22667441
8137,8137,Dixon Ward,2003-04,35.0,11,0,8,8,0,0,0,7.0,70.0,537,95,129,224,717.0,82,5.31,60,363,2326,9.4,0.17421219
8138,8138,Dmitri Bykov,2003-04,26.0,2,12,71,71,2,10,12,58.0,1304.0,71,2,10,12,58.0,82,5.31,60,363,2326,9.4,0.15908006
8139,8139,Dmitri Filimonov,1994-95,23.0,2,5,30,30,1,4,5,15.0,,30,1,4,5,15.0,84,6.48,76,407,2545,10.7,0.18644804
8140,8140,Dmitri Kalinin,2000-01,20.0,2,0,4,4,0,0,0,3.0,68.0,4,0,0,0,3.0,82,5.49,53,331,2294,9.8,0.2224206
8141,8141,Dmitri Kalinin,2001-02,21.0,3,22,79,79,4,18,22,88.0,1566.0,83,4,18,22,91.0,82,5.51,63,376,2272,9.9,0.30384144
8142,8142,Dmitri Kalinin,2002-03,22.0,4,13,58,58,2,11,13,67.0,1047.0,141,6,29,35,158.0,82,5.24,53,338,2262,9.5,0.24777779
8143,8143,Dmitri Kalinin,2003-04,23.0,5,21,65,65,8,13,21,83.0,1409.0,206,14,42,56,241.0,82,5.31,60,363,2326,9.4,0.34240633
8144,8144,Dmitri Kalinin,2004-05,24.0,6,34,77,77,10,24,34,118.0,1778.0,283,24,66,90,359.0,82,5.14,57,348,2300,9.2,0.44544157
8145,8145,Dmitri Kalinin,2006-07,26.0,7,18,55,55,2,16,18,47.0,922.0,338,26,82,108,406.0,82,6.05,85,480,2458,10.1,0.3030054
8146,8146,Dmitri Kalinin,2007-08,27.0,8,29,82,82,7,22,29,86.0,1600.0,420,33,104,137,492.0,82,5.76,70,398,2426,9.7,0.3469692
8147,8147,Dmitri Kalinin,2008-09,28.0,9,8,46,46,1,7,8,60.0,798.0,466,34,111,145,552.0,82,5.44,62,351,2383,9.4,0.19902003
8148,8148,Dmitri Kalinin,2009-10,29.0,10,17,73,73,2,15,17,67.0,1290.0,539,36,126,162,619.0,82,5.7,65,341,2477,9.4,0.21053076
8149,8149,Dmitri Khristich,1991-92,22.0,2,27,40,40,13,14,27,77.0,,40,13,14,27,77.0,80,6.91,71,366,2385,11.6,0.6188172
8150,8150,Dmitri Khristich,1992-93,23.0,3,73,80,80,36,37,73,188.0,,120,49,51,100,265.0,80,6.96,77,402,2440,11.4,0.882457
8151,8151,Dmitri Khristich,1993-94,24.0,4,66,64,64,31,35,66,127.0,,184,80,86,166,392.0,84,7.25,87,443,2603,11.7,0.95213544
8152,8152,Dmitri Khristich,1994-95,25.0,5,58,83,83,29,29,58,195.0,,267,109,115,224,587.0,84,6.48,76,407,2545,10.7,0.65284824
8153,8153,Dmitri Khristich,1995-96,26.0,6,26,48,48,12,14,26,92.0,,315,121,129,250,679.0,48,5.97,37,209,1408,10.2,0.70794487
8154,8154,Dmitri Khristich,1996-97,27.0,7,64,76,76,27,37,64,204.0,,391,148,166,314,883.0,82,6.29,74,413,2481,10.4,0.69898254
8155,8155,Dmitri Khristich,1997-98,28.0,8,56,75,75,19,37,56,135.0,,466,167,203,370,1018.0,82,5.83,55,336,2444,9.8,0.71135575
8156,8156,Dmitri Khristich,1998-99,29.0,9,66,82,82,29,37,66,144.0,,548,196,240,436,1162.0,82,5.28,57,380,2242,9.6,0.8087965
8157,8157,Dmitri Khristich,1999-00,30.0,10,71,79,79,29,42,71,144.0,1562.0,627,225,282,507,1306.0,82,5.27,57,359,2285,9.4,0.7824935
8158,8158,Dmitri Khristich,2000-01,31.0,11,30,53,53,12,18,30,79.0,857.0,680,237,300,537,1385.0,82,5.49,53,331,2294,9.8,0.533419
8159,8159,Dmitri Khristich,2001-02,32.0,12,38,70,70,13,25,38,77.0,1046.0,750,250,325,575,1462.0,82,5.51,63,376,2272,9.9,0.46332902
8160,8160,Dmitri Khristich,2002-03,33.0,13,21,61,61,9,12,21,54.0,854.0,811,259,337,596,1516.0,82,5.24,53,338,2262,9.5,0.37207037
8161,8161,Dmitri Kvartalnov,1993-94,27.0,2,72,73,73,30,42,72,226.0,,73,30,42,72,226.0,84,7.25,87,443,2603,11.7,0.7217538
8162,8162,Dmitri Kvartalnov,1994-95,28.0,3,19,39,39,12,7,19,68.0,,112,42,49,91,294.0,84,6.48,76,407,2545,10.7,0.4373865
8163,8163,Dmitri Mironov,1992-93,27.0,2,1,7,7,1,0,1,7.0,,7,1,0,1,7.0,80,6.96,77,402,2440,11.4,0.25506872
8164,8164,Dmitri Mironov,1993-94,28.0,3,31,59,59,7,24,31,105.0,,66,8,24,32,112.0,84,7.25,87,443,2603,11.7,0.4893802
8165,8165,Dmitri Mironov,1994-95,29.0,4,36,76,76,9,27,36,147.0,,142,17,51,68,259.0,84,6.48,76,407,2545,10.7,0.41758484
8166,8166,Dmitri Mironov,1995-96,30.0,5,17,33,33,5,12,17,68.0,,175,22,63,85,327.0,48,5.97,37,209,1408,10.2,0.4069619
8167,8167,Dmitri Mironov,1996-97,31.0,6,34,72,72,3,31,34,86.0,,247,25,94,119,413.0,82,6.29,74,413,2481,10.4,0.38763165
8168,8168,Dmitri Mironov,1997-98,32.0,7,52,77,77,13,39,52,177.0,,324,38,133,171,590.0,82,5.83,55,336,2444,9.8,0.54303133
8169,8169,Dmitri Mironov,1998-99,33.0,8,43,77,77,8,35,43,170.0,,401,46,168,214,760.0,82,5.28,57,380,2242,9.6,0.4838561
8170,8170,Dmitri Mironov,1999-00,34.0,9,16,46,46,2,14,16,86.0,913.0,447,48,182,230,846.0,82,5.27,57,359,2285,9.4,0.33034876
8171,8171,Dmitri Mironov,2000-01,35.0,10,22,73,73,3,19,22,99.0,1487.0,520,51,201,252,945.0,82,5.49,53,331,2294,9.8,0.2796188
8172,8172,Dmitri Mironov,2001-02,36.0,11,8,36,36,3,5,8,33.0,595.0,556,54,206,260,978.0,82,5.51,63,376,2272,9.9,0.19910574
8173,8173,Dmitri Nabokov,1998-99,22.0,2,11,25,25,7,4,11,34.0,,25,7,4,11,34.0,82,5.28,57,380,2242,9.6,0.3427368
8174,8174,Dmitri Nabokov,1999-00,23.0,3,2,4,4,0,2,2,4.0,47.0,29,7,6,13,38.0,82,5.27,57,359,2285,9.4,0.24254218
8175,8175,Dmitri Nabokov,2000-01,24.0,4,11,26,26,4,7,11,40.0,352.0,55,11,13,24,78.0,82,5.49,53,331,2294,9.8,0.27808335
8176,8176,Dmitri Tertyshny,1999-00,23.0,2,10,62,62,2,8,10,68.0,1150.0,62,2,8,10,68.0,82,5.27,57,359,2285,9.4,0.20459434
8177,8177,Dmitri Yakushin,2000-01,23.0,2,0,2,2,0,0,0,1.0,20.0,2,0,0,0,1.0,82,5.49,53,331,2294,9.8,0.17198798
8178,8178,Dmitrij Jaskin,2013-14,20.0,2,0,2,2,0,0,0,2.0,15.0,2,0,0,0,2.0,48,5.31,29,160,1399,9.1,0.24648023
8179,8179,Dmitrij Jaskin,2014-15,21.0,3,2,18,18,1,1,2,18.0,191.0,20,1,1,2,20.0,82,5.34,48,269,2463,8.9,0.24722856
8180,8180,Dmitrij Jaskin,2015-16,22.0,4,18,54,54,13,5,18,108.0,727.0,74,14,6,20,128.0,82,5.32,47,251,2453,8.9,0.41436428
8181,8181,Dmitrij Jaskin,2016-17,23.0,5,13,65,65,4,9,13,92.0,771.0,139,18,15,33,220.0,82,5.34,48,255,2438,9.0,0.22484905
8182,8182,Dmitrij Jaskin,2017-18,24.0,6,11,51,51,1,10,11,55.0,589.0,190,19,25,44,275.0,82,5.45,47,245,2478,9.0,0.22043726
8183,8183,Dmitrij Jaskin,2018-19,25.0,7,17,76,76,6,11,17,124.0,946.0,266,25,36,61,399.0,82,5.86,50,250,2620,9.2,0.2608553
8184,8184,Dmitrij Jaskin,2019-20,26.0,8,8,37,37,2,6,8,48.0,373.0,303,27,42,69,447.0,82,5.96,47,239,2579,9.5,0.2174581
8185,8185,Dmitry Afanasenkov,2001-02,21.0,2,2,9,9,1,1,2,8.0,103.0,9,1,1,2,8.0,82,5.51,63,376,2272,9.9,0.22806406
8186,8186,Dmitry Afanasenkov,2002-03,22.0,3,0,5,5,0,0,0,1.0,25.0,14,1,1,2,9.0,82,5.24,53,338,2262,9.5,0.16263106
8187,8187,Dmitry Afanasenkov,2004-05,24.0,4,16,71,71,6,10,16,98.0,877.0,85,7,11,18,107.0,82,5.14,57,348,2300,9.2,0.29104197
8188,8188,Dmitry Afanasenkov,2006-07,26.0,5,15,68,68,9,6,15,78.0,662.0,153,16,17,33,185.0,82,6.05,85,480,2458,10.1,0.22213855
8189,8189,Dmitry Afanasenkov,2007-08,27.0,6,21,74,74,11,10,21,96.0,779.0,227,27,27,54,281.0,82,5.76,70,398,2426,9.7,0.26690954
8190,8190,Dmitry Korobov,2014-15,25.0,2,1,3,3,0,1,1,0.0,32.0,3,0,1,1,0.0,82,5.34,48,269,2463,8.9,0.16924879
8191,8191,Dmitry Kulikov,2010-11,20.0,2,16,68,68,3,13,16,87.0,1220.0,68,3,13,16,87.0,82,5.53,56,304,2486,9.1,0.28476536
8192,8192,Dmitry Kulikov,2011-12,21.0,3,26,72,72,6,20,26,83.0,1436.0,140,9,33,42,170.0,82,5.46,52,291,2492,9.0,0.39119202
8193,8193,Dmitry Kulikov,2012-13,22.0,4,28,58,58,4,24,28,104.0,1268.0,198,13,57,70,274.0,82,5.32,47,271,2439,8.9,0.41616842
8194,8194,Dmitry Kulikov,2013-14,23.0,5,10,34,34,3,7,10,52.0,713.0,232,16,64,80,326.0,48,5.31,29,160,1399,9.1,0.3369713
8195,8195,Dmitry Kulikov,2014-15,24.0,6,19,81,81,8,11,19,127.0,1757.0,313,24,75,99,453.0,82,5.34,48,269,2463,8.9,0.30713144
8196,8196,Dmitry Kulikov,2015-16,25.0,7,22,73,73,3,19,22,83.0,1556.0,386,27,94,121,536.0,82,5.32,47,251,2453,8.9,0.29041797
8197,8197,Dmitry Kulikov,2016-17,26.0,8,17,74,74,1,16,17,99.0,1557.0,460,28,110,138,635.0,82,5.34,48,255,2438,9.0,0.25058198
8198,8198,Dmitry Kulikov,2017-18,27.0,9,5,47,47,2,3,5,42.0,1029.0,507,30,113,143,677.0,82,5.45,47,245,2478,9.0,0.19160986
8199,8199,Dmitry Kulikov,2018-19,28.0,10,11,62,62,3,8,11,48.0,1058.0,569,33,121,154,725.0,82,5.86,50,250,2620,9.2,0.17099768
8200,8200,Dmitry Kulikov,2019-20,29.0,11,6,57,57,0,6,6,40.0,893.0,626,33,127,160,765.0,82,5.96,47,239,2579,9.5,0.14633694
8201,8201,Dmitry Kulikov,2020-21,30.0,12,10,51,51,2,8,10,54.0,1021.0,677,35,135,170,819.0,70,5.96,42,208,2192,9.5,0.21698004
8202,8202,Dmitry Orlov,2012-13,21.0,2,19,60,60,3,16,19,51.0,1012.0,60,3,16,19,51.0,82,5.32,47,271,2439,8.9,0.30257595
8203,8203,Dmitry Orlov,2013-14,22.0,3,1,5,5,0,1,1,1.0,75.0,65,3,17,20,52.0,48,5.31,29,160,1399,9.1,0.2252334
8204,8204,Dmitry Orlov,2014-15,23.0,4,11,54,54,3,8,11,59.0,1058.0,119,6,25,31,111.0,82,5.34,48,269,2463,8.9,0.25384808
8205,8205,Dmitry Orlov,2016-17,25.0,5,29,82,82,8,21,29,90.0,1314.0,201,14,46,60,201.0,82,5.34,48,255,2438,9.0,0.33671117
8206,8206,Dmitry Orlov,2017-18,26.0,6,33,82,82,6,27,33,125.0,1602.0,283,20,73,93,326.0,82,5.45,47,245,2478,9.0,0.39913052
8207,8207,Dmitry Orlov,2018-19,27.0,7,31,82,82,10,21,31,125.0,1897.0,365,30,94,124,451.0,82,5.86,50,250,2620,9.2,0.4040747
8208,8208,Dmitry Orlov,2019-20,28.0,8,29,82,82,3,26,29,101.0,1774.0,447,33,120,153,552.0,82,5.96,47,239,2579,9.5,0.3358274
8209,8209,Dmitry Orlov,2020-21,29.0,9,27,69,69,4,23,27,105.0,1530.0,516,37,143,180,657.0,70,5.96,42,208,2192,9.5,0.34990144
8210,8210,Dmitry Yushkevich,1993-94,22.0,2,32,82,82,5,27,32,155.0,,82,5,27,32,155.0,84,7.25,87,443,2603,11.7,0.4553178
8211,8211,Dmitry Yushkevich,1994-95,23.0,3,30,75,75,5,25,30,136.0,,157,10,52,62,291.0,84,6.48,76,407,2545,10.7,0.42122352
8212,8212,Dmitry Yushkevich,1995-96,24.0,4,14,40,40,5,9,14,80.0,,197,15,61,76,371.0,48,5.97,37,209,1408,10.2,0.38751516
8213,8213,Dmitry Yushkevich,1996-97,25.0,5,11,69,69,1,10,11,96.0,,266,16,71,87,467.0,82,6.29,74,413,2481,10.4,0.20965111
8214,8214,Dmitry Yushkevich,1997-98,26.0,6,14,74,74,4,10,14,99.0,,340,20,81,101,566.0,82,5.83,55,336,2444,9.8,0.26314297
8215,8215,Dmitry Yushkevich,1998-99,27.0,7,12,72,72,0,12,12,92.0,,412,20,93,113,658.0,82,5.28,57,380,2242,9.6,0.2023586
8216,8216,Dmitry Yushkevich,1999-00,28.0,8,28,78,78,6,22,28,95.0,1742.0,490,26,115,141,753.0,82,5.27,57,359,2285,9.4,0.33731678
8217,8217,Dmitry Yushkevich,2000-01,29.0,9,27,77,77,3,24,27,103.0,1794.0,567,29,139,168,856.0,82,5.49,53,331,2294,9.8,0.31508404
8218,8218,Dmitry Yushkevich,2001-02,30.0,10,24,81,81,5,19,24,110.0,1963.0,648,34,158,192,966.0,82,5.51,63,376,2272,9.9,0.27815837
8219,8219,Dmitry Yushkevich,2002-03,31.0,11,19,55,55,6,13,19,79.0,1288.0,703,40,171,211,1045.0,82,5.24,53,338,2262,9.5,0.32934356
8220,8220,Dmitry Yushkevich,2003-04,32.0,12,14,83,83,3,11,14,75.0,1708.0,786,43,182,225,1120.0,82,5.31,60,363,2326,9.4,0.17573938
8221,8221,Dmytro Timashov,2020-21,24.0,2,9,44,44,4,5,9,37.0,375.0,44,4,5,9,37.0,70,5.96,42,208,2192,9.5,0.21115226
8222,8222,Dody Wood,1993-94,21.0,2,2,13,13,1,1,2,10.0,,13,1,1,2,10.0,84,7.25,87,443,2603,11.7,0.28966013
8223,8223,Dody Wood,1995-96,23.0,3,2,9,9,1,1,2,5.0,,22,2,2,4,15.0,48,5.97,37,209,1408,10.2,0.23724726
8224,8224,Dody Wood,1996-97,24.0,4,9,32,32,3,6,9,33.0,,54,5,8,13,48.0,82,6.29,74,413,2481,10.4,0.23627943
8225,8225,Dody Wood,1997-98,25.0,5,5,44,44,3,2,5,43.0,,98,8,10,18,91.0,82,5.83,55,336,2444,9.8,0.16882113
8226,8226,Dody Wood,1998-99,26.0,6,0,8,8,0,0,0,4.0,,106,8,10,18,95.0,82,5.28,57,380,2242,9.6,0.16334426
8227,8227,Dom Campedelli,1986-87,22.0,2,0,2,2,0,0,0,1.0,,2,0,0,0,1.0,80,7.94,82,370,2484,12.8,0.21656275
8228,8228,Domenic Pittis,1997-98,23.0,2,0,1,1,0,0,0,0.0,,1,0,0,0,0.0,82,5.83,55,336,2444,9.8,0.15535027
8229,8229,Domenic Pittis,1999-00,25.0,3,0,3,3,0,0,0,1.0,26.0,4,0,0,0,1.0,82,5.27,57,359,2285,9.4,0.16009426
8230,8230,Domenic Pittis,2000-01,26.0,4,1,7,7,1,0,1,6.0,80.0,11,1,0,1,7.0,82,5.49,53,331,2294,9.8,0.17935824
8231,8231,Domenic Pittis,2001-02,27.0,5,9,47,47,4,5,9,42.0,506.0,58,5,5,10,49.0,82,5.51,63,376,2272,9.9,0.15232164
8232,8232,Domenic Pittis,2002-03,28.0,6,6,22,22,0,6,6,18.0,251.0,80,5,11,16,67.0,82,5.24,53,338,2262,9.5,0.15230772
8233,8233,Domenic Pittis,2003-04,29.0,7,0,2,2,0,0,0,1.0,10.0,82,5,11,16,68.0,82,5.31,60,363,2326,9.4,0.14552915
8234,8234,Domenic Pittis,2004-05,30.0,8,0,4,4,0,0,0,3.0,46.0,86,5,11,16,71.0,82,5.14,57,348,2300,9.2,0.17509568
8235,8235,Dominic Lavoie,1989-90,22.0,2,0,1,1,0,0,0,1.0,,1,0,0,0,1.0,80,7.48,85,403,2430,12.3,0.21754727
8236,8236,Dominic Lavoie,1990-91,23.0,3,2,13,13,1,1,2,20.0,,14,1,1,2,21.0,80,7.37,76,367,2421,12.2,0.25712648
8237,8237,Dominic Lavoie,1991-92,24.0,4,3,6,6,1,2,3,11.0,,20,2,3,5,32.0,80,6.91,71,366,2385,11.6,0.24587929
8238,8238,Dominic Lavoie,1992-93,25.0,5,1,6,6,0,1,1,11.0,,26,2,4,6,43.0,80,6.96,77,402,2440,11.4,0.20925993
8239,8239,Dominic Lavoie,1993-94,26.0,6,1,4,4,0,1,1,15.0,,30,2,5,7,58.0,84,7.25,87,443,2603,11.7,0.21021631
8240,8240,Dominic Lavoie,1994-95,27.0,7,6,8,8,3,3,6,21.0,,38,5,8,13,79.0,84,6.48,76,407,2545,10.7,0.2563619
8241,8241,Dominic Moore,2004-05,24.0,2,3,5,5,0,3,3,3.0,47.0,5,0,3,3,3.0,82,5.14,57,348,2300,9.2,0.21462986
8242,8242,Dominic Moore,2006-07,26.0,3,18,82,82,9,9,18,139.0,1022.0,87,9,12,21,142.0,82,6.05,85,480,2458,10.1,0.28588784
8243,8243,Dominic Moore,2007-08,27.0,4,17,69,69,8,9,17,111.0,873.0,156,17,21,38,253.0,82,5.76,70,398,2426,9.7,0.23740199
8244,8244,Dominic Moore,2008-09,28.0,5,17,68,68,5,12,17,100.0,904.0,224,22,33,55,353.0,82,5.44,62,351,2383,9.4,0.26202
8245,8245,Dominic Moore,2009-10,29.0,6,45,81,81,13,32,45,165.0,1364.0,305,35,65,100,518.0,82,5.7,65,341,2477,9.4,0.4708748
8246,8246,Dominic Moore,2010-11,30.0,7,28,69,69,10,18,28,119.0,1024.0,374,45,83,128,637.0,82,5.53,56,304,2486,9.1,0.35582924
8247,8247,Dominic Moore,2011-12,31.0,8,32,77,77,18,14,32,175.0,1201.0,451,63,97,160,812.0,82,5.46,52,291,2492,9.0,0.39652675
8248,8248,Dominic Moore,2012-13,32.0,9,25,79,79,4,21,25,103.0,1227.0,530,67,118,185,915.0,82,5.32,47,271,2439,8.9,0.28201866
8249,8249,Dominic Moore,2014-15,34.0,10,18,73,73,6,12,18,96.0,856.0,603,73,130,203,1011.0,82,5.34,48,269,2463,8.9,0.2630645
8250,8250,Dominic Moore,2015-16,35.0,11,27,82,82,10,17,27,116.0,1132.0,685,83,147,230,1127.0,82,5.32,47,251,2453,8.9,0.2720482
8251,8251,Dominic Moore,2016-17,36.0,12,15,80,80,6,9,15,94.0,1064.0,765,89,156,245,1221.0,82,5.34,48,255,2438,9.0,0.20206758
8252,8252,Dominic Moore,2017-18,37.0,13,25,82,82,11,14,25,96.0,1061.0,847,100,170,270,1317.0,82,5.45,47,245,2478,9.0,0.25332272
8253,8253,Dominic Moore,2018-19,38.0,14,12,50,50,6,6,12,46.0,515.0,897,106,176,282,1363.0,82,5.86,50,250,2620,9.2,0.18684891
8254,8254,Dominic Toninato,2018-19,24.0,2,2,37,37,0,2,2,25.0,292.0,37,0,2,2,25.0,82,5.86,50,250,2620,9.2,0.15904117
8255,8255,Dominic Toninato,2019-20,25.0,3,1,2,2,1,0,1,1.0,13.0,39,1,2,3,26.0,82,5.96,47,239,2579,9.5,0.18858418
8256,8256,Dominic Toninato,2020-21,26.0,4,11,46,46,4,7,11,38.0,513.0,85,5,9,14,64.0,70,5.96,42,208,2192,9.5,0.22818053
8257,8257,Dominic Turgeon,2018-19,22.0,2,0,5,5,0,0,0,3.0,46.0,5,0,0,0,3.0,82,5.86,50,250,2620,9.2,0.18558577
8258,8258,Dominic Turgeon,2019-20,23.0,3,0,4,4,0,0,0,2.0,50.0,9,0,0,0,5.0,82,5.96,47,239,2579,9.5,0.17906961
8259,8259,Dominik Kahun,2019-20,24.0,2,37,82,82,13,24,37,137.0,1160.0,82,13,24,37,137.0,82,5.96,47,239,2579,9.5,0.4865074
8260,8260,Dominik Kahun,2020-21,25.0,3,31,56,56,12,19,31,87.0,744.0,138,25,43,68,224.0,70,5.96,42,208,2192,9.5,0.4962221
8261,8261,Dominik Kubalík,2020-21,25.0,2,46,68,68,30,16,46,157.0,977.0,68,30,16,46,157.0,70,5.96,42,208,2192,9.5,0.6779573
8262,8262,Dominik Simon,2016-17,22.0,2,1,3,3,0,1,1,2.0,18.0,3,0,1,1,2.0,82,5.34,48,255,2438,9.0,0.19857627
8263,8263,Dominik Simon,2017-18,23.0,3,1,2,2,0,1,1,2.0,26.0,5,0,2,2,4.0,82,5.45,47,245,2478,9.0,0.2027472
8264,8264,Dominik Simon,2018-19,24.0,4,12,33,33,4,8,12,36.0,377.0,38,4,10,14,40.0,82,5.86,50,250,2620,9.2,0.23625618
8265,8265,Dominik Simon,2019-20,25.0,5,28,71,71,8,20,28,121.0,946.0,109,12,30,42,161.0,82,5.96,47,239,2579,9.5,0.37329787
8266,8266,Dominik Simon,2020-21,26.0,6,22,64,64,7,15,22,102.0,922.0,173,19,45,64,263.0,70,5.96,42,208,2192,9.5,0.3316419
8267,8267,Dominik Uher,2015-16,23.0,2,0,2,2,0,0,0,0.0,13.0,2,0,0,0,0.0,82,5.32,47,251,2453,8.9,0.14718214
8268,8268,Don Barber,1989-90,25.0,2,13,23,23,8,5,13,42.0,,23,8,5,13,42.0,80,7.48,85,403,2430,12.3,0.50187194
8269,8269,Don Barber,1990-91,26.0,3,34,44,44,15,19,34,100.0,,67,23,24,47,142.0,80,7.37,76,367,2421,12.2,0.5402941
8270,8270,Don Barber,1991-92,27.0,4,3,23,23,1,2,3,29.0,,90,24,26,50,171.0,80,6.91,71,366,2385,11.6,0.25841662
8271,8271,Don Barber,1992-93,28.0,5,7,25,25,1,6,7,24.0,,115,25,32,57,195.0,80,6.96,77,402,2440,11.4,0.2702297
8272,8272,Don Biggs,1985-86,20.0,2,0,1,1,0,0,0,0.0,,1,0,0,0,0.0,80,7.77,71,321,2447,12.7,0.25912797
8273,8273,Don Biggs,1990-91,25.0,3,2,11,11,2,0,2,14.0,,12,2,0,2,14.0,80,7.37,76,367,2421,12.2,0.2701303
8274,8274,Don Dietrich,1984-85,23.0,2,5,17,17,0,5,5,22.0,,17,0,5,5,22.0,80,7.89,74,336,2448,12.9,0.28545457
8275,8275,Don Dietrich,1986-87,25.0,3,2,11,11,0,2,2,14.0,,28,0,7,7,36.0,80,7.94,82,370,2484,12.8,0.21273494
8276,8276,Don Gibson,1991-92,24.0,2,3,14,14,0,3,3,9.0,,14,0,3,3,9.0,80,6.91,71,366,2385,11.6,0.21998465
8277,8277,Don Gillen,1980-81,20.0,2,1,1,1,1,0,1,2.0,,1,1,0,1,2.0,80,7.03,61,280,2352,12.0,0.32708824
8278,8278,Don Gillen,1982-83,22.0,3,5,34,34,1,4,5,25.0,,35,2,4,6,27.0,80,8.03,73,320,2489,12.9,0.24335271
8279,8279,Don Howse,1980-81,28.0,2,7,33,33,2,5,7,46.0,,33,2,5,7,46.0,80,7.03,61,280,2352,12.0,0.2727495
8280,8280,Don MacIver,1980-81,25.0,2,0,6,6,0,0,0,2.0,,6,0,0,0,2.0,80,7.03,61,280,2352,12.0,0.21139047
8281,8281,Don MacLean,1998-99,22.0,2,7,22,22,5,2,7,25.0,,22,5,2,7,25.0,82,5.28,57,380,2242,9.6,0.33576965
8282,8282,Don MacLean,2001-02,25.0,3,1,3,3,0,1,1,2.0,29.0,25,5,3,8,27.0,82,5.51,63,376,2272,9.9,0.18147898
8283,8283,Don MacLean,2004-05,28.0,4,1,4,4,1,0,1,10.0,47.0,29,6,3,9,37.0,82,5.14,57,348,2300,9.2,0.21057442
8284,8284,Don MacLean,2006-07,30.0,5,2,3,3,1,1,2,3.0,38.0,32,7,4,11,40.0,82,6.05,85,480,2458,10.1,0.16118231
8285,8285,Don MacLean,2007-08,31.0,6,2,9,9,1,1,2,12.0,114.0,41,8,5,13,52.0,82,5.76,70,398,2426,9.7,0.1730575
8286,8286,Don McSween,1988-89,24.0,2,1,5,5,0,1,1,4.0,,5,0,1,1,4.0,80,7.43,89,437,2435,12.2,0.23277095
8287,8287,Don McSween,1990-91,26.0,3,0,4,4,0,0,0,4.0,,9,0,1,1,8.0,80,7.37,76,367,2421,12.2,0.1906017
8288,8288,Don McSween,1994-95,30.0,4,12,32,32,3,9,12,43.0,,41,3,10,13,51.0,84,6.48,76,407,2545,10.7,0.20329303
8289,8289,Don McSween,1995-96,31.0,5,0,2,2,0,0,0,1.0,,43,3,10,13,52.0,48,5.97,37,209,1408,10.2,0.14751518
8290,8290,Don McSween,1996-97,32.0,6,0,4,4,0,0,0,1.0,,47,3,10,13,53.0,82,6.29,74,413,2481,10.4,0.13685897
8291,8291,Don Nachbaur,1981-82,23.0,2,33,77,77,16,17,33,70.0,,77,16,17,33,70.0,80,7.69,77,340,2441,12.6,0.43329608
8292,8292,Don Nachbaur,1982-83,24.0,3,26,77,77,5,21,26,113.0,,154,21,38,59,183.0,80,8.03,73,320,2489,12.9,0.34630275
8293,8293,Don Nachbaur,1983-84,25.0,4,0,4,4,0,0,0,0.0,,158,21,38,59,183.0,80,7.73,71,310,2444,12.7,0.28425637
8294,8294,Don Nachbaur,1986-87,28.0,5,2,5,5,1,1,2,4.0,,163,22,39,61,187.0,80,7.94,82,370,2484,12.8,0.25926813
8295,8295,Don Nachbaur,1987-88,29.0,6,2,23,23,0,2,2,12.0,,186,22,41,63,199.0,80,7.34,72,344,2400,12.2,0.21333638
8296,8296,Don Nachbaur,1988-89,30.0,7,4,20,20,0,4,4,11.0,,206,22,45,67,210.0,80,7.43,89,437,2435,12.2,0.22277772
8297,8297,Don Nachbaur,1989-90,31.0,8,1,15,15,1,0,1,10.0,,221,23,45,68,220.0,80,7.48,85,403,2430,12.3,0.25163984
8298,8298,Don Nachbaur,1990-91,32.0,9,1,2,2,0,1,1,0.0,,223,23,46,69,220.0,80,7.37,76,367,2421,12.2,0.29177937
8299,8299,Don Spring,1981-82,22.0,2,19,80,80,1,18,19,51.0,,80,1,18,19,51.0,80,7.69,77,340,2441,12.6,0.26829427
8300,8300,Don Spring,1982-83,23.0,3,16,78,78,0,16,16,67.0,,158,1,34,35,118.0,80,8.03,73,320,2489,12.9,0.22101727
8301,8301,Don Spring,1983-84,24.0,4,16,80,80,0,16,16,50.0,,238,1,50,51,168.0,80,7.73,71,310,2444,12.7,0.21048671
8302,8302,Don Spring,1984-85,25.0,5,4,21,21,0,4,4,11.0,,259,1,54,55,179.0,80,7.89,74,336,2448,12.9,0.19350764
8303,8303,Don Sweeney,1989-90,23.0,2,8,36,36,3,5,8,35.0,,36,3,5,8,35.0,80,7.48,85,403,2430,12.3,0.2584728
8304,8304,Don Sweeney,1990-91,24.0,3,8,58,58,3,5,8,49.0,,94,6,10,16,84.0,80,7.37,76,367,2421,12.2,0.21722493
8305,8305,Don Sweeney,1991-92,25.0,4,21,77,77,8,13,21,102.0,,171,14,23,37,186.0,80,6.91,71,366,2385,11.6,0.2687078
8306,8306,Don Sweeney,1992-93,26.0,5,14,75,75,3,11,14,92.0,,246,17,34,51,278.0,80,6.96,77,402,2440,11.4,0.23738548
8307,8307,Don Sweeney,1993-94,27.0,6,34,84,84,7,27,34,107.0,,330,24,61,85,385.0,84,7.25,87,443,2603,11.7,0.36221826
8308,8308,Don Sweeney,1994-95,28.0,7,21,75,75,6,15,21,136.0,,405,30,76,106,521.0,84,6.48,76,407,2545,10.7,0.28422144
8309,8309,Don Sweeney,1995-96,29.0,8,22,47,47,3,19,22,102.0,,452,33,95,128,623.0,48,5.97,37,209,1408,10.2,0.37850526
8310,8310,Don Sweeney,1996-97,30.0,9,28,77,77,4,24,28,142.0,,529,37,119,156,765.0,82,6.29,74,413,2481,10.4,0.32673395
8311,8311,Don Sweeney,1997-98,31.0,10,26,82,82,3,23,26,113.0,,611,40,142,182,878.0,82,5.83,55,336,2444,9.8,0.30830148
8312,8312,Don Sweeney,1998-99,32.0,11,16,59,59,1,15,16,55.0,,670,41,157,198,933.0,82,5.28,57,380,2242,9.6,0.20983732
8313,8313,Don Sweeney,1999-00,33.0,12,12,81,81,2,10,12,79.0,1581.0,751,43,167,210,1012.0,82,5.27,57,359,2285,9.4,0.15836129
8314,8314,Don Sweeney,2000-01,34.0,13,14,81,81,1,13,14,82.0,1712.0,832,44,180,224,1094.0,82,5.49,53,331,2294,9.8,0.1499905
8315,8315,Don Sweeney,2001-02,35.0,14,12,72,72,2,10,12,60.0,1387.0,904,46,190,236,1154.0,82,5.51,63,376,2272,9.9,0.12891397
8316,8316,Don Sweeney,2002-03,36.0,15,18,81,81,3,15,18,70.0,1632.0,985,49,205,254,1224.0,82,5.24,53,338,2262,9.5,0.16889897
8317,8317,Don Sweeney,2003-04,37.0,16,8,67,67,3,5,8,55.0,885.0,1052,52,210,262,1279.0,82,5.31,60,363,2326,9.4,0.12248105
8318,8318,Don Sweeney,2004-05,38.0,17,11,63,63,0,11,11,39.0,1001.0,1115,52,221,273,1318.0,82,5.14,57,348,2300,9.2,0.1495642
8319,8319,Don Waddell,1981-82,23.0,2,0,1,1,0,0,0,0.0,,1,0,0,0,0.0,80,7.69,77,340,2441,12.6,0.19254631
8320,8320,Donald Audette,1991-92,22.0,2,7,8,8,4,3,7,17.0,,8,4,3,7,17.0,80,6.91,71,366,2385,11.6,0.40943697
8321,8321,Donald Audette,1992-93,23.0,3,48,63,63,31,17,48,153.0,,71,35,20,55,170.0,80,6.96,77,402,2440,11.4,0.7098061
8322,8322,Donald Audette,1993-94,24.0,4,19,44,44,12,7,19,92.0,,115,47,27,74,262.0,84,7.25,87,443,2603,11.7,0.5020412
8323,8323,Donald Audette,1994-95,25.0,5,59,77,77,29,30,59,207.0,,192,76,57,133,469.0,84,6.48,76,407,2545,10.7,0.62888527
8324,8324,Donald Audette,1995-96,26.0,6,37,46,46,24,13,37,124.0,,238,100,70,170,593.0,48,5.97,37,209,1408,10.2,0.81042516
8325,8325,Donald Audette,1996-97,27.0,7,25,23,23,12,13,25,92.0,,261,112,83,195,685.0,82,6.29,74,413,2481,10.4,0.7726235
8326,8326,Donald Audette,1997-98,28.0,8,50,73,73,28,22,50,182.0,,334,140,105,245,867.0,82,5.83,55,336,2444,9.8,0.6078747
8327,8327,Donald Audette,1998-99,29.0,9,44,75,75,24,20,44,198.0,,409,164,125,289,1065.0,82,5.28,57,380,2242,9.6,0.59270954
8328,8328,Donald Audette,1999-00,30.0,10,36,49,49,18,18,36,152.0,825.0,458,182,143,325,1217.0,82,5.27,57,359,2285,9.4,0.66739756
8329,8329,Donald Audette,2000-01,31.0,11,43,63,63,19,24,43,162.0,1034.0,521,201,167,368,1379.0,82,5.49,53,331,2294,9.8,0.62222934
8330,8330,Donald Audette,2001-02,32.0,12,79,76,76,34,45,79,225.0,1508.0,597,235,212,447,1604.0,82,5.51,63,376,2272,9.9,0.75448215
8331,8331,Donald Audette,2002-03,33.0,13,18,33,33,5,13,18,82.0,479.0,630,240,225,465,1686.0,82,5.24,53,338,2262,9.5,0.4383669
8332,8332,Donald Audette,2003-04,34.0,14,23,54,54,11,12,23,118.0,837.0,684,251,237,488,1804.0,82,5.31,60,363,2326,9.4,0.43363124
8333,8333,Donald Audette,2004-05,35.0,15,21,51,51,9,12,21,107.0,759.0,735,260,249,509,1911.0,82,5.14,57,348,2300,9.2,0.48618558
8334,8334,Donald Brashear,1994-95,23.0,2,4,14,14,2,2,4,15.0,,14,2,2,4,15.0,84,6.48,76,407,2545,10.7,0.27617064
8335,8335,Donald Brashear,1995-96,24.0,3,2,20,20,1,1,2,10.0,,34,3,3,6,25.0,48,5.97,37,209,1408,10.2,0.17659813
8336,8336,Donald Brashear,1996-97,25.0,4,4,67,67,0,4,4,25.0,,101,3,7,10,50.0,82,6.29,74,413,2481,10.4,0.10395828
8337,8337,Donald Brashear,1997-98,26.0,5,13,69,69,8,5,13,61.0,,170,11,12,23,111.0,82,5.83,55,336,2444,9.8,0.17888364
8338,8338,Donald Brashear,1998-99,27.0,6,18,77,77,9,9,18,64.0,,247,20,21,41,175.0,82,5.28,57,380,2242,9.6,0.22426993
8339,8339,Donald Brashear,1999-00,28.0,7,18,82,82,8,10,18,112.0,1100.0,329,28,31,59,287.0,82,5.27,57,359,2285,9.4,0.2348141
8340,8340,Donald Brashear,2000-01,29.0,8,13,60,60,11,2,13,83.0,787.0,389,39,33,72,370.0,82,5.49,53,331,2294,9.8,0.2233493
8341,8341,Donald Brashear,2001-02,30.0,9,28,79,79,9,19,28,127.0,1063.0,468,48,52,100,497.0,82,5.51,63,376,2272,9.9,0.28896177
8342,8342,Donald Brashear,2002-03,31.0,10,32,81,81,9,23,32,107.0,1082.0,549,57,75,132,604.0,82,5.24,53,338,2262,9.5,0.33822292
8343,8343,Donald Brashear,2003-04,32.0,11,25,80,80,8,17,25,99.0,1070.0,629,65,92,157,703.0,82,5.31,60,363,2326,9.4,0.27794495
8344,8344,Donald Brashear,2004-05,33.0,12,13,64,64,6,7,13,72.0,706.0,693,71,99,170,775.0,82,5.14,57,348,2300,9.2,0.19255936
8345,8345,Donald Brashear,2006-07,35.0,13,9,76,76,4,5,9,73.0,653.0,769,75,104,179,848.0,82,6.05,85,480,2458,10.1,0.16028368
8346,8346,Donald Brashear,2007-08,36.0,14,13,77,77,4,9,13,47.0,614.0,846,79,113,192,895.0,82,5.76,70,398,2426,9.7,0.13092586
8347,8347,Donald Brashear,2008-09,37.0,15,8,80,80,5,3,8,59.0,629.0,926,84,116,200,954.0,82,5.44,62,351,2383,9.4,0.13608307
8348,8348,Donald Brashear,2009-10,38.0,16,4,63,63,1,3,4,43.0,520.0,989,85,119,204,997.0,82,5.7,65,341,2477,9.4,0.13495314
8349,8349,Donald Brashear,2010-11,39.0,17,1,36,36,0,1,1,18.0,225.0,1025,85,120,205,1015.0,82,5.53,56,304,2486,9.1,0.11052489
8350,8350,Donald Dufresne,1989-90,22.0,2,1,13,13,0,1,1,5.0,,13,0,1,1,5.0,80,7.48,85,403,2430,12.3,0.21920201
8351,8351,Donald Dufresne,1990-91,23.0,3,4,18,18,0,4,4,6.0,,31,0,5,5,11.0,80,7.37,76,367,2421,12.2,0.21554178
8352,8352,Donald Dufresne,1991-92,24.0,4,15,53,53,2,13,15,32.0,,84,2,18,20,43.0,80,6.91,71,366,2385,11.6,0.24019217
8353,8353,Donald Dufresne,1992-93,25.0,5,0,3,3,0,0,0,2.0,,87,2,18,20,45.0,80,6.96,77,402,2440,11.4,0.18234882
8354,8354,Donald Dufresne,1993-94,26.0,6,3,32,32,1,2,3,13.0,,119,3,20,23,58.0,84,7.25,87,443,2603,11.7,0.15886766
8355,8355,Donald Dufresne,1994-95,27.0,7,8,60,60,2,6,8,56.0,,179,5,26,31,114.0,84,6.48,76,407,2545,10.7,0.14277169
8356,8356,Donald Dufresne,1995-96,28.0,8,3,22,22,0,3,3,11.0,,201,5,29,34,125.0,48,5.97,37,209,1408,10.2,0.11477351
8357,8357,Donald Dufresne,1996-97,29.0,9,7,45,45,1,6,7,21.0,,246,6,35,41,146.0,82,6.29,74,413,2481,10.4,0.1059078
8358,8358,Donald Dufresne,1997-98,30.0,10,1,22,22,0,1,1,10.0,,268,6,36,42,156.0,82,5.83,55,336,2444,9.8,0.10156834
8359,8359,Doug Barrault,1993-94,23.0,2,0,2,2,0,0,0,0.0,,2,0,0,0,0.0,84,7.25,87,443,2603,11.7,0.17103139
8360,8360,Doug Barrault,1994-95,24.0,3,0,2,2,0,0,0,2.0,,4,0,0,0,2.0,84,6.48,76,407,2545,10.7,0.16599926
8361,8361,Doug Berry,1980-81,23.0,2,30,75,75,7,23,30,66.0,,75,7,23,30,66.0,80,7.03,61,280,2352,12.0,0.41905636
8362,8362,Doug Berry,1981-82,24.0,3,13,46,46,3,10,13,44.0,,121,10,33,43,110.0,80,7.69,77,340,2441,12.6,0.2970602
8363,8363,Doug Bodger,1985-86,19.0,2,31,65,65,5,26,31,119.0,,65,5,26,31,119.0,80,7.77,71,321,2447,12.7,0.49968484
8364,8364,Doug Bodger,1986-87,20.0,3,37,79,79,4,33,37,140.0,,144,9,59,68,259.0,80,7.94,82,370,2484,12.8,0.5116861
8365,8365,Doug Bodger,1987-88,21.0,4,49,76,76,11,38,49,176.0,,220,20,97,117,435.0,80,7.34,72,344,2400,12.2,0.6850277
8366,8366,Doug Bodger,1988-89,22.0,5,45,69,69,14,31,45,184.0,,289,34,128,162,619.0,80,7.43,89,437,2435,12.2,0.72576237
8367,8367,Doug Bodger,1989-90,23.0,6,52,71,71,8,44,52,156.0,,360,42,172,214,775.0,80,7.48,85,403,2430,12.3,0.6717397
8368,8368,Doug Bodger,1990-91,24.0,7,48,71,71,12,36,48,167.0,,431,54,208,262,942.0,80,7.37,76,367,2421,12.2,0.64422333
8369,8369,Doug Bodger,1991-92,25.0,8,28,58,58,5,23,28,139.0,,489,59,231,290,1081.0,80,6.91,71,366,2385,11.6,0.5421725
8370,8370,Doug Bodger,1992-93,26.0,9,46,73,73,11,35,46,180.0,,562,70,266,336,1261.0,80,6.96,77,402,2440,11.4,0.6370406
8371,8371,Doug Bodger,1993-94,27.0,10,54,81,81,9,45,54,154.0,,643,79,311,390,1415.0,84,7.25,87,443,2603,11.7,0.57848376
8372,8372,Doug Bodger,1994-95,28.0,11,39,75,75,7,32,39,144.0,,718,86,343,429,1559.0,84,6.48,76,407,2545,10.7,0.46055007
8373,8373,Doug Bodger,1995-96,29.0,12,20,44,44,3,17,20,87.0,,762,89,360,449,1646.0,48,5.97,37,209,1408,10.2,0.4758085
8374,8374,Doug Bodger,1996-97,30.0,13,28,73,73,4,24,28,121.0,,835,93,384,477,1767.0,82,6.29,74,413,2481,10.4,0.33749476
8375,8375,Doug Bodger,1997-98,31.0,14,16,81,81,1,15,16,96.0,,916,94,399,493,1863.0,82,5.83,55,336,2444,9.8,0.24720877
8376,8376,Doug Bodger,1998-99,32.0,15,20,77,77,9,11,20,96.0,,993,103,410,513,1959.0,82,5.28,57,380,2242,9.6,0.2642712
8377,8377,Doug Bodger,1999-00,33.0,16,14,65,65,3,11,14,67.0,1264.0,1058,106,421,527,2026.0,82,5.27,57,359,2285,9.4,0.18959734
8378,8378,Doug Bodger,2000-01,34.0,17,1,13,13,0,1,1,11.0,212.0,1071,106,422,528,2037.0,82,5.49,53,331,2294,9.8,0.22049418
8379,8379,Doug Brown,1987-88,23.0,2,1,4,4,0,1,1,10.0,,4,0,1,1,10.0,80,7.34,72,344,2400,12.2,0.25713283
8380,8380,Doug Brown,1988-89,24.0,3,25,70,70,14,11,25,112.0,,74,14,12,26,122.0,80,7.43,89,437,2435,12.2,0.40083098
8381,8381,Doug Brown,1989-90,25.0,4,25,63,63,15,10,25,110.0,,137,29,22,51,232.0,80,7.48,85,403,2430,12.3,0.43138292
8382,8382,Doug Brown,1990-91,26.0,5,34,69,69,14,20,34,135.0,,206,43,42,85,367.0,80,7.37,76,367,2421,12.2,0.4945765
8383,8383,Doug Brown,1991-92,27.0,6,30,58,58,14,16,30,122.0,,264,57,58,115,489.0,80,6.91,71,366,2385,11.6,0.47203273
8384,8384,Doug Brown,1992-93,28.0,7,28,71,71,11,17,28,140.0,,335,68,75,143,629.0,80,6.96,77,402,2440,11.4,0.37349445
8385,8385,Doug Brown,1993-94,29.0,8,5,15,15,0,5,5,17.0,,350,68,80,148,646.0,84,7.25,87,443,2603,11.7,0.35175717
8386,8386,Doug Brown,1994-95,30.0,9,55,77,77,18,37,55,152.0,,427,86,117,203,798.0,84,6.48,76,407,2545,10.7,0.5220489
8387,8387,Doug Brown,1995-96,31.0,10,21,45,45,9,12,21,69.0,,472,95,129,224,867.0,48,5.97,37,209,1408,10.2,0.40834394
8388,8388,Doug Brown,1996-97,32.0,11,27,62,62,12,15,27,115.0,,534,107,144,251,982.0,82,6.29,74,413,2481,10.4,0.3709845
8389,8389,Doug Brown,1997-98,33.0,12,13,49,49,6,7,13,69.0,,583,113,151,264,1051.0,82,5.83,55,336,2444,9.8,0.25783765
8390,8390,Doug Brown,1998-99,34.0,13,42,80,80,19,23,42,145.0,,663,132,174,306,1196.0,82,5.28,57,380,2242,9.6,0.43590292
8391,8391,Doug Brown,1999-00,35.0,14,28,80,80,9,19,28,180.0,1103.0,743,141,193,334,1376.0,82,5.27,57,359,2285,9.4,0.35185242
8392,8392,Doug Brown,2000-01,36.0,15,18,51,51,10,8,18,67.0,657.0,794,151,201,352,1443.0,82,5.49,53,331,2294,9.8,0.30181563
8393,8393,Doug Brown,2001-02,37.0,16,22,60,60,9,13,22,91.0,674.0,854,160,214,374,1534.0,82,5.51,63,376,2272,9.9,0.26001167
8394,8394,Doug Crossman,1981-82,21.0,2,2,9,9,0,2,2,16.0,,9,0,2,2,16.0,80,7.69,77,340,2441,12.6,0.3053329
8395,8395,Doug Crossman,1982-83,22.0,3,40,70,70,12,28,40,127.0,,79,12,30,42,143.0,80,8.03,73,320,2489,12.9,0.5522824
8396,8396,Doug Crossman,1983-84,23.0,4,53,80,80,13,40,53,135.0,,159,25,70,95,278.0,80,7.73,71,310,2444,12.7,0.64141655
8397,8397,Doug Crossman,1984-85,24.0,5,35,78,78,7,28,35,159.0,,237,32,98,130,437.0,80,7.89,74,336,2448,12.9,0.49001306
8398,8398,Doug Crossman,1985-86,25.0,6,37,80,80,4,33,37,114.0,,317,36,131,167,551.0,80,7.77,71,321,2447,12.7,0.47423676
8399,8399,Doug Crossman,1986-87,26.0,7,43,80,80,6,37,43,134.0,,397,42,168,210,685.0,80,7.94,82,370,2484,12.8,0.51675016
8400,8400,Doug Crossman,1987-88,27.0,8,40,78,78,9,31,40,122.0,,475,51,199,250,807.0,80,7.34,72,344,2400,12.2,0.47790113
8401,8401,Doug Crossman,1988-89,28.0,9,38,76,76,9,29,38,153.0,,551,60,228,288,960.0,80,7.43,89,437,2435,12.2,0.49853274
8402,8402,Doug Crossman,1989-90,29.0,10,25,74,74,10,15,25,137.0,,625,70,243,313,1097.0,80,7.48,85,403,2430,12.3,0.365933
8403,8403,Doug Crossman,1990-91,30.0,11,59,80,80,15,44,59,159.0,,705,85,287,372,1256.0,80,7.37,76,367,2421,12.2,0.625852
8404,8404,Doug Crossman,1991-92,31.0,12,37,74,74,8,29,37,108.0,,779,93,316,409,1364.0,80,6.91,71,366,2385,11.6,0.44356817
8405,8405,Doug Crossman,1992-93,32.0,13,8,26,26,0,8,8,21.0,,805,93,324,417,1385.0,80,6.96,77,402,2440,11.4,0.3307467
8406,8406,Doug Crossman,1993-94,33.0,14,38,59,59,10,28,38,78.0,,864,103,352,455,1463.0,84,7.25,87,443,2603,11.7,0.415223
8407,8407,Doug Crossman,1994-95,34.0,15,9,50,50,2,7,9,30.0,,914,105,359,464,1493.0,84,6.48,76,407,2545,10.7,0.13198525
8408,8408,Doug Doull,2004-05,30.0,2,1,35,35,0,1,1,4.0,99.0,35,0,1,1,4.0,82,5.14,57,348,2300,9.2,0.09174478
8409,8409,Doug Doull,2006-07,32.0,3,0,2,2,0,0,0,0.0,8.0,37,0,1,1,4.0,82,6.05,85,480,2458,10.1,0.11826655
8410,8410,Doug Evans,1986-87,23.0,2,1,13,13,1,0,1,12.0,,13,1,0,1,12.0,80,7.94,82,370,2484,12.8,0.24407187
8411,8411,Doug Evans,1987-88,24.0,3,16,53,53,3,13,16,51.0,,66,4,13,17,63.0,80,7.34,72,344,2400,12.2,0.30194795
8412,8412,Doug Evans,1988-89,25.0,4,12,41,41,5,7,12,32.0,,107,9,20,29,95.0,80,7.43,89,437,2435,12.2,0.28647625
8413,8413,Doug Evans,1989-90,26.0,5,19,53,53,7,12,19,48.0,,160,16,32,48,143.0,80,7.48,85,403,2430,12.3,0.36023182
8414,8414,Doug Evans,1990-91,27.0,6,18,30,30,10,8,18,37.0,,190,26,40,66,180.0,80,7.37,76,367,2421,12.2,0.40228584
8415,8415,Doug Evans,1991-92,28.0,7,34,70,70,7,27,34,70.0,,260,33,67,100,250.0,80,6.91,71,366,2385,11.6,0.39842975
8416,8416,Doug Evans,1992-93,29.0,8,14,30,30,7,7,14,39.0,,290,40,74,114,289.0,80,6.96,77,402,2440,11.4,0.32204613
8417,8417,Doug Evans,1993-94,30.0,9,21,65,65,8,13,21,60.0,,355,48,87,135,349.0,84,7.25,87,443,2603,11.7,0.26577562
8418,8418,Doug Friedman,1998-99,27.0,2,0,16,16,0,0,0,8.0,,16,0,0,0,8.0,82,5.28,57,380,2242,9.6,0.16429117
8419,8419,Doug Friedman,1999-00,28.0,3,1,2,2,0,1,1,3.0,14.0,18,0,1,1,11.0,82,5.27,57,359,2285,9.4,0.15782496
8420,8420,Doug Gilmour,1984-85,21.0,2,53,80,80,25,28,53,157.0,,80,25,28,53,157.0,80,7.89,74,336,2448,12.9,0.71220386
8421,8421,Doug Gilmour,1985-86,22.0,3,57,78,78,21,36,57,162.0,,158,46,64,110,319.0,80,7.77,71,321,2447,12.7,0.7126744
8422,8422,Doug Gilmour,1986-87,23.0,4,53,74,74,25,28,53,183.0,,232,71,92,163,502.0,80,7.94,82,370,2484,12.8,0.7625829
8423,8423,Doug Gilmour,1987-88,24.0,5,105,80,80,42,63,105,208.0,,312,113,155,268,710.0,80,7.34,72,344,2400,12.2,1.2338396
8424,8424,Doug Gilmour,1988-89,25.0,6,86,72,72,36,50,86,163.0,,384,149,205,354,873.0,80,7.43,89,437,2435,12.2,1.0578997
8425,8425,Doug Gilmour,1989-90,26.0,7,85,72,72,26,59,85,161.0,,456,175,264,439,1034.0,80,7.48,85,403,2430,12.3,1.0868723
8426,8426,Doug Gilmour,1990-91,27.0,8,91,78,78,24,67,91,152.0,,534,199,331,530,1186.0,80,7.37,76,367,2421,12.2,1.0106772
8427,8427,Doug Gilmour,1991-92,28.0,9,81,78,78,20,61,81,135.0,,612,219,392,611,1321.0,80,6.91,71,366,2385,11.6,0.93910086
8428,8428,Doug Gilmour,1992-93,29.0,10,87,78,78,26,61,87,168.0,,690,245,453,698,1489.0,80,6.96,77,402,2440,11.4,1.0935206
8429,8429,Doug Gilmour,1993-94,30.0,11,127,83,83,32,95,127,211.0,,773,277,548,825,1700.0,84,7.25,87,443,2603,11.7,1.2132701
8430,8430,Doug Gilmour,1994-95,31.0,12,111,83,83,27,84,111,167.0,,856,304,632,936,1867.0,84,6.48,76,407,2545,10.7,1.0141714
8431,8431,Doug Gilmour,1995-96,32.0,13,33,44,44,10,23,33,73.0,,900,314,655,969,1940.0,48,5.97,37,209,1408,10.2,0.72913283
8432,8432,Doug Gilmour,1996-97,33.0,14,72,81,81,32,40,72,180.0,,981,346,695,1041,2120.0,82,6.29,74,413,2481,10.4,0.8031063
8433,8433,Doug Gilmour,1997-98,34.0,15,82,81,81,22,60,82,143.0,,1062,368,755,1123,2263.0,82,5.83,55,336,2444,9.8,0.8678868
8434,8434,Doug Gilmour,1998-99,35.0,16,53,63,63,13,40,53,94.0,,1125,381,795,1176,2357.0,82,5.28,57,380,2242,9.6,0.7812573
8435,8435,Doug Gilmour,1999-00,36.0,17,56,72,72,16,40,56,110.0,1619.0,1197,397,835,1232,2467.0,82,5.27,57,359,2285,9.4,0.7628646
8436,8436,Doug Gilmour,2000-01,37.0,18,73,74,74,25,48,73,113.0,1468.0,1271,422,883,1305,2580.0,82,5.49,53,331,2294,9.8,0.73803097
8437,8437,Doug Gilmour,2001-02,38.0,19,38,71,71,7,31,38,91.0,1281.0,1342,429,914,1343,2671.0,82,5.51,63,376,2272,9.9,0.47452945
8438,8438,Doug Gilmour,2002-03,39.0,20,41,70,70,10,31,41,78.0,1306.0,1412,439,945,1384,2749.0,82,5.24,53,338,2262,9.5,0.5020281
8439,8439,Doug Gilmour,2003-04,40.0,21,30,62,62,11,19,30,85.0,1027.0,1474,450,964,1414,2834.0,82,5.31,60,363,2326,9.4,0.43164596
8440,8440,Doug Houda,1986-87,20.0,2,0,6,6,0,0,0,5.0,,6,0,0,0,5.0,80,7.94,82,370,2484,12.8,0.2753299
8441,8441,Doug Houda,1988-89,22.0,3,2,11,11,1,1,2,10.0,,17,1,1,2,15.0,80,7.43,89,437,2435,12.2,0.25135726
8442,8442,Doug Houda,1989-90,23.0,4,13,57,57,2,11,13,38.0,,74,3,12,15,53.0,80,7.48,85,403,2430,12.3,0.2393969
8443,8443,Doug Houda,1990-91,24.0,5,11,73,73,2,9,11,59.0,,147,5,21,26,112.0,80,7.37,76,367,2421,12.2,0.20642835
8444,8444,Doug Houda,1991-92,25.0,6,7,41,41,1,6,7,42.0,,188,6,27,33,154.0,80,6.91,71,366,2385,11.6,0.18623233
8445,8445,Doug Houda,1992-93,26.0,7,9,56,56,3,6,9,40.0,,244,9,33,42,194.0,80,6.96,77,402,2440,11.4,0.17113432
8446,8446,Doug Houda,1993-94,27.0,8,8,60,60,2,6,8,43.0,,304,11,39,50,237.0,84,7.25,87,443,2603,11.7,0.16290015
8447,8447,Doug Houda,1994-95,28.0,9,8,61,61,2,6,8,32.0,,365,13,45,58,269.0,84,6.48,76,407,2545,10.7,0.12757644
8448,8448,Doug Houda,1995-96,29.0,10,3,28,28,1,2,3,21.0,,393,14,47,61,290.0,48,5.97,37,209,1408,10.2,0.14729872
8449,8449,Doug Houda,1996-97,30.0,11,4,38,38,1,3,4,21.0,,431,15,50,65,311.0,82,6.29,74,413,2481,10.4,0.09530431
8450,8450,Doug Houda,1997-98,31.0,12,10,70,70,2,8,10,29.0,,501,17,58,75,340.0,82,5.83,55,336,2444,9.8,0.1184043
8451,8451,Doug Houda,1998-99,32.0,13,6,55,55,2,4,6,24.0,,556,19,62,81,364.0,82,5.28,57,380,2242,9.6,0.111903846
8452,8452,Doug Houda,1999-00,33.0,14,1,3,3,0,1,1,1.0,21.0,559,19,63,82,365.0,82,5.27,57,359,2285,9.4,0.12256315
8453,8453,Doug Houda,2000-01,34.0,15,0,1,1,0,0,0,0.0,9.0,560,19,63,82,365.0,82,5.49,53,331,2294,9.8,0.15627354
8454,8454,Doug Houda,2003-04,37.0,16,0,1,1,0,0,0,1.0,13.0,561,19,63,82,366.0,82,5.31,60,363,2326,9.4,0.1403409
8455,8455,Doug Janik,2003-04,23.0,2,0,6,6,0,0,0,1.0,46.0,6,0,0,0,1.0,82,5.31,60,363,2326,9.4,0.16786653
8456,8456,Doug Janik,2004-05,24.0,3,0,4,4,0,0,0,3.0,34.0,10,0,0,0,4.0,82,5.14,57,348,2300,9.2,0.22156826
8457,8457,Doug Janik,2007-08,27.0,4,11,75,75,2,9,11,49.0,1085.0,85,2,9,11,53.0,82,5.76,70,398,2426,9.7,0.14580089
8458,8458,Doug Janik,2008-09,28.0,5,4,61,61,1,3,4,23.0,569.0,146,3,12,15,76.0,82,5.44,62,351,2383,9.4,0.10018757
8459,8459,Doug Janik,2009-10,29.0,6,1,15,15,0,1,1,1.0,154.0,161,3,13,16,77.0,82,5.7,65,341,2477,9.4,0.11638126
8460,8460,Doug Janik,2010-11,30.0,7,2,13,13,0,2,2,5.0,175.0,174,3,15,18,82.0,82,5.53,56,304,2486,9.1,0.11754498
8461,8461,Doug Janik,2011-12,31.0,8,0,7,7,0,0,0,8.0,93.0,181,3,15,18,90.0,82,5.46,52,291,2492,9.0,0.11425468
8462,8462,Doug Janik,2012-13,32.0,9,1,9,9,0,1,1,6.0,131.0,190,3,16,19,96.0,82,5.32,47,271,2439,8.9,0.11170712
8463,8463,Doug Kostynski,1984-85,21.0,2,4,9,9,3,1,4,8.0,,9,3,1,4,8.0,80,7.89,74,336,2448,12.9,0.37646744
8464,8464,Doug Kostynski,1985-86,22.0,3,0,6,6,0,0,0,4.0,,15,3,1,4,12.0,80,7.77,71,321,2447,12.7,0.2306808
8465,8465,Doug Lidster,1984-85,24.0,2,0,8,8,0,0,0,7.0,,8,0,0,0,7.0,80,7.89,74,336,2448,12.9,0.2206254
8466,8466,Doug Lidster,1985-86,25.0,3,30,78,78,6,24,30,126.0,,86,6,24,30,133.0,80,7.77,71,321,2447,12.7,0.4010498
8467,8467,Doug Lidster,1986-87,26.0,4,28,78,78,12,16,28,152.0,,164,18,40,58,285.0,80,7.94,82,370,2484,12.8,0.39843798
8468,8468,Doug Lidster,1987-88,27.0,5,63,80,80,12,51,63,176.0,,244,30,91,121,461.0,80,7.34,72,344,2400,12.2,0.6923351
8469,8469,Doug Lidster,1988-89,28.0,6,36,64,64,4,32,36,133.0,,308,34,123,157,594.0,80,7.43,89,437,2435,12.2,0.4766126
8470,8470,Doug Lidster,1989-90,29.0,7,22,63,63,5,17,22,116.0,,371,39,140,179,710.0,80,7.48,85,403,2430,12.3,0.38256943
8471,8471,Doug Lidster,1990-91,30.0,8,36,80,80,8,28,36,143.0,,451,47,168,215,853.0,80,7.37,76,367,2421,12.2,0.41221267
8472,8472,Doug Lidster,1991-92,31.0,9,38,78,78,6,32,38,157.0,,529,53,200,253,1010.0,80,6.91,71,366,2385,11.6,0.46694002
8473,8473,Doug Lidster,1992-93,32.0,10,29,66,66,6,23,29,89.0,,595,59,223,282,1099.0,80,6.96,77,402,2440,11.4,0.35631025
8474,8474,Doug Lidster,1993-94,33.0,11,25,71,71,6,19,25,76.0,,666,65,242,307,1175.0,84,7.25,87,443,2603,11.7,0.2907563
8475,8475,Doug Lidster,1994-95,34.0,12,2,34,34,0,2,2,25.0,,700,65,244,309,1200.0,84,6.48,76,407,2545,10.7,0.15818262
8476,8476,Doug Lidster,1995-96,35.0,13,9,37,37,2,7,9,37.0,,737,67,251,318,1237.0,48,5.97,37,209,1408,10.2,0.207041
8477,8477,Doug Lidster,1996-97,36.0,14,14,59,59,5,9,14,73.0,,796,72,260,332,1310.0,82,6.29,74,413,2481,10.4,0.22232881
8478,8478,Doug Lidster,1997-98,37.0,15,7,48,48,3,4,7,42.0,,844,75,264,339,1352.0,82,5.83,55,336,2444,9.8,0.13844398
8479,8479,Doug Lidster,1998-99,38.0,16,4,36,36,0,4,4,25.0,,880,75,268,343,1377.0,82,5.28,57,380,2242,9.6,0.14118806
8480,8480,Doug Lidster,1999-00,39.0,17,0,17,17,0,0,0,7.0,226.0,897,75,268,343,1384.0,82,5.27,57,359,2285,9.4,0.16604495
8481,8481,Doug Lynch,2004-05,21.0,2,0,2,2,0,0,0,2.0,21.0,2,0,0,0,2.0,82,5.14,57,348,2300,9.2,0.24899867
8482,8482,Doug MacDonald,1993-94,24.0,2,1,5,5,1,0,1,1.0,,5,1,0,1,1.0,84,7.25,87,443,2603,11.7,0.2491163
8483,8483,Doug MacDonald,1994-95,25.0,3,0,4,4,0,0,0,3.0,,9,1,0,1,4.0,84,6.48,76,407,2545,10.7,0.17176712
8484,8484,Doug MacDonald,1995-96,26.0,4,0,2,2,0,0,0,0.0,,11,1,0,1,4.0,48,5.97,37,209,1408,10.2,0.17561358
8485,8485,Doug Morrison,1980-81,20.0,2,0,1,1,0,0,0,1.0,,1,0,0,0,1.0,80,7.03,61,280,2352,12.0,0.2907704
8486,8486,Doug Morrison,1981-82,21.0,3,10,18,18,7,3,10,30.0,,19,7,3,10,31.0,80,7.69,77,340,2441,12.6,0.43458006
8487,8487,Doug Morrison,1982-83,22.0,4,0,3,3,0,0,0,1.0,,22,7,3,10,32.0,80,8.03,73,320,2489,12.9,0.21165875
8488,8488,Doug Morrison,1985-86,25.0,5,0,1,1,0,0,0,1.0,,23,7,3,10,33.0,80,7.77,71,321,2447,12.7,0.18918145
8489,8489,Doug O'Brien,2006-07,22.0,2,0,5,5,0,0,0,2.0,39.0,5,0,0,0,2.0,82,6.05,85,480,2458,10.1,0.16974506
8490,8490,Doug Shedden,1982-83,21.0,2,25,38,38,10,15,25,76.0,,38,10,15,25,76.0,80,8.03,73,320,2489,12.9,0.64116913
8491,8491,Doug Shedden,1983-84,22.0,3,67,80,80,24,43,67,173.0,,118,34,58,92,249.0,80,7.73,71,310,2444,12.7,0.83910394
8492,8492,Doug Shedden,1984-85,23.0,4,57,67,67,22,35,57,160.0,,185,56,93,149,409.0,80,7.89,74,336,2448,12.9,0.7739067
8493,8493,Doug Shedden,1985-86,24.0,5,67,80,80,35,32,67,203.0,,265,91,125,216,612.0,80,7.77,71,321,2447,12.7,0.879267
8494,8494,Doug Shedden,1986-87,25.0,6,71,78,78,34,37,71,212.0,,343,125,162,287,824.0,80,7.94,82,370,2484,12.8,0.82932794
8495,8495,Doug Shedden,1987-88,26.0,7,20,49,49,6,14,20,80.0,,392,131,176,307,904.0,80,7.34,72,344,2400,12.2,0.4719574
8496,8496,Doug Shedden,1989-90,28.0,8,0,1,1,0,0,0,2.0,,393,131,176,307,906.0,80,7.48,85,403,2430,12.3,0.50439245
8497,8497,Doug Shedden,1991-92,30.0,9,18,23,23,8,10,18,35.0,,416,139,186,325,941.0,80,6.91,71,366,2385,11.6,0.67080706
8498,8498,Doug Smail,1981-82,24.0,2,18,30,30,10,8,18,58.0,,30,10,8,18,58.0,80,7.69,77,340,2441,12.6,0.46579075
8499,8499,Doug Smail,1982-83,25.0,3,35,72,72,17,18,35,97.0,,102,27,26,53,155.0,80,8.03,73,320,2489,12.9,0.47058514
8500,8500,Doug Smail,1983-84,26.0,4,44,80,80,15,29,44,114.0,,182,42,55,97,269.0,80,7.73,71,310,2444,12.7,0.5308518
8501,8501,Doug Smail,1984-85,27.0,5,37,66,66,20,17,37,122.0,,248,62,72,134,391.0,80,7.89,74,336,2448,12.9,0.49884105
8502,8502,Doug Smail,1985-86,28.0,6,66,80,80,31,35,66,154.0,,328,93,107,200,545.0,80,7.77,71,321,2447,12.7,0.7501091
8503,8503,Doug Smail,1986-87,29.0,7,42,73,73,16,26,42,150.0,,401,109,133,242,695.0,80,7.94,82,370,2484,12.8,0.5077954
8504,8504,Doug Smail,1987-88,30.0,8,43,78,78,25,18,43,131.0,,479,134,151,285,826.0,80,7.34,72,344,2400,12.2,0.5132502
8505,8505,Doug Smail,1988-89,31.0,9,31,71,71,15,16,31,110.0,,550,149,167,316,936.0,80,7.43,89,437,2435,12.2,0.4211714
8506,8506,Doug Smail,1989-90,32.0,10,29,47,47,14,15,29,68.0,,597,163,182,345,1004.0,80,7.48,85,403,2430,12.3,0.45531696
8507,8507,Doug Smail,1990-91,33.0,11,49,79,79,25,24,49,165.0,,676,188,206,394,1169.0,80,7.37,76,367,2421,12.2,0.5560174
8508,8508,Doug Smail,1991-92,34.0,12,23,72,72,8,15,23,107.0,,748,196,221,417,1276.0,80,6.91,71,366,2385,11.6,0.32779467
8509,8509,Doug Smail,1992-93,35.0,13,28,46,46,10,18,28,72.0,,794,206,239,445,1348.0,80,6.96,77,402,2440,11.4,0.45271054
8510,8510,Doug Smail,1993-94,36.0,14,14,51,51,4,10,14,73.0,,845,210,249,459,1421.0,84,7.25,87,443,2603,11.7,0.25426906
8511,8511,Doug Smith,1982-83,19.0,2,30,80,80,16,14,30,141.0,,80,16,14,30,141.0,80,8.03,73,320,2489,12.9,0.5552074
8512,8512,Doug Smith,1983-84,20.0,3,22,42,42,11,11,22,91.0,,122,27,25,52,232.0,80,7.73,71,310,2444,12.7,0.5431997
8513,8513,Doug Smith,1984-85,21.0,4,36,72,72,16,20,36,146.0,,194,43,45,88,378.0,80,7.89,74,336,2448,12.9,0.5865972
8514,8514,Doug Smith,1985-86,22.0,5,41,62,62,21,20,41,147.0,,256,64,65,129,525.0,80,7.77,71,321,2447,12.7,0.677976
8515,8515,Doug Smith,1986-87,23.0,6,38,78,78,18,20,38,187.0,,334,82,85,167,712.0,80,7.94,82,370,2484,12.8,0.5706508
8516,8516,Doug Smith,1987-88,24.0,7,40,62,62,16,24,40,158.0,,396,98,109,207,870.0,80,7.34,72,344,2400,12.2,0.63997936
8517,8517,Doug Smith,1988-89,25.0,8,28,70,70,9,19,28,136.0,,466,107,128,235,1006.0,80,7.43,89,437,2435,12.2,0.41026956
8518,8518,Doug Smith,1989-90,26.0,9,9,29,29,4,5,9,27.0,,495,111,133,244,1033.0,80,7.48,85,403,2430,12.3,0.3258385
8519,8519,Doug Smith,1990-91,27.0,10,9,40,40,4,5,9,51.0,,535,115,138,253,1084.0,80,7.37,76,367,2421,12.2,0.2829374
8520,8520,Doug Sulliman,1980-81,21.0,2,11,31,31,4,7,11,26.0,,31,4,7,11,26.0,80,7.03,61,280,2352,12.0,0.36620927
8521,8521,Doug Sulliman,1981-82,22.0,3,5,32,32,4,1,5,56.0,,63,8,8,16,82.0,80,7.69,77,340,2441,12.6,0.35701084
8522,8522,Doug Sulliman,1982-83,23.0,4,69,77,77,29,40,69,197.0,,140,37,48,85,279.0,80,8.03,73,320,2489,12.9,0.79978716
8523,8523,Doug Sulliman,1983-84,24.0,5,41,77,77,22,19,41,162.0,,217,59,67,126,441.0,80,7.73,71,310,2444,12.7,0.5517987
8524,8524,Doug Sulliman,1984-85,25.0,6,19,67,67,6,13,19,130.0,,284,65,80,145,571.0,80,7.89,74,336,2448,12.9,0.40816388
8525,8525,Doug Sulliman,1985-86,26.0,7,38,57,57,22,16,38,112.0,,341,87,96,183,683.0,80,7.77,71,321,2447,12.7,0.6367578
8526,8526,Doug Sulliman,1986-87,27.0,8,43,73,73,21,22,43,139.0,,414,108,118,226,822.0,80,7.94,82,370,2484,12.8,0.49698818
8527,8527,Doug Sulliman,1987-88,28.0,9,53,78,78,27,26,53,148.0,,492,135,144,279,970.0,80,7.34,72,344,2400,12.2,0.63596714
8528,8528,Doug Sulliman,1988-89,29.0,10,30,59,59,16,14,30,89.0,,551,151,158,309,1059.0,80,7.43,89,437,2435,12.2,0.4451224
8529,8529,Doug Sulliman,1989-90,30.0,11,12,52,52,6,6,12,52.0,,603,157,164,321,1111.0,80,7.48,85,403,2430,12.3,0.3023762
8530,8530,Doug Sulliman,1990-91,31.0,12,7,28,28,3,4,7,28.0,,631,160,168,328,1139.0,80,7.37,76,367,2421,12.2,0.3061905
8531,8531,Doug Trapp,1987-88,22.0,2,0,2,2,0,0,0,1.0,,2,0,0,0,1.0,80,7.34,72,344,2400,12.2,0.23124611
8532,8532,Doug Weight,1992-93,22.0,2,30,53,53,8,22,30,72.0,,53,8,22,30,72.0,80,6.96,77,402,2440,11.4,0.54636717
8533,8533,Doug Weight,1993-94,23.0,3,48,78,78,17,31,48,125.0,,131,25,53,78,197.0,84,7.25,87,443,2603,11.7,0.5680676
8534,8534,Doug Weight,1994-95,24.0,4,74,84,84,24,50,74,188.0,,215,49,103,152,385.0,84,6.48,76,407,2545,10.7,0.8238031
8535,8535,Doug Weight,1995-96,25.0,5,40,48,48,7,33,40,104.0,,263,56,136,192,489.0,48,5.97,37,209,1408,10.2,0.94791514
8536,8536,Doug Weight,1996-97,26.0,6,104,82,82,25,79,104,204.0,,345,81,215,296,693.0,82,6.29,74,413,2481,10.4,1.1571598
8537,8537,Doug Weight,1997-98,27.0,7,82,80,80,21,61,82,235.0,,425,102,276,378,928.0,82,5.83,55,336,2444,9.8,0.9168321
8538,8538,Doug Weight,1998-99,28.0,8,70,79,79,26,44,70,205.0,,504,128,320,448,1133.0,82,5.28,57,380,2242,9.6,0.8456743
8539,8539,Doug Weight,1999-00,29.0,9,37,43,43,6,31,37,79.0,854.0,547,134,351,485,1212.0,82,5.27,57,359,2285,9.4,0.7679605
8540,8540,Doug Weight,2000-01,30.0,10,72,77,77,21,51,72,167.0,1585.0,624,155,402,557,1379.0,82,5.49,53,331,2294,9.8,0.86984617
8541,8541,Doug Weight,2001-02,31.0,11,90,82,82,25,65,90,188.0,1815.0,706,180,467,647,1567.0,82,5.51,63,376,2272,9.9,0.92734766
8542,8542,Doug Weight,2002-03,32.0,12,49,61,61,15,34,49,131.0,1208.0,767,195,501,696,1698.0,82,5.24,53,338,2262,9.5,0.7495804
8543,8543,Doug Weight,2003-04,33.0,13,67,70,70,15,52,67,182.0,1426.0,837,210,553,763,1880.0,82,5.31,60,363,2326,9.4,0.8758842
8544,8544,Doug Weight,2004-05,34.0,14,65,75,75,14,51,65,198.0,1532.0,912,224,604,828,2078.0,82,5.14,57,348,2300,9.2,0.88450205
8545,8545,Doug Weight,2006-07,36.0,15,57,70,70,15,42,57,175.0,1452.0,982,239,646,885,2253.0,82,6.05,85,480,2458,10.1,0.69854426
8546,8546,Doug Weight,2007-08,37.0,16,59,82,82,16,43,59,123.0,1500.0,1064,255,689,944,2376.0,82,5.76,70,398,2426,9.7,0.60724443
8547,8547,Doug Weight,2008-09,38.0,17,25,67,67,10,15,25,96.0,979.0,1131,265,704,969,2472.0,82,5.44,62,351,2383,9.4,0.382932
8548,8548,Doug Weight,2009-10,39.0,18,38,53,53,10,28,38,96.0,969.0,1184,275,732,1007,2568.0,82,5.7,65,341,2477,9.4,0.5829741
8549,8549,Doug Weight,2010-11,40.0,19,17,36,36,1,16,17,61.0,570.0,1220,276,748,1024,2629.0,82,5.53,56,304,2486,9.1,0.37251356
8550,8550,Doug Weight,2011-12,41.0,20,9,18,18,2,7,9,26.0,315.0,1238,278,755,1033,2655.0,82,5.46,52,291,2492,9.0,0.45785552
8551,8551,Doug Wickenheiser,1981-82,20.0,2,15,41,41,7,8,15,56.0,,41,7,8,15,56.0,80,7.69,77,340,2441,12.6,0.43067768
8552,8552,Doug Wickenheiser,1982-83,21.0,3,35,56,56,12,23,35,94.0,,97,19,31,50,150.0,80,8.03,73,320,2489,12.9,0.56656015
8553,8553,Doug Wickenheiser,1983-84,22.0,4,55,78,78,25,30,55,160.0,,175,44,61,105,310.0,80,7.73,71,310,2444,12.7,0.7239803
8554,8554,Doug Wickenheiser,1984-85,23.0,5,38,73,73,12,26,38,143.0,,248,56,87,143,453.0,80,7.89,74,336,2448,12.9,0.55621374
8555,8555,Doug Wickenheiser,1985-86,24.0,6,43,68,68,23,20,43,155.0,,316,79,107,186,608.0,80,7.77,71,321,2447,12.7,0.6702989
8556,8556,Doug Wickenheiser,1986-87,25.0,7,19,36,36,8,11,19,53.0,,352,87,118,205,661.0,80,7.94,82,370,2484,12.8,0.5364096
8557,8557,Doug Wickenheiser,1987-88,26.0,8,28,80,80,13,15,28,131.0,,432,100,133,233,792.0,80,7.34,72,344,2400,12.2,0.41792473
8558,8558,Doug Wickenheiser,1988-89,27.0,9,26,80,80,7,19,26,123.0,,512,107,152,259,915.0,80,7.43,89,437,2435,12.2,0.3318568
8559,8559,Doug Wickenheiser,1989-90,28.0,10,8,17,17,3,5,8,33.0,,529,110,157,267,948.0,80,7.48,85,403,2430,12.3,0.3836213
8560,8560,Doug Wickenheiser,1990-91,29.0,11,9,27,27,1,8,9,44.0,,556,111,165,276,992.0,80,7.37,76,367,2421,12.2,0.33159503
8561,8561,Doug Zmolek,1993-94,23.0,2,15,84,84,5,10,15,94.0,,84,5,10,15,94.0,84,7.25,87,443,2603,11.7,0.26535767
8562,8562,Doug Zmolek,1994-95,24.0,3,5,75,75,1,4,5,32.0,,159,6,14,20,126.0,84,6.48,76,407,2545,10.7,0.13242748
8563,8563,Doug Zmolek,1995-96,25.0,4,5,42,42,0,5,5,28.0,,201,6,19,25,154.0,48,5.97,37,209,1408,10.2,0.13554549
8564,8564,Doug Zmolek,1996-97,26.0,5,7,58,58,2,5,7,36.0,,259,8,24,32,190.0,82,6.29,74,413,2481,10.4,0.15521395
8565,8565,Doug Zmolek,1997-98,27.0,6,1,57,57,1,0,1,28.0,,316,9,24,33,218.0,82,5.83,55,336,2444,9.8,0.09395236
8566,8566,Doug Zmolek,1998-99,28.0,7,8,46,46,0,8,8,23.0,,362,9,32,41,241.0,82,5.28,57,380,2242,9.6,0.09853855
8567,8567,Doug Zmolek,1999-00,29.0,8,14,62,62,0,14,14,33.0,1062.0,424,9,46,55,274.0,82,5.27,57,359,2285,9.4,0.14644623
8568,8568,Doug Zmolek,2000-01,30.0,9,9,43,43,2,7,9,24.0,656.0,467,11,53,64,298.0,82,5.49,53,331,2294,9.8,0.13003239
8569,8569,Dougie Hamilton,2013-14,20.0,2,16,42,42,5,11,16,83.0,719.0,42,5,11,16,83.0,48,5.31,29,160,1399,9.1,0.43370086
8570,8570,Dougie Hamilton,2014-15,21.0,3,25,64,64,7,18,25,114.0,1223.0,106,12,29,41,197.0,82,5.34,48,269,2463,8.9,0.4170664
8571,8571,Dougie Hamilton,2015-16,22.0,4,42,72,72,10,32,42,188.0,1536.0,178,22,61,83,385.0,82,5.32,47,251,2453,8.9,0.55161095
8572,8572,Dougie Hamilton,2016-17,23.0,5,43,82,82,12,31,43,190.0,1621.0,260,34,92,126,575.0,82,5.34,48,255,2438,9.0,0.5823947
8573,8573,Dougie Hamilton,2017-18,24.0,6,50,81,81,13,37,50,222.0,1594.0,341,47,129,176,797.0,82,5.45,47,245,2478,9.0,0.65682006
8574,8574,Dougie Hamilton,2018-19,25.0,7,44,82,82,17,27,44,270.0,1766.0,423,64,156,220,1067.0,82,5.86,50,250,2620,9.2,0.61392146
8575,8575,Dougie Hamilton,2019-20,26.0,8,39,82,82,18,21,39,259.0,1613.0,505,82,177,259,1326.0,82,5.96,47,239,2579,9.5,0.59758687
8576,8576,Dougie Hamilton,2020-21,27.0,9,40,47,47,14,26,40,170.0,1094.0,552,96,203,299,1496.0,70,5.96,42,208,2192,9.5,0.7562169
8577,8577,Douglas Murray,2006-07,26.0,2,1,34,34,0,1,1,21.0,472.0,34,0,1,1,21.0,82,6.05,85,480,2458,10.1,0.14801964
8578,8578,Douglas Murray,2007-08,27.0,3,3,35,35,0,3,3,18.0,377.0,69,0,4,4,39.0,82,5.76,70,398,2426,9.7,0.11952567
8579,8579,Douglas Murray,2008-09,28.0,4,10,66,66,1,9,10,48.0,1153.0,135,1,13,14,87.0,82,5.44,62,351,2383,9.4,0.13926652
8580,8580,Douglas Murray,2009-10,29.0,5,7,75,75,0,7,7,56.0,1249.0,210,1,20,21,143.0,82,5.7,65,341,2477,9.4,0.12841007
8581,8581,Douglas Murray,2010-11,30.0,6,17,79,79,4,13,17,85.0,1607.0,289,5,33,38,228.0,82,5.53,56,304,2486,9.1,0.1762641
8582,8582,Douglas Murray,2011-12,31.0,7,14,73,73,1,13,14,102.0,1432.0,362,6,46,52,330.0,82,5.46,52,291,2492,9.0,0.1621534
8583,8583,Douglas Murray,2012-13,32.0,8,4,60,60,0,4,4,71.0,1103.0,422,6,50,56,401.0,82,5.32,47,271,2439,8.9,0.1210939
8584,8584,Douglas Murray,2013-14,33.0,9,6,43,43,1,5,6,27.0,756.0,465,7,55,62,428.0,48,5.31,29,160,1399,9.1,0.120357364
8585,8585,Douglas Murray,2014-15,34.0,10,2,53,53,0,2,2,26.0,761.0,518,7,57,64,454.0,82,5.34,48,269,2463,8.9,0.0855377
8586,8586,Drake Batherson,2019-20,21.0,2,9,20,20,3,6,9,18.0,268.0,20,3,6,9,18.0,82,5.96,47,239,2579,9.5,0.32918388
8587,8587,Drake Batherson,2020-21,22.0,3,10,23,23,3,7,10,32.0,358.0,43,6,13,19,50.0,70,5.96,42,208,2192,9.5,0.36700037
8588,8588,Drake Berehowsky,1991-92,20.0,2,1,8,8,0,1,1,4.0,,8,0,1,1,4.0,80,6.91,71,366,2385,11.6,0.26093993
8589,8589,Drake Berehowsky,1992-93,21.0,3,0,1,1,0,0,0,0.0,,9,0,1,1,4.0,80,6.96,77,402,2440,11.4,0.25347638
8590,8590,Drake Berehowsky,1993-94,22.0,4,19,41,41,4,15,19,41.0,,50,4,16,20,45.0,84,7.25,87,443,2603,11.7,0.3480404
8591,8591,Drake Berehowsky,1994-95,23.0,5,10,49,49,2,8,10,29.0,,99,6,24,30,74.0,84,6.48,76,407,2545,10.7,0.25411668
8592,8592,Drake Berehowsky,1995-96,24.0,6,2,29,29,0,2,2,14.0,,128,6,26,32,88.0,48,5.97,37,209,1408,10.2,0.1290276
8593,8593,Drake Berehowsky,1996-97,25.0,7,0,1,1,0,0,0,0.0,,129,6,26,32,88.0,82,6.29,74,413,2481,10.4,0.15528902
8594,8594,Drake Berehowsky,1998-99,27.0,8,7,67,67,1,6,7,58.0,,196,7,32,39,146.0,82,5.28,57,380,2242,9.6,0.14507324
8595,8595,Drake Berehowsky,1999-00,28.0,9,17,74,74,2,15,17,79.0,1607.0,270,9,47,56,225.0,82,5.27,57,359,2285,9.4,0.22053853
8596,8596,Drake Berehowsky,2000-01,29.0,10,32,79,79,12,20,32,102.0,1790.0,349,21,67,88,327.0,82,5.49,53,331,2294,9.8,0.36287552
8597,8597,Drake Berehowsky,2001-02,30.0,11,26,80,80,7,19,26,107.0,1668.0,429,28,86,114,434.0,82,5.51,63,376,2272,9.9,0.2917011
8598,8598,Drake Berehowsky,2002-03,31.0,12,8,57,57,2,6,8,38.0,731.0,486,30,92,122,472.0,82,5.24,53,338,2262,9.5,0.14932624
8599,8599,Drake Berehowsky,2003-04,32.0,13,3,7,7,1,2,3,8.0,76.0,493,31,94,125,480.0,82,5.31,60,363,2326,9.4,0.17819923
8600,8600,Drake Berehowsky,2004-05,33.0,14,24,56,56,6,18,24,70.0,1144.0,549,37,112,149,550.0,82,5.14,57,348,2300,9.2,0.33896124
8601,8601,Drake Caggiula,2017-18,23.0,2,18,60,60,7,11,18,93.0,794.0,60,7,11,18,93.0,82,5.45,47,245,2478,9.0,0.34299737
8602,8602,Drake Caggiula,2018-19,24.0,3,20,67,67,13,7,20,104.0,908.0,127,20,18,38,197.0,82,5.86,50,250,2620,9.2,0.32713103
8603,8603,Drake Caggiula,2019-20,25.0,4,23,55,55,12,11,23,96.0,794.0,182,32,29,61,293.0,82,5.96,47,239,2579,9.5,0.39154345
8604,8604,Drake Caggiula,2020-21,26.0,5,15,40,40,9,6,15,56.0,473.0,222,41,35,76,349.0,70,5.96,42,208,2192,9.5,0.40416914
8605,8605,Drayson Bowman,2010-11,21.0,2,2,9,9,2,0,2,17.0,108.0,9,2,0,2,17.0,82,5.53,56,304,2486,9.1,0.25689316
8606,8606,Drayson Bowman,2011-12,22.0,3,1,23,23,0,1,1,28.0,226.0,32,2,1,3,45.0,82,5.46,52,291,2492,9.0,0.20383158
8607,8607,Drayson Bowman,2012-13,23.0,4,13,37,37,6,7,13,70.0,494.0,69,8,8,16,115.0,82,5.32,47,271,2439,8.9,0.3239128
8608,8608,Drayson Bowman,2013-14,24.0,5,5,37,37,3,2,5,68.0,433.0,106,11,10,21,183.0,48,5.31,29,160,1399,9.1,0.25561517
8609,8609,Drayson Bowman,2014-15,25.0,6,12,70,70,4,8,12,80.0,725.0,176,15,18,33,263.0,82,5.34,48,269,2463,8.9,0.18814147
8610,8610,Drayson Bowman,2015-16,26.0,7,0,3,3,0,0,0,0.0,20.0,179,15,18,33,263.0,82,5.32,47,251,2453,8.9,0.14179075
8611,8611,Drew Bagnall,2011-12,28.0,2,0,2,2,0,0,0,1.0,26.0,2,0,0,0,1.0,82,5.46,52,291,2492,9.0,0.15076256
8612,8612,Drew Bannister,1996-97,22.0,2,1,13,13,0,1,1,10.0,,13,0,1,1,10.0,82,6.29,74,413,2481,10.4,0.19679812
8613,8613,Drew Bannister,1997-98,23.0,3,18,65,65,4,14,18,59.0,,78,4,15,19,69.0,82,5.83,55,336,2444,9.8,0.24726474
8614,8614,Drew Bannister,1998-99,24.0,4,8,61,61,0,8,8,50.0,,139,4,23,27,119.0,82,5.28,57,380,2242,9.6,0.15800545
8615,8615,Drew Bannister,1999-00,25.0,5,3,21,21,1,2,3,29.0,332.0,160,5,25,30,148.0,82,5.27,57,359,2285,9.4,0.18669039
8616,8616,Drew Bannister,2001-02,27.0,6,0,3,3,0,0,0,3.0,32.0,163,5,25,30,151.0,82,5.51,63,376,2272,9.9,0.13385627
8617,8617,Drew Bannister,2002-03,28.0,7,0,1,1,0,0,0,1.0,13.0,164,5,25,30,152.0,82,5.24,53,338,2262,9.5,0.13724253
8618,8618,Drew Doughty,2009-10,20.0,2,27,81,81,6,21,27,126.0,1930.0,81,6,21,27,126.0,82,5.7,65,341,2477,9.4,0.39870948
8619,8619,Drew Doughty,2010-11,21.0,3,59,82,82,16,43,59,142.0,2048.0,163,22,64,86,268.0,82,5.53,56,304,2486,9.1,0.64887416
8620,8620,Drew Doughty,2011-12,22.0,4,40,76,76,11,29,40,139.0,1949.0,239,33,93,126,407.0,82,5.46,52,291,2492,9.0,0.51742625
8621,8621,Drew Doughty,2012-13,23.0,5,36,77,77,10,26,36,168.0,1917.0,316,43,119,162,575.0,82,5.32,47,271,2439,8.9,0.5337172
8622,8622,Drew Doughty,2013-14,24.0,6,22,48,48,6,16,22,114.0,1267.0,364,49,135,184,689.0,48,5.31,29,160,1399,9.1,0.52388495
8623,8623,Drew Doughty,2014-15,25.0,7,37,78,78,10,27,37,177.0,2006.0,442,59,162,221,866.0,82,5.34,48,269,2463,8.9,0.5208375
8624,8624,Drew Doughty,2015-16,26.0,8,46,82,82,7,39,46,219.0,2378.0,524,66,201,267,1085.0,82,5.32,47,251,2453,8.9,0.5820616
8625,8625,Drew Doughty,2016-17,27.0,9,51,82,82,14,37,51,197.0,2297.0,606,80,238,318,1282.0,82,5.34,48,255,2438,9.0,0.61983746
8626,8626,Drew Doughty,2017-18,28.0,10,44,82,82,12,32,44,181.0,2226.0,688,92,270,362,1463.0,82,5.45,47,245,2478,9.0,0.5673337
8627,8627,Drew Doughty,2018-19,29.0,11,60,82,82,10,50,60,205.0,2201.0,770,102,320,422,1668.0,82,5.86,50,250,2620,9.2,0.693724
8628,8628,Drew Doughty,2019-20,30.0,12,45,82,82,8,37,45,154.0,2181.0,852,110,357,467,1822.0,82,5.96,47,239,2579,9.5,0.51701057
8629,8629,Drew Doughty,2020-21,31.0,13,35,67,67,7,28,35,141.0,1730.0,919,117,385,502,1963.0,70,5.96,42,208,2192,9.5,0.4497248
8630,8630,Drew Fata,2007-08,24.0,2,1,3,3,1,0,1,1.0,31.0,3,1,0,1,1.0,82,5.76,70,398,2426,9.7,0.25393116
8631,8631,Drew Fata,2008-09,25.0,3,1,5,5,0,1,1,4.0,88.0,8,1,1,2,5.0,82,5.44,62,351,2383,9.4,0.18535659
8632,8632,Drew Larman,2007-08,22.0,2,2,16,16,2,0,2,15.0,118.0,16,2,0,2,15.0,82,5.76,70,398,2426,9.7,0.24475458
8633,8633,Drew Larman,2008-09,23.0,3,1,6,6,0,1,1,1.0,36.0,22,2,1,3,16.0,82,5.44,62,351,2383,9.4,0.1905348
8634,8634,Drew Larman,2010-11,25.0,4,0,4,4,0,0,0,5.0,32.0,26,2,1,3,21.0,82,5.53,56,304,2486,9.1,0.15586632
8635,8635,Drew LeBlanc,2013-14,24.0,2,0,2,2,0,0,0,3.0,27.0,2,0,0,0,3.0,48,5.31,29,160,1399,9.1,0.1963234
8636,8636,Drew Miller,2008-09,24.0,2,5,26,26,2,3,5,30.0,291.0,26,2,3,5,30.0,82,5.44,62,351,2383,9.4,0.22544533
8637,8637,Drew Miller,2009-10,25.0,3,10,27,27,4,6,10,45.0,351.0,53,6,9,15,75.0,82,5.7,65,341,2477,9.4,0.25984782
8638,8638,Drew Miller,2010-11,26.0,4,19,80,80,10,9,19,103.0,1010.0,133,16,18,34,178.0,82,5.53,56,304,2486,9.1,0.24627239
8639,8639,Drew Miller,2011-12,27.0,5,18,67,67,10,8,18,85.0,787.0,200,26,26,52,263.0,82,5.46,52,291,2492,9.0,0.2518223
8640,8640,Drew Miller,2012-13,28.0,6,25,80,80,14,11,25,131.0,1030.0,280,40,37,77,394.0,82,5.32,47,271,2439,8.9,0.31666732
8641,8641,Drew Miller,2013-14,29.0,7,8,44,44,4,4,8,54.0,608.0,324,44,41,85,448.0,48,5.31,29,160,1399,9.1,0.19149464
8642,8642,Drew Miller,2014-15,30.0,8,15,82,82,7,8,15,117.0,1159.0,406,51,49,100,565.0,82,5.34,48,269,2463,8.9,0.21902016
8643,8643,Drew Miller,2015-16,31.0,9,13,82,82,5,8,13,98.0,1102.0,488,56,57,113,663.0,82,5.32,47,251,2453,8.9,0.20576048
8644,8644,Drew Miller,2016-17,32.0,10,2,28,28,1,1,2,27.0,363.0,516,57,58,115,690.0,82,5.34,48,255,2438,9.0,0.18494207
8645,8645,Drew Miller,2017-18,33.0,11,7,55,55,5,2,7,43.0,565.0,571,62,60,122,733.0,82,5.45,47,245,2478,9.0,0.13491184
8646,8646,Drew Shore,2013-14,23.0,2,13,43,43,3,10,13,96.0,680.0,43,3,10,13,96.0,48,5.31,29,160,1399,9.1,0.3220314
8647,8647,Drew Shore,2014-15,24.0,3,7,24,24,5,2,7,23.0,288.0,67,8,12,20,119.0,82,5.34,48,269,2463,8.9,0.26618558
8648,8648,Drew Shore,2015-16,25.0,4,3,11,11,1,2,3,13.0,117.0,78,9,14,23,132.0,82,5.32,47,251,2453,8.9,0.22695547
8649,8649,Drew Shore,2016-17,26.0,5,1,2,2,0,1,1,3.0,28.0,80,9,15,24,135.0,82,5.34,48,255,2438,9.0,0.18739939
8650,8650,Drew Shore,2017-18,27.0,6,2,14,14,0,2,2,11.0,168.0,94,9,17,26,146.0,82,5.45,47,245,2478,9.0,0.17341396
8651,8651,Drew Stafford,2007-08,22.0,2,27,41,41,13,14,27,67.0,539.0,41,13,14,27,67.0,82,5.76,70,398,2426,9.7,0.5248214
8652,8652,Drew Stafford,2008-09,23.0,3,38,64,64,16,22,38,103.0,866.0,105,29,36,65,170.0,82,5.44,62,351,2383,9.4,0.57592
8653,8653,Drew Stafford,2009-10,24.0,4,45,79,79,20,25,45,183.0,1235.0,184,49,61,110,353.0,82,5.7,65,341,2477,9.4,0.5586023
8654,8654,Drew Stafford,2010-11,25.0,5,34,71,71,14,20,34,181.0,1027.0,255,63,81,144,534.0,82,5.53,56,304,2486,9.1,0.5552097
8655,8655,Drew Stafford,2011-12,26.0,6,52,62,62,31,21,52,179.0,1025.0,317,94,102,196,713.0,82,5.46,52,291,2492,9.0,0.7309576
8656,8656,Drew Stafford,2012-13,27.0,7,50,80,80,20,30,50,226.0,1412.0,397,114,132,246,939.0,82,5.32,47,271,2439,8.9,0.5783367
8657,8657,Drew Stafford,2013-14,28.0,8,18,46,46,6,12,18,121.0,783.0,443,120,144,264,1060.0,48,5.31,29,160,1399,9.1,0.4791628
8658,8658,Drew Stafford,2014-15,29.0,9,34,70,70,16,18,34,185.0,1305.0,513,136,162,298,1245.0,82,5.34,48,269,2463,8.9,0.5158477
8659,8659,Drew Stafford,2015-16,30.0,10,43,76,76,18,25,43,147.0,1254.0,589,154,187,341,1392.0,82,5.32,47,251,2453,8.9,0.5183398
8660,8660,Drew Stafford,2016-17,31.0,11,38,78,78,21,17,38,187.0,1394.0,667,175,204,379,1579.0,82,5.34,48,255,2438,9.0,0.5013825
8661,8661,Drew Stafford,2017-18,32.0,12,21,58,58,8,13,21,109.0,789.0,725,183,217,400,1688.0,82,5.45,47,245,2478,9.0,0.34078732
8662,8662,Drew Stafford,2018-19,33.0,13,15,59,59,8,7,15,102.0,818.0,784,191,224,415,1790.0,82,5.86,50,250,2620,9.2,0.2716697
8663,8663,Drew Stafford,2019-20,34.0,14,13,57,57,5,8,13,77.0,699.0,841,196,232,428,1867.0,82,5.96,47,239,2579,9.5,0.2274768
8664,8664,Dryden Hunt,2018-19,23.0,2,1,11,11,0,1,1,12.0,116.0,11,0,1,1,12.0,82,5.86,50,250,2620,9.2,0.20251799
8665,8665,Dryden Hunt,2019-20,24.0,3,10,31,31,3,7,10,53.0,343.0,42,3,8,11,65.0,82,5.96,47,239,2579,9.5,0.24621701
8666,8666,Dryden Hunt,2020-21,25.0,4,4,21,21,0,4,4,33.0,220.0,63,3,12,15,98.0,70,5.96,42,208,2192,9.5,0.23543546
8667,8667,Duane Joyce,1994-95,29.0,2,0,3,3,0,0,0,1.0,,3,0,0,0,1.0,84,6.48,76,407,2545,10.7,0.1752109
8668,8668,Duane Sutter,1980-81,20.0,2,24,56,56,15,9,24,75.0,,56,15,9,24,75.0,80,7.03,61,280,2352,12.0,0.49499115
8669,8669,Duane Sutter,1981-82,21.0,3,18,23,23,7,11,18,48.0,,79,22,20,42,123.0,80,7.69,77,340,2441,12.6,0.6640285
8670,8670,Duane Sutter,1982-83,22.0,4,53,77,77,18,35,53,140.0,,156,40,55,95,263.0,80,8.03,73,320,2489,12.9,0.6667636
8671,8671,Duane Sutter,1983-84,23.0,5,32,75,75,13,19,32,120.0,,231,53,74,127,383.0,80,7.73,71,310,2444,12.7,0.48603848
8672,8672,Duane Sutter,1984-85,24.0,6,40,78,78,17,23,40,137.0,,309,70,97,167,520.0,80,7.89,74,336,2448,12.9,0.52844256
8673,8673,Duane Sutter,1985-86,25.0,7,41,78,78,17,24,41,125.0,,387,87,121,208,645.0,80,7.77,71,321,2447,12.7,0.5518037
8674,8674,Duane Sutter,1986-87,26.0,8,53,80,80,20,33,53,151.0,,467,107,154,261,796.0,80,7.94,82,370,2484,12.8,0.6159991
8675,8675,Duane Sutter,1987-88,27.0,9,31,80,80,14,17,31,152.0,,547,121,171,292,948.0,80,7.34,72,344,2400,12.2,0.44791964
8676,8676,Duane Sutter,1988-89,28.0,10,16,37,37,7,9,16,74.0,,584,128,180,308,1022.0,80,7.43,89,437,2435,12.2,0.43848312
8677,8677,Duane Sutter,1989-90,29.0,11,16,75,75,7,9,16,83.0,,659,135,189,324,1105.0,80,7.48,85,403,2430,12.3,0.28116137
8678,8678,Duane Sutter,1990-91,30.0,12,18,72,72,4,14,18,70.0,,731,139,203,342,1175.0,80,7.37,76,367,2421,12.2,0.27443552
8679,8679,Duncan Keith,2006-07,23.0,2,21,81,81,9,12,21,134.0,1898.0,81,9,12,21,134.0,82,6.05,85,480,2458,10.1,0.34854537
8680,8680,Duncan Keith,2007-08,24.0,3,31,82,82,2,29,31,122.0,1935.0,163,11,41,52,256.0,82,5.76,70,398,2426,9.7,0.38181672
8681,8681,Duncan Keith,2008-09,25.0,4,32,82,82,12,20,32,148.0,2096.0,245,23,61,84,404.0,82,5.44,62,351,2383,9.4,0.46201503
8682,8682,Duncan Keith,2009-10,26.0,5,44,77,77,8,36,44,173.0,1969.0,322,31,97,128,577.0,82,5.7,65,341,2477,9.4,0.55549663
8683,8683,Duncan Keith,2010-11,27.0,6,69,82,82,14,55,69,213.0,2181.0,404,45,152,197,790.0,82,5.53,56,304,2486,9.1,0.7222309
8684,8684,Duncan Keith,2011-12,28.0,7,45,82,82,7,38,45,173.0,2205.0,486,52,190,242,963.0,82,5.46,52,291,2492,9.0,0.5358962
8685,8685,Duncan Keith,2012-13,29.0,8,40,74,74,4,36,40,162.0,1990.0,560,56,226,282,1125.0,82,5.32,47,271,2439,8.9,0.4742318
8686,8686,Duncan Keith,2013-14,30.0,9,27,47,47,3,24,27,91.0,1133.0,607,59,250,309,1216.0,48,5.31,29,160,1399,9.1,0.50585604
8687,8687,Duncan Keith,2014-15,31.0,10,61,79,79,6,55,61,198.0,1947.0,686,65,305,370,1414.0,82,5.34,48,269,2463,8.9,0.6524164
8688,8688,Duncan Keith,2015-16,32.0,11,45,80,80,10,35,45,171.0,2045.0,766,75,340,415,1585.0,82,5.32,47,251,2453,8.9,0.5382911
8689,8689,Duncan Keith,2016-17,33.0,12,43,67,67,9,34,43,130.0,1691.0,833,84,374,458,1715.0,82,5.34,48,255,2438,9.0,0.5578027
8690,8690,Duncan Keith,2017-18,34.0,13,53,80,80,6,47,53,183.0,2049.0,913,90,421,511,1898.0,82,5.45,47,245,2478,9.0,0.5735197
8691,8691,Duncan Keith,2018-19,35.0,14,32,82,82,2,30,32,187.0,1954.0,995,92,451,543,2085.0,82,5.86,50,250,2620,9.2,0.3958797
8692,8692,Duncan Keith,2019-20,36.0,15,40,82,82,6,34,40,141.0,1887.0,1077,98,485,583,2226.0,82,5.96,47,239,2579,9.5,0.4226768
8693,8693,Duncan Keith,2020-21,37.0,16,27,61,61,3,24,27,111.0,1488.0,1138,101,509,610,2337.0,70,5.96,42,208,2192,9.5,0.41182244
8694,8694,Duncan Milroy,2007-08,24.0,2,1,5,5,0,1,1,6.0,65.0,5,0,1,1,6.0,82,5.76,70,398,2426,9.7,0.18681282
8695,8695,Duncan Siemens,2015-16,22.0,2,0,1,1,0,0,0,0.0,14.0,1,0,0,0,0.0,82,5.32,47,251,2453,8.9,0.14922687
8696,8696,Duncan Siemens,2017-18,24.0,3,0,3,3,0,0,0,2.0,37.0,4,0,0,0,2.0,82,5.45,47,245,2478,9.0,0.17305931
8697,8697,Duncan Siemens,2018-19,25.0,4,2,16,16,1,1,2,14.0,197.0,20,1,1,2,16.0,82,5.86,50,250,2620,9.2,0.18129921
8698,8698,Dusan Pasek,1989-90,29.0,2,14,48,48,4,10,14,86.0,,48,4,10,14,86.0,80,7.48,85,403,2430,12.3,0.31268758
8699,8699,Dustin Boyd,2007-08,21.0,2,4,13,13,2,2,4,8.0,132.0,13,2,2,4,8.0,82,5.76,70,398,2426,9.7,0.28274828
8700,8700,Dustin Boyd,2008-09,22.0,3,12,48,48,7,5,12,46.0,471.0,61,9,7,16,54.0,82,5.44,62,351,2383,9.4,0.29057544
8701,8701,Dustin Boyd,2009-10,23.0,4,22,71,71,11,11,22,74.0,914.0,132,20,18,38,128.0,82,5.7,65,341,2477,9.4,0.33750945
8702,8702,Dustin Boyd,2010-11,24.0,5,24,78,78,11,13,24,112.0,954.0,210,31,31,62,240.0,82,5.53,56,304,2486,9.1,0.3056193
8703,8703,Dustin Boyd,2011-12,25.0,6,1,10,10,1,0,1,8.0,98.0,220,32,31,63,248.0,82,5.46,52,291,2492,9.0,0.1968359
8704,8704,Dustin Brown,2004-05,20.0,2,5,31,31,1,4,5,40.0,325.0,31,1,4,5,40.0,82,5.14,57,348,2300,9.2,0.2759984
8705,8705,Dustin Brown,2006-07,22.0,3,28,79,79,14,14,28,159.0,1104.0,110,15,18,33,199.0,82,6.05,85,480,2458,10.1,0.42857566
8706,8706,Dustin Brown,2007-08,23.0,4,46,81,81,17,29,46,195.0,1516.0,191,32,47,79,394.0,82,5.76,70,398,2426,9.7,0.5865597
8707,8707,Dustin Brown,2008-09,24.0,5,60,78,78,33,27,60,219.0,1583.0,269,65,74,139,613.0,82,5.44,62,351,2383,9.4,0.72076887
8708,8708,Dustin Brown,2009-10,25.0,6,53,80,80,24,29,53,292.0,1552.0,349,89,103,192,905.0,82,5.7,65,341,2477,9.4,0.68080306
8709,8709,Dustin Brown,2010-11,26.0,7,56,82,82,24,32,56,248.0,1579.0,431,113,135,248,1153.0,82,5.53,56,304,2486,9.1,0.6882738
8710,8710,Dustin Brown,2011-12,27.0,8,57,82,82,28,29,57,228.0,1588.0,513,141,164,305,1381.0,82,5.46,52,291,2492,9.0,0.66629124
8711,8711,Dustin Brown,2012-13,28.0,9,54,82,82,22,32,54,214.0,1654.0,595,163,196,359,1595.0,82,5.32,47,271,2439,8.9,0.66920227
8712,8712,Dustin Brown,2013-14,29.0,10,29,46,46,18,11,29,142.0,897.0,641,181,207,388,1737.0,48,5.31,29,160,1399,9.1,0.6015905
8713,8713,Dustin Brown,2014-15,30.0,11,27,79,79,15,12,27,195.0,1251.0,720,196,219,415,1932.0,82,5.34,48,269,2463,8.9,0.41880208
8714,8714,Dustin Brown,2015-16,31.0,12,27,82,82,11,16,27,189.0,1354.0,802,207,235,442,2121.0,82,5.32,47,251,2453,8.9,0.3711155
8715,8715,Dustin Brown,2016-17,32.0,13,28,82,82,11,17,28,218.0,1326.0,884,218,252,470,2339.0,82,5.34,48,255,2438,9.0,0.40501964
8716,8716,Dustin Brown,2017-18,33.0,14,36,80,80,14,22,36,175.0,1280.0,964,232,274,506,2514.0,82,5.45,47,245,2478,9.0,0.4513689
8717,8717,Dustin Brown,2018-19,34.0,15,61,81,81,28,33,61,222.0,1607.0,1045,260,307,567,2736.0,82,5.86,50,250,2620,9.2,0.64111644
8718,8718,Dustin Brown,2019-20,35.0,16,51,72,72,22,29,51,180.0,1469.0,1117,282,336,618,2916.0,82,5.96,47,239,2579,9.5,0.5412518
8719,8719,Dustin Brown,2020-21,36.0,17,35,66,66,17,18,35,169.0,1215.0,1183,299,354,653,3085.0,70,5.96,42,208,2192,9.5,0.46784136
8720,8720,Dustin Byfuglien,2006-07,21.0,2,5,25,25,3,2,5,45.0,433.0,25,3,2,5,45.0,82,6.05,85,480,2458,10.1,0.33326617
8721,8721,Dustin Byfuglien,2007-08,22.0,3,3,9,9,1,2,3,18.0,156.0,34,4,4,8,63.0,82,5.76,70,398,2426,9.7,0.27497303
8722,8722,Dustin Byfuglien,2008-09,23.0,4,36,67,67,19,17,36,163.0,1141.0,101,23,21,44,226.0,82,5.44,62,351,2383,9.4,0.50560296
8723,8723,Dustin Byfuglien,2009-10,24.0,5,31,77,77,15,16,31,202.0,1145.0,178,38,37,75,428.0,82,5.7,65,341,2477,9.4,0.48874712
8724,8724,Dustin Byfuglien,2010-11,25.0,6,34,82,82,17,17,34,211.0,1346.0,260,55,54,109,639.0,82,5.53,56,304,2486,9.1,0.48765457
8725,8725,Dustin Byfuglien,2011-12,26.0,7,53,81,81,20,33,53,347.0,1888.0,341,75,87,162,986.0,82,5.46,52,291,2492,9.0,0.6569135
8726,8726,Dustin Byfuglien,2012-13,27.0,8,53,66,66,12,41,53,223.0,1592.0,407,87,128,215,1209.0,82,5.32,47,271,2439,8.9,0.66108775
8727,8727,Dustin Byfuglien,2013-14,28.0,9,28,43,43,8,20,28,142.0,1049.0,450,95,148,243,1351.0,48,5.31,29,160,1399,9.1,0.63031906
8728,8728,Dustin Byfuglien,2014-15,29.0,10,56,78,78,20,36,56,256.0,1801.0,528,115,184,299,1607.0,82,5.34,48,269,2463,8.9,0.703723
8729,8729,Dustin Byfuglien,2015-16,30.0,11,45,69,69,18,27,45,209.0,1565.0,597,133,211,344,1816.0,82,5.32,47,251,2453,8.9,0.6192221
8730,8730,Dustin Byfuglien,2016-17,31.0,12,53,81,81,19,34,53,247.0,2041.0,678,152,245,397,2063.0,82,5.34,48,255,2438,9.0,0.6350184
8731,8731,Dustin Byfuglien,2017-18,32.0,13,52,80,80,13,39,52,241.0,2196.0,758,165,284,449,2304.0,82,5.45,47,245,2478,9.0,0.6352324
8732,8732,Dustin Byfuglien,2018-19,33.0,14,45,69,69,8,37,45,193.0,1679.0,827,173,321,494,2497.0,82,5.86,50,250,2620,9.2,0.62050277
8733,8733,Dustin Byfuglien,2019-20,34.0,15,31,42,42,4,27,31,115.0,1023.0,869,177,348,525,2612.0,82,5.96,47,239,2579,9.5,0.5194197
8734,8734,Dustin Jeffrey,2009-10,21.0,2,3,14,14,1,2,3,18.0,151.0,14,1,2,3,18.0,82,5.7,65,341,2477,9.4,0.26441824
8735,8735,Dustin Jeffrey,2010-11,22.0,3,0,1,1,0,0,0,0.0,9.0,15,1,2,3,18.0,82,5.53,56,304,2486,9.1,0.16897273
8736,8736,Dustin Jeffrey,2011-12,23.0,4,12,25,25,7,5,12,39.0,324.0,40,8,7,15,57.0,82,5.46,52,291,2492,9.0,0.32282007
8737,8737,Dustin Jeffrey,2012-13,24.0,5,6,26,26,4,2,6,33.0,315.0,66,12,9,21,90.0,82,5.32,47,271,2439,8.9,0.23249596
8738,8738,Dustin Jeffrey,2013-14,25.0,6,6,24,24,3,3,6,26.0,276.0,90,15,12,27,116.0,48,5.31,29,160,1399,9.1,0.2582015
8739,8739,Dustin Jeffrey,2014-15,26.0,7,4,34,34,2,2,4,30.0,325.0,124,17,14,31,146.0,82,5.34,48,269,2463,8.9,0.16928479
8740,8740,Dustin Jeffrey,2016-17,28.0,8,2,7,7,1,1,2,5.0,80.0,131,18,15,33,151.0,82,5.34,48,255,2438,9.0,0.15717092
8741,8741,Dustin Kohn,2010-11,23.0,2,4,22,22,0,4,4,7.0,255.0,22,0,4,4,7.0,82,5.53,56,304,2486,9.1,0.14393333
8742,8742,Dustin Penner,2006-07,24.0,2,7,19,19,4,3,7,46.0,227.0,19,4,3,7,46.0,82,6.05,85,480,2458,10.1,0.28914607
8743,8743,Dustin Penner,2007-08,25.0,3,45,82,82,29,16,45,204.0,1147.0,101,33,19,52,250.0,82,5.76,70,398,2426,9.7,0.590668
8744,8744,Dustin Penner,2008-09,26.0,4,47,82,82,23,24,47,201.0,1411.0,183,56,43,99,451.0,82,5.44,62,351,2383,9.4,0.5978982
8745,8745,Dustin Penner,2009-10,27.0,5,37,78,78,17,20,37,137.0,1200.0,261,73,63,136,588.0,82,5.7,65,341,2477,9.4,0.46992978
8746,8746,Dustin Penner,2010-11,28.0,6,63,82,82,32,31,63,203.0,1507.0,343,105,94,199,791.0,82,5.53,56,304,2486,9.1,0.68330735
8747,8747,Dustin Penner,2011-12,29.0,7,45,81,81,23,22,45,173.0,1468.0,424,128,116,244,964.0,82,5.46,52,291,2492,9.0,0.5200471
8748,8748,Dustin Penner,2012-13,30.0,8,17,65,65,7,10,17,119.0,931.0,489,135,126,261,1083.0,82,5.32,47,271,2439,8.9,0.31886172
8749,8749,Dustin Penner,2013-14,31.0,9,14,33,33,2,12,14,61.0,419.0,522,137,138,275,1144.0,48,5.31,29,160,1399,9.1,0.3609662
8750,8750,Dustin Penner,2014-15,32.0,10,35,67,67,14,21,35,119.0,969.0,589,151,159,310,1263.0,82,5.34,48,269,2463,8.9,0.37691474
8751,8751,Duvie Westcott,2002-03,25.0,2,0,4,4,0,0,0,3.0,61.0,4,0,0,0,3.0,82,5.24,53,338,2262,9.5,0.16574696
8752,8752,Duvie Westcott,2003-04,26.0,3,7,39,39,0,7,7,27.0,728.0,43,0,7,7,30.0,82,5.31,60,363,2326,9.4,0.1437675
8753,8753,Duvie Westcott,2004-05,27.0,4,7,34,34,0,7,7,43.0,720.0,77,0,14,14,73.0,82,5.14,57,348,2300,9.2,0.18972194
8754,8754,Duvie Westcott,2006-07,29.0,5,28,78,78,6,22,28,113.0,1761.0,155,6,36,42,186.0,82,6.05,85,480,2458,10.1,0.3021167
8755,8755,Duvie Westcott,2007-08,30.0,6,10,23,23,4,6,10,34.0,509.0,178,10,42,52,220.0,82,5.76,70,398,2426,9.7,0.25210392
8756,8756,Duvie Westcott,2008-09,31.0,7,4,23,23,1,3,4,27.0,378.0,201,11,45,56,247.0,82,5.44,62,351,2383,9.4,0.1878249
8757,8757,Dwayne Hay,1998-99,21.0,2,0,2,2,0,0,0,1.0,,2,0,0,0,1.0,82,5.28,57,380,2242,9.6,0.17559981
8758,8758,Dwayne Hay,1999-00,22.0,3,0,9,9,0,0,0,3.0,59.0,11,0,0,0,4.0,82,5.27,57,359,2285,9.4,0.16779467
8759,8759,Dwayne Hay,2000-01,23.0,4,2,19,19,1,1,2,14.0,118.0,30,1,1,2,18.0,82,5.49,53,331,2294,9.8,0.151874
8760,8760,Dwayne Hay,2001-02,24.0,5,4,49,49,1,3,4,39.0,412.0,79,2,4,6,57.0,82,5.51,63,376,2272,9.9,0.14585191
8761,8761,Dwayne Lowdermilk,1981-82,24.0,2,1,2,2,0,1,1,2.0,,2,0,1,1,2.0,80,7.69,77,340,2441,12.6,0.24307808
8762,8762,Dwayne Norris,1994-95,25.0,2,2,4,4,1,1,2,7.0,,4,1,1,2,7.0,84,6.48,76,407,2545,10.7,0.21831805
8763,8763,Dwayne Norris,1995-96,26.0,3,3,13,13,1,2,3,7.0,,17,2,3,5,14.0,48,5.97,37,209,1408,10.2,0.21443635
8764,8764,Dwayne Norris,1996-97,27.0,4,1,3,3,0,1,1,3.0,,20,2,4,6,17.0,82,6.29,74,413,2481,10.4,0.16152331
8765,8765,Dwayne Zinger,2004-05,28.0,2,1,7,7,0,1,1,0.0,38.0,7,0,1,1,0.0,82,5.14,57,348,2300,9.2,0.15515995
8766,8766,Dwight Helminen,2009-10,26.0,2,2,23,23,1,1,2,15.0,157.0,23,1,1,2,15.0,82,5.7,65,341,2477,9.4,0.14439246
8767,8767,Dwight Helminen,2010-11,27.0,3,1,4,4,1,0,1,1.0,44.0,27,2,1,3,16.0,82,5.53,56,304,2486,9.1,0.16736668
8768,8768,Dwight King,2011-12,22.0,2,0,6,6,0,0,0,3.0,70.0,6,0,0,0,3.0,82,5.46,52,291,2492,9.0,0.18394265
8769,8769,Dwight King,2012-13,23.0,3,14,27,27,5,9,14,42.0,395.0,33,5,9,14,45.0,82,5.32,47,271,2439,8.9,0.321429
8770,8770,Dwight King,2013-14,24.0,4,10,47,47,4,6,10,60.0,600.0,80,9,15,24,105.0,48,5.31,29,160,1399,9.1,0.28550994
8771,8771,Dwight King,2014-15,25.0,5,30,77,77,15,15,30,111.0,1158.0,157,24,30,54,216.0,82,5.34,48,269,2463,8.9,0.38145283
8772,8772,Dwight King,2015-16,26.0,6,26,81,81,13,13,26,127.0,1166.0,238,37,43,80,343.0,82,5.32,47,251,2453,8.9,0.348468
8773,8773,Dwight King,2016-17,27.0,7,13,47,47,7,6,13,48.0,679.0,285,44,49,93,391.0,82,5.34,48,255,2438,9.0,0.25337574
8774,8774,Dwight King,2017-18,28.0,8,16,80,80,9,7,16,110.0,1153.0,365,53,56,109,501.0,82,5.45,47,245,2478,9.0,0.24895528
8775,8775,Dwight Mathiasen,1986-87,23.0,2,1,4,4,1,0,1,4.0,,4,1,0,1,4.0,80,7.94,82,370,2484,12.8,0.26137036
8776,8776,Dwight Mathiasen,1987-88,24.0,3,1,6,6,0,1,1,4.0,,10,1,1,2,8.0,80,7.34,72,344,2400,12.2,0.22255209
8777,8777,Dwight Mathiasen,1988-89,25.0,4,6,23,23,0,6,6,29.0,,33,1,7,8,37.0,80,7.43,89,437,2435,12.2,0.26637554
8778,8778,Dylan DeMelo,2016-17,23.0,2,4,45,45,2,2,4,42.0,613.0,45,2,2,4,42.0,82,5.34,48,255,2438,9.0,0.19254681
8779,8779,Dylan DeMelo,2017-18,24.0,3,8,25,25,1,7,8,32.0,397.0,70,3,9,12,74.0,82,5.45,47,245,2478,9.0,0.22454786
8780,8780,Dylan DeMelo,2018-19,25.0,4,20,63,63,0,20,20,67.0,895.0,133,3,29,32,141.0,82,5.86,50,250,2620,9.2,0.22368261
8781,8781,Dylan DeMelo,2019-20,26.0,5,22,77,77,4,18,22,109.0,1485.0,210,7,47,54,250.0,82,5.96,47,239,2579,9.5,0.25880373
8782,8782,Dylan DeMelo,2020-21,27.0,6,10,59,59,0,10,10,74.0,1188.0,269,7,57,64,324.0,70,5.96,42,208,2192,9.5,0.22516891
8783,8783,Dylan Gambrell,2018-19,22.0,2,0,3,3,0,0,0,1.0,32.0,3,0,0,0,1.0,82,5.86,50,250,2620,9.2,0.1645863
8784,8784,Dylan Gambrell,2019-20,23.0,3,0,8,8,0,0,0,6.0,69.0,11,0,0,0,7.0,82,5.96,47,239,2579,9.5,0.173381
8785,8785,Dylan Gambrell,2020-21,24.0,4,11,50,50,5,6,11,43.0,598.0,61,5,6,11,50.0,70,5.96,42,208,2192,9.5,0.24668169
8786,8786,Dylan Larkin,2016-17,20.0,2,45,80,80,23,22,45,221.0,1324.0,80,23,22,45,221.0,82,5.34,48,255,2438,9.0,0.6345446
8787,8787,Dylan Larkin,2017-18,21.0,3,32,80,80,17,15,32,178.0,1292.0,160,40,37,77,399.0,82,5.45,47,245,2478,9.0,0.5531345
8788,8788,Dylan Larkin,2018-19,22.0,4,63,82,82,16,47,63,232.0,1627.0,242,56,84,140,631.0,82,5.86,50,250,2620,9.2,0.820063
8789,8789,Dylan Larkin,2019-20,23.0,5,73,76,76,32,41,73,287.0,1660.0,318,88,125,213,918.0,82,5.96,47,239,2579,9.5,0.89060855
8790,8790,Dylan Larkin,2020-21,24.0,6,53,71,71,19,34,53,223.0,1509.0,389,107,159,266,1141.0,70,5.96,42,208,2192,9.5,0.77221286
8791,8791,Dylan McIlrath,2014-15,22.0,2,0,2,2,0,0,0,0.0,14.0,2,0,0,0,0.0,82,5.34,48,269,2463,8.9,0.14922687
8792,8792,Dylan McIlrath,2015-16,23.0,3,0,1,1,0,0,0,0.0,8.0,3,0,0,0,0.0,82,5.32,47,251,2453,8.9,0.14851156
8793,8793,Dylan McIlrath,2016-17,24.0,4,4,34,34,2,2,4,28.0,480.0,37,2,2,4,28.0,82,5.34,48,255,2438,9.0,0.18753344
8794,8794,Dylan McIlrath,2017-18,25.0,5,1,6,6,1,0,1,3.0,57.0,43,3,2,5,31.0,82,5.45,47,245,2478,9.0,0.1658161
8795,8795,Dylan McIlrath,2019-20,27.0,6,0,7,7,0,0,0,6.0,106.0,50,3,2,5,37.0,82,5.96,47,239,2579,9.5,0.122241646
8796,8796,Dylan McIlrath,2020-21,28.0,7,0,16,16,0,0,0,14.0,237.0,66,3,2,5,51.0,70,5.96,42,208,2192,9.5,0.1251275
8797,8797,Dylan Olsen,2012-13,22.0,2,1,28,28,0,1,1,16.0,365.0,28,0,1,1,16.0,82,5.32,47,271,2439,8.9,0.15086508
8798,8798,Dylan Olsen,2014-15,24.0,3,12,44,44,3,9,12,60.0,679.0,72,3,10,13,76.0,82,5.34,48,269,2463,8.9,0.22246796
8799,8799,Dylan Olsen,2015-16,25.0,4,8,44,44,2,6,8,44.0,700.0,116,5,16,21,120.0,82,5.32,47,251,2453,8.9,0.17928398
8800,8800,Dylan Olsen,2016-17,26.0,5,1,8,8,0,1,1,9.0,110.0,124,5,17,22,129.0,82,5.34,48,255,2438,9.0,0.15382692
8801,8801,Dylan Reese,2010-11,26.0,2,4,19,19,2,2,4,16.0,286.0,19,2,2,4,16.0,82,5.53,56,304,2486,9.1,0.18296003
8802,8802,Dylan Reese,2011-12,27.0,3,6,27,27,0,6,6,23.0,400.0,46,2,8,10,39.0,82,5.46,52,291,2492,9.0,0.16006061
8803,8803,Dylan Reese,2012-13,28.0,4,7,28,28,1,6,7,26.0,478.0,74,3,14,17,65.0,82,5.32,47,271,2439,8.9,0.17571843
8804,8804,Dylan Reese,2013-14,29.0,5,0,3,3,0,0,0,1.0,46.0,77,3,14,17,66.0,48,5.31,29,160,1399,9.1,0.15125233
8805,8805,Dylan Reese,2015-16,31.0,6,0,1,1,0,0,0,3.0,20.0,78,3,14,17,69.0,82,5.32,47,251,2453,8.9,0.12842041
8806,8806,Dylan Sikura,2018-19,23.0,2,3,5,5,0,3,3,9.0,67.0,5,0,3,3,9.0,82,5.86,50,250,2620,9.2,0.21211612
8807,8807,Dylan Sikura,2019-20,24.0,3,8,33,33,0,8,8,52.0,372.0,38,0,11,11,61.0,82,5.96,47,239,2579,9.5,0.19867003
8808,8808,Dylan Sikura,2020-21,25.0,4,3,9,9,1,2,3,10.0,89.0,47,1,13,14,71.0,70,5.96,42,208,2192,9.5,0.22782958
8809,8809,Dylan Strome,2017-18,20.0,2,1,7,7,0,1,1,6.0,96.0,7,0,1,1,6.0,82,5.45,47,245,2478,9.0,0.2780878
8810,8810,Dylan Strome,2018-19,21.0,3,9,21,21,4,5,9,30.0,272.0,28,4,6,10,36.0,82,5.86,50,250,2620,9.2,0.36927944
8811,8811,Dylan Strome,2019-20,22.0,4,57,78,78,20,37,57,145.0,1260.0,106,24,43,67,181.0,82,5.96,47,239,2579,9.5,0.67150486
8812,8812,Dylan Strome,2020-21,23.0,5,38,58,58,12,26,38,97.0,925.0,164,36,69,105,278.0,70,5.96,42,208,2192,9.5,0.56582135
8813,8813,Earl Ingarfield,1980-81,22.0,2,0,1,1,0,0,0,7.0,,1,0,0,0,7.0,80,7.03,61,280,2352,12.0,0.23961547
8814,8814,Earl Ingarfield,1981-82,23.0,3,8,38,38,4,4,8,37.0,,39,4,4,8,44.0,80,7.69,77,340,2441,12.6,0.25151426
8815,8815,Ed Cooper,1981-82,21.0,2,14,47,47,7,7,14,52.0,,47,7,7,14,52.0,80,7.69,77,340,2441,12.6,0.36183387
8816,8816,Ed Cooper,1982-83,22.0,3,1,2,2,1,0,1,1.0,,49,8,7,15,53.0,80,8.03,73,320,2489,12.9,0.2668715
8817,8817,Ed Courtenay,1992-93,24.0,2,0,5,5,0,0,0,7.0,,5,0,0,0,7.0,80,6.96,77,402,2440,11.4,0.21770963
8818,8818,Ed Courtenay,1993-94,25.0,3,20,39,39,7,13,20,56.0,,44,7,13,20,63.0,84,7.25,87,443,2603,11.7,0.37172344
8819,8819,Ed Cristofoli,1990-91,23.0,2,1,9,9,0,1,1,6.0,,9,0,1,1,6.0,80,7.37,76,367,2421,12.2,0.2315563
8820,8820,Ed Hospodar,1980-81,21.0,2,1,20,20,0,1,1,9.0,,20,0,1,1,9.0,80,7.03,61,280,2352,12.0,0.23082757
8821,8821,Ed Hospodar,1981-82,22.0,3,19,61,61,5,14,19,49.0,,81,5,15,20,58.0,80,7.69,77,340,2441,12.6,0.31809646
8822,8822,Ed Hospodar,1982-83,23.0,4,11,41,41,3,8,11,29.0,,122,8,23,31,87.0,80,8.03,73,320,2489,12.9,0.26033294
8823,8823,Ed Hospodar,1983-84,24.0,5,10,72,72,1,9,10,55.0,,194,9,32,41,142.0,80,7.73,71,310,2444,12.7,0.21192938
8824,8824,Ed Hospodar,1984-85,25.0,6,9,59,59,0,9,9,56.0,,253,9,41,50,198.0,80,7.89,74,336,2448,12.9,0.21375233
8825,8825,Ed Hospodar,1985-86,26.0,7,7,50,50,3,4,7,50.0,,303,12,45,57,248.0,80,7.77,71,321,2447,12.7,0.19385713
8826,8826,Ed Hospodar,1986-87,27.0,8,6,60,60,3,3,6,44.0,,363,15,48,63,292.0,80,7.94,82,370,2484,12.8,0.16845122
8827,8827,Ed Hospodar,1987-88,28.0,9,4,45,45,2,2,4,17.0,,408,17,50,67,309.0,80,7.34,72,344,2400,12.2,0.14678323
8828,8828,Ed Hospodar,1988-89,29.0,10,1,42,42,0,1,1,15.0,,450,17,51,68,324.0,80,7.43,89,437,2435,12.2,0.10216746
8829,8829,Ed Jovanovski,1996-97,20.0,2,21,70,70,10,11,21,116.0,,70,10,11,21,116.0,82,6.29,74,413,2481,10.4,0.3630286
8830,8830,Ed Jovanovski,1997-98,21.0,3,23,61,61,7,16,23,80.0,,131,17,27,44,196.0,82,5.83,55,336,2444,9.8,0.38793
8831,8831,Ed Jovanovski,1998-99,22.0,4,23,81,81,9,14,23,142.0,,212,26,41,67,338.0,82,5.28,57,380,2242,9.6,0.38366807
8832,8832,Ed Jovanovski,1999-00,23.0,5,27,72,72,5,22,27,109.0,1585.0,284,31,63,94,447.0,82,5.27,57,359,2285,9.4,0.38246208
8833,8833,Ed Jovanovski,2000-01,24.0,6,26,75,75,5,21,26,109.0,1803.0,359,36,84,120,556.0,82,5.49,53,331,2294,9.8,0.40753144
8834,8834,Ed Jovanovski,2001-02,25.0,7,47,79,79,12,35,47,193.0,1971.0,438,48,119,167,749.0,82,5.51,63,376,2272,9.9,0.58805317
8835,8835,Ed Jovanovski,2002-03,26.0,8,48,82,82,17,31,48,202.0,2065.0,520,65,150,215,951.0,82,5.24,53,338,2262,9.5,0.60441184
8836,8836,Ed Jovanovski,2003-04,27.0,9,46,67,67,6,40,46,145.0,1625.0,587,71,190,261,1096.0,82,5.31,60,363,2326,9.4,0.53826606
8837,8837,Ed Jovanovski,2004-05,28.0,10,23,56,56,7,16,23,143.0,1299.0,643,78,206,284,1239.0,82,5.14,57,348,2300,9.2,0.5101994
8838,8838,Ed Jovanovski,2006-07,30.0,11,33,44,44,8,25,33,87.0,1075.0,687,86,231,317,1326.0,82,6.05,85,480,2458,10.1,0.55931246
8839,8839,Ed Jovanovski,2007-08,31.0,12,29,54,54,11,18,29,135.0,1250.0,741,97,249,346,1461.0,82,5.76,70,398,2426,9.7,0.5024146
8840,8840,Ed Jovanovski,2008-09,32.0,13,51,80,80,12,39,51,240.0,1804.0,821,109,288,397,1701.0,82,5.44,62,351,2383,9.4,0.597371
8841,8841,Ed Jovanovski,2009-10,33.0,14,36,82,82,9,27,36,194.0,1817.0,903,118,315,433,1895.0,82,5.7,65,341,2477,9.4,0.44373122
8842,8842,Ed Jovanovski,2010-11,34.0,15,34,66,66,10,24,34,117.0,1428.0,969,128,339,467,2012.0,82,5.53,56,304,2486,9.1,0.33883956
8843,8843,Ed Jovanovski,2011-12,35.0,16,14,50,50,5,9,14,73.0,1024.0,1019,133,348,481,2085.0,82,5.46,52,291,2492,9.0,0.25400808
8844,8844,Ed Jovanovski,2012-13,36.0,17,13,66,66,3,10,13,58.0,1102.0,1085,136,358,494,2143.0,82,5.32,47,271,2439,8.9,0.16347852
8845,8845,Ed Jovanovski,2013-14,37.0,18,1,6,6,0,1,1,6.0,94.0,1091,136,359,495,2149.0,48,5.31,29,160,1399,9.1,0.1761044
8846,8846,Ed Jovanovski,2014-15,38.0,19,5,37,37,1,4,5,44.0,598.0,1128,137,363,500,2193.0,82,5.34,48,269,2463,8.9,0.17474753
8847,8847,Ed Kastelic,1986-87,23.0,2,0,15,15,0,0,0,2.0,,15,0,0,0,2.0,80,7.94,82,370,2484,12.8,0.19986296
8848,8848,Ed Kastelic,1987-88,24.0,3,2,23,23,1,1,2,15.0,,38,1,1,2,17.0,80,7.34,72,344,2400,12.2,0.19448495
8849,8849,Ed Kastelic,1988-89,25.0,4,1,35,35,1,0,1,20.0,,73,2,1,3,37.0,80,7.43,89,437,2435,12.2,0.1537306
8850,8850,Ed Kastelic,1989-90,26.0,5,2,10,10,0,2,2,6.0,,83,2,3,5,43.0,80,7.48,85,403,2430,12.3,0.17708135
8851,8851,Ed Kastelic,1990-91,27.0,6,8,67,67,6,2,8,35.0,,150,8,5,13,78.0,80,7.37,76,367,2421,12.2,0.1447978
8852,8852,Ed Kastelic,1991-92,28.0,7,4,45,45,2,2,4,15.0,,195,10,7,17,93.0,80,6.91,71,366,2385,11.6,0.12923041
8853,8853,Ed Kastelic,1992-93,29.0,8,4,25,25,1,3,4,4.0,,220,11,10,21,97.0,80,6.96,77,402,2440,11.4,0.13272628
8854,8854,Ed Olczyk,1985-86,19.0,2,50,70,70,20,30,50,134.0,,70,20,30,50,134.0,80,7.77,71,321,2447,12.7,0.7879225
8855,8855,Ed Olczyk,1986-87,20.0,3,79,79,79,29,50,79,218.0,,149,49,80,129,352.0,80,7.94,82,370,2484,12.8,0.8993956
8856,8856,Ed Olczyk,1987-88,21.0,4,51,79,79,16,35,51,181.0,,228,65,115,180,533.0,80,7.34,72,344,2400,12.2,0.8001662
8857,8857,Ed Olczyk,1988-89,22.0,5,75,80,80,42,33,75,243.0,,308,107,148,255,776.0,80,7.43,89,437,2435,12.2,0.9520295
8858,8858,Ed Olczyk,1989-90,23.0,6,90,80,80,38,52,90,249.0,,388,145,200,345,1025.0,80,7.48,85,403,2430,12.3,1.1233438
8859,8859,Ed Olczyk,1990-91,24.0,7,88,79,79,32,56,88,208.0,,467,177,256,433,1233.0,80,7.37,76,367,2421,12.2,1.0362422
8860,8860,Ed Olczyk,1991-92,25.0,8,71,79,79,30,41,71,226.0,,546,207,297,504,1459.0,80,6.91,71,366,2385,11.6,0.9485627
8861,8861,Ed Olczyk,1992-93,26.0,9,65,64,64,32,33,65,245.0,,610,239,330,569,1704.0,80,6.96,77,402,2440,11.4,0.9486148
8862,8862,Ed Olczyk,1993-94,27.0,10,49,71,71,21,28,49,190.0,,681,260,358,618,1894.0,84,7.25,87,443,2603,11.7,0.61111027
8863,8863,Ed Olczyk,1994-95,28.0,11,8,37,37,3,5,8,40.0,,718,263,363,626,1934.0,84,6.48,76,407,2545,10.7,0.43228564
8864,8864,Ed Olczyk,1995-96,29.0,12,13,33,33,4,9,13,56.0,,751,267,372,639,1990.0,48,5.97,37,209,1408,10.2,0.56987625
8865,8865,Ed Olczyk,1996-97,30.0,13,49,51,51,27,22,49,147.0,,802,294,394,688,2137.0,82,6.29,74,413,2481,10.4,0.838001
8866,8866,Ed Olczyk,1997-98,31.0,14,55,79,79,25,30,55,195.0,,881,319,424,743,2332.0,82,5.83,55,336,2444,9.8,0.59775007
8867,8867,Ed Olczyk,1998-99,32.0,15,22,56,56,11,11,22,123.0,,937,330,435,765,2455.0,82,5.28,57,380,2242,9.6,0.4330381
8868,8868,Ed Olczyk,1999-00,33.0,16,25,61,61,10,15,25,88.0,899.0,998,340,450,790,2543.0,82,5.27,57,359,2285,9.4,0.3564503
8869,8869,Ed Olczyk,2000-01,34.0,17,4,33,33,2,2,4,33.0,307.0,1031,342,452,794,2576.0,82,5.49,53,331,2294,9.8,0.366105
8870,8870,Ed Patterson,1994-95,22.0,2,4,27,27,3,1,4,15.0,,27,3,1,4,15.0,84,6.48,76,407,2545,10.7,0.22284102
8871,8871,Ed Patterson,1996-97,24.0,3,2,35,35,0,2,2,17.0,,62,3,3,6,32.0,82,6.29,74,413,2481,10.4,0.13182583
8872,8872,Ed Patterson,1997-98,25.0,4,0,6,6,0,0,0,2.0,,68,3,3,6,34.0,82,5.83,55,336,2444,9.8,0.13089931
8873,8873,Ed Ronan,1992-93,24.0,2,0,3,3,0,0,0,1.0,,3,0,0,0,1.0,80,6.96,77,402,2440,11.4,0.20740378
8874,8874,Ed Ronan,1993-94,25.0,3,12,53,53,5,7,12,54.0,,56,5,7,12,55.0,84,7.25,87,443,2603,11.7,0.20796713
8875,8875,Ed Ronan,1994-95,26.0,4,14,61,61,6,8,14,49.0,,117,11,15,26,104.0,84,6.48,76,407,2545,10.7,0.22692144
8876,8876,Ed Ronan,1995-96,27.0,5,5,30,30,1,4,5,14.0,,147,12,19,31,118.0,48,5.97,37,209,1408,10.2,0.13480574
8877,8877,Ed Ronan,1996-97,28.0,6,0,17,17,0,0,0,13.0,,164,12,19,31,131.0,82,6.29,74,413,2481,10.4,0.13092867
8878,8878,Ed Ronan,1997-98,29.0,7,5,18,18,1,4,5,10.0,,182,13,23,36,141.0,82,5.83,55,336,2444,9.8,0.16648814
8879,8879,Ed Ward,1994-95,25.0,2,1,7,7,1,0,1,3.0,,7,1,0,1,3.0,84,6.48,76,407,2545,10.7,0.20859784
8880,8880,Ed Ward,1995-96,26.0,3,2,2,2,1,1,2,1.0,,9,2,1,3,4.0,48,5.97,37,209,1408,10.2,0.24858293
8881,8881,Ed Ward,1996-97,27.0,4,8,41,41,3,5,8,33.0,,50,5,6,11,37.0,82,6.29,74,413,2481,10.4,0.1693388
8882,8882,Ed Ward,1997-98,28.0,5,13,40,40,5,8,13,33.0,,90,10,14,24,70.0,82,5.83,55,336,2444,9.8,0.21559206
8883,8883,Ed Ward,1998-99,29.0,6,9,64,64,4,5,9,52.0,,154,14,19,33,122.0,82,5.28,57,380,2242,9.6,0.14909634
8884,8884,Ed Ward,1999-00,30.0,7,8,68,68,3,5,8,56.0,546.0,222,17,24,41,178.0,82,5.27,57,359,2285,9.4,0.13542512
8885,8885,Ed Ward,2000-01,31.0,8,7,52,52,6,1,7,56.0,559.0,274,23,25,48,234.0,82,5.49,53,331,2294,9.8,0.16691616
8886,8886,Ed Ward,2001-02,32.0,9,1,4,4,0,1,1,4.0,19.0,278,23,26,49,238.0,82,5.51,63,376,2272,9.9,0.15017667
8887,8887,Eddy Beers,1982-83,23.0,2,2,5,5,1,1,2,7.0,,5,1,1,2,7.0,80,8.03,73,320,2489,12.9,0.29558438
8888,8888,Eddy Beers,1983-84,24.0,3,26,41,41,11,15,26,74.0,,46,12,16,28,81.0,80,7.73,71,310,2444,12.7,0.5750454
8889,8889,Eddy Beers,1984-85,25.0,4,75,73,73,36,39,75,189.0,,119,48,55,103,270.0,80,7.89,74,336,2448,12.9,0.86774707
8890,8890,Eddy Beers,1985-86,26.0,5,68,74,74,28,40,68,171.0,,193,76,95,171,441.0,80,7.77,71,321,2447,12.7,0.85993135
8891,8891,Eddy Beers,1986-87,27.0,6,39,57,57,18,21,39,135.0,,250,94,116,210,576.0,80,7.94,82,370,2484,12.8,0.73399174
8892,8892,Edward Lee,1985-86,24.0,2,0,2,2,0,0,0,2.0,,2,0,0,0,2.0,80,7.77,71,321,2447,12.7,0.22581163
8893,8893,Eeli Tolvanen,2018-19,19.0,2,0,3,3,0,0,0,3.0,36.0,3,0,0,0,3.0,82,5.86,50,250,2620,9.2,0.21850714
8894,8894,Eeli Tolvanen,2019-20,20.0,3,2,4,4,1,1,2,2.0,53.0,7,1,1,2,5.0,82,5.96,47,239,2579,9.5,0.29904678
8895,8895,Eetu Luostarinen,2020-21,22.0,2,1,8,8,0,1,1,9.0,80.0,8,0,1,1,9.0,70,5.96,42,208,2192,9.5,0.22885302
8896,8896,Egor Korshkov,2020-21,24.0,2,1,1,1,1,0,1,1.0,10.0,1,1,0,1,1.0,70,5.96,42,208,2192,9.5,0.24894738
8897,8897,Egor Yakovlev,2019-20,28.0,2,7,25,25,2,5,7,24.0,392.0,25,2,5,7,24.0,82,5.96,47,239,2579,9.5,0.21694463
8898,8898,Elias Lindholm,2014-15,20.0,2,21,58,58,9,12,21,70.0,843.0,58,9,12,21,70.0,82,5.34,48,269,2463,8.9,0.34743935
8899,8899,Elias Lindholm,2015-16,21.0,3,39,81,81,17,22,39,170.0,1330.0,139,26,34,60,240.0,82,5.32,47,251,2453,8.9,0.55268586
8900,8900,Elias Lindholm,2016-17,22.0,4,39,82,82,11,28,39,176.0,1485.0,221,37,62,99,416.0,82,5.34,48,255,2438,9.0,0.5357829
8901,8901,Elias Lindholm,2017-18,23.0,5,45,72,72,11,34,45,151.0,1309.0,293,48,96,144,567.0,82,5.45,47,245,2478,9.0,0.6036203
8902,8902,Elias Lindholm,2018-19,24.0,6,44,81,81,16,28,44,153.0,1449.0,374,64,124,188,720.0,82,5.86,50,250,2620,9.2,0.5842233
8903,8903,Elias Lindholm,2019-20,25.0,7,78,81,81,27,51,78,182.0,1623.0,455,91,175,266,902.0,82,5.96,47,239,2579,9.5,0.8163159
8904,8904,Elias Lindholm,2020-21,26.0,8,54,70,70,29,25,54,169.0,1381.0,525,120,200,320,1071.0,70,5.96,42,208,2192,9.5,0.79737985
8905,8905,Elias Pettersson,2019-20,21.0,2,66,71,71,28,38,66,144.0,1294.0,71,28,38,66,144.0,82,5.96,47,239,2579,9.5,0.85767514
8906,8906,Elias Pettersson,2020-21,22.0,3,66,68,68,27,39,66,162.0,1260.0,139,55,77,132,306.0,70,5.96,42,208,2192,9.5,0.93298465
8907,8907,Emanuel Viveiros,1986-87,21.0,2,1,4,4,0,1,1,4.0,,4,0,1,1,4.0,80,7.94,82,370,2484,12.8,0.29835194
8908,8908,Emanuel Viveiros,1987-88,22.0,3,1,1,1,0,1,1,1.0,,5,0,2,2,5.0,80,7.34,72,344,2400,12.2,0.24218112
8909,8909,Emanuel Viveiros,1988-89,23.0,4,10,24,24,1,9,10,35.0,,29,1,11,12,40.0,80,7.43,89,437,2435,12.2,0.28343374
8910,8910,Emerson Etem,2013-14,21.0,2,10,38,38,3,7,10,48.0,436.0,38,3,7,10,48.0,48,5.31,29,160,1399,9.1,0.3249146
8911,8911,Emerson Etem,2014-15,22.0,3,11,29,29,7,4,11,44.0,371.0,67,10,11,21,92.0,82,5.34,48,269,2463,8.9,0.3342166
8912,8912,Emerson Etem,2015-16,23.0,4,10,45,45,5,5,10,77.0,551.0,112,15,16,31,169.0,82,5.32,47,251,2453,8.9,0.31915033
8913,8913,Emerson Etem,2016-17,24.0,5,15,58,58,7,8,15,100.0,763.0,170,22,24,46,269.0,82,5.34,48,255,2438,9.0,0.27131903
8914,8914,Emerson Etem,2017-18,25.0,6,0,3,3,0,0,0,0.0,26.0,173,22,24,46,269.0,82,5.45,47,245,2478,9.0,0.19028878
8915,8915,Emil Bemstrom,2020-21,21.0,2,20,56,56,10,10,20,97.0,687.0,56,10,10,20,97.0,70,5.96,42,208,2192,9.5,0.4138253
8916,8916,Emile Poirier,2015-16,21.0,2,1,6,6,0,1,1,2.0,48.0,6,0,1,1,2.0,82,5.32,47,251,2453,8.9,0.24529347
8917,8917,Emile Poirier,2016-17,22.0,3,0,2,2,0,0,0,3.0,28.0,8,0,1,1,5.0,82,5.34,48,255,2438,9.0,0.18155146
8918,8918,Enrico Ciccone,1992-93,22.0,2,0,11,11,0,0,0,2.0,,11,0,0,0,2.0,80,6.96,77,402,2440,11.4,0.1842047
8919,8919,Enrico Ciccone,1993-94,23.0,3,1,31,31,0,1,1,13.0,,42,0,1,1,15.0,84,7.25,87,443,2603,11.7,0.14611962
8920,8920,Enrico Ciccone,1994-95,24.0,4,3,57,57,1,2,3,33.0,,99,1,3,4,48.0,84,6.48,76,407,2545,10.7,0.13587245
8921,8921,Enrico Ciccone,1995-96,25.0,5,6,41,41,2,4,6,43.0,,140,3,7,10,91.0,48,5.97,37,209,1408,10.2,0.176633
8922,8922,Enrico Ciccone,1996-97,26.0,6,6,66,66,2,4,6,60.0,,206,5,11,16,151.0,82,6.29,74,413,2481,10.4,0.15128043
8923,8923,Enrico Ciccone,1997-98,27.0,7,4,67,67,2,2,4,65.0,,273,7,13,20,216.0,82,5.83,55,336,2444,9.8,0.14277294
8924,8924,Enrico Ciccone,1998-99,28.0,8,4,39,39,0,4,4,22.0,,312,7,17,24,238.0,82,5.28,57,380,2242,9.6,0.0852288
8925,8925,Enrico Ciccone,1999-00,29.0,9,4,59,59,3,1,4,52.0,659.0,371,10,18,28,290.0,82,5.27,57,359,2285,9.4,0.13168734
8926,8926,Enrico Ciccone,2001-02,31.0,10,0,3,3,0,0,0,0.0,9.0,374,10,18,28,290.0,82,5.51,63,376,2272,9.9,0.116714865
8927,8927,Enver Lisin,2007-08,21.0,2,2,17,17,1,1,2,35.0,256.0,17,1,1,2,35.0,82,5.76,70,398,2426,9.7,0.27981615
8928,8928,Enver Lisin,2008-09,22.0,3,5,13,13,4,1,5,27.0,188.0,30,5,2,7,62.0,82,5.44,62,351,2383,9.4,0.342219
8929,8929,Enver Lisin,2009-10,23.0,4,21,48,48,13,8,21,105.0,712.0,78,18,10,28,167.0,82,5.7,65,341,2477,9.4,0.4398759
8930,8930,Enver Lisin,2010-11,24.0,5,14,57,57,6,8,14,91.0,637.0,135,24,18,42,258.0,82,5.53,56,304,2486,9.1,0.27495795
8931,8931,Eriah Hayes,2014-15,26.0,2,1,15,15,1,0,1,17.0,118.0,15,1,0,1,17.0,82,5.34,48,269,2463,8.9,0.1832645
8932,8932,Eriah Hayes,2015-16,27.0,3,0,4,4,0,0,0,10.0,40.0,19,1,0,1,27.0,82,5.32,47,251,2453,8.9,0.17177862
8933,8933,Eric Beaudoin,2002-03,22.0,2,4,8,8,1,3,4,11.0,140.0,8,1,3,4,11.0,82,5.24,53,338,2262,9.5,0.2405687
8934,8934,Eric Beaudoin,2003-04,23.0,3,1,15,15,0,1,1,11.0,148.0,23,1,4,5,22.0,82,5.31,60,363,2326,9.4,0.18382311
8935,8935,Eric Beaudoin,2004-05,24.0,4,6,30,30,2,4,6,30.0,309.0,53,3,8,11,52.0,82,5.14,57,348,2300,9.2,0.22335991
8936,8936,Eric Belanger,2001-02,24.0,2,21,62,62,9,12,21,80.0,832.0,62,9,12,21,80.0,82,5.51,63,376,2272,9.9,0.31286544
8937,8937,Eric Belanger,2002-03,25.0,3,24,53,53,8,16,24,67.0,771.0,115,17,28,45,147.0,82,5.24,53,338,2262,9.5,0.36479744
8938,8938,Eric Belanger,2003-04,26.0,4,35,62,62,16,19,35,114.0,1097.0,177,33,47,80,261.0,82,5.31,60,363,2326,9.4,0.4802448
8939,8939,Eric Belanger,2004-05,27.0,5,33,81,81,13,20,33,132.0,1378.0,258,46,67,113,393.0,82,5.14,57,348,2300,9.2,0.55584055
8940,8940,Eric Belanger,2006-07,29.0,6,37,65,65,17,20,37,119.0,1141.0,323,63,87,150,512.0,82,6.05,85,480,2458,10.1,0.46037108
8941,8941,Eric Belanger,2007-08,30.0,7,35,80,80,17,18,35,149.0,1299.0,403,80,105,185,661.0,82,5.76,70,398,2426,9.7,0.42901736
8942,8942,Eric Belanger,2008-09,31.0,8,37,75,75,13,24,37,115.0,1291.0,478,93,129,222,776.0,82,5.44,62,351,2383,9.4,0.43202722
8943,8943,Eric Belanger,2009-10,32.0,9,36,79,79,13,23,36,147.0,1409.0,557,106,152,258,923.0,82,5.7,65,341,2477,9.4,0.3961303
8944,8944,Eric Belanger,2010-11,33.0,10,41,77,77,15,26,41,151.0,1194.0,634,121,178,299,1074.0,82,5.53,56,304,2486,9.1,0.4575792
8945,8945,Eric Belanger,2011-12,34.0,11,40,82,82,13,27,40,127.0,1422.0,716,134,205,339,1201.0,82,5.46,52,291,2492,9.0,0.40751785
8946,8946,Eric Belanger,2012-13,35.0,12,16,78,78,4,12,16,118.0,1149.0,794,138,217,355,1319.0,82,5.32,47,271,2439,8.9,0.22858745
8947,8947,Eric Belanger,2013-14,36.0,13,3,26,26,0,3,3,31.0,367.0,820,138,220,358,1350.0,48,5.31,29,160,1399,9.1,0.19389907
8948,8948,Eric Bertrand,2000-01,25.0,2,0,12,12,0,0,0,12.0,111.0,12,0,0,0,12.0,82,5.49,53,331,2294,9.8,0.17412964
8949,8949,Eric Bertrand,2001-02,26.0,3,0,3,3,0,0,0,0.0,13.0,15,0,0,0,12.0,82,5.51,63,376,2272,9.9,0.13628656
8950,8950,Eric Boguniecki,2000-01,25.0,2,0,4,4,0,0,0,5.0,34.0,4,0,0,0,5.0,82,5.49,53,331,2294,9.8,0.16268289
8951,8951,Eric Boguniecki,2001-02,26.0,3,0,1,1,0,0,0,1.0,14.0,5,0,0,0,6.0,82,5.51,63,376,2272,9.9,0.15367508
8952,8952,Eric Boguniecki,2002-03,27.0,4,1,8,8,0,1,1,10.0,94.0,13,0,1,1,16.0,82,5.24,53,338,2262,9.5,0.19300514
8953,8953,Eric Boguniecki,2003-04,28.0,5,49,80,80,22,27,49,117.0,1121.0,93,22,28,50,133.0,82,5.31,60,363,2326,9.4,0.51579905
8954,8954,Eric Boguniecki,2004-05,29.0,6,10,27,27,6,4,10,40.0,397.0,120,28,32,60,173.0,82,5.14,57,348,2300,9.2,0.30376792
8955,8955,Eric Boguniecki,2006-07,31.0,7,16,47,47,6,10,16,48.0,522.0,167,34,42,76,221.0,82,6.05,85,480,2458,10.1,0.2811168
8956,8956,Eric Boguniecki,2007-08,32.0,8,0,11,11,0,0,0,2.0,54.0,178,34,42,76,223.0,82,5.76,70,398,2426,9.7,0.20470083
8957,8957,Eric Boulton,2001-02,25.0,2,3,35,35,1,2,3,20.0,199.0,35,1,2,3,20.0,82,5.51,63,376,2272,9.9,0.15808746
8958,8958,Eric Boulton,2002-03,26.0,3,5,35,35,2,3,5,21.0,215.0,70,3,5,8,41.0,82,5.24,53,338,2262,9.5,0.17017123
8959,8959,Eric Boulton,2003-04,27.0,4,6,58,58,1,5,6,33.0,382.0,128,4,10,14,74.0,82,5.31,60,363,2326,9.4,0.12852848
8960,8960,Eric Boulton,2004-05,28.0,5,3,44,44,1,2,3,20.0,214.0,172,5,12,17,94.0,82,5.14,57,348,2300,9.2,0.12521127
8961,8961,Eric Boulton,2006-07,30.0,6,9,51,51,4,5,9,28.0,250.0,223,9,17,26,122.0,82,6.05,85,480,2458,10.1,0.09966725
8962,8962,Eric Boulton,2007-08,31.0,7,7,45,45,3,4,7,42.0,282.0,268,12,21,33,164.0,82,5.76,70,398,2426,9.7,0.13161251
8963,8963,Eric Boulton,2008-09,32.0,8,9,74,74,4,5,9,64.0,551.0,342,16,26,42,228.0,82,5.44,62,351,2383,9.4,0.13197306
8964,8964,Eric Boulton,2009-10,33.0,9,13,76,76,3,10,13,71.0,574.0,418,19,36,55,299.0,82,5.7,65,341,2477,9.4,0.15275928
8965,8965,Eric Boulton,2010-11,34.0,10,8,62,62,2,6,8,39.0,425.0,480,21,42,63,338.0,82,5.53,56,304,2486,9.1,0.13730505
8966,8966,Eric Boulton,2011-12,35.0,11,10,69,69,6,4,10,51.0,618.0,549,27,46,73,389.0,82,5.46,52,291,2492,9.0,0.12603033
8967,8967,Eric Boulton,2012-13,36.0,12,0,51,51,0,0,0,25.0,336.0,600,27,46,73,414.0,82,5.32,47,271,2439,8.9,0.08162522
8968,8968,Eric Boulton,2013-14,37.0,13,0,15,15,0,0,0,5.0,85.0,615,27,46,73,419.0,48,5.31,29,160,1399,9.1,0.12284958
8969,8969,Eric Boulton,2014-15,38.0,14,4,23,23,2,2,4,21.0,147.0,638,29,48,77,440.0,82,5.34,48,269,2463,8.9,0.14365429
8970,8970,Eric Boulton,2015-16,39.0,15,2,10,10,2,0,2,9.0,72.0,648,31,48,79,449.0,82,5.32,47,251,2453,8.9,0.14957011
8971,8971,Eric Boulton,2016-17,40.0,16,0,6,6,0,0,0,3.0,57.0,654,31,48,79,452.0,82,5.34,48,255,2438,9.0,0.103762925
8972,8972,Eric Brewer,1999-00,20.0,2,11,63,63,5,6,11,63.0,974.0,63,5,6,11,63.0,82,5.27,57,359,2285,9.4,0.24935693
8973,8973,Eric Brewer,2000-01,21.0,3,2,26,26,0,2,2,30.0,482.0,89,5,8,13,93.0,82,5.49,53,331,2294,9.8,0.23770112
8974,8974,Eric Brewer,2001-02,22.0,4,21,77,77,7,14,21,91.0,1425.0,166,12,22,34,184.0,82,5.51,63,376,2272,9.9,0.30532444
8975,8975,Eric Brewer,2002-03,23.0,5,25,81,81,7,18,25,165.0,1938.0,247,19,40,59,349.0,82,5.24,53,338,2262,9.5,0.4157359
8976,8976,Eric Brewer,2003-04,24.0,6,29,80,80,8,21,29,147.0,1994.0,327,27,61,88,496.0,82,5.31,60,363,2326,9.4,0.3803255
8977,8977,Eric Brewer,2004-05,25.0,7,25,77,77,7,18,25,135.0,1899.0,404,34,79,113,631.0,82,5.14,57,348,2300,9.2,0.3969757
8978,8978,Eric Brewer,2006-07,27.0,8,9,32,32,6,3,9,64.0,751.0,436,40,82,122,695.0,82,6.05,85,480,2458,10.1,0.289451
8979,8979,Eric Brewer,2007-08,28.0,9,29,82,82,6,23,29,111.0,2011.0,518,46,105,151,806.0,82,5.76,70,398,2426,9.7,0.3459533
8980,8980,Eric Brewer,2008-09,29.0,10,22,77,77,1,21,22,101.0,1896.0,595,47,126,173,907.0,82,5.44,62,351,2383,9.4,0.2510109
8981,8981,Eric Brewer,2009-10,30.0,11,6,28,28,1,5,6,49.0,703.0,623,48,131,179,956.0,82,5.7,65,341,2477,9.4,0.24220616
8982,8982,Eric Brewer,2010-11,31.0,12,15,59,59,8,7,15,84.0,1265.0,682,56,138,194,1040.0,82,5.53,56,304,2486,9.1,0.23568726
8983,8983,Eric Brewer,2011-12,32.0,13,16,76,76,9,7,16,110.0,1675.0,758,65,145,210,1150.0,82,5.46,52,291,2492,9.0,0.22961846
8984,8984,Eric Brewer,2012-13,33.0,14,21,82,82,1,20,21,83.0,1908.0,840,66,165,231,1233.0,82,5.32,47,271,2439,8.9,0.22160164
8985,8985,Eric Brewer,2013-14,34.0,15,12,48,48,4,8,12,56.0,985.0,888,70,173,243,1289.0,48,5.31,29,160,1399,9.1,0.20434356
8986,8986,Eric Brewer,2014-15,35.0,16,17,77,77,4,13,17,83.0,1352.0,965,74,186,260,1372.0,82,5.34,48,269,2463,8.9,0.18467411
8987,8987,Eric Brewer,2015-16,36.0,17,11,44,44,3,8,11,33.0,822.0,1009,77,194,271,1405.0,82,5.32,47,251,2453,8.9,0.16353834
8988,8988,Eric Cairns,1997-98,23.0,2,1,40,40,0,1,1,17.0,,40,0,1,1,17.0,82,5.83,55,336,2444,9.8,0.123405874
8989,8989,Eric Cairns,1998-99,24.0,3,3,39,39,0,3,3,17.0,,79,0,4,4,34.0,82,5.28,57,380,2242,9.6,0.1007902
8990,8990,Eric Cairns,1999-00,25.0,4,3,9,9,0,3,3,2.0,92.0,88,0,7,7,36.0,82,5.27,57,359,2285,9.4,0.15377095
8991,8991,Eric Cairns,2000-01,26.0,5,9,67,67,2,7,9,55.0,1187.0,155,2,14,16,91.0,82,5.49,53,331,2294,9.8,0.1397259
8992,8992,Eric Cairns,2001-02,27.0,6,4,45,45,2,2,4,21.0,738.0,200,4,16,20,112.0,82,5.51,63,376,2272,9.9,0.10255417
8993,8993,Eric Cairns,2002-03,28.0,7,7,74,74,2,5,7,34.0,825.0,274,6,21,27,146.0,82,5.24,53,338,2262,9.5,0.1237531
8994,8994,Eric Cairns,2003-04,29.0,8,5,60,60,1,4,5,31.0,710.0,334,7,25,32,177.0,82,5.31,60,363,2326,9.4,0.10515836
8995,8995,Eric Cairns,2004-05,30.0,9,8,72,72,2,6,8,24.0,845.0,406,9,31,40,201.0,82,5.14,57,348,2300,9.2,0.116380155
8996,8996,Eric Cairns,2006-07,32.0,10,2,50,50,1,1,2,19.0,327.0,456,10,32,42,220.0,82,6.05,85,480,2458,10.1,0.07377699
8997,8997,Eric Cairns,2007-08,33.0,11,0,1,1,0,0,0,0.0,1.0,457,10,32,42,220.0,82,5.76,70,398,2426,9.7,0.1353539
8998,8998,Eric Calder,1982-83,19.0,2,0,1,1,0,0,0,0.0,,1,0,0,0,0.0,80,8.03,73,320,2489,12.9,0.25628674
8999,8999,Eric Calder,1983-84,20.0,3,0,1,1,0,0,0,0.0,,2,0,0,0,0.0,80,7.73,71,310,2444,12.7,0.25316358
9000,9000,Eric Charron,1993-94,24.0,2,0,3,3,0,0,0,0.0,,3,0,0,0,0.0,84,7.25,87,443,2603,11.7,0.15629503
9001,9001,Eric Charron,1994-95,25.0,3,0,4,4,0,0,0,1.0,,7,0,0,0,1.0,84,6.48,76,407,2545,10.7,0.15712321
9002,9002,Eric Charron,1995-96,26.0,4,5,45,45,1,4,5,33.0,,52,1,4,5,34.0,48,5.97,37,209,1408,10.2,0.14142013
9003,9003,Eric Charron,1996-97,27.0,5,1,18,18,0,1,1,13.0,,70,1,5,6,47.0,82,6.29,74,413,2481,10.4,0.1432612
9004,9004,Eric Charron,1997-98,28.0,6,2,25,25,1,1,2,11.0,,95,2,6,8,58.0,82,5.83,55,336,2444,9.8,0.109653294
9005,9005,Eric Charron,1998-99,29.0,7,0,2,2,0,0,0,1.0,,97,2,6,8,59.0,82,5.28,57,380,2242,9.6,0.13323313
9006,9006,Eric Charron,1999-00,30.0,8,1,12,12,0,1,1,9.0,165.0,109,2,7,9,68.0,82,5.27,57,359,2285,9.4,0.1464099
9007,9007,Eric Charron,2000-01,31.0,9,0,21,21,0,0,0,8.0,220.0,130,2,7,9,76.0,82,5.49,53,331,2294,9.8,0.07836598
9008,9008,Eric Chouinard,2001-02,21.0,2,4,13,13,1,3,4,11.0,143.0,13,1,3,4,11.0,82,5.51,63,376,2272,9.9,0.24309167
9009,9009,Eric Chouinard,2003-04,23.0,3,8,28,28,4,4,8,45.0,270.0,41,5,7,12,56.0,82,5.31,60,363,2326,9.4,0.26923123
9010,9010,Eric Chouinard,2004-05,24.0,4,10,48,48,6,4,10,60.0,557.0,89,11,11,22,116.0,82,5.14,57,348,2300,9.2,0.27880335
9011,9011,Eric Chouinard,2006-07,26.0,5,0,1,1,0,0,0,0.0,5.0,90,11,11,22,116.0,82,6.05,85,480,2458,10.1,0.17702857
9012,9012,Eric Daze,1995-96,20.0,2,2,4,4,1,1,2,1.0,,4,1,1,2,1.0,48,5.97,37,209,1408,10.2,0.31113255
9013,9013,Eric Daze,1996-97,21.0,3,53,80,80,30,23,53,167.0,,84,31,24,55,168.0,82,6.29,74,413,2481,10.4,0.7055784
9014,9014,Eric Daze,1997-98,22.0,4,41,71,71,22,19,41,176.0,,155,53,43,96,344.0,82,5.83,55,336,2444,9.8,0.58408904
9015,9015,Eric Daze,1998-99,23.0,5,42,80,80,31,11,42,216.0,,235,84,54,138,560.0,82,5.28,57,380,2242,9.6,0.63160175
9016,9016,Eric Daze,1999-00,24.0,6,42,72,72,22,20,42,189.0,1171.0,307,106,74,180,749.0,82,5.27,57,359,2285,9.4,0.6227993
9017,9017,Eric Daze,2000-01,25.0,7,36,59,59,23,13,36,143.0,959.0,366,129,87,216,892.0,82,5.49,53,331,2294,9.8,0.6085792
9018,9018,Eric Daze,2001-02,26.0,8,57,79,79,33,24,57,205.0,1402.0,445,162,111,273,1097.0,82,5.51,63,376,2272,9.9,0.6832694
9019,9019,Eric Daze,2002-03,27.0,9,70,82,82,38,32,70,264.0,1404.0,527,200,143,343,1361.0,82,5.24,53,338,2262,9.5,0.87911797
9020,9020,Eric Daze,2003-04,28.0,10,44,54,54,22,22,44,170.0,879.0,581,222,165,387,1531.0,82,5.31,60,363,2326,9.4,0.7024935
9021,9021,Eric Daze,2004-05,29.0,11,11,19,19,4,7,11,76.0,360.0,600,226,172,398,1607.0,82,5.14,57,348,2300,9.2,0.34366372
9022,9022,Eric Daze,2006-07,31.0,12,0,1,1,0,0,0,0.0,12.0,601,226,172,398,1607.0,82,6.05,85,480,2458,10.1,0.39859486
9023,9023,Eric Desjardins,1989-90,20.0,2,14,36,36,2,12,14,39.0,,36,2,12,14,39.0,80,7.48,85,403,2430,12.3,0.33560467
9024,9024,Eric Desjardins,1990-91,21.0,3,16,55,55,3,13,16,48.0,,91,5,25,30,87.0,80,7.37,76,367,2421,12.2,0.32756737
9025,9025,Eric Desjardins,1991-92,22.0,4,25,62,62,7,18,25,114.0,,153,12,43,55,201.0,80,6.91,71,366,2385,11.6,0.4249797
9026,9026,Eric Desjardins,1992-93,23.0,5,38,77,77,6,32,38,141.0,,230,18,75,93,342.0,80,6.96,77,402,2440,11.4,0.48026994
9027,9027,Eric Desjardins,1993-94,24.0,6,45,82,82,13,32,45,163.0,,312,31,107,138,505.0,84,7.25,87,443,2603,11.7,0.5419714
9028,9028,Eric Desjardins,1994-95,25.0,7,35,84,84,12,23,35,193.0,,396,43,130,173,698.0,84,6.48,76,407,2545,10.7,0.5033814
9029,9029,Eric Desjardins,1995-96,26.0,8,29,43,43,5,24,29,93.0,,439,48,154,202,791.0,48,5.97,37,209,1408,10.2,0.58636546
9030,9030,Eric Desjardins,1996-97,27.0,9,47,80,80,7,40,47,184.0,,519,55,194,249,975.0,82,6.29,74,413,2481,10.4,0.5687436
9031,9031,Eric Desjardins,1997-98,28.0,10,46,82,82,12,34,46,183.0,,601,67,228,295,1158.0,82,5.83,55,336,2444,9.8,0.5638762
9032,9032,Eric Desjardins,1998-99,29.0,11,33,77,77,6,27,33,150.0,,678,73,255,328,1308.0,82,5.28,57,380,2242,9.6,0.42606896
9033,9033,Eric Desjardins,1999-00,30.0,12,51,68,68,15,36,51,190.0,1754.0,746,88,291,379,1498.0,82,5.27,57,359,2285,9.4,0.6563221
9034,9034,Eric Desjardins,2000-01,31.0,13,55,81,81,14,41,55,207.0,2188.0,827,102,332,434,1705.0,82,5.49,53,331,2294,9.8,0.6605227
9035,9035,Eric Desjardins,2001-02,32.0,14,48,79,79,15,33,48,187.0,2089.0,906,117,365,482,1892.0,82,5.51,63,376,2272,9.9,0.5326322
9036,9036,Eric Desjardins,2002-03,33.0,15,25,65,65,6,19,25,117.0,1443.0,971,123,384,507,2009.0,82,5.24,53,338,2262,9.5,0.3203805
9037,9037,Eric Desjardins,2003-04,34.0,16,32,79,79,8,24,32,197.0,1810.0,1050,131,408,539,2206.0,82,5.31,60,363,2326,9.4,0.41423348
9038,9038,Eric Desjardins,2004-05,35.0,17,12,48,48,1,11,12,92.0,1079.0,1098,132,419,551,2298.0,82,5.14,57,348,2300,9.2,0.36829334
9039,9039,Eric Desjardins,2006-07,37.0,18,24,45,45,4,20,24,88.0,1062.0,1143,136,439,575,2386.0,82,6.05,85,480,2458,10.1,0.3666612
9040,9040,Eric Fehr,2006-07,21.0,2,0,11,11,0,0,0,10.0,63.0,11,0,0,0,10.0,82,6.05,85,480,2458,10.1,0.20006272
9041,9041,Eric Fehr,2007-08,22.0,3,3,14,14,2,1,3,25.0,150.0,25,2,1,3,35.0,82,5.76,70,398,2426,9.7,0.27136356
9042,9042,Eric Fehr,2008-09,23.0,4,6,23,23,1,5,6,40.0,242.0,48,3,6,9,75.0,82,5.44,62,351,2383,9.4,0.26241848
9043,9043,Eric Fehr,2009-10,24.0,5,25,61,61,12,13,25,134.0,686.0,109,15,19,34,209.0,82,5.7,65,341,2477,9.4,0.43154272
9044,9044,Eric Fehr,2010-11,25.0,6,39,69,69,21,18,39,145.0,837.0,178,36,37,73,354.0,82,5.53,56,304,2486,9.1,0.52818435
9045,9045,Eric Fehr,2011-12,26.0,7,20,52,52,10,10,20,120.0,655.0,230,46,47,93,474.0,82,5.46,52,291,2492,9.0,0.37669924
9046,9046,Eric Fehr,2012-13,27.0,8,3,35,35,2,1,3,54.0,339.0,265,48,48,96,528.0,82,5.32,47,271,2439,8.9,0.23722264
9047,9047,Eric Fehr,2013-14,28.0,9,17,41,41,9,8,17,72.0,548.0,306,57,56,113,600.0,48,5.31,29,160,1399,9.1,0.35367948
9048,9048,Eric Fehr,2014-15,29.0,10,31,73,73,13,18,31,137.0,1077.0,379,70,74,144,737.0,82,5.34,48,269,2463,8.9,0.36990106
9049,9049,Eric Fehr,2015-16,30.0,11,33,75,75,19,14,33,142.0,1114.0,454,89,88,177,879.0,82,5.32,47,251,2453,8.9,0.37725088
9050,9050,Eric Fehr,2016-17,31.0,12,14,55,55,8,6,14,74.0,718.0,509,97,94,191,953.0,82,5.34,48,255,2438,9.0,0.24723929
9051,9051,Eric Fehr,2017-18,32.0,13,11,53,53,6,5,11,62.0,579.0,562,103,99,202,1015.0,82,5.45,47,245,2478,9.0,0.21336862
9052,9052,Eric Fehr,2018-19,33.0,14,4,18,18,3,1,4,27.0,212.0,580,106,100,206,1042.0,82,5.86,50,250,2620,9.2,0.23490238
9053,9053,Eric Fehr,2019-20,34.0,15,15,72,72,7,8,15,67.0,795.0,652,113,108,221,1109.0,82,5.96,47,239,2579,9.5,0.17388955
9054,9054,Eric Gelinas,2013-14,22.0,2,0,1,1,0,0,0,1.0,16.0,1,0,0,0,1.0,48,5.31,29,160,1399,9.1,0.19732639
9055,9055,Eric Gelinas,2014-15,23.0,3,29,60,60,7,22,29,124.0,1015.0,61,7,22,29,125.0,82,5.34,48,269,2463,8.9,0.46073532
9056,9056,Eric Gelinas,2015-16,24.0,4,19,61,61,6,13,19,112.0,1004.0,122,13,35,48,237.0,82,5.32,47,251,2453,8.9,0.32210615
9057,9057,Eric Gelinas,2016-17,25.0,5,6,40,40,1,5,6,55.0,553.0,162,14,40,54,292.0,82,5.34,48,255,2438,9.0,0.20009652
9058,9058,Eric Gelinas,2017-18,26.0,6,1,27,27,0,1,1,29.0,313.0,189,14,41,55,321.0,82,5.45,47,245,2478,9.0,0.1722956
9059,9059,Eric Germain,1988-89,22.0,2,1,4,4,0,1,1,2.0,,4,0,1,1,2.0,80,7.43,89,437,2435,12.2,0.23997626
9060,9060,Eric Godard,2003-04,23.0,2,0,19,19,0,0,0,6.0,86.0,19,0,0,0,6.0,82,5.31,60,363,2326,9.4,0.12096414
9061,9061,Eric Godard,2004-05,24.0,3,1,31,31,0,1,1,5.0,117.0,50,0,1,1,11.0,82,5.14,57,348,2300,9.2,0.11082327
9062,9062,Eric Godard,2006-07,26.0,4,4,57,57,2,2,4,17.0,203.0,107,2,3,5,28.0,82,6.05,85,480,2458,10.1,0.09828591
9063,9063,Eric Godard,2007-08,27.0,5,1,19,19,0,1,1,3.0,72.0,126,2,4,6,31.0,82,5.76,70,398,2426,9.7,0.07141751
9064,9064,Eric Godard,2008-09,28.0,6,2,74,74,1,1,2,14.0,349.0,200,3,5,8,45.0,82,5.44,62,351,2383,9.4,0.074529946
9065,9065,Eric Godard,2009-10,29.0,7,4,71,71,2,2,4,20.0,289.0,271,5,7,12,65.0,82,5.7,65,341,2477,9.4,0.09265825
9066,9066,Eric Godard,2010-11,30.0,8,3,45,45,1,2,3,17.0,188.0,316,6,9,15,82.0,82,5.53,56,304,2486,9.1,0.076314986
9067,9067,Eric Godard,2011-12,31.0,9,3,19,19,0,3,3,1.0,98.0,335,6,12,18,83.0,82,5.46,52,291,2492,9.0,0.079999804
9068,9068,Eric Gryba,2013-14,25.0,2,6,33,33,2,4,6,51.0,669.0,33,2,4,6,51.0,48,5.31,29,160,1399,9.1,0.25101292
9069,9069,Eric Gryba,2014-15,26.0,3,11,57,57,2,9,11,57.0,999.0,90,4,13,17,108.0,82,5.34,48,269,2463,8.9,0.19641513
9070,9070,Eric Gryba,2015-16,27.0,4,12,75,75,0,12,12,64.0,1174.0,165,4,25,29,172.0,82,5.32,47,251,2453,8.9,0.13879728
9071,9071,Eric Gryba,2016-17,28.0,5,6,53,53,1,5,6,58.0,948.0,218,5,30,35,230.0,82,5.34,48,255,2438,9.0,0.14229688
9072,9072,Eric Gryba,2017-18,29.0,6,6,40,40,2,4,6,45.0,646.0,258,7,34,41,275.0,82,5.45,47,245,2478,9.0,0.15670395
9073,9073,Eric Gryba,2018-19,30.0,7,2,21,21,0,2,2,19.0,309.0,279,7,36,43,294.0,82,5.86,50,250,2620,9.2,0.10531697
9074,9074,Eric Gryba,2019-20,31.0,8,0,10,10,0,0,0,11.0,153.0,289,7,36,43,305.0,82,5.96,47,239,2579,9.5,0.13465723
9075,9075,Eric Healey,2006-07,32.0,2,0,2,2,0,0,0,1.0,17.0,2,0,0,0,1.0,82,6.05,85,480,2458,10.1,0.14503872
9076,9076,Eric Houde,1997-98,21.0,2,2,13,13,0,2,2,1.0,,13,0,2,2,1.0,82,5.83,55,336,2444,9.8,0.2061199
9077,9077,Eric Houde,1998-99,22.0,3,1,9,9,1,0,1,4.0,,22,1,2,3,5.0,82,5.28,57,380,2242,9.6,0.20375547
9078,9078,Eric Houde,1999-00,23.0,4,2,8,8,1,1,2,4.0,57.0,30,2,3,5,9.0,82,5.27,57,359,2285,9.4,0.21775559
9079,9079,Eric Lacroix,1994-95,23.0,2,0,3,3,0,0,0,3.0,,3,0,0,0,3.0,84,6.48,76,407,2545,10.7,0.18269011
9080,9080,Eric Lacroix,1995-96,24.0,3,16,45,45,9,7,16,64.0,,48,9,7,16,67.0,48,5.97,37,209,1408,10.2,0.35750896
9081,9081,Eric Lacroix,1996-97,25.0,4,32,72,72,16,16,32,107.0,,120,25,23,48,174.0,82,6.29,74,413,2481,10.4,0.41796404
9082,9082,Eric Lacroix,1997-98,26.0,5,36,81,81,18,18,36,141.0,,201,43,41,84,315.0,82,5.83,55,336,2444,9.8,0.4330302
9083,9083,Eric Lacroix,1998-99,27.0,6,31,82,82,16,15,31,126.0,,283,59,56,115,441.0,82,5.28,57,380,2242,9.6,0.41412944
9084,9084,Eric Lacroix,1999-00,28.0,7,4,64,64,2,2,4,38.0,439.0,347,61,58,119,479.0,82,5.27,57,359,2285,9.4,0.21260941
9085,9085,Eric Lacroix,2000-01,29.0,8,12,70,70,4,8,12,46.0,702.0,417,65,66,131,525.0,82,5.49,53,331,2294,9.8,0.19899824
9086,9086,Eric Lacroix,2001-02,30.0,9,6,55,55,2,4,6,32.0,363.0,472,67,70,137,557.0,82,5.51,63,376,2272,9.9,0.17312568
9087,9087,Eric Landry,1998-99,24.0,2,1,12,12,1,0,1,7.0,,12,1,0,1,7.0,82,5.28,57,380,2242,9.6,0.18927431
9088,9088,Eric Landry,1999-00,25.0,3,1,3,3,0,1,1,1.0,30.0,15,1,1,2,8.0,82,5.27,57,359,2285,9.4,0.17124009
9089,9089,Eric Landry,2001-02,27.0,4,11,51,51,4,7,11,54.0,475.0,66,5,8,13,62.0,82,5.51,63,376,2272,9.9,0.19434181
9090,9090,Eric Landry,2002-03,28.0,5,1,2,2,0,1,1,0.0,15.0,68,5,9,14,62.0,82,5.24,53,338,2262,9.5,0.15652692
9091,9091,Eric Lavigne,1995-96,23.0,2,0,1,1,0,0,0,0.0,,1,0,0,0,0.0,48,5.97,37,209,1408,10.2,0.19166964
9092,9092,Eric Lindros,1993-94,20.0,2,75,61,61,41,34,75,180.0,,61,41,34,75,180.0,84,7.25,87,443,2603,11.7,1.1134462
9093,9093,Eric Lindros,1994-95,21.0,3,97,65,65,44,53,97,197.0,,126,85,87,172,377.0,84,6.48,76,407,2545,10.7,1.4089068
9094,9094,Eric Lindros,1995-96,22.0,4,70,46,46,29,41,70,144.0,,172,114,128,242,521.0,48,5.97,37,209,1408,10.2,1.498028
9095,9095,Eric Lindros,1996-97,23.0,5,115,73,73,47,68,115,294.0,,245,161,196,357,815.0,82,6.29,74,413,2481,10.4,1.3116881
9096,9096,Eric Lindros,1997-98,24.0,6,79,52,52,32,47,79,198.0,,297,193,243,436,1013.0,82,5.83,55,336,2444,9.8,1.2341703
9097,9097,Eric Lindros,1998-99,25.0,7,71,63,63,30,41,71,202.0,,360,223,284,507,1215.0,82,5.28,57,380,2242,9.6,1.2753463
9098,9098,Eric Lindros,1999-00,26.0,8,93,71,71,40,53,93,242.0,1628.0,431,263,337,600,1457.0,82,5.27,57,359,2285,9.4,1.142559
9099,9099,Eric Lindros,2000-01,27.0,9,59,55,55,27,32,59,187.0,1212.0,486,290,369,659,1644.0,82,5.49,53,331,2294,9.8,1.109451
9100,9100,Eric Lindros,2002-03,29.0,10,73,72,72,37,36,73,196.0,1516.0,558,327,405,732,1840.0,82,5.24,53,338,2262,9.5,0.94840384
9101,9101,Eric Lindros,2003-04,30.0,11,53,81,81,19,34,53,235.0,1640.0,639,346,439,785,2075.0,82,5.31,60,363,2326,9.4,0.74020374
9102,9102,Eric Lindros,2004-05,31.0,12,32,39,39,10,22,32,83.0,623.0,678,356,461,817,2158.0,82,5.14,57,348,2300,9.2,0.7477769
9103,9103,Eric Lindros,2006-07,33.0,13,22,33,33,11,11,22,59.0,574.0,711,367,472,839,2217.0,82,6.05,85,480,2458,10.1,0.55295056
9104,9104,Eric Lindros,2007-08,34.0,14,26,49,49,5,21,26,95.0,718.0,760,372,493,865,2312.0,82,5.76,70,398,2426,9.7,0.505766
9105,9105,Eric Manlow,2001-02,26.0,2,1,8,8,0,1,1,3.0,59.0,8,0,1,1,3.0,82,5.51,63,376,2272,9.9,0.16610667
9106,9106,Eric Manlow,2002-03,27.0,3,0,3,3,0,0,0,2.0,18.0,11,0,1,1,5.0,82,5.24,53,338,2262,9.5,0.16829216
9107,9107,Eric Manlow,2003-04,28.0,4,3,8,8,2,1,3,7.0,100.0,19,2,2,4,12.0,82,5.31,60,363,2326,9.4,0.2084342
9108,9108,Eric Manlow,2004-05,29.0,5,2,18,18,0,2,2,10.0,184.0,37,2,4,6,22.0,82,5.14,57,348,2300,9.2,0.17101225
9109,9109,Eric Meloche,2002-03,26.0,2,1,23,23,0,1,1,29.0,234.0,23,0,1,1,29.0,82,5.24,53,338,2262,9.5,0.17585099
9110,9110,Eric Meloche,2003-04,27.0,3,6,13,13,5,1,6,34.0,219.0,36,5,2,7,63.0,82,5.31,60,363,2326,9.4,0.27148744
9111,9111,Eric Meloche,2004-05,28.0,4,10,25,25,3,7,10,28.0,370.0,61,8,9,17,91.0,82,5.14,57,348,2300,9.2,0.2670669
9112,9112,Eric Meloche,2007-08,31.0,5,3,13,13,1,2,3,12.0,109.0,74,9,11,20,103.0,82,5.76,70,398,2426,9.7,0.20511392
9113,9113,Eric Messier,1997-98,24.0,2,0,21,21,0,0,0,11.0,,21,0,0,0,11.0,82,5.83,55,336,2444,9.8,0.11251289
9114,9114,Eric Messier,1998-99,25.0,3,16,62,62,4,12,16,66.0,,83,4,12,16,77.0,82,5.28,57,380,2242,9.6,0.22918987
9115,9115,Eric Messier,1999-00,26.0,4,6,31,31,4,2,6,30.0,425.0,114,8,14,22,107.0,82,5.27,57,359,2285,9.4,0.24085164
9116,9116,Eric Messier,2000-01,27.0,5,9,61,61,3,6,9,28.0,637.0,175,11,20,31,135.0,82,5.49,53,331,2294,9.8,0.10864067
9117,9117,Eric Messier,2001-02,28.0,6,12,64,64,5,7,12,60.0,786.0,239,16,27,43,195.0,82,5.51,63,376,2272,9.9,0.17633343
9118,9118,Eric Messier,2002-03,29.0,7,15,74,74,5,10,15,84.0,1128.0,313,21,37,58,279.0,82,5.24,53,338,2262,9.5,0.20317668
9119,9119,Eric Messier,2003-04,30.0,8,14,72,72,4,10,14,52.0,888.0,385,25,47,72,331.0,82,5.31,60,363,2326,9.4,0.16531372
9120,9120,Eric Messier,2004-05,31.0,9,3,21,21,0,3,3,13.0,237.0,406,25,50,75,344.0,82,5.14,57,348,2300,9.2,0.14840457
9121,9121,Eric Nickulas,1999-00,24.0,2,0,2,2,0,0,0,0.0,7.0,2,0,0,0,0.0,82,5.27,57,359,2285,9.4,0.16840222
9122,9122,Eric Nickulas,2000-01,25.0,3,11,20,20,5,6,11,28.0,224.0,22,5,6,11,28.0,82,5.49,53,331,2294,9.8,0.27308595
9123,9123,Eric Nickulas,2001-02,26.0,4,0,7,7,0,0,0,6.0,50.0,29,5,6,11,34.0,82,5.51,63,376,2272,9.9,0.17227966
9124,9124,Eric Nickulas,2003-04,28.0,5,1,8,8,0,1,1,3.0,76.0,37,5,7,12,37.0,82,5.31,60,363,2326,9.4,0.14988914
9125,9125,Eric Nickulas,2004-05,29.0,6,20,65,65,8,12,20,121.0,854.0,102,13,19,32,158.0,82,5.14,57,348,2300,9.2,0.3116724
9126,9126,Eric Nickulas,2006-07,31.0,7,6,16,16,2,4,6,14.0,130.0,118,15,23,38,172.0,82,6.05,85,480,2458,10.1,0.21457067
9127,9127,Eric Nystrom,2006-07,23.0,2,0,2,2,0,0,0,0.0,24.0,2,0,0,0,0.0,82,6.05,85,480,2458,10.1,0.15705729
9128,9128,Eric Nystrom,2008-09,25.0,3,10,44,44,3,7,10,42.0,506.0,46,3,7,10,42.0,82,5.44,62,351,2383,9.4,0.19393519
9129,9129,Eric Nystrom,2009-10,26.0,4,10,76,76,5,5,10,83.0,704.0,122,8,12,20,125.0,82,5.7,65,341,2477,9.4,0.20015886
9130,9130,Eric Nystrom,2010-11,27.0,5,19,82,82,11,8,19,91.0,1080.0,204,19,20,39,216.0,82,5.53,56,304,2486,9.1,0.24316597
9131,9131,Eric Nystrom,2011-12,28.0,6,12,82,82,4,8,12,83.0,1091.0,286,23,28,51,299.0,82,5.46,52,291,2492,9.0,0.18194154
9132,9132,Eric Nystrom,2012-13,29.0,7,21,74,74,16,5,21,102.0,1017.0,360,39,33,72,401.0,82,5.32,47,271,2439,8.9,0.28295407
9133,9133,Eric Nystrom,2013-14,30.0,8,11,48,48,7,4,11,49.0,689.0,408,46,37,83,450.0,48,5.31,29,160,1399,9.1,0.24166927
9134,9134,Eric Nystrom,2014-15,31.0,9,21,79,79,15,6,21,120.0,1174.0,487,61,43,104,570.0,82,5.34,48,269,2463,8.9,0.279056
9135,9135,Eric Nystrom,2015-16,32.0,10,12,60,60,7,5,12,60.0,792.0,547,68,48,116,630.0,82,5.32,47,251,2453,8.9,0.19170004
9136,9136,Eric Nystrom,2016-17,33.0,11,7,46,46,7,0,7,27.0,528.0,593,75,48,123,657.0,82,5.34,48,255,2438,9.0,0.14530948
9137,9137,Eric O'Dell,2014-15,24.0,2,7,30,30,3,4,7,17.0,291.0,30,3,4,7,17.0,82,5.34,48,269,2463,8.9,0.21137053
9138,9138,Eric O'Dell,2015-16,25.0,3,1,11,11,0,1,1,6.0,82.0,41,3,5,8,23.0,82,5.32,47,251,2453,8.9,0.14842865
9139,9139,Eric Perrin,2004-05,29.0,2,0,4,4,0,0,0,3.0,34.0,4,0,0,0,3.0,82,5.14,57,348,2300,9.2,0.19969288
9140,9140,Eric Perrin,2007-08,32.0,3,36,82,82,13,23,36,151.0,1394.0,86,13,23,36,154.0,82,5.76,70,398,2426,9.7,0.41758096
9141,9141,Eric Perrin,2008-09,33.0,4,45,81,81,12,33,45,121.0,1444.0,167,25,56,81,275.0,82,5.44,62,351,2383,9.4,0.46402135
9142,9142,Eric Perrin,2009-10,34.0,5,23,78,78,7,16,23,109.0,1106.0,245,32,72,104,384.0,82,5.7,65,341,2477,9.4,0.28161037
9143,9143,Eric Robinson,2018-19,23.0,2,0,1,1,0,0,0,2.0,11.0,1,0,0,0,2.0,82,5.86,50,250,2620,9.2,0.17507556
9144,9144,Eric Robinson,2019-20,24.0,3,0,13,13,0,0,0,18.0,154.0,14,0,0,0,20.0,82,5.96,47,239,2579,9.5,0.17199564
9145,9145,Eric Robinson,2020-21,25.0,4,12,50,50,7,5,12,69.0,548.0,64,7,5,12,89.0,70,5.96,42,208,2192,9.5,0.27921963
9146,9146,Eric Selleck,2013-14,26.0,2,1,2,2,0,1,1,2.0,16.0,2,0,1,1,2.0,48,5.31,29,160,1399,9.1,0.21147704
9147,9147,Eric Selleck,2016-17,29.0,3,0,1,1,0,0,0,1.0,10.0,3,0,1,1,3.0,82,5.34,48,255,2438,9.0,0.14542595
9148,9148,Eric Staal,2004-05,20.0,2,31,81,81,11,20,31,164.0,1350.0,81,11,20,31,164.0,82,5.14,57,348,2300,9.2,0.77092636
9149,9149,Eric Staal,2006-07,22.0,3,100,82,82,45,55,100,279.0,1611.0,163,56,75,131,443.0,82,6.05,85,480,2458,10.1,1.1015633
9150,9150,Eric Staal,2007-08,23.0,4,70,82,82,30,40,70,288.0,1650.0,245,86,115,201,731.0,82,5.76,70,398,2426,9.7,0.90626323
9151,9151,Eric Staal,2008-09,24.0,5,82,82,82,38,44,82,310.0,1774.0,327,124,159,283,1041.0,82,5.44,62,351,2383,9.4,0.9937495
9152,9152,Eric Staal,2009-10,25.0,6,75,82,82,40,35,75,372.0,1726.0,409,164,194,358,1413.0,82,5.7,65,341,2477,9.4,0.922928
9153,9153,Eric Staal,2010-11,26.0,7,70,70,70,29,41,70,277.0,1450.0,479,193,235,428,1690.0,82,5.53,56,304,2486,9.1,0.98687077
9154,9154,Eric Staal,2011-12,27.0,8,76,81,81,33,43,76,296.0,1777.0,560,226,278,504,1986.0,82,5.46,52,291,2492,9.0,0.85859025
9155,9155,Eric Staal,2012-13,28.0,9,70,82,82,24,46,70,262.0,1767.0,642,250,324,574,2248.0,82,5.32,47,271,2439,8.9,0.8741044
9156,9156,Eric Staal,2013-14,29.0,10,53,48,48,18,35,53,152.0,1008.0,690,268,359,627,2400.0,48,5.31,29,160,1399,9.1,0.9878912
9157,9157,Eric Staal,2014-15,30.0,11,61,79,79,21,40,61,230.0,1603.0,769,289,399,688,2630.0,82,5.34,48,269,2463,8.9,0.74253607
9158,9158,Eric Staal,2015-16,31.0,12,54,77,77,23,31,54,244.0,1451.0,846,312,430,742,2874.0,82,5.32,47,251,2453,8.9,0.6325952
9159,9159,Eric Staal,2016-17,32.0,13,39,83,83,13,26,39,199.0,1540.0,929,325,456,781,3073.0,82,5.34,48,255,2438,9.0,0.56481147
9160,9160,Eric Staal,2017-18,33.0,14,65,82,82,28,37,65,211.0,1526.0,1011,353,493,846,3284.0,82,5.45,47,245,2478,9.0,0.8131264
9161,9161,Eric Staal,2018-19,34.0,15,76,82,82,42,34,76,241.0,1461.0,1093,395,527,922,3525.0,82,5.86,50,250,2620,9.2,0.78663856
9162,9162,Eric Staal,2019-20,35.0,16,52,81,81,22,30,52,215.0,1468.0,1174,417,557,974,3740.0,82,5.96,47,239,2579,9.5,0.62009364
9163,9163,Eric Staal,2020-21,36.0,17,47,66,66,19,28,47,113.0,1131.0,1240,436,585,1021,3853.0,70,5.96,42,208,2192,9.5,0.5999444
9164,9164,Eric Tangradi,2010-11,21.0,2,0,1,1,0,0,0,3.0,14.0,1,0,0,0,3.0,82,5.53,56,304,2486,9.1,0.2152408
9165,9165,Eric Tangradi,2011-12,22.0,3,3,15,15,1,2,3,18.0,168.0,16,1,2,3,21.0,82,5.46,52,291,2492,9.0,0.21263075
9166,9166,Eric Tangradi,2012-13,23.0,4,2,24,24,0,2,2,20.0,215.0,40,1,4,5,41.0,82,5.32,47,271,2439,8.9,0.16493446
9167,9167,Eric Tangradi,2013-14,24.0,5,4,41,41,1,3,4,48.0,413.0,81,2,7,9,89.0,48,5.31,29,160,1399,9.1,0.19677764
9168,9168,Eric Tangradi,2014-15,25.0,6,6,55,55,3,3,6,52.0,475.0,136,5,10,15,141.0,82,5.34,48,269,2463,8.9,0.14463887
9169,9169,Eric Tangradi,2015-16,26.0,7,0,7,7,0,0,0,5.0,54.0,143,5,10,15,146.0,82,5.32,47,251,2453,8.9,0.13152671
9170,9170,Eric Tangradi,2016-17,27.0,8,0,1,1,0,0,0,0.0,7.0,144,5,10,15,146.0,82,5.34,48,255,2438,9.0,0.13109633
9171,9171,Eric Tangradi,2019-20,30.0,9,1,6,6,0,1,1,10.0,83.0,150,5,11,16,156.0,82,5.96,47,239,2579,9.5,0.12414628
9172,9172,Eric Weinrich,1989-90,23.0,2,0,2,2,0,0,0,3.0,,2,0,0,0,3.0,80,7.48,85,403,2430,12.3,0.22346655
9173,9173,Eric Weinrich,1990-91,24.0,3,9,19,19,2,7,9,16.0,,21,2,7,9,19.0,80,7.37,76,367,2421,12.2,0.28346118
9174,9174,Eric Weinrich,1991-92,25.0,4,38,76,76,4,34,38,96.0,,97,6,41,47,115.0,80,6.91,71,366,2385,11.6,0.45949668
9175,9175,Eric Weinrich,1992-93,26.0,5,32,76,76,7,25,32,97.0,,173,13,66,79,212.0,80,6.96,77,402,2440,11.4,0.41504812
9176,9176,Eric Weinrich,1993-94,27.0,6,36,79,79,7,29,36,104.0,,252,20,95,115,316.0,84,7.25,87,443,2603,11.7,0.4396187
9177,9177,Eric Weinrich,1994-95,28.0,7,28,62,62,4,24,28,115.0,,314,24,119,143,431.0,84,6.48,76,407,2545,10.7,0.4150072
9178,9178,Eric Weinrich,1995-96,29.0,8,13,48,48,3,10,13,50.0,,362,27,129,156,481.0,48,5.97,37,209,1408,10.2,0.28200686
9179,9179,Eric Weinrich,1996-97,30.0,9,15,77,77,5,10,15,76.0,,439,32,139,171,557.0,82,6.29,74,413,2481,10.4,0.23876512
9180,9180,Eric Weinrich,1997-98,31.0,10,32,81,81,7,25,32,115.0,,520,39,164,203,672.0,82,5.83,55,336,2444,9.8,0.35297838
9181,9181,Eric Weinrich,1998-99,32.0,11,23,82,82,2,21,23,85.0,,602,41,185,226,757.0,82,5.28,57,380,2242,9.6,0.23909083
9182,9182,Eric Weinrich,1999-00,33.0,12,22,80,80,7,15,22,119.0,1915.0,682,48,200,248,876.0,82,5.27,57,359,2285,9.4,0.26116008
9183,9183,Eric Weinrich,2000-01,34.0,13,29,77,77,4,25,29,120.0,1952.0,759,52,225,277,996.0,82,5.49,53,331,2294,9.8,0.30761072
9184,9184,Eric Weinrich,2001-02,35.0,14,31,82,82,7,24,31,109.0,2036.0,841,59,249,308,1105.0,82,5.51,63,376,2272,9.9,0.30713725
9185,9185,Eric Weinrich,2002-03,36.0,15,24,80,80,4,20,24,102.0,1750.0,921,63,269,332,1207.0,82,5.24,53,338,2262,9.5,0.2362217
9186,9186,Eric Weinrich,2003-04,37.0,16,20,81,81,2,18,20,103.0,1733.0,1002,65,287,352,1310.0,82,5.31,60,363,2326,9.4,0.23864532
9187,9187,Eric Weinrich,2004-05,38.0,17,19,80,80,4,15,19,83.0,1723.0,1082,69,302,371,1393.0,82,5.14,57,348,2300,9.2,0.23516273
9188,9188,Eric Weinrich,2006-07,40.0,18,17,75,75,1,16,17,68.0,1612.0,1157,70,318,388,1461.0,82,6.05,85,480,2458,10.1,0.15890738
9189,9189,Eric Wellwood,2011-12,21.0,2,1,3,3,0,1,1,8.0,40.0,3,0,1,1,8.0,82,5.46,52,291,2492,9.0,0.2532974
9190,9190,Eric Wellwood,2012-13,22.0,3,9,24,24,5,4,9,36.0,263.0,27,5,5,10,44.0,82,5.32,47,271,2439,8.9,0.3075152
9191,9191,Eric Wellwood,2013-14,23.0,4,0,4,4,0,0,0,2.0,38.0,31,5,5,10,46.0,48,5.31,29,160,1399,9.1,0.20572218
9192,9192,Erich Goldmann,2000-01,24.0,2,0,1,1,0,0,0,0.0,10.0,1,0,0,0,0.0,82,5.49,53,331,2294,9.8,0.15586606
9193,9193,Erik Andersson,1998-99,27.0,2,3,12,12,2,1,3,11.0,,12,2,1,3,11.0,82,5.28,57,380,2242,9.6,0.23536983
9194,9194,Erik Brannstrom,2019-20,20.0,2,0,2,2,0,0,0,0.0,36.0,2,0,0,0,0.0,82,5.96,47,239,2579,9.5,0.2670741
9195,9195,Erik Brannstrom,2020-21,21.0,3,4,31,31,0,4,4,38.0,460.0,33,0,4,4,38.0,70,5.96,42,208,2192,9.5,0.21783647
9196,9196,Erik Burgdoerfer,2017-18,29.0,2,0,2,2,0,0,0,2.0,22.0,2,0,0,0,2.0,82,5.45,47,245,2478,9.0,0.17871994
9197,9197,Erik Burgdoerfer,2018-19,30.0,3,1,2,2,0,1,1,2.0,27.0,4,0,1,1,4.0,82,5.86,50,250,2620,9.2,0.15169767
9198,9198,Erik Burgdoerfer,2019-20,31.0,4,0,4,4,0,0,0,2.0,43.0,8,0,1,1,6.0,82,5.96,47,239,2579,9.5,0.1728645
9199,9199,Erik Cernak,2019-20,22.0,2,16,58,58,5,11,16,107.0,1117.0,58,5,11,16,107.0,82,5.96,47,239,2579,9.5,0.32478052
9200,9200,Erik Cernak,2020-21,23.0,3,12,67,67,5,7,12,125.0,1270.0,125,10,18,28,232.0,70,5.96,42,208,2192,9.5,0.28309828
9201,9201,Erik Christensen,2006-07,23.0,2,13,33,33,6,7,13,85.0,471.0,33,6,7,13,85.0,82,6.05,85,480,2458,10.1,0.3645199
9202,9202,Erik Christensen,2007-08,24.0,3,33,61,61,18,15,33,133.0,709.0,94,24,22,46,218.0,82,5.76,70,398,2426,9.7,0.5149568
9203,9203,Erik Christensen,2008-09,25.0,4,24,59,59,11,13,24,132.0,788.0,153,35,35,70,350.0,82,5.44,62,351,2383,9.4,0.45178446
9204,9204,Erik Christensen,2009-10,26.0,5,28,64,64,7,21,28,122.0,873.0,217,42,56,98,472.0,82,5.7,65,341,2477,9.4,0.4386037
9205,9205,Erik Christensen,2010-11,27.0,6,26,58,58,8,18,26,86.0,861.0,275,50,74,124,558.0,82,5.53,56,304,2486,9.1,0.3409288
9206,9206,Erik Christensen,2011-12,28.0,7,27,63,63,11,16,27,86.0,804.0,338,61,90,151,644.0,82,5.46,52,291,2492,9.0,0.36384016
9207,9207,Erik Christensen,2012-13,29.0,8,12,49,49,7,5,12,44.0,510.0,387,68,95,163,688.0,82,5.32,47,271,2439,8.9,0.27953476
9208,9208,Erik Cole,2002-03,24.0,2,40,81,81,16,24,40,159.0,1301.0,81,16,24,40,159.0,82,5.24,53,338,2262,9.5,0.51074076
9209,9209,Erik Cole,2003-04,25.0,3,27,53,53,14,13,27,125.0,908.0,134,30,37,67,284.0,82,5.31,60,363,2326,9.4,0.5330641
9210,9210,Erik Cole,2004-05,26.0,4,42,80,80,18,24,42,172.0,1448.0,214,48,61,109,456.0,82,5.14,57,348,2300,9.2,0.6659437
9211,9211,Erik Cole,2006-07,28.0,5,59,60,60,30,29,59,164.0,1158.0,274,78,90,168,620.0,82,6.05,85,480,2458,10.1,0.8055086
9212,9212,Erik Cole,2007-08,29.0,6,61,71,71,29,32,61,166.0,1279.0,345,107,122,229,786.0,82,5.76,70,398,2426,9.7,0.714069
9213,9213,Erik Cole,2008-09,30.0,7,51,73,73,22,29,51,216.0,1413.0,418,129,151,280,1002.0,82,5.44,62,351,2383,9.4,0.59042305
9214,9214,Erik Cole,2009-10,31.0,8,42,80,80,18,24,42,178.0,1409.0,498,147,175,322,1180.0,82,5.7,65,341,2477,9.4,0.5049403
9215,9215,Erik Cole,2010-11,32.0,9,16,40,40,11,5,16,81.0,656.0,538,158,180,338,1261.0,82,5.53,56,304,2486,9.1,0.44092107
9216,9216,Erik Cole,2011-12,33.0,10,52,82,82,26,26,52,201.0,1514.0,620,184,206,390,1462.0,82,5.46,52,291,2492,9.0,0.6159786
9217,9217,Erik Cole,2012-13,34.0,11,61,82,82,35,26,61,241.0,1519.0,702,219,232,451,1703.0,82,5.32,47,271,2439,8.9,0.6368937
9218,9218,Erik Cole,2013-14,35.0,12,13,47,47,9,4,13,86.0,770.0,749,228,236,464,1789.0,48,5.31,29,160,1399,9.1,0.36912385
9219,9219,Erik Cole,2014-15,36.0,13,29,75,75,16,13,29,139.0,1137.0,824,244,249,493,1928.0,82,5.34,48,269,2463,8.9,0.37345868
9220,9220,Erik Cole,2015-16,37.0,14,39,68,68,21,18,39,122.0,989.0,892,265,267,532,2050.0,82,5.32,47,251,2453,8.9,0.4565102
9221,9221,Erik Condra,2011-12,25.0,2,11,26,26,6,5,11,48.0,413.0,26,6,5,11,48.0,82,5.46,52,291,2492,9.0,0.2738307
9222,9222,Erik Condra,2012-13,26.0,3,25,81,81,8,17,25,140.0,1147.0,107,14,22,36,188.0,82,5.32,47,271,2439,8.9,0.33391148
9223,9223,Erik Condra,2013-14,27.0,4,12,48,48,4,8,12,73.0,632.0,155,18,30,48,261.0,48,5.31,29,160,1399,9.1,0.28261375
9224,9224,Erik Condra,2014-15,28.0,5,16,76,76,6,10,16,85.0,885.0,231,24,40,64,346.0,82,5.34,48,269,2463,8.9,0.24008247
9225,9225,Erik Condra,2015-16,29.0,6,23,68,68,9,14,23,106.0,983.0,299,33,54,87,452.0,82,5.32,47,251,2453,8.9,0.27854574
9226,9226,Erik Condra,2016-17,30.0,7,11,54,54,6,5,11,58.0,578.0,353,39,59,98,510.0,82,5.34,48,255,2438,9.0,0.21498701
9227,9227,Erik Condra,2017-18,31.0,8,0,13,13,0,0,0,8.0,125.0,366,39,59,98,518.0,82,5.45,47,245,2478,9.0,0.18041626
9228,9228,Erik Condra,2019-20,33.0,9,1,6,6,1,0,1,10.0,76.0,372,40,59,99,528.0,82,5.96,47,239,2579,9.5,0.18546674
9229,9229,Erik Gudbranson,2012-13,21.0,2,8,72,72,2,6,8,76.0,1022.0,72,2,6,8,76.0,82,5.32,47,271,2439,8.9,0.23935577
9230,9230,Erik Gudbranson,2013-14,22.0,3,4,32,32,0,4,4,49.0,600.0,104,2,10,12,125.0,48,5.31,29,160,1399,9.1,0.22529823
9231,9231,Erik Gudbranson,2014-15,23.0,4,9,65,65,3,6,9,92.0,1169.0,169,5,16,21,217.0,82,5.34,48,269,2463,8.9,0.20279372
9232,9232,Erik Gudbranson,2015-16,24.0,5,13,76,76,4,9,13,110.0,1414.0,245,9,25,34,327.0,82,5.32,47,251,2453,8.9,0.21238872
9233,9233,Erik Gudbranson,2016-17,25.0,6,9,64,64,2,7,9,73.0,1287.0,309,11,32,43,400.0,82,5.34,48,255,2438,9.0,0.16575533
9234,9234,Erik Gudbranson,2017-18,26.0,7,6,30,30,1,5,6,40.0,610.0,339,12,37,49,440.0,82,5.45,47,245,2478,9.0,0.18527266
9235,9235,Erik Gudbranson,2018-19,27.0,8,5,52,52,2,3,5,53.0,958.0,391,14,40,54,493.0,82,5.86,50,250,2620,9.2,0.14674342
9236,9236,Erik Gudbranson,2019-20,28.0,9,10,76,76,2,8,10,94.0,1386.0,467,16,48,64,587.0,82,5.96,47,239,2579,9.5,0.1881611
9237,9237,Erik Gudbranson,2020-21,29.0,10,9,51,51,4,5,9,78.0,988.0,518,20,53,73,665.0,70,5.96,42,208,2192,9.5,0.20278099
9238,9238,Erik Gustafsson,2011-12,23.0,2,0,3,3,0,0,0,2.0,33.0,3,0,0,0,2.0,82,5.46,52,291,2492,9.0,0.17343244
9239,9239,Erik Gustafsson,2012-13,24.0,3,5,30,30,1,4,5,18.0,504.0,33,1,4,5,20.0,82,5.32,47,271,2439,8.9,0.16053686
9240,9240,Erik Gustafsson,2013-14,25.0,4,8,27,27,3,5,8,36.0,544.0,60,4,9,13,56.0,48,5.31,29,160,1399,9.1,0.25801218
9241,9241,Erik Gustafsson,2014-15,26.0,5,10,31,31,2,8,10,30.0,543.0,91,6,17,23,86.0,82,5.34,48,269,2463,8.9,0.22845748
9242,9242,Erik Gustafsson0,2016-17,24.0,2,14,41,41,0,14,14,58.0,633.0,41,0,14,14,58.0,82,5.34,48,255,2438,9.0,0.21749502
9243,9243,Erik Gustafsson0,2018-19,26.0,3,16,35,35,5,11,16,71.0,649.0,76,5,25,30,129.0,82,5.86,50,250,2620,9.2,0.35259843
9244,9244,Erik Gustafsson0,2019-20,27.0,4,60,79,79,17,43,60,160.0,1784.0,155,22,68,90,289.0,82,5.96,47,239,2579,9.5,0.6016738
9245,9245,Erik Gustafsson0,2020-21,28.0,5,29,66,66,6,23,29,103.0,1345.0,221,28,91,119,392.0,70,5.96,42,208,2192,9.5,0.46272355
9246,9246,Erik Haula,2014-15,23.0,2,15,46,46,6,9,15,56.0,467.0,46,6,9,15,56.0,82,5.34,48,269,2463,8.9,0.30448884
9247,9247,Erik Haula,2015-16,24.0,3,14,72,72,7,7,14,92.0,875.0,118,13,16,29,148.0,82,5.32,47,251,2453,8.9,0.25451648
9248,9248,Erik Haula,2016-17,25.0,4,34,76,76,14,20,34,99.0,967.0,194,27,36,63,247.0,82,5.34,48,255,2438,9.0,0.41774204
9249,9249,Erik Haula,2017-18,26.0,5,26,72,72,15,11,26,134.0,995.0,266,42,47,89,381.0,82,5.45,47,245,2478,9.0,0.41863564
9250,9250,Erik Haula,2018-19,27.0,6,55,76,76,29,26,55,175.0,1320.0,342,71,73,144,556.0,82,5.86,50,250,2620,9.2,0.59990203
9251,9251,Erik Haula,2019-20,28.0,7,7,15,15,2,5,7,26.0,249.0,357,73,78,151,582.0,82,5.96,47,239,2579,9.5,0.35870454
9252,9252,Erik Haula,2020-21,29.0,8,24,48,48,12,12,24,92.0,760.0,405,85,90,175,674.0,70,5.96,42,208,2192,9.5,0.4299121
9253,9253,Erik Johnson,2008-09,20.0,2,33,69,69,5,28,33,105.0,1255.0,69,5,28,33,105.0,82,5.44,62,351,2383,9.4,0.49807018
9254,9254,Erik Johnson,2010-11,22.0,3,39,79,79,10,29,39,186.0,1694.0,148,15,57,72,291.0,82,5.53,56,304,2486,9.1,0.50492805
9255,9255,Erik Johnson,2011-12,23.0,4,29,77,77,8,21,29,161.0,1757.0,225,23,78,101,452.0,82,5.46,52,291,2492,9.0,0.42848614
9256,9256,Erik Johnson,2012-13,24.0,5,26,73,73,4,22,26,155.0,1521.0,298,27,100,127,607.0,82,5.32,47,271,2439,8.9,0.38321996
9257,9257,Erik Johnson,2013-14,25.0,6,4,31,31,0,4,4,64.0,643.0,329,27,104,131,671.0,48,5.31,29,160,1399,9.1,0.32717186
9258,9258,Erik Johnson,2014-15,26.0,7,39,80,80,9,30,39,157.0,1841.0,409,36,134,170,828.0,82,5.34,48,269,2463,8.9,0.5098343
9259,9259,Erik Johnson,2015-16,27.0,8,23,47,47,12,11,23,115.0,1148.0,456,48,145,193,943.0,82,5.32,47,251,2453,8.9,0.4515298
9260,9260,Erik Johnson,2016-17,28.0,9,27,73,73,11,16,27,175.0,1711.0,529,59,161,220,1118.0,82,5.34,48,255,2438,9.0,0.39849862
9261,9261,Erik Johnson,2017-18,29.0,10,17,46,46,2,15,17,96.0,1016.0,575,61,176,237,1214.0,82,5.45,47,245,2478,9.0,0.35196096
9262,9262,Erik Johnson,2018-19,30.0,11,25,62,62,9,16,25,168.0,1577.0,637,70,192,262,1382.0,82,5.86,50,250,2620,9.2,0.39642555
9263,9263,Erik Johnson,2019-20,31.0,12,25,80,80,7,18,25,144.0,1745.0,717,77,210,287,1526.0,82,5.96,47,239,2579,9.5,0.30916333
9264,9264,Erik Johnson,2020-21,32.0,13,16,59,59,3,13,16,99.0,1242.0,776,80,223,303,1625.0,70,5.96,42,208,2192,9.5,0.3164829
9265,9265,Erik Karlsson,2010-11,20.0,2,26,60,60,5,21,26,112.0,1207.0,60,5,21,26,112.0,82,5.53,56,304,2486,9.1,0.45532164
9266,9266,Erik Karlsson,2011-12,21.0,3,45,75,75,13,32,45,182.0,1764.0,135,18,53,71,294.0,82,5.46,52,291,2492,9.0,0.6247623
9267,9267,Erik Karlsson,2012-13,22.0,4,78,81,81,19,59,78,261.0,2051.0,216,37,112,149,555.0,82,5.32,47,271,2439,8.9,0.94366
9268,9268,Erik Karlsson,2013-14,23.0,5,14,17,17,6,8,14,79.0,462.0,233,43,120,163,634.0,48,5.31,29,160,1399,9.1,0.704842
9269,9269,Erik Karlsson,2014-15,24.0,6,74,82,82,20,54,74,257.0,2220.0,315,63,174,237,891.0,82,5.34,48,269,2463,8.9,0.897399
9270,9270,Erik Karlsson,2015-16,25.0,7,66,82,82,21,45,66,292.0,2235.0,397,84,219,303,1183.0,82,5.32,47,251,2453,8.9,0.8456086
9271,9271,Erik Karlsson,2016-17,26.0,8,82,82,82,16,66,82,248.0,2375.0,479,100,285,385,1431.0,82,5.34,48,255,2438,9.0,0.94441664
9272,9272,Erik Karlsson,2017-18,27.0,9,71,77,77,17,54,71,218.0,2066.0,556,117,339,456,1649.0,82,5.45,47,245,2478,9.0,0.9035776
9273,9273,Erik Karlsson,2018-19,28.0,10,62,71,71,9,53,62,196.0,1899.0,627,126,392,518,1845.0,82,5.86,50,250,2620,9.2,0.810837
9274,9274,Erik Karlsson,2019-20,29.0,11,45,53,53,3,42,45,169.0,1298.0,680,129,434,563,2014.0,82,5.96,47,239,2579,9.5,0.72145206
9275,9275,Erik Karlsson,2020-21,30.0,12,40,56,56,6,34,40,120.0,1373.0,736,135,468,603,2134.0,70,5.96,42,208,2192,9.5,0.7065304
9276,9276,Erik Rasmussen,1998-99,21.0,2,5,21,21,2,3,5,28.0,,21,2,3,5,28.0,82,5.28,57,380,2242,9.6,0.2984181
9277,9277,Erik Rasmussen,1999-00,22.0,3,10,42,42,3,7,10,40.0,519.0,63,5,10,15,68.0,82,5.27,57,359,2285,9.4,0.263664
9278,9278,Erik Rasmussen,2000-01,23.0,4,14,67,67,8,6,14,76.0,767.0,130,13,16,29,144.0,82,5.49,53,331,2294,9.8,0.24981925
9279,9279,Erik Rasmussen,2001-02,24.0,5,31,82,82,12,19,31,95.0,1130.0,212,25,35,60,239.0,82,5.51,63,376,2272,9.9,0.39631942
9280,9280,Erik Rasmussen,2002-03,25.0,6,19,69,69,8,11,19,89.0,900.0,281,33,46,79,328.0,82,5.24,53,338,2262,9.5,0.28331453
9281,9281,Erik Rasmussen,2003-04,26.0,7,16,57,57,4,12,16,75.0,778.0,338,37,58,95,403.0,82,5.31,60,363,2326,9.4,0.2527304
9282,9282,Erik Rasmussen,2004-05,27.0,8,13,69,69,7,6,13,68.0,798.0,407,44,64,108,471.0,82,5.14,57,348,2300,9.2,0.24882066
9283,9283,Erik Rasmussen,2006-07,29.0,9,10,67,67,5,5,10,45.0,473.0,474,49,69,118,516.0,82,6.05,85,480,2458,10.1,0.18736663
9284,9284,Erik Rasmussen,2007-08,30.0,10,10,71,71,3,7,10,80.0,672.0,545,52,76,128,596.0,82,5.76,70,398,2426,9.7,0.20163125
9285,9285,Erik Reitz,2006-07,24.0,2,0,5,5,0,0,0,0.0,66.0,5,0,0,0,0.0,82,6.05,85,480,2458,10.1,0.14232093
9286,9286,Erik Reitz,2007-08,25.0,3,0,1,1,0,0,0,0.0,11.0,6,0,0,0,0.0,82,5.76,70,398,2426,9.7,0.1386244
9287,9287,Erik Reitz,2009-10,27.0,4,2,42,42,1,1,2,22.0,419.0,48,1,1,2,22.0,82,5.7,65,341,2477,9.4,0.103212416
9288,9288,Erik Westrum,2004-05,25.0,2,2,15,15,1,1,2,29.0,240.0,15,1,1,2,29.0,82,5.14,57,348,2300,9.2,0.22441867
9289,9289,Erik Westrum,2006-07,27.0,3,1,10,10,0,1,1,16.0,108.0,25,1,2,3,45.0,82,6.05,85,480,2458,10.1,0.16541493
9290,9290,Erik Westrum,2007-08,28.0,4,0,2,2,0,0,0,0.0,7.0,27,1,2,3,45.0,82,5.76,70,398,2426,9.7,0.15367678
9291,9291,Ernie Godden,1982-83,21.0,2,2,5,5,1,1,2,5.0,,5,1,1,2,5.0,80,8.03,73,320,2489,12.9,0.3482496
9292,9292,Errol Rausse,1980-81,21.0,2,8,24,24,6,2,8,24.0,,24,6,2,8,24.0,80,7.03,61,280,2352,12.0,0.42246366
9293,9293,Errol Rausse,1981-82,22.0,3,2,5,5,1,1,2,3.0,,29,7,3,10,27.0,80,7.69,77,340,2441,12.6,0.28296432
9294,9294,Errol Rausse,1982-83,23.0,4,0,2,2,0,0,0,0.0,,31,7,3,10,27.0,80,8.03,73,320,2489,12.9,0.2143144
9295,9295,Esa Lindell,2016-17,22.0,2,0,4,4,0,0,0,2.0,56.0,4,0,0,0,2.0,82,5.34,48,255,2438,9.0,0.17487222
9296,9296,Esa Lindell,2017-18,23.0,3,18,73,73,6,12,18,99.0,1597.0,77,6,12,18,101.0,82,5.45,47,245,2478,9.0,0.32143116
9297,9297,Esa Lindell,2018-19,24.0,4,27,80,80,7,20,27,137.0,1766.0,157,13,32,45,238.0,82,5.86,50,250,2620,9.2,0.35188448
9298,9298,Esa Lindell,2019-20,25.0,5,32,82,82,11,21,32,132.0,1995.0,239,24,53,77,370.0,82,5.96,47,239,2579,9.5,0.407118
9299,9299,Esa Lindell,2020-21,26.0,6,23,69,69,3,20,23,98.0,1615.0,308,27,73,100,468.0,70,5.96,42,208,2192,9.5,0.3188854
9300,9300,Esa Pirnes,2004-05,27.0,2,11,57,57,3,8,11,57.0,670.0,57,3,8,11,57.0,82,5.14,57,348,2300,9.2,0.200993
9301,9301,Esa Tikkanen,1986-87,22.0,2,13,35,35,7,6,13,47.0,,35,7,6,13,47.0,80,7.94,82,370,2484,12.8,0.40398747
9302,9302,Esa Tikkanen,1987-88,23.0,3,78,76,76,34,44,78,126.0,,111,41,50,91,173.0,80,7.34,72,344,2400,12.2,0.84153086
9303,9303,Esa Tikkanen,1988-89,24.0,4,74,80,80,23,51,74,142.0,,191,64,101,165,315.0,80,7.43,89,437,2435,12.2,0.88500285
9304,9304,Esa Tikkanen,1989-90,25.0,5,78,67,67,31,47,78,151.0,,258,95,148,243,466.0,80,7.48,85,403,2430,12.3,0.96157575
9305,9305,Esa Tikkanen,1990-91,26.0,6,63,79,79,30,33,63,199.0,,337,125,181,306,665.0,80,7.37,76,367,2421,12.2,0.7702824
9306,9306,Esa Tikkanen,1991-92,27.0,7,69,79,79,27,42,69,235.0,,416,152,223,375,900.0,80,6.91,71,366,2385,11.6,0.8194308
9307,9307,Esa Tikkanen,1992-93,28.0,8,28,40,40,12,16,28,117.0,,456,164,239,403,1017.0,80,6.96,77,402,2440,11.4,0.67344415
9308,9308,Esa Tikkanen,1993-94,29.0,9,40,81,81,16,24,40,202.0,,537,180,263,443,1219.0,84,7.25,87,443,2603,11.7,0.59173435
9309,9309,Esa Tikkanen,1994-95,30.0,10,54,83,83,22,32,54,257.0,,620,202,295,497,1476.0,84,6.48,76,407,2545,10.7,0.6505745
9310,9310,Esa Tikkanen,1995-96,31.0,11,35,43,43,12,23,35,107.0,,663,214,318,532,1583.0,48,5.97,37,209,1408,10.2,0.65616536
9311,9311,Esa Tikkanen,1996-97,32.0,12,44,58,58,14,30,44,95.0,,721,228,348,576,1678.0,82,6.29,74,413,2481,10.4,0.50193715
9312,9312,Esa Tikkanen,1997-98,33.0,13,30,76,76,13,17,30,133.0,,797,241,365,606,1811.0,82,5.83,55,336,2444,9.8,0.41583312
9313,9313,Esa Tikkanen,1998-99,34.0,14,21,48,48,3,18,21,67.0,,845,244,383,627,1878.0,82,5.28,57,380,2242,9.6,0.33715943
9314,9314,Esa Tikkanen,1999-00,35.0,15,3,32,32,0,3,3,25.0,436.0,877,244,386,630,1903.0,82,5.27,57,359,2285,9.4,0.32235694
9315,9315,Espen Knutsen,1998-99,27.0,2,3,19,19,3,0,3,21.0,,19,3,0,3,21.0,82,5.28,57,380,2242,9.6,0.22891775
9316,9316,Espen Knutsen,2001-02,30.0,3,53,66,66,11,42,53,62.0,1054.0,85,14,42,56,83.0,82,5.51,63,376,2272,9.9,0.5925823
9317,9317,Espen Knutsen,2002-03,31.0,4,42,77,77,11,31,42,102.0,1559.0,162,25,73,98,185.0,82,5.24,53,338,2262,9.5,0.43192405
9318,9318,Espen Knutsen,2003-04,32.0,5,9,31,31,5,4,9,28.0,519.0,193,30,77,107,213.0,82,5.31,60,363,2326,9.4,0.28844848
9319,9319,Espen Knutsen,2004-05,33.0,6,4,14,14,0,4,4,11.0,216.0,207,30,81,111,224.0,82,5.14,57,348,2300,9.2,0.32954645
9320,9320,Ethan Bear,2018-19,21.0,2,4,18,18,1,3,4,20.0,335.0,18,1,3,4,20.0,82,5.86,50,250,2620,9.2,0.26158834
9321,9321,Ethan Bear,2020-21,23.0,3,21,71,71,5,16,21,99.0,1560.0,89,6,19,25,119.0,70,5.96,42,208,2192,9.5,0.33629203
9322,9322,Ethan Moreau,1996-97,21.0,2,1,8,8,0,1,1,1.0,,8,0,1,1,1.0,82,6.29,74,413,2481,10.4,0.22123289
9323,9323,Ethan Moreau,1997-98,22.0,3,31,82,82,15,16,31,114.0,,90,15,17,32,115.0,82,5.83,55,336,2444,9.8,0.44403404
9324,9324,Ethan Moreau,1998-99,23.0,4,18,54,54,9,9,18,87.0,,144,24,26,50,202.0,82,5.28,57,380,2242,9.6,0.4036293
9325,9325,Ethan Moreau,1999-00,24.0,5,21,80,80,10,11,21,96.0,990.0,224,34,37,71,298.0,82,5.27,57,359,2285,9.4,0.34678212
9326,9326,Ethan Moreau,2000-01,25.0,6,27,73,73,17,10,27,106.0,1103.0,297,51,47,98,404.0,82,5.49,53,331,2294,9.8,0.389838
9327,9327,Ethan Moreau,2001-02,26.0,7,19,68,68,9,10,19,97.0,964.0,365,60,57,117,501.0,82,5.51,63,376,2272,9.9,0.29168808
9328,9328,Ethan Moreau,2002-03,27.0,8,16,80,80,11,5,16,129.0,1017.0,445,71,62,133,630.0,82,5.24,53,338,2262,9.5,0.29312682
9329,9329,Ethan Moreau,2003-04,28.0,9,31,78,78,14,17,31,137.0,1054.0,523,85,79,164,767.0,82,5.31,60,363,2326,9.4,0.39517072
9330,9330,Ethan Moreau,2004-05,29.0,10,32,81,81,20,12,32,180.0,1221.0,604,105,91,196,947.0,82,5.14,57,348,2300,9.2,0.47702003
9331,9331,Ethan Moreau,2006-07,31.0,11,27,74,74,11,16,27,151.0,1183.0,678,116,107,223,1098.0,82,6.05,85,480,2458,10.1,0.30795053
9332,9332,Ethan Moreau,2007-08,32.0,12,1,7,7,1,0,1,18.0,106.0,685,117,107,224,1116.0,82,5.76,70,398,2426,9.7,0.23021671
9333,9333,Ethan Moreau,2008-09,33.0,13,9,25,25,5,4,9,54.0,398.0,710,122,111,233,1170.0,82,5.44,62,351,2383,9.4,0.26431692
9334,9334,Ethan Moreau,2009-10,34.0,14,26,77,77,14,12,26,159.0,1183.0,787,136,123,259,1329.0,82,5.7,65,341,2477,9.4,0.29676938
9335,9335,Ethan Moreau,2010-11,35.0,15,18,76,76,9,9,18,143.0,1095.0,863,145,132,277,1472.0,82,5.53,56,304,2486,9.1,0.22208914
9336,9336,Ethan Moreau,2011-12,36.0,16,6,37,37,1,5,6,56.0,462.0,900,146,137,283,1528.0,82,5.46,52,291,2492,9.0,0.18346071
9337,9337,Ethan Moreau,2012-13,37.0,17,4,28,28,1,3,4,29.0,295.0,928,147,140,287,1557.0,82,5.32,47,271,2439,8.9,0.18146268
9338,9338,Evan Bouchard,2019-20,20.0,2,1,7,7,1,0,1,10.0,86.0,7,1,0,1,10.0,82,5.96,47,239,2579,9.5,0.288857
9339,9339,Evan Brophey,2011-12,25.0,2,0,1,1,0,0,0,1.0,7.0,1,0,0,0,1.0,82,5.46,52,291,2492,9.0,0.15797141
9340,9340,Evan Brophey,2012-13,26.0,3,0,3,3,0,0,0,0.0,13.0,4,0,0,0,1.0,82,5.32,47,271,2439,8.9,0.14268374
9341,9341,Evan McEneny,2017-18,23.0,2,0,1,1,0,0,0,1.0,15.0,1,0,0,0,1.0,82,5.45,47,245,2478,9.0,0.18257251
9342,9342,Evan Oberg,2010-11,22.0,2,0,2,2,0,0,0,0.0,13.0,2,0,0,0,0.0,82,5.53,56,304,2486,9.1,0.16590163
9343,9343,Evan Oberg,2011-12,23.0,3,0,2,2,0,0,0,1.0,20.0,4,0,0,0,1.0,82,5.46,52,291,2492,9.0,0.16370213
9344,9344,Evan Oberg,2012-13,24.0,4,0,3,3,0,0,0,3.0,30.0,7,0,0,0,4.0,82,5.32,47,271,2439,8.9,0.16039535
9345,9345,Evan Rodrigues,2016-17,23.0,2,2,2,2,1,1,2,8.0,24.0,2,1,1,2,8.0,82,5.34,48,255,2438,9.0,0.22664776
9346,9346,Evan Rodrigues,2017-18,24.0,3,6,30,30,4,2,6,51.0,388.0,32,5,3,8,59.0,82,5.45,47,245,2478,9.0,0.25768077
9347,9347,Evan Rodrigues,2018-19,25.0,4,25,48,48,7,18,25,91.0,669.0,80,12,21,33,150.0,82,5.86,50,250,2620,9.2,0.4059917
9348,9348,Evan Rodrigues,2019-20,26.0,5,29,74,74,9,20,29,168.0,1171.0,154,21,41,62,318.0,82,5.96,47,239,2579,9.5,0.3959335
9349,9349,Evan Rodrigues,2020-21,27.0,6,10,45,45,6,4,10,75.0,508.0,199,27,45,72,393.0,70,5.96,42,208,2192,9.5,0.33486405
9350,9350,Evander Kane,2010-11,19.0,2,26,66,66,14,12,26,127.0,924.0,66,14,12,26,127.0,82,5.53,56,304,2486,9.1,0.44822946
9351,9351,Evander Kane,2011-12,20.0,3,43,73,73,19,24,43,234.0,1304.0,139,33,36,69,361.0,82,5.46,52,291,2492,9.0,0.64100575
9352,9352,Evander Kane,2012-13,21.0,4,57,74,74,30,27,57,287.0,1296.0,213,63,63,126,648.0,82,5.32,47,271,2439,8.9,0.762478
9353,9353,Evander Kane,2013-14,22.0,5,33,48,48,17,16,33,190.0,982.0,261,80,79,159,838.0,48,5.31,29,160,1399,9.1,0.7465977
9354,9354,Evander Kane,2014-15,23.0,6,41,63,63,19,22,41,250.0,1278.0,324,99,101,200,1088.0,82,5.34,48,269,2463,8.9,0.71348083
9355,9355,Evander Kane,2015-16,24.0,7,22,37,37,10,12,22,126.0,715.0,361,109,113,222,1214.0,82,5.32,47,251,2453,8.9,0.62955296
9356,9356,Evander Kane,2016-17,25.0,8,35,65,65,20,15,35,271.0,1367.0,426,129,128,257,1485.0,82,5.34,48,255,2438,9.0,0.57969564
9357,9357,Evander Kane,2017-18,26.0,9,43,70,70,28,15,43,260.0,1344.0,496,157,143,300,1745.0,82,5.45,47,245,2478,9.0,0.70477504
9358,9358,Evander Kane,2018-19,27.0,10,54,78,78,29,25,54,307.0,1527.0,574,186,168,354,2052.0,82,5.86,50,250,2620,9.2,0.7128493
9359,9359,Evander Kane,2019-20,28.0,11,56,75,75,30,26,56,268.0,1381.0,649,216,194,410,2320.0,82,5.96,47,239,2579,9.5,0.73254263
9360,9360,Evander Kane,2020-21,29.0,12,47,64,64,26,21,47,216.0,1250.0,713,242,215,457,2536.0,70,5.96,42,208,2192,9.5,0.7313869
9361,9361,Everett Sanipass,1987-88,19.0,2,4,7,7,1,3,4,9.0,,7,1,3,4,9.0,80,7.34,72,344,2400,12.2,0.33569473
9362,9362,Everett Sanipass,1988-89,20.0,3,20,57,57,8,12,20,55.0,,64,9,15,24,64.0,80,7.43,89,437,2435,12.2,0.3639261
9363,9363,Everett Sanipass,1989-90,21.0,4,15,50,50,6,9,15,51.0,,114,15,24,39,115.0,80,7.48,85,403,2430,12.3,0.39777324
9364,9364,Everett Sanipass,1990-91,22.0,5,10,21,21,5,5,10,32.0,,135,20,29,49,147.0,80,7.37,76,367,2421,12.2,0.42697743
9365,9365,Everett Sanipass,1991-92,23.0,6,10,29,29,5,5,10,38.0,,164,25,34,59,185.0,80,6.91,71,366,2385,11.6,0.37003183
9366,9366,Evgeni Malkin,2007-08,21.0,2,85,78,78,33,52,85,242.0,1494.0,78,33,52,85,242.0,82,5.76,70,398,2426,9.7,1.1295094
9367,9367,Evgeni Malkin,2008-09,22.0,3,106,82,82,47,59,106,272.0,1748.0,160,80,111,191,514.0,82,5.44,62,351,2383,9.4,1.3026578
9368,9368,Evgeni Malkin,2009-10,23.0,4,113,82,82,35,78,113,290.0,1846.0,242,115,189,304,804.0,82,5.7,65,341,2477,9.4,1.219456
9369,9369,Evgeni Malkin,2010-11,24.0,5,77,67,67,28,49,77,268.0,1397.0,309,143,238,381,1072.0,82,5.53,56,304,2486,9.1,1.0571597
9370,9370,Evgeni Malkin,2011-12,25.0,6,37,43,43,15,22,37,182.0,852.0,352,158,260,418,1254.0,82,5.46,52,291,2492,9.0,0.97733843
9371,9371,Evgeni Malkin,2012-13,26.0,7,109,75,75,50,59,109,339.0,1577.0,427,208,319,527,1593.0,82,5.32,47,271,2439,8.9,1.158211
9372,9372,Evgeni Malkin,2013-14,27.0,8,33,31,31,9,24,33,99.0,611.0,458,217,343,560,1692.0,48,5.31,29,160,1399,9.1,1.0369018
9373,9373,Evgeni Malkin,2014-15,28.0,9,72,60,60,23,49,72,191.0,1204.0,518,240,392,632,1883.0,82,5.34,48,269,2463,8.9,1.0999742
9374,9374,Evgeni Malkin,2015-16,29.0,10,70,69,69,28,42,70,212.0,1309.0,587,268,434,702,2095.0,82,5.32,47,251,2453,8.9,0.9395216
9375,9375,Evgeni Malkin,2016-17,30.0,11,58,57,57,27,31,58,162.0,1104.0,644,295,465,760,2257.0,82,5.34,48,255,2438,9.0,1.0173273
9376,9376,Evgeni Malkin,2017-18,31.0,12,72,62,62,33,39,72,191.0,1154.0,706,328,504,832,2448.0,82,5.45,47,245,2478,9.0,1.1413295
9377,9377,Evgeni Malkin,2018-19,32.0,13,98,78,78,42,56,98,239.0,1481.0,784,370,560,930,2687.0,82,5.86,50,250,2620,9.2,1.1354856
9378,9378,Evgeni Malkin,2019-20,33.0,14,72,68,68,21,51,72,187.0,1279.0,852,391,611,1002,2874.0,82,5.96,47,239,2579,9.5,0.9920168
9379,9379,Evgeni Malkin,2020-21,34.0,15,74,55,55,25,49,74,171.0,1074.0,907,416,660,1076,3045.0,70,5.96,42,208,2192,9.5,1.0867862
9380,9380,Evgenii Dadonov,2010-11,21.0,2,0,4,4,0,0,0,4.0,53.0,4,0,0,0,4.0,82,5.53,56,304,2486,9.1,0.2152408
9381,9381,Evgenii Dadonov,2011-12,22.0,3,17,36,36,8,9,17,60.0,513.0,40,8,9,17,64.0,82,5.46,52,291,2492,9.0,0.39231458
9382,9382,Evgenii Dadonov,2012-13,23.0,4,3,15,15,2,1,3,21.0,151.0,55,10,10,20,85.0,82,5.32,47,271,2439,8.9,0.29584432
9383,9383,Evgenii Dadonov,2018-19,29.0,5,65,74,74,28,37,65,188.0,1384.0,129,38,47,85,273.0,82,5.86,50,250,2620,9.2,0.7390528
9384,9384,Evgenii Dadonov,2019-20,30.0,6,70,82,82,28,42,70,195.0,1506.0,211,66,89,155,468.0,82,5.96,47,239,2579,9.5,0.76521343
9385,9385,Evgenii Dadonov,2020-21,31.0,7,47,69,69,25,22,47,167.0,1180.0,280,91,111,202,635.0,70,5.96,42,208,2192,9.5,0.62233764
9386,9386,Evgeny Artyukhin,2006-07,23.0,2,17,72,72,4,13,17,79.0,628.0,72,4,13,17,79.0,82,6.05,85,480,2458,10.1,0.2546687
9387,9387,Evgeny Artyukhin,2009-10,26.0,3,16,73,73,6,10,16,100.0,779.0,145,10,23,33,179.0,82,5.7,65,341,2477,9.4,0.26096147
9388,9388,Evgeny Artyukhin,2010-11,27.0,4,16,54,54,9,7,16,42.0,482.0,199,19,30,49,221.0,82,5.53,56,304,2486,9.1,0.297907
9389,9389,Evgeny Davydov,1992-93,25.0,2,7,12,12,4,3,7,32.0,,12,4,3,7,32.0,80,6.96,77,402,2440,11.4,0.40169066
9390,9390,Evgeny Davydov,1993-94,26.0,3,49,79,79,28,21,49,176.0,,91,32,24,56,208.0,84,7.25,87,443,2603,11.7,0.58323497
9391,9391,Evgeny Davydov,1994-95,27.0,4,20,61,61,7,13,20,66.0,,152,39,37,76,274.0,84,6.48,76,407,2545,10.7,0.33042967
9392,9392,Evgeny Davydov,1995-96,28.0,5,3,3,3,1,2,3,2.0,,155,40,39,79,276.0,48,5.97,37,209,1408,10.2,0.29963154
9393,9393,Evgeny Grachev,2011-12,21.0,2,0,8,8,0,0,0,3.0,62.0,8,0,0,0,3.0,82,5.46,52,291,2492,9.0,0.1958966
9394,9394,Evgeny Grachev,2012-13,22.0,3,4,26,26,1,3,4,14.0,243.0,34,1,3,4,17.0,82,5.32,47,271,2439,8.9,0.15826139
9395,9395,Evgeny Korolev,2000-01,22.0,2,3,17,17,1,2,3,7.0,275.0,17,1,2,3,7.0,82,5.49,53,331,2294,9.8,0.1940487
9396,9396,Evgeny Korolev,2001-02,23.0,3,0,8,8,0,0,0,11.0,133.0,25,1,2,3,18.0,82,5.51,63,376,2272,9.9,0.16435915
9397,9397,Evgeny Korolev,2002-03,24.0,4,2,17,17,0,2,2,9.0,176.0,42,1,4,5,27.0,82,5.24,53,338,2262,9.5,0.15784106
9398,9398,Evgeny Kuznetsov,2014-15,22.0,2,9,17,17,3,6,9,22.0,229.0,17,3,6,9,22.0,82,5.34,48,269,2463,8.9,0.29335386
9399,9399,Evgeny Kuznetsov,2015-16,23.0,3,37,80,80,11,26,37,127.0,1066.0,97,14,32,46,149.0,82,5.32,47,251,2453,8.9,0.46255678
9400,9400,Evgeny Kuznetsov,2016-17,24.0,4,77,82,82,20,57,77,193.0,1428.0,179,34,89,123,342.0,82,5.34,48,255,2438,9.0,0.8514712
9401,9401,Evgeny Kuznetsov,2017-18,25.0,5,59,82,82,19,40,59,170.0,1390.0,261,53,129,182,512.0,82,5.45,47,245,2478,9.0,0.7632135
9402,9402,Evgeny Kuznetsov,2018-19,26.0,6,83,79,79,27,56,83,187.0,1486.0,340,80,185,265,699.0,82,5.86,50,250,2620,9.2,0.9006407
9403,9403,Evgeny Kuznetsov,2019-20,27.0,7,72,76,76,21,51,72,193.0,1428.0,416,101,236,337,892.0,82,5.96,47,239,2579,9.5,0.83273727
9404,9404,Evgeny Kuznetsov,2020-21,28.0,8,52,63,63,19,33,52,129.0,1124.0,479,120,269,389,1021.0,70,5.96,42,208,2192,9.5,0.71895695
9405,9405,Evgeny Medvedev,2016-17,34.0,2,12,45,45,4,8,12,71.0,847.0,45,4,8,12,71.0,82,5.34,48,255,2438,9.0,0.21005431
9406,9406,Evgeny Namestnikov,1994-95,23.0,2,5,17,17,0,5,5,11.0,,17,0,5,5,11.0,84,6.48,76,407,2545,10.7,0.20558506
9407,9407,Evgeny Namestnikov,1995-96,24.0,3,3,16,16,0,3,3,18.0,,33,0,8,8,29.0,48,5.97,37,209,1408,10.2,0.21708736
9408,9408,Evgeny Namestnikov,1997-98,26.0,4,0,2,2,0,0,0,1.0,,35,0,8,8,30.0,82,5.83,55,336,2444,9.8,0.15006885
9409,9409,Evgeny Namestnikov,1998-99,27.0,5,1,6,6,0,1,1,2.0,,41,0,9,9,32.0,82,5.28,57,380,2242,9.6,0.13967681
9410,9410,Evgeny Namestnikov,2000-01,29.0,6,0,2,2,0,0,0,3.0,32.0,43,0,9,9,35.0,82,5.49,53,331,2294,9.8,0.12993205
9411,9411,Evgeny Svechnikov,2017-18,21.0,2,0,2,2,0,0,0,4.0,26.0,2,0,0,0,4.0,82,5.45,47,245,2478,9.0,0.24101004
9412,9412,Evgeny Svechnikov,2018-19,22.0,3,4,14,14,2,2,4,15.0,123.0,16,2,2,4,19.0,82,5.86,50,250,2620,9.2,0.253765
9413,9413,Evgeny Svechnikov,2020-21,24.0,4,0,4,4,0,0,0,7.0,33.0,20,2,2,4,26.0,70,5.96,42,208,2192,9.5,0.18040168
9414,9414,Fabian Brunnstrom,2009-10,24.0,2,29,55,55,17,12,29,81.0,639.0,55,17,12,29,81.0,82,5.7,65,341,2477,9.4,0.44359836
9415,9415,Fabian Brunnstrom,2010-11,25.0,3,11,44,44,2,9,11,38.0,469.0,99,19,21,40,119.0,82,5.53,56,304,2486,9.1,0.25447917
9416,9416,Fabian Brunnstrom,2012-13,27.0,4,1,5,5,0,1,1,6.0,45.0,104,19,22,41,125.0,82,5.32,47,271,2439,8.9,0.17960301
9417,9417,Fedor Fedorov,2003-04,22.0,2,1,7,7,0,1,1,2.0,64.0,7,0,1,1,2.0,82,5.31,60,363,2326,9.4,0.17601657
9418,9418,Fedor Fedorov,2004-05,23.0,3,1,8,8,0,1,1,10.0,88.0,15,0,2,2,12.0,82,5.14,57,348,2300,9.2,0.20322418
9419,9419,Fedor Fedorov,2006-07,25.0,4,0,3,3,0,0,0,2.0,29.0,18,0,2,2,14.0,82,6.05,85,480,2458,10.1,0.15220594
9420,9420,Fedor Tyutin,2004-05,21.0,2,7,25,25,2,5,7,33.0,503.0,25,2,5,7,33.0,82,5.14,57,348,2300,9.2,0.30510753
9421,9421,Fedor Tyutin,2006-07,23.0,3,25,77,77,6,19,25,102.0,1583.0,102,8,24,32,135.0,82,6.05,85,480,2458,10.1,0.3560988
9422,9422,Fedor Tyutin,2007-08,24.0,4,14,66,66,2,12,14,75.0,1322.0,168,10,36,46,210.0,82,5.76,70,398,2426,9.7,0.23035741
9423,9423,Fedor Tyutin,2008-09,25.0,5,20,82,82,5,15,20,131.0,1676.0,250,15,51,66,341.0,82,5.44,62,351,2383,9.4,0.30459827
9424,9424,Fedor Tyutin,2009-10,26.0,6,34,82,82,9,25,34,167.0,1928.0,332,24,76,100,508.0,82,5.7,65,341,2477,9.4,0.4258508
9425,9425,Fedor Tyutin,2010-11,27.0,7,32,80,80,6,26,32,149.0,1882.0,412,30,102,132,657.0,82,5.53,56,304,2486,9.1,0.4137591
9426,9426,Fedor Tyutin,2011-12,28.0,8,27,80,80,7,20,27,128.0,1816.0,492,37,122,159,785.0,82,5.46,52,291,2492,9.0,0.32901984
9427,9427,Fedor Tyutin,2012-13,29.0,9,26,66,66,5,21,26,124.0,1593.0,558,42,143,185,909.0,82,5.32,47,271,2439,8.9,0.32455233
9428,9428,Fedor Tyutin,2013-14,30.0,10,22,48,48,4,18,22,56.0,1157.0,606,46,161,207,965.0,48,5.31,29,160,1399,9.1,0.36372745
9429,9429,Fedor Tyutin,2014-15,31.0,11,26,69,69,4,22,26,87.0,1477.0,675,50,183,233,1052.0,82,5.34,48,269,2463,8.9,0.28667566
9430,9430,Fedor Tyutin,2015-16,32.0,12,15,67,67,3,12,15,56.0,1335.0,742,53,195,248,1108.0,82,5.32,47,251,2453,8.9,0.17276603
9431,9431,Fedor Tyutin,2016-17,33.0,13,3,61,61,1,2,3,25.0,1073.0,803,54,197,251,1133.0,82,5.34,48,255,2438,9.0,0.13478997
9432,9432,Fedor Tyutin,2017-18,34.0,14,13,69,69,1,12,13,46.0,1307.0,872,55,209,264,1179.0,82,5.45,47,245,2478,9.0,0.12852216
9433,9433,Fernando Pisani,2003-04,27.0,2,13,35,35,8,5,13,32.0,375.0,35,8,5,13,32.0,82,5.31,60,363,2326,9.4,0.2811768
9434,9434,Fernando Pisani,2004-05,28.0,3,30,76,76,16,14,30,99.0,971.0,111,24,19,43,131.0,82,5.14,57,348,2300,9.2,0.44812724
9435,9435,Fernando Pisani,2006-07,30.0,4,37,80,80,18,19,37,131.0,1108.0,191,42,38,80,262.0,82,6.05,85,480,2458,10.1,0.43019122
9436,9436,Fernando Pisani,2007-08,31.0,5,28,77,77,14,14,28,142.0,1301.0,268,56,52,108,404.0,82,5.76,70,398,2426,9.7,0.37115613
9437,9437,Fernando Pisani,2008-09,32.0,6,22,56,56,13,9,22,96.0,926.0,324,69,61,130,500.0,82,5.44,62,351,2383,9.4,0.3641432
9438,9438,Fernando Pisani,2009-10,33.0,7,15,38,38,7,8,15,72.0,582.0,362,76,69,145,572.0,82,5.7,65,341,2477,9.4,0.3363315
9439,9439,Fernando Pisani,2010-11,34.0,8,8,40,40,4,4,8,54.0,583.0,402,80,73,153,626.0,82,5.53,56,304,2486,9.1,0.21055469
9440,9440,Fernando Pisani,2011-12,35.0,9,16,60,60,7,9,16,72.0,754.0,462,87,82,169,698.0,82,5.46,52,291,2492,9.0,0.2557751
9441,9441,Filip Chlapik,2018-19,21.0,2,4,20,20,1,3,4,21.0,201.0,20,1,3,4,21.0,82,5.86,50,250,2620,9.2,0.24372947
9442,9442,Filip Chlapik,2019-20,22.0,3,1,5,5,1,0,1,9.0,69.0,25,2,3,5,30.0,82,5.96,47,239,2579,9.5,0.23479849
9443,9443,Filip Chlapik,2020-21,23.0,4,6,31,31,3,3,6,27.0,272.0,56,5,6,11,57.0,70,5.96,42,208,2192,9.5,0.25693235
9444,9444,Filip Chytil,2018-19,19.0,2,3,9,9,1,2,3,21.0,122.0,9,1,2,3,21.0,82,5.86,50,250,2620,9.2,0.29354286
9445,9445,Filip Chytil,2019-20,20.0,3,23,75,75,11,12,23,133.0,1034.0,84,12,14,26,154.0,82,5.96,47,239,2579,9.5,0.3844609
9446,9446,Filip Chytil,2020-21,21.0,4,23,60,60,14,9,23,114.0,890.0,144,26,23,49,268.0,70,5.96,42,208,2192,9.5,0.44246608
9447,9447,Filip Forsberg,2013-14,19.0,2,1,5,5,0,1,1,14.0,77.0,5,0,1,1,14.0,48,5.31,29,160,1399,9.1,0.2741931
9448,9448,Filip Forsberg,2014-15,20.0,3,5,13,13,1,4,5,20.0,148.0,18,1,5,6,34.0,82,5.34,48,269,2463,8.9,0.31495324
9449,9449,Filip Forsberg,2015-16,21.0,4,63,82,82,26,37,63,237.0,1421.0,100,27,42,69,271.0,82,5.32,47,251,2453,8.9,0.79491365
9450,9450,Filip Forsberg,2016-17,22.0,5,64,82,82,33,31,64,247.0,1562.0,182,60,73,133,518.0,82,5.34,48,255,2438,9.0,0.78238046
9451,9451,Filip Forsberg,2017-18,23.0,6,58,82,82,31,27,58,234.0,1518.0,264,91,100,191,752.0,82,5.45,47,245,2478,9.0,0.79642475
9452,9452,Filip Forsberg,2018-19,24.0,7,64,67,67,26,38,64,179.0,1171.0,331,117,138,255,931.0,82,5.86,50,250,2620,9.2,0.905595
9453,9453,Filip Forsberg,2019-20,25.0,8,50,64,64,28,22,50,217.0,1191.0,395,145,160,305,1148.0,82,5.96,47,239,2579,9.5,0.77811
9454,9454,Filip Forsberg,2020-21,26.0,9,48,63,63,21,27,48,198.0,1093.0,458,166,187,353,1346.0,70,5.96,42,208,2192,9.5,0.7929466
9455,9455,Filip Hronek,2019-20,22.0,2,23,46,46,5,18,23,73.0,918.0,46,5,18,23,73.0,82,5.96,47,239,2579,9.5,0.41588372
9456,9456,Filip Hronek,2020-21,23.0,3,31,65,65,9,22,31,125.0,1553.0,111,14,40,54,198.0,70,5.96,42,208,2192,9.5,0.46065396
9457,9457,Filip Kuba,1999-00,23.0,2,1,5,5,0,1,1,5.0,112.0,5,0,1,1,5.0,82,5.27,57,359,2285,9.4,0.19362187
9458,9458,Filip Kuba,2000-01,24.0,3,6,13,13,1,5,6,16.0,180.0,18,1,6,7,21.0,82,5.49,53,331,2294,9.8,0.209492
9459,9459,Filip Kuba,2001-02,25.0,4,30,75,75,9,21,30,141.0,1820.0,93,10,27,37,162.0,82,5.51,63,376,2272,9.9,0.3996899
9460,9460,Filip Kuba,2002-03,26.0,5,24,62,62,5,19,24,101.0,1581.0,155,15,46,61,263.0,82,5.24,53,338,2262,9.5,0.35546643
9461,9461,Filip Kuba,2003-04,27.0,6,29,78,78,8,21,29,129.0,1867.0,233,23,67,90,392.0,82,5.31,60,363,2326,9.4,0.36957496
9462,9462,Filip Kuba,2004-05,28.0,7,24,77,77,5,19,24,114.0,1856.0,310,28,86,114,506.0,82,5.14,57,348,2300,9.2,0.34023434
9463,9463,Filip Kuba,2006-07,30.0,8,25,65,65,6,19,25,69.0,1415.0,375,34,105,139,575.0,82,6.05,85,480,2458,10.1,0.30366492
9464,9464,Filip Kuba,2007-08,31.0,9,37,81,81,15,22,37,106.0,1637.0,456,49,127,176,681.0,82,5.76,70,398,2426,9.7,0.40481883
9465,9465,Filip Kuba,2008-09,32.0,10,31,75,75,6,25,31,113.0,1872.0,531,55,152,207,794.0,82,5.44,62,351,2383,9.4,0.3543575
9466,9466,Filip Kuba,2009-10,33.0,11,40,71,71,3,37,40,111.0,1653.0,602,58,189,247,905.0,82,5.7,65,341,2477,9.4,0.40913075
9467,9467,Filip Kuba,2010-11,34.0,12,28,53,53,3,25,28,90.0,1211.0,655,61,214,275,995.0,82,5.53,56,304,2486,9.1,0.43101782
9468,9468,Filip Kuba,2011-12,35.0,13,16,64,64,2,14,16,76.0,1327.0,719,63,228,291,1071.0,82,5.46,52,291,2492,9.0,0.22376806
9469,9469,Filip Kuba,2012-13,36.0,14,32,73,73,6,26,32,78.0,1724.0,792,69,254,323,1149.0,82,5.32,47,271,2439,8.9,0.3207032
9470,9470,Filip Kuba,2013-14,37.0,15,10,44,44,1,9,10,50.0,934.0,836,70,263,333,1199.0,48,5.31,29,160,1399,9.1,0.20857534
9471,9471,Filip Novak,2006-07,24.0,2,0,11,11,0,0,0,5.0,104.0,11,0,0,0,5.0,82,6.05,85,480,2458,10.1,0.16140214
9472,9472,Filip Novak,2007-08,25.0,3,0,6,6,0,0,0,3.0,60.0,17,0,0,0,8.0,82,5.76,70,398,2426,9.7,0.15777099
9473,9473,Filip Zadina,2019-20,20.0,2,3,9,9,1,2,3,18.0,138.0,9,1,2,3,18.0,82,5.96,47,239,2579,9.5,0.30624747
9474,9474,Filip Zadina,2020-21,21.0,3,15,28,28,8,7,15,60.0,425.0,37,9,9,18,78.0,70,5.96,42,208,2192,9.5,0.4643864
9475,9475,Florent Robidoux,1981-82,21.0,2,8,39,39,6,2,8,31.0,,39,6,2,8,31.0,80,7.69,77,340,2441,12.6,0.32806778
9476,9476,Florent Robidoux,1982-83,22.0,3,3,4,4,1,2,3,4.0,,43,7,4,11,35.0,80,8.03,73,320,2489,12.9,0.27080685
9477,9477,Florent Robidoux,1984-85,24.0,4,0,9,9,0,0,0,2.0,,52,7,4,11,37.0,80,7.89,74,336,2448,12.9,0.2029866
9478,9478,Francis Belanger,2001-02,24.0,2,0,10,10,0,0,0,2.0,45.0,10,0,0,0,2.0,82,5.51,63,376,2272,9.9,0.15320021
9479,9479,Francis Bouillon,2000-01,25.0,2,16,74,74,3,13,16,76.0,1174.0,74,3,13,16,76.0,82,5.49,53,331,2294,9.8,0.22913244
9480,9480,Francis Bouillon,2001-02,26.0,3,6,29,29,0,6,6,24.0,389.0,103,3,19,22,100.0,82,5.51,63,376,2272,9.9,0.18950894
9481,9481,Francis Bouillon,2002-03,27.0,4,5,28,28,0,5,5,24.0,526.0,131,3,24,27,124.0,82,5.24,53,338,2262,9.5,0.15779626
9482,9482,Francis Bouillon,2003-04,28.0,5,4,24,24,3,1,4,30.0,459.0,155,6,25,31,154.0,82,5.31,60,363,2326,9.4,0.19626123
9483,9483,Francis Bouillon,2004-05,29.0,6,18,73,73,2,16,18,86.0,1435.0,228,8,41,49,240.0,82,5.14,57,348,2300,9.2,0.25849462
9484,9484,Francis Bouillon,2006-07,31.0,7,22,67,67,3,19,22,75.0,1392.0,295,11,60,71,315.0,82,6.05,85,480,2458,10.1,0.23262379
9485,9485,Francis Bouillon,2007-08,32.0,8,14,62,62,3,11,14,56.0,1135.0,357,14,71,85,371.0,82,5.76,70,398,2426,9.7,0.1627158
9486,9486,Francis Bouillon,2008-09,33.0,9,8,74,74,2,6,8,60.0,1285.0,431,16,77,93,431.0,82,5.44,62,351,2383,9.4,0.16384438
9487,9487,Francis Bouillon,2009-10,34.0,10,9,54,54,5,4,9,51.0,891.0,485,21,81,102,482.0,82,5.7,65,341,2477,9.4,0.16665417
9488,9488,Francis Bouillon,2010-11,35.0,11,11,81,81,3,8,11,86.0,1564.0,566,24,89,113,568.0,82,5.53,56,304,2486,9.1,0.15553084
9489,9489,Francis Bouillon,2011-12,36.0,12,10,44,44,1,9,10,47.0,890.0,610,25,98,123,615.0,82,5.46,52,291,2492,9.0,0.1515927
9490,9490,Francis Bouillon,2012-13,37.0,13,11,66,66,4,7,11,38.0,1158.0,676,29,105,134,653.0,82,5.32,47,271,2439,8.9,0.12566563
9491,9491,Francis Bouillon,2013-14,38.0,14,9,48,48,1,8,9,46.0,868.0,724,30,113,143,699.0,48,5.31,29,160,1399,9.1,0.15795866
9492,9492,Francis Bouillon,2014-15,39.0,15,6,52,52,2,4,6,34.0,920.0,776,32,117,149,733.0,82,5.34,48,269,2463,8.9,0.115092784
9493,9493,Francis Breault,1991-92,24.0,2,5,17,17,1,4,5,12.0,,17,1,4,5,12.0,80,6.91,71,366,2385,11.6,0.24850044
9494,9494,Francis Breault,1992-93,25.0,3,1,6,6,1,0,1,6.0,,23,2,4,6,18.0,80,6.96,77,402,2440,11.4,0.21537742
9495,9495,Francis Breault,1993-94,26.0,4,0,4,4,0,0,0,0.0,,27,2,4,6,18.0,84,7.25,87,443,2603,11.7,0.16826773
9496,9496,Francis Lessard,2002-03,23.0,2,0,5,5,0,0,0,2.0,64.0,5,0,0,0,2.0,82,5.24,53,338,2262,9.5,0.17551199
9497,9497,Francis Lessard,2003-04,24.0,3,2,18,18,0,2,2,7.0,102.0,23,0,2,2,9.0,82,5.31,60,363,2326,9.4,0.15790018
9498,9498,Francis Lessard,2004-05,25.0,4,2,62,62,1,1,2,19.0,277.0,85,1,3,4,28.0,82,5.14,57,348,2300,9.2,0.115058064
9499,9499,Francis Lessard,2006-07,27.0,5,0,6,6,0,0,0,0.0,15.0,91,1,3,4,28.0,82,6.05,85,480,2458,10.1,0.10918203
9500,9500,Francis Lessard,2011-12,32.0,6,0,24,24,0,0,0,6.0,93.0,115,1,3,4,34.0,82,5.46,52,291,2492,9.0,0.07656136
9501,9501,Francis Wathier,2010-11,26.0,2,0,5,5,0,0,0,4.0,26.0,5,0,0,0,4.0,82,5.53,56,304,2486,9.1,0.16698298
9502,9502,Francis Wathier,2011-12,27.0,3,0,3,3,0,0,0,0.0,12.0,8,0,0,0,4.0,82,5.46,52,291,2492,9.0,0.13624889
9503,9503,Francis Wathier,2012-13,28.0,4,0,1,1,0,0,0,0.0,5.0,9,0,0,0,4.0,82,5.32,47,271,2439,8.9,0.13322994
9504,9504,Francis Wathier,2013-14,29.0,5,0,1,1,0,0,0,0.0,6.0,10,0,0,0,4.0,48,5.31,29,160,1399,9.1,0.2068739
9505,9505,Francois Beauchemin,2003-04,23.0,2,0,1,1,0,0,0,1.0,17.0,1,0,0,0,1.0,82,5.31,60,363,2326,9.4,0.18287873
9506,9506,Francois Beauchemin,2006-07,26.0,3,36,72,72,8,28,36,137.0,1668.0,73,8,28,36,138.0,82,6.05,85,480,2458,10.1,0.44604614
9507,9507,Francois Beauchemin,2007-08,27.0,4,28,71,71,7,21,28,128.0,1809.0,144,15,49,64,266.0,82,5.76,70,398,2426,9.7,0.36297947
9508,9508,Francois Beauchemin,2008-09,28.0,5,21,82,82,2,19,21,144.0,2093.0,226,17,68,85,410.0,82,5.44,62,351,2383,9.4,0.3006871
9509,9509,Francois Beauchemin,2009-10,29.0,6,5,20,20,4,1,5,45.0,498.0,246,21,69,90,455.0,82,5.7,65,341,2477,9.4,0.25896084
9510,9510,Francois Beauchemin,2010-11,30.0,7,26,82,82,5,21,26,170.0,2088.0,328,26,90,116,625.0,82,5.53,56,304,2486,9.1,0.3501529
9511,9511,Francois Beauchemin,2011-12,31.0,8,17,81,81,5,12,17,106.0,1869.0,409,31,102,133,731.0,82,5.46,52,291,2492,9.0,0.23840362
9512,9512,Francois Beauchemin,2012-13,32.0,9,22,82,82,8,14,22,139.0,2095.0,491,39,116,155,870.0,82,5.32,47,271,2439,8.9,0.28161782
9513,9513,Francois Beauchemin,2013-14,33.0,10,24,48,48,6,18,24,74.0,1126.0,539,45,134,179,944.0,48,5.31,29,160,1399,9.1,0.39810532
9514,9514,Francois Beauchemin,2014-15,34.0,11,17,70,70,4,13,17,100.0,1617.0,609,49,147,196,1044.0,82,5.34,48,269,2463,8.9,0.22438666
9515,9515,Francois Beauchemin,2015-16,35.0,12,23,64,64,11,12,23,110.0,1456.0,673,60,159,219,1154.0,82,5.32,47,251,2453,8.9,0.29110265
9516,9516,Francois Beauchemin,2016-17,36.0,13,34,82,82,8,26,34,127.0,2057.0,755,68,185,253,1281.0,82,5.34,48,255,2438,9.0,0.32646978
9517,9517,Francois Beauchemin,2017-18,37.0,14,18,81,81,5,13,18,132.0,1743.0,836,73,198,271,1413.0,82,5.45,47,245,2478,9.0,0.23483008
9518,9518,Francois Beauchemin,2018-19,38.0,15,17,67,67,3,14,17,93.0,1160.0,903,76,212,288,1506.0,82,5.86,50,250,2620,9.2,0.21414071
9519,9519,Francois Groleau,1996-97,24.0,2,1,2,2,0,1,1,1.0,,2,0,1,1,1.0,82,6.29,74,413,2481,10.4,0.17837283
9520,9520,Francois Groleau,1997-98,25.0,3,0,5,5,0,0,0,3.0,,7,0,1,1,4.0,82,5.83,55,336,2444,9.8,0.1596331
9521,9521,Francois Groleau,1998-99,26.0,4,0,1,1,0,0,0,3.0,,8,0,1,1,7.0,82,5.28,57,380,2242,9.6,0.16132897
9522,9522,Francois Guay,1990-91,22.0,2,0,1,1,0,0,0,0.0,,1,0,0,0,0.0,80,7.37,76,367,2421,12.2,0.19196308
9523,9523,Francois Leroux,1989-90,19.0,2,0,2,2,0,0,0,0.0,,2,0,0,0,0.0,80,7.48,85,403,2430,12.3,0.23472664
9524,9524,Francois Leroux,1990-91,20.0,3,1,3,3,0,1,1,0.0,,5,0,1,1,0.0,80,7.37,76,367,2421,12.2,0.43382567
9525,9525,Francois Leroux,1991-92,21.0,4,2,1,1,0,2,2,1.0,,6,0,3,3,1.0,80,6.91,71,366,2385,11.6,0.26880294
9526,9526,Francois Leroux,1992-93,22.0,5,0,4,4,0,0,0,0.0,,10,0,3,3,1.0,80,6.96,77,402,2440,11.4,0.18717986
9527,9527,Francois Leroux,1993-94,23.0,6,0,1,1,0,0,0,0.0,,11,0,3,3,1.0,84,7.25,87,443,2603,11.7,0.1785295
9528,9528,Francois Leroux,1994-95,24.0,7,1,23,23,0,1,1,8.0,,34,0,4,4,9.0,84,6.48,76,407,2545,10.7,0.12232152
9529,9529,Francois Leroux,1995-96,25.0,8,2,40,40,0,2,2,19.0,,74,0,6,6,28.0,48,5.97,37,209,1408,10.2,0.09845561
9530,9530,Francois Leroux,1996-97,26.0,9,11,66,66,2,9,11,43.0,,140,2,15,17,71.0,82,6.29,74,413,2481,10.4,0.14695796
9531,9531,Francois Leroux,1997-98,27.0,10,3,59,59,0,3,3,5.0,,199,2,18,20,76.0,82,5.83,55,336,2444,9.8,0.06618807
9532,9532,Francois Leroux,1998-99,28.0,11,3,50,50,1,2,3,14.0,,249,3,20,23,90.0,82,5.28,57,380,2242,9.6,0.0660696
9533,9533,Frank Banham,1997-98,22.0,2,0,3,3,0,0,0,1.0,,3,0,0,0,1.0,82,5.83,55,336,2444,9.8,0.16294318
9534,9534,Frank Banham,1998-99,23.0,3,11,21,21,9,2,11,43.0,,24,9,2,11,44.0,82,5.28,57,380,2242,9.6,0.34825063
9535,9535,Frank Banham,2000-01,25.0,4,0,3,3,0,0,0,4.0,20.0,27,9,2,11,48.0,82,5.49,53,331,2294,9.8,0.15608597
9536,9536,Frank Banham,2003-04,28.0,5,0,5,5,0,0,0,5.0,39.0,32,9,2,11,53.0,82,5.31,60,363,2326,9.4,0.14400521
9537,9537,Frank Bialowas,1994-95,25.0,2,0,3,3,0,0,0,1.0,,3,0,0,0,1.0,84,6.48,76,407,2545,10.7,0.16115752
9538,9538,Frank Corrado,2013-14,20.0,2,0,3,3,0,0,0,4.0,58.0,3,0,0,0,4.0,48,5.31,29,160,1399,9.1,0.23965779
9539,9539,Frank Corrado,2014-15,21.0,3,1,15,15,1,0,1,20.0,188.0,18,1,0,1,24.0,82,5.34,48,269,2463,8.9,0.22223833
9540,9540,Frank Corrado,2015-16,22.0,4,1,10,10,1,0,1,8.0,157.0,28,2,0,2,32.0,82,5.32,47,251,2453,8.9,0.20863211
9541,9541,Frank Corrado,2016-17,23.0,5,6,39,39,1,5,6,46.0,564.0,67,3,5,8,78.0,82,5.34,48,255,2438,9.0,0.2111899
9542,9542,Frank Corrado,2017-18,24.0,6,0,4,4,0,0,0,3.0,43.0,71,3,5,8,81.0,82,5.45,47,245,2478,9.0,0.1523799
9543,9543,Frank Corrado,2018-19,25.0,7,0,5,5,0,0,0,6.0,58.0,76,3,5,8,87.0,82,5.86,50,250,2620,9.2,0.14978036
9544,9544,Frank Nigro,1983-84,23.0,2,21,51,51,6,15,21,77.0,,51,6,15,21,77.0,80,7.73,71,310,2444,12.7,0.43131477
9545,9545,Frank Nigro,1984-85,24.0,3,5,17,17,2,3,5,18.0,,68,8,18,26,95.0,80,7.89,74,336,2448,12.9,0.3368926
9546,9546,Frank Simonetti,1985-86,23.0,2,6,43,43,1,5,6,36.0,,43,1,5,6,36.0,80,7.77,71,321,2447,12.7,0.21695825
9547,9547,Frank Simonetti,1986-87,24.0,3,1,17,17,1,0,1,8.0,,60,2,5,7,44.0,80,7.94,82,370,2484,12.8,0.19486329
9548,9548,Frank Simonetti,1987-88,25.0,4,1,25,25,1,0,1,11.0,,85,3,5,8,55.0,80,7.34,72,344,2400,12.2,0.15409586
9549,9549,Frank Simonetti,1988-89,26.0,5,5,30,30,2,3,5,20.0,,115,5,8,13,75.0,80,7.43,89,437,2435,12.2,0.23213518
9550,9550,Frank Vatrano,2016-17,22.0,2,11,39,39,8,3,11,99.0,463.0,39,8,3,11,99.0,82,5.34,48,255,2438,9.0,0.34450686
9551,9551,Frank Vatrano,2017-18,23.0,3,18,44,44,10,8,18,116.0,593.0,83,18,11,29,215.0,82,5.45,47,245,2478,9.0,0.41407755
9552,9552,Frank Vatrano,2018-19,24.0,4,10,41,41,7,3,10,72.0,444.0,124,25,14,39,287.0,82,5.86,50,250,2620,9.2,0.32437384
9553,9553,Frank Vatrano,2019-20,25.0,5,39,81,81,24,15,39,208.0,1188.0,205,49,29,78,495.0,82,5.96,47,239,2579,9.5,0.55209863
9554,9554,Frank Vatrano,2020-21,26.0,6,34,69,69,16,18,34,162.0,1036.0,274,65,47,112,657.0,70,5.96,42,208,2192,9.5,0.5083756
9555,9555,Frans Nielsen,2007-08,23.0,2,2,15,15,1,1,2,16.0,78.0,15,1,1,2,16.0,82,5.76,70,398,2426,9.7,0.21429601
9556,9556,Frans Nielsen,2008-09,24.0,3,3,16,16,2,1,3,17.0,139.0,31,3,2,5,33.0,82,5.44,62,351,2383,9.4,0.23023173
9557,9557,Frans Nielsen,2009-10,25.0,4,33,59,59,9,24,33,101.0,976.0,90,12,26,38,134.0,82,5.7,65,341,2477,9.4,0.47519502
9558,9558,Frans Nielsen,2010-11,26.0,5,38,76,76,12,26,38,136.0,1308.0,166,24,52,76,270.0,82,5.53,56,304,2486,9.1,0.46230718
9559,9559,Frans Nielsen,2011-12,27.0,6,44,71,71,13,31,44,156.0,1261.0,237,37,83,120,426.0,82,5.46,52,291,2492,9.0,0.5330511
9560,9560,Frans Nielsen,2012-13,28.0,7,47,82,82,17,30,47,133.0,1431.0,319,54,113,167,559.0,82,5.32,47,271,2439,8.9,0.56285906
9561,9561,Frans Nielsen,2013-14,29.0,8,29,48,48,6,23,29,93.0,865.0,367,60,136,196,652.0,48,5.31,29,160,1399,9.1,0.56826967
9562,9562,Frans Nielsen,2014-15,30.0,9,58,80,80,25,33,58,167.0,1467.0,447,85,169,254,819.0,82,5.34,48,269,2463,8.9,0.59896153
9563,9563,Frans Nielsen,2015-16,31.0,10,43,78,78,14,29,43,157.0,1293.0,525,99,198,297,976.0,82,5.32,47,251,2453,8.9,0.5183112
9564,9564,Frans Nielsen,2016-17,32.0,11,52,81,81,20,32,52,181.0,1435.0,606,119,230,349,1157.0,82,5.34,48,255,2438,9.0,0.57534593
9565,9565,Frans Nielsen,2017-18,33.0,12,41,79,79,17,24,41,162.0,1355.0,685,136,254,390,1319.0,82,5.45,47,245,2478,9.0,0.4929509
9566,9566,Frans Nielsen,2018-19,34.0,13,33,79,79,16,17,33,134.0,1250.0,764,152,271,423,1453.0,82,5.86,50,250,2620,9.2,0.3859459
9567,9567,Frans Nielsen,2019-20,35.0,14,35,72,72,10,25,35,120.0,1201.0,836,162,296,458,1573.0,82,5.96,47,239,2579,9.5,0.35844618
9568,9568,Frans Nielsen,2020-21,36.0,15,9,60,60,4,5,9,86.0,821.0,896,166,301,467,1659.0,70,5.96,42,208,2192,9.5,0.20344973
9569,9569,Frantisek Cernik,1985-86,32.0,2,9,49,49,5,4,9,50.0,,49,5,4,9,50.0,80,7.77,71,321,2447,12.7,0.20660347
9570,9570,Frantisek Kaberle,2000-01,27.0,2,16,51,51,1,15,16,76.0,977.0,51,1,15,16,76.0,82,5.49,53,331,2294,9.8,0.28549784
9571,9571,Frantisek Kaberle,2001-02,28.0,3,15,51,51,4,11,15,99.0,1136.0,102,5,26,31,175.0,82,5.51,63,376,2272,9.9,0.282525
9572,9572,Frantisek Kaberle,2002-03,29.0,4,25,61,61,5,20,25,82.0,1316.0,163,10,46,56,257.0,82,5.24,53,338,2262,9.5,0.30672076
9573,9573,Frantisek Kaberle,2003-04,30.0,5,26,79,79,7,19,26,105.0,1734.0,242,17,65,82,362.0,82,5.31,60,363,2326,9.4,0.3061889
9574,9574,Frantisek Kaberle,2004-05,31.0,6,29,67,67,3,26,29,94.0,1563.0,309,20,91,111,456.0,82,5.14,57,348,2300,9.2,0.4202039
9575,9575,Frantisek Kaberle,2006-07,33.0,7,44,77,77,6,38,44,126.0,1510.0,386,26,129,155,582.0,82,6.05,85,480,2458,10.1,0.44169
9576,9576,Frantisek Kaberle,2007-08,34.0,8,8,27,27,2,6,8,33.0,419.0,413,28,135,163,615.0,82,5.76,70,398,2426,9.7,0.22440779
9577,9577,Frantisek Kaberle,2008-09,35.0,9,22,80,80,0,22,22,89.0,1372.0,493,28,157,185,704.0,82,5.44,62,351,2383,9.4,0.24888435
9578,9578,Frantisek Kaberle,2009-10,36.0,10,8,30,30,1,7,8,28.0,422.0,523,29,164,193,732.0,82,5.7,65,341,2477,9.4,0.21099192
9579,9579,Frantisek Kucera,1991-92,23.0,2,14,40,40,2,12,14,65.0,,40,2,12,14,65.0,80,6.91,71,366,2385,11.6,0.30859858
9580,9580,Frantisek Kucera,1992-93,24.0,3,13,61,61,3,10,13,82.0,,101,5,22,27,147.0,80,6.96,77,402,2440,11.4,0.30387896
9581,9581,Frantisek Kucera,1993-94,25.0,4,19,71,71,5,14,19,117.0,,172,10,36,46,264.0,84,7.25,87,443,2603,11.7,0.27726007
9582,9582,Frantisek Kucera,1994-95,26.0,5,21,76,76,5,16,21,122.0,,248,15,52,67,386.0,84,6.48,76,407,2545,10.7,0.26244903
9583,9583,Frantisek Kucera,1995-96,27.0,6,20,48,48,3,17,20,73.0,,296,18,69,87,459.0,48,5.97,37,209,1408,10.2,0.3673867
9584,9584,Frantisek Kucera,1996-97,28.0,7,9,54,54,3,6,9,77.0,,350,21,75,96,536.0,82,6.29,74,413,2481,10.4,0.21359086
9585,9585,Frantisek Kucera,1997-98,29.0,8,0,4,4,0,0,0,5.0,,354,21,75,96,541.0,82,5.83,55,336,2444,9.8,0.20875916
9586,9586,Frantisek Kucera,2001-02,33.0,9,9,55,55,2,7,9,60.0,965.0,409,23,82,105,601.0,82,5.51,63,376,2272,9.9,0.17752594
9587,9587,Frantisek Kucera,2002-03,34.0,10,14,56,56,1,13,14,67.0,1157.0,465,24,95,119,668.0,82,5.24,53,338,2262,9.5,0.1665892
9588,9588,Frantisek Musil,1987-88,23.0,2,11,72,72,2,9,11,83.0,,72,2,9,11,83.0,80,7.34,72,344,2400,12.2,0.26228154
9589,9589,Frantisek Musil,1988-89,24.0,3,17,80,80,9,8,17,78.0,,152,11,17,28,161.0,80,7.43,89,437,2435,12.2,0.26761693
9590,9590,Frantisek Musil,1989-90,25.0,4,20,55,55,1,19,20,78.0,,207,12,36,48,239.0,80,7.48,85,403,2430,12.3,0.33191773
9591,9591,Frantisek Musil,1990-91,26.0,5,10,56,56,2,8,10,78.0,,263,14,44,58,317.0,80,7.37,76,367,2421,12.2,0.2758423
9592,9592,Frantisek Musil,1991-92,27.0,6,23,75,75,7,16,23,73.0,,338,21,60,81,390.0,80,6.91,71,366,2385,11.6,0.26914418
9593,9593,Frantisek Musil,1992-93,28.0,7,12,78,78,4,8,12,71.0,,416,25,68,93,461.0,80,6.96,77,402,2440,11.4,0.21171895
9594,9594,Frantisek Musil,1993-94,29.0,8,16,80,80,6,10,16,87.0,,496,31,78,109,548.0,84,7.25,87,443,2603,11.7,0.21798766
9595,9595,Frantisek Musil,1994-95,30.0,9,9,75,75,1,8,9,65.0,,571,32,86,118,613.0,84,6.48,76,407,2545,10.7,0.15424272
9596,9596,Frantisek Musil,1995-96,31.0,10,5,35,35,0,5,5,18.0,,606,32,91,123,631.0,48,5.97,37,209,1408,10.2,0.13315609
9597,9597,Frantisek Musil,1996-97,32.0,11,4,65,65,1,3,4,37.0,,671,33,94,127,668.0,82,6.29,74,413,2481,10.4,0.12093815
9598,9598,Frantisek Musil,1997-98,33.0,12,5,57,57,0,5,5,24.0,,728,33,99,132,692.0,82,5.83,55,336,2444,9.8,0.09234938
9599,9599,Frantisek Musil,1998-99,34.0,13,3,17,17,1,2,3,8.0,,745,34,101,135,700.0,82,5.28,57,380,2242,9.6,0.13189656
9600,9600,Frantisek Musil,1999-00,35.0,14,3,39,39,0,3,3,9.0,560.0,784,34,104,138,709.0,82,5.27,57,359,2285,9.4,0.07954207
9601,9601,Frantisek Musil,2001-02,37.0,15,2,13,13,0,2,2,0.0,145.0,797,34,106,140,709.0,82,5.51,63,376,2272,9.9,0.2700625
9602,9602,Frazer McLaren,2010-11,23.0,2,6,23,23,1,5,6,13.0,139.0,23,1,5,6,13.0,82,5.53,56,304,2486,9.1,0.19024041
9603,9603,Frazer McLaren,2011-12,24.0,3,0,9,9,0,0,0,1.0,38.0,32,1,5,6,14.0,82,5.46,52,291,2492,9.0,0.14725268
9604,9604,Frazer McLaren,2012-13,25.0,4,0,7,7,0,0,0,2.0,34.0,39,1,5,6,16.0,82,5.32,47,271,2439,8.9,0.14534602
9605,9605,Frazer McLaren,2013-14,26.0,5,5,36,36,3,2,5,20.0,187.0,75,4,7,11,36.0,48,5.31,29,160,1399,9.1,0.17129114
9606,9606,Frazer McLaren,2014-15,27.0,6,0,27,27,0,0,0,4.0,108.0,102,4,7,11,40.0,82,5.34,48,269,2463,8.9,0.08941552
9607,9607,Fred Arthur,1981-82,20.0,2,0,3,3,0,0,0,3.0,,3,0,0,0,3.0,80,7.69,77,340,2441,12.6,0.28836784
9608,9608,Fred Arthur,1982-83,21.0,3,8,74,74,1,7,8,33.0,,77,1,7,8,36.0,80,8.03,73,320,2489,12.9,0.22148296
9609,9609,Fred Arthur,1983-84,22.0,4,1,3,3,0,1,1,1.0,,80,1,8,9,37.0,80,7.73,71,310,2444,12.7,0.20435917
9610,9610,Fred Boimistruck,1982-83,21.0,2,13,57,57,2,11,13,48.0,,57,2,11,13,48.0,80,8.03,73,320,2489,12.9,0.2941245
9611,9611,Fred Boimistruck,1983-84,22.0,3,5,26,26,2,3,5,26.0,,83,4,14,18,74.0,80,7.73,71,310,2444,12.7,0.31841278
9612,9612,Fred Knipscheer,1994-95,25.0,2,5,11,11,3,2,5,15.0,,11,3,2,5,15.0,84,6.48,76,407,2545,10.7,0.26368505
9613,9613,Fred Knipscheer,1995-96,26.0,3,4,16,16,3,1,4,20.0,,27,6,3,9,35.0,48,5.97,37,209,1408,10.2,0.27963528
9614,9614,Fred Knipscheer,1996-97,27.0,4,0,1,1,0,0,0,2.0,,28,6,3,9,37.0,82,6.29,74,413,2481,10.4,0.15122849
9615,9615,Fred Perlini,1982-83,20.0,2,5,7,7,2,3,5,12.0,,7,2,3,5,12.0,80,8.03,73,320,2489,12.9,0.37894407
9616,9616,Fred Perlini,1984-85,22.0,3,0,1,1,0,0,0,3.0,,8,2,3,5,15.0,80,7.89,74,336,2448,12.9,0.24025479
9617,9617,Freddie Hamilton,2014-15,23.0,2,0,11,11,0,0,0,13.0,114.0,11,0,0,0,13.0,82,5.34,48,269,2463,8.9,0.18161383
9618,9618,Freddie Hamilton,2015-16,24.0,3,1,18,18,1,0,1,11.0,136.0,29,1,0,1,24.0,82,5.32,47,251,2453,8.9,0.1901246
9619,9619,Freddie Hamilton,2016-17,25.0,4,2,4,4,1,1,2,7.0,51.0,33,2,1,3,31.0,82,5.34,48,255,2438,9.0,0.18463284
9620,9620,Freddie Hamilton,2017-18,26.0,5,2,26,26,2,0,2,30.0,254.0,59,4,1,5,61.0,82,5.45,47,245,2478,9.0,0.17263094
9621,9621,Freddie Hamilton,2018-19,27.0,6,1,16,16,0,1,1,12.0,144.0,75,4,2,6,73.0,82,5.86,50,250,2620,9.2,0.1420551
9622,9622,Freddy Meyer,2004-05,24.0,2,0,1,1,0,0,0,1.0,15.0,1,0,0,0,1.0,82,5.14,57,348,2300,9.2,0.25496042
9623,9623,Freddy Meyer,2006-07,26.0,3,27,57,57,6,21,27,68.0,1023.0,58,6,21,27,69.0,82,6.05,85,480,2458,10.1,0.36966765
9624,9624,Freddy Meyer,2007-08,27.0,4,8,60,60,2,6,8,41.0,1048.0,118,8,27,35,110.0,82,5.76,70,398,2426,9.7,0.18886745
9625,9625,Freddy Meyer,2008-09,28.0,5,12,57,57,3,9,12,51.0,1069.0,175,11,36,47,161.0,82,5.44,62,351,2383,9.4,0.20582807
9626,9626,Freddy Meyer,2009-10,29.0,6,9,27,27,4,5,9,36.0,567.0,202,15,41,56,197.0,82,5.7,65,341,2477,9.4,0.22221333
9627,9627,Freddy Meyer,2010-11,30.0,7,15,64,64,4,11,15,56.0,1073.0,266,19,52,71,253.0,82,5.53,56,304,2486,9.1,0.17855579
9628,9628,Freddy Meyer,2011-12,31.0,8,2,15,15,1,1,2,11.0,229.0,281,20,53,73,264.0,82,5.46,52,291,2492,9.0,0.18429434
9629,9629,Frederick Gaudreau,2017-18,24.0,2,1,9,9,0,1,1,8.0,78.0,9,0,1,1,8.0,82,5.45,47,245,2478,9.0,0.18880245
9630,9630,Frederick Gaudreau,2018-19,25.0,3,3,20,20,0,3,3,14.0,183.0,29,0,4,4,22.0,82,5.86,50,250,2620,9.2,0.12598243
9631,9631,Frederick Gaudreau,2019-20,26.0,4,4,55,55,3,1,4,43.0,496.0,84,3,5,8,65.0,82,5.96,47,239,2579,9.5,0.14804268
9632,9632,Frederik Gauthier,2016-17,21.0,2,1,7,7,0,1,1,3.0,97.0,7,0,1,1,3.0,82,5.34,48,255,2438,9.0,0.24059772
9633,9633,Frederik Gauthier,2017-18,22.0,3,3,21,21,2,1,3,15.0,204.0,28,2,2,4,18.0,82,5.45,47,245,2478,9.0,0.21491185
9634,9634,Frederik Gauthier,2018-19,23.0,4,1,9,9,1,0,1,12.0,79.0,37,3,2,5,30.0,82,5.86,50,250,2620,9.2,0.22224629
9635,9635,Frederik Gauthier,2019-20,24.0,5,14,70,70,3,11,14,46.0,586.0,107,6,13,19,76.0,82,5.96,47,239,2579,9.5,0.19531542
9636,9636,Frederik Gauthier,2020-21,25.0,6,12,61,61,7,5,12,42.0,573.0,168,13,18,31,118.0,70,5.96,42,208,2192,9.5,0.22343662
9637,9637,Fredrik Bremberg,1999-00,26.0,2,0,8,8,0,0,0,6.0,98.0,8,0,0,0,6.0,82,5.27,57,359,2285,9.4,0.16484177
9638,9638,Fredrik Claesson,2016-17,24.0,2,2,16,16,0,2,2,15.0,309.0,16,0,2,2,15.0,82,5.34,48,255,2438,9.0,0.17417029
9639,9639,Fredrik Claesson,2017-18,25.0,3,11,33,33,3,8,11,25.0,434.0,49,3,10,13,40.0,82,5.45,47,245,2478,9.0,0.22504985
9640,9640,Fredrik Claesson,2018-19,26.0,4,7,64,64,1,6,7,60.0,982.0,113,4,16,20,100.0,82,5.86,50,250,2620,9.2,0.16476518
9641,9641,Fredrik Claesson,2019-20,27.0,5,6,37,37,2,4,6,44.0,638.0,150,6,20,26,144.0,82,5.96,47,239,2579,9.5,0.17101425
9642,9642,Fredrik Claesson,2020-21,28.0,6,2,5,5,1,1,2,1.0,72.0,155,7,21,28,145.0,70,5.96,42,208,2192,9.5,0.17288974
9643,9643,Fredrik Modin,1997-98,23.0,2,13,76,76,6,7,13,85.0,,76,6,7,13,85.0,82,5.83,55,336,2444,9.8,0.24521181
9644,9644,Fredrik Modin,1998-99,24.0,3,32,74,74,16,16,32,137.0,,150,22,23,45,222.0,82,5.28,57,380,2242,9.6,0.45510828
9645,9645,Fredrik Modin,1999-00,25.0,4,31,67,67,16,15,31,108.0,909.0,217,38,38,76,330.0,82,5.27,57,359,2285,9.4,0.4873893
9646,9646,Fredrik Modin,2000-01,26.0,5,48,80,80,22,26,48,167.0,1243.0,297,60,64,124,497.0,82,5.49,53,331,2294,9.8,0.58721477
9647,9647,Fredrik Modin,2001-02,27.0,6,56,76,76,32,24,56,217.0,1312.0,373,92,88,180,714.0,82,5.51,63,376,2272,9.9,0.6550306
9648,9648,Fredrik Modin,2002-03,28.0,7,31,54,54,14,17,31,141.0,1031.0,427,106,105,211,855.0,82,5.24,53,338,2262,9.5,0.6440282
9649,9649,Fredrik Modin,2003-04,29.0,8,40,76,76,17,23,40,179.0,1336.0,503,123,128,251,1034.0,82,5.31,60,363,2326,9.4,0.53209865
9650,9650,Fredrik Modin,2004-05,30.0,9,57,82,82,29,28,57,206.0,1492.0,585,152,156,308,1240.0,82,5.14,57,348,2300,9.2,0.7337763
9651,9651,Fredrik Modin,2006-07,32.0,10,54,77,77,31,23,54,221.0,1508.0,662,183,179,362,1461.0,82,6.05,85,480,2458,10.1,0.64918864
9652,9652,Fredrik Modin,2007-08,33.0,11,42,79,79,22,20,42,220.0,1510.0,741,205,199,404,1681.0,82,5.76,70,398,2426,9.7,0.5297634
9653,9653,Fredrik Modin,2008-09,34.0,12,12,23,23,6,6,12,41.0,387.0,764,211,205,416,1722.0,82,5.44,62,351,2383,9.4,0.36438233
9654,9654,Fredrik Modin,2009-10,35.0,13,25,50,50,9,16,25,113.0,844.0,814,220,221,441,1835.0,82,5.7,65,341,2477,9.4,0.45911562
9655,9655,Fredrik Modin,2010-11,36.0,14,11,44,44,5,6,11,67.0,650.0,858,225,227,452,1902.0,82,5.53,56,304,2486,9.1,0.2258974
9656,9656,Fredrik Modin,2011-12,37.0,15,10,40,40,7,3,10,54.0,464.0,898,232,230,462,1956.0,82,5.46,52,291,2492,9.0,0.28153795
9657,9657,Fredrik Olausson,1987-88,21.0,2,36,72,72,7,29,36,119.0,,72,7,29,36,119.0,80,7.34,72,344,2400,12.2,0.5164314
9658,9658,Fredrik Olausson,1988-89,22.0,3,15,38,38,5,10,15,65.0,,110,12,39,51,184.0,80,7.43,89,437,2435,12.2,0.43425447
9659,9659,Fredrik Olausson,1989-90,23.0,4,62,75,75,15,47,62,178.0,,185,27,86,113,362.0,80,7.48,85,403,2430,12.3,0.7845862
9660,9660,Fredrik Olausson,1990-91,24.0,5,55,77,77,9,46,55,147.0,,262,36,132,168,509.0,80,7.37,76,367,2421,12.2,0.69239825
9661,9661,Fredrik Olausson,1991-92,25.0,6,41,71,71,12,29,41,168.0,,333,48,161,209,677.0,80,6.91,71,366,2385,11.6,0.6153955
9662,9662,Fredrik Olausson,1992-93,26.0,7,62,77,77,20,42,62,227.0,,410,68,203,271,904.0,80,6.96,77,402,2440,11.4,0.80665565
9663,9663,Fredrik Olausson,1993-94,27.0,8,57,68,68,16,41,57,165.0,,478,84,244,328,1069.0,84,7.25,87,443,2603,11.7,0.738621
9664,9664,Fredrik Olausson,1994-95,28.0,9,35,73,73,11,24,35,126.0,,551,95,268,363,1195.0,84,6.48,76,407,2545,10.7,0.43208116
9665,9665,Fredrik Olausson,1995-96,29.0,10,10,33,33,0,10,10,52.0,,584,95,278,373,1247.0,48,5.97,37,209,1408,10.2,0.3526442
9666,9666,Fredrik Olausson,1996-97,30.0,11,24,56,56,2,22,24,83.0,,640,97,300,397,1330.0,82,6.29,74,413,2481,10.4,0.38610214
9667,9667,Fredrik Olausson,1997-98,31.0,12,38,71,71,9,29,38,110.0,,711,106,329,435,1440.0,82,5.83,55,336,2444,9.8,0.44067642
9668,9668,Fredrik Olausson,1998-99,32.0,13,33,76,76,6,27,33,89.0,,787,112,356,468,1529.0,82,5.28,57,380,2242,9.6,0.39697057
9669,9669,Fredrik Olausson,1999-00,33.0,14,56,74,74,16,40,56,121.0,1464.0,861,128,396,524,1650.0,82,5.27,57,359,2285,9.4,0.64785147
9670,9670,Fredrik Olausson,2000-01,34.0,15,34,70,70,15,19,34,120.0,1401.0,931,143,415,558,1770.0,82,5.49,53,331,2294,9.8,0.38853976
9671,9671,Fredrik Olausson,2002-03,36.0,16,15,47,47,2,13,15,61.0,781.0,978,145,428,573,1831.0,82,5.24,53,338,2262,9.5,0.22324327
9672,9672,Fredrik Olausson,2003-04,37.0,17,8,44,44,2,6,8,38.0,635.0,1022,147,434,581,1869.0,82,5.31,60,363,2326,9.4,0.18603405
9673,9673,Fredrik Sjostrom,2004-05,21.0,2,13,57,57,7,6,13,73.0,661.0,57,7,6,13,73.0,82,5.14,57,348,2300,9.2,0.39430228
9674,9674,Fredrik Sjostrom,2006-07,23.0,3,23,75,75,6,17,23,109.0,999.0,132,13,23,36,182.0,82,6.05,85,480,2458,10.1,0.3205213
9675,9675,Fredrik Sjostrom,2007-08,24.0,4,18,78,78,9,9,18,125.0,1101.0,210,22,32,54,307.0,82,5.76,70,398,2426,9.7,0.28817728
9676,9676,Fredrik Sjostrom,2008-09,25.0,5,21,69,69,12,9,21,110.0,837.0,279,34,41,75,417.0,82,5.44,62,351,2383,9.4,0.31663865
9677,9677,Fredrik Sjostrom,2009-10,26.0,6,13,79,79,7,6,13,95.0,961.0,358,41,47,88,512.0,82,5.7,65,341,2477,9.4,0.21715164
9678,9678,Fredrik Sjostrom,2010-11,27.0,7,11,65,65,3,8,11,64.0,701.0,423,44,55,99,576.0,82,5.53,56,304,2486,9.1,0.17859116
9679,9679,Fredrik Sjostrom,2011-12,28.0,8,5,66,66,2,3,5,62.0,740.0,489,46,58,104,638.0,82,5.46,52,291,2492,9.0,0.17483899
9680,9680,Frédéric St. Denis,2012-13,27.0,2,3,17,17,1,2,3,11.0,247.0,17,1,2,3,11.0,82,5.32,47,271,2439,8.9,0.19706154
9681,9681,Frédéric St. Denis,2015-16,30.0,3,1,4,4,0,1,1,2.0,53.0,21,1,3,4,13.0,82,5.32,47,251,2453,8.9,0.13719308
9682,9682,Gabe Gauthier,2007-08,24.0,2,0,5,5,0,0,0,6.0,50.0,5,0,0,0,6.0,82,5.76,70,398,2426,9.7,0.1724348
9683,9683,Gabe Gauthier,2008-09,25.0,3,0,3,3,0,0,0,2.0,21.0,8,0,0,0,8.0,82,5.44,62,351,2383,9.4,0.16000289
9684,9684,Gabriel Bourque,2012-13,22.0,2,19,43,43,7,12,19,59.0,550.0,43,7,12,19,59.0,82,5.32,47,271,2439,8.9,0.381713
9685,9685,Gabriel Bourque,2013-14,23.0,3,16,34,34,11,5,16,50.0,538.0,77,18,17,35,109.0,48,5.31,29,160,1399,9.1,0.4478288
9686,9686,Gabriel Bourque,2014-15,24.0,4,26,74,74,9,17,26,108.0,1024.0,151,27,34,61,217.0,82,5.34,48,269,2463,8.9,0.35477334
9687,9687,Gabriel Bourque,2015-16,25.0,5,13,69,69,3,10,13,76.0,829.0,220,30,44,74,293.0,82,5.32,47,251,2453,8.9,0.2346698
9688,9688,Gabriel Bourque,2016-17,26.0,6,4,22,22,1,3,4,25.0,272.0,242,31,47,78,318.0,82,5.34,48,255,2438,9.0,0.22046524
9689,9689,Gabriel Bourque,2017-18,27.0,7,0,6,6,0,0,0,4.0,67.0,248,31,47,78,322.0,82,5.45,47,245,2478,9.0,0.22873256
9690,9690,Gabriel Bourque,2018-19,28.0,8,11,58,58,5,6,11,44.0,632.0,306,36,53,89,366.0,82,5.86,50,250,2620,9.2,0.19175297
9691,9691,Gabriel Bourque,2019-20,29.0,9,8,55,55,2,6,8,34.0,536.0,361,38,59,97,400.0,82,5.96,47,239,2579,9.5,0.1569229
9692,9692,Gabriel Bourque,2020-21,30.0,10,6,52,52,2,4,6,33.0,447.0,413,40,63,103,433.0,70,5.96,42,208,2192,9.5,0.16210875
9693,9693,Gabriel Carlsson,2017-18,21.0,2,1,2,2,0,1,1,3.0,34.0,2,0,1,1,3.0,82,5.45,47,245,2478,9.0,0.27938905
9694,9694,Gabriel Carlsson,2018-19,22.0,3,2,14,14,0,2,2,18.0,159.0,16,0,3,3,21.0,82,5.86,50,250,2620,9.2,0.18666855
9695,9695,Gabriel Carlsson,2019-20,23.0,4,0,1,1,0,0,0,1.0,9.0,17,0,3,3,22.0,82,5.96,47,239,2579,9.5,0.16639116
9696,9696,Gabriel Carlsson,2020-21,24.0,5,0,6,6,0,0,0,3.0,65.0,23,0,3,3,25.0,70,5.96,42,208,2192,9.5,0.23432887
9697,9697,Gabriel Dumont,2012-13,22.0,2,0,3,3,0,0,0,1.0,26.0,3,0,0,0,1.0,82,5.32,47,271,2439,8.9,0.1610541
9698,9698,Gabriel Dumont,2013-14,23.0,3,3,10,10,1,2,3,20.0,97.0,13,1,2,3,21.0,48,5.31,29,160,1399,9.1,0.2653408
9699,9699,Gabriel Dumont,2014-15,24.0,4,0,2,2,0,0,0,1.0,14.0,15,1,2,3,22.0,82,5.34,48,269,2463,8.9,0.14935109
9700,9700,Gabriel Dumont,2015-16,25.0,5,0,3,3,0,0,0,4.0,27.0,18,1,2,3,26.0,82,5.32,47,251,2453,8.9,0.14584842
9701,9701,Gabriel Dumont,2017-18,27.0,6,4,39,39,2,2,4,34.0,377.0,57,3,4,7,60.0,82,5.45,47,245,2478,9.0,0.13056037
9702,9702,Gabriel Dumont,2018-19,28.0,7,2,30,30,1,1,2,38.0,271.0,87,4,5,9,98.0,82,5.86,50,250,2620,9.2,0.15517125
9703,9703,Gabriel Dumont,2020-21,30.0,8,0,3,3,0,0,0,3.0,35.0,90,4,5,9,101.0,70,5.96,42,208,2192,9.5,0.14430395
9704,9704,Gabriel Landeskog,2012-13,20.0,2,52,82,82,22,30,52,270.0,1526.0,82,22,30,52,270.0,82,5.32,47,271,2439,8.9,0.7022382
9705,9705,Gabriel Landeskog,2013-14,21.0,3,17,36,36,9,8,17,109.0,696.0,118,31,38,69,379.0,48,5.31,29,160,1399,9.1,0.5450603
9706,9706,Gabriel Landeskog,2014-15,22.0,4,65,81,81,26,39,65,222.0,1513.0,199,57,77,134,601.0,82,5.34,48,269,2463,8.9,0.8283688
9707,9707,Gabriel Landeskog,2015-16,23.0,5,59,82,82,23,36,59,214.0,1517.0,281,80,113,193,815.0,82,5.32,47,251,2453,8.9,0.72124827
9708,9708,Gabriel Landeskog,2016-17,24.0,6,53,75,75,20,33,53,169.0,1419.0,356,100,146,246,984.0,82,5.34,48,255,2438,9.0,0.6728022
9709,9709,Gabriel Landeskog,2017-18,25.0,7,33,72,72,18,15,33,169.0,1352.0,428,118,161,279,1153.0,82,5.45,47,245,2478,9.0,0.5725825
9710,9710,Gabriel Landeskog,2018-19,26.0,8,62,78,78,25,37,62,183.0,1571.0,506,143,198,341,1336.0,82,5.86,50,250,2620,9.2,0.7551567
9711,9711,Gabriel Landeskog,2019-20,27.0,9,75,73,73,34,41,75,243.0,1544.0,579,177,239,416,1579.0,82,5.96,47,239,2579,9.5,0.8495271
9712,9712,Gabriel Landeskog,2020-21,28.0,10,44,54,54,21,23,44,145.0,1082.0,633,198,262,460,1724.0,70,5.96,42,208,2192,9.5,0.7495579
9713,9713,Gabriel Vilardi,2020-21,21.0,2,7,10,10,3,4,7,19.0,129.0,10,3,4,7,19.0,70,5.96,42,208,2192,9.5,0.38151643
9714,9714,Gaetan Duchesne,1982-83,20.0,2,23,74,74,9,14,23,78.0,,74,9,14,23,78.0,80,8.03,73,320,2489,12.9,0.3807507
9715,9715,Gaetan Duchesne,1983-84,21.0,3,37,77,77,18,19,37,126.0,,151,27,33,60,204.0,80,7.73,71,310,2444,12.7,0.49677375
9716,9716,Gaetan Duchesne,1984-85,22.0,4,36,79,79,17,19,36,116.0,,230,44,52,96,320.0,80,7.89,74,336,2448,12.9,0.4577527
9717,9717,Gaetan Duchesne,1985-86,23.0,5,38,67,67,15,23,38,84.0,,297,59,75,134,404.0,80,7.77,71,321,2447,12.7,0.5318559
9718,9718,Gaetan Duchesne,1986-87,24.0,6,39,80,80,11,28,39,119.0,,377,70,103,173,523.0,80,7.94,82,370,2484,12.8,0.479402
9719,9719,Gaetan Duchesne,1987-88,25.0,7,52,74,74,17,35,52,108.0,,451,87,138,225,631.0,80,7.34,72,344,2400,12.2,0.6169838
9720,9720,Gaetan Duchesne,1988-89,26.0,8,47,80,80,24,23,47,138.0,,531,111,161,272,769.0,80,7.43,89,437,2435,12.2,0.6336048
9721,9721,Gaetan Duchesne,1989-90,27.0,9,29,70,70,8,21,29,110.0,,601,119,182,301,879.0,80,7.48,85,403,2430,12.3,0.4025077
9722,9722,Gaetan Duchesne,1990-91,28.0,10,20,72,72,12,8,20,93.0,,673,131,190,321,972.0,80,7.37,76,367,2421,12.2,0.29920387
9723,9723,Gaetan Duchesne,1991-92,29.0,11,18,68,68,9,9,18,100.0,,741,140,199,339,1072.0,80,6.91,71,366,2385,11.6,0.33355448
9724,9724,Gaetan Duchesne,1992-93,30.0,12,23,73,73,8,15,23,106.0,,814,148,214,362,1178.0,80,6.96,77,402,2440,11.4,0.31955773
9725,9725,Gaetan Duchesne,1993-94,31.0,13,29,84,84,16,13,29,134.0,,898,164,227,391,1312.0,84,7.25,87,443,2603,11.7,0.34992975
9726,9726,Gaetan Duchesne,1994-95,32.0,14,30,84,84,12,18,30,121.0,,982,176,245,421,1433.0,84,6.48,76,407,2545,10.7,0.3107521
9727,9727,Gaetan Duchesne,1995-96,33.0,15,12,46,46,3,9,12,62.0,,1028,179,254,433,1495.0,48,5.97,37,209,1408,10.2,0.25371146
9728,9728,Gaetan Haas,2020-21,29.0,2,10,58,58,5,5,10,54.0,562.0,58,5,5,10,54.0,70,5.96,42,208,2192,9.5,0.226149
9729,9729,Gaetan Royer,2002-03,26.0,2,0,3,3,0,0,0,0.0,15.0,3,0,0,0,0.0,82,5.24,53,338,2262,9.5,0.14532295
9730,9730,Gage Quinney,2020-21,25.0,2,1,3,3,0,1,1,2.0,29.0,3,0,1,1,2.0,70,5.96,42,208,2192,9.5,0.20626745
9731,9731,Garnet Exelby,2003-04,22.0,2,2,15,15,0,2,2,9.0,271.0,15,0,2,2,9.0,82,5.31,60,363,2326,9.4,0.17150679
9732,9732,Garnet Exelby,2004-05,23.0,3,10,71,71,1,9,10,42.0,1387.0,86,1,11,12,51.0,82,5.14,57,348,2300,9.2,0.2037968
9733,9733,Garnet Exelby,2006-07,25.0,4,10,75,75,1,9,10,44.0,1176.0,161,2,20,22,95.0,82,6.05,85,480,2458,10.1,0.154219
9734,9734,Garnet Exelby,2007-08,26.0,5,10,58,58,2,8,10,57.0,1044.0,219,4,28,32,152.0,82,5.76,70,398,2426,9.7,0.18122298
9735,9735,Garnet Exelby,2008-09,27.0,6,7,79,79,2,5,7,37.0,1492.0,298,6,33,39,189.0,82,5.44,62,351,2383,9.4,0.13044825
9736,9736,Garnet Exelby,2009-10,28.0,7,7,59,59,0,7,7,42.0,987.0,357,6,40,46,231.0,82,5.7,65,341,2477,9.4,0.13883218
9737,9737,Garnet Exelby,2010-11,29.0,8,4,51,51,1,3,4,14.0,515.0,408,7,43,50,245.0,82,5.53,56,304,2486,9.1,0.09338361
9738,9738,Garnet Hathaway,2016-17,25.0,2,3,14,14,0,3,3,11.0,168.0,14,0,3,3,11.0,82,5.34,48,255,2438,9.0,0.18614197
9739,9739,Garnet Hathaway,2017-18,26.0,3,5,26,26,1,4,5,22.0,238.0,40,1,7,8,33.0,82,5.45,47,245,2478,9.0,0.18146545
9740,9740,Garnet Hathaway,2018-19,27.0,4,13,59,59,4,9,13,68.0,680.0,99,5,16,21,101.0,82,5.86,50,250,2620,9.2,0.21270862
9741,9741,Garnet Hathaway,2019-20,28.0,5,19,76,76,11,8,19,77.0,800.0,175,16,24,40,178.0,82,5.96,47,239,2579,9.5,0.23268023
9742,9742,Garnet Hathaway,2020-21,29.0,6,16,66,66,9,7,16,80.0,711.0,241,25,31,56,258.0,70,5.96,42,208,2192,9.5,0.2577492
9743,9743,Garret Stroshein,2004-05,24.0,2,0,3,3,0,0,0,2.0,22.0,3,0,0,0,2.0,82,5.14,57,348,2300,9.2,0.2180599
9744,9744,Garrett Burnett,2004-05,29.0,2,3,39,39,1,2,3,24.0,140.0,39,1,2,3,24.0,82,5.14,57,348,2300,9.2,0.13316295
9745,9745,Garrett Mitchell,2017-18,26.0,2,0,1,1,0,0,0,0.0,9.0,1,0,0,0,0.0,82,5.45,47,245,2478,9.0,0.1562587
9746,9746,Garrett Stafford,2008-09,29.0,2,0,2,2,0,0,0,1.0,14.0,2,0,0,0,1.0,82,5.44,62,351,2383,9.4,0.17363831
9747,9747,Garrett Stafford,2009-10,30.0,3,2,3,3,0,2,2,5.0,54.0,5,0,2,2,6.0,82,5.7,65,341,2477,9.4,0.16453043
9748,9748,Garrett Stafford,2011-12,32.0,4,0,2,2,0,0,0,2.0,25.0,7,0,2,2,8.0,82,5.46,52,291,2492,9.0,0.16222504
9749,9749,Garrett Wilson,2014-15,23.0,2,0,3,3,0,0,0,4.0,31.0,3,0,0,0,4.0,82,5.34,48,269,2463,8.9,0.17318648
9750,9750,Garrett Wilson,2015-16,24.0,3,0,2,2,0,0,0,5.0,18.0,5,0,0,0,9.0,82,5.32,47,251,2453,8.9,0.16434428
9751,9751,Garrett Wilson,2016-17,25.0,4,0,29,29,0,0,0,28.0,272.0,34,0,0,0,37.0,82,5.34,48,255,2438,9.0,0.15730622
9752,9752,Garrett Wilson,2019-20,28.0,5,8,50,50,2,6,8,54.0,381.0,84,2,6,8,91.0,82,5.96,47,239,2579,9.5,0.16296041
9753,9753,Garry Galley,1985-86,22.0,2,38,78,78,8,30,38,133.0,,78,8,30,38,133.0,80,7.77,71,321,2447,12.7,0.5203523
9754,9754,Garry Galley,1986-87,23.0,3,22,49,49,9,13,22,57.0,,127,17,43,60,190.0,80,7.94,82,370,2484,12.8,0.44262898
9755,9755,Garry Galley,1987-88,24.0,4,27,48,48,6,21,27,72.0,,175,23,64,87,262.0,80,7.34,72,344,2400,12.2,0.50048196
9756,9756,Garry Galley,1988-89,25.0,5,30,58,58,7,23,30,100.0,,233,30,87,117,362.0,80,7.43,89,437,2435,12.2,0.5212597
9757,9757,Garry Galley,1989-90,26.0,6,30,78,78,8,22,30,145.0,,311,38,109,147,507.0,80,7.48,85,403,2430,12.3,0.46933696
9758,9758,Garry Galley,1990-91,27.0,7,35,71,71,8,27,35,142.0,,382,46,136,182,649.0,80,7.37,76,367,2421,12.2,0.47968727
9759,9759,Garry Galley,1991-92,28.0,8,27,70,70,6,21,27,128.0,,452,52,157,209,777.0,80,6.91,71,366,2385,11.6,0.37332606
9760,9760,Garry Galley,1992-93,29.0,9,32,77,77,5,27,32,125.0,,529,57,184,241,902.0,80,6.96,77,402,2440,11.4,0.40916675
9761,9761,Garry Galley,1993-94,30.0,10,62,83,83,13,49,62,231.0,,612,70,233,303,1133.0,84,7.25,87,443,2603,11.7,0.6839804
9762,9762,Garry Galley,1994-95,31.0,11,70,81,81,10,60,70,186.0,,693,80,293,373,1319.0,84,6.48,76,407,2545,10.7,0.6580288
9763,9763,Garry Galley,1995-96,32.0,12,32,47,47,3,29,32,97.0,,740,83,322,405,1416.0,48,5.97,37,209,1408,10.2,0.57125974
9764,9764,Garry Galley,1996-97,33.0,13,54,78,78,10,44,54,175.0,,818,93,366,459,1591.0,82,6.29,74,413,2481,10.4,0.5501138
9765,9765,Garry Galley,1997-98,34.0,14,38,71,71,4,34,38,84.0,,889,97,400,497,1675.0,82,5.83,55,336,2444,9.8,0.36979628
9766,9766,Garry Galley,1998-99,35.0,15,37,74,74,9,28,37,128.0,,963,106,428,534,1803.0,82,5.28,57,380,2242,9.6,0.3985352
9767,9767,Garry Galley,1999-00,36.0,16,16,60,60,4,12,16,77.0,1036.0,1023,110,440,550,1880.0,82,5.27,57,359,2285,9.4,0.26034796
9768,9768,Garry Galley,2000-01,37.0,17,30,70,70,9,21,30,96.0,1417.0,1093,119,461,580,1976.0,82,5.49,53,331,2294,9.8,0.37361133
9769,9769,Garry Galley,2001-02,38.0,18,20,56,56,6,14,20,94.0,1167.0,1149,125,475,600,2070.0,82,5.51,63,376,2272,9.9,0.34052283
9770,9770,Garry Lariviere,1980-81,26.0,2,21,75,75,2,19,21,73.0,,75,2,19,21,73.0,80,7.03,61,280,2352,12.0,0.2768712
9771,9771,Garry Lariviere,1981-82,27.0,3,18,65,65,3,15,18,66.0,,140,5,34,39,139.0,80,7.69,77,340,2441,12.6,0.2669602
9772,9772,Garry Lariviere,1982-83,28.0,4,22,62,62,1,21,22,46.0,,202,6,55,61,185.0,80,8.03,73,320,2489,12.9,0.26809186
9773,9773,Garry Lariviere,1983-84,29.0,5,2,17,17,0,2,2,15.0,,219,6,57,63,200.0,80,7.73,71,310,2444,12.7,0.22748348
9774,9774,Garry Valk,1991-92,24.0,2,21,59,59,10,11,21,90.0,,59,10,11,21,90.0,80,6.91,71,366,2385,11.6,0.34684876
9775,9775,Garry Valk,1992-93,25.0,3,25,65,65,8,17,25,93.0,,124,18,28,46,183.0,80,6.96,77,402,2440,11.4,0.3424471
9776,9776,Garry Valk,1993-94,26.0,4,13,48,48,6,7,13,46.0,,172,24,35,59,229.0,84,7.25,87,443,2603,11.7,0.3068754
9777,9777,Garry Valk,1994-95,27.0,5,45,78,78,18,27,45,165.0,,250,42,62,104,394.0,84,6.48,76,407,2545,10.7,0.4424036
9778,9778,Garry Valk,1995-96,28.0,6,9,36,36,3,6,9,53.0,,286,45,68,113,447.0,48,5.97,37,209,1408,10.2,0.2730446
9779,9779,Garry Valk,1996-97,29.0,7,24,79,79,12,12,24,108.0,,365,57,80,137,555.0,82,6.29,74,413,2481,10.4,0.3019769
9780,9780,Garry Valk,1997-98,30.0,8,21,70,70,10,11,21,100.0,,435,67,91,158,655.0,82,5.83,55,336,2444,9.8,0.304339
9781,9781,Garry Valk,1998-99,31.0,9,3,39,39,2,1,3,32.0,,474,69,92,161,687.0,82,5.28,57,380,2242,9.6,0.20740569
9782,9782,Garry Valk,1999-00,32.0,10,29,77,77,8,21,29,93.0,1069.0,551,77,113,190,780.0,82,5.27,57,359,2285,9.4,0.32541305
9783,9783,Garry Valk,2000-01,33.0,11,24,73,73,10,14,24,91.0,938.0,624,87,127,214,871.0,82,5.49,53,331,2294,9.8,0.27807426
9784,9784,Garry Valk,2001-02,34.0,12,26,74,74,8,18,26,87.0,854.0,698,95,145,240,958.0,82,5.51,63,376,2272,9.9,0.262419
9785,9785,Garry Valk,2002-03,35.0,13,15,63,63,5,10,15,80.0,680.0,761,100,155,255,1038.0,82,5.24,53,338,2262,9.5,0.20856899
9786,9786,Garry Valk,2003-04,36.0,14,1,16,16,0,1,1,9.0,157.0,777,100,156,256,1047.0,82,5.31,60,363,2326,9.4,0.15303218
9787,9787,Garth Butcher,1982-83,20.0,2,0,5,5,0,0,0,7.0,,5,0,0,0,7.0,80,8.03,73,320,2489,12.9,0.28902286
9788,9788,Garth Butcher,1983-84,21.0,3,14,55,55,1,13,14,60.0,,60,1,13,14,67.0,80,7.73,71,310,2444,12.7,0.2811333
9789,9789,Garth Butcher,1984-85,22.0,4,2,28,28,2,0,2,33.0,,88,3,13,16,100.0,80,7.89,74,336,2448,12.9,0.30581778
9790,9790,Garth Butcher,1985-86,23.0,5,12,75,75,3,9,12,59.0,,163,6,22,28,159.0,80,7.77,71,321,2447,12.7,0.22556323
9791,9791,Garth Butcher,1986-87,24.0,6,11,70,70,4,7,11,57.0,,233,10,29,39,216.0,80,7.94,82,370,2484,12.8,0.2141025
9792,9792,Garth Butcher,1987-88,25.0,7,20,70,70,5,15,20,97.0,,303,15,44,59,313.0,80,7.34,72,344,2400,12.2,0.27493495
9793,9793,Garth Butcher,1988-89,26.0,8,23,80,80,6,17,23,77.0,,383,21,61,82,390.0,80,7.43,89,437,2435,12.2,0.2757019
9794,9794,Garth Butcher,1989-90,27.0,9,20,78,78,0,20,20,101.0,,461,21,81,102,491.0,80,7.48,85,403,2430,12.3,0.25452864
9795,9795,Garth Butcher,1990-91,28.0,10,20,80,80,6,14,20,87.0,,541,27,95,122,578.0,80,7.37,76,367,2421,12.2,0.2540424
9796,9796,Garth Butcher,1991-92,29.0,11,22,82,82,6,16,22,75.0,,623,33,111,144,653.0,80,6.91,71,366,2385,11.6,0.25308448
9797,9797,Garth Butcher,1992-93,30.0,12,20,68,68,5,15,20,50.0,,691,38,126,164,703.0,80,6.96,77,402,2440,11.4,0.24539036
9798,9798,Garth Butcher,1993-94,31.0,13,15,84,84,5,10,15,83.0,,775,43,136,179,786.0,84,7.25,87,443,2603,11.7,0.18080273
9799,9799,Garth Butcher,1994-95,32.0,14,19,77,77,4,15,19,66.0,,852,47,151,198,852.0,84,6.48,76,407,2545,10.7,0.19086665
9800,9800,Garth Butcher,1995-96,33.0,15,8,45,45,1,7,8,24.0,,897,48,158,206,876.0,48,5.97,37,209,1408,10.2,0.14535275
9801,9801,Garth MacGuigan,1980-81,24.0,2,0,2,2,0,0,0,1.0,,2,0,0,0,1.0,80,7.03,61,280,2352,12.0,0.22955823
9802,9802,Garth MacGuigan,1984-85,28.0,3,1,3,3,0,1,1,2.0,,5,0,1,1,3.0,80,7.89,74,336,2448,12.9,0.17663428
9803,9803,Garth Murray,2004-05,22.0,2,1,20,20,1,0,1,18.0,185.0,20,1,0,1,18.0,82,5.14,57,348,2300,9.2,0.19792542
9804,9804,Garth Murray,2006-07,24.0,3,6,36,36,5,1,6,25.0,333.0,56,6,1,7,43.0,82,6.05,85,480,2458,10.1,0.20557654
9805,9805,Garth Murray,2007-08,25.0,4,3,43,43,2,1,3,28.0,360.0,99,8,2,10,71.0,82,5.76,70,398,2426,9.7,0.12518334
9806,9806,Garth Murray,2008-09,26.0,5,0,7,7,0,0,0,3.0,44.0,106,8,2,10,74.0,82,5.44,62,351,2383,9.4,0.153061
9807,9807,Garth Murray,2009-10,27.0,6,0,10,10,0,0,0,12.0,93.0,116,8,2,10,86.0,82,5.7,65,341,2477,9.4,0.16332257
9808,9808,Gary Burns,1981-82,27.0,2,4,11,11,2,2,4,13.0,,11,2,2,4,13.0,80,7.69,77,340,2441,12.6,0.30689016
9809,9809,Gary Dillon,1981-82,22.0,2,2,13,13,1,1,2,15.0,,13,1,1,2,15.0,80,7.69,77,340,2441,12.6,0.27039528
9810,9810,Gary Emmons,1994-95,31.0,2,1,3,3,1,0,1,6.0,,3,1,0,1,6.0,84,6.48,76,407,2545,10.7,0.22957435
9811,9811,Gary Leeman,1984-85,20.0,2,12,52,52,4,8,12,41.0,,52,4,8,12,41.0,80,7.89,74,336,2448,12.9,0.31257856
9812,9812,Gary Leeman,1985-86,21.0,3,31,53,53,5,26,31,88.0,,105,9,34,43,129.0,80,7.77,71,321,2447,12.7,0.550151
9813,9813,Gary Leeman,1986-87,22.0,4,32,53,53,9,23,32,123.0,,158,18,57,75,252.0,80,7.94,82,370,2484,12.8,0.5921209
9814,9814,Gary Leeman,1987-88,23.0,5,52,80,80,21,31,52,196.0,,238,39,88,127,448.0,80,7.34,72,344,2400,12.2,0.6721493
9815,9815,Gary Leeman,1988-89,24.0,6,61,80,80,30,31,61,234.0,,318,69,119,188,682.0,80,7.43,89,437,2435,12.2,0.80030084
9816,9816,Gary Leeman,1989-90,25.0,7,75,61,61,32,43,75,195.0,,379,101,162,263,877.0,80,7.48,85,403,2430,12.3,1.107832
9817,9817,Gary Leeman,1990-91,26.0,8,95,80,80,51,44,95,256.0,,459,152,206,358,1133.0,80,7.37,76,367,2421,12.2,1.0341263
9818,9818,Gary Leeman,1991-92,27.0,9,29,52,52,17,12,29,135.0,,511,169,218,387,1268.0,80,6.91,71,366,2385,11.6,0.6470246
9819,9819,Gary Leeman,1992-93,28.0,10,29,63,63,9,20,29,141.0,,574,178,238,416,1409.0,80,6.96,77,402,2440,11.4,0.5334822
9820,9820,Gary Leeman,1993-94,29.0,11,32,50,50,15,17,32,85.0,,624,193,255,448,1494.0,84,7.25,87,443,2603,11.7,0.561326
9821,9821,Gary Leeman,1994-95,30.0,12,15,31,31,4,11,15,53.0,,655,197,266,463,1547.0,84,6.48,76,407,2545,10.7,0.39863247
9822,9822,Gary Leeman,1995-96,31.0,13,2,10,10,2,0,2,14.0,,665,199,266,465,1561.0,48,5.97,37,209,1408,10.2,0.39359206
9823,9823,Gary Leeman,1997-98,33.0,14,1,2,2,0,1,1,3.0,,667,199,267,466,1564.0,82,5.83,55,336,2444,9.8,0.27115157
9824,9824,Gary Lupul,1980-81,21.0,2,20,51,51,9,11,20,71.0,,51,9,11,20,71.0,80,7.03,61,280,2352,12.0,0.40998912
9825,9825,Gary Lupul,1981-82,22.0,3,2,7,7,0,2,2,5.0,,58,9,13,22,76.0,80,7.69,77,340,2441,12.6,0.34949404
9826,9826,Gary Lupul,1982-83,23.0,4,17,41,41,10,7,17,45.0,,99,19,20,39,121.0,80,8.03,73,320,2489,12.9,0.4600624
9827,9827,Gary Lupul,1983-84,24.0,5,28,40,40,18,10,28,64.0,,139,37,30,67,185.0,80,7.73,71,310,2444,12.7,0.5642869
9828,9828,Gary Lupul,1984-85,25.0,6,44,69,69,17,27,44,128.0,,208,54,57,111,313.0,80,7.89,74,336,2448,12.9,0.5335885
9829,9829,Gary Lupul,1985-86,26.0,7,29,66,66,12,17,29,106.0,,274,66,74,140,419.0,80,7.77,71,321,2447,12.7,0.4090972
9830,9830,Gary Lupul,1986-87,27.0,8,5,19,19,4,1,5,17.0,,293,70,75,145,436.0,80,7.94,82,370,2484,12.8,0.29190502
9831,9831,Gary Morrison,1980-81,25.0,2,2,3,3,0,2,2,1.0,,3,0,2,2,1.0,80,7.03,61,280,2352,12.0,0.24897829
9832,9832,Gary Morrison,1981-82,26.0,3,14,33,33,1,13,14,21.0,,36,1,15,16,22.0,80,7.69,77,340,2441,12.6,0.23063707
9833,9833,Gary Morrison,1982-83,27.0,4,0,7,7,0,0,0,5.0,,43,1,15,16,27.0,80,8.03,73,320,2489,12.9,0.18198854
9834,9834,Gary Nylund,1983-84,20.0,2,3,16,16,0,3,3,12.0,,16,0,3,3,12.0,80,7.73,71,310,2444,12.7,0.306425
9835,9835,Gary Nylund,1984-85,21.0,3,16,47,47,2,14,16,71.0,,63,2,17,19,83.0,80,7.89,74,336,2448,12.9,0.38131845
9836,9836,Gary Nylund,1985-86,22.0,4,20,76,76,3,17,20,62.0,,139,5,34,39,145.0,80,7.77,71,321,2447,12.7,0.27853924
9837,9837,Gary Nylund,1986-87,23.0,5,18,79,79,2,16,18,84.0,,218,7,50,57,229.0,80,7.94,82,370,2484,12.8,0.26941526
9838,9838,Gary Nylund,1987-88,24.0,6,27,80,80,7,20,27,123.0,,298,14,70,84,352.0,80,7.34,72,344,2400,12.2,0.33886838
9839,9839,Gary Nylund,1988-89,25.0,7,19,76,76,4,15,19,92.0,,374,18,85,103,444.0,80,7.43,89,437,2435,12.2,0.26318237
9840,9840,Gary Nylund,1989-90,26.0,8,17,69,69,7,10,17,74.0,,443,25,95,120,518.0,80,7.48,85,403,2430,12.3,0.30431458
9841,9841,Gary Nylund,1990-91,27.0,9,25,64,64,4,21,25,65.0,,507,29,116,145,583.0,80,7.37,76,367,2421,12.2,0.28082472
9842,9842,Gary Nylund,1991-92,28.0,10,23,72,72,2,21,23,102.0,,579,31,137,168,685.0,80,6.91,71,366,2385,11.6,0.2791406
9843,9843,Gary Nylund,1992-93,29.0,11,1,7,7,0,1,1,5.0,,586,31,138,169,690.0,80,6.96,77,402,2440,11.4,0.17058909
9844,9844,Gary Nylund,1993-94,30.0,12,2,22,22,1,1,2,19.0,,608,32,139,171,709.0,84,7.25,87,443,2603,11.7,0.15476269
9845,9845,Gary Roberts,1987-88,21.0,2,15,32,32,5,10,15,38.0,,32,5,10,15,38.0,80,7.34,72,344,2400,12.2,0.4306753
9846,9846,Gary Roberts,1988-89,22.0,3,28,74,74,13,15,28,118.0,,106,18,25,43,156.0,80,7.43,89,437,2435,12.2,0.42710346
9847,9847,Gary Roberts,1989-90,23.0,4,38,71,71,22,16,38,123.0,,177,40,41,81,279.0,80,7.48,85,403,2430,12.3,0.53550917
9848,9848,Gary Roberts,1990-91,24.0,5,72,78,78,39,33,72,175.0,,255,79,74,153,454.0,80,7.37,76,367,2421,12.2,0.85297215
9849,9849,Gary Roberts,1991-92,25.0,6,53,80,80,22,31,53,132.0,,335,101,105,206,586.0,80,6.91,71,366,2385,11.6,0.68505365
9850,9850,Gary Roberts,1992-93,26.0,7,90,76,76,53,37,90,196.0,,411,154,142,296,782.0,80,6.96,77,402,2440,11.4,1.0987291
9851,9851,Gary Roberts,1993-94,27.0,8,79,58,58,38,41,79,166.0,,469,192,183,375,948.0,84,7.25,87,443,2603,11.7,1.0200899
9852,9852,Gary Roberts,1994-95,28.0,9,84,73,73,41,43,84,202.0,,542,233,226,459,1150.0,84,6.48,76,407,2545,10.7,0.9899549
9853,9853,Gary Roberts,1995-96,29.0,10,4,8,8,2,2,4,20.0,,550,235,228,463,1170.0,48,5.97,37,209,1408,10.2,0.7947229
9854,9854,Gary Roberts,1996-97,30.0,11,42,35,35,22,20,42,84.0,,585,257,248,505,1254.0,82,6.29,74,413,2481,10.4,0.7463056
9855,9855,Gary Roberts,1998-99,32.0,12,49,61,61,20,29,49,106.0,,646,277,277,554,1360.0,82,5.28,57,380,2242,9.6,0.5999723
9856,9856,Gary Roberts,1999-00,33.0,13,42,77,77,14,28,42,138.0,1509.0,723,291,305,596,1498.0,82,5.27,57,359,2285,9.4,0.5239936
9857,9857,Gary Roberts,2000-01,34.0,14,53,69,69,23,30,53,150.0,1278.0,792,314,335,649,1648.0,82,5.49,53,331,2294,9.8,0.6285595
9858,9858,Gary Roberts,2001-02,35.0,15,53,82,82,29,24,53,138.0,1405.0,874,343,359,702,1786.0,82,5.51,63,376,2272,9.9,0.5676526
9859,9859,Gary Roberts,2002-03,36.0,16,48,69,69,21,27,48,122.0,1199.0,943,364,386,750,1908.0,82,5.24,53,338,2262,9.5,0.52943474
9860,9860,Gary Roberts,2003-04,37.0,17,8,14,14,5,3,8,22.0,218.0,957,369,389,758,1930.0,82,5.31,60,363,2326,9.4,0.47738242
9861,9861,Gary Roberts,2004-05,38.0,18,48,72,72,28,20,48,124.0,1264.0,1029,397,409,806,2054.0,82,5.14,57,348,2300,9.2,0.62608016
9862,9862,Gary Roberts,2006-07,40.0,19,40,58,58,14,26,40,122.0,972.0,1087,411,435,846,2176.0,82,6.05,85,480,2458,10.1,0.53219587
9863,9863,Gary Roberts,2007-08,41.0,20,42,69,69,20,22,42,125.0,1154.0,1156,431,457,888,2301.0,82,5.76,70,398,2426,9.7,0.48948187
9864,9864,Gary Roberts,2008-09,42.0,21,15,38,38,3,12,15,41.0,507.0,1194,434,469,903,2342.0,82,5.44,62,351,2383,9.4,0.30394447
9865,9865,Gary Roberts,2009-10,43.0,22,7,30,30,4,3,7,32.0,349.0,1224,438,472,910,2374.0,82,5.7,65,341,2477,9.4,0.3218274
9866,9866,Gary Sampson,1984-85,25.0,2,2,15,15,1,1,2,17.0,,15,1,1,2,17.0,80,7.89,74,336,2448,12.9,0.25540945
9867,9867,Gary Sampson,1985-86,26.0,3,25,46,46,10,15,25,51.0,,61,11,16,27,68.0,80,7.77,71,321,2447,12.7,0.4095618
9868,9868,Gary Sampson,1986-87,27.0,4,5,19,19,1,4,5,17.0,,80,12,20,32,85.0,80,7.94,82,370,2484,12.8,0.25638667
9869,9869,Gary Sampson,1987-88,28.0,5,3,25,25,1,2,3,14.0,,105,13,22,35,99.0,80,7.34,72,344,2400,12.2,0.18938658
9870,9870,Gary Shuchuk,1991-92,24.0,2,3,6,6,1,2,3,8.0,,6,1,2,3,8.0,80,6.91,71,366,2385,11.6,0.26069966
9871,9871,Gary Shuchuk,1993-94,26.0,3,6,25,25,2,4,6,24.0,,31,3,6,9,32.0,84,7.25,87,443,2603,11.7,0.23827514
9872,9872,Gary Shuchuk,1994-95,27.0,4,7,56,56,3,4,7,55.0,,87,6,10,16,87.0,84,6.48,76,407,2545,10.7,0.17596918
9873,9873,Gary Shuchuk,1995-96,28.0,5,9,22,22,3,6,9,16.0,,109,9,16,25,103.0,48,5.97,37,209,1408,10.2,0.29623276
9874,9874,Gary Shuchuk,1996-97,29.0,6,14,33,33,4,10,14,22.0,,142,13,26,39,125.0,82,6.29,74,413,2481,10.4,0.22380403
9875,9875,Gary Suter,1986-87,22.0,2,68,80,80,18,50,68,195.0,,80,18,50,68,195.0,80,7.94,82,370,2484,12.8,0.8163196
9876,9876,Gary Suter,1987-88,23.0,3,48,68,68,9,39,48,152.0,,148,27,89,116,347.0,80,7.34,72,344,2400,12.2,0.7290854
9877,9877,Gary Suter,1988-89,24.0,4,91,75,75,21,70,91,204.0,,223,48,159,207,551.0,80,7.43,89,437,2435,12.2,1.062798
9878,9878,Gary Suter,1989-90,25.0,5,62,63,63,13,49,62,216.0,,286,61,208,269,767.0,80,7.48,85,403,2430,12.3,1.0258925
9879,9879,Gary Suter,1990-91,26.0,6,76,76,76,16,60,76,211.0,,362,77,268,345,978.0,80,7.37,76,367,2421,12.2,0.9312936
9880,9880,Gary Suter,1991-92,27.0,7,70,79,79,12,58,70,258.0,,441,89,326,415,1236.0,80,6.91,71,366,2385,11.6,0.8538939
9881,9881,Gary Suter,1992-93,28.0,8,55,70,70,12,43,55,189.0,,511,101,369,470,1425.0,80,6.96,77,402,2440,11.4,0.88025033
9882,9882,Gary Suter,1993-94,29.0,9,81,81,81,23,58,81,263.0,,592,124,427,551,1688.0,84,7.25,87,443,2603,11.7,0.79903674
9883,9883,Gary Suter,1994-95,30.0,10,18,41,41,6,12,18,86.0,,633,130,439,569,1774.0,84,6.48,76,407,2545,10.7,0.5218493
9884,9884,Gary Suter,1995-96,31.0,11,37,48,48,10,27,37,144.0,,681,140,466,606,1918.0,48,5.97,37,209,1408,10.2,0.78973114
9885,9885,Gary Suter,1996-97,32.0,12,67,82,82,20,47,67,242.0,,763,160,513,673,2160.0,82,6.29,74,413,2481,10.4,0.7536784
9886,9886,Gary Suter,1997-98,33.0,13,28,82,82,7,21,28,225.0,,845,167,534,701,2385.0,82,5.83,55,336,2444,9.8,0.47853455
9887,9887,Gary Suter,1998-99,34.0,14,42,73,73,14,28,42,199.0,,918,181,562,743,2584.0,82,5.28,57,380,2242,9.6,0.57395
9888,9888,Gary Suter,1999-00,35.0,15,0,1,1,0,0,0,1.0,13.0,919,181,562,743,2585.0,82,5.27,57,359,2285,9.4,0.38390374
9889,9889,Gary Suter,2000-01,36.0,16,34,76,76,6,28,34,175.0,1785.0,995,187,590,777,2760.0,82,5.49,53,331,2294,9.8,0.41110867
9890,9890,Gary Suter,2001-02,37.0,17,34,68,68,10,24,34,157.0,1459.0,1063,197,614,811,2917.0,82,5.51,63,376,2272,9.9,0.4018082
9891,9891,Gary Suter,2002-03,38.0,18,33,82,82,6,27,33,174.0,1650.0,1145,203,641,844,3091.0,82,5.24,53,338,2262,9.5,0.44011945
9892,9892,Gary Yaremchuk,1982-83,21.0,2,3,18,18,0,3,3,6.0,,18,0,3,3,6.0,80,8.03,73,320,2489,12.9,0.26422137
9893,9893,Gary Yaremchuk,1983-84,22.0,3,0,3,3,0,0,0,3.0,,21,0,3,3,9.0,80,7.73,71,310,2444,12.7,0.1980648
9894,9894,Gary Yaremchuk,1984-85,23.0,4,0,1,1,0,0,0,1.0,,22,0,3,3,10.0,80,7.89,74,336,2448,12.9,0.19547415
9895,9895,Gary Yaremchuk,1985-86,24.0,5,2,12,12,1,1,2,7.0,,34,1,4,5,17.0,80,7.77,71,321,2447,12.7,0.22338429
9896,9896,Gaston Gingras,1980-81,21.0,2,10,34,34,3,7,10,60.0,,34,3,7,10,60.0,80,7.03,61,280,2352,12.0,0.3475165
9897,9897,Gaston Gingras,1981-82,22.0,3,21,55,55,5,16,21,133.0,,89,8,23,31,193.0,80,7.69,77,340,2441,12.6,0.49016267
9898,9898,Gaston Gingras,1982-83,23.0,4,24,34,34,6,18,24,89.0,,123,14,41,55,282.0,80,8.03,73,320,2489,12.9,0.5376037
9899,9899,Gaston Gingras,1983-84,24.0,5,37,67,67,11,26,37,155.0,,190,25,67,92,437.0,80,7.73,71,310,2444,12.7,0.5237651
9900,9900,Gaston Gingras,1984-85,25.0,6,27,59,59,7,20,27,125.0,,249,32,87,119,562.0,80,7.89,74,336,2448,12.9,0.49851707
9901,9901,Gaston Gingras,1985-86,26.0,7,2,5,5,0,2,2,17.0,,254,32,89,121,579.0,80,7.77,71,321,2447,12.7,0.3307634
9902,9902,Gaston Gingras,1986-87,27.0,8,26,34,34,8,18,26,77.0,,288,40,107,147,656.0,80,7.94,82,370,2484,12.8,0.6466002
9903,9903,Gaston Gingras,1987-88,28.0,9,45,66,66,11,34,45,174.0,,354,51,141,192,830.0,80,7.34,72,344,2400,12.2,0.595546
9904,9904,Gaston Gingras,1988-89,29.0,10,30,70,70,7,23,30,133.0,,424,58,164,222,963.0,80,7.43,89,437,2435,12.2,0.43514073
9905,9905,Gaston Gingras,1989-90,30.0,11,13,52,52,3,10,13,98.0,,476,61,174,235,1061.0,80,7.48,85,403,2430,12.3,0.2909258
9906,9906,Gaston Therrien,1981-82,21.0,2,1,3,3,0,1,1,10.0,,3,0,1,1,10.0,80,7.69,77,340,2441,12.6,0.31849843
9907,9907,Gaston Therrien,1982-83,22.0,3,7,14,14,0,7,7,15.0,,17,0,8,8,25.0,80,8.03,73,320,2489,12.9,0.24351925
9908,9908,Gaston Therrien,1983-84,23.0,4,0,5,5,0,0,0,5.0,,22,0,8,8,30.0,80,7.73,71,310,2444,12.7,0.20014927
9909,9909,Gates Orlando,1985-86,23.0,2,9,11,11,3,6,9,22.0,,11,3,6,9,22.0,80,7.77,71,321,2447,12.7,0.38286573
9910,9910,Gates Orlando,1986-87,24.0,3,25,60,60,13,12,25,70.0,,71,16,18,34,92.0,80,7.94,82,370,2484,12.8,0.41454786
9911,9911,Gates Orlando,1987-88,25.0,4,10,27,27,2,8,10,24.0,,98,18,26,44,116.0,80,7.34,72,344,2400,12.2,0.36485854
9912,9912,Gavin Bayreuther,2019-20,25.0,2,5,19,19,2,3,5,25.0,346.0,19,2,3,5,25.0,82,5.96,47,239,2579,9.5,0.22799525
9913,9913,Gavin Morgan,2004-05,28.0,2,0,6,6,0,0,0,7.0,35.0,6,0,0,0,7.0,82,5.14,57,348,2300,9.2,0.18953094
9914,9914,Gemel Smith,2017-18,23.0,2,6,17,17,3,3,6,19.0,231.0,17,3,3,6,19.0,82,5.45,47,245,2478,9.0,0.27995896
9915,9915,Gemel Smith,2018-19,24.0,3,11,46,46,6,5,11,42.0,434.0,63,9,8,17,61.0,82,5.86,50,250,2620,9.2,0.23439124
9916,9916,Gemel Smith,2019-20,25.0,4,3,17,17,2,1,3,14.0,142.0,80,11,9,20,75.0,82,5.96,47,239,2579,9.5,0.23256528
9917,9917,Gemel Smith,2020-21,26.0,5,1,3,3,1,0,1,1.0,28.0,83,12,9,21,76.0,70,5.96,42,208,2192,9.5,0.22121873
9918,9918,Geoff Courtnall,1984-85,22.0,2,0,4,4,0,0,0,1.0,,4,0,0,0,1.0,80,7.89,74,336,2448,12.9,0.22380707
9919,9919,Geoff Courtnall,1985-86,23.0,3,28,64,64,12,16,28,87.0,,68,12,16,28,88.0,80,7.77,71,321,2447,12.7,0.4551863
9920,9920,Geoff Courtnall,1986-87,24.0,4,37,64,64,21,16,37,162.0,,132,33,32,65,250.0,80,7.94,82,370,2484,12.8,0.58657193
9921,9921,Geoff Courtnall,1987-88,25.0,5,36,65,65,13,23,36,178.0,,197,46,55,101,428.0,80,7.34,72,344,2400,12.2,0.58191335
9922,9922,Geoff Courtnall,1988-89,26.0,6,66,74,74,36,30,66,252.0,,271,82,85,167,680.0,80,7.43,89,437,2435,12.2,0.85756636
9923,9923,Geoff Courtnall,1989-90,27.0,7,80,79,79,42,38,80,239.0,,350,124,123,247,919.0,80,7.48,85,403,2430,12.3,0.851195
9924,9924,Geoff Courtnall,1990-91,28.0,8,74,80,80,35,39,74,307.0,,430,159,162,321,1226.0,80,7.37,76,367,2421,12.2,0.83380115
9925,9925,Geoff Courtnall,1991-92,29.0,9,65,77,77,33,32,65,263.0,,507,192,194,386,1489.0,80,6.91,71,366,2385,11.6,0.7960931
9926,9926,Geoff Courtnall,1992-93,30.0,10,57,70,70,23,34,57,281.0,,577,215,228,443,1770.0,80,6.96,77,402,2440,11.4,0.795388
9927,9927,Geoff Courtnall,1993-94,31.0,11,77,84,84,31,46,77,214.0,,661,246,274,520,1984.0,84,7.25,87,443,2603,11.7,0.75571644
9928,9928,Geoff Courtnall,1994-95,32.0,12,70,82,82,26,44,70,264.0,,743,272,318,590,2248.0,84,6.48,76,407,2545,10.7,0.7561233
9929,9929,Geoff Courtnall,1995-96,33.0,13,34,45,45,16,18,34,144.0,,788,288,336,624,2392.0,48,5.97,37,209,1408,10.2,0.69351506
9930,9930,Geoff Courtnall,1996-97,34.0,14,40,69,69,24,16,40,228.0,,857,312,352,664,2620.0,82,6.29,74,413,2481,10.4,0.5824038
9931,9931,Geoff Courtnall,1997-98,35.0,15,57,82,82,17,40,57,203.0,,939,329,392,721,2823.0,82,5.83,55,336,2444,9.8,0.6128569
9932,9932,Geoff Courtnall,1998-99,36.0,16,62,79,79,31,31,62,189.0,,1018,360,423,783,3012.0,82,5.28,57,380,2242,9.6,0.6047052
9933,9933,Geoff Courtnall,1999-00,37.0,17,12,24,24,5,7,12,60.0,355.0,1042,365,430,795,3072.0,82,5.27,57,359,2285,9.4,0.44103172
9934,9934,Geoff Courtnall,2000-01,38.0,18,4,6,6,2,2,4,15.0,86.0,1048,367,432,799,3087.0,82,5.49,53,331,2294,9.8,0.44305384
9935,9935,Geoff Kinrade,2009-10,24.0,2,0,1,1,0,0,0,1.0,18.0,1,0,0,0,1.0,82,5.7,65,341,2477,9.4,0.17428878
9936,9936,Geoff Platt,2006-07,21.0,2,5,15,15,0,5,5,29.0,168.0,15,0,5,5,29.0,82,6.05,85,480,2458,10.1,0.26824152
9937,9937,Geoff Platt,2007-08,22.0,3,9,26,26,4,5,9,40.0,262.0,41,4,10,14,69.0,82,5.76,70,398,2426,9.7,0.26694208
9938,9938,Geoff Platt,2008-09,23.0,4,0,5,5,0,0,0,4.0,56.0,46,4,10,14,73.0,82,5.44,62,351,2383,9.4,0.20901382
9939,9939,Geoff Sanderson,1991-92,19.0,2,1,2,2,1,0,1,2.0,,2,1,0,1,2.0,80,6.91,71,366,2385,11.6,0.28590822
9940,9940,Geoff Sanderson,1992-93,20.0,3,31,64,64,13,18,31,98.0,,66,14,18,32,100.0,80,6.96,77,402,2440,11.4,0.62108076
9941,9941,Geoff Sanderson,1993-94,21.0,4,89,82,82,46,43,89,271.0,,148,60,61,121,371.0,84,7.25,87,443,2603,11.7,0.98068416
9942,9942,Geoff Sanderson,1994-95,22.0,5,67,82,82,41,26,67,266.0,,230,101,87,188,637.0,84,6.48,76,407,2545,10.7,0.788622
9943,9943,Geoff Sanderson,1995-96,23.0,6,32,46,46,18,14,32,170.0,,276,119,101,220,807.0,48,5.97,37,209,1408,10.2,0.7828298
9944,9944,Geoff Sanderson,1996-97,24.0,7,65,81,81,34,31,65,314.0,,357,153,132,285,1121.0,82,6.29,74,413,2481,10.4,0.82917976
9945,9945,Geoff Sanderson,1997-98,25.0,8,67,82,82,36,31,67,297.0,,439,189,163,352,1418.0,82,5.83,55,336,2444,9.8,0.8092253
9946,9946,Geoff Sanderson,1998-99,26.0,9,29,75,75,11,18,29,197.0,,514,200,181,381,1615.0,82,5.28,57,380,2242,9.6,0.51346844
9947,9947,Geoff Sanderson,1999-00,27.0,10,30,75,75,12,18,30,155.0,969.0,589,212,199,411,1770.0,82,5.27,57,359,2285,9.4,0.47449386
9948,9948,Geoff Sanderson,2000-01,28.0,11,26,67,67,13,13,26,136.0,865.0,656,225,212,437,1906.0,82,5.49,53,331,2294,9.8,0.42543504
9949,9949,Geoff Sanderson,2001-02,29.0,12,56,68,68,30,26,56,199.0,1130.0,724,255,238,493,2105.0,82,5.51,63,376,2272,9.9,0.7207949
9950,9950,Geoff Sanderson,2002-03,30.0,13,16,42,42,11,5,16,112.0,707.0,766,266,243,509,2217.0,82,5.24,53,338,2262,9.5,0.53030217
9951,9951,Geoff Sanderson,2003-04,31.0,14,67,82,82,34,33,67,286.0,1536.0,848,300,276,576,2503.0,82,5.31,60,363,2326,9.4,0.69766283
9952,9952,Geoff Sanderson,2004-05,32.0,15,36,80,80,16,20,36,227.0,1287.0,928,316,296,612,2730.0,82,5.14,57,348,2300,9.2,0.55765826
9953,9953,Geoff Sanderson,2006-07,34.0,16,46,77,77,25,21,46,159.0,1056.0,1005,341,317,658,2889.0,82,6.05,85,480,2458,10.1,0.46283138
9954,9954,Geoff Sanderson,2007-08,35.0,17,29,58,58,11,18,29,143.0,811.0,1063,352,335,687,3032.0,82,5.76,70,398,2426,9.7,0.40463534
9955,9955,Geoff Sanderson,2008-09,36.0,18,13,41,41,3,10,13,40.0,416.0,1104,355,345,700,3072.0,82,5.44,62,351,2383,9.4,0.30773437
9956,9956,Geoff Smith,1990-91,21.0,2,15,74,74,4,11,15,66.0,,74,4,11,15,66.0,80,7.37,76,367,2421,12.2,0.27442726
9957,9957,Geoff Smith,1991-92,22.0,3,13,59,59,1,12,13,66.0,,133,5,23,28,132.0,80,6.91,71,366,2385,11.6,0.2502694
9958,9958,Geoff Smith,1992-93,23.0,4,18,74,74,2,16,18,61.0,,207,7,39,46,193.0,80,6.96,77,402,2440,11.4,0.2767915
9959,9959,Geoff Smith,1993-94,24.0,5,18,78,78,4,14,18,67.0,,285,11,53,64,260.0,84,7.25,87,443,2603,11.7,0.2129511
9960,9960,Geoff Smith,1994-95,25.0,6,9,77,77,1,8,9,67.0,,362,12,61,73,327.0,84,6.48,76,407,2545,10.7,0.15402108
9961,9961,Geoff Smith,1995-96,26.0,7,6,47,47,2,4,6,40.0,,409,14,65,79,367.0,48,5.97,37,209,1408,10.2,0.19514844
9962,9962,Geoff Smith,1996-97,27.0,8,10,31,31,3,7,10,34.0,,440,17,72,89,401.0,82,6.29,74,413,2481,10.4,0.21785343
9963,9963,Geoff Smith,1997-98,28.0,9,0,3,3,0,0,0,2.0,,443,17,72,89,403.0,82,5.83,55,336,2444,9.8,0.17667595
9964,9964,Geoff Smith,1998-99,29.0,10,2,15,15,1,1,2,11.0,,458,18,73,91,414.0,82,5.28,57,380,2242,9.6,0.19468045
9965,9965,Geoff Smith,1999-00,30.0,11,0,4,4,0,0,0,0.0,60.0,462,18,73,91,414.0,82,5.27,57,359,2285,9.4,0.1830891
9966,9966,Geordie Kinnear,2000-01,27.0,2,0,4,4,0,0,0,2.0,74.0,4,0,0,0,2.0,82,5.49,53,331,2294,9.8,0.15595585
9967,9967,Geordie Robertson,1983-84,24.0,2,3,5,5,1,2,3,10.0,,5,1,2,3,10.0,80,7.73,71,310,2444,12.7,0.29690427
9968,9968,George Lyle,1980-81,27.0,2,11,27,27,7,4,11,41.0,,27,7,4,11,41.0,80,7.03,61,280,2352,12.0,0.36080518
9969,9969,George Lyle,1981-82,28.0,3,24,31,31,10,14,24,49.0,,58,17,18,35,90.0,80,7.69,77,340,2441,12.6,0.47988695
9970,9970,George Lyle,1982-83,29.0,4,17,25,25,3,14,17,42.0,,83,20,32,52,132.0,80,8.03,73,320,2489,12.9,0.5141826
9971,9971,George Lyle,1983-84,30.0,5,10,16,16,4,6,10,33.0,,99,24,38,62,165.0,80,7.73,71,310,2444,12.7,0.36016455
9972,9972,George McPhee,1984-85,26.0,2,2,9,9,1,1,2,1.0,,9,1,1,2,1.0,80,7.89,74,336,2448,12.9,0.27695894
9973,9973,George McPhee,1985-86,27.0,3,27,49,49,12,15,27,54.0,,58,13,16,29,55.0,80,7.77,71,321,2447,12.7,0.43251067
9974,9974,George McPhee,1986-87,28.0,4,8,30,30,4,4,8,31.0,,88,17,20,37,86.0,80,7.94,82,370,2484,12.8,0.3020214
9975,9975,George McPhee,1987-88,29.0,5,8,21,21,4,4,8,31.0,,109,21,24,45,117.0,80,7.34,72,344,2400,12.2,0.36814252
9976,9976,George McPhee,1988-89,30.0,6,3,5,5,3,0,3,5.0,,114,24,24,48,122.0,80,7.43,89,437,2435,12.2,0.38924813
9977,9977,George McPhee,1989-90,31.0,7,1,1,1,0,1,1,0.0,,115,24,25,49,122.0,80,7.48,85,403,2430,12.3,0.25825876
9978,9978,George Parros,2006-07,27.0,2,5,55,55,2,3,5,23.0,272.0,55,2,3,5,23.0,82,6.05,85,480,2458,10.1,0.10969365
9979,9979,George Parros,2007-08,28.0,3,1,34,34,1,0,1,19.0,172.0,89,3,3,6,42.0,82,5.76,70,398,2426,9.7,0.124483824
9980,9980,George Parros,2008-09,29.0,4,5,69,69,1,4,5,30.0,410.0,158,4,7,11,72.0,82,5.44,62,351,2383,9.4,0.102326125
9981,9981,George Parros,2009-10,30.0,5,10,74,74,5,5,10,47.0,463.0,232,9,12,21,119.0,82,5.7,65,341,2477,9.4,0.1455884
9982,9982,George Parros,2010-11,31.0,6,4,57,57,4,0,4,25.0,342.0,289,13,12,25,144.0,82,5.53,56,304,2486,9.1,0.08041996
9983,9983,George Parros,2011-12,32.0,7,4,78,78,3,1,4,33.0,500.0,367,16,13,29,177.0,82,5.46,52,291,2492,9.0,0.10063875
9984,9984,George Parros,2012-13,33.0,8,4,46,46,1,3,4,17.0,293.0,413,17,16,33,194.0,82,5.32,47,271,2439,8.9,0.07529935
9985,9985,George Parros,2013-14,34.0,9,2,39,39,1,1,2,16.0,258.0,452,18,17,35,210.0,48,5.31,29,160,1399,9.1,0.09626761
9986,9986,George Parros,2014-15,35.0,10,1,22,22,0,1,1,4.0,100.0,474,18,18,36,214.0,82,5.34,48,269,2463,8.9,0.07037178
9987,9987,George Servinis,1988-89,26.0,2,0,5,5,0,0,0,8.0,,5,0,0,0,8.0,80,7.43,89,437,2435,12.2,0.2236597
9988,9988,Georges Laraque,1998-99,22.0,2,0,11,11,0,0,0,4.0,,11,0,0,0,4.0,82,5.28,57,380,2242,9.6,0.15597463
9989,9989,Georges Laraque,1999-00,23.0,3,5,39,39,3,2,5,17.0,215.0,50,3,2,5,21.0,82,5.27,57,359,2285,9.4,0.17242223
9990,9990,Georges Laraque,2000-01,24.0,4,16,76,76,8,8,16,56.0,644.0,126,11,10,21,77.0,82,5.49,53,331,2294,9.8,0.19176573
9991,9991,Georges Laraque,2001-02,25.0,5,29,82,82,13,16,29,73.0,742.0,208,24,26,50,150.0,82,5.51,63,376,2272,9.9,0.33714655
9992,9992,Georges Laraque,2002-03,26.0,6,19,80,80,5,14,19,95.0,784.0,288,29,40,69,245.0,82,5.24,53,338,2262,9.5,0.26405528
9993,9993,Georges Laraque,2003-04,27.0,7,13,64,64,6,7,13,46.0,592.0,352,35,47,82,291.0,82,5.31,60,363,2326,9.4,0.18963113
9994,9994,Georges Laraque,2004-05,28.0,8,17,66,66,6,11,17,54.0,618.0,418,41,58,99,345.0,82,5.14,57,348,2300,9.2,0.22355133
9995,9995,Georges Laraque,2006-07,30.0,9,12,72,72,2,10,12,50.0,474.0,490,43,68,111,395.0,82,6.05,85,480,2458,10.1,0.17784634
9996,9996,Georges Laraque,2007-08,31.0,10,24,73,73,5,19,24,44.0,705.0,563,48,87,135,439.0,82,5.76,70,398,2426,9.7,0.2361933
9997,9997,Georges Laraque,2008-09,32.0,11,13,71,71,4,9,13,29.0,547.0,634,52,96,148,468.0,82,5.44,62,351,2383,9.4,0.13551152
9998,9998,Georges Laraque,2009-10,33.0,12,2,33,33,0,2,2,15.0,252.0,667,52,98,150,483.0,82,5.7,65,341,2477,9.4,0.13495275
9999,9999,Georges Laraque,2010-11,34.0,13,3,28,28,1,2,3,2.0,161.0,695,53,100,153,485.0,82,5.53,56,304,2486,9.1,0.117367566
10000,10000,Gerald Diduck,1985-86,20.0,2,10,65,65,2,8,10,52.0,,65,2,8,10,52.0,80,7.77,71,321,2447,12.7,0.2690723
10001,10001,Gerald Diduck,1986-87,21.0,3,3,10,10,1,2,3,6.0,,75,3,10,13,58.0,80,7.94,82,370,2484,12.8,0.2842636
10002,10002,Gerald Diduck,1987-88,22.0,4,5,30,30,2,3,5,54.0,,105,5,13,18,112.0,80,7.34,72,344,2400,12.2,0.30816126
10003,10003,Gerald Diduck,1988-89,23.0,5,19,68,68,7,12,19,128.0,,173,12,25,37,240.0,80,7.43,89,437,2435,12.2,0.35886508
10004,10004,Gerald Diduck,1989-90,24.0,6,32,65,65,11,21,32,132.0,,238,23,46,69,372.0,80,7.48,85,403,2430,12.3,0.44297063
10005,10005,Gerald Diduck,1990-91,25.0,7,20,76,76,3,17,20,102.0,,314,26,63,89,474.0,80,7.37,76,367,2421,12.2,0.26821488
10006,10006,Gerald Diduck,1991-92,26.0,8,13,63,63,4,9,13,100.0,,377,30,72,102,574.0,80,6.91,71,366,2385,11.6,0.26796502
10007,10007,Gerald Diduck,1992-93,27.0,9,27,77,77,6,21,27,128.0,,454,36,93,129,702.0,80,6.96,77,402,2440,11.4,0.32166916
10008,10008,Gerald Diduck,1993-94,28.0,10,20,80,80,6,14,20,92.0,,534,42,107,149,794.0,84,7.25,87,443,2603,11.7,0.25908718
10009,10009,Gerald Diduck,1994-95,29.0,11,11,55,55,1,10,11,50.0,,589,43,117,160,844.0,84,6.48,76,407,2545,10.7,0.16573548
10010,10010,Gerald Diduck,1995-96,30.0,12,5,35,35,2,3,5,67.0,,624,45,120,165,911.0,48,5.97,37,209,1408,10.2,0.22726935
10011,10011,Gerald Diduck,1996-97,31.0,13,10,79,79,1,9,10,93.0,,703,46,129,175,1004.0,82,6.29,74,413,2481,10.4,0.14753652
10012,10012,Gerald Diduck,1997-98,32.0,14,14,67,67,2,12,14,80.0,,770,48,141,189,1084.0,82,5.83,55,336,2444,9.8,0.1644041
10013,10013,Gerald Diduck,1998-99,33.0,15,18,78,78,8,10,18,104.0,,848,56,151,207,1188.0,82,5.28,57,380,2242,9.6,0.22800872
10014,10014,Gerald Diduck,1999-00,34.0,16,2,44,44,0,2,2,39.0,815.0,892,56,153,209,1227.0,82,5.27,57,359,2285,9.4,0.12676182
10015,10015,Gerald Diduck,2000-01,35.0,17,3,26,26,0,3,3,18.0,401.0,918,56,156,212,1245.0,82,5.49,53,331,2294,9.8,0.13389641
10016,10016,Gerald Diduck,2001-02,36.0,18,0,14,14,0,0,0,8.0,150.0,932,56,156,212,1253.0,82,5.51,63,376,2272,9.9,0.1299128
10017,10017,Gerald Mayhew,2020-21,28.0,2,2,13,13,2,0,2,16.0,150.0,13,2,0,2,16.0,70,5.96,42,208,2192,9.5,0.26803508
10018,10018,Gerard Gallant,1985-86,22.0,2,18,32,32,6,12,18,44.0,,32,6,12,18,44.0,80,7.77,71,321,2447,12.7,0.4950582
10019,10019,Gerard Gallant,1986-87,23.0,3,39,52,52,20,19,39,116.0,,84,26,31,57,160.0,80,7.94,82,370,2484,12.8,0.64758044
10020,10020,Gerard Gallant,1987-88,24.0,4,72,80,80,38,34,72,191.0,,164,64,65,129,351.0,80,7.34,72,344,2400,12.2,0.9363853
10021,10021,Gerard Gallant,1988-89,25.0,5,73,73,73,34,39,73,197.0,,237,98,104,202,548.0,80,7.43,89,437,2435,12.2,0.907753
10022,10022,Gerard Gallant,1989-90,26.0,6,93,76,76,39,54,93,221.0,,313,137,158,295,769.0,80,7.48,85,403,2430,12.3,1.0581272
10023,10023,Gerard Gallant,1990-91,27.0,7,80,69,69,36,44,80,219.0,,382,173,202,375,988.0,80,7.37,76,367,2421,12.2,0.8731139
10024,10024,Gerard Gallant,1991-92,28.0,8,26,45,45,10,16,26,82.0,,427,183,218,401,1070.0,80,6.91,71,366,2385,11.6,0.60598606
10025,10025,Gerard Gallant,1992-93,29.0,9,36,69,69,14,22,36,116.0,,496,197,240,437,1186.0,80,6.96,77,402,2440,11.4,0.52192765
10026,10026,Gerard Gallant,1993-94,30.0,10,30,67,67,10,20,30,81.0,,563,207,260,467,1267.0,84,7.25,87,443,2603,11.7,0.42043757
10027,10027,Gerard Gallant,1994-95,31.0,11,13,51,51,4,9,13,45.0,,614,211,269,480,1312.0,84,6.48,76,407,2545,10.7,0.27001137
10028,10028,Gerard Gallant,1995-96,32.0,12,0,1,1,0,0,0,1.0,,615,211,269,480,1313.0,48,5.97,37,209,1408,10.2,0.39989558
10029,10029,German Rubtsov,2020-21,22.0,2,0,4,4,0,0,0,1.0,27.0,4,0,0,0,1.0,70,5.96,42,208,2192,9.5,0.19276294
10030,10030,German Titov,1994-95,29.0,2,45,76,76,27,18,45,153.0,,76,27,18,45,153.0,84,6.48,76,407,2545,10.7,0.49754456
10031,10031,German Titov,1995-96,30.0,3,24,40,40,12,12,24,88.0,,116,39,30,69,241.0,48,5.97,37,209,1408,10.2,0.54380244
10032,10032,German Titov,1996-97,31.0,4,67,82,82,28,39,67,214.0,,198,67,69,136,455.0,82,6.29,74,413,2481,10.4,0.6878251
10033,10033,German Titov,1997-98,32.0,5,52,79,79,22,30,52,192.0,,277,89,99,188,647.0,82,5.83,55,336,2444,9.8,0.57428956
10034,10034,German Titov,1998-99,33.0,6,40,68,68,18,22,40,133.0,,345,107,121,228,780.0,82,5.28,57,380,2242,9.6,0.5674633
10035,10035,German Titov,1999-00,34.0,7,56,72,72,11,45,56,113.0,1405.0,417,118,166,284,893.0,82,5.27,57,359,2285,9.4,0.6168529
10036,10036,German Titov,2000-01,35.0,8,46,70,70,17,29,46,122.0,1376.0,487,135,195,330,1015.0,82,5.49,53,331,2294,9.8,0.5226685
10037,10037,German Titov,2001-02,36.0,9,20,71,71,9,11,20,78.0,1128.0,558,144,206,350,1093.0,82,5.51,63,376,2272,9.9,0.28640383
10038,10038,German Titov,2002-03,37.0,10,27,66,66,13,14,27,63.0,824.0,624,157,220,377,1156.0,82,5.24,53,338,2262,9.5,0.32741633
10039,10039,Gerry Fleming,1994-95,28.0,2,0,5,5,0,0,0,4.0,,5,0,0,0,4.0,84,6.48,76,407,2545,10.7,0.15394169
10040,10040,Gerry Fleming,1995-96,29.0,3,0,6,6,0,0,0,1.0,,11,0,0,0,5.0,48,5.97,37,209,1408,10.2,0.1648314
10041,10041,Gerry McDonald,1982-83,24.0,2,0,3,3,0,0,0,1.0,,3,0,0,0,1.0,80,8.03,73,320,2489,12.9,0.22071677
10042,10042,Gerry McDonald,1984-85,26.0,3,0,5,5,0,0,0,7.0,,8,0,0,0,8.0,80,7.89,74,336,2448,12.9,0.1953536
10043,10043,Gerry Minor,1980-81,22.0,2,1,5,5,0,1,1,4.0,,5,0,1,1,4.0,80,7.03,61,280,2352,12.0,0.25166434
10044,10044,Gerry Minor,1981-82,23.0,3,24,74,74,10,14,24,93.0,,79,10,15,25,97.0,80,7.69,77,340,2441,12.6,0.3737688
10045,10045,Gerry Minor,1982-83,24.0,4,1,13,13,0,1,1,18.0,,92,10,16,26,115.0,80,8.03,73,320,2489,12.9,0.2593667
10046,10046,Gerry Minor,1983-84,25.0,5,6,39,39,1,5,6,24.0,,131,11,21,32,139.0,80,7.73,71,310,2444,12.7,0.16852209
10047,10047,Gerry Minor,1984-85,26.0,6,0,9,9,0,0,0,2.0,,140,11,21,32,141.0,80,7.89,74,336,2448,12.9,0.1978763
10048,10048,Gerry Rioux,1980-81,21.0,2,0,8,8,0,0,0,4.0,,8,0,0,0,4.0,80,7.03,61,280,2352,12.0,0.23218885
10049,10049,Gilbert Brule,2006-07,20.0,2,4,7,7,2,2,4,11.0,92.0,7,2,2,4,11.0,82,6.05,85,480,2458,10.1,0.30433238
10050,10050,Gilbert Brule,2007-08,21.0,3,19,78,78,9,10,19,98.0,830.0,85,11,12,23,109.0,82,5.76,70,398,2426,9.7,0.3398874
10051,10051,Gilbert Brule,2008-09,22.0,4,9,61,61,1,8,9,74.0,604.0,146,12,20,32,183.0,82,5.44,62,351,2383,9.4,0.23540437
10052,10052,Gilbert Brule,2009-10,23.0,5,3,11,11,2,1,3,13.0,109.0,157,14,21,35,196.0,82,5.7,65,341,2477,9.4,0.28590328
10053,10053,Gilbert Brule,2010-11,24.0,6,37,65,65,17,20,37,121.0,925.0,222,31,41,72,317.0,82,5.53,56,304,2486,9.1,0.47118974
10054,10054,Gilbert Brule,2011-12,25.0,7,9,41,41,7,2,9,72.0,565.0,263,38,43,81,389.0,82,5.46,52,291,2492,9.0,0.262487
10055,10055,Gilbert Brule,2012-13,26.0,8,14,33,33,5,9,14,56.0,382.0,296,43,52,95,445.0,82,5.32,47,271,2439,8.9,0.30972016
10056,10056,Gilbert Brule,2014-15,28.0,9,0,3,3,0,0,0,3.0,35.0,299,43,52,95,448.0,82,5.34,48,269,2463,8.9,0.21255761
10057,10057,Gilbert Delorme,1982-83,20.0,2,11,60,60,3,8,11,80.0,,60,3,8,11,80.0,80,8.03,73,320,2489,12.9,0.3314185
10058,10058,Gilbert Delorme,1983-84,21.0,3,33,78,78,12,21,33,166.0,,138,15,29,44,246.0,80,7.73,71,310,2444,12.7,0.48701277
10059,10059,Gilbert Delorme,1984-85,22.0,4,14,71,71,2,12,14,105.0,,209,17,41,58,351.0,80,7.89,74,336,2448,12.9,0.31844735
10060,10060,Gilbert Delorme,1985-86,23.0,5,14,74,74,2,12,14,86.0,,283,19,53,72,437.0,80,7.77,71,321,2447,12.7,0.28142858
10061,10061,Gilbert Delorme,1986-87,24.0,6,20,64,64,2,18,20,100.0,,347,21,71,92,537.0,80,7.94,82,370,2484,12.8,0.29862815
10062,10062,Gilbert Delorme,1987-88,25.0,7,7,43,43,4,3,7,46.0,,390,25,74,99,583.0,80,7.34,72,344,2400,12.2,0.23022223
10063,10063,Gilbert Delorme,1988-89,26.0,8,10,55,55,2,8,10,46.0,,445,27,82,109,629.0,80,7.43,89,437,2435,12.2,0.24653879
10064,10064,Gilbert Delorme,1989-90,27.0,9,4,42,42,1,3,4,23.0,,487,28,85,113,652.0,80,7.48,85,403,2430,12.3,0.141657
10065,10065,Gilbert Delorme,1990-91,28.0,10,10,54,54,3,7,10,37.0,,541,31,92,123,689.0,80,7.37,76,367,2421,12.2,0.21658283
10066,10066,Gilbert Dionne,1991-92,21.0,2,0,2,2,0,0,0,0.0,,2,0,0,0,0.0,80,6.91,71,366,2385,11.6,0.21852574
10067,10067,Gilbert Dionne,1992-93,22.0,3,34,39,39,21,13,34,90.0,,41,21,13,34,90.0,80,6.96,77,402,2440,11.4,0.679071
10068,10068,Gilbert Dionne,1993-94,23.0,4,48,75,75,20,28,48,145.0,,116,41,41,82,235.0,84,7.25,87,443,2603,11.7,0.5989789
10069,10069,Gilbert Dionne,1994-95,24.0,5,45,74,74,19,26,45,162.0,,190,60,67,127,397.0,84,6.48,76,407,2545,10.7,0.5441259
10070,10070,Gilbert Dionne,1995-96,25.0,6,9,26,26,0,9,9,33.0,,216,60,76,136,430.0,48,5.97,37,209,1408,10.2,0.39410174
10071,10071,Gilbert Dionne,1996-97,26.0,7,4,7,7,1,3,4,12.0,,223,61,79,140,442.0,82,6.29,74,413,2481,10.4,0.32553062
10072,10072,Gilles Bilodeau,1980-81,25.0,2,1,9,9,0,1,1,1.0,,9,0,1,1,1.0,80,7.03,61,280,2352,12.0,0.2215442
10073,10073,Gilles Hamel,1981-82,21.0,2,19,51,51,10,9,19,56.0,,51,10,9,19,56.0,80,7.69,77,340,2441,12.6,0.41627473
10074,10074,Gilles Hamel,1982-83,22.0,3,9,16,16,2,7,9,17.0,,67,12,16,28,73.0,80,8.03,73,320,2489,12.9,0.42194462
10075,10075,Gilles Hamel,1983-84,23.0,4,42,66,66,22,20,42,121.0,,133,34,36,70,194.0,80,7.73,71,310,2444,12.7,0.5775366
10076,10076,Gilles Hamel,1984-85,24.0,5,44,75,75,21,23,44,135.0,,208,55,59,114,329.0,80,7.89,74,336,2448,12.9,0.5754878
10077,10077,Gilles Hamel,1985-86,25.0,6,48,80,80,18,30,48,163.0,,288,73,89,162,492.0,80,7.77,71,321,2447,12.7,0.60832644
10078,10078,Gilles Hamel,1986-87,26.0,7,44,77,77,19,25,44,158.0,,365,92,114,206,650.0,80,7.94,82,370,2484,12.8,0.56970257
10079,10079,Gilles Hamel,1987-88,27.0,8,48,79,79,27,21,48,175.0,,444,119,135,254,825.0,80,7.34,72,344,2400,12.2,0.5885567
10080,10080,Gilles Hamel,1988-89,28.0,9,19,63,63,8,11,19,106.0,,507,127,146,273,931.0,80,7.43,89,437,2435,12.2,0.33888668
10081,10081,Gilles Hamel,1989-90,29.0,10,1,12,12,0,1,1,11.0,,519,127,147,274,942.0,80,7.48,85,403,2430,12.3,0.29831314
10082,10082,Gilles Thibaudeau,1987-88,24.0,2,4,9,9,1,3,4,10.0,,9,1,3,4,10.0,80,7.34,72,344,2400,12.2,0.2958992
10083,10083,Gilles Thibaudeau,1988-89,25.0,3,11,17,17,5,6,11,25.0,,26,6,9,15,35.0,80,7.43,89,437,2435,12.2,0.37984636
10084,10084,Gilles Thibaudeau,1989-90,26.0,4,12,32,32,6,6,12,42.0,,58,12,15,27,77.0,80,7.48,85,403,2430,12.3,0.36289924
10085,10085,Gilles Thibaudeau,1990-91,27.0,5,26,41,41,11,15,26,67.0,,99,23,30,53,144.0,80,7.37,76,367,2421,12.2,0.4884671
10086,10086,Gilles Thibaudeau,1991-92,28.0,6,9,20,20,2,7,9,36.0,,119,25,37,62,180.0,80,6.91,71,366,2385,11.6,0.32827714
10087,10087,Gino Cavallini,1985-86,23.0,2,16,27,27,6,10,16,44.0,,27,6,10,16,44.0,80,7.77,71,321,2447,12.7,0.46365777
10088,10088,Gino Cavallini,1986-87,24.0,3,25,57,57,13,12,25,95.0,,84,19,22,41,139.0,80,7.94,82,370,2484,12.8,0.43091616
10089,10089,Gino Cavallini,1987-88,25.0,4,44,80,80,18,26,44,159.0,,164,37,48,85,298.0,80,7.34,72,344,2400,12.2,0.55928075
10090,10090,Gino Cavallini,1988-89,26.0,5,32,64,64,15,17,32,131.0,,228,52,65,117,429.0,80,7.43,89,437,2435,12.2,0.5265751
10091,10091,Gino Cavallini,1989-90,27.0,6,43,74,74,20,23,43,153.0,,302,72,88,160,582.0,80,7.48,85,403,2430,12.3,0.52161247
10092,10092,Gino Cavallini,1990-91,28.0,7,30,80,80,15,15,30,134.0,,382,87,103,190,716.0,80,7.37,76,367,2421,12.2,0.43723008
10093,10093,Gino Cavallini,1991-92,29.0,8,35,78,78,8,27,35,131.0,,460,95,130,225,847.0,80,6.91,71,366,2385,11.6,0.4181118
10094,10094,Gino Cavallini,1992-93,30.0,9,24,66,66,10,14,24,111.0,,526,105,144,249,958.0,80,6.96,77,402,2440,11.4,0.3282711
10095,10095,Gino Cavallini,1993-94,31.0,10,24,67,67,9,15,24,71.0,,593,114,159,273,1029.0,84,7.25,87,443,2603,11.7,0.2686295
10096,10096,Gino Odjick,1991-92,21.0,2,8,45,45,7,1,8,39.0,,45,7,1,8,39.0,80,6.91,71,366,2385,11.6,0.30477017
10097,10097,Gino Odjick,1992-93,22.0,3,10,65,65,4,6,10,68.0,,110,11,7,18,107.0,80,6.96,77,402,2440,11.4,0.26006576
10098,10098,Gino Odjick,1993-94,23.0,4,17,75,75,4,13,17,79.0,,185,15,20,35,186.0,84,7.25,87,443,2603,11.7,0.23731652
10099,10099,Gino Odjick,1994-95,24.0,5,29,76,76,16,13,29,121.0,,261,31,33,64,307.0,84,6.48,76,407,2545,10.7,0.38305876
10100,10100,Gino Odjick,1995-96,25.0,6,9,23,23,4,5,9,35.0,,284,35,38,73,342.0,48,5.97,37,209,1408,10.2,0.3132128
10101,10101,Gino Odjick,1996-97,26.0,7,7,55,55,3,4,7,59.0,,339,38,42,80,401.0,82,6.29,74,413,2481,10.4,0.17989013
10102,10102,Gino Odjick,1997-98,27.0,8,13,70,70,5,8,13,85.0,,409,43,50,93,486.0,82,5.83,55,336,2444,9.8,0.21293199
10103,10103,Gino Odjick,1998-99,28.0,9,5,48,48,3,2,5,52.0,,457,46,52,98,538.0,82,5.28,57,380,2242,9.6,0.17098838
10104,10104,Gino Odjick,1999-00,29.0,10,7,23,23,4,3,7,28.0,227.0,480,50,55,105,566.0,82,5.27,57,359,2285,9.4,0.2821518
10105,10105,Gino Odjick,2000-01,30.0,11,19,59,59,8,11,19,115.0,678.0,539,58,66,124,681.0,82,5.49,53,331,2294,9.8,0.29651257
10106,10106,Gino Odjick,2001-02,31.0,12,5,30,30,2,3,5,32.0,237.0,569,60,69,129,713.0,82,5.51,63,376,2272,9.9,0.20585746
10107,10107,Gino Odjick,2002-03,32.0,13,8,36,36,4,4,8,40.0,274.0,605,64,73,137,753.0,82,5.24,53,338,2262,9.5,0.19348899
10108,10108,Giovanni Fiore,2018-19,22.0,2,0,1,1,0,0,0,0.0,8.0,1,0,0,0,0.0,82,5.86,50,250,2620,9.2,0.15903813
10109,10109,Givani Smith,2020-21,22.0,2,3,21,21,2,1,3,22.0,203.0,21,2,1,3,22.0,70,5.96,42,208,2192,9.5,0.27358183
10110,10110,Glen Currie,1980-81,22.0,2,2,32,32,2,0,2,25.0,,32,2,0,2,25.0,80,7.03,61,280,2352,12.0,0.2975155
10111,10111,Glen Currie,1981-82,23.0,3,18,40,40,5,13,18,52.0,,72,7,13,20,77.0,80,7.69,77,340,2441,12.6,0.41599944
10112,10112,Glen Currie,1982-83,24.0,4,14,43,43,7,7,14,45.0,,115,14,20,34,122.0,80,8.03,73,320,2489,12.9,0.3905488
10113,10113,Glen Currie,1983-84,25.0,5,39,68,68,11,28,39,54.0,,183,25,48,73,176.0,80,7.73,71,310,2444,12.7,0.47214022
10114,10114,Glen Currie,1984-85,26.0,6,36,80,80,12,24,36,71.0,,263,37,72,109,247.0,80,7.89,74,336,2448,12.9,0.3996415
10115,10115,Glen Currie,1985-86,27.0,7,6,44,44,1,5,6,27.0,,307,38,77,115,274.0,80,7.77,71,321,2447,12.7,0.18187517
10116,10116,Glen Currie,1986-87,28.0,8,3,12,12,1,2,3,11.0,,319,39,79,118,285.0,80,7.94,82,370,2484,12.8,0.2405729
10117,10117,Glen Currie,1988-89,30.0,9,0,7,7,0,0,0,3.0,,326,39,79,118,288.0,80,7.43,89,437,2435,12.2,0.21622488
10118,10118,Glen Featherstone,1989-90,21.0,2,2,18,18,0,2,2,9.0,,18,0,2,2,9.0,80,7.48,85,403,2430,12.3,0.2897459
10119,10119,Glen Featherstone,1990-91,22.0,3,12,58,58,0,12,12,34.0,,76,0,14,14,43.0,80,7.37,76,367,2421,12.2,0.19983098
10120,10120,Glen Featherstone,1991-92,23.0,4,20,68,68,5,15,20,59.0,,144,5,29,34,102.0,80,6.91,71,366,2385,11.6,0.28560454
10121,10121,Glen Featherstone,1992-93,24.0,5,1,7,7,1,0,1,8.0,,151,6,29,35,110.0,80,6.96,77,402,2440,11.4,0.23461518
10122,10122,Glen Featherstone,1993-94,25.0,6,10,34,34,5,5,10,33.0,,185,11,34,45,143.0,84,7.25,87,443,2603,11.7,0.24210659
10123,10123,Glen Featherstone,1994-95,26.0,7,9,58,58,1,8,9,55.0,,243,12,42,54,198.0,84,6.48,76,407,2545,10.7,0.15885597
10124,10124,Glen Featherstone,1995-96,27.0,8,3,19,19,2,1,3,22.0,,262,14,43,57,220.0,48,5.97,37,209,1408,10.2,0.22443584
10125,10125,Glen Featherstone,1996-97,28.0,9,12,68,68,2,10,12,62.0,,330,16,53,69,282.0,82,6.29,74,413,2481,10.4,0.16731307
10126,10126,Glen Featherstone,1997-98,29.0,10,11,54,54,3,8,11,67.0,,384,19,61,80,349.0,82,5.83,55,336,2444,9.8,0.20871678
10127,10127,Glen Metropolit,2000-01,26.0,2,19,30,30,6,13,19,57.0,398.0,30,6,13,19,57.0,82,5.49,53,331,2294,9.8,0.413179
10128,10128,Glen Metropolit,2001-02,27.0,3,6,15,15,1,5,6,20.0,178.0,45,7,18,25,77.0,82,5.51,63,376,2272,9.9,0.22775891
10129,10129,Glen Metropolit,2002-03,28.0,4,17,35,35,1,16,17,52.0,496.0,80,8,34,42,129.0,82,5.24,53,338,2262,9.5,0.3014715
10130,10130,Glen Metropolit,2003-04,29.0,5,5,23,23,2,3,5,22.0,233.0,103,10,37,47,151.0,82,5.31,60,363,2326,9.4,0.24428058
10131,10131,Glen Metropolit,2007-08,33.0,6,33,77,77,14,19,33,123.0,931.0,180,24,56,80,274.0,82,5.76,70,398,2426,9.7,0.34935385
10132,10132,Glen Metropolit,2008-09,34.0,7,33,82,82,11,22,33,141.0,1347.0,262,35,78,113,415.0,82,5.44,62,351,2383,9.4,0.37778944
10133,10133,Glen Metropolit,2009-10,35.0,8,17,76,76,6,11,17,82.0,958.0,338,41,89,130,497.0,82,5.7,65,341,2477,9.4,0.25232968
10134,10134,Glen Metropolit,2010-11,36.0,9,29,69,69,16,13,29,115.0,936.0,407,57,102,159,612.0,82,5.53,56,304,2486,9.1,0.35439837
10135,10135,Glen Murray,1992-93,20.0,2,4,5,5,3,1,4,20.0,,5,3,1,4,20.0,80,6.96,77,402,2440,11.4,0.39771432
10136,10136,Glen Murray,1993-94,21.0,3,7,27,27,3,4,7,28.0,,32,6,5,11,48.0,84,7.25,87,443,2603,11.7,0.3485463
10137,10137,Glen Murray,1994-95,22.0,4,31,81,81,18,13,31,114.0,,113,24,18,42,162.0,84,6.48,76,407,2545,10.7,0.44075513
10138,10138,Glen Murray,1995-96,23.0,5,7,35,35,5,2,7,64.0,,148,29,20,49,226.0,48,5.97,37,209,1408,10.2,0.3389454
10139,10139,Glen Murray,1996-97,24.0,6,29,69,69,14,15,29,100.0,,217,43,35,78,326.0,82,6.29,74,413,2481,10.4,0.42580464
10140,10140,Glen Murray,1997-98,25.0,7,30,77,77,16,14,30,153.0,,294,59,49,108,479.0,82,5.83,55,336,2444,9.8,0.44528508
10141,10141,Glen Murray,1998-99,26.0,8,60,81,81,29,31,60,193.0,,375,88,80,168,672.0,82,5.28,57,380,2242,9.6,0.6717828
10142,10142,Glen Murray,1999-00,27.0,9,31,61,61,16,15,31,173.0,1254.0,436,104,95,199,845.0,82,5.27,57,359,2285,9.4,0.60249686
10143,10143,Glen Murray,2000-01,28.0,10,62,78,78,29,33,62,202.0,1443.0,514,133,128,261,1047.0,82,5.49,53,331,2294,9.8,0.69238603
10144,10144,Glen Murray,2001-02,29.0,11,39,64,64,18,21,39,138.0,1165.0,578,151,149,300,1185.0,82,5.51,63,376,2272,9.9,0.59768766
10145,10145,Glen Murray,2002-03,30.0,12,71,82,82,41,30,71,246.0,1620.0,660,192,179,371,1431.0,82,5.24,53,338,2262,9.5,0.7956768
10146,10146,Glen Murray,2003-04,31.0,13,92,82,82,44,48,92,331.0,1854.0,742,236,227,463,1762.0,82,5.31,60,363,2326,9.4,0.92780024
10147,10147,Glen Murray,2004-05,32.0,14,60,81,81,32,28,60,260.0,1696.0,823,268,255,523,2022.0,82,5.14,57,348,2300,9.2,0.7596506
10148,10148,Glen Murray,2006-07,34.0,15,53,64,64,24,29,53,195.0,1292.0,887,292,284,576,2217.0,82,6.05,85,480,2458,10.1,0.74503005
10149,10149,Glen Murray,2007-08,35.0,16,45,59,59,28,17,45,201.0,1106.0,946,320,301,621,2418.0,82,5.76,70,398,2426,9.7,0.61024994
10150,10150,Glen Murray,2008-09,36.0,17,30,63,63,17,13,30,158.0,1147.0,1009,337,314,651,2576.0,82,5.44,62,351,2383,9.4,0.47337157
10151,10151,Glen Seabrooke,1987-88,20.0,2,5,10,10,1,4,5,10.0,,10,1,4,5,10.0,80,7.34,72,344,2400,12.2,0.33881032
10152,10152,Glen Seabrooke,1988-89,21.0,3,1,6,6,0,1,1,3.0,,16,1,5,6,13.0,80,7.43,89,437,2435,12.2,0.2820352
10153,10153,Glen Seabrooke,1989-90,22.0,4,1,3,3,0,1,1,0.0,,19,1,6,7,13.0,80,7.48,85,403,2430,12.3,0.21647903
10154,10154,Glen Wesley,1988-89,20.0,2,37,79,79,7,30,37,158.0,,79,7,30,37,158.0,80,7.43,89,437,2435,12.2,0.5455297
10155,10155,Glen Wesley,1989-90,21.0,3,54,77,77,19,35,54,181.0,,156,26,65,91,339.0,80,7.48,85,403,2430,12.3,0.7080984
10156,10156,Glen Wesley,1990-91,22.0,4,36,78,78,9,27,36,166.0,,234,35,92,127,505.0,80,7.37,76,367,2421,12.2,0.52175343
10157,10157,Glen Wesley,1991-92,23.0,5,43,80,80,11,32,43,199.0,,314,46,124,170,704.0,80,6.91,71,366,2385,11.6,0.6443878
10158,10158,Glen Wesley,1992-93,24.0,6,46,78,78,9,37,46,211.0,,392,55,161,216,915.0,80,6.96,77,402,2440,11.4,0.6512203
10159,10159,Glen Wesley,1993-94,25.0,7,33,64,64,8,25,33,183.0,,456,63,186,249,1098.0,84,7.25,87,443,2603,11.7,0.5373635
10160,10160,Glen Wesley,1994-95,26.0,8,58,81,81,14,44,58,265.0,,537,77,230,307,1363.0,84,6.48,76,407,2545,10.7,0.64587945
10161,10161,Glen Wesley,1995-96,27.0,9,16,48,48,2,14,16,125.0,,585,79,244,323,1488.0,48,5.97,37,209,1408,10.2,0.39649397
10162,10162,Glen Wesley,1996-97,28.0,10,24,68,68,8,16,24,129.0,,653,87,260,347,1617.0,82,6.29,74,413,2481,10.4,0.34963465
10163,10163,Glen Wesley,1997-98,29.0,11,32,68,68,6,26,32,126.0,,721,93,286,379,1743.0,82,5.83,55,336,2444,9.8,0.4130756
10164,10164,Glen Wesley,1998-99,30.0,12,25,82,82,6,19,25,121.0,,803,99,305,404,1864.0,82,5.28,57,380,2242,9.6,0.32707706
10165,10165,Glen Wesley,1999-00,31.0,13,24,74,74,7,17,24,112.0,1666.0,877,106,322,428,1976.0,82,5.27,57,359,2285,9.4,0.32276002
10166,10166,Glen Wesley,2000-01,32.0,14,22,78,78,7,15,22,99.0,1680.0,955,113,337,450,2075.0,82,5.49,53,331,2294,9.8,0.28046793
10167,10167,Glen Wesley,2001-02,33.0,15,21,71,71,5,16,21,92.0,1587.0,1026,118,353,471,2167.0,82,5.51,63,376,2272,9.9,0.24503434
10168,10168,Glen Wesley,2002-03,34.0,16,18,77,77,5,13,18,88.0,1557.0,1103,123,366,489,2255.0,82,5.24,53,338,2262,9.5,0.21146965
10169,10169,Glen Wesley,2003-04,35.0,17,11,70,70,1,10,11,77.0,1493.0,1173,124,376,500,2332.0,82,5.31,60,363,2326,9.4,0.18013889
10170,10170,Glen Wesley,2004-05,36.0,18,6,74,74,0,6,6,82.0,1581.0,1247,124,382,506,2414.0,82,5.14,57,348,2300,9.2,0.22354683
10171,10171,Glen Wesley,2006-07,38.0,19,10,64,64,2,8,10,28.0,990.0,1311,126,390,516,2442.0,82,6.05,85,480,2458,10.1,0.1610381
10172,10172,Glen Wesley,2007-08,39.0,20,13,68,68,1,12,13,51.0,1060.0,1379,127,402,529,2493.0,82,5.76,70,398,2426,9.7,0.15400884
10173,10173,Glen Wesley,2008-09,40.0,21,8,78,78,1,7,8,63.0,1255.0,1457,128,409,537,2556.0,82,5.44,62,351,2383,9.4,0.18240952
10174,10174,Glenn Anderson,1981-82,21.0,2,53,58,58,30,23,53,161.0,,58,30,23,53,161.0,80,7.69,77,340,2441,12.6,1.0713253
10175,10175,Glenn Anderson,1982-83,22.0,3,105,80,80,38,67,105,252.0,,138,68,90,158,413.0,80,8.03,73,320,2489,12.9,1.2997551
10176,10176,Glenn Anderson,1983-84,23.0,4,104,72,72,48,56,104,243.0,,210,116,146,262,656.0,80,7.73,71,310,2444,12.7,1.25285
10177,10177,Glenn Anderson,1984-85,24.0,5,99,80,80,54,45,99,277.0,,290,170,191,361,933.0,80,7.89,74,336,2448,12.9,1.1164207
10178,10178,Glenn Anderson,1985-86,25.0,6,81,80,80,42,39,81,258.0,,370,212,230,442,1191.0,80,7.77,71,321,2447,12.7,1.137979
10179,10179,Glenn Anderson,1986-87,26.0,7,102,72,72,54,48,102,242.0,,442,266,278,544,1433.0,80,7.94,82,370,2484,12.8,1.1391201
10180,10180,Glenn Anderson,1987-88,27.0,8,73,80,80,35,38,73,189.0,,522,301,316,617,1622.0,80,7.34,72,344,2400,12.2,0.92191756
10181,10181,Glenn Anderson,1988-89,28.0,9,88,80,80,38,50,88,255.0,,602,339,366,705,1877.0,80,7.43,89,437,2435,12.2,1.038975
10182,10182,Glenn Anderson,1989-90,29.0,10,64,79,79,16,48,64,212.0,,681,355,414,769,2089.0,80,7.48,85,403,2430,12.3,0.828302
10183,10183,Glenn Anderson,1990-91,30.0,11,72,73,73,34,38,72,204.0,,754,389,452,841,2293.0,80,7.37,76,367,2421,12.2,0.8772613
10184,10184,Glenn Anderson,1991-92,31.0,12,55,74,74,24,31,55,193.0,,828,413,483,896,2486.0,80,6.91,71,366,2385,11.6,0.7666845
10185,10185,Glenn Anderson,1992-93,32.0,13,57,72,72,24,33,57,188.0,,900,437,516,953,2674.0,80,6.96,77,402,2440,11.4,0.81313545
10186,10186,Glenn Anderson,1993-94,33.0,14,65,76,76,22,43,65,161.0,,976,459,559,1018,2835.0,84,7.25,87,443,2603,11.7,0.7128377
10187,10187,Glenn Anderson,1994-95,34.0,15,41,85,85,21,20,41,149.0,,1061,480,579,1059,2984.0,84,6.48,76,407,2545,10.7,0.51064295
10188,10188,Glenn Anderson,1995-96,35.0,16,26,36,36,12,14,26,54.0,,1097,492,593,1085,3038.0,48,5.97,37,209,1408,10.2,0.6104886
10189,10189,Glenn Anderson,1996-97,36.0,17,14,32,32,6,8,14,71.0,,1129,498,601,1099,3109.0,82,6.29,74,413,2481,10.4,0.44614094
10190,10190,Glenn Hicks,1980-81,22.0,2,3,50,50,1,2,3,52.0,,50,1,2,3,52.0,80,7.03,61,280,2352,12.0,0.21007437
10191,10191,Glenn Hicks,1981-82,23.0,3,15,58,58,5,10,15,71.0,,108,6,12,18,123.0,80,7.69,77,340,2441,12.6,0.30703598
10192,10192,Glenn Johannesen,1986-87,24.0,2,0,2,2,0,0,0,2.0,,2,0,0,0,2.0,80,7.94,82,370,2484,12.8,0.2139774
10193,10193,Glenn Merkosky,1982-83,23.0,2,0,7,7,0,0,0,2.0,,7,0,0,0,2.0,80,8.03,73,320,2489,12.9,0.22391903
10194,10194,Glenn Merkosky,1983-84,24.0,3,14,34,34,4,10,14,43.0,,41,4,10,14,45.0,80,7.73,71,310,2444,12.7,0.30925816
10195,10195,Glenn Merkosky,1984-85,25.0,4,1,5,5,1,0,1,6.0,,46,5,10,15,51.0,80,7.89,74,336,2448,12.9,0.22316542
10196,10196,Glenn Merkosky,1986-87,27.0,5,2,17,17,0,2,2,18.0,,63,5,12,17,69.0,80,7.94,82,370,2484,12.8,0.20207736
10197,10197,Glenn Merkosky,1990-91,31.0,6,0,3,3,0,0,0,0.0,,66,5,12,17,69.0,80,7.37,76,367,2421,12.2,0.16720721
10198,10198,Glenn Mulvenna,1992-93,25.0,2,0,1,1,0,0,0,0.0,,1,0,0,0,0.0,80,6.96,77,402,2440,11.4,0.1660105
10199,10199,Glenn Mulvenna,1993-94,26.0,3,0,1,1,0,0,0,1.0,,2,0,0,0,1.0,84,7.25,87,443,2603,11.7,0.18108302
10200,10200,Glenn Tomalty,1980-81,26.0,2,0,1,1,0,0,0,1.0,,1,0,0,0,1.0,80,7.03,61,280,2352,12.0,0.22837335
10201,10201,Goran Bezina,2004-05,24.0,2,0,3,3,0,0,0,0.0,16.0,3,0,0,0,0.0,82,5.14,57,348,2300,9.2,0.20503095
10202,10202,Gord Dineen,1983-84,21.0,2,0,2,2,0,0,0,3.0,,2,0,0,0,3.0,80,7.73,71,310,2444,12.7,0.25479347
10203,10203,Gord Dineen,1984-85,22.0,3,12,43,43,1,11,12,37.0,,45,1,11,12,40.0,80,7.89,74,336,2448,12.9,0.22960275
10204,10204,Gord Dineen,1985-86,23.0,4,13,48,48,1,12,13,46.0,,93,2,23,25,86.0,80,7.77,71,321,2447,12.7,0.28088522
10205,10205,Gord Dineen,1986-87,24.0,5,9,57,57,1,8,9,52.0,,150,3,31,34,138.0,80,7.94,82,370,2484,12.8,0.19908404
10206,10206,Gord Dineen,1987-88,25.0,6,14,71,71,4,10,14,59.0,,221,7,41,48,197.0,80,7.34,72,344,2400,12.2,0.24505988
10207,10207,Gord Dineen,1988-89,26.0,7,18,70,70,5,13,18,56.0,,291,12,54,66,253.0,80,7.43,89,437,2435,12.2,0.22027513
10208,10208,Gord Dineen,1989-90,27.0,8,4,40,40,1,3,4,32.0,,331,13,57,70,285.0,80,7.48,85,403,2430,12.3,0.15779808
10209,10209,Gord Dineen,1990-91,28.0,9,9,69,69,1,8,9,38.0,,400,14,65,79,323.0,80,7.37,76,367,2421,12.2,0.16382992
10210,10210,Gord Dineen,1991-92,29.0,10,0,9,9,0,0,0,6.0,,409,14,65,79,329.0,80,6.91,71,366,2385,11.6,0.15925255
10211,10211,Gord Dineen,1992-93,30.0,11,0,1,1,0,0,0,0.0,,410,14,65,79,329.0,80,6.96,77,402,2440,11.4,0.19111955
10212,10212,Gord Dineen,1993-94,31.0,12,6,32,32,2,4,6,36.0,,442,16,69,85,365.0,84,7.25,87,443,2603,11.7,0.19547626
10213,10213,Gord Dineen,1994-95,32.0,13,21,77,77,0,21,21,62.0,,519,16,90,106,427.0,84,6.48,76,407,2545,10.7,0.18939918
10214,10214,Gord Dineen,1995-96,33.0,14,0,9,9,0,0,0,4.0,,528,16,90,106,431.0,48,5.97,37,209,1408,10.2,0.0958471
10215,10215,Gord Donnelly,1984-85,22.0,2,5,38,38,0,5,5,14.0,,38,0,5,5,14.0,80,7.89,74,336,2448,12.9,0.14982593
10216,10216,Gord Donnelly,1985-86,23.0,3,0,22,22,0,0,0,7.0,,60,0,5,5,21.0,80,7.77,71,321,2447,12.7,0.1495139
10217,10217,Gord Donnelly,1986-87,24.0,4,4,36,36,2,2,4,30.0,,96,2,7,9,51.0,80,7.94,82,370,2484,12.8,0.1666741
10218,10218,Gord Donnelly,1987-88,25.0,5,2,38,38,0,2,2,14.0,,134,2,9,11,65.0,80,7.34,72,344,2400,12.2,0.11811429
10219,10219,Gord Donnelly,1988-89,26.0,6,7,63,63,4,3,7,46.0,,197,6,12,18,111.0,80,7.43,89,437,2435,12.2,0.16583171
10220,10220,Gord Donnelly,1989-90,27.0,7,20,73,73,10,10,20,67.0,,270,16,22,38,178.0,80,7.48,85,403,2430,12.3,0.23623845
10221,10221,Gord Donnelly,1990-91,28.0,8,6,55,55,3,3,6,43.0,,325,19,25,44,221.0,80,7.37,76,367,2421,12.2,0.1668176
10222,10222,Gord Donnelly,1991-92,29.0,9,7,57,57,3,4,7,35.0,,382,22,29,51,256.0,80,6.91,71,366,2385,11.6,0.1462872
10223,10223,Gord Donnelly,1992-93,30.0,10,5,71,71,2,3,5,30.0,,453,24,32,56,286.0,80,6.96,77,402,2440,11.4,0.11097348
10224,10224,Gord Donnelly,1993-94,31.0,11,11,60,60,3,8,11,38.0,,513,27,40,67,324.0,84,7.25,87,443,2603,11.7,0.15767011
10225,10225,Gord Donnelly,1994-95,32.0,12,1,25,25,0,1,1,7.0,,538,27,41,68,331.0,84,6.48,76,407,2545,10.7,0.08233231
10226,10226,Gord Donnelly,1995-96,33.0,13,1,16,16,1,0,1,9.0,,554,28,41,69,340.0,48,5.97,37,209,1408,10.2,0.14454693
10227,10227,Gord Hampson,1983-84,24.0,2,0,4,4,0,0,0,4.0,,4,0,0,0,4.0,80,7.73,71,310,2444,12.7,0.22581163
10228,10228,Gord Hynes,1992-93,26.0,2,5,15,15,0,5,5,16.0,,15,0,5,5,16.0,80,6.96,77,402,2440,11.4,0.24026495
10229,10229,Gord Hynes,1993-94,27.0,3,7,37,37,3,4,7,39.0,,52,3,9,12,55.0,84,7.25,87,443,2603,11.7,0.18755963
10230,10230,Gord Kluzak,1983-84,19.0,2,7,70,70,1,6,7,49.0,,70,1,6,7,49.0,80,7.73,71,310,2444,12.7,0.2656353
10231,10231,Gord Kluzak,1984-85,20.0,3,37,80,80,10,27,37,121.0,,150,11,33,44,170.0,80,7.89,74,336,2448,12.9,0.4707482
10232,10232,Gord Kluzak,1986-87,22.0,4,39,70,70,8,31,39,114.0,,220,19,64,83,284.0,80,7.94,82,370,2484,12.8,0.5200698
10233,10233,Gord Kluzak,1988-89,24.0,5,37,66,66,6,31,37,168.0,,286,25,95,120,452.0,80,7.43,89,437,2435,12.2,0.5187252
10234,10234,Gord Kluzak,1989-90,25.0,6,1,3,3,0,1,1,4.0,,289,25,96,121,456.0,80,7.48,85,403,2430,12.3,0.27058068
10235,10235,Gord Kluzak,1990-91,26.0,7,2,8,8,0,2,2,8.0,,297,25,98,123,464.0,80,7.37,76,367,2421,12.2,0.2622403
10236,10236,Gord Kluzak,1991-92,27.0,8,0,2,2,0,0,0,3.0,,299,25,98,123,467.0,80,6.91,71,366,2385,11.6,0.20794857
10237,10237,Gord Kruppke,1991-92,22.0,2,0,4,4,0,0,0,0.0,,4,0,0,0,0.0,80,6.91,71,366,2385,11.6,0.18537673
10238,10238,Gord Kruppke,1993-94,24.0,3,0,10,10,0,0,0,7.0,,14,0,0,0,7.0,84,7.25,87,443,2603,11.7,0.1889506
10239,10239,Gord Kruppke,1994-95,25.0,4,0,9,9,0,0,0,5.0,,23,0,0,0,12.0,84,6.48,76,407,2545,10.7,0.15598124
10240,10240,Gord Murphy,1989-90,22.0,2,35,75,75,4,31,35,116.0,,75,4,31,35,116.0,80,7.48,85,403,2430,12.3,0.44505757
10241,10241,Gord Murphy,1990-91,23.0,3,41,75,75,14,27,41,160.0,,150,18,58,76,276.0,80,7.37,76,367,2421,12.2,0.5602912
10242,10242,Gord Murphy,1991-92,24.0,4,42,80,80,11,31,42,203.0,,230,29,89,118,479.0,80,6.91,71,366,2385,11.6,0.5709385
10243,10243,Gord Murphy,1992-93,25.0,5,19,73,73,5,14,19,132.0,,303,34,103,137,611.0,80,6.96,77,402,2440,11.4,0.37577504
10244,10244,Gord Murphy,1993-94,26.0,6,17,49,49,5,12,17,68.0,,352,39,115,154,679.0,84,7.25,87,443,2603,11.7,0.40199372
10245,10245,Gord Murphy,1994-95,27.0,7,43,84,84,14,29,43,172.0,,436,53,144,197,851.0,84,6.48,76,407,2545,10.7,0.47402048
10246,10246,Gord Murphy,1995-96,28.0,8,22,46,46,6,16,22,94.0,,482,59,160,219,945.0,48,5.97,37,209,1408,10.2,0.48362738
10247,10247,Gord Murphy,1996-97,29.0,9,30,70,70,8,22,30,125.0,,552,67,182,249,1070.0,82,6.29,74,413,2481,10.4,0.40159574
10248,10248,Gord Murphy,1997-98,30.0,10,23,80,80,8,15,23,137.0,,632,75,197,272,1207.0,82,5.83,55,336,2444,9.8,0.31663418
10249,10249,Gord Murphy,1998-99,31.0,11,17,79,79,6,11,17,123.0,,711,81,208,289,1330.0,82,5.28,57,380,2242,9.6,0.24968669
10250,10250,Gord Murphy,1999-00,32.0,12,7,51,51,0,7,7,56.0,1017.0,762,81,215,296,1386.0,82,5.27,57,359,2285,9.4,0.19495544
10251,10251,Gord Murphy,2000-01,33.0,13,11,58,58,1,10,11,74.0,1315.0,820,82,225,307,1460.0,82,5.49,53,331,2294,9.8,0.21346787
10252,10252,Gord Murphy,2001-02,34.0,14,14,27,27,3,11,14,44.0,560.0,847,85,236,321,1504.0,82,5.51,63,376,2272,9.9,0.25741798
10253,10253,Gord Murphy,2002-03,35.0,15,2,15,15,0,2,2,10.0,218.0,862,85,238,323,1514.0,82,5.24,53,338,2262,9.5,0.17260277
10254,10254,Gord Sherven,1984-85,21.0,2,1,2,2,1,0,1,5.0,,2,1,0,1,5.0,80,7.89,74,336,2448,12.9,0.29929668
10255,10255,Gord Sherven,1985-86,22.0,3,30,69,69,11,19,30,97.0,,71,12,19,31,102.0,80,7.77,71,321,2447,12.7,0.456761
10256,10256,Gord Sherven,1986-87,23.0,4,4,18,18,1,3,4,14.0,,89,13,22,35,116.0,80,7.94,82,370,2484,12.8,0.32413334
10257,10257,Gord Sherven,1987-88,24.0,5,0,7,7,0,0,0,7.0,,96,13,22,35,123.0,80,7.34,72,344,2400,12.2,0.24032447
10258,10258,Gord Sherven,1988-89,25.0,6,0,1,1,0,0,0,2.0,,97,13,22,35,125.0,80,7.43,89,437,2435,12.2,0.24816567
10259,10259,Gord Walker,1987-88,22.0,2,1,1,1,1,0,1,1.0,,1,1,0,1,1.0,80,7.34,72,344,2400,12.2,0.28515643
10260,10260,Gord Walker,1988-89,23.0,3,5,18,18,1,4,5,23.0,,19,2,4,6,24.0,80,7.43,89,437,2435,12.2,0.3096527
10261,10261,Gord Walker,1989-90,24.0,4,1,11,11,1,0,1,13.0,,30,3,4,7,37.0,80,7.48,85,403,2430,12.3,0.23557854
10262,10262,Gord Walker,1990-91,25.0,5,0,1,1,0,0,0,0.0,,31,3,4,7,37.0,80,7.37,76,367,2421,12.2,0.18043843
10263,10263,Gord Wappel,1980-81,22.0,2,0,2,2,0,0,0,2.0,,2,0,0,0,2.0,80,7.03,61,280,2352,12.0,0.22890192
10264,10264,Gord Wappel,1981-82,23.0,3,1,7,7,0,1,1,3.0,,9,0,1,1,5.0,80,7.69,77,340,2441,12.6,0.22411224
10265,10265,Gord Wappel,1982-83,24.0,4,1,11,11,1,0,1,7.0,,20,1,1,2,12.0,80,8.03,73,320,2489,12.9,0.22046813
10266,10266,Gord Williams,1982-83,22.0,2,0,1,1,0,0,0,1.0,,1,0,0,0,1.0,80,8.03,73,320,2489,12.9,0.22839698
10267,10267,Gord Williams,1983-84,23.0,3,0,1,1,0,0,0,1.0,,2,0,0,0,2.0,80,7.73,71,310,2444,12.7,0.21157894
10268,10268,Gordie Dwyer,2000-01,23.0,2,1,24,24,0,1,1,7.0,119.0,24,0,1,1,7.0,82,5.49,53,331,2294,9.8,0.12941283
10269,10269,Gordie Dwyer,2001-02,24.0,3,1,28,28,0,1,1,12.0,162.0,52,0,2,2,19.0,82,5.51,63,376,2272,9.9,0.09776452
10270,10270,Gordie Dwyer,2002-03,25.0,4,2,26,26,0,2,2,6.0,132.0,78,0,4,4,25.0,82,5.24,53,338,2262,9.5,0.10092068
10271,10271,Gordie Dwyer,2003-04,26.0,5,1,28,28,0,1,1,10.0,193.0,106,0,5,5,35.0,82,5.31,60,363,2326,9.4,0.0958516
10272,10272,Gordie Dwyer,2004-05,27.0,6,0,2,2,0,0,0,0.0,12.0,108,0,5,5,35.0,82,5.14,57,348,2300,9.2,0.15715769
10273,10273,Gordie Roberts,1980-81,23.0,2,36,80,80,8,28,36,107.0,,80,8,28,36,107.0,80,7.03,61,280,2352,12.0,0.47459242
10274,10274,Gordie Roberts,1981-82,24.0,3,50,77,77,8,42,50,119.0,,157,16,70,86,226.0,80,7.69,77,340,2441,12.6,0.5527038
10275,10275,Gordie Roberts,1982-83,25.0,4,34,79,79,4,30,34,104.0,,236,20,100,120,330.0,80,8.03,73,320,2489,12.9,0.45102024
10276,10276,Gordie Roberts,1983-84,26.0,5,44,80,80,3,41,44,126.0,,316,23,141,164,456.0,80,7.73,71,310,2444,12.7,0.5366312
10277,10277,Gordie Roberts,1984-85,27.0,6,53,77,77,8,45,53,129.0,,393,31,186,217,585.0,80,7.89,74,336,2448,12.9,0.6021271
10278,10278,Gordie Roberts,1985-86,28.0,7,42,78,78,6,36,42,142.0,,471,37,222,259,727.0,80,7.77,71,321,2447,12.7,0.5121591
10279,10279,Gordie Roberts,1986-87,29.0,8,23,76,76,2,21,23,66.0,,547,39,243,282,793.0,80,7.94,82,370,2484,12.8,0.30789456
10280,10280,Gordie Roberts,1987-88,30.0,9,13,67,67,3,10,13,43.0,,614,42,253,295,836.0,80,7.34,72,344,2400,12.2,0.2543797
10281,10281,Gordie Roberts,1988-89,31.0,10,18,70,70,3,15,18,52.0,,684,45,268,313,888.0,80,7.43,89,437,2435,12.2,0.26250136
10282,10282,Gordie Roberts,1989-90,32.0,11,26,77,77,2,24,26,52.0,,761,47,292,339,940.0,80,7.48,85,403,2430,12.3,0.27467358
10283,10283,Gordie Roberts,1990-91,33.0,12,17,75,75,3,14,17,56.0,,836,50,306,356,996.0,80,7.37,76,367,2421,12.2,0.2060386
10284,10284,Gordie Roberts,1991-92,34.0,13,16,64,64,3,13,16,24.0,,900,53,319,372,1020.0,80,6.91,71,366,2385,11.6,0.23594645
10285,10285,Gordie Roberts,1992-93,35.0,14,24,73,73,2,22,24,29.0,,973,55,341,396,1049.0,80,6.96,77,402,2440,11.4,0.22067294
10286,10286,Gordie Roberts,1993-94,36.0,15,17,65,65,5,12,17,40.0,,1038,60,353,413,1089.0,84,7.25,87,443,2603,11.7,0.16860053
10287,10287,Gordie Roberts,1994-95,37.0,16,7,59,59,1,6,7,19.0,,1097,61,359,420,1108.0,84,6.48,76,407,2545,10.7,0.11460394
10288,10288,Gordon Mark,1987-88,23.0,2,8,36,36,3,5,8,31.0,,36,3,5,8,31.0,80,7.34,72,344,2400,12.2,0.26010007
10289,10289,Gordon Mark,1988-89,24.0,3,2,19,19,0,2,2,11.0,,55,3,7,10,42.0,80,7.43,89,437,2435,12.2,0.18952233
10290,10290,Gordon Mark,1994-95,30.0,4,1,12,12,0,1,1,8.0,,67,3,8,11,50.0,84,6.48,76,407,2545,10.7,0.123300344
10291,10291,Gordon Mark,1995-96,31.0,5,2,18,18,0,2,2,21.0,,85,3,10,13,71.0,48,5.97,37,209,1408,10.2,0.1827743
10292,10292,Graeme Townshend,1990-91,25.0,2,0,4,4,0,0,0,3.0,,4,0,0,0,3.0,80,7.37,76,367,2421,12.2,0.21491268
10293,10293,Graeme Townshend,1991-92,26.0,3,7,18,18,2,5,7,10.0,,22,2,5,7,13.0,80,6.91,71,366,2385,11.6,0.2913459
10294,10294,Graeme Townshend,1992-93,27.0,4,3,7,7,1,2,3,6.0,,29,3,7,10,19.0,80,6.96,77,402,2440,11.4,0.21649101
10295,10295,Graeme Townshend,1993-94,28.0,5,0,2,2,0,0,0,0.0,,31,3,7,10,19.0,84,7.25,87,443,2603,11.7,0.16416311
10296,10296,Graeme Townshend,1994-95,29.0,6,0,14,14,0,0,0,5.0,,45,3,7,10,24.0,84,6.48,76,407,2545,10.7,0.1350005
10297,10297,Graham Mink,2004-05,25.0,2,0,2,2,0,0,0,0.0,11.0,2,0,0,0,0.0,82,5.14,57,348,2300,9.2,0.15451938
10298,10298,Graham Mink,2006-07,27.0,3,0,3,3,0,0,0,1.0,17.0,5,0,0,0,1.0,82,6.05,85,480,2458,10.1,0.14114666
10299,10299,Graham Mink,2009-10,30.0,4,0,2,2,0,0,0,4.0,16.0,7,0,0,0,5.0,82,5.7,65,341,2477,9.4,0.14946178
10300,10300,Grant Clitsome,2010-11,25.0,2,3,11,11,1,2,3,7.0,162.0,11,1,2,3,7.0,82,5.53,56,304,2486,9.1,0.19798136
10301,10301,Grant Clitsome,2011-12,26.0,3,19,31,31,4,15,19,50.0,659.0,42,5,17,22,57.0,82,5.46,52,291,2492,9.0,0.38720924
10302,10302,Grant Clitsome,2012-13,27.0,4,17,63,63,4,13,17,87.0,1071.0,105,9,30,39,144.0,82,5.32,47,271,2439,8.9,0.22540143
10303,10303,Grant Clitsome,2013-14,28.0,5,16,44,44,4,12,16,56.0,829.0,149,13,42,55,200.0,48,5.31,29,160,1399,9.1,0.31466365
10304,10304,Grant Clitsome,2014-15,29.0,6,12,32,32,2,10,12,42.0,633.0,181,15,52,67,242.0,82,5.34,48,269,2463,8.9,0.21526083
10305,10305,Grant Clitsome,2015-16,30.0,7,4,24,24,0,4,4,22.0,393.0,205,15,56,71,264.0,82,5.32,47,251,2453,8.9,0.18002972
10306,10306,Grant Jennings,1989-90,24.0,2,13,55,55,3,10,13,39.0,,55,3,10,13,39.0,80,7.48,85,403,2430,12.3,0.2564597
10307,10307,Grant Jennings,1990-91,25.0,3,9,64,64,3,6,9,45.0,,119,6,16,22,84.0,80,7.37,76,367,2421,12.2,0.2061818
10308,10308,Grant Jennings,1991-92,26.0,4,9,57,57,2,7,9,36.0,,176,8,23,31,120.0,80,6.91,71,366,2385,11.6,0.18688643
10309,10309,Grant Jennings,1992-93,27.0,5,9,53,53,4,5,9,35.0,,229,12,28,40,155.0,80,6.96,77,402,2440,11.4,0.16242996
10310,10310,Grant Jennings,1993-94,28.0,6,5,58,58,0,5,5,32.0,,287,12,33,45,187.0,84,7.25,87,443,2603,11.7,0.123084635
10311,10311,Grant Jennings,1994-95,29.0,7,6,61,61,2,4,6,49.0,,348,14,37,51,236.0,84,6.48,76,407,2545,10.7,0.14851344
10312,10312,Grant Jennings,1995-96,30.0,8,6,35,35,0,6,6,25.0,,383,14,43,57,261.0,48,5.97,37,209,1408,10.2,0.1583395
10313,10313,Grant Jennings,1996-97,31.0,9,0,6,6,0,0,0,3.0,,389,14,43,57,264.0,82,6.29,74,413,2481,10.4,0.1313475
10314,10314,Grant Ledyard,1985-86,24.0,2,20,42,42,8,12,20,91.0,,42,8,12,20,91.0,80,7.77,71,321,2447,12.7,0.47236726
10315,10315,Grant Ledyard,1986-87,25.0,3,36,79,79,9,27,36,170.0,,121,17,39,56,261.0,80,7.94,82,370,2484,12.8,0.4715645
10316,10316,Grant Ledyard,1987-88,26.0,4,37,67,67,14,23,37,144.0,,188,31,62,93,405.0,80,7.34,72,344,2400,12.2,0.5452079
10317,10317,Grant Ledyard,1988-89,27.0,5,15,44,44,5,10,15,81.0,,232,36,72,108,486.0,80,7.43,89,437,2435,12.2,0.3690855
10318,10318,Grant Ledyard,1989-90,28.0,6,20,74,74,4,16,20,106.0,,306,40,88,128,592.0,80,7.48,85,403,2430,12.3,0.30702734
10319,10319,Grant Ledyard,1990-91,29.0,7,15,67,67,2,13,15,91.0,,373,42,101,143,683.0,80,7.37,76,367,2421,12.2,0.28181064
10320,10320,Grant Ledyard,1991-92,30.0,8,31,60,60,8,23,31,118.0,,433,50,124,174,801.0,80,6.91,71,366,2385,11.6,0.45994815
10321,10321,Grant Ledyard,1992-93,31.0,9,21,50,50,5,16,21,87.0,,483,55,140,195,888.0,80,6.96,77,402,2440,11.4,0.37056053
10322,10322,Grant Ledyard,1993-94,32.0,10,16,50,50,2,14,16,79.0,,533,57,154,211,967.0,84,7.25,87,443,2603,11.7,0.3263676
10323,10323,Grant Ledyard,1994-95,33.0,11,46,84,84,9,37,46,177.0,,617,66,191,257,1144.0,84,6.48,76,407,2545,10.7,0.46302596
10324,10324,Grant Ledyard,1995-96,34.0,12,18,38,38,5,13,18,79.0,,655,71,204,275,1223.0,48,5.97,37,209,1408,10.2,0.41278887
10325,10325,Grant Ledyard,1996-97,35.0,13,24,73,73,5,19,24,123.0,,728,76,223,299,1346.0,82,6.29,74,413,2481,10.4,0.2442781
10326,10326,Grant Ledyard,1997-98,36.0,14,16,67,67,1,15,16,99.0,,795,77,238,315,1445.0,82,5.83,55,336,2444,9.8,0.22321561
10327,10327,Grant Ledyard,1998-99,37.0,15,24,71,71,4,20,24,90.0,,866,81,258,339,1535.0,82,5.28,57,380,2242,9.6,0.23501503
10328,10328,Grant Ledyard,1999-00,38.0,16,12,47,47,4,8,12,47.0,823.0,913,85,266,351,1582.0,82,5.27,57,359,2285,9.4,0.17919403
10329,10329,Grant Ledyard,2000-01,39.0,17,6,40,40,2,4,6,42.0,590.0,953,87,270,357,1624.0,82,5.49,53,331,2294,9.8,0.15660211
10330,10330,Grant Ledyard,2001-02,40.0,18,5,22,22,2,3,5,19.0,379.0,975,89,273,362,1643.0,82,5.51,63,376,2272,9.9,0.18148321
10331,10331,Grant Ledyard,2002-03,41.0,19,4,53,53,1,3,4,27.0,773.0,1028,90,276,366,1670.0,82,5.24,53,338,2262,9.5,0.1212976
10332,10332,Grant Lewis,2009-10,25.0,2,0,1,1,0,0,0,1.0,15.0,1,0,0,0,1.0,82,5.7,65,341,2477,9.4,0.17050758
10333,10333,Grant Marshall,1995-96,22.0,2,1,2,2,0,1,1,0.0,,2,0,1,1,0.0,48,5.97,37,209,1408,10.2,0.21553603
10334,10334,Grant Marshall,1996-97,23.0,3,28,70,70,9,19,28,62.0,,72,9,20,29,62.0,82,6.29,74,413,2481,10.4,0.3745399
10335,10335,Grant Marshall,1997-98,24.0,4,10,56,56,6,4,10,62.0,,128,15,24,39,124.0,82,5.83,55,336,2444,9.8,0.23607448
10336,10336,Grant Marshall,1998-99,25.0,5,19,72,72,9,10,19,91.0,,200,24,34,58,215.0,82,5.28,57,380,2242,9.6,0.29400417
10337,10337,Grant Marshall,1999-00,26.0,6,31,82,82,13,18,31,112.0,1037.0,282,37,52,89,327.0,82,5.27,57,359,2285,9.4,0.38894838
10338,10338,Grant Marshall,2000-01,27.0,7,8,45,45,2,6,8,43.0,509.0,327,39,58,97,370.0,82,5.49,53,331,2294,9.8,0.18537652
10339,10339,Grant Marshall,2001-02,28.0,8,37,75,75,13,24,37,93.0,832.0,402,52,82,134,463.0,82,5.51,63,376,2272,9.9,0.43200445
10340,10340,Grant Marshall,2002-03,29.0,9,33,81,81,15,18,33,152.0,1252.0,483,67,100,167,615.0,82,5.24,53,338,2262,9.5,0.4280078
10341,10341,Grant Marshall,2003-04,30.0,10,32,76,76,9,23,32,113.0,1036.0,559,76,123,199,728.0,82,5.31,60,363,2326,9.4,0.3535614
10342,10342,Grant Marshall,2004-05,31.0,11,15,65,65,8,7,15,76.0,838.0,624,84,130,214,804.0,82,5.14,57,348,2300,9.2,0.23855361
10343,10343,Grant Marshall,2006-07,33.0,12,25,76,76,8,17,25,89.0,960.0,700,92,147,239,893.0,82,6.05,85,480,2458,10.1,0.26353908
10344,10344,Grant Martin,1984-85,22.0,2,2,12,12,0,2,2,7.0,,12,0,2,2,7.0,80,7.89,74,336,2448,12.9,0.23249337
10345,10345,Grant Martin,1985-86,23.0,3,1,12,12,0,1,1,1.0,,24,0,3,3,8.0,80,7.77,71,321,2447,12.7,0.21076605
10346,10346,Grant Martin,1986-87,24.0,4,1,11,11,0,1,1,5.0,,35,0,4,4,13.0,80,7.94,82,370,2484,12.8,0.1906448
10347,10347,Grant Martin,1987-88,25.0,5,0,9,9,0,0,0,5.0,,44,0,4,4,18.0,80,7.34,72,344,2400,12.2,0.16530448
10348,10348,Grant McNeill,2004-05,21.0,2,0,3,3,0,0,0,0.0,8.0,3,0,0,0,0.0,82,5.14,57,348,2300,9.2,0.26028785
10349,10349,Grant Sasser,1984-85,20.0,2,0,3,3,0,0,0,2.0,,3,0,0,0,2.0,80,7.89,74,336,2448,12.9,0.28967196
10350,10350,Grant Stevenson,2006-07,25.0,2,22,47,47,10,12,22,67.0,561.0,47,10,12,22,67.0,82,6.05,85,480,2458,10.1,0.36074775
10351,10351,Greg Adams,1981-82,21.0,2,3,6,6,3,0,3,6.0,,6,3,0,3,6.0,80,7.69,77,340,2441,12.6,0.39005235
10352,10352,Greg Adams,1982-83,22.0,3,19,33,33,4,15,19,29.0,,39,7,15,22,35.0,80,8.03,73,320,2489,12.9,0.45906603
10353,10353,Greg Adams,1983-84,23.0,4,23,79,79,10,13,23,114.0,,118,17,28,45,149.0,80,7.73,71,310,2444,12.7,0.34472832
10354,10354,Greg Adams,1984-85,24.0,5,8,57,57,2,6,8,37.0,,175,19,34,53,186.0,80,7.89,74,336,2448,12.9,0.24395084
10355,10355,Greg Adams,1985-86,25.0,6,18,51,51,6,12,18,62.0,,226,25,46,71,248.0,80,7.77,71,321,2447,12.7,0.39864865
10356,10356,Greg Adams,1986-87,26.0,7,56,78,78,18,38,56,150.0,,304,43,84,127,398.0,80,7.94,82,370,2484,12.8,0.62794083
10357,10357,Greg Adams,1987-88,27.0,8,44,66,66,14,30,44,92.0,,370,57,114,171,490.0,80,7.34,72,344,2400,12.2,0.5156591
10358,10358,Greg Adams,1988-89,28.0,9,27,78,78,15,12,27,109.0,,448,72,126,198,599.0,80,7.43,89,437,2435,12.2,0.3440101
10359,10359,Greg Adams,1989-90,29.0,10,15,61,61,8,7,15,71.0,,509,80,133,213,670.0,80,7.48,85,403,2430,12.3,0.29103965
10360,10360,Greg Adams,1990-91,30.0,11,14,35,35,4,10,14,27.0,,544,84,143,227,697.0,80,7.37,76,367,2421,12.2,0.3502829
10361,10361,Greg Adams0,1985-86,22.0,2,21,36,36,12,9,21,65.0,,36,12,9,21,65.0,80,7.77,71,321,2447,12.7,0.51990384
10362,10362,Greg Adams0,1986-87,23.0,3,77,78,78,35,42,77,202.0,,114,47,51,98,267.0,80,7.94,82,370,2484,12.8,0.8090135
10363,10363,Greg Adams0,1987-88,24.0,4,47,72,72,20,27,47,140.0,,186,67,78,145,407.0,80,7.34,72,344,2400,12.2,0.6770249
10364,10364,Greg Adams0,1988-89,25.0,5,76,80,80,36,40,76,227.0,,266,103,118,221,634.0,80,7.43,89,437,2435,12.2,0.88427436
10365,10365,Greg Adams0,1989-90,26.0,6,33,61,61,19,14,33,144.0,,327,122,132,254,778.0,80,7.48,85,403,2430,12.3,0.66871107
10366,10366,Greg Adams0,1990-91,27.0,7,50,65,65,30,20,50,181.0,,392,152,152,304,959.0,80,7.37,76,367,2421,12.2,0.7264049
10367,10367,Greg Adams0,1991-92,28.0,8,45,55,55,21,24,45,148.0,,447,173,176,349,1107.0,80,6.91,71,366,2385,11.6,0.76919717
10368,10368,Greg Adams0,1992-93,29.0,9,57,76,76,30,27,57,184.0,,523,203,203,406,1291.0,80,6.96,77,402,2440,11.4,0.79243386
10369,10369,Greg Adams0,1993-94,30.0,10,56,53,53,25,31,56,124.0,,576,228,234,462,1415.0,84,7.25,87,443,2603,11.7,0.7671099
10370,10370,Greg Adams0,1994-95,31.0,11,37,68,68,13,24,37,139.0,,644,241,258,499,1554.0,84,6.48,76,407,2545,10.7,0.4825822
10371,10371,Greg Adams0,1995-96,32.0,12,21,43,43,8,13,21,72.0,,687,249,271,520,1626.0,48,5.97,37,209,1408,10.2,0.4935753
10372,10372,Greg Adams0,1996-97,33.0,13,43,66,66,22,21,43,140.0,,753,271,292,563,1766.0,82,6.29,74,413,2481,10.4,0.5762236
10373,10373,Greg Adams0,1997-98,34.0,14,36,50,50,21,15,36,113.0,,803,292,307,599,1879.0,82,5.83,55,336,2444,9.8,0.5739123
10374,10374,Greg Adams0,1998-99,35.0,15,32,49,49,14,18,32,75.0,,852,306,325,631,1954.0,82,5.28,57,380,2242,9.6,0.51289433
10375,10375,Greg Adams0,1999-00,36.0,16,43,75,75,19,24,43,176.0,1303.0,927,325,349,674,2130.0,82,5.27,57,359,2285,9.4,0.5066883
10376,10376,Greg Adams0,2000-01,37.0,17,46,69,69,19,27,46,129.0,1171.0,996,344,376,720,2259.0,82,5.49,53,331,2294,9.8,0.5154668
10377,10377,Greg Adams0,2001-02,38.0,18,23,60,60,11,12,23,66.0,863.0,1056,355,388,743,2325.0,82,5.51,63,376,2272,9.9,0.33152735
10378,10378,Greg Andrusak,1994-95,25.0,2,0,3,3,0,0,0,4.0,,3,0,0,0,4.0,84,6.48,76,407,2545,10.7,0.17292508
10379,10379,Greg Andrusak,1995-96,26.0,3,4,7,7,0,4,4,7.0,,10,0,4,4,11.0,48,5.97,37,209,1408,10.2,0.21400762
10380,10380,Greg Andrusak,1996-97,27.0,4,0,2,2,0,0,0,1.0,,12,0,4,4,12.0,82,6.29,74,413,2481,10.4,0.16151127
10381,10381,Greg Andrusak,1999-00,30.0,5,1,7,7,0,1,1,2.0,124.0,19,0,5,5,14.0,82,5.27,57,359,2285,9.4,0.13792598
10382,10382,Greg Andrusak,2000-01,31.0,6,1,9,9,0,1,1,5.0,166.0,28,0,6,6,19.0,82,5.49,53,331,2294,9.8,0.13419908
10383,10383,Greg Britz,1984-85,24.0,2,0,6,6,0,0,0,1.0,,6,0,0,0,1.0,80,7.89,74,336,2448,12.9,0.21553054
10384,10384,Greg Britz,1985-86,25.0,3,0,1,1,0,0,0,0.0,,7,0,0,0,1.0,80,7.77,71,321,2447,12.7,0.18643507
10385,10385,Greg Britz,1987-88,27.0,4,0,1,1,0,0,0,0.0,,8,0,0,0,1.0,80,7.34,72,344,2400,12.2,0.17013404
10386,10386,Greg Brown,1991-92,23.0,2,3,39,39,1,2,3,26.0,,39,1,2,3,26.0,80,6.91,71,366,2385,11.6,0.18462929
10387,10387,Greg Brown,1993-94,25.0,3,1,10,10,0,1,1,10.0,,49,1,3,4,36.0,84,7.25,87,443,2603,11.7,0.18690968
10388,10388,Greg Brown,1994-95,26.0,4,11,36,36,3,8,11,37.0,,85,4,11,15,73.0,84,6.48,76,407,2545,10.7,0.22840416
10389,10389,Greg Brown,1995-96,27.0,5,3,9,9,0,3,3,12.0,,94,4,14,18,85.0,48,5.97,37,209,1408,10.2,0.21153605
10390,10390,Greg Classen,2001-02,24.0,2,6,27,27,2,4,6,18.0,277.0,27,2,4,6,18.0,82,5.51,63,376,2272,9.9,0.18760851
10391,10391,Greg Classen,2002-03,25.0,3,11,55,55,5,6,11,32.0,558.0,82,7,10,17,50.0,82,5.24,53,338,2262,9.5,0.18217087
10392,10392,Greg Classen,2003-04,26.0,4,0,8,8,0,0,0,2.0,80.0,90,7,10,17,52.0,82,5.31,60,363,2326,9.4,0.15882778
10393,10393,Greg Crozier,2001-02,25.0,2,0,1,1,0,0,0,0.0,4.0,1,0,0,0,0.0,82,5.51,63,376,2272,9.9,0.15280735
10394,10394,Greg Gilbert,1982-83,21.0,2,1,1,1,1,0,1,2.0,,1,1,0,1,2.0,80,8.03,73,320,2489,12.9,0.27989274
10395,10395,Greg Gilbert,1983-84,22.0,3,19,45,45,8,11,19,33.0,,46,9,11,20,35.0,80,7.73,71,310,2444,12.7,0.4121843
10396,10396,Greg Gilbert,1984-85,23.0,4,66,79,79,31,35,66,118.0,,125,40,46,86,153.0,80,7.89,74,336,2448,12.9,0.75562155
10397,10397,Greg Gilbert,1985-86,24.0,5,38,58,58,13,25,38,82.0,,183,53,71,124,235.0,80,7.77,71,321,2447,12.7,0.5414283
10398,10398,Greg Gilbert,1986-87,25.0,6,28,60,60,9,19,28,58.0,,243,62,90,152,293.0,80,7.94,82,370,2484,12.8,0.4263091
10399,10399,Greg Gilbert,1987-88,26.0,7,13,51,51,6,7,13,50.0,,294,68,97,165,343.0,80,7.34,72,344,2400,12.2,0.38567677
10400,10400,Greg Gilbert,1988-89,27.0,8,45,76,76,17,28,45,77.0,,370,85,125,210,420.0,80,7.43,89,437,2435,12.2,0.51553035
10401,10401,Greg Gilbert,1989-90,28.0,9,21,59,59,8,13,21,75.0,,429,93,138,231,495.0,80,7.48,85,403,2430,12.3,0.34684798
10402,10402,Greg Gilbert,1990-91,29.0,10,37,70,70,12,25,37,108.0,,499,105,163,268,603.0,80,7.37,76,367,2421,12.2,0.43777737
10403,10403,Greg Gilbert,1991-92,30.0,11,25,72,72,10,15,25,98.0,,571,115,178,293,701.0,80,6.91,71,366,2385,11.6,0.33155093
10404,10404,Greg Gilbert,1992-93,31.0,12,12,50,50,7,5,12,45.0,,621,122,183,305,746.0,80,6.96,77,402,2440,11.4,0.27346808
10405,10405,Greg Gilbert,1993-94,32.0,13,32,77,77,13,19,32,72.0,,698,135,202,337,818.0,84,7.25,87,443,2603,11.7,0.32528663
10406,10406,Greg Gilbert,1994-95,33.0,14,15,76,76,4,11,15,64.0,,774,139,213,352,882.0,84,6.48,76,407,2545,10.7,0.19229123
10407,10407,Greg Gilbert,1995-96,34.0,15,25,46,46,11,14,25,57.0,,820,150,227,377,939.0,48,5.97,37,209,1408,10.2,0.39743692
10408,10408,Greg Gilbert,1996-97,35.0,16,1,17,17,0,1,1,9.0,,837,150,228,378,948.0,82,6.29,74,413,2481,10.4,0.15003759
10409,10409,Greg Hawgood,1988-89,20.0,2,0,1,1,0,0,0,1.0,,1,0,0,0,1.0,80,7.43,89,437,2435,12.2,0.27996272
10410,10410,Greg Hawgood,1989-90,21.0,3,40,56,56,16,24,40,132.0,,57,16,24,40,133.0,80,7.48,85,403,2430,12.3,0.7395035
10411,10411,Greg Hawgood,1990-91,22.0,4,38,77,77,11,27,38,127.0,,134,27,51,78,260.0,80,7.37,76,367,2421,12.2,0.49735472
10412,10412,Greg Hawgood,1991-92,23.0,5,1,6,6,0,1,1,9.0,,140,27,52,79,269.0,80,6.91,71,366,2385,11.6,0.4131962
10413,10413,Greg Hawgood,1992-93,24.0,6,13,20,20,2,11,13,24.0,,160,29,63,92,293.0,80,6.96,77,402,2440,11.4,0.4090474
10414,10414,Greg Hawgood,1993-94,25.0,7,46,69,69,11,35,46,138.0,,229,40,98,138,431.0,84,7.25,87,443,2603,11.7,0.5662744
10415,10415,Greg Hawgood,1994-95,26.0,8,34,64,64,6,28,34,112.0,,293,46,126,172,543.0,84,6.48,76,407,2545,10.7,0.49518833
10416,10416,Greg Hawgood,1995-96,27.0,9,5,21,21,1,4,5,17.0,,314,47,130,177,560.0,48,5.97,37,209,1408,10.2,0.30740827
10417,10417,Greg Hawgood,1997-98,29.0,10,18,63,63,6,12,18,83.0,,377,53,142,195,643.0,82,5.83,55,336,2444,9.8,0.31365803
10418,10418,Greg Hawgood,2000-01,32.0,11,22,79,79,5,17,22,70.0,1358.0,456,58,159,217,713.0,82,5.49,53,331,2294,9.8,0.24464333
10419,10419,Greg Hawgood,2001-02,33.0,12,7,16,16,2,5,7,16.0,239.0,472,60,164,224,729.0,82,5.51,63,376,2272,9.9,0.24354607
10420,10420,Greg Hawgood,2002-03,34.0,13,0,2,2,0,0,0,1.0,13.0,474,60,164,224,730.0,82,5.24,53,338,2262,9.5,0.19287038
10421,10421,Greg Hotham,1980-81,24.0,2,13,46,46,3,10,13,46.0,,46,3,10,13,46.0,80,7.03,61,280,2352,12.0,0.28293663
10422,10422,Greg Hotham,1981-82,25.0,3,2,11,11,1,1,2,8.0,,57,4,11,15,54.0,80,7.69,77,340,2441,12.6,0.23083356
10423,10423,Greg Hotham,1982-83,26.0,4,10,28,28,4,6,10,42.0,,85,8,17,25,96.0,80,8.03,73,320,2489,12.9,0.3521585
10424,10424,Greg Hotham,1983-84,27.0,5,32,58,58,2,30,32,75.0,,143,10,47,57,171.0,80,7.73,71,310,2444,12.7,0.42507514
10425,10425,Greg Hotham,1984-85,28.0,6,30,76,76,5,25,30,120.0,,219,15,72,87,291.0,80,7.89,74,336,2448,12.9,0.36302978
10426,10426,Greg Hotham,1985-86,29.0,7,2,11,11,0,2,2,6.0,,230,15,74,89,297.0,80,7.77,71,321,2447,12.7,0.22752228
10427,10427,Greg Jacina,2006-07,24.0,2,1,11,11,0,1,1,10.0,64.0,11,0,1,1,10.0,82,6.05,85,480,2458,10.1,0.19198093
10428,10428,Greg Jacina,2007-08,25.0,3,0,3,3,0,0,0,2.0,21.0,14,0,1,1,12.0,82,5.76,70,398,2426,9.7,0.15777099
10429,10429,Greg Johnson,1994-95,23.0,2,17,52,52,6,11,17,48.0,,52,6,11,17,48.0,84,6.48,76,407,2545,10.7,0.32812595
10430,10430,Greg Johnson,1995-96,24.0,3,8,22,22,3,5,8,32.0,,74,9,16,25,80.0,48,5.97,37,209,1408,10.2,0.3544882
10431,10431,Greg Johnson,1996-97,25.0,4,40,60,60,18,22,40,87.0,,134,27,38,65,167.0,82,6.29,74,413,2481,10.4,0.5092523
10432,10432,Greg Johnson,1997-98,26.0,5,32,75,75,13,19,32,108.0,,209,40,57,97,275.0,82,5.83,55,336,2444,9.8,0.423493
10433,10433,Greg Johnson,1998-99,27.0,6,34,74,74,12,22,34,89.0,,283,52,79,131,364.0,82,5.28,57,380,2242,9.6,0.458578
10434,10434,Greg Johnson,1999-00,28.0,7,50,68,68,16,34,50,120.0,1321.0,351,68,113,181,484.0,82,5.27,57,359,2285,9.4,0.60947233
10435,10435,Greg Johnson,2000-01,29.0,8,44,82,82,11,33,44,133.0,1576.0,433,79,146,225,617.0,82,5.49,53,331,2294,9.8,0.48936027
10436,10436,Greg Johnson,2001-02,30.0,9,32,82,82,15,17,32,97.0,1461.0,515,94,163,257,714.0,82,5.51,63,376,2272,9.9,0.38037875
10437,10437,Greg Johnson,2002-03,31.0,10,44,82,82,18,26,44,145.0,1605.0,597,112,189,301,859.0,82,5.24,53,338,2262,9.5,0.512103
10438,10438,Greg Johnson,2003-04,32.0,11,17,38,38,8,9,17,55.0,653.0,635,120,198,318,914.0,82,5.31,60,363,2326,9.4,0.355419
10439,10439,Greg Johnson,2004-05,33.0,12,32,82,82,14,18,32,100.0,1446.0,717,134,216,350,1014.0,82,5.14,57,348,2300,9.2,0.36904943
10440,10440,Greg Johnson,2006-07,35.0,13,19,68,68,11,8,19,76.0,1128.0,785,145,224,369,1090.0,82,6.05,85,480,2458,10.1,0.24585408
10441,10441,Greg Johnston,1984-85,20.0,2,3,15,15,2,1,3,15.0,,15,2,1,3,15.0,80,7.89,74,336,2448,12.9,0.3642918
10442,10442,Greg Johnston,1985-86,21.0,3,0,6,6,0,0,0,1.0,,21,2,1,3,16.0,80,7.77,71,321,2447,12.7,0.26443943
10443,10443,Greg Johnston,1986-87,22.0,4,2,20,20,0,2,2,11.0,,41,2,3,5,27.0,80,7.94,82,370,2484,12.8,0.19631991
10444,10444,Greg Johnston,1987-88,23.0,5,27,76,76,12,15,27,132.0,,117,14,18,32,159.0,80,7.34,72,344,2400,12.2,0.42170498
10445,10445,Greg Johnston,1989-90,25.0,6,20,57,57,11,9,20,89.0,,174,25,27,52,248.0,80,7.48,85,403,2430,12.3,0.3163638
10446,10446,Greg Johnston,1990-91,26.0,7,2,9,9,1,1,2,9.0,,183,26,28,54,257.0,80,7.37,76,367,2421,12.2,0.2580585
10447,10447,Greg Johnston,1991-92,27.0,8,0,1,1,0,0,0,0.0,,184,26,28,54,257.0,80,6.91,71,366,2385,11.6,0.24611604
10448,10448,Greg Johnston,1992-93,28.0,9,1,3,3,0,1,1,2.0,,187,26,29,55,259.0,80,6.96,77,402,2440,11.4,0.20260397
10449,10449,Greg Koehler,2001-02,26.0,2,0,1,1,0,0,0,0.0,1.0,1,0,0,0,0.0,82,5.51,63,376,2272,9.9,0.15280735
10450,10450,Greg Kuznik,2001-02,23.0,2,0,1,1,0,0,0,0.0,8.0,1,0,0,0,0.0,82,5.51,63,376,2272,9.9,0.16257238
10451,10451,Greg Leeb,2001-02,24.0,2,0,2,2,0,0,0,4.0,14.0,2,0,0,0,4.0,82,5.51,63,376,2272,9.9,0.16723159
10452,10452,Greg Mauldin,2004-05,22.0,2,0,6,6,0,0,0,6.0,53.0,6,0,0,0,6.0,82,5.14,57,348,2300,9.2,0.21192512
10453,10453,Greg Mauldin,2010-11,28.0,3,0,1,1,0,0,0,2.0,10.0,7,0,0,0,8.0,82,5.53,56,304,2486,9.1,0.16035512
10454,10454,Greg Mauldin,2011-12,29.0,4,10,29,29,5,5,10,46.0,306.0,36,5,5,10,54.0,82,5.46,52,291,2492,9.0,0.22655675
10455,10455,Greg McKegg,2014-15,22.0,2,0,1,1,0,0,0,1.0,4.0,1,0,0,0,1.0,82,5.34,48,269,2463,8.9,0.16728714
10456,10456,Greg McKegg,2015-16,23.0,3,0,3,3,0,0,0,1.0,28.0,4,0,0,0,2.0,82,5.32,47,251,2453,8.9,0.1600422
10457,10457,Greg McKegg,2016-17,24.0,4,2,15,15,2,0,2,14.0,124.0,19,2,0,2,16.0,82,5.34,48,255,2438,9.0,0.20674628
10458,10458,Greg McKegg,2017-18,25.0,5,7,46,46,3,4,7,36.0,456.0,65,5,4,9,52.0,82,5.45,47,245,2478,9.0,0.17206576
10459,10459,Greg McKegg,2018-19,26.0,6,4,26,26,2,2,4,21.0,252.0,91,7,6,13,73.0,82,5.86,50,250,2620,9.2,0.18094727
10460,10460,Greg McKegg,2019-20,27.0,7,11,41,41,6,5,11,27.0,437.0,132,13,11,24,100.0,82,5.96,47,239,2579,9.5,0.19212896
10461,10461,Greg McKegg,2020-21,28.0,8,9,53,53,5,4,9,40.0,507.0,185,18,15,33,140.0,70,5.96,42,208,2192,9.5,0.15411007
10462,10462,Greg Meredith,1981-82,23.0,2,1,3,3,1,0,1,5.0,,3,1,0,1,5.0,80,7.69,77,340,2441,12.6,0.27675617
10463,10463,Greg Meredith,1983-84,25.0,3,9,35,35,5,4,9,39.0,,38,6,4,10,44.0,80,7.73,71,310,2444,12.7,0.25193036
10464,10464,Greg Moore,2008-09,24.0,2,0,6,6,0,0,0,13.0,71.0,6,0,0,0,13.0,82,5.44,62,351,2383,9.4,0.18006971
10465,10465,Greg Moore,2010-11,26.0,3,0,4,4,0,0,0,2.0,24.0,10,0,0,0,15.0,82,5.53,56,304,2486,9.1,0.1621441
10466,10466,Greg Nemisz,2011-12,21.0,2,1,6,6,0,1,1,5.0,31.0,6,0,1,1,5.0,82,5.46,52,291,2492,9.0,0.24860835
10467,10467,Greg Nemisz,2012-13,22.0,3,0,9,9,0,0,0,2.0,69.0,15,0,1,1,7.0,82,5.32,47,271,2439,8.9,0.14841801
10468,10468,Greg Pankewicz,1994-95,24.0,2,0,3,3,0,0,0,3.0,,3,0,0,0,3.0,84,6.48,76,407,2545,10.7,0.17670628
10469,10469,Greg Pankewicz,1999-00,29.0,3,3,18,18,0,3,3,10.0,134.0,21,0,3,3,13.0,82,5.27,57,359,2285,9.4,0.16702306
10470,10470,Greg Parks,1991-92,24.0,2,3,20,20,1,2,3,10.0,,20,1,2,3,10.0,80,6.91,71,366,2385,11.6,0.18160617
10471,10471,Greg Parks,1992-93,25.0,3,0,1,1,0,0,0,0.0,,21,1,2,3,10.0,80,6.96,77,402,2440,11.4,0.18407017
10472,10472,Greg Parks,1993-94,26.0,4,0,2,2,0,0,0,3.0,,23,1,2,3,13.0,84,7.25,87,443,2603,11.7,0.19351336
10473,10473,Greg Paslawski,1984-85,23.0,2,19,60,60,9,10,19,63.0,,60,9,10,19,63.0,80,7.89,74,336,2448,12.9,0.34701625
10474,10474,Greg Paslawski,1985-86,24.0,3,42,72,72,22,20,42,163.0,,132,31,30,61,226.0,80,7.77,71,321,2447,12.7,0.5185416
10475,10475,Greg Paslawski,1986-87,25.0,4,33,56,56,22,11,33,151.0,,188,53,41,94,377.0,80,7.94,82,370,2484,12.8,0.6206637
10476,10476,Greg Paslawski,1987-88,26.0,5,64,76,76,29,35,64,204.0,,264,82,76,158,581.0,80,7.34,72,344,2400,12.2,0.7746148
10477,10477,Greg Paslawski,1988-89,27.0,6,3,17,17,2,1,3,30.0,,281,84,77,161,611.0,80,7.43,89,437,2435,12.2,0.4306862
10478,10478,Greg Paslawski,1989-90,28.0,7,52,75,75,26,26,52,179.0,,356,110,103,213,790.0,80,7.48,85,403,2430,12.3,0.6444785
10479,10479,Greg Paslawski,1990-91,29.0,8,48,71,71,18,30,48,122.0,,427,128,133,261,912.0,80,7.37,76,367,2421,12.2,0.5470378
10480,10480,Greg Paslawski,1991-92,30.0,9,22,55,55,11,11,22,75.0,,482,139,144,283,987.0,80,6.91,71,366,2385,11.6,0.414205
10481,10481,Greg Paslawski,1992-93,31.0,10,45,80,80,28,17,45,134.0,,562,167,161,328,1121.0,80,6.96,77,402,2440,11.4,0.51475114
10482,10482,Greg Paslawski,1993-94,32.0,11,42,73,73,18,24,42,109.0,,635,185,185,370,1230.0,84,7.25,87,443,2603,11.7,0.43473125
10483,10483,Greg Paslawski,1994-95,33.0,12,2,15,15,2,0,2,13.0,,650,187,185,372,1243.0,84,6.48,76,407,2545,10.7,0.2541063
10484,10484,Greg Pateryn,2013-14,23.0,2,0,3,3,0,0,0,0.0,29.0,3,0,0,0,0.0,48,5.31,29,160,1399,9.1,0.1818172
10485,10485,Greg Pateryn,2015-16,25.0,3,0,17,17,0,0,0,10.0,215.0,20,0,0,0,10.0,82,5.32,47,251,2453,8.9,0.15768945
10486,10486,Greg Pateryn,2016-17,26.0,4,7,38,38,1,6,7,32.0,636.0,58,1,6,7,42.0,82,5.34,48,255,2438,9.0,0.14339101
10487,10487,Greg Pateryn,2017-18,27.0,5,9,36,36,1,8,9,42.0,555.0,94,2,14,16,84.0,82,5.45,47,245,2478,9.0,0.17516789
10488,10488,Greg Pateryn,2018-19,28.0,6,13,73,73,1,12,13,100.0,1432.0,167,3,26,29,184.0,82,5.86,50,250,2620,9.2,0.170955
10489,10489,Greg Pateryn,2019-20,29.0,7,7,80,80,1,6,7,100.0,1370.0,247,4,32,36,284.0,82,5.96,47,239,2579,9.5,0.16100213
10490,10490,Greg Pateryn,2020-21,30.0,8,3,20,20,0,3,3,22.0,309.0,267,4,35,39,306.0,70,5.96,42,208,2192,9.5,0.14883596
10491,10491,Greg Rallo,2012-13,31.0,2,0,1,1,0,0,0,1.0,4.0,1,0,0,0,1.0,82,5.32,47,271,2439,8.9,0.14045587
10492,10492,Greg Rallo,2013-14,32.0,3,1,10,10,1,0,1,10.0,96.0,11,1,0,1,11.0,48,5.31,29,160,1399,9.1,0.21595663
10493,10493,Greg Smyth,1987-88,21.0,2,0,1,1,0,0,0,1.0,,1,0,0,0,1.0,80,7.34,72,344,2400,12.2,0.24449232
10494,10494,Greg Smyth,1988-89,22.0,3,7,48,48,1,6,7,29.0,,49,1,6,7,30.0,80,7.43,89,437,2435,12.2,0.18118021
10495,10495,Greg Smyth,1989-90,23.0,4,1,10,10,0,1,1,3.0,,59,1,7,8,33.0,80,7.48,85,403,2430,12.3,0.1958169
10496,10496,Greg Smyth,1990-91,24.0,5,0,13,13,0,0,0,4.0,,72,1,7,8,37.0,80,7.37,76,367,2421,12.2,0.16789928
10497,10497,Greg Smyth,1991-92,25.0,6,0,1,1,0,0,0,0.0,,73,1,7,8,37.0,80,6.91,71,366,2385,11.6,0.15984428
10498,10498,Greg Smyth,1992-93,26.0,7,4,36,36,1,3,4,34.0,,109,2,10,12,71.0,80,6.96,77,402,2440,11.4,0.1658262
10499,10499,Greg Smyth,1993-94,27.0,8,3,35,35,1,2,3,14.0,,144,3,12,15,85.0,84,7.25,87,443,2603,11.7,0.12090656
10500,10500,Greg Smyth,1994-95,28.0,9,2,61,61,1,1,2,36.0,,205,4,13,17,121.0,84,6.48,76,407,2545,10.7,0.1115185
10501,10501,Greg Smyth,1995-96,29.0,10,3,22,22,0,3,3,10.0,,227,4,16,20,131.0,48,5.97,37,209,1408,10.2,0.09866956
10502,10502,Greg Smyth,1997-98,31.0,11,0,2,2,0,0,0,1.0,,229,4,16,20,132.0,82,5.83,55,336,2444,9.8,0.09744516
10503,10503,Greg Stewart,2008-09,22.0,2,0,1,1,0,0,0,2.0,11.0,1,0,0,0,2.0,82,5.44,62,351,2383,9.4,0.1834439
10504,10504,Greg Stewart,2009-10,23.0,3,1,20,20,0,1,1,16.0,172.0,21,0,1,1,18.0,82,5.7,65,341,2477,9.4,0.15257064
10505,10505,Greg Stewart,2010-11,24.0,4,0,5,5,0,0,0,4.0,21.0,26,0,1,1,22.0,82,5.53,56,304,2486,9.1,0.15375176
10506,10506,Greg Tebbutt,1980-81,23.0,2,1,2,2,0,1,1,0.0,,2,0,1,1,0.0,80,7.03,61,280,2352,12.0,0.22546506
10507,10507,Greg Tebbutt,1984-85,27.0,3,2,24,24,0,2,2,38.0,,26,0,3,3,38.0,80,7.89,74,336,2448,12.9,0.2019155
10508,10508,Greg Terrion,1981-82,21.0,2,37,73,73,12,25,37,92.0,,73,12,25,37,92.0,80,7.69,77,340,2441,12.6,0.574103
10509,10509,Greg Terrion,1982-83,22.0,3,37,61,61,15,22,37,111.0,,134,27,47,74,203.0,80,8.03,73,320,2489,12.9,0.5569035
10510,10510,Greg Terrion,1983-84,23.0,4,32,74,74,16,16,32,72.0,,208,43,63,106,275.0,80,7.73,71,310,2444,12.7,0.4831095
10511,10511,Greg Terrion,1984-85,24.0,5,39,79,79,15,24,39,93.0,,287,58,87,145,368.0,80,7.89,74,336,2448,12.9,0.4788531
10512,10512,Greg Terrion,1985-86,25.0,6,31,72,72,14,17,31,91.0,,359,72,104,176,459.0,80,7.77,71,321,2447,12.7,0.5095687
10513,10513,Greg Terrion,1986-87,26.0,7,32,76,76,10,22,32,105.0,,435,82,126,208,564.0,80,7.94,82,370,2484,12.8,0.42354828
10514,10514,Greg Terrion,1987-88,27.0,8,15,67,67,7,8,15,55.0,,502,89,134,223,619.0,80,7.34,72,344,2400,12.2,0.29106814
10515,10515,Greg Terrion,1988-89,28.0,9,20,59,59,4,16,20,57.0,,561,93,150,243,676.0,80,7.43,89,437,2435,12.2,0.31731224
10516,10516,Greg Theberge,1980-81,21.0,2,1,12,12,0,1,1,21.0,,12,0,1,1,21.0,80,7.03,61,280,2352,12.0,0.3100816
10517,10517,Greg Theberge,1981-82,22.0,3,1,1,1,1,0,1,1.0,,13,1,1,2,22.0,80,7.69,77,340,2441,12.6,0.25924084
10518,10518,Greg Theberge,1982-83,23.0,4,37,57,57,5,32,37,150.0,,70,6,33,39,172.0,80,8.03,73,320,2489,12.9,0.6408072
10519,10519,Greg Theberge,1983-84,24.0,5,36,70,70,8,28,36,136.0,,140,14,61,75,308.0,80,7.73,71,310,2444,12.7,0.46761206
10520,10520,Greg Theberge,1984-85,25.0,6,3,13,13,1,2,3,19.0,,153,15,63,78,327.0,80,7.89,74,336,2448,12.9,0.2934448
10521,10521,Greg Zanon,2006-07,26.0,2,2,4,4,0,2,2,3.0,69.0,4,0,2,2,3.0,82,6.05,85,480,2458,10.1,0.19318017
10522,10522,Greg Zanon,2007-08,27.0,3,8,66,66,3,5,8,43.0,1144.0,70,3,7,10,46.0,82,5.76,70,398,2426,9.7,0.14276159
10523,10523,Greg Zanon,2008-09,28.0,4,5,78,78,0,5,5,38.0,1440.0,148,3,12,15,84.0,82,5.44,62,351,2383,9.4,0.11435348
10524,10524,Greg Zanon,2009-10,29.0,5,11,82,82,4,7,11,54.0,1710.0,230,7,19,26,138.0,82,5.7,65,341,2477,9.4,0.15096614
10525,10525,Greg Zanon,2010-11,30.0,6,15,81,81,2,13,15,59.0,1812.0,311,9,32,41,197.0,82,5.53,56,304,2486,9.1,0.1442149
10526,10526,Greg Zanon,2011-12,31.0,7,7,82,82,0,7,7,55.0,1767.0,393,9,39,48,252.0,82,5.46,52,291,2492,9.0,0.12258053
10527,10527,Greg Zanon,2012-13,32.0,8,8,56,56,3,5,8,41.0,997.0,449,12,44,56,293.0,82,5.32,47,271,2439,8.9,0.120477825
10528,10528,Greg Zanon,2013-14,33.0,9,6,44,44,0,6,6,40.0,851.0,493,12,50,62,333.0,48,5.31,29,160,1399,9.1,0.13460231
10529,10529,Greg de Vries,1996-97,24.0,2,2,13,13,1,1,2,8.0,,13,1,1,2,8.0,82,6.29,74,413,2481,10.4,0.19529006
10530,10530,Greg de Vries,1997-98,25.0,3,4,37,37,0,4,4,31.0,,50,1,5,6,39.0,82,5.83,55,336,2444,9.8,0.14818352
10531,10531,Greg de Vries,1998-99,26.0,4,11,65,65,7,4,11,53.0,,115,8,9,17,92.0,82,5.28,57,380,2242,9.6,0.19468644
10532,10532,Greg de Vries,1999-00,27.0,5,4,73,73,1,3,4,57.0,1207.0,188,9,12,21,149.0,82,5.27,57,359,2285,9.4,0.13391867
10533,10533,Greg de Vries,2000-01,28.0,6,9,69,69,2,7,9,40.0,1034.0,257,11,19,30,189.0,82,5.49,53,331,2294,9.8,0.13980788
10534,10534,Greg de Vries,2001-02,29.0,7,17,79,79,5,12,17,76.0,1351.0,336,16,31,47,265.0,82,5.51,63,376,2272,9.9,0.1889723
10535,10535,Greg de Vries,2002-03,30.0,8,20,82,82,8,12,20,148.0,1890.0,418,24,43,67,413.0,82,5.24,53,338,2262,9.5,0.2869205
10536,10536,Greg de Vries,2003-04,31.0,9,32,82,82,6,26,32,112.0,1825.0,500,30,69,99,525.0,82,5.31,60,363,2326,9.4,0.3322939
10537,10537,Greg de Vries,2004-05,32.0,10,16,66,66,3,13,16,70.0,1240.0,566,33,82,115,595.0,82,5.14,57,348,2300,9.2,0.20158216
10538,10538,Greg de Vries,2006-07,34.0,11,35,82,82,7,28,35,111.0,1805.0,648,40,110,150,706.0,82,6.05,85,480,2458,10.1,0.32871437
10539,10539,Greg de Vries,2007-08,35.0,12,24,82,82,3,21,24,102.0,1824.0,730,43,131,174,808.0,82,5.76,70,398,2426,9.7,0.22413227
10540,10540,Greg de Vries,2008-09,36.0,13,15,77,77,4,11,15,66.0,1452.0,807,47,142,189,874.0,82,5.44,62,351,2383,9.4,0.15813816
10541,10541,Greg de Vries,2009-10,37.0,14,5,71,71,1,4,5,38.0,1074.0,878,48,146,194,912.0,82,5.7,65,341,2477,9.4,0.12845677
10542,10542,Gregory Campbell,2004-05,21.0,2,0,2,2,0,0,0,0.0,18.0,2,0,0,0,0.0,82,5.14,57,348,2300,9.2,0.24485323
10543,10543,Gregory Campbell,2006-07,23.0,3,9,64,64,3,6,9,59.0,553.0,66,3,6,9,59.0,82,6.05,85,480,2458,10.1,0.1864425
10544,10544,Gregory Campbell,2007-08,24.0,4,9,79,79,6,3,9,103.0,835.0,145,9,9,18,162.0,82,5.76,70,398,2426,9.7,0.20766267
10545,10545,Gregory Campbell,2008-09,25.0,5,18,81,81,5,13,18,113.0,1008.0,226,14,22,36,275.0,82,5.44,62,351,2383,9.4,0.23680767
10546,10546,Gregory Campbell,2009-10,26.0,6,32,77,77,13,19,32,135.0,1292.0,303,27,41,68,410.0,82,5.7,65,341,2477,9.4,0.38924927
10547,10547,Gregory Campbell,2010-11,27.0,7,17,60,60,2,15,17,84.0,924.0,363,29,56,85,494.0,82,5.53,56,304,2486,9.1,0.23353934
10548,10548,Gregory Campbell,2011-12,28.0,8,29,80,80,13,16,29,98.0,1075.0,443,42,72,114,592.0,82,5.46,52,291,2492,9.0,0.3219595
10549,10549,Gregory Campbell,2012-13,29.0,9,16,78,78,8,8,16,74.0,998.0,521,50,80,130,666.0,82,5.32,47,271,2439,8.9,0.23003858
10550,10550,Gregory Campbell,2013-14,30.0,10,13,48,48,4,9,13,52.0,658.0,569,54,89,143,718.0,48,5.31,29,160,1399,9.1,0.2334975
10551,10551,Gregory Campbell,2014-15,31.0,11,21,82,82,8,13,21,84.0,976.0,651,62,102,164,802.0,82,5.34,48,269,2463,8.9,0.24585196
10552,10552,Gregory Campbell,2015-16,32.0,12,12,70,70,6,6,12,64.0,849.0,721,68,108,176,866.0,82,5.32,47,251,2453,8.9,0.16314065
10553,10553,Gregory Campbell,2016-17,33.0,13,11,82,82,3,8,11,58.0,866.0,803,71,116,187,924.0,82,5.34,48,255,2438,9.0,0.15067649
10554,10554,Griffen Molino,2017-18,24.0,2,0,5,5,0,0,0,3.0,53.0,5,0,0,0,3.0,82,5.45,47,245,2478,9.0,0.17442444
10555,10555,Griffin Reinhart,2015-16,22.0,2,1,8,8,0,1,1,4.0,113.0,8,0,1,1,4.0,82,5.32,47,251,2453,8.9,0.19470122
10556,10556,Griffin Reinhart,2016-17,23.0,3,1,29,29,0,1,1,24.0,524.0,37,0,2,2,28.0,82,5.34,48,255,2438,9.0,0.17345357
10557,10557,Grigori Panteleev,1993-94,21.0,2,14,39,39,8,6,14,45.0,,39,8,6,14,45.0,84,7.25,87,443,2603,11.7,0.3512418
10558,10558,Grigori Panteleev,1994-95,22.0,3,0,10,10,0,0,0,8.0,,49,8,6,14,53.0,84,6.48,76,407,2545,10.7,0.18083218
10559,10559,Grigori Panteleev,1995-96,23.0,4,0,1,1,0,0,0,0.0,,50,8,6,14,53.0,48,5.97,37,209,1408,10.2,0.20144588
10560,10560,Grigori Panteleev,1996-97,24.0,5,0,4,4,0,0,0,1.0,,54,8,6,14,54.0,82,6.29,74,413,2481,10.4,0.16131496
10561,10561,Guillaume Brisebois,2019-20,22.0,2,0,8,8,0,0,0,5.0,88.0,8,0,0,0,5.0,82,5.96,47,239,2579,9.5,0.1829344
10562,10562,Guillaume Desbiens,2010-11,25.0,2,0,1,1,0,0,0,0.0,9.0,1,0,0,0,0.0,82,5.53,56,304,2486,9.1,0.14992926
10563,10563,Guillaume Desbiens,2011-12,26.0,3,0,12,12,0,0,0,4.0,88.0,13,0,0,0,4.0,82,5.46,52,291,2492,9.0,0.15206805
10564,10564,Guillaume Desbiens,2012-13,27.0,4,0,10,10,0,0,0,2.0,71.0,23,0,0,0,6.0,82,5.32,47,271,2439,8.9,0.13146141
10565,10565,Guillaume Latendresse,2007-08,20.0,2,29,80,80,16,13,29,121.0,1008.0,80,16,13,29,121.0,82,5.76,70,398,2426,9.7,0.4606573
10566,10566,Guillaume Latendresse,2008-09,21.0,3,27,73,73,16,11,27,116.0,895.0,153,32,24,56,237.0,82,5.44,62,351,2383,9.4,0.4605023
10567,10567,Guillaume Latendresse,2009-10,22.0,4,26,56,56,14,12,26,117.0,762.0,209,46,36,82,354.0,82,5.7,65,341,2477,9.4,0.5338044
10568,10568,Guillaume Latendresse,2010-11,23.0,5,40,78,78,27,13,40,160.0,1166.0,287,73,49,122,514.0,82,5.53,56,304,2486,9.1,0.55797285
10569,10569,Guillaume Latendresse,2011-12,24.0,6,6,11,11,3,3,6,18.0,140.0,298,76,52,128,532.0,82,5.46,52,291,2492,9.0,0.46835506
10570,10570,Guillaume Latendresse,2012-13,25.0,7,9,16,16,5,4,9,36.0,243.0,314,81,56,137,568.0,82,5.32,47,271,2439,8.9,0.40336037
10571,10571,Guillaume Latendresse,2013-14,26.0,8,10,27,27,6,4,10,53.0,400.0,341,87,60,147,621.0,48,5.31,29,160,1399,9.1,0.36264107
10572,10572,Guillaume Lefebvre,2002-03,21.0,2,0,3,3,0,0,0,3.0,18.0,3,0,0,0,3.0,82,5.24,53,338,2262,9.5,0.1963087
10573,10573,Guillaume Lefebvre,2003-04,22.0,3,6,26,26,2,4,6,19.0,314.0,29,2,4,6,22.0,82,5.31,60,363,2326,9.4,0.23471174
10574,10574,Guillaume Lefebvre,2006-07,25.0,4,0,9,9,0,0,0,3.0,111.0,38,2,4,6,25.0,82,6.05,85,480,2458,10.1,0.15679434
10575,10575,Guillaume Lefebvre,2010-11,29.0,5,0,1,1,0,0,0,0.0,11.0,39,2,4,6,25.0,82,5.53,56,304,2486,9.1,0.1352638
10576,10576,Gustav Forsling,2017-18,21.0,2,5,38,38,2,3,5,48.0,563.0,38,2,3,5,48.0,82,5.45,47,245,2478,9.0,0.26506835
10577,10577,Gustav Forsling,2018-19,22.0,3,13,41,41,3,10,13,82.0,785.0,79,5,13,18,130.0,82,5.86,50,250,2620,9.2,0.30319607
10578,10578,Gustav Forsling,2019-20,23.0,4,9,43,43,3,6,9,57.0,735.0,122,8,19,27,187.0,82,5.96,47,239,2579,9.5,0.23790261
10579,10579,Gustav Lindstrom,2020-21,22.0,2,1,16,16,0,1,1,9.0,265.0,16,0,1,1,9.0,70,5.96,42,208,2192,9.5,0.19587088
10580,10580,Gustav Nyquist,2012-13,23.0,2,7,18,18,1,6,7,19.0,191.0,18,1,6,7,19.0,82,5.32,47,271,2439,8.9,0.23720607
10581,10581,Gustav Nyquist,2013-14,24.0,3,6,22,22,3,3,6,46.0,287.0,40,4,9,13,65.0,48,5.31,29,160,1399,9.1,0.30922619
10582,10582,Gustav Nyquist,2014-15,25.0,4,48,57,57,28,20,48,153.0,961.0,97,32,29,61,218.0,82,5.34,48,269,2463,8.9,0.7362379
10583,10583,Gustav Nyquist,2015-16,26.0,5,54,82,82,27,27,54,195.0,1366.0,179,59,56,115,413.0,82,5.32,47,251,2453,8.9,0.6562767
10584,10584,Gustav Nyquist,2016-17,27.0,6,43,82,82,17,26,43,161.0,1244.0,261,76,82,158,574.0,82,5.34,48,255,2438,9.0,0.52205783
10585,10585,Gustav Nyquist,2017-18,28.0,7,48,76,76,12,36,48,165.0,1325.0,337,88,118,206,739.0,82,5.45,47,245,2478,9.0,0.57078195
10586,10586,Gustav Nyquist,2018-19,29.0,8,40,82,82,21,19,40,213.0,1464.0,419,109,137,246,952.0,82,5.86,50,250,2620,9.2,0.55113155
10587,10587,Gustav Nyquist,2019-20,30.0,9,60,81,81,22,38,60,204.0,1419.0,500,131,175,306,1156.0,82,5.96,47,239,2579,9.5,0.67063224
10588,10588,Gustav Nyquist,2020-21,31.0,10,42,70,70,15,27,42,151.0,1262.0,570,146,202,348,1307.0,70,5.96,42,208,2192,9.5,0.53596926
10589,10589,Gustav Olofsson,2016-17,22.0,2,0,2,2,0,0,0,1.0,18.0,2,0,0,0,1.0,82,5.34,48,255,2438,9.0,0.16917622
10590,10590,Gustav Olofsson,2017-18,23.0,3,3,13,13,0,3,3,7.0,175.0,15,0,3,3,8.0,82,5.45,47,245,2478,9.0,0.18761212
10591,10591,Gustav Olofsson,2018-19,24.0,4,8,41,41,0,8,8,22.0,524.0,56,0,11,11,30.0,82,5.86,50,250,2620,9.2,0.122505635
10592,10592,Gustav Olofsson,2020-21,26.0,5,0,3,3,0,0,0,2.0,24.0,59,0,11,11,32.0,70,5.96,42,208,2192,9.5,0.15539265
10593,10593,Guy Carbonneau,1981-82,21.0,2,1,2,2,0,1,1,1.0,,2,0,1,1,1.0,80,7.69,77,340,2441,12.6,0.30067632
10594,10594,Guy Carbonneau,1983-84,23.0,3,47,77,77,18,29,47,109.0,,79,18,30,48,110.0,80,7.73,71,310,2444,12.7,0.6036848
10595,10595,Guy Carbonneau,1984-85,24.0,4,54,78,78,24,30,54,166.0,,157,42,60,102,276.0,80,7.89,74,336,2448,12.9,0.6519413
10596,10596,Guy Carbonneau,1985-86,25.0,5,57,79,79,23,34,57,163.0,,236,65,94,159,439.0,80,7.77,71,321,2447,12.7,0.6665734
10597,10597,Guy Carbonneau,1986-87,26.0,6,56,80,80,20,36,56,147.0,,316,85,130,215,586.0,80,7.94,82,370,2484,12.8,0.6841404
10598,10598,Guy Carbonneau,1987-88,27.0,7,45,79,79,18,27,45,121.0,,395,103,157,260,707.0,80,7.34,72,344,2400,12.2,0.529442
10599,10599,Guy Carbonneau,1988-89,28.0,8,38,80,80,17,21,38,109.0,,475,120,178,298,816.0,80,7.43,89,437,2435,12.2,0.48593202
10600,10600,Guy Carbonneau,1989-90,29.0,9,56,79,79,26,30,56,142.0,,554,146,208,354,958.0,80,7.48,85,403,2430,12.3,0.7252866
10601,10601,Guy Carbonneau,1990-91,30.0,10,55,68,68,19,36,55,125.0,,622,165,244,409,1083.0,80,7.37,76,367,2421,12.2,0.64430594
10602,10602,Guy Carbonneau,1991-92,31.0,11,44,78,78,20,24,44,131.0,,700,185,268,453,1214.0,80,6.91,71,366,2385,11.6,0.5090248
10603,10603,Guy Carbonneau,1992-93,32.0,12,39,72,72,18,21,39,120.0,,772,203,289,492,1334.0,80,6.96,77,402,2440,11.4,0.44899738
10604,10604,Guy Carbonneau,1993-94,33.0,13,17,61,61,4,13,17,73.0,,833,207,302,509,1407.0,84,7.25,87,443,2603,11.7,0.28478038
10605,10605,Guy Carbonneau,1994-95,34.0,14,38,79,79,14,24,38,120.0,,912,221,326,547,1527.0,84,6.48,76,407,2545,10.7,0.38793263
10606,10606,Guy Carbonneau,1995-96,35.0,15,16,42,42,5,11,16,33.0,,954,226,337,563,1560.0,48,5.97,37,209,1408,10.2,0.3443069
10607,10607,Guy Carbonneau,1996-97,36.0,16,23,71,71,8,15,23,54.0,,1025,234,352,586,1614.0,82,6.29,74,413,2481,10.4,0.25454557
10608,10608,Guy Carbonneau,1997-98,37.0,17,21,73,73,5,16,21,99.0,,1098,239,368,607,1713.0,82,5.83,55,336,2444,9.8,0.2670222
10609,10609,Guy Carbonneau,1998-99,38.0,18,24,77,77,7,17,24,81.0,,1175,246,385,631,1794.0,82,5.28,57,380,2242,9.6,0.24798092
10610,10610,Guy Carbonneau,1999-00,39.0,19,16,74,74,4,12,16,60.0,988.0,1249,250,397,647,1854.0,82,5.27,57,359,2285,9.4,0.23804826
10611,10611,Guy Carbonneau,2000-01,40.0,20,16,69,69,10,6,16,70.0,1079.0,1318,260,403,663,1924.0,82,5.49,53,331,2294,9.8,0.2772296
10612,10612,Guy Gosselin,1988-89,25.0,2,0,5,5,0,0,0,1.0,,5,0,0,0,1.0,80,7.43,89,437,2435,12.2,0.20161664
10613,10613,Guy Larose,1989-90,22.0,2,1,3,3,0,1,1,2.0,,3,0,1,1,2.0,80,7.48,85,403,2430,12.3,0.23997626
10614,10614,Guy Larose,1991-92,24.0,3,0,7,7,0,0,0,7.0,,10,0,1,1,9.0,80,6.91,71,366,2385,11.6,0.18894777
10615,10615,Guy Larose,1992-93,25.0,4,14,34,34,9,5,14,60.0,,44,9,6,15,69.0,80,6.96,77,402,2440,11.4,0.3347361
10616,10616,Guy Larose,1993-94,26.0,5,0,9,9,0,0,0,8.0,,53,9,6,15,77.0,84,7.25,87,443,2603,11.7,0.20470518
10617,10617,Guy Larose,1994-95,27.0,6,4,17,17,1,3,4,12.0,,70,10,9,19,89.0,84,6.48,76,407,2545,10.7,0.18932024
10618,10618,Guy Leveque,1993-94,21.0,2,3,12,12,2,1,3,12.0,,12,2,1,3,12.0,84,7.25,87,443,2603,11.7,0.33940697
10619,10619,Guy Leveque,1994-95,22.0,3,1,5,5,0,1,1,3.0,,17,2,2,4,15.0,84,6.48,76,407,2545,10.7,0.20472446
10620,10620,Hakan Loob,1984-85,24.0,2,55,77,77,30,25,55,178.0,,77,30,25,55,178.0,80,7.89,74,336,2448,12.9,0.6988638
10621,10621,Hakan Loob,1985-86,25.0,3,72,78,78,37,35,72,224.0,,155,67,60,127,402.0,80,7.77,71,321,2447,12.7,0.8469473
10622,10622,Hakan Loob,1986-87,26.0,4,67,68,68,31,36,67,174.0,,223,98,96,194,576.0,80,7.94,82,370,2484,12.8,0.8754393
10623,10623,Hakan Loob,1987-88,27.0,5,44,68,68,18,26,44,129.0,,291,116,122,238,705.0,80,7.34,72,344,2400,12.2,0.7072288
10624,10624,Hakan Loob,1988-89,28.0,6,106,80,80,50,56,106,198.0,,371,166,178,344,903.0,80,7.43,89,437,2435,12.2,1.1176925
10625,10625,Hakan Loob,1989-90,29.0,7,85,79,79,27,58,85,223.0,,450,193,236,429,1126.0,80,7.48,85,403,2430,12.3,0.9933394
10626,10626,Hal Gill,1998-99,23.0,2,6,68,68,2,4,6,56.0,,68,2,4,6,56.0,82,5.28,57,380,2242,9.6,0.1814155
10627,10627,Hal Gill,1999-00,24.0,3,10,80,80,3,7,10,102.0,1672.0,148,5,11,16,158.0,82,5.27,57,359,2285,9.4,0.2076157
10628,10628,Hal Gill,2000-01,25.0,4,12,81,81,3,9,12,120.0,1398.0,229,8,20,28,278.0,82,5.49,53,331,2294,9.8,0.19768113
10629,10629,Hal Gill,2001-02,26.0,5,11,80,80,1,10,11,79.0,1467.0,309,9,30,39,357.0,82,5.51,63,376,2272,9.9,0.16469255
10630,10630,Hal Gill,2002-03,27.0,6,22,79,79,4,18,22,137.0,1913.0,388,13,48,61,494.0,82,5.24,53,338,2262,9.5,0.28777722
10631,10631,Hal Gill,2003-04,28.0,7,17,76,76,4,13,17,114.0,1573.0,464,17,61,78,608.0,82,5.31,60,363,2326,9.4,0.21424055
10632,10632,Hal Gill,2004-05,29.0,8,9,82,82,2,7,9,104.0,1509.0,546,19,68,87,712.0,82,5.14,57,348,2300,9.2,0.18274796
10633,10633,Hal Gill,2006-07,31.0,9,10,80,80,1,9,10,68.0,1489.0,626,20,77,97,780.0,82,6.05,85,480,2458,10.1,0.14853433
10634,10634,Hal Gill,2007-08,32.0,10,20,82,82,6,14,20,79.0,1549.0,708,26,91,117,859.0,82,5.76,70,398,2426,9.7,0.23122069
10635,10635,Hal Gill,2008-09,33.0,11,24,81,81,3,21,24,86.0,1620.0,789,29,112,141,945.0,82,5.44,62,351,2383,9.4,0.21034998
10636,10636,Hal Gill,2009-10,34.0,12,10,62,62,2,8,10,40.0,1109.0,851,31,120,151,985.0,82,5.7,65,341,2477,9.4,0.1336247
10637,10637,Hal Gill,2010-11,35.0,13,11,68,68,2,9,11,41.0,1247.0,919,33,129,162,1026.0,82,5.53,56,304,2486,9.1,0.12672126
10638,10638,Hal Gill,2011-12,36.0,14,9,75,75,2,7,9,62.0,1486.0,994,35,136,171,1088.0,82,5.46,52,291,2492,9.0,0.12676823
10639,10639,Hal Gill,2012-13,37.0,15,13,76,76,1,12,13,49.0,1302.0,1070,36,148,184,1137.0,82,5.32,47,271,2439,8.9,0.11083764
10640,10640,Hal Gill,2013-14,38.0,16,0,32,32,0,0,0,8.0,428.0,1102,36,148,184,1145.0,48,5.31,29,160,1399,9.1,0.083057284
10641,10641,Hal Gill,2014-15,39.0,17,0,6,6,0,0,0,1.0,89.0,1108,36,148,184,1146.0,82,5.34,48,269,2463,8.9,0.12553534
10642,10642,Hampus Lindholm,2014-15,21.0,2,30,78,78,6,24,30,116.0,1516.0,78,6,24,30,116.0,82,5.34,48,269,2463,8.9,0.43389603
10643,10643,Hampus Lindholm,2015-16,22.0,3,34,78,78,7,27,34,107.0,1697.0,156,13,51,64,223.0,82,5.32,47,251,2453,8.9,0.4197133
10644,10644,Hampus Lindholm,2016-17,23.0,4,28,80,80,10,18,28,149.0,1760.0,236,23,69,92,372.0,82,5.34,48,255,2438,9.0,0.41819808
10645,10645,Hampus Lindholm,2017-18,24.0,5,20,66,66,6,14,20,94.0,1482.0,302,29,83,112,466.0,82,5.45,47,245,2478,9.0,0.36251998
10646,10646,Hampus Lindholm,2018-19,25.0,6,31,69,69,13,18,31,131.0,1569.0,371,42,101,143,597.0,82,5.86,50,250,2620,9.2,0.49442962
10647,10647,Hampus Lindholm,2019-20,26.0,7,28,76,76,6,22,28,125.0,1824.0,447,48,123,171,722.0,82,5.96,47,239,2579,9.5,0.40194997
10648,10648,Hampus Lindholm,2020-21,27.0,8,22,55,55,2,20,22,109.0,1269.0,502,50,143,193,831.0,70,5.96,42,208,2192,9.5,0.4135442
10649,10649,Hank Lammens,1994-95,28.0,2,3,27,27,1,2,3,6.0,,27,1,2,3,6.0,84,6.48,76,407,2545,10.7,0.13985938
10650,10650,Hannes Hyvonen,2002-03,27.0,2,0,6,6,0,0,0,4.0,34.0,6,0,0,0,4.0,82,5.24,53,338,2262,9.5,0.1541453
10651,10651,Hannes Hyvonen,2003-04,28.0,3,9,36,36,4,5,9,48.0,361.0,42,4,5,9,52.0,82,5.31,60,363,2326,9.4,0.20614076
10652,10652,Hannu Jarvenpaa,1987-88,24.0,2,9,20,20,1,8,9,36.0,,20,1,8,9,36.0,80,7.34,72,344,2400,12.2,0.30831802
10653,10653,Hannu Jarvenpaa,1988-89,25.0,3,17,41,41,6,11,17,52.0,,61,7,19,26,88.0,80,7.43,89,437,2435,12.2,0.3700127
10654,10654,Hannu Jarvenpaa,1989-90,26.0,4,11,53,53,4,7,11,27.0,,114,11,26,37,115.0,80,7.48,85,403,2430,12.3,0.28499585
10655,10655,Hannu Virta,1982-83,19.0,2,1,3,3,0,1,1,3.0,,3,0,1,1,3.0,80,8.03,73,320,2489,12.9,0.32459444
10656,10656,Hannu Virta,1983-84,20.0,3,37,74,74,13,24,37,168.0,,77,13,25,38,171.0,80,7.73,71,310,2444,12.7,0.5972945
10657,10657,Hannu Virta,1984-85,21.0,4,36,70,70,6,30,36,98.0,,147,19,55,74,269.0,80,7.89,74,336,2448,12.9,0.47077996
10658,10658,Hannu Virta,1985-86,22.0,5,24,51,51,1,23,24,56.0,,198,20,78,98,325.0,80,7.77,71,321,2447,12.7,0.45825705
10659,10659,Hannu Virta,1986-87,23.0,6,28,47,47,5,23,28,81.0,,245,25,101,126,406.0,80,7.94,82,370,2484,12.8,0.5289567
10660,10660,Hans Jonsson,2000-01,27.0,2,14,68,68,3,11,14,49.0,1263.0,68,3,11,14,49.0,82,5.49,53,331,2294,9.8,0.16691872
10661,10661,Hans Jonsson,2001-02,28.0,3,22,58,58,4,18,22,44.0,1070.0,126,7,29,36,93.0,82,5.51,63,376,2272,9.9,0.25183797
10662,10662,Hans Jonsson,2002-03,29.0,4,7,53,53,2,5,7,37.0,964.0,179,9,34,43,130.0,82,5.24,53,338,2262,9.5,0.16053966
10663,10663,Hans Jonsson,2003-04,30.0,5,5,63,63,1,4,5,40.0,1075.0,242,10,38,48,170.0,82,5.31,60,363,2326,9.4,0.15704203
10664,10664,Harijs Vitolinsh,1994-95,26.0,2,0,8,8,0,0,0,7.0,,8,0,0,0,7.0,84,6.48,76,407,2545,10.7,0.16916966
10665,10665,Harold Druken,2000-01,22.0,2,16,33,33,7,9,16,69.0,429.0,33,7,9,16,69.0,82,5.49,53,331,2294,9.8,0.4034145
10666,10666,Harold Druken,2001-02,23.0,3,30,55,55,15,15,30,82.0,660.0,88,22,24,46,151.0,82,5.51,63,376,2272,9.9,0.4879787
10667,10667,Harold Druken,2002-03,24.0,4,8,27,27,4,4,8,33.0,301.0,115,26,28,54,184.0,82,5.24,53,338,2262,9.5,0.29539365
10668,10668,Harold Druken,2003-04,25.0,5,5,22,22,1,4,5,16.0,146.0,137,27,32,59,200.0,82,5.31,60,363,2326,9.4,0.21840176
10669,10669,Harold Druken,2004-05,26.0,6,4,9,9,0,4,4,19.0,97.0,146,27,36,63,219.0,82,5.14,57,348,2300,9.2,0.29743284
10670,10670,Harri Pesonen,2013-14,25.0,2,0,4,4,0,0,0,3.0,37.0,4,0,0,0,3.0,48,5.31,29,160,1399,9.1,0.18283695
10671,10671,Harry York,1997-98,23.0,2,32,74,74,14,18,32,86.0,,74,14,18,32,86.0,82,5.83,55,336,2444,9.8,0.4359438
10672,10672,Harry York,1998-99,24.0,3,10,60,60,4,6,10,44.0,,134,18,24,42,130.0,82,5.28,57,380,2242,9.6,0.21335843
10673,10673,Harry York,1999-00,25.0,4,16,56,56,7,9,16,60.0,768.0,190,25,33,58,190.0,82,5.27,57,359,2285,9.4,0.30928794
10674,10674,Harry York,2000-01,26.0,5,17,54,54,4,13,17,50.0,679.0,244,29,46,75,240.0,82,5.49,53,331,2294,9.8,0.29485267
10675,10675,Harry Zolnierczyk,2012-13,25.0,2,6,37,37,3,3,6,49.0,285.0,37,3,3,6,49.0,82,5.32,47,271,2439,8.9,0.2110802
10676,10676,Harry Zolnierczyk,2013-14,26.0,3,1,7,7,0,1,1,4.0,52.0,44,3,4,7,53.0,48,5.31,29,160,1399,9.1,0.18080768
10677,10677,Harry Zolnierczyk,2014-15,27.0,4,2,13,13,2,0,2,12.0,132.0,57,5,4,9,65.0,82,5.34,48,269,2463,8.9,0.19326308
10678,10678,Harry Zolnierczyk,2015-16,28.0,5,0,2,2,0,0,0,1.0,22.0,59,5,4,9,66.0,82,5.32,47,251,2453,8.9,0.12239969
10679,10679,Harry Zolnierczyk,2016-17,29.0,6,0,1,1,0,0,0,1.0,9.0,60,5,4,9,67.0,82,5.34,48,255,2438,9.0,0.119286
10680,10680,Harry Zolnierczyk,2017-18,30.0,7,4,24,24,2,2,4,19.0,213.0,84,7,6,13,86.0,82,5.45,47,245,2478,9.0,0.15714657
10681,10681,Harvie Pocza,1980-81,21.0,2,0,1,1,0,0,0,2.0,,1,0,0,0,2.0,80,7.03,61,280,2352,12.0,0.24568322
10682,10682,Harvie Pocza,1982-83,23.0,3,0,2,2,0,0,0,1.0,,3,0,0,0,3.0,80,8.03,73,320,2489,12.9,0.21157894
10683,10683,Haydn Fleury,2018-19,22.0,2,8,67,67,0,8,8,86.0,1125.0,67,0,8,8,86.0,82,5.86,50,250,2620,9.2,0.17830777
10684,10684,Haydn Fleury,2019-20,23.0,3,1,20,20,0,1,1,17.0,251.0,87,0,9,9,103.0,82,5.96,47,239,2579,9.5,0.16527575
10685,10685,Haydn Fleury,2020-21,24.0,4,14,45,45,4,10,14,65.0,615.0,132,4,19,23,168.0,70,5.96,42,208,2192,9.5,0.29798687
10686,10686,Helmut Balderis,1990-91,38.0,2,9,26,26,3,6,9,30.0,,26,3,6,9,30.0,80,7.37,76,367,2421,12.2,0.29800293
10687,10687,Henri Jokiharju,2019-20,20.0,2,12,38,38,0,12,12,62.0,721.0,38,0,12,12,62.0,82,5.96,47,239,2579,9.5,0.28198588
10688,10688,Henri Jokiharju,2020-21,21.0,3,15,69,69,4,11,15,78.0,1188.0,107,4,23,27,140.0,70,5.96,42,208,2192,9.5,0.326172
10689,10689,Henrik Borgström,2018-19,21.0,2,1,4,4,1,0,1,6.0,51.0,4,1,0,1,6.0,82,5.86,50,250,2620,9.2,0.24716744
10690,10690,Henrik Borgström,2019-20,22.0,3,18,50,50,8,10,18,54.0,600.0,54,9,10,19,60.0,82,5.96,47,239,2579,9.5,0.35324344
10691,10691,Henrik Borgström,2020-21,23.0,4,0,4,4,0,0,0,3.0,50.0,58,9,10,19,63.0,70,5.96,42,208,2192,9.5,0.21417883
10692,10692,Henrik Haapala,2018-19,24.0,2,1,5,5,0,1,1,3.0,69.0,5,0,1,1,3.0,82,5.86,50,250,2620,9.2,0.18346974
10693,10693,Henrik Samuelsson,2015-16,21.0,2,0,3,3,0,0,0,4.0,40.0,3,0,0,0,4.0,82,5.32,47,251,2453,8.9,0.22231701
10694,10694,Henrik Sedin,2001-02,21.0,2,29,82,82,9,20,29,98.0,1109.0,82,9,20,29,98.0,82,5.51,63,376,2272,9.9,0.39264414
10695,10695,Henrik Sedin,2002-03,22.0,3,36,82,82,16,20,36,78.0,1050.0,164,25,40,65,176.0,82,5.24,53,338,2262,9.5,0.49991128
10696,10696,Henrik Sedin,2003-04,23.0,4,39,78,78,8,31,39,81.0,1089.0,242,33,71,104,257.0,82,5.31,60,363,2326,9.4,0.47734058
10697,10697,Henrik Sedin,2004-05,24.0,5,42,76,76,11,31,42,99.0,1067.0,318,44,102,146,356.0,82,5.14,57,348,2300,9.2,0.61546427
10698,10698,Henrik Sedin,2006-07,26.0,6,75,82,82,18,57,75,113.0,1386.0,400,62,159,221,469.0,82,6.05,85,480,2458,10.1,0.81332636
10699,10699,Henrik Sedin,2007-08,27.0,7,81,82,82,10,71,81,134.0,1511.0,482,72,230,302,603.0,82,5.76,70,398,2426,9.7,0.81606394
10700,10700,Henrik Sedin,2008-09,28.0,8,76,82,82,15,61,76,141.0,1600.0,564,87,291,378,744.0,82,5.44,62,351,2383,9.4,0.8387488
10701,10701,Henrik Sedin,2009-10,29.0,9,82,82,82,22,60,82,143.0,1601.0,646,109,351,460,887.0,82,5.7,65,341,2477,9.4,0.8928946
10702,10702,Henrik Sedin,2010-11,30.0,10,112,82,82,29,83,112,166.0,1614.0,728,138,434,572,1053.0,82,5.53,56,304,2486,9.1,1.1127965
10703,10703,Henrik Sedin,2011-12,31.0,11,94,82,82,19,75,94,157.0,1579.0,810,157,509,666,1210.0,82,5.46,52,291,2492,9.0,0.9205713
10704,10704,Henrik Sedin,2012-13,32.0,12,81,82,82,14,67,81,113.0,1565.0,892,171,576,747,1323.0,82,5.32,47,271,2439,8.9,0.85923696
10705,10705,Henrik Sedin,2013-14,33.0,13,45,48,48,11,34,45,70.0,929.0,940,182,610,792,1393.0,48,5.31,29,160,1399,9.1,0.7793106
10706,10706,Henrik Sedin,2014-15,34.0,14,50,70,70,11,39,50,97.0,1447.0,1010,193,649,842,1490.0,82,5.34,48,269,2463,8.9,0.6303167
10707,10707,Henrik Sedin,2015-16,35.0,15,73,82,82,18,55,73,101.0,1526.0,1092,211,704,915,1591.0,82,5.32,47,251,2453,8.9,0.74849856
10708,10708,Henrik Sedin,2016-17,36.0,16,55,74,74,11,44,55,99.0,1360.0,1166,222,748,970,1690.0,82,5.34,48,255,2438,9.0,0.63063765
10709,10709,Henrik Sedin,2017-18,37.0,17,50,82,82,15,35,50,99.0,1561.0,1248,237,783,1020,1789.0,82,5.45,47,245,2478,9.0,0.5975919
10710,10710,Henrik Sedin,2018-19,38.0,18,50,82,82,3,47,50,67.0,1275.0,1330,240,830,1070,1856.0,82,5.86,50,250,2620,9.2,0.52020514
10711,10711,Henrik Tallinder,2002-03,24.0,2,0,2,2,0,0,0,4.0,36.0,2,0,0,0,4.0,82,5.24,53,338,2262,9.5,0.17170015
10712,10712,Henrik Tallinder,2003-04,25.0,3,13,46,46,3,10,13,37.0,914.0,48,3,10,13,41.0,82,5.31,60,363,2326,9.4,0.2085942
10713,10713,Henrik Tallinder,2004-05,26.0,4,10,72,72,1,9,10,63.0,1323.0,120,4,19,23,104.0,82,5.14,57,348,2300,9.2,0.18698442
10714,10714,Henrik Tallinder,2006-07,28.0,5,21,82,82,6,15,21,79.0,1668.0,202,10,34,44,183.0,82,6.05,85,480,2458,10.1,0.2376329
10715,10715,Henrik Tallinder,2007-08,29.0,6,14,47,47,4,10,14,34.0,993.0,249,14,44,58,217.0,82,5.76,70,398,2426,9.7,0.20511356
10716,10716,Henrik Tallinder,2008-09,30.0,7,18,71,71,1,17,18,70.0,1494.0,320,15,61,76,287.0,82,5.44,62,351,2383,9.4,0.21973497
10717,10717,Henrik Tallinder,2009-10,31.0,8,12,66,66,1,11,12,35.0,1216.0,386,16,72,88,322.0,82,5.7,65,341,2477,9.4,0.15191218
10718,10718,Henrik Tallinder,2010-11,32.0,9,20,82,82,4,16,20,53.0,1690.0,468,20,88,108,375.0,82,5.53,56,304,2486,9.1,0.2130593
10719,10719,Henrik Tallinder,2011-12,33.0,10,16,82,82,5,11,16,102.0,1848.0,550,25,99,124,477.0,82,5.46,52,291,2492,9.0,0.22176409
10720,10720,Henrik Tallinder,2012-13,34.0,11,6,39,39,0,6,6,43.0,831.0,589,25,105,130,520.0,82,5.32,47,271,2439,8.9,0.13889796
10721,10721,Henrik Tallinder,2013-14,35.0,12,4,25,25,1,3,4,22.0,439.0,614,26,108,134,542.0,48,5.31,29,160,1399,9.1,0.14162534
10722,10722,Henrik Tallinder,2014-15,36.0,13,8,64,64,2,6,8,40.0,1216.0,678,28,114,142,582.0,82,5.34,48,269,2463,8.9,0.1270816
10723,10723,Henrik Zetterberg,2003-04,23.0,2,44,79,79,22,22,44,135.0,1289.0,79,22,22,44,135.0,82,5.31,60,363,2326,9.4,0.5571183
10724,10724,Henrik Zetterberg,2004-05,24.0,3,43,61,61,15,28,43,137.0,1113.0,140,37,50,87,272.0,82,5.14,57,348,2300,9.2,0.7549435
10725,10725,Henrik Zetterberg,2006-07,26.0,4,85,77,77,39,46,85,270.0,1460.0,217,76,96,172,542.0,82,6.05,85,480,2458,10.1,1.0289358
10726,10726,Henrik Zetterberg,2007-08,27.0,5,68,63,63,33,35,68,224.0,1313.0,280,109,131,240,766.0,82,5.76,70,398,2426,9.7,1.0469296
10727,10727,Henrik Zetterberg,2008-09,28.0,6,92,75,75,43,49,92,358.0,1655.0,355,152,180,332,1124.0,82,5.44,62,351,2383,9.4,1.0470716
10728,10728,Henrik Zetterberg,2009-10,29.0,7,73,77,77,31,42,73,309.0,1531.0,432,183,222,405,1433.0,82,5.7,65,341,2477,9.4,0.8835187
10729,10729,Henrik Zetterberg,2010-11,30.0,8,70,74,74,23,47,70,309.0,1485.0,506,206,269,475,1742.0,82,5.53,56,304,2486,9.1,0.85916257
10730,10730,Henrik Zetterberg,2011-12,31.0,9,80,80,80,24,56,80,306.0,1567.0,586,230,325,555,2048.0,82,5.46,52,291,2492,9.0,0.8530315
10731,10731,Henrik Zetterberg,2012-13,32.0,10,69,82,82,22,47,69,267.0,1627.0,668,252,372,624,2315.0,82,5.32,47,271,2439,8.9,0.873435
10732,10732,Henrik Zetterberg,2013-14,33.0,11,48,46,46,11,37,48,173.0,944.0,714,263,409,672,2488.0,48,5.31,29,160,1399,9.1,0.9825238
10733,10733,Henrik Zetterberg,2014-15,34.0,12,48,45,45,16,32,48,151.0,925.0,759,279,441,720,2639.0,82,5.34,48,269,2463,8.9,0.92947006
10734,10734,Henrik Zetterberg,2015-16,35.0,13,66,77,77,17,49,66,227.0,1472.0,836,296,490,786,2866.0,82,5.32,47,251,2453,8.9,0.7654563
10735,10735,Henrik Zetterberg,2016-17,36.0,14,50,82,82,13,37,50,214.0,1592.0,918,309,527,836,3080.0,82,5.34,48,255,2438,9.0,0.6364746
10736,10736,Henrik Zetterberg,2017-18,37.0,15,68,82,82,17,51,68,195.0,1617.0,1000,326,578,904,3275.0,82,5.45,47,245,2478,9.0,0.7401258
10737,10737,Henrik Zetterberg,2018-19,38.0,16,56,82,82,11,45,56,180.0,1599.0,1082,337,623,960,3455.0,82,5.86,50,250,2620,9.2,0.65226305
10738,10738,Herb Raglan,1986-87,19.0,2,0,7,7,0,0,0,4.0,,7,0,0,0,4.0,80,7.94,82,370,2484,12.8,0.24548903
10739,10739,Herb Raglan,1987-88,20.0,3,16,62,62,6,10,16,58.0,,69,6,10,16,62.0,80,7.34,72,344,2400,12.2,0.3121975
10740,10740,Herb Raglan,1988-89,21.0,4,25,73,73,10,15,25,95.0,,142,16,25,41,157.0,80,7.43,89,437,2435,12.2,0.397772
10741,10741,Herb Raglan,1989-90,22.0,5,17,50,50,7,10,17,86.0,,192,23,35,58,243.0,80,7.48,85,403,2430,12.3,0.41478017
10742,10742,Herb Raglan,1990-91,23.0,6,1,11,11,0,1,1,13.0,,203,23,36,59,256.0,80,7.37,76,367,2421,12.2,0.32886922
10743,10743,Herb Raglan,1991-92,24.0,7,10,47,47,4,6,10,48.0,,250,27,42,69,304.0,80,6.91,71,366,2385,11.6,0.29166877
10744,10744,Herb Raglan,1992-93,25.0,8,20,62,62,6,14,20,79.0,,312,33,56,89,383.0,80,6.96,77,402,2440,11.4,0.29552883
10745,10745,Herb Raglan,1993-94,26.0,9,0,2,2,0,0,0,0.0,,314,33,56,89,383.0,84,7.25,87,443,2603,11.7,0.2295498
10746,10746,Herb Raglan,1994-95,27.0,10,0,29,29,0,0,0,13.0,,343,33,56,89,396.0,84,6.48,76,407,2545,10.7,0.1521132
10747,10747,Herbert Vasiljevs,1999-00,23.0,2,0,5,5,0,0,0,6.0,56.0,5,0,0,0,6.0,82,5.27,57,359,2285,9.4,0.1746068
10748,10748,Herbert Vasiljevs,2000-01,24.0,3,1,7,7,1,0,1,2.0,65.0,12,1,0,1,8.0,82,5.49,53,331,2294,9.8,0.1887632
10749,10749,Herbert Vasiljevs,2001-02,25.0,4,9,21,21,4,5,9,41.0,336.0,33,5,5,10,49.0,82,5.51,63,376,2272,9.9,0.25771955
10750,10750,Herbert Vasiljevs,2002-03,26.0,5,5,18,18,3,2,5,17.0,165.0,51,8,7,15,66.0,82,5.24,53,338,2262,9.5,0.22143698
10751,10751,Hnat Domenichelli,1997-98,21.0,2,6,23,23,3,3,6,30.0,,23,3,3,6,30.0,82,5.83,55,336,2444,9.8,0.3234008
10752,10752,Hnat Domenichelli,1998-99,22.0,3,16,31,31,9,7,16,70.0,,54,12,10,22,100.0,82,5.28,57,380,2242,9.6,0.4311169
10753,10753,Hnat Domenichelli,1999-00,23.0,4,10,23,23,5,5,10,45.0,299.0,77,17,15,32,145.0,82,5.27,57,359,2285,9.4,0.3670938
10754,10754,Hnat Domenichelli,2000-01,24.0,5,29,59,59,11,18,29,125.0,861.0,136,28,33,61,270.0,82,5.49,53,331,2294,9.8,0.42378962
10755,10755,Hnat Domenichelli,2001-02,25.0,6,27,63,63,15,12,27,150.0,904.0,199,43,45,88,420.0,82,5.51,63,376,2272,9.9,0.45229787
10756,10756,Hnat Domenichelli,2002-03,26.0,7,25,67,67,9,16,25,144.0,936.0,266,52,61,113,564.0,82,5.24,53,338,2262,9.5,0.38930872
10757,10757,Hnat Domenichelli,2003-04,27.0,8,0,1,1,0,0,0,1.0,11.0,267,52,61,113,565.0,82,5.31,60,363,2326,9.4,0.30846724
10758,10758,Howard Scruton,1983-84,21.0,2,4,4,4,0,4,4,4.0,,4,0,4,4,4.0,80,7.73,71,310,2444,12.7,0.32280767
10759,10759,Howard Walker,1981-82,23.0,2,13,64,64,2,11,13,68.0,,64,2,11,13,68.0,80,7.69,77,340,2441,12.6,0.24990854
10760,10760,Howard Walker,1982-83,24.0,3,2,16,16,0,2,2,18.0,,80,2,13,15,86.0,80,8.03,73,320,2489,12.9,0.24839908
10761,10761,Howard Walker,1983-84,25.0,4,0,3,3,0,0,0,2.0,,83,2,13,15,88.0,80,7.73,71,310,2444,12.7,0.21112072
10762,10762,Hubie McDonough,1989-90,26.0,2,1,4,4,0,1,1,3.0,,4,0,1,1,3.0,80,7.48,85,403,2430,12.3,0.22676522
10763,10763,Hubie McDonough,1990-91,27.0,3,36,76,76,21,15,36,105.0,,80,21,16,37,108.0,80,7.37,76,367,2421,12.2,0.43456772
10764,10764,Hubie McDonough,1991-92,28.0,4,12,52,52,6,6,12,47.0,,132,27,22,49,155.0,80,6.91,71,366,2385,11.6,0.27993184
10765,10765,Hubie McDonough,1992-93,29.0,5,9,33,33,7,2,9,31.0,,165,34,24,58,186.0,80,6.96,77,402,2440,11.4,0.28261787
10766,10766,Hubie McDonough,1993-94,30.0,6,8,30,30,6,2,8,41.0,,195,40,26,66,227.0,84,7.25,87,443,2603,11.7,0.27307457
10767,10767,Hudson Fasching,2016-17,21.0,2,2,7,7,1,1,2,9.0,81.0,7,1,1,2,9.0,82,5.34,48,255,2438,9.0,0.26181984
10768,10768,Hudson Fasching,2017-18,22.0,3,1,10,10,0,1,1,6.0,104.0,17,1,2,3,15.0,82,5.45,47,245,2478,9.0,0.18025121
10769,10769,Hudson Fasching,2018-19,23.0,4,0,5,5,0,0,0,1.0,49.0,22,1,2,3,16.0,82,5.86,50,250,2620,9.2,0.15145817
10770,10770,Hugh Jessiman,2011-12,27.0,2,0,2,2,0,0,0,2.0,15.0,2,0,0,0,2.0,82,5.46,52,291,2492,9.0,0.15595362
10771,10771,Hunter Shinkaruk,2016-17,22.0,2,3,8,8,2,1,3,12.0,120.0,8,2,1,3,12.0,82,5.34,48,255,2438,9.0,0.2644227
10772,10772,Hunter Shinkaruk,2017-18,23.0,3,1,7,7,0,1,1,5.0,74.0,15,2,2,4,17.0,82,5.45,47,245,2478,9.0,0.19266215
10773,10773,Iain Duncan,1987-88,24.0,2,3,6,6,1,2,3,7.0,,6,1,2,3,7.0,80,7.34,72,344,2400,12.2,0.28879064
10774,10774,Iain Duncan,1988-89,25.0,3,42,62,62,19,23,42,104.0,,68,20,25,45,111.0,80,7.43,89,437,2435,12.2,0.61187845
10775,10775,Iain Duncan,1989-90,26.0,4,44,57,57,14,30,44,91.0,,125,34,55,89,202.0,80,7.48,85,403,2430,12.3,0.57281387
10776,10776,Iain Duncan,1991-92,28.0,5,0,2,2,0,0,0,2.0,,127,34,55,89,204.0,80,6.91,71,366,2385,11.6,0.3231257
10777,10777,Iain Fraser,1993-94,24.0,2,4,7,7,2,2,4,7.0,,7,2,2,4,7.0,84,7.25,87,443,2603,11.7,0.28437096
10778,10778,Iain Fraser,1994-95,25.0,3,37,60,60,17,20,37,109.0,,67,19,22,41,116.0,84,6.48,76,407,2545,10.7,0.5141547
10779,10779,Iain Fraser,1995-96,26.0,4,3,13,13,3,0,3,7.0,,80,22,22,44,123.0,48,5.97,37,209,1408,10.2,0.31010675
10780,10780,Iain Fraser,1996-97,27.0,5,2,12,12,1,1,2,12.0,,92,23,23,46,135.0,82,6.29,74,413,2481,10.4,0.22649711
10781,10781,Iain Fraser,1997-98,28.0,6,0,2,2,0,0,0,0.0,,94,23,23,46,135.0,82,5.83,55,336,2444,9.8,0.20133087
10782,10782,Ian Cole,2011-12,22.0,2,4,26,26,1,3,4,22.0,458.0,26,1,3,4,22.0,82,5.46,52,291,2492,9.0,0.19853294
10783,10783,Ian Cole,2012-13,23.0,3,6,26,26,1,5,6,18.0,414.0,52,2,8,10,40.0,82,5.32,47,271,2439,8.9,0.20167515
10784,10784,Ian Cole,2013-14,24.0,4,1,15,15,0,1,1,10.0,266.0,67,2,9,11,50.0,48,5.31,29,160,1399,9.1,0.18268085
10785,10785,Ian Cole,2014-15,25.0,5,11,46,46,3,8,11,45.0,694.0,113,5,17,22,95.0,82,5.34,48,269,2463,8.9,0.20491412
10786,10786,Ian Cole,2015-16,26.0,6,17,74,74,5,12,17,83.0,1183.0,187,10,29,39,178.0,82,5.32,47,251,2453,8.9,0.21736857
10787,10787,Ian Cole,2016-17,27.0,7,12,70,70,0,12,12,72.0,1207.0,257,10,41,51,250.0,82,5.34,48,255,2438,9.0,0.16624999
10788,10788,Ian Cole,2017-18,28.0,8,26,81,81,5,21,26,89.0,1605.0,338,15,62,77,339.0,82,5.45,47,245,2478,9.0,0.26800877
10789,10789,Ian Cole,2018-19,29.0,9,20,67,67,5,15,20,84.0,1191.0,405,20,77,97,423.0,82,5.86,50,250,2620,9.2,0.25719774
10790,10790,Ian Cole,2019-20,30.0,10,15,71,71,2,13,15,82.0,1403.0,476,22,90,112,505.0,82,5.96,47,239,2579,9.5,0.20266914
10791,10791,Ian Cole,2020-21,31.0,11,26,65,65,4,22,26,92.0,1150.0,541,26,112,138,597.0,70,5.96,42,208,2192,9.5,0.29115963
10792,10792,Ian Herbers,1994-95,27.0,2,2,22,22,0,2,2,16.0,,22,0,2,2,16.0,84,6.48,76,407,2545,10.7,0.14631116
10793,10793,Ian Herbers,2000-01,33.0,3,3,43,43,0,3,3,14.0,651.0,65,0,5,5,30.0,82,5.49,53,331,2294,9.8,0.073360234
10794,10794,Ian Kidd,1988-89,24.0,2,11,19,19,4,7,11,22.0,,19,4,7,11,22.0,80,7.43,89,437,2435,12.2,0.3890391
10795,10795,Ian Kidd,1989-90,25.0,3,0,1,1,0,0,0,0.0,,20,4,7,11,22.0,80,7.48,85,403,2430,12.3,0.18562102
10796,10796,Ian Laperriere,1994-95,21.0,2,0,1,1,0,0,0,1.0,,1,0,0,0,1.0,84,6.48,76,407,2545,10.7,0.20140201
10797,10797,Ian Laperriere,1995-96,22.0,3,27,37,37,13,14,27,53.0,,38,13,14,27,54.0,48,5.97,37,209,1408,10.2,0.54268175
10798,10798,Ian Laperriere,1996-97,23.0,4,17,71,71,6,11,17,70.0,,109,19,25,44,124.0,82,6.29,74,413,2481,10.4,0.29131803
10799,10799,Ian Laperriere,1997-98,24.0,5,23,62,62,8,15,23,84.0,,171,27,40,67,208.0,82,5.83,55,336,2444,9.8,0.33993557
10800,10800,Ian Laperriere,1998-99,25.0,6,21,77,77,6,15,21,74.0,,248,33,55,88,282.0,82,5.28,57,380,2242,9.6,0.2842164
10801,10801,Ian Laperriere,1999-00,26.0,7,13,72,72,3,10,13,62.0,848.0,320,36,65,101,344.0,82,5.27,57,359,2285,9.4,0.20383698
10802,10802,Ian Laperriere,2000-01,27.0,8,22,79,79,9,13,22,87.0,1047.0,399,45,78,123,431.0,82,5.49,53,331,2294,9.8,0.2755491
10803,10803,Ian Laperriere,2001-02,28.0,9,18,79,79,8,10,18,60.0,951.0,478,53,88,141,491.0,82,5.51,63,376,2272,9.9,0.25474924
10804,10804,Ian Laperriere,2002-03,29.0,10,22,81,81,8,14,22,89.0,1113.0,559,61,102,163,580.0,82,5.24,53,338,2262,9.5,0.27672958
10805,10805,Ian Laperriere,2003-04,30.0,11,19,73,73,7,12,19,85.0,1151.0,632,68,114,182,665.0,82,5.31,60,363,2326,9.4,0.28179353
10806,10806,Ian Laperriere,2004-05,31.0,12,22,62,62,10,12,22,59.0,982.0,694,78,126,204,724.0,82,5.14,57,348,2300,9.2,0.28302664
10807,10807,Ian Laperriere,2006-07,33.0,13,45,82,82,21,24,45,133.0,1407.0,776,99,150,249,857.0,82,6.05,85,480,2458,10.1,0.449192
10808,10808,Ian Laperriere,2007-08,34.0,14,29,81,81,8,21,29,118.0,1121.0,857,107,171,278,975.0,82,5.76,70,398,2426,9.7,0.27313322
10809,10809,Ian Laperriere,2008-09,35.0,15,19,70,70,4,15,19,68.0,956.0,927,111,186,297,1043.0,82,5.44,62,351,2383,9.4,0.21190563
10810,10810,Ian Laperriere,2009-10,36.0,16,19,74,74,7,12,19,61.0,1024.0,1001,118,198,316,1104.0,82,5.7,65,341,2477,9.4,0.20949
10811,10811,Ian Laperriere,2010-11,37.0,17,20,82,82,3,17,20,53.0,1025.0,1083,121,215,336,1157.0,82,5.53,56,304,2486,9.1,0.18786457
10812,10812,Ian MacNeil,2003-04,26.0,2,0,2,2,0,0,0,2.0,20.0,2,0,0,0,2.0,82,5.31,60,363,2326,9.4,0.18068418
10813,10813,Ian McCoshen,2017-18,22.0,2,1,3,3,0,1,1,0.0,40.0,3,0,1,1,0.0,82,5.45,47,245,2478,9.0,0.19644007
10814,10814,Ian McCoshen,2018-19,23.0,3,4,38,38,3,1,4,26.0,573.0,41,3,2,5,26.0,82,5.86,50,250,2620,9.2,0.1859751
10815,10815,Ian McCoshen,2019-20,24.0,4,2,19,19,1,1,2,15.0,253.0,60,4,3,7,41.0,82,5.96,47,239,2579,9.5,0.15781292
10816,10816,Ian Moran,1996-97,24.0,2,2,51,51,1,1,2,44.0,,51,1,1,2,44.0,82,6.29,74,413,2481,10.4,0.15480101
10817,10817,Ian Moran,1997-98,25.0,3,9,36,36,4,5,9,50.0,,87,5,6,11,94.0,82,5.83,55,336,2444,9.8,0.21785256
10818,10818,Ian Moran,1998-99,26.0,4,7,37,37,1,6,7,33.0,,124,6,12,18,127.0,82,5.28,57,380,2242,9.6,0.15954098
10819,10819,Ian Moran,1999-00,27.0,5,9,62,62,4,5,9,65.0,1027.0,186,10,17,27,192.0,82,5.27,57,359,2285,9.4,0.15967304
10820,10820,Ian Moran,2000-01,28.0,6,12,73,73,4,8,12,58.0,829.0,259,14,25,39,250.0,82,5.49,53,331,2294,9.8,0.1504843
10821,10821,Ian Moran,2001-02,29.0,7,7,40,40,3,4,7,73.0,708.0,299,17,29,46,323.0,82,5.51,63,376,2272,9.9,0.19453672
10822,10822,Ian Moran,2002-03,30.0,8,10,64,64,2,8,10,94.0,1280.0,363,19,37,56,417.0,82,5.24,53,338,2262,9.5,0.1854682
10823,10823,Ian Moran,2003-04,31.0,9,8,78,78,0,8,8,96.0,1435.0,441,19,45,64,513.0,82,5.31,60,363,2326,9.4,0.150269
10824,10824,Ian Moran,2004-05,32.0,10,5,35,35,1,4,5,54.0,656.0,476,20,49,69,567.0,82,5.14,57,348,2300,9.2,0.1976569
10825,10825,Ian Moran,2006-07,34.0,11,2,12,12,1,1,2,7.0,173.0,488,21,50,71,574.0,82,6.05,85,480,2458,10.1,0.13129523
10826,10826,Ian Moran,2007-08,35.0,12,0,1,1,0,0,0,0.0,6.0,489,21,50,71,574.0,82,5.76,70,398,2426,9.7,0.1884337
10827,10827,Ian White,2006-07,22.0,2,6,12,12,1,5,6,21.0,229.0,12,1,5,6,21.0,82,6.05,85,480,2458,10.1,0.27554387
10828,10828,Ian White,2007-08,23.0,3,26,76,76,3,23,26,138.0,1408.0,88,4,28,32,159.0,82,5.76,70,398,2426,9.7,0.3641904
10829,10829,Ian White,2008-09,24.0,4,21,81,81,5,16,21,116.0,1523.0,169,9,44,53,275.0,82,5.44,62,351,2383,9.4,0.2733225
10830,10830,Ian White,2009-10,25.0,5,26,71,71,10,16,26,158.0,1622.0,240,19,60,79,433.0,82,5.7,65,341,2477,9.4,0.38429683
10831,10831,Ian White,2010-11,26.0,6,38,83,83,13,25,38,173.0,1891.0,323,32,85,117,606.0,82,5.53,56,304,2486,9.1,0.5155439
10832,10832,Ian White,2011-12,27.0,7,26,78,78,4,22,26,138.0,1559.0,401,36,107,143,744.0,82,5.46,52,291,2492,9.0,0.32050472
10833,10833,Ian White,2012-13,28.0,8,32,77,77,7,25,32,196.0,1770.0,478,43,132,175,940.0,82,5.32,47,271,2439,8.9,0.429553
10834,10834,Ian White,2013-14,29.0,9,4,25,25,2,2,4,27.0,490.0,503,45,134,179,967.0,48,5.31,29,160,1399,9.1,0.27756768
10835,10835,Igor Chibirev,1994-95,26.0,2,15,37,37,4,11,15,30.0,,37,4,11,15,30.0,84,6.48,76,407,2545,10.7,0.27803618
10836,10836,Igor Chibirev,1995-96,27.0,3,4,8,8,3,1,4,9.0,,45,7,12,19,39.0,48,5.97,37,209,1408,10.2,0.27828026
10837,10837,Igor Korolev,1993-94,23.0,2,27,74,74,4,23,27,76.0,,74,4,23,27,76.0,84,7.25,87,443,2603,11.7,0.36432123
10838,10838,Igor Korolev,1994-95,24.0,3,16,73,73,6,10,16,93.0,,147,10,33,43,169.0,84,6.48,76,407,2545,10.7,0.28795934
10839,10839,Igor Korolev,1995-96,25.0,4,30,45,45,8,22,30,85.0,,192,18,55,73,254.0,48,5.97,37,209,1408,10.2,0.5317846
10840,10840,Igor Korolev,1996-97,26.0,5,51,73,73,22,29,51,165.0,,265,40,84,124,419.0,82,6.29,74,413,2481,10.4,0.5902769
10841,10841,Igor Korolev,1997-98,27.0,6,10,41,41,3,7,10,41.0,,306,43,91,134,460.0,82,5.83,55,336,2444,9.8,0.27665967
10842,10842,Igor Korolev,1998-99,28.0,7,39,78,78,17,22,39,97.0,,384,60,113,173,557.0,82,5.28,57,380,2242,9.6,0.4907451
10843,10843,Igor Korolev,1999-00,29.0,8,47,66,66,13,34,47,99.0,1195.0,450,73,147,220,656.0,82,5.27,57,359,2285,9.4,0.56364065
10844,10844,Igor Korolev,2000-01,30.0,9,46,80,80,20,26,46,101.0,1435.0,530,93,173,266,757.0,82,5.49,53,331,2294,9.8,0.4827889
10845,10845,Igor Korolev,2001-02,31.0,10,29,73,73,10,19,29,78.0,1145.0,603,103,192,295,835.0,82,5.51,63,376,2272,9.9,0.3187445
10846,10846,Igor Korolev,2002-03,32.0,11,29,82,82,9,20,29,78.0,1380.0,685,112,212,324,913.0,82,5.24,53,338,2262,9.5,0.32332337
10847,10847,Igor Korolev,2003-04,33.0,12,9,48,48,4,5,9,32.0,655.0,733,116,217,333,945.0,82,5.31,60,363,2326,9.4,0.16620833
10848,10848,Igor Korolev,2004-05,34.0,13,13,62,62,3,10,13,38.0,693.0,795,119,227,346,983.0,82,5.14,57,348,2300,9.2,0.22721782
10849,10849,Igor Kravchuk,1992-93,26.0,2,9,18,18,1,8,9,40.0,,18,1,8,9,40.0,80,6.96,77,402,2440,11.4,0.31850094
10850,10850,Igor Kravchuk,1993-94,27.0,3,27,55,55,10,17,27,143.0,,73,11,25,36,183.0,84,7.25,87,443,2603,11.7,0.45916513
10851,10851,Igor Kravchuk,1994-95,28.0,4,50,81,81,12,38,50,197.0,,154,23,63,86,380.0,84,6.48,76,407,2545,10.7,0.5196129
10852,10852,Igor Kravchuk,1995-96,29.0,5,18,36,36,7,11,18,93.0,,190,30,74,104,473.0,48,5.97,37,209,1408,10.2,0.48051593
10853,10853,Igor Kravchuk,1996-97,30.0,6,23,66,66,7,16,23,173.0,,256,37,90,127,646.0,82,6.29,74,413,2481,10.4,0.38928804
10854,10854,Igor Kravchuk,1997-98,31.0,7,28,82,82,4,24,28,142.0,,338,41,114,155,788.0,82,5.83,55,336,2444,9.8,0.3586353
10855,10855,Igor Kravchuk,1998-99,32.0,8,35,81,81,8,27,35,191.0,,419,49,141,190,979.0,82,5.28,57,380,2242,9.6,0.42838752
10856,10856,Igor Kravchuk,1999-00,33.0,9,25,79,79,4,21,25,171.0,1884.0,498,53,162,215,1150.0,82,5.27,57,359,2285,9.4,0.33340526
10857,10857,Igor Kravchuk,2000-01,34.0,10,18,64,64,6,12,18,126.0,1324.0,562,59,174,233,1276.0,82,5.49,53,331,2294,9.8,0.28894925
10858,10858,Igor Kravchuk,2001-02,35.0,11,14,52,52,1,13,14,67.0,1188.0,614,60,187,247,1343.0,82,5.51,63,376,2272,9.9,0.20139223
10859,10859,Igor Kravchuk,2002-03,36.0,12,26,78,78,4,22,26,135.0,1446.0,692,64,209,273,1478.0,82,5.24,53,338,2262,9.5,0.29841223
10860,10860,Igor Kravchuk,2003-04,37.0,13,1,7,7,0,1,1,8.0,131.0,699,64,210,274,1486.0,82,5.31,60,363,2326,9.4,0.17989981
10861,10861,Igor Larionov,1990-91,30.0,2,44,74,74,17,27,44,118.0,,74,17,27,44,118.0,80,7.37,76,367,2421,12.2,0.50497764
10862,10862,Igor Larionov,1991-92,31.0,3,34,64,64,13,21,34,66.0,,138,30,48,78,184.0,80,6.91,71,366,2385,11.6,0.4428402
10863,10863,Igor Larionov,1992-93,32.0,4,65,72,72,21,44,65,97.0,,210,51,92,143,281.0,80,6.96,77,402,2440,11.4,0.71125495
10864,10864,Igor Larionov,1994-95,34.0,5,56,60,60,18,38,56,72.0,,270,69,130,199,353.0,84,6.48,76,407,2545,10.7,0.68522125
10865,10865,Igor Larionov,1995-96,35.0,6,24,33,33,4,20,24,69.0,,303,73,150,223,422.0,48,5.97,37,209,1408,10.2,0.6570692
10866,10866,Igor Larionov,1996-97,36.0,7,73,73,73,22,51,73,113.0,,376,95,201,296,535.0,82,6.29,74,413,2481,10.4,0.70396894
10867,10867,Igor Larionov,1997-98,37.0,8,54,64,64,12,42,54,95.0,,440,107,243,350,630.0,82,5.83,55,336,2444,9.8,0.6512147
10868,10868,Igor Larionov,1998-99,38.0,9,47,69,69,8,39,47,93.0,,509,115,282,397,723.0,82,5.28,57,380,2242,9.6,0.59129727
10869,10869,Igor Larionov,1999-00,39.0,10,63,75,75,14,49,63,83.0,1300.0,584,129,331,460,806.0,82,5.27,57,359,2285,9.4,0.6686782
10870,10870,Igor Larionov,2000-01,40.0,11,47,79,79,9,38,47,69.0,1270.0,663,138,369,507,875.0,82,5.49,53,331,2294,9.8,0.5716172
10871,10871,Igor Larionov,2001-02,41.0,12,40,65,65,9,31,40,46.0,1078.0,728,147,400,547,921.0,82,5.51,63,376,2272,9.9,0.5049665
10872,10872,Igor Larionov,2002-03,42.0,13,43,70,70,11,32,43,50.0,1012.0,798,158,432,590,971.0,82,5.24,53,338,2262,9.5,0.5288693
10873,10873,Igor Larionov,2003-04,43.0,14,43,74,74,10,33,43,50.0,1030.0,872,168,465,633,1021.0,82,5.31,60,363,2326,9.4,0.43277383
10874,10874,Igor Larionov,2004-05,44.0,15,11,49,49,1,10,11,25.0,593.0,921,169,475,644,1046.0,82,5.14,57,348,2300,9.2,0.31771237
10875,10875,Igor Liba,1989-90,29.0,2,25,37,37,7,18,25,42.0,,37,7,18,25,42.0,80,7.48,85,403,2430,12.3,0.47207746
10876,10876,Igor Ozhiganov,2019-20,27.0,2,7,53,53,3,4,7,43.0,743.0,53,3,4,7,43.0,82,5.96,47,239,2579,9.5,0.16248462
10877,10877,Igor Radulov,2003-04,21.0,2,5,7,7,5,0,5,14.0,106.0,7,5,0,5,14.0,82,5.31,60,363,2326,9.4,0.35716802
10878,10878,Igor Radulov,2004-05,22.0,3,11,36,36,4,7,11,47.0,441.0,43,9,7,16,61.0,82,5.14,57,348,2300,9.2,0.29873437
10879,10879,Igor Ulanov,1992-93,23.0,2,11,27,27,2,9,11,23.0,,27,2,9,11,23.0,80,6.96,77,402,2440,11.4,0.33102843
10880,10880,Igor Ulanov,1993-94,24.0,3,16,56,56,2,14,16,26.0,,83,4,23,27,49.0,84,7.25,87,443,2603,11.7,0.24513718
10881,10881,Igor Ulanov,1994-95,25.0,4,17,74,74,0,17,17,46.0,,157,4,40,44,95.0,84,6.48,76,407,2545,10.7,0.19749364
10882,10882,Igor Ulanov,1995-96,26.0,5,5,22,22,1,4,5,13.0,,179,5,44,49,108.0,48,5.97,37,209,1408,10.2,0.20996556
10883,10883,Igor Ulanov,1996-97,27.0,6,12,64,64,3,9,12,37.0,,243,8,53,61,145.0,82,6.29,74,413,2481,10.4,0.16961908
10884,10884,Igor Ulanov,1997-98,28.0,7,8,59,59,1,7,8,56.0,,302,9,60,69,201.0,82,5.83,55,336,2444,9.8,0.14451197
10885,10885,Igor Ulanov,1998-99,29.0,8,10,49,49,2,8,10,36.0,,351,11,68,79,237.0,82,5.28,57,380,2242,9.6,0.19155362
10886,10886,Igor Ulanov,1999-00,30.0,9,12,76,76,3,9,12,55.0,1336.0,427,14,77,91,292.0,82,5.27,57,359,2285,9.4,0.16326758
10887,10887,Igor Ulanov,2000-01,31.0,10,9,57,57,1,8,9,39.0,941.0,484,15,85,100,331.0,82,5.49,53,331,2294,9.8,0.1506007
10888,10888,Igor Ulanov,2001-02,32.0,11,23,67,67,3,20,23,74.0,1542.0,551,18,105,123,405.0,82,5.51,63,376,2272,9.9,0.243626
10889,10889,Igor Ulanov,2002-03,33.0,12,10,53,53,0,10,10,26.0,928.0,604,18,115,133,431.0,82,5.24,53,338,2262,9.5,0.12653086
10890,10890,Igor Ulanov,2003-04,34.0,13,2,56,56,1,1,2,20.0,935.0,660,19,116,135,451.0,82,5.31,60,363,2326,9.4,0.10453147
10891,10891,Igor Ulanov,2004-05,35.0,14,18,42,42,5,13,18,49.0,833.0,702,24,129,153,500.0,82,5.14,57,348,2300,9.2,0.27792192
10892,10892,Igor Ulanov,2006-07,37.0,15,9,37,37,3,6,9,29.0,609.0,739,27,135,162,529.0,82,6.05,85,480,2458,10.1,0.15815559
10893,10893,Igor Vyazmikin,1991-92,26.0,2,1,4,4,1,0,1,5.0,,4,1,0,1,5.0,80,6.91,71,366,2385,11.6,0.23726931
10894,10894,Iiro Jarvi,1989-90,24.0,2,41,75,75,11,30,41,109.0,,75,11,30,41,109.0,80,7.48,85,403,2430,12.3,0.48104146
10895,10895,Iiro Jarvi,1990-91,25.0,3,20,41,41,7,13,20,52.0,,116,18,43,61,161.0,80,7.37,76,367,2421,12.2,0.4314345
10896,10896,Iiro Pakarinen,2015-16,24.0,2,3,17,17,1,2,3,34.0,172.0,17,1,2,3,34.0,82,5.32,47,251,2453,8.9,0.22635719
10897,10897,Iiro Pakarinen,2016-17,25.0,3,13,63,63,5,8,13,76.0,677.0,80,6,10,16,110.0,82,5.34,48,255,2438,9.0,0.22799632
10898,10898,Iiro Pakarinen,2017-18,26.0,4,4,14,14,2,2,4,15.0,125.0,94,8,12,20,125.0,82,5.45,47,245,2478,9.0,0.2375671
10899,10899,Iiro Pakarinen,2018-19,27.0,5,3,40,40,2,1,3,50.0,408.0,134,10,13,23,175.0,82,5.86,50,250,2620,9.2,0.16514698
10900,10900,Ilja Byakin,1994-95,31.0,2,28,44,44,8,20,28,51.0,,44,8,20,28,51.0,84,6.48,76,407,2545,10.7,0.43430465
10901,10901,Ilja Byakin,1995-96,32.0,3,5,13,13,0,5,5,19.0,,57,8,25,33,70.0,48,5.97,37,209,1408,10.2,0.24879414
10902,10902,Ilkka Heikkinen,2010-11,26.0,2,0,7,7,0,0,0,4.0,62.0,7,0,0,0,4.0,82,5.53,56,304,2486,9.1,0.16698298
10903,10903,Ilkka Pikkarainen,2010-11,29.0,2,4,31,31,1,3,4,26.0,252.0,31,1,3,4,26.0,82,5.53,56,304,2486,9.1,0.18818274
10904,10904,Ilkka Sinisalo,1982-83,24.0,2,37,66,66,15,22,37,87.0,,66,15,22,37,87.0,80,8.03,73,320,2489,12.9,0.51547396
10905,10905,Ilkka Sinisalo,1983-84,25.0,3,50,61,61,21,29,50,126.0,,127,36,51,87,213.0,80,7.73,71,310,2444,12.7,0.67125493
10906,10906,Ilkka Sinisalo,1984-85,26.0,4,46,73,73,29,17,46,164.0,,200,65,68,133,377.0,80,7.89,74,336,2448,12.9,0.6717065
10907,10907,Ilkka Sinisalo,1985-86,27.0,5,73,70,70,36,37,73,170.0,,270,101,105,206,547.0,80,7.77,71,321,2447,12.7,0.8627906
10908,10908,Ilkka Sinisalo,1986-87,28.0,6,76,74,74,39,37,76,184.0,,344,140,142,282,731.0,80,7.94,82,370,2484,12.8,0.7903105
10909,10909,Ilkka Sinisalo,1987-88,29.0,7,32,42,42,10,22,32,80.0,,386,150,164,314,811.0,80,7.34,72,344,2400,12.2,0.65340936
10910,10910,Ilkka Sinisalo,1988-89,30.0,8,42,68,68,25,17,42,148.0,,454,175,181,356,959.0,80,7.43,89,437,2435,12.2,0.62014705
10911,10911,Ilkka Sinisalo,1989-90,31.0,9,7,13,13,1,6,7,15.0,,467,176,187,363,974.0,80,7.48,85,403,2430,12.3,0.5239557
10912,10912,Ilkka Sinisalo,1990-91,32.0,10,46,59,59,23,23,46,102.0,,526,199,210,409,1076.0,80,7.37,76,367,2421,12.2,0.60333395
10913,10913,Ilkka Sinisalo,1991-92,33.0,11,17,53,53,5,12,17,72.0,,579,204,222,426,1148.0,80,6.91,71,366,2385,11.6,0.35596585
10914,10914,Ilkka Sinisalo,1992-93,34.0,12,1,3,3,0,1,1,3.0,,582,204,223,427,1151.0,80,6.96,77,402,2440,11.4,0.26084977
10915,10915,Ilya Kovalchuk,2002-03,19.0,2,51,65,65,29,22,51,184.0,1205.0,65,29,22,51,184.0,82,5.24,53,338,2262,9.5,0.84316367
10916,10916,Ilya Kovalchuk,2003-04,20.0,3,67,81,81,38,29,67,257.0,1575.0,146,67,51,118,441.0,82,5.31,60,363,2326,9.4,0.87888926
10917,10917,Ilya Kovalchuk,2004-05,21.0,4,87,81,81,41,46,87,341.0,1919.0,227,108,97,205,782.0,82,5.14,57,348,2300,9.2,1.1946098
10918,10918,Ilya Kovalchuk,2006-07,23.0,5,98,78,78,52,46,98,323.0,1746.0,305,160,143,303,1105.0,82,6.05,85,480,2458,10.1,1.0936861
10919,10919,Ilya Kovalchuk,2007-08,24.0,6,76,82,82,42,34,76,336.0,1765.0,387,202,177,379,1441.0,82,5.76,70,398,2426,9.7,0.9953872
10920,10920,Ilya Kovalchuk,2008-09,25.0,7,87,79,79,52,35,87,283.0,1699.0,466,254,212,466,1724.0,82,5.44,62,351,2383,9.4,1.0582694
10921,10921,Ilya Kovalchuk,2009-10,26.0,8,91,79,79,43,48,91,275.0,1723.0,545,297,260,557,1999.0,82,5.7,65,341,2477,9.4,1.0728157
10922,10922,Ilya Kovalchuk,2010-11,27.0,9,85,76,76,41,44,85,290.0,1675.0,621,338,304,642,2289.0,82,5.53,56,304,2486,9.1,1.0180922
10923,10923,Ilya Kovalchuk,2011-12,28.0,10,60,81,81,31,29,60,245.0,1828.0,702,369,333,702,2534.0,82,5.46,52,291,2492,9.0,0.7568622
10924,10924,Ilya Kovalchuk,2012-13,29.0,11,83,77,77,37,46,83,310.0,1882.0,779,406,379,785,2844.0,82,5.32,47,271,2439,8.9,0.9341533
10925,10925,Ilya Kovalchuk,2013-14,30.0,12,31,37,37,11,20,31,123.0,915.0,816,417,399,816,2967.0,48,5.31,29,160,1399,9.1,0.7862405
10926,10926,Ilya Kovalchuk,2019-20,36.0,13,34,64,64,16,18,34,141.0,1039.0,880,433,417,850,3108.0,82,5.96,47,239,2579,9.5,0.52242553
10927,10927,Ilya Kovalchuk,2020-21,37.0,14,26,46,46,10,16,26,115.0,780.0,926,443,433,876,3223.0,70,5.96,42,208,2192,9.5,0.55003583
10928,10928,Ilya Lyubushkin,2019-20,25.0,2,4,41,41,0,4,4,27.0,563.0,41,0,4,4,27.0,82,5.96,47,239,2579,9.5,0.12990704
10929,10929,Ilya Lyubushkin,2020-21,26.0,3,4,51,51,0,4,4,41.0,724.0,92,0,8,8,68.0,70,5.96,42,208,2192,9.5,0.1455926
10930,10930,Ilya Mikheyev,2020-21,26.0,2,23,39,39,8,15,23,98.0,607.0,39,8,15,23,98.0,70,5.96,42,208,2192,9.5,0.47040728
10931,10931,Ilya Zubov,2008-09,21.0,2,0,1,1,0,0,0,0.0,15.0,1,0,0,0,0.0,82,5.44,62,351,2383,9.4,0.20099464
10932,10932,Ilya Zubov,2009-10,22.0,3,2,10,10,0,2,2,11.0,103.0,11,0,2,2,11.0,82,5.7,65,341,2477,9.4,0.20188871
10933,10933,Isac Lundestrom,2019-20,20.0,2,2,15,15,0,2,2,13.0,195.0,15,0,2,2,13.0,82,5.96,47,239,2579,9.5,0.27163813
10934,10934,Isac Lundestrom,2020-21,21.0,3,4,15,15,0,4,4,10.0,209.0,30,0,6,6,23.0,70,5.96,42,208,2192,9.5,0.24507713
10935,10935,Ivan Baranka,2008-09,23.0,2,1,1,1,0,1,1,1.0,13.0,1,0,1,1,1.0,82,5.44,62,351,2383,9.4,0.20873314
10936,10936,Ivan Barbashev,2017-18,22.0,2,12,30,30,5,7,12,20.0,354.0,30,5,7,12,20.0,82,5.45,47,245,2478,9.0,0.30983788
10937,10937,Ivan Barbashev,2018-19,23.0,3,13,53,53,7,6,13,45.0,646.0,83,12,13,25,65.0,82,5.86,50,250,2620,9.2,0.2870826
10938,10938,Ivan Barbashev,2019-20,24.0,4,26,80,80,14,12,26,60.0,921.0,163,26,25,51,125.0,82,5.96,47,239,2579,9.5,0.33789852
10939,10939,Ivan Barbashev,2020-21,25.0,5,26,69,69,11,15,26,75.0,928.0,232,37,40,77,200.0,70,5.96,42,208,2192,9.5,0.39384976
10940,10940,Ivan Ciernik,1998-99,21.0,2,0,2,2,0,0,0,0.0,,2,0,0,0,0.0,82,5.28,57,380,2242,9.6,0.16920802
10941,10941,Ivan Ciernik,2001-02,24.0,3,2,4,4,2,0,2,7.0,31.0,6,2,0,2,7.0,82,5.51,63,376,2272,9.9,0.21545187
10942,10942,Ivan Ciernik,2002-03,25.0,4,4,29,29,1,3,4,23.0,236.0,35,3,3,6,30.0,82,5.24,53,338,2262,9.5,0.17836705
10943,10943,Ivan Ciernik,2003-04,26.0,5,18,47,47,8,10,18,61.0,555.0,82,11,13,24,91.0,82,5.31,60,363,2326,9.4,0.32641226
10944,10944,Ivan Ciernik,2004-05,27.0,6,2,7,7,1,1,2,8.0,67.0,89,12,14,26,99.0,82,5.14,57,348,2300,9.2,0.21563631
10945,10945,Ivan Droppa,1994-95,22.0,2,1,12,12,0,1,1,13.0,,12,0,1,1,13.0,84,6.48,76,407,2545,10.7,0.20388064
10946,10946,Ivan Droppa,1996-97,24.0,3,0,7,7,0,0,0,1.0,,19,0,1,1,14.0,82,6.29,74,413,2481,10.4,0.15343791
10947,10947,Ivan Hlinka,1982-83,33.0,2,60,72,72,23,37,60,152.0,,72,23,37,60,152.0,80,8.03,73,320,2489,12.9,0.7672807
10948,10948,Ivan Hlinka,1983-84,34.0,3,63,65,65,19,44,63,148.0,,137,42,81,123,300.0,80,7.73,71,310,2444,12.7,0.7719854
10949,10949,Ivan Huml,2002-03,21.0,2,1,1,1,0,1,1,2.0,16.0,1,0,1,1,2.0,82,5.24,53,338,2262,9.5,0.22397411
10950,10950,Ivan Huml,2003-04,22.0,3,17,41,41,6,11,17,75.0,523.0,42,6,12,18,77.0,82,5.31,60,363,2326,9.4,0.3844506
10951,10951,Ivan Huml,2004-05,23.0,4,0,7,7,0,0,0,11.0,65.0,49,6,12,18,88.0,82,5.14,57,348,2300,9.2,0.2558828
10952,10952,Ivan Majesky,2003-04,27.0,2,12,82,82,4,8,12,52.0,1713.0,82,4,8,12,52.0,82,5.31,60,363,2326,9.4,0.15487057
10953,10953,Ivan Majesky,2004-05,28.0,3,10,63,63,3,7,10,35.0,911.0,145,7,15,22,87.0,82,5.14,57,348,2300,9.2,0.16746506
10954,10954,Ivan Majesky,2006-07,30.0,4,9,57,57,1,8,9,35.0,987.0,202,8,23,31,122.0,82,6.05,85,480,2458,10.1,0.12795457
10955,10955,Ivan Novoseltsev,2000-01,22.0,2,3,14,14,2,1,3,8.0,147.0,14,2,1,3,8.0,82,5.49,53,331,2294,9.8,0.24832213
10956,10956,Ivan Novoseltsev,2001-02,23.0,3,9,38,38,3,6,9,34.0,408.0,52,5,7,12,42.0,82,5.51,63,376,2272,9.9,0.2406098
10957,10957,Ivan Novoseltsev,2002-03,24.0,4,29,70,70,13,16,29,109.0,1042.0,122,18,23,41,151.0,82,5.24,53,338,2262,9.5,0.4013058
10958,10958,Ivan Novoseltsev,2003-04,25.0,5,27,78,78,10,17,27,115.0,1172.0,200,28,40,68,266.0,82,5.31,60,363,2326,9.4,0.3396432
10959,10959,Ivan Novoseltsev,2004-05,26.0,6,7,34,34,3,4,7,48.0,376.0,234,31,44,75,314.0,82,5.14,57,348,2300,9.2,0.2821347
10960,10960,Ivan Provorov,2017-18,21.0,2,30,82,82,6,24,30,161.0,1802.0,82,6,24,30,161.0,82,5.45,47,245,2478,9.0,0.4614782
10961,10961,Ivan Provorov,2018-19,22.0,3,41,82,82,17,24,41,203.0,1981.0,164,23,48,71,364.0,82,5.86,50,250,2620,9.2,0.58147496
10962,10962,Ivan Provorov,2019-20,23.0,4,26,82,82,7,19,26,145.0,2059.0,246,30,67,97,509.0,82,5.96,47,239,2579,9.5,0.39833423
10963,10963,Ivan Provorov,2020-21,24.0,5,36,69,69,13,23,36,150.0,1714.0,315,43,90,133,659.0,70,5.96,42,208,2192,9.5,0.5582662
10964,10964,Ivan Vishnevskiy,2009-10,21.0,2,2,3,3,0,2,2,9.0,59.0,3,0,2,2,9.0,82,5.7,65,341,2477,9.4,0.27458212
10965,10965,Ivan Vishnevskiy,2010-11,22.0,3,0,2,2,0,0,0,4.0,33.0,5,0,2,2,13.0,82,5.53,56,304,2486,9.1,0.18241933
10966,10966,J.C. Beaudin,2020-21,23.0,2,1,22,22,0,1,1,18.0,190.0,22,0,1,1,18.0,70,5.96,42,208,2192,9.5,0.18267295
10967,10967,J.C. Lipon,2016-17,23.0,2,1,9,9,0,1,1,4.0,63.0,9,0,1,1,4.0,82,5.34,48,255,2438,9.0,0.19409063
10968,10968,J.F. Sauve,1981-82,22.0,2,14,20,20,5,9,14,26.0,,20,5,9,14,26.0,80,7.69,77,340,2441,12.6,0.52013373
10969,10969,J.F. Sauve,1982-83,23.0,3,55,69,69,19,36,55,121.0,,89,24,45,69,147.0,80,8.03,73,320,2489,12.9,0.6678878
10970,10970,J.F. Sauve,1983-84,24.0,4,4,9,9,0,4,4,14.0,,98,24,49,73,161.0,80,7.73,71,310,2444,12.7,0.41341466
10971,10971,J.F. Sauve,1984-85,25.0,5,27,39,39,10,17,27,43.0,,137,34,66,100,204.0,80,7.89,74,336,2448,12.9,0.5364137
10972,10972,J.F. Sauve,1985-86,26.0,6,42,64,64,13,29,42,87.0,,201,47,95,142,291.0,80,7.77,71,321,2447,12.7,0.59737116
10973,10973,J.F. Sauve,1986-87,27.0,7,56,75,75,16,40,56,100.0,,276,63,135,198,391.0,80,7.94,82,370,2484,12.8,0.627684
10974,10974,J.F. Sauve,1987-88,28.0,8,5,14,14,2,3,5,14.0,,290,65,138,203,405.0,80,7.34,72,344,2400,12.2,0.42444906
10975,10975,J.J. Daigneault,1985-86,20.0,2,27,67,67,4,23,27,93.0,,67,4,23,27,93.0,80,7.77,71,321,2447,12.7,0.4275393
10976,10976,J.J. Daigneault,1986-87,21.0,3,28,64,64,5,23,28,115.0,,131,9,46,55,208.0,80,7.94,82,370,2484,12.8,0.46871105
10977,10977,J.J. Daigneault,1987-88,22.0,4,22,77,77,6,16,22,82.0,,208,15,62,77,290.0,80,7.34,72,344,2400,12.2,0.32773814
10978,10978,J.J. Daigneault,1988-89,23.0,5,4,28,28,2,2,4,20.0,,236,17,64,81,310.0,80,7.43,89,437,2435,12.2,0.33417213
10979,10979,J.J. Daigneault,1990-91,25.0,6,12,36,36,2,10,12,40.0,,272,19,74,93,350.0,80,7.37,76,367,2421,12.2,0.28772175
10980,10980,J.J. Daigneault,1991-92,26.0,7,19,51,51,3,16,19,68.0,,323,22,90,112,418.0,80,6.91,71,366,2385,11.6,0.3469388
10981,10981,J.J. Daigneault,1992-93,27.0,8,18,79,79,4,14,18,108.0,,402,26,104,130,526.0,80,6.96,77,402,2440,11.4,0.28207165
10982,10982,J.J. Daigneault,1993-94,28.0,9,18,66,66,8,10,18,68.0,,468,34,114,148,594.0,84,7.25,87,443,2603,11.7,0.26658198
10983,10983,J.J. Daigneault,1994-95,29.0,10,14,68,68,2,12,14,61.0,,536,36,126,162,655.0,84,6.48,76,407,2545,10.7,0.18361378
10984,10984,J.J. Daigneault,1995-96,30.0,11,8,45,45,3,5,8,36.0,,581,39,131,170,691.0,48,5.97,37,209,1408,10.2,0.17847311
10985,10985,J.J. Daigneault,1996-97,31.0,12,11,57,57,4,7,11,61.0,,638,43,138,181,752.0,82,6.29,74,413,2481,10.4,0.18023866
10986,10986,J.J. Daigneault,1997-98,32.0,13,28,66,66,5,23,28,62.0,,704,48,161,209,814.0,82,5.83,55,336,2444,9.8,0.3178079
10987,10987,J.J. Daigneault,1998-99,33.0,14,23,71,71,2,21,23,92.0,,775,50,182,232,906.0,82,5.28,57,380,2242,9.6,0.25467747
10988,10988,J.J. Daigneault,1999-00,34.0,15,11,70,70,2,9,11,65.0,1357.0,845,52,191,243,971.0,82,5.27,57,359,2285,9.4,0.13022971
10989,10989,J.J. Daigneault,2000-01,35.0,16,7,53,53,1,6,7,44.0,753.0,898,53,197,250,1015.0,82,5.49,53,331,2294,9.8,0.12189424
10990,10990,J.J. Daigneault,2001-02,36.0,17,0,1,1,0,0,0,0.0,12.0,899,53,197,250,1015.0,82,5.51,63,376,2272,9.9,0.25745648
10991,10991,J.P. Dumont,1999-00,21.0,2,15,25,25,9,6,15,42.0,356.0,25,9,6,15,42.0,82,5.27,57,359,2285,9.4,0.43528765
10992,10992,J.P. Dumont,2000-01,22.0,3,18,47,47,10,8,18,86.0,606.0,72,19,14,33,128.0,82,5.49,53,331,2294,9.8,0.4146706
10993,10993,J.P. Dumont,2001-02,23.0,4,51,79,79,23,28,51,156.0,1186.0,151,42,42,84,284.0,82,5.51,63,376,2272,9.9,0.607577
10994,10994,J.P. Dumont,2002-03,24.0,5,44,76,76,23,21,44,154.0,1157.0,227,65,63,128,438.0,82,5.24,53,338,2262,9.5,0.57998
10995,10995,J.P. Dumont,2003-04,25.0,6,35,76,76,14,21,35,135.0,1145.0,303,79,84,163,573.0,82,5.31,60,363,2326,9.4,0.50293994
10996,10996,J.P. Dumont,2004-05,26.0,7,53,77,77,22,31,53,156.0,1310.0,380,101,115,216,729.0,82,5.14,57,348,2300,9.2,0.7572472
10997,10997,J.P. Dumont,2006-07,28.0,8,40,54,54,20,20,40,116.0,864.0,434,121,135,256,845.0,82,6.05,85,480,2458,10.1,0.6509054
10998,10998,J.P. Dumont,2007-08,29.0,9,66,82,82,21,45,66,143.0,1328.0,516,142,180,322,988.0,82,5.76,70,398,2426,9.7,0.749391
10999,10999,J.P. Dumont,2008-09,30.0,10,72,80,80,29,43,72,192.0,1480.0,596,171,223,394,1180.0,82,5.44,62,351,2383,9.4,0.79720545
11000,11000,J.P. Dumont,2009-10,31.0,11,65,82,82,16,49,65,176.0,1435.0,678,187,272,459,1356.0,82,5.7,65,341,2477,9.4,0.718709
11001,11001,J.P. Dumont,2010-11,32.0,12,45,74,74,17,28,45,112.0,1093.0,752,204,300,504,1468.0,82,5.53,56,304,2486,9.1,0.5132642
11002,11002,J.P. Dumont,2011-12,33.0,13,19,70,70,10,9,19,89.0,783.0,822,214,309,523,1557.0,82,5.46,52,291,2492,9.0,0.32539535
11003,11003,J.P. Vigier,2001-02,25.0,2,0,2,2,0,0,0,1.0,20.0,2,0,0,0,1.0,82,5.51,63,376,2272,9.9,0.16294545
11004,11004,J.P. Vigier,2002-03,26.0,3,5,15,15,4,1,5,18.0,198.0,17,4,1,5,19.0,82,5.24,53,338,2262,9.5,0.22832593
11005,11005,J.P. Vigier,2003-04,27.0,4,0,13,13,0,0,0,21.0,184.0,30,4,1,5,40.0,82,5.31,60,363,2326,9.4,0.20265391
11006,11006,J.P. Vigier,2004-05,28.0,5,18,70,70,10,8,18,110.0,1022.0,100,14,9,23,150.0,82,5.14,57,348,2300,9.2,0.30244857
11007,11007,J.P. Vigier,2006-07,30.0,6,10,41,41,4,6,10,53.0,589.0,141,18,15,33,203.0,82,6.05,85,480,2458,10.1,0.20556456
11008,11008,J.P. Vigier,2007-08,31.0,7,13,72,72,5,8,13,83.0,792.0,213,23,23,46,286.0,82,5.76,70,398,2426,9.7,0.19011647
11009,11009,J.T. Brown,2012-13,22.0,2,1,5,5,0,1,1,13.0,69.0,5,0,1,1,13.0,82,5.32,47,271,2439,8.9,0.21251541
11010,11010,J.T. Brown,2014-15,24.0,3,19,63,63,4,15,19,113.0,821.0,68,4,16,20,126.0,82,5.34,48,269,2463,8.9,0.29313385
11011,11011,J.T. Brown,2015-16,25.0,4,9,52,52,3,6,9,74.0,552.0,120,7,22,29,200.0,82,5.32,47,251,2453,8.9,0.21803492
11012,11012,J.T. Brown,2016-17,26.0,5,22,78,78,8,14,22,140.0,1042.0,198,15,36,51,340.0,82,5.34,48,255,2438,9.0,0.2817067
11013,11013,J.T. Brown,2017-18,27.0,6,6,64,64,3,3,6,67.0,664.0,262,18,39,57,407.0,82,5.45,47,245,2478,9.0,0.17398492
11014,11014,J.T. Brown,2018-19,28.0,7,7,47,47,2,5,7,40.0,426.0,309,20,44,64,447.0,82,5.86,50,250,2620,9.2,0.15779641
11015,11015,J.T. Brown,2019-20,29.0,8,8,56,56,3,5,8,56.0,514.0,365,23,49,72,503.0,82,5.96,47,239,2579,9.5,0.15997034
11016,11016,J.T. Compher,2017-18,22.0,2,5,21,21,3,2,5,30.0,314.0,21,3,2,5,30.0,82,5.45,47,245,2478,9.0,0.28135914
11017,11017,J.T. Compher,2018-19,23.0,3,23,69,69,13,10,23,131.0,1104.0,90,16,12,28,161.0,82,5.86,50,250,2620,9.2,0.38628584
11018,11018,J.T. Compher,2019-20,24.0,4,32,66,66,16,16,32,118.0,1153.0,156,32,28,60,279.0,82,5.96,47,239,2579,9.5,0.4324115
11019,11019,J.T. Compher,2020-21,25.0,5,31,67,67,11,20,31,106.0,1122.0,223,43,48,91,385.0,70,5.96,42,208,2192,9.5,0.47130477
11020,11020,J.T. Miller,2013-14,20.0,2,4,26,26,2,2,4,43.0,352.0,26,2,2,4,43.0,48,5.31,29,160,1399,9.1,0.32557392
11021,11021,J.T. Miller,2014-15,21.0,3,6,30,30,3,3,6,46.0,344.0,56,5,5,10,89.0,82,5.34,48,269,2463,8.9,0.30574125
11022,11022,J.T. Miller,2015-16,22.0,4,23,58,58,10,13,23,92.0,737.0,114,15,18,33,181.0,82,5.32,47,251,2453,8.9,0.37772956
11023,11023,J.T. Miller,2016-17,23.0,5,43,82,82,22,21,43,135.0,1233.0,196,37,39,76,316.0,82,5.34,48,255,2438,9.0,0.53170794
11024,11024,J.T. Miller,2017-18,24.0,6,56,82,82,22,34,56,132.0,1342.0,278,59,73,132,448.0,82,5.45,47,245,2478,9.0,0.65420496
11025,11025,J.T. Miller,2018-19,25.0,7,58,82,82,23,35,58,143.0,1396.0,360,82,108,190,591.0,82,5.86,50,250,2620,9.2,0.6493513
11026,11026,J.T. Miller,2019-20,26.0,8,47,75,75,13,34,47,108.0,1100.0,435,95,142,237,699.0,82,5.96,47,239,2579,9.5,0.6058451
11027,11027,J.T. Miller,2020-21,27.0,9,72,69,69,27,45,72,165.0,1387.0,504,122,187,309,864.0,70,5.96,42,208,2192,9.5,0.8376549
11028,11028,J.T. Wyman,2010-11,24.0,2,0,3,3,0,0,0,0.0,13.0,3,0,0,0,0.0,82,5.53,56,304,2486,9.1,0.14912054
11029,11029,J.T. Wyman,2012-13,26.0,3,11,40,40,2,9,11,31.0,422.0,43,2,9,11,31.0,82,5.32,47,271,2439,8.9,0.18478262
11030,11030,J.T. Wyman,2013-14,27.0,4,0,1,1,0,0,0,0.0,14.0,44,2,9,11,31.0,48,5.31,29,160,1399,9.1,0.15510374
11031,11031,Jaccob Slavin,2016-17,22.0,2,20,63,63,2,18,20,84.0,1322.0,63,2,18,20,84.0,82,5.34,48,255,2438,9.0,0.32712635
11032,11032,Jaccob Slavin,2017-18,23.0,3,34,82,82,5,29,34,99.0,1922.0,145,7,47,54,183.0,82,5.45,47,245,2478,9.0,0.41124973
11033,11033,Jaccob Slavin,2018-19,24.0,4,30,82,82,8,22,30,154.0,1852.0,227,15,69,84,337.0,82,5.86,50,250,2620,9.2,0.40906584
11034,11034,Jaccob Slavin,2019-20,25.0,5,31,82,82,8,23,31,146.0,1889.0,309,23,92,115,483.0,82,5.96,47,239,2579,9.5,0.45736298
11035,11035,Jaccob Slavin,2020-21,26.0,6,36,68,68,6,30,36,145.0,1592.0,377,29,122,151,628.0,70,5.96,42,208,2192,9.5,0.51850253
11036,11036,Jack Capuano,1990-91,24.0,2,0,1,1,0,0,0,1.0,,1,0,0,0,1.0,80,7.37,76,367,2421,12.2,0.22265816
11037,11037,Jack Capuano,1991-92,25.0,3,0,3,3,0,0,0,4.0,,4,0,0,0,5.0,80,6.91,71,366,2385,11.6,0.18588361
11038,11038,Jack Capuano,1992-93,26.0,4,0,2,2,0,0,0,1.0,,6,0,0,0,6.0,80,6.96,77,402,2440,11.4,0.19043165
11039,11039,Jack Eichel,2016-17,20.0,2,56,81,81,24,32,56,238.0,1549.0,81,24,32,56,238.0,82,5.34,48,255,2438,9.0,0.7613286
11040,11040,Jack Eichel,2017-18,21.0,3,57,61,61,24,33,57,249.0,1215.0,142,48,65,113,487.0,82,5.45,47,245,2478,9.0,0.9138444
11041,11041,Jack Eichel,2018-19,22.0,4,64,67,67,25,39,64,246.0,1350.0,209,73,104,177,733.0,82,5.86,50,250,2620,9.2,0.9742209
11042,11042,Jack Eichel,2019-20,23.0,5,82,77,77,28,54,82,303.0,1574.0,286,101,158,259,1036.0,82,5.96,47,239,2579,9.5,1.0138575
11043,11043,Jack Eichel,2020-21,24.0,6,78,68,68,36,42,78,227.0,1503.0,354,137,200,337,1263.0,70,5.96,42,208,2192,9.5,1.0889447
11044,11044,Jack Hillen,2008-09,23.0,2,1,2,2,0,1,1,3.0,31.0,2,0,1,1,3.0,82,5.44,62,351,2383,9.4,0.20873314
11045,11045,Jack Hillen,2009-10,24.0,3,6,40,40,1,5,6,47.0,608.0,42,1,6,7,50.0,82,5.7,65,341,2477,9.4,0.19569087
11046,11046,Jack Hillen,2010-11,25.0,4,21,69,69,3,18,21,78.0,1428.0,111,4,24,28,128.0,82,5.53,56,304,2486,9.1,0.2662311
11047,11047,Jack Hillen,2011-12,26.0,5,22,64,64,4,18,22,81.0,1204.0,175,8,42,50,209.0,82,5.46,52,291,2492,9.0,0.25418532
11048,11048,Jack Hillen,2012-13,27.0,6,6,55,55,2,4,6,51.0,773.0,230,10,46,56,260.0,82,5.32,47,271,2439,8.9,0.16000772
11049,11049,Jack Hillen,2013-14,28.0,7,9,23,23,3,6,9,28.0,405.0,253,13,52,65,288.0,48,5.31,29,160,1399,9.1,0.3111031
11050,11050,Jack Hillen,2014-15,29.0,8,1,13,13,0,1,1,12.0,238.0,266,13,53,66,300.0,82,5.34,48,269,2463,8.9,0.18130139
11051,11051,Jack Hillen,2015-16,30.0,9,5,38,38,0,5,5,24.0,489.0,304,13,58,71,324.0,82,5.32,47,251,2453,8.9,0.115398616
11052,11052,Jack Hughes,1981-82,24.0,2,7,38,38,2,5,7,20.0,,38,2,5,7,20.0,80,7.69,77,340,2441,12.6,0.20249572
11053,11053,Jack Hughes,1982-83,25.0,3,0,8,8,0,0,0,1.0,,46,2,5,7,21.0,80,8.03,73,320,2489,12.9,0.18138096
11054,11054,Jack Hughes0,2020-21,19.0,2,21,61,61,7,14,21,123.0,968.0,61,7,14,21,123.0,70,5.96,42,208,2192,9.5,0.41838777
11055,11055,Jack Johnson,2007-08,21.0,2,0,5,5,0,0,0,5.0,107.0,5,0,0,0,5.0,82,5.76,70,398,2426,9.7,0.21502173
11056,11056,Jack Johnson,2008-09,22.0,3,11,74,74,3,8,11,81.0,1605.0,79,3,8,11,86.0,82,5.44,62,351,2383,9.4,0.22529122
11057,11057,Jack Johnson,2009-10,23.0,4,11,41,41,6,5,11,50.0,831.0,120,9,13,22,136.0,82,5.7,65,341,2477,9.4,0.29892558
11058,11058,Jack Johnson,2010-11,24.0,5,36,80,80,8,28,36,130.0,1809.0,200,17,41,58,266.0,82,5.53,56,304,2486,9.1,0.41419005
11059,11059,Jack Johnson,2011-12,25.0,6,42,82,82,5,37,42,153.0,1902.0,282,22,78,100,419.0,82,5.46,52,291,2492,9.0,0.49952585
11060,11060,Jack Johnson,2012-13,26.0,7,38,82,82,12,26,38,176.0,1949.0,364,34,104,138,595.0,82,5.32,47,271,2439,8.9,0.51448655
11061,11061,Jack Johnson,2013-14,27.0,8,19,44,44,5,14,19,96.0,1143.0,408,39,118,157,691.0,48,5.31,29,160,1399,9.1,0.426004
11062,11062,Jack Johnson,2014-15,28.0,9,33,82,82,5,28,33,147.0,2024.0,490,44,146,190,838.0,82,5.34,48,269,2463,8.9,0.41167763
11063,11063,Jack Johnson,2015-16,29.0,10,40,79,79,8,32,40,141.0,1909.0,569,52,178,230,979.0,82,5.32,47,251,2453,8.9,0.4282689
11064,11064,Jack Johnson,2016-17,30.0,11,14,60,60,6,8,14,86.0,1451.0,629,58,186,244,1065.0,82,5.34,48,255,2438,9.0,0.25376222
11065,11065,Jack Johnson,2017-18,31.0,12,23,82,82,5,18,23,116.0,1789.0,711,63,204,267,1181.0,82,5.45,47,245,2478,9.0,0.26140875
11066,11066,Jack Johnson,2018-19,32.0,13,11,77,77,3,8,11,88.0,1505.0,788,66,212,278,1269.0,82,5.86,50,250,2620,9.2,0.19941333
11067,11067,Jack Johnson,2019-20,33.0,14,13,82,82,1,12,13,86.0,1581.0,870,67,224,291,1355.0,82,5.96,47,239,2579,9.5,0.19032803
11068,11068,Jack Johnson,2020-21,34.0,15,11,67,67,3,8,11,63.0,1304.0,937,70,232,302,1418.0,70,5.96,42,208,2192,9.5,0.1726217
11069,11069,Jack O'Callahan,1983-84,26.0,2,11,39,39,0,11,11,45.0,,39,0,11,11,45.0,80,7.73,71,310,2444,12.7,0.23482546
11070,11070,Jack O'Callahan,1984-85,27.0,3,17,70,70,4,13,17,89.0,,109,4,24,28,134.0,80,7.89,74,336,2448,12.9,0.27941322
11071,11071,Jack O'Callahan,1985-86,28.0,4,14,66,66,6,8,14,69.0,,175,10,32,42,203.0,80,7.77,71,321,2447,12.7,0.24486688
11072,11072,Jack O'Callahan,1986-87,29.0,5,23,80,80,4,19,23,86.0,,255,14,51,65,289.0,80,7.94,82,370,2484,12.8,0.24228472
11073,11073,Jack O'Callahan,1987-88,30.0,6,14,48,48,1,13,14,66.0,,303,15,64,79,355.0,80,7.34,72,344,2400,12.2,0.23473504
11074,11074,Jack O'Callahan,1988-89,31.0,7,26,50,50,7,19,26,90.0,,353,22,83,105,445.0,80,7.43,89,437,2435,12.2,0.44230172
11075,11075,Jack O'Callahan,1989-90,32.0,8,26,36,36,5,21,26,96.0,,389,27,104,131,541.0,80,7.48,85,403,2430,12.3,0.5353712
11076,11076,Jack Rodewald,2018-19,24.0,2,0,4,4,0,0,0,0.0,29.0,4,0,0,0,0.0,82,5.86,50,250,2620,9.2,0.14225703
11077,11077,Jack Rodewald,2019-20,25.0,3,0,6,6,0,0,0,2.0,42.0,10,0,0,0,2.0,82,5.96,47,239,2579,9.5,0.16930458
11078,11078,Jack Roslovic,2017-18,21.0,2,0,1,1,0,0,0,1.0,8.0,1,0,0,0,1.0,82,5.45,47,245,2478,9.0,0.23246074
11079,11079,Jack Roslovic,2018-19,22.0,3,14,31,31,5,9,14,38.0,382.0,32,5,9,14,39.0,82,5.86,50,250,2620,9.2,0.32665455
11080,11080,Jack Roslovic,2019-20,23.0,4,24,77,77,9,15,24,74.0,750.0,109,14,24,38,113.0,82,5.96,47,239,2579,9.5,0.34192002
11081,11081,Jack Roslovic,2020-21,24.0,5,29,71,71,12,17,29,117.0,1058.0,180,26,41,67,230.0,70,5.96,42,208,2192,9.5,0.4268525
11082,11082,Jack Skille,2008-09,21.0,2,5,16,16,3,2,5,23.0,192.0,16,3,2,5,23.0,82,5.44,62,351,2383,9.4,0.3451624
11083,11083,Jack Skille,2009-10,22.0,3,1,8,8,1,0,1,14.0,76.0,24,4,2,6,37.0,82,5.7,65,341,2477,9.4,0.2664851
11084,11084,Jack Skille,2010-11,23.0,4,2,6,6,1,1,2,9.0,46.0,30,5,3,8,46.0,82,5.53,56,304,2486,9.1,0.25098598
11085,11085,Jack Skille,2011-12,24.0,5,19,62,62,8,11,19,154.0,739.0,92,13,14,27,200.0,82,5.46,52,291,2492,9.0,0.33078343
11086,11086,Jack Skille,2012-13,25.0,6,10,46,46,4,6,10,76.0,550.0,138,17,20,37,276.0,82,5.32,47,271,2439,8.9,0.2274673
11087,11087,Jack Skille,2013-14,26.0,7,12,40,40,3,9,12,69.0,533.0,178,20,29,49,345.0,48,5.31,29,160,1399,9.1,0.26784852
11088,11088,Jack Skille,2014-15,27.0,8,4,16,16,4,0,4,23.0,139.0,194,24,29,53,368.0,82,5.34,48,269,2463,8.9,0.23476788
11089,11089,Jack Skille,2015-16,28.0,9,8,45,45,6,2,8,95.0,564.0,239,30,31,61,463.0,82,5.32,47,251,2453,8.9,0.220388
11090,11090,Jack Skille,2016-17,29.0,10,14,74,74,8,6,14,106.0,654.0,313,38,37,75,569.0,82,5.34,48,255,2438,9.0,0.20028588
11091,11091,Jack Skille,2017-18,30.0,11,9,55,55,5,4,9,73.0,484.0,368,43,41,84,642.0,82,5.45,47,245,2478,9.0,0.18221477
11092,11092,Jack Studnicka,2020-21,21.0,2,1,2,2,0,1,1,3.0,24.0,2,0,1,1,3.0,70,5.96,42,208,2192,9.5,0.25606358
11093,11093,Jacob Josefson,2011-12,20.0,2,10,28,28,3,7,10,31.0,371.0,28,3,7,10,31.0,82,5.46,52,291,2492,9.0,0.31680495
11094,11094,Jacob Josefson,2012-13,21.0,3,9,41,41,2,7,9,37.0,496.0,69,5,14,19,68.0,82,5.32,47,271,2439,8.9,0.2568576
11095,11095,Jacob Josefson,2013-14,22.0,4,3,22,22,1,2,3,20.0,286.0,91,6,16,22,88.0,48,5.31,29,160,1399,9.1,0.27104935
11096,11096,Jacob Josefson,2014-15,23.0,5,3,27,27,1,2,3,21.0,274.0,118,7,18,25,109.0,82,5.34,48,269,2463,8.9,0.24179271
11097,11097,Jacob Josefson,2015-16,24.0,6,11,62,62,6,5,11,61.0,771.0,180,13,23,36,170.0,82,5.32,47,251,2453,8.9,0.18899512
11098,11098,Jacob Josefson,2016-17,25.0,7,14,58,58,4,10,14,86.0,900.0,238,17,33,50,256.0,82,5.34,48,255,2438,9.0,0.22376761
11099,11099,Jacob Josefson,2017-18,26.0,8,10,38,38,1,9,10,44.0,465.0,276,18,42,60,300.0,82,5.45,47,245,2478,9.0,0.1983904
11100,11100,Jacob Josefson,2018-19,27.0,9,4,39,39,2,2,4,35.0,444.0,315,20,44,64,335.0,82,5.86,50,250,2620,9.2,0.16635272
11101,11101,Jacob Larsson,2017-18,20.0,2,0,4,4,0,0,0,2.0,66.0,4,0,0,0,2.0,82,5.45,47,245,2478,9.0,0.28519332
11102,11102,Jacob Larsson,2019-20,22.0,3,5,49,49,0,5,5,57.0,839.0,53,0,5,5,59.0,82,5.96,47,239,2579,9.5,0.16085932
11103,11103,Jacob Larsson,2020-21,23.0,4,11,60,60,2,9,11,58.0,969.0,113,2,14,16,117.0,70,5.96,42,208,2192,9.5,0.24373698
11104,11104,Jacob MacDonald,2019-20,26.0,2,1,2,2,1,0,1,1.0,24.0,2,1,0,1,1.0,82,5.96,47,239,2579,9.5,0.23629463
11105,11105,Jacob Middleton,2019-20,24.0,2,1,3,3,0,1,1,0.0,30.0,3,0,1,1,0.0,82,5.96,47,239,2579,9.5,0.1796383
11106,11106,Jacob Middleton,2020-21,25.0,3,2,10,10,0,2,2,9.0,108.0,13,0,3,3,9.0,70,5.96,42,208,2192,9.5,0.2065709
11107,11107,Jacob Nilsson,2019-20,26.0,2,0,2,2,0,0,0,0.0,16.0,2,0,0,0,0.0,82,5.96,47,239,2579,9.5,0.15628517
11108,11108,Jacob Trouba,2014-15,20.0,2,29,65,65,10,19,29,121.0,1458.0,65,10,19,29,121.0,82,5.34,48,269,2463,8.9,0.4256837
11109,11109,Jacob Trouba,2015-16,21.0,3,22,65,65,7,15,22,133.0,1516.0,130,17,34,51,254.0,82,5.32,47,251,2453,8.9,0.38873732
11110,11110,Jacob Trouba,2016-17,22.0,4,21,81,81,6,15,21,133.0,1787.0,211,23,49,72,387.0,82,5.34,48,255,2438,9.0,0.3786694
11111,11111,Jacob Trouba,2017-18,23.0,5,33,60,60,8,25,33,154.0,1498.0,271,31,74,105,541.0,82,5.45,47,245,2478,9.0,0.5571552
11112,11112,Jacob Trouba,2018-19,24.0,6,24,55,55,3,21,24,144.0,1204.0,326,34,95,129,685.0,82,5.86,50,250,2620,9.2,0.45317376
11113,11113,Jacob Trouba,2019-20,25.0,7,50,82,82,8,42,50,162.0,1876.0,408,42,137,179,847.0,82,5.96,47,239,2579,9.5,0.58985686
11114,11114,Jacob Trouba,2020-21,26.0,8,27,70,70,7,20,27,168.0,1580.0,478,49,157,206,1015.0,70,5.96,42,208,2192,9.5,0.4502707
11115,11115,Jacob de La Rose,2015-16,20.0,2,6,33,33,4,2,6,38.0,455.0,33,4,2,6,38.0,82,5.32,47,251,2453,8.9,0.30294874
11116,11116,Jacob de La Rose,2016-17,21.0,3,1,22,22,0,1,1,20.0,274.0,55,4,3,7,58.0,82,5.34,48,255,2438,9.0,0.24521527
11117,11117,Jacob de La Rose,2017-18,22.0,4,0,9,9,0,0,0,4.0,98.0,64,4,3,7,62.0,82,5.45,47,245,2478,9.0,0.18830389
11118,11118,Jacob de La Rose,2018-19,23.0,5,12,55,55,4,8,12,53.0,652.0,119,8,11,19,115.0,82,5.86,50,250,2620,9.2,0.22242773
11119,11119,Jacob de La Rose,2019-20,24.0,6,9,60,60,3,6,9,55.0,686.0,179,11,17,28,170.0,82,5.96,47,239,2579,9.5,0.1649772
11120,11120,Jacob de La Rose,2020-21,25.0,7,9,50,50,2,7,9,46.0,536.0,229,13,24,37,216.0,70,5.96,42,208,2192,9.5,0.18657184
11121,11121,Jacques Mailhot,1989-90,28.0,2,0,5,5,0,0,0,0.0,,5,0,0,0,0.0,80,7.48,85,403,2430,12.3,0.14266536
11122,11122,Jaden Schwartz,2012-13,20.0,2,3,7,7,2,1,3,6.0,82.0,7,2,1,3,6.0,82,5.32,47,271,2439,8.9,0.28465253
11123,11123,Jaden Schwartz,2013-14,21.0,3,13,45,45,7,6,13,50.0,561.0,52,9,7,16,56.0,48,5.31,29,160,1399,9.1,0.3532982
11124,11124,Jaden Schwartz,2014-15,22.0,4,56,80,80,25,31,56,188.0,1402.0,132,34,38,72,244.0,82,5.34,48,269,2463,8.9,0.7092847
11125,11125,Jaden Schwartz,2015-16,23.0,5,63,75,75,28,35,63,184.0,1368.0,207,62,73,135,428.0,82,5.32,47,251,2453,8.9,0.7746241
11126,11126,Jaden Schwartz,2016-17,24.0,6,22,33,33,8,14,22,63.0,568.0,240,70,87,157,491.0,82,5.34,48,255,2438,9.0,0.57065153
11127,11127,Jaden Schwartz,2017-18,25.0,7,55,78,78,19,36,55,179.0,1475.0,318,89,123,212,670.0,82,5.45,47,245,2478,9.0,0.7053403
11128,11128,Jaden Schwartz,2018-19,26.0,8,59,62,62,24,35,59,157.0,1202.0,380,113,158,271,827.0,82,5.86,50,250,2620,9.2,0.7901232
11129,11129,Jaden Schwartz,2019-20,27.0,9,36,69,69,11,25,36,183.0,1251.0,449,124,183,307,1010.0,82,5.96,47,239,2579,9.5,0.5536383
11130,11130,Jaden Schwartz,2020-21,28.0,10,57,71,71,22,35,57,162.0,1291.0,520,146,218,364,1172.0,70,5.96,42,208,2192,9.5,0.76651
11131,11131,Jaime Sifers,2009-10,27.0,2,2,23,23,0,2,2,25.0,295.0,23,0,2,2,25.0,82,5.7,65,341,2477,9.4,0.1873999
11132,11132,Jaime Sifers,2010-11,28.0,3,0,14,14,0,0,0,9.0,182.0,37,0,2,2,34.0,82,5.53,56,304,2486,9.1,0.14320737
11133,11133,Jake Bean,2019-20,21.0,2,0,2,2,0,0,0,1.0,17.0,2,0,0,0,1.0,82,5.96,47,239,2579,9.5,0.2324872
11134,11134,Jake Bischoff,2020-21,26.0,2,0,4,4,0,0,0,6.0,62.0,4,0,0,0,6.0,70,5.96,42,208,2192,9.5,0.18286341
11135,11135,Jake Chelios,2019-20,28.0,2,0,5,5,0,0,0,5.0,86.0,5,0,0,0,5.0,82,5.96,47,239,2579,9.5,0.1832191
11136,11136,Jake Debrusk,2018-19,22.0,2,43,70,70,16,27,43,143.0,1006.0,70,16,27,43,143.0,82,5.86,50,250,2620,9.2,0.6170833
11137,11137,Jake Debrusk,2019-20,23.0,3,42,68,68,27,15,42,156.0,1099.0,138,43,42,85,299.0,82,5.96,47,239,2579,9.5,0.6597362
11138,11138,Jake Debrusk,2020-21,24.0,4,35,65,65,19,16,35,161.0,1043.0,203,62,58,120,460.0,70,5.96,42,208,2192,9.5,0.5582451
11139,11139,Jake Dotchin,2017-18,23.0,2,11,35,35,0,11,11,50.0,645.0,35,0,11,11,50.0,82,5.45,47,245,2478,9.0,0.22637436
11140,11140,Jake Dotchin,2018-19,24.0,3,11,48,48,3,8,11,48.0,791.0,83,3,19,22,98.0,82,5.86,50,250,2620,9.2,0.23721182
11141,11141,Jake Dotchin,2019-20,25.0,4,1,20,20,0,1,1,7.0,236.0,103,3,20,23,105.0,82,5.96,47,239,2579,9.5,0.15260768
11142,11142,Jake Dowell,2008-09,23.0,2,3,19,19,2,1,3,19.0,227.0,19,2,1,3,19.0,82,5.44,62,351,2383,9.4,0.22147861
11143,11143,Jake Dowell,2009-10,24.0,3,0,1,1,0,0,0,0.0,14.0,20,2,1,3,19.0,82,5.7,65,341,2477,9.4,0.15580067
11144,11144,Jake Dowell,2010-11,25.0,4,2,3,3,1,1,2,4.0,21.0,23,3,2,5,23.0,82,5.53,56,304,2486,9.1,0.18804619
11145,11145,Jake Dowell,2011-12,26.0,5,21,79,79,6,15,21,74.0,933.0,102,9,17,26,97.0,82,5.46,52,291,2492,9.0,0.25348142
11146,11146,Jake Dowell,2012-13,27.0,6,7,52,52,2,5,7,39.0,397.0,154,11,22,33,136.0,82,5.32,47,271,2439,8.9,0.1385859
11147,11147,Jake Dowell,2013-14,28.0,7,0,2,2,0,0,0,3.0,17.0,156,11,22,33,139.0,48,5.31,29,160,1399,9.1,0.1411171
11148,11148,Jake Dowell,2014-15,29.0,8,0,1,1,0,0,0,1.0,7.0,157,11,22,33,140.0,82,5.34,48,269,2463,8.9,0.13255957
11149,11149,Jake Evans,2020-21,24.0,2,3,13,13,2,1,3,14.0,135.0,13,2,1,3,14.0,70,5.96,42,208,2192,9.5,0.27292413
11150,11150,Jake Gardiner,2012-13,22.0,2,30,75,75,7,23,30,79.0,1619.0,75,7,23,30,79.0,82,5.32,47,271,2439,8.9,0.43345124
11151,11151,Jake Gardiner,2013-14,23.0,3,4,12,12,0,4,4,12.0,246.0,87,7,27,34,91.0,48,5.31,29,160,1399,9.1,0.3105905
11152,11152,Jake Gardiner,2014-15,24.0,4,31,80,80,10,21,31,136.0,1686.0,167,17,48,65,227.0,82,5.34,48,269,2463,8.9,0.38767543
11153,11153,Jake Gardiner,2015-16,25.0,5,24,79,79,4,20,24,100.0,1657.0,246,21,68,89,327.0,82,5.32,47,251,2453,8.9,0.3002274
11154,11154,Jake Gardiner,2016-17,26.0,6,31,79,79,7,24,31,122.0,1629.0,325,28,92,120,449.0,82,5.34,48,255,2438,9.0,0.4380235
11155,11155,Jake Gardiner,2017-18,27.0,7,43,82,82,9,34,43,127.0,1766.0,407,37,126,163,576.0,82,5.45,47,245,2478,9.0,0.4770668
11156,11156,Jake Gardiner,2018-19,28.0,8,52,82,82,5,47,52,133.0,1847.0,489,42,173,215,709.0,82,5.86,50,250,2620,9.2,0.5618795
11157,11157,Jake Gardiner,2019-20,29.0,9,30,62,62,3,27,30,78.0,1315.0,551,45,200,245,787.0,82,5.96,47,239,2579,9.5,0.40217733
11158,11158,Jake Gardiner,2020-21,30.0,10,24,68,68,4,20,24,87.0,1133.0,619,49,220,269,874.0,70,5.96,42,208,2192,9.5,0.30988687
11159,11159,Jake Guentzel,2017-18,23.0,2,33,40,40,16,17,33,81.0,635.0,40,16,17,33,81.0,82,5.45,47,245,2478,9.0,0.6530702
11160,11160,Jake Guentzel,2018-19,24.0,3,48,82,82,22,26,48,171.0,1352.0,122,38,43,81,252.0,82,5.86,50,250,2620,9.2,0.6097398
11161,11161,Jake Guentzel,2019-20,25.0,4,76,82,82,40,36,76,227.0,1587.0,204,78,79,157,479.0,82,5.96,47,239,2579,9.5,0.8686832
11162,11162,Jake Guentzel,2020-21,26.0,5,43,39,39,20,23,43,127.0,805.0,243,98,102,200,606.0,70,5.96,42,208,2192,9.5,0.88255143
11163,11163,Jake McCabe,2014-15,21.0,2,1,7,7,0,1,1,1.0,107.0,7,0,1,1,1.0,82,5.34,48,269,2463,8.9,0.22402593
11164,11164,Jake McCabe,2015-16,22.0,3,0,2,2,0,0,0,2.0,22.0,9,0,1,1,3.0,82,5.32,47,251,2453,8.9,0.18083832
11165,11165,Jake McCabe,2016-17,23.0,4,14,77,77,4,10,14,62.0,1472.0,86,4,11,15,65.0,82,5.34,48,255,2438,9.0,0.20087779
11166,11166,Jake McCabe,2017-18,24.0,5,20,76,76,3,17,20,79.0,1574.0,162,7,28,35,144.0,82,5.45,47,245,2478,9.0,0.24361199
11167,11167,Jake McCabe,2018-19,25.0,6,12,53,53,3,9,12,53.0,1034.0,215,10,37,47,197.0,82,5.86,50,250,2620,9.2,0.1997959
11168,11168,Jake McCabe,2019-20,26.0,7,14,59,59,4,10,14,64.0,1118.0,274,14,47,61,261.0,82,5.96,47,239,2579,9.5,0.20511535
11169,11169,Jake McCabe,2020-21,27.0,8,13,66,66,3,10,13,75.0,1223.0,340,17,57,74,336.0,70,5.96,42,208,2192,9.5,0.23040456
11170,11170,Jake Muzzin,2011-12,22.0,2,1,11,11,0,1,1,8.0,151.0,11,0,1,1,8.0,82,5.46,52,291,2492,9.0,0.18217763
11171,11171,Jake Muzzin,2013-14,24.0,3,16,45,45,7,9,16,77.0,805.0,56,7,10,17,85.0,48,5.31,29,160,1399,9.1,0.38763455
11172,11172,Jake Muzzin,2014-15,25.0,4,24,76,76,5,19,24,175.0,1446.0,132,12,29,41,260.0,82,5.34,48,269,2463,8.9,0.32460806
11173,11173,Jake Muzzin,2015-16,26.0,5,41,76,76,10,31,41,173.0,1725.0,208,22,60,82,433.0,82,5.32,47,251,2453,8.9,0.49347925
11174,11174,Jake Muzzin,2016-17,27.0,6,40,82,82,8,32,40,203.0,1891.0,290,30,92,122,636.0,82,5.34,48,255,2438,9.0,0.517453
11175,11175,Jake Muzzin,2017-18,28.0,7,28,82,82,9,19,28,184.0,1828.0,372,39,111,150,820.0,82,5.45,47,245,2478,9.0,0.42611715
11176,11176,Jake Muzzin,2018-19,29.0,8,42,74,74,8,34,42,154.0,1602.0,446,47,145,192,974.0,82,5.86,50,250,2620,9.2,0.50035906
11177,11177,Jake Muzzin,2019-20,30.0,9,37,80,80,9,28,37,141.0,1707.0,526,56,173,229,1115.0,82,5.96,47,239,2579,9.5,0.43774486
11178,11178,Jake Muzzin,2020-21,31.0,10,23,53,53,6,17,23,99.0,1145.0,579,62,190,252,1214.0,70,5.96,42,208,2192,9.5,0.40714535
11179,11179,Jake Virtanen,2016-17,20.0,2,13,55,55,7,6,13,94.0,636.0,55,7,6,13,94.0,82,5.34,48,255,2438,9.0,0.32415453
11180,11180,Jake Virtanen,2017-18,21.0,3,1,10,10,0,1,1,13.0,101.0,65,7,7,14,107.0,82,5.45,47,245,2478,9.0,0.2886998
11181,11181,Jake Virtanen,2018-19,22.0,4,20,75,75,10,10,20,130.0,899.0,140,17,17,34,237.0,82,5.86,50,250,2620,9.2,0.34873486
11182,11182,Jake Virtanen,2019-20,23.0,5,25,70,70,15,10,25,154.0,1037.0,210,32,27,59,391.0,82,5.96,47,239,2579,9.5,0.4048344
11183,11183,Jake Virtanen,2020-21,24.0,6,36,69,69,18,18,36,150.0,903.0,279,50,45,95,541.0,70,5.96,42,208,2192,9.5,0.48387212
11184,11184,Jake Walman,2020-21,24.0,2,0,1,1,0,0,0,1.0,11.0,1,0,0,0,1.0,70,5.96,42,208,2192,9.5,0.1985141
11185,11185,Jakob Chychrun,2017-18,19.0,2,20,68,68,7,13,20,86.0,1133.0,68,7,13,20,86.0,82,5.45,47,245,2478,9.0,0.36572695
11186,11186,Jakob Chychrun,2018-19,20.0,3,14,50,50,4,10,14,102.0,1013.0,118,11,23,34,188.0,82,5.86,50,250,2620,9.2,0.36136937
11187,11187,Jakob Chychrun,2019-20,21.0,4,20,53,53,5,15,20,117.0,1074.0,171,16,38,54,305.0,82,5.96,47,239,2579,9.5,0.42485097
11188,11188,Jakob Chychrun,2020-21,22.0,5,26,63,63,12,14,26,149.0,1413.0,234,28,52,80,454.0,70,5.96,42,208,2192,9.5,0.49802446
11189,11189,Jakob Forsbacka Karlsson,2017-18,21.0,2,0,1,1,0,0,0,0.0,8.0,1,0,0,0,0.0,82,5.45,47,245,2478,9.0,0.22606894
11190,11190,Jakob Forsbacka Karlsson,2019-20,23.0,3,9,28,28,3,6,9,21.0,330.0,29,3,6,9,21.0,82,5.96,47,239,2579,9.5,0.2590229
11191,11191,Jakob Lilja,2020-21,27.0,2,5,37,37,2,3,5,23.0,366.0,37,2,3,5,23.0,70,5.96,42,208,2192,9.5,0.18250114
11192,11192,Jakob Silfverberg,2013-14,23.0,2,19,48,48,10,9,19,134.0,779.0,48,10,9,19,134.0,48,5.31,29,160,1399,9.1,0.48729503
11193,11193,Jakob Silfverberg,2014-15,24.0,3,23,52,52,10,13,23,119.0,742.0,100,20,22,42,253.0,82,5.34,48,269,2463,8.9,0.42699602
11194,11194,Jakob Silfverberg,2015-16,25.0,4,39,81,81,13,26,39,189.0,1269.0,181,33,48,81,442.0,82,5.32,47,251,2453,8.9,0.5203158
11195,11195,Jakob Silfverberg,2016-17,26.0,5,39,82,82,20,19,39,215.0,1392.0,263,53,67,120,657.0,82,5.34,48,255,2438,9.0,0.52926975
11196,11196,Jakob Silfverberg,2017-18,27.0,6,49,79,79,23,26,49,227.0,1460.0,342,76,93,169,884.0,82,5.45,47,245,2478,9.0,0.5825646
11197,11197,Jakob Silfverberg,2018-19,28.0,7,40,77,77,17,23,40,187.0,1383.0,419,93,116,209,1071.0,82,5.86,50,250,2620,9.2,0.5501271
11198,11198,Jakob Silfverberg,2019-20,29.0,8,43,73,73,24,19,43,163.0,1248.0,492,117,135,252,1234.0,82,5.96,47,239,2579,9.5,0.5287172
11199,11199,Jakob Silfverberg,2020-21,30.0,9,39,66,66,21,18,39,155.0,1167.0,558,138,153,291,1389.0,70,5.96,42,208,2192,9.5,0.58886695
11200,11200,Jakub Cutta,2001-02,20.0,2,0,3,3,0,0,0,1.0,35.0,3,0,0,0,1.0,82,5.51,63,376,2272,9.9,0.2156628
11201,11201,Jakub Cutta,2002-03,21.0,3,0,2,2,0,0,0,2.0,32.0,5,0,0,0,3.0,82,5.24,53,338,2262,9.5,0.19227439
11202,11202,Jakub Cutta,2004-05,23.0,4,0,3,3,0,0,0,1.0,42.0,8,0,0,0,4.0,82,5.14,57,348,2300,9.2,0.20870686
11203,11203,Jakub Jerabek,2018-19,27.0,2,8,36,36,2,6,8,33.0,588.0,36,2,6,8,33.0,82,5.86,50,250,2620,9.2,0.19018325
11204,11204,Jakub Jerabek,2019-20,28.0,3,0,1,1,0,0,0,1.0,8.0,37,2,6,8,34.0,82,5.96,47,239,2579,9.5,0.15320614
11205,11205,Jakub Kindl,2010-11,23.0,2,0,3,3,0,0,0,1.0,32.0,3,0,0,0,1.0,82,5.53,56,304,2486,9.1,0.17165315
11206,11206,Jakub Kindl,2011-12,24.0,3,4,48,48,2,2,4,62.0,653.0,51,2,2,4,63.0,82,5.46,52,291,2492,9.0,0.16970843
11207,11207,Jakub Kindl,2012-13,25.0,4,13,55,55,1,12,13,69.0,773.0,106,3,14,17,132.0,82,5.32,47,271,2439,8.9,0.19287139
11208,11208,Jakub Kindl,2013-14,26.0,5,13,41,41,4,9,13,76.0,761.0,147,7,23,30,208.0,48,5.31,29,160,1399,9.1,0.2965272
11209,11209,Jakub Kindl,2014-15,27.0,6,19,66,66,2,17,19,93.0,1137.0,213,9,40,49,301.0,82,5.34,48,269,2463,8.9,0.23926193
11210,11210,Jakub Kindl,2015-16,28.0,7,13,35,35,5,8,13,54.0,557.0,248,14,48,62,355.0,82,5.32,47,251,2453,8.9,0.24099916
11211,11211,Jakub Kindl,2016-17,29.0,8,8,44,44,2,6,8,63.0,677.0,292,16,54,70,418.0,82,5.34,48,255,2438,9.0,0.16606879
11212,11212,Jakub Kindl,2017-18,30.0,9,4,39,39,0,4,4,41.0,573.0,331,16,58,74,459.0,82,5.45,47,245,2478,9.0,0.13870442
11213,11213,Jakub Klepis,2006-07,22.0,2,4,25,25,1,3,4,26.0,185.0,25,1,3,4,26.0,82,6.05,85,480,2458,10.1,0.21888572
11214,11214,Jakub Klepis,2007-08,23.0,3,10,41,41,3,7,10,38.0,408.0,66,4,10,14,64.0,82,5.76,70,398,2426,9.7,0.24621862
11215,11215,Jakub Nakladal,2016-17,29.0,2,5,27,27,2,3,5,42.0,383.0,27,2,3,5,42.0,82,5.34,48,255,2438,9.0,0.2019332
11216,11216,Jakub Nakladal,2017-18,30.0,3,0,3,3,0,0,0,3.0,44.0,30,2,3,5,45.0,82,5.45,47,245,2478,9.0,0.15922806
11217,11217,Jakub Petruzalek,2009-10,24.0,2,1,2,2,0,1,1,0.0,16.0,2,0,1,1,0.0,82,5.7,65,341,2477,9.4,0.17731193
11218,11218,Jakub Voracek,2009-10,20.0,2,38,80,80,9,29,38,101.0,1013.0,80,9,29,38,101.0,82,5.7,65,341,2477,9.4,0.49930206
11219,11219,Jakub Voracek,2010-11,21.0,3,50,81,81,16,34,50,154.0,1265.0,161,25,63,88,255.0,82,5.53,56,304,2486,9.1,0.6266166
11220,11220,Jakub Voracek,2011-12,22.0,4,46,80,80,14,32,46,183.0,1358.0,241,39,95,134,438.0,82,5.46,52,291,2492,9.0,0.6312564
11221,11221,Jakub Voracek,2012-13,23.0,5,49,78,78,18,31,49,190.0,1271.0,319,57,126,183,628.0,82,5.32,47,271,2439,8.9,0.67302835
11222,11222,Jakub Voracek,2013-14,24.0,6,46,48,48,22,24,46,129.0,827.0,367,79,150,229,757.0,48,5.31,29,160,1399,9.1,0.8728306
11223,11223,Jakub Voracek,2014-15,25.0,7,62,82,82,23,39,62,235.0,1415.0,449,102,189,291,992.0,82,5.34,48,269,2463,8.9,0.74489284
11224,11224,Jakub Voracek,2015-16,26.0,8,81,82,82,22,59,81,221.0,1525.0,531,124,248,372,1213.0,82,5.32,47,251,2453,8.9,0.9289975
11225,11225,Jakub Voracek,2016-17,27.0,9,55,73,73,11,44,55,213.0,1357.0,604,135,292,427,1426.0,82,5.34,48,255,2438,9.0,0.7275876
11226,11226,Jakub Voracek,2017-18,28.0,10,61,82,82,20,41,61,253.0,1565.0,686,155,333,488,1679.0,82,5.45,47,245,2478,9.0,0.7724365
11227,11227,Jakub Voracek,2018-19,29.0,11,85,82,82,20,65,85,228.0,1595.0,768,175,398,573,1907.0,82,5.86,50,250,2620,9.2,0.95262367
11228,11228,Jakub Voracek,2019-20,30.0,12,66,78,78,20,46,66,210.0,1456.0,846,195,444,639,2117.0,82,5.96,47,239,2579,9.5,0.7784219
11229,11229,Jakub Voracek,2020-21,31.0,13,56,69,69,12,44,56,132.0,1176.0,915,207,488,695,2249.0,70,5.96,42,208,2192,9.5,0.689889
11230,11230,Jakub Vrana,2017-18,21.0,2,6,21,21,3,3,6,32.0,233.0,21,3,3,6,32.0,82,5.45,47,245,2478,9.0,0.3427502
11231,11231,Jakub Vrana,2018-19,22.0,3,27,73,73,13,14,27,133.0,912.0,94,16,17,33,165.0,82,5.86,50,250,2620,9.2,0.41507223
11232,11232,Jakub Vrana,2019-20,23.0,4,47,82,82,24,23,47,161.0,1151.0,176,40,40,80,326.0,82,5.96,47,239,2579,9.5,0.64063054
11233,11233,Jakub Vrana,2020-21,24.0,5,52,69,69,25,27,52,187.0,1027.0,245,65,67,132,513.0,70,5.96,42,208,2192,9.5,0.75723493
11234,11234,Jakub Zboril,2019-20,22.0,2,0,2,2,0,0,0,1.0,22.0,2,0,0,0,1.0,82,5.96,47,239,2579,9.5,0.18239564
11235,11235,Jamal Mayers,1997-98,23.0,2,1,6,6,0,1,1,7.0,,6,0,1,1,7.0,82,5.83,55,336,2444,9.8,0.19244751
11236,11236,Jamal Mayers,1999-00,25.0,3,9,34,34,4,5,9,48.0,277.0,40,4,6,10,55.0,82,5.27,57,359,2285,9.4,0.23414978
11237,11237,Jamal Mayers,2000-01,26.0,4,17,79,79,7,10,17,99.0,771.0,119,11,16,27,154.0,82,5.49,53,331,2294,9.8,0.24489614
11238,11238,Jamal Mayers,2001-02,27.0,5,21,77,77,8,13,21,132.0,852.0,196,19,29,48,286.0,82,5.51,63,376,2272,9.9,0.2835151
11239,11239,Jamal Mayers,2002-03,28.0,6,17,77,77,9,8,17,105.0,893.0,273,28,37,65,391.0,82,5.24,53,338,2262,9.5,0.26549405
11240,11240,Jamal Mayers,2003-04,29.0,7,7,15,15,2,5,7,26.0,215.0,288,30,42,72,417.0,82,5.31,60,363,2326,9.4,0.26590338
11241,11241,Jamal Mayers,2004-05,30.0,8,11,80,80,6,5,11,130.0,1041.0,368,36,47,83,547.0,82,5.14,57,348,2300,9.2,0.2646467
11242,11242,Jamal Mayers,2006-07,32.0,9,26,67,67,15,11,26,111.0,1013.0,435,51,58,109,658.0,82,6.05,85,480,2458,10.1,0.3113056
11243,11243,Jamal Mayers,2007-08,33.0,10,22,80,80,8,14,22,129.0,1170.0,515,59,72,131,787.0,82,5.76,70,398,2426,9.7,0.26589146
11244,11244,Jamal Mayers,2008-09,34.0,11,27,80,80,12,15,27,153.0,1275.0,595,71,87,158,940.0,82,5.44,62,351,2383,9.4,0.3084382
11245,11245,Jamal Mayers,2009-10,35.0,12,16,71,71,7,9,16,72.0,749.0,666,78,96,174,1012.0,82,5.7,65,341,2477,9.4,0.20460296
11246,11246,Jamal Mayers,2010-11,36.0,13,14,71,71,3,11,14,75.0,640.0,737,81,107,188,1087.0,82,5.53,56,304,2486,9.1,0.17773136
11247,11247,Jamal Mayers,2011-12,37.0,14,14,78,78,3,11,14,62.0,693.0,815,84,118,202,1149.0,82,5.46,52,291,2492,9.0,0.14976475
11248,11248,Jamal Mayers,2012-13,38.0,15,15,81,81,6,9,15,70.0,794.0,896,90,127,217,1219.0,82,5.32,47,271,2439,8.9,0.15617827
11249,11249,Jamal Mayers,2013-14,39.0,16,2,19,19,0,2,2,10.0,132.0,915,90,129,219,1229.0,48,5.31,29,160,1399,9.1,0.13251415
11250,11250,Jame Pollock,2004-05,25.0,2,0,9,9,0,0,0,19.0,139.0,9,0,0,0,19.0,82,5.14,57,348,2300,9.2,0.19109103
11251,11251,James Black,1990-91,21.0,2,0,1,1,0,0,0,0.0,,1,0,0,0,0.0,80,7.37,76,367,2421,12.2,0.21253276
11252,11252,James Black,1991-92,22.0,3,0,1,1,0,0,0,0.0,,2,0,0,0,0.0,80,6.91,71,366,2385,11.6,0.19462326
11253,11253,James Black,1992-93,23.0,4,10,30,30,4,6,10,54.0,,32,4,6,10,54.0,80,6.96,77,402,2440,11.4,0.31454945
11254,11254,James Black,1993-94,24.0,5,3,10,10,2,1,3,10.0,,42,6,7,13,64.0,84,7.25,87,443,2603,11.7,0.24629185
11255,11255,James Black,1994-95,25.0,6,5,15,15,2,3,5,18.0,,57,8,10,18,82.0,84,6.48,76,407,2545,10.7,0.24831903
11256,11256,James Black,1996-97,27.0,7,6,13,13,3,3,6,23.0,,70,11,13,24,105.0,82,6.29,74,413,2481,10.4,0.28421804
11257,11257,James Black,1997-98,28.0,8,23,64,64,12,11,23,122.0,,134,23,24,47,227.0,82,5.83,55,336,2444,9.8,0.29188085
11258,11258,James Black,1998-99,29.0,9,15,52,52,10,5,15,90.0,,186,33,29,62,317.0,82,5.28,57,380,2242,9.6,0.28075293
11259,11259,James Black,1999-00,30.0,10,30,75,75,16,14,30,135.0,1130.0,261,49,43,92,452.0,82,5.27,57,359,2285,9.4,0.41500753
11260,11260,James Black,2000-01,31.0,11,17,49,49,8,9,17,71.0,591.0,310,57,52,109,523.0,82,5.49,53,331,2294,9.8,0.28687668
11261,11261,James Black,2001-02,32.0,12,6,42,42,1,5,6,34.0,381.0,352,58,57,115,557.0,82,5.51,63,376,2272,9.9,0.14538422
11262,11262,James Camazzola,1984-85,21.0,2,0,1,1,0,0,0,1.0,,1,0,0,0,1.0,80,7.89,74,336,2448,12.9,0.24357492
11263,11263,James Camazzola,1987-88,24.0,3,0,2,2,0,0,0,2.0,,3,0,0,0,3.0,80,7.34,72,344,2400,12.2,0.20778516
11264,11264,James Latos,1989-90,24.0,2,0,1,1,0,0,0,0.0,,1,0,0,0,0.0,80,7.48,85,403,2430,12.3,0.17426091
11265,11265,James Neal,2009-10,22.0,2,37,77,77,24,13,37,171.0,1222.0,77,24,13,37,171.0,82,5.7,65,341,2477,9.4,0.62407273
11266,11266,James Neal,2010-11,23.0,3,55,78,78,27,28,55,200.0,1419.0,155,51,41,92,371.0,82,5.53,56,304,2486,9.1,0.66727275
11267,11267,James Neal,2011-12,24.0,4,45,79,79,22,23,45,212.0,1382.0,234,73,64,137,583.0,82,5.46,52,291,2492,9.0,0.6062203
11268,11268,James Neal,2012-13,25.0,5,81,80,80,40,41,81,329.0,1531.0,314,113,105,218,912.0,82,5.32,47,271,2439,8.9,0.9558544
11269,11269,James Neal,2013-14,26.0,6,36,40,40,21,15,36,136.0,699.0,354,134,120,254,1048.0,48,5.31,29,160,1399,9.1,0.8754411
11270,11270,James Neal,2014-15,27.0,7,61,59,59,27,34,61,238.0,1089.0,413,161,154,315,1286.0,82,5.34,48,269,2463,8.9,0.8604357
11271,11271,James Neal,2015-16,28.0,8,37,67,67,23,14,37,221.0,1212.0,480,184,168,352,1507.0,82,5.32,47,251,2453,8.9,0.6161433
11272,11272,James Neal,2016-17,29.0,9,58,82,82,31,27,58,268.0,1564.0,562,215,195,410,1775.0,82,5.34,48,255,2438,9.0,0.7524581
11273,11273,James Neal,2017-18,30.0,10,41,70,70,23,18,41,202.0,1239.0,632,238,213,451,1977.0,82,5.45,47,245,2478,9.0,0.6236199
11274,11274,James Neal,2018-19,31.0,11,44,71,71,25,19,44,202.0,1219.0,703,263,232,495,2179.0,82,5.86,50,250,2620,9.2,0.5990282
11275,11275,James Neal,2019-20,32.0,12,19,63,63,7,12,19,141.0,942.0,766,270,244,514,2320.0,82,5.96,47,239,2579,9.5,0.3623288
11276,11276,James Neal,2020-21,33.0,13,31,55,55,19,12,31,112.0,897.0,821,289,256,545,2432.0,70,5.96,42,208,2192,9.5,0.5486147
11277,11277,James Patrick,1984-85,21.0,2,8,12,12,1,7,8,15.0,,12,1,7,8,15.0,80,7.89,74,336,2448,12.9,0.34334922
11278,11278,James Patrick,1985-86,22.0,3,36,75,75,8,28,36,102.0,,87,9,35,44,117.0,80,7.77,71,321,2447,12.7,0.4807478
11279,11279,James Patrick,1986-87,23.0,4,43,75,75,14,29,43,131.0,,162,23,64,87,248.0,80,7.94,82,370,2484,12.8,0.5532938
11280,11280,James Patrick,1987-88,24.0,5,55,78,78,10,45,55,145.0,,240,33,109,142,393.0,80,7.34,72,344,2400,12.2,0.7095875
11281,11281,James Patrick,1988-89,25.0,6,62,70,70,17,45,62,187.0,,310,50,154,204,580.0,80,7.43,89,437,2435,12.2,0.81736946
11282,11282,James Patrick,1989-90,26.0,7,47,68,68,11,36,47,147.0,,378,61,190,251,727.0,80,7.48,85,403,2430,12.3,0.6535847
11283,11283,James Patrick,1990-91,27.0,8,57,73,73,14,43,57,136.0,,451,75,233,308,863.0,80,7.37,76,367,2421,12.2,0.7129292
11284,11284,James Patrick,1991-92,28.0,9,59,74,74,10,49,59,138.0,,525,85,282,367,1001.0,80,6.91,71,366,2385,11.6,0.70682085
11285,11285,James Patrick,1992-93,29.0,10,71,80,80,14,57,71,148.0,,605,99,339,438,1149.0,80,6.96,77,402,2440,11.4,0.79566705
11286,11286,James Patrick,1993-94,30.0,11,26,60,60,5,21,26,99.0,,665,104,360,464,1248.0,84,7.25,87,443,2603,11.7,0.3891815
11287,11287,James Patrick,1994-95,31.0,12,35,68,68,10,25,35,91.0,,733,114,385,499,1339.0,84,6.48,76,407,2545,10.7,0.4092337
11288,11288,James Patrick,1995-96,32.0,13,10,43,43,0,10,10,43.0,,776,114,395,509,1382.0,48,5.97,37,209,1408,10.2,0.3448645
11289,11289,James Patrick,1996-97,33.0,14,35,80,80,3,32,35,116.0,,856,117,427,544,1498.0,82,6.29,74,413,2481,10.4,0.32908505
11290,11290,James Patrick,1997-98,34.0,15,4,19,19,3,1,4,22.0,,875,120,428,548,1520.0,82,5.83,55,336,2444,9.8,0.262281
11291,11291,James Patrick,1998-99,35.0,16,17,60,60,6,11,17,57.0,,935,126,439,565,1577.0,82,5.28,57,380,2242,9.6,0.2395978
11292,11292,James Patrick,1999-00,36.0,17,8,45,45,1,7,8,31.0,664.0,980,127,446,573,1608.0,82,5.27,57,359,2285,9.4,0.1915656
11293,11293,James Patrick,2000-01,37.0,18,13,66,66,5,8,13,40.0,1055.0,1046,132,454,586,1648.0,82,5.49,53,331,2294,9.8,0.18430603
11294,11294,James Patrick,2001-02,38.0,19,13,54,54,4,9,13,48.0,932.0,1100,136,463,599,1696.0,82,5.51,63,376,2272,9.9,0.19571176
11295,11295,James Patrick,2002-03,39.0,20,13,56,56,5,8,13,45.0,921.0,1156,141,471,612,1741.0,82,5.24,53,338,2262,9.5,0.19508502
11296,11296,James Patrick,2003-04,40.0,21,16,69,69,4,12,16,63.0,1305.0,1225,145,483,628,1804.0,82,5.31,60,363,2326,9.4,0.21439403
11297,11297,James Patrick,2004-05,41.0,22,11,55,55,4,7,11,44.0,1044.0,1280,149,490,639,1848.0,82,5.14,57,348,2300,9.2,0.23110771
11298,11298,James Sheppard,2008-09,20.0,2,19,78,78,4,15,19,57.0,828.0,78,4,15,19,57.0,82,5.44,62,351,2383,9.4,0.28299007
11299,11299,James Sheppard,2009-10,21.0,3,24,82,82,5,19,24,88.0,1245.0,160,9,34,43,145.0,82,5.7,65,341,2477,9.4,0.3573383
11300,11300,James Sheppard,2010-11,22.0,4,6,64,64,2,4,6,64.0,767.0,224,11,38,49,209.0,82,5.53,56,304,2486,9.1,0.2514702
11301,11301,James Sheppard,2013-14,25.0,5,4,32,32,1,3,4,40.0,376.0,256,12,41,53,249.0,48,5.31,29,160,1399,9.1,0.21712479
11302,11302,James Sheppard,2014-15,26.0,6,20,67,67,4,16,20,84.0,815.0,323,16,57,73,333.0,82,5.34,48,269,2463,8.9,0.24319482
11303,11303,James Sheppard,2015-16,27.0,7,18,71,71,7,11,18,79.0,941.0,394,23,68,91,412.0,82,5.32,47,251,2453,8.9,0.2596546
11304,11304,James Wisniewski,2006-07,22.0,2,7,19,19,2,5,7,25.0,302.0,19,2,5,7,25.0,82,6.05,85,480,2458,10.1,0.2889377
11305,11305,James Wisniewski,2007-08,23.0,3,10,50,50,2,8,10,55.0,950.0,69,4,13,17,80.0,82,5.76,70,398,2426,9.7,0.25550002
11306,11306,James Wisniewski,2008-09,24.0,4,26,68,68,7,19,26,82.0,1156.0,137,11,32,43,162.0,82,5.44,62,351,2383,9.4,0.35565567
11307,11307,James Wisniewski,2009-10,25.0,5,24,48,48,3,21,24,89.0,953.0,185,14,53,67,251.0,82,5.7,65,341,2477,9.4,0.36481404
11308,11308,James Wisniewski,2010-11,26.0,6,30,69,69,3,27,30,146.0,1680.0,254,17,80,97,397.0,82,5.53,56,304,2486,9.1,0.42988876
11309,11309,James Wisniewski,2011-12,27.0,7,51,75,75,10,41,51,158.0,1721.0,329,27,121,148,555.0,82,5.46,52,291,2492,9.0,0.54807186
11310,11310,James Wisniewski,2012-13,28.0,8,27,48,48,6,21,27,99.0,1190.0,377,33,142,175,654.0,82,5.32,47,271,2439,8.9,0.4779693
11311,11311,James Wisniewski,2013-14,29.0,9,14,30,30,5,9,14,62.0,685.0,407,38,151,189,716.0,48,5.31,29,160,1399,9.1,0.38690382
11312,11312,James Wisniewski,2014-15,30.0,10,51,75,75,7,44,51,166.0,1697.0,482,45,195,240,882.0,82,5.34,48,269,2463,8.9,0.55670244
11313,11313,James Wisniewski,2015-16,31.0,11,34,69,69,8,26,34,147.0,1462.0,551,53,221,274,1029.0,82,5.32,47,251,2453,8.9,0.3974318
11314,11314,James Wisniewski,2016-17,32.0,12,0,1,1,0,0,0,0.0,1.0,552,53,221,274,1029.0,82,5.34,48,255,2438,9.0,0.3335325
11315,11315,James Wright,2010-11,20.0,2,5,48,48,2,3,5,25.0,559.0,48,2,3,5,25.0,82,5.53,56,304,2486,9.1,0.19925103
11316,11316,James Wright,2011-12,21.0,3,0,1,1,0,0,0,0.0,5.0,49,2,3,5,25.0,82,5.46,52,291,2492,9.0,0.21295047
11317,11317,James Wright,2013-14,23.0,4,5,38,38,2,3,5,32.0,441.0,87,4,6,10,57.0,48,5.31,29,160,1399,9.1,0.1973288
11318,11318,James Wright,2014-15,24.0,5,2,59,59,0,2,2,41.0,565.0,146,4,8,12,98.0,82,5.34,48,269,2463,8.9,0.13611346
11319,11319,James van Riemsdyk,2010-11,21.0,2,35,78,78,15,20,35,173.0,1011.0,78,15,20,35,173.0,82,5.53,56,304,2486,9.1,0.50994426
11320,11320,James van Riemsdyk,2011-12,22.0,3,40,75,75,21,19,40,173.0,1090.0,153,36,39,75,346.0,82,5.46,52,291,2492,9.0,0.54742634
11321,11321,James van Riemsdyk,2012-13,23.0,4,24,43,43,11,13,24,121.0,652.0,196,47,52,99,467.0,82,5.32,47,271,2439,8.9,0.5710422
11322,11322,James van Riemsdyk,2013-14,24.0,5,32,48,48,18,14,32,140.0,922.0,244,65,66,131,607.0,48,5.31,29,160,1399,9.1,0.68871766
11323,11323,James van Riemsdyk,2014-15,25.0,6,61,80,80,30,31,61,279.0,1685.0,324,95,97,192,886.0,82,5.34,48,269,2463,8.9,0.7204079
11324,11324,James van Riemsdyk,2015-16,26.0,7,56,82,82,27,29,56,248.0,1565.0,406,122,126,248,1134.0,82,5.32,47,251,2453,8.9,0.6802287
11325,11325,James van Riemsdyk,2016-17,27.0,8,29,40,40,14,15,29,129.0,711.0,446,136,141,277,1263.0,82,5.34,48,255,2438,9.0,0.6731752
11326,11326,James van Riemsdyk,2017-18,28.0,9,62,82,82,29,33,62,238.0,1303.0,528,165,174,339,1501.0,82,5.45,47,245,2478,9.0,0.7173981
11327,11327,James van Riemsdyk,2018-19,29.0,10,54,81,81,36,18,54,248.0,1206.0,609,201,192,393,1749.0,82,5.86,50,250,2620,9.2,0.693045
11328,11328,James van Riemsdyk,2019-20,30.0,11,48,66,66,27,21,48,167.0,1096.0,675,228,213,441,1916.0,82,5.96,47,239,2579,9.5,0.6666441
11329,11329,James van Riemsdyk,2020-21,31.0,12,40,66,66,19,21,40,151.0,983.0,741,247,234,481,2067.0,70,5.96,42,208,2192,9.5,0.5889858
11330,11330,Jamie Allison,1995-96,20.0,2,0,1,1,0,0,0,0.0,,1,0,0,0,0.0,48,5.97,37,209,1408,10.2,0.23960996
11331,11331,Jamie Allison,1997-98,22.0,3,0,20,20,0,0,0,8.0,,21,0,0,0,8.0,82,5.83,55,336,2444,9.8,0.1149044
11332,11332,Jamie Allison,1998-99,23.0,4,11,43,43,3,8,11,27.0,,64,3,8,11,35.0,82,5.28,57,380,2242,9.6,0.20190799
11333,11333,Jamie Allison,1999-00,24.0,5,4,39,39,2,2,4,24.0,547.0,103,5,10,15,59.0,82,5.27,57,359,2285,9.4,0.17260724
11334,11334,Jamie Allison,2000-01,25.0,6,4,59,59,1,3,4,24.0,840.0,162,6,13,19,83.0,82,5.49,53,331,2294,9.8,0.105543286
11335,11335,Jamie Allison,2001-02,26.0,7,4,44,44,1,3,4,16.0,640.0,206,7,16,23,99.0,82,5.51,63,376,2272,9.9,0.109347016
11336,11336,Jamie Allison,2002-03,27.0,8,2,44,44,0,2,2,16.0,366.0,250,7,18,25,115.0,82,5.24,53,338,2262,9.5,0.08575669
11337,11337,Jamie Allison,2003-04,28.0,9,1,48,48,0,1,1,23.0,574.0,298,7,19,26,138.0,82,5.31,60,363,2326,9.4,0.093642354
11338,11338,Jamie Allison,2004-05,29.0,10,3,47,47,0,3,3,19.0,615.0,345,7,22,29,157.0,82,5.14,57,348,2300,9.2,0.10770112
11339,11339,Jamie Allison,2006-07,31.0,11,1,27,27,0,1,1,7.0,243.0,372,7,23,30,164.0,82,6.05,85,480,2458,10.1,0.07203293
11340,11340,Jamie Arniel,2011-12,22.0,2,0,1,1,0,0,0,3.0,12.0,1,0,0,0,3.0,82,5.46,52,291,2492,9.0,0.18394265
11341,11341,Jamie Baker,1990-91,24.0,2,0,1,1,0,0,0,0.0,,1,0,0,0,0.0,80,7.37,76,367,2421,12.2,0.1824621
11342,11342,Jamie Baker,1991-92,25.0,3,2,18,18,2,0,2,18.0,,19,2,0,2,18.0,80,6.91,71,366,2385,11.6,0.25670516
11343,11343,Jamie Baker,1992-93,26.0,4,17,52,52,7,10,17,77.0,,71,9,10,19,95.0,80,6.96,77,402,2440,11.4,0.35754162
11344,11344,Jamie Baker,1993-94,27.0,5,48,76,76,19,29,48,160.0,,147,28,39,67,255.0,84,7.25,87,443,2603,11.7,0.4885777
11345,11345,Jamie Baker,1994-95,28.0,6,17,65,65,12,5,17,68.0,,212,40,44,84,323.0,84,6.48,76,407,2545,10.7,0.25306702
11346,11346,Jamie Baker,1995-96,29.0,7,11,43,43,7,4,11,60.0,,255,47,48,95,383.0,48,5.97,37,209,1408,10.2,0.29518902
11347,11347,Jamie Baker,1996-97,30.0,8,33,77,77,16,17,33,117.0,,332,63,65,128,500.0,82,6.29,74,413,2481,10.4,0.35384813
11348,11348,Jamie Baker,1997-98,31.0,9,16,58,58,8,8,16,69.0,,390,71,73,144,569.0,82,5.83,55,336,2444,9.8,0.2552025
11349,11349,Jamie Baker,1998-99,32.0,10,5,13,13,0,5,5,16.0,,403,71,78,149,585.0,82,5.28,57,380,2242,9.6,0.29511595
11350,11350,Jamie Baker,1999-00,33.0,11,1,1,1,0,1,1,1.0,,404,71,79,150,586.0,82,5.27,57,359,2285,9.4,0.20800692
11351,11351,Jamie Benn,2010-11,21.0,2,41,82,82,22,19,41,182.0,1206.0,82,22,19,41,182.0,82,5.53,56,304,2486,9.1,0.6320721
11352,11352,Jamie Benn,2011-12,22.0,3,56,69,69,22,34,56,177.0,1243.0,151,44,53,97,359.0,82,5.46,52,291,2492,9.0,0.77798486
11353,11353,Jamie Benn,2012-13,23.0,4,63,71,71,26,37,63,203.0,1283.0,222,70,90,160,562.0,82,5.32,47,271,2439,8.9,0.8290099
11354,11354,Jamie Benn,2013-14,24.0,5,33,41,41,12,21,33,110.0,816.0,263,82,111,193,672.0,48,5.31,29,160,1399,9.1,0.83651876
11355,11355,Jamie Benn,2014-15,25.0,6,79,81,81,34,45,79,279.0,1551.0,344,116,156,272,951.0,82,5.34,48,269,2463,8.9,0.8996446
11356,11356,Jamie Benn,2015-16,26.0,7,87,82,82,35,52,87,253.0,1636.0,426,151,208,359,1204.0,82,5.32,47,251,2453,8.9,0.9654979
11357,11357,Jamie Benn,2016-17,27.0,8,89,82,82,41,48,89,247.0,1642.0,508,192,256,448,1451.0,82,5.34,48,255,2438,9.0,0.9949703
11358,11358,Jamie Benn,2017-18,28.0,9,69,77,77,26,43,69,201.0,1492.0,585,218,299,517,1652.0,82,5.45,47,245,2478,9.0,0.8305106
11359,11359,Jamie Benn,2018-19,29.0,10,79,82,82,36,43,79,241.0,1625.0,667,254,342,596,1893.0,82,5.86,50,250,2620,9.2,0.8463335
11360,11360,Jamie Benn,2019-20,30.0,11,53,78,78,27,26,53,189.0,1422.0,745,281,368,649,2082.0,82,5.96,47,239,2579,9.5,0.69175184
11361,11361,Jamie Benn,2020-21,31.0,12,39,69,69,19,20,39,163.0,1134.0,814,300,388,688,2245.0,70,5.96,42,208,2192,9.5,0.63809794
11362,11362,Jamie Devane,2014-15,23.0,2,0,2,2,0,0,0,1.0,12.0,2,0,0,0,1.0,82,5.34,48,269,2463,8.9,0.16749048
11363,11363,Jamie Doornbosch,2011-12,21.0,2,0,1,1,0,0,0,1.0,5.0,1,0,0,0,1.0,82,5.46,52,291,2492,9.0,0.19850874
11364,11364,Jamie Fraser,2009-10,24.0,2,0,1,1,0,0,0,0.0,11.0,1,0,0,0,0.0,82,5.7,65,341,2477,9.4,0.15774
11365,11365,Jamie Fritsch,2009-10,24.0,2,0,1,1,0,0,0,0.0,5.0,1,0,0,0,0.0,82,5.7,65,341,2477,9.4,0.15774
11366,11366,Jamie Heward,1996-97,25.0,2,0,5,5,0,0,0,8.0,,5,0,0,0,8.0,82,6.29,74,413,2481,10.4,0.1686536
11367,11367,Jamie Heward,1997-98,26.0,3,5,20,20,1,4,5,23.0,,25,1,4,5,31.0,82,5.83,55,336,2444,9.8,0.20048046
11368,11368,Jamie Heward,1999-00,28.0,4,18,63,63,6,12,18,124.0,1021.0,88,7,16,23,155.0,82,5.27,57,359,2285,9.4,0.2985028
11369,11369,Jamie Heward,2000-01,29.0,5,17,54,54,6,11,17,92.0,1078.0,142,13,27,40,247.0,82,5.49,53,331,2294,9.8,0.3094342
11370,11370,Jamie Heward,2001-02,30.0,6,27,69,69,11,16,27,108.0,991.0,211,24,43,67,355.0,82,5.51,63,376,2272,9.9,0.3124954
11371,11371,Jamie Heward,2002-03,31.0,7,3,28,28,1,2,3,38.0,394.0,239,25,45,70,393.0,82,5.24,53,338,2262,9.5,0.19576272
11372,11372,Jamie Heward,2006-07,35.0,8,28,71,71,7,21,28,140.0,1552.0,310,32,66,98,533.0,82,6.05,85,480,2458,10.1,0.34776455
11373,11373,Jamie Heward,2007-08,36.0,9,24,71,71,6,18,24,75.0,1226.0,381,38,84,122,608.0,82,5.76,70,398,2426,9.7,0.2755045
11374,11374,Jamie Heward,2009-10,38.0,10,2,13,13,0,2,2,11.0,154.0,394,38,86,124,619.0,82,5.7,65,341,2477,9.4,0.1971969
11375,11375,Jamie Hislop,1980-81,27.0,2,39,80,80,19,20,39,124.0,,80,19,20,39,124.0,80,7.03,61,280,2352,12.0,0.4769235
11376,11376,Jamie Hislop,1981-82,28.0,3,56,79,79,25,31,56,117.0,,159,44,51,95,241.0,80,7.69,77,340,2441,12.6,0.60770786
11377,11377,Jamie Hislop,1982-83,29.0,4,41,80,80,16,25,41,113.0,,239,60,76,136,354.0,80,8.03,73,320,2489,12.9,0.47772416
11378,11378,Jamie Hislop,1983-84,30.0,5,33,79,79,14,19,33,80.0,,318,74,95,169,434.0,80,7.73,71,310,2444,12.7,0.39473006
11379,11379,Jamie Hislop,1984-85,31.0,6,9,27,27,1,8,9,18.0,,345,75,103,178,452.0,80,7.89,74,336,2448,12.9,0.40597606
11380,11380,Jamie Hunt,2007-08,23.0,2,0,1,1,0,0,0,0.0,6.0,1,0,0,0,0.0,82,5.76,70,398,2426,9.7,0.15239856
11381,11381,Jamie Huscroft,1989-90,23.0,2,2,15,15,0,2,2,9.0,,15,0,2,2,9.0,80,7.48,85,403,2430,12.3,0.24225757
11382,11382,Jamie Huscroft,1990-91,24.0,3,5,42,42,2,3,5,19.0,,57,2,5,7,28.0,80,7.37,76,367,2421,12.2,0.14715472
11383,11383,Jamie Huscroft,1991-92,25.0,4,1,8,8,0,1,1,3.0,,65,2,6,8,31.0,80,6.91,71,366,2385,11.6,0.17443526
11384,11384,Jamie Huscroft,1994-95,28.0,5,1,36,36,0,1,1,13.0,,101,2,7,9,44.0,84,6.48,76,407,2545,10.7,0.09751263
11385,11385,Jamie Huscroft,1995-96,29.0,6,6,34,34,0,6,6,30.0,,135,2,13,15,74.0,48,5.97,37,209,1408,10.2,0.1354663
11386,11386,Jamie Huscroft,1996-97,30.0,7,12,70,70,3,9,12,57.0,,205,5,22,27,131.0,82,6.29,74,413,2481,10.4,0.13777417
11387,11387,Jamie Huscroft,1997-98,31.0,8,5,52,52,0,5,5,40.0,,257,5,27,32,171.0,82,5.83,55,336,2444,9.8,0.10856968
11388,11388,Jamie Huscroft,1998-99,32.0,9,4,51,51,0,4,4,26.0,,308,5,31,36,197.0,82,5.28,57,380,2242,9.6,0.085229754
11389,11389,Jamie Huscroft,1999-00,33.0,10,2,37,37,0,2,2,27.0,353.0,345,5,33,38,224.0,82,5.27,57,359,2285,9.4,0.109021604
11390,11390,Jamie Huscroft,2000-01,34.0,11,0,7,7,0,0,0,4.0,74.0,352,5,33,38,228.0,82,5.49,53,331,2294,9.8,0.09546882
11391,11391,Jamie Langenbrunner,1995-96,20.0,2,0,2,2,0,0,0,1.0,,2,0,0,0,1.0,48,5.97,37,209,1408,10.2,0.24600175
11392,11392,Jamie Langenbrunner,1996-97,21.0,3,4,12,12,2,2,4,15.0,,14,2,2,4,16.0,82,6.29,74,413,2481,10.4,0.3071939
11393,11393,Jamie Langenbrunner,1997-98,22.0,4,39,76,76,13,26,39,112.0,,90,15,28,43,128.0,82,5.83,55,336,2444,9.8,0.4951555
11394,11394,Jamie Langenbrunner,1998-99,23.0,5,52,81,81,23,29,52,159.0,,171,38,57,95,287.0,82,5.28,57,380,2242,9.6,0.6178478
11395,11395,Jamie Langenbrunner,1999-00,24.0,6,45,75,75,12,33,45,145.0,1189.0,246,50,90,140,432.0,82,5.27,57,359,2285,9.4,0.5702129
11396,11396,Jamie Langenbrunner,2000-01,25.0,7,39,65,65,18,21,39,153.0,1141.0,311,68,111,179,585.0,82,5.49,53,331,2294,9.8,0.6420251
11397,11397,Jamie Langenbrunner,2001-02,26.0,8,30,53,53,12,18,30,104.0,874.0,364,80,129,209,689.0,82,5.51,63,376,2272,9.9,0.53249276
11398,11398,Jamie Langenbrunner,2002-03,27.0,9,32,82,82,13,19,32,163.0,1288.0,446,93,148,241,852.0,82,5.24,53,338,2262,9.5,0.45312852
11399,11399,Jamie Langenbrunner,2003-04,28.0,10,55,78,78,22,33,55,197.0,1388.0,524,115,181,296,1049.0,82,5.31,60,363,2326,9.4,0.66227114
11400,11400,Jamie Langenbrunner,2004-05,29.0,11,26,53,53,10,16,26,130.0,849.0,577,125,197,322,1179.0,82,5.14,57,348,2300,9.2,0.60041225
11401,11401,Jamie Langenbrunner,2006-07,31.0,12,53,80,80,19,34,53,243.0,1488.0,657,144,231,375,1422.0,82,6.05,85,480,2458,10.1,0.6272806
11402,11402,Jamie Langenbrunner,2007-08,32.0,13,60,82,82,23,37,60,243.0,1522.0,739,167,268,435,1665.0,82,5.76,70,398,2426,9.7,0.67096937
11403,11403,Jamie Langenbrunner,2008-09,33.0,14,41,64,64,13,28,41,152.0,1171.0,803,180,296,476,1817.0,82,5.44,62,351,2383,9.4,0.5632933
11404,11404,Jamie Langenbrunner,2009-10,34.0,15,69,81,81,29,40,69,229.0,1466.0,884,209,336,545,2046.0,82,5.7,65,341,2477,9.4,0.718709
11405,11405,Jamie Langenbrunner,2010-11,35.0,16,61,81,81,19,42,61,228.0,1584.0,965,228,378,606,2274.0,82,5.53,56,304,2486,9.1,0.60439676
11406,11406,Jamie Langenbrunner,2011-12,36.0,17,32,70,70,9,23,32,153.0,1221.0,1035,237,401,638,2427.0,82,5.46,52,291,2492,9.0,0.39013916
11407,11407,Jamie Langenbrunner,2012-13,37.0,18,24,70,70,6,18,24,127.0,1023.0,1105,243,419,662,2554.0,82,5.32,47,271,2439,8.9,0.31448627
11408,11408,Jamie Langenbrunner,2013-14,38.0,19,1,4,4,0,1,1,5.0,39.0,1109,243,420,663,2559.0,48,5.31,29,160,1399,9.1,0.27892786
11409,11409,Jamie Leach,1990-91,21.0,2,3,10,10,0,3,3,10.0,,10,0,3,3,10.0,80,7.37,76,367,2421,12.2,0.29794616
11410,11410,Jamie Leach,1991-92,22.0,3,2,7,7,2,0,2,8.0,,17,2,3,5,18.0,80,6.91,71,366,2385,11.6,0.29444107
11411,11411,Jamie Leach,1992-93,23.0,4,9,38,38,5,4,9,32.0,,55,7,7,14,50.0,80,6.96,77,402,2440,11.4,0.23927674
11412,11412,Jamie Leach,1993-94,24.0,5,5,24,24,3,2,5,19.0,,79,10,9,19,69.0,84,7.25,87,443,2603,11.7,0.23825651
11413,11413,Jamie Leach,1994-95,25.0,6,1,2,2,1,0,1,2.0,,81,11,9,20,71.0,84,6.48,76,407,2545,10.7,0.18858472
11414,11414,Jamie Linden,1995-96,23.0,2,0,4,4,0,0,0,0.0,,4,0,0,0,0.0,48,5.97,37,209,1408,10.2,0.18184367
11415,11415,Jamie Lundmark,2003-04,23.0,2,19,55,55,8,11,19,78.0,663.0,55,8,11,19,78.0,82,5.31,60,363,2326,9.4,0.37783748
11416,11416,Jamie Lundmark,2004-05,24.0,3,10,56,56,2,8,10,68.0,715.0,111,10,19,29,146.0,82,5.14,57,348,2300,9.2,0.24555668
11417,11417,Jamie Lundmark,2006-07,26.0,4,29,53,53,10,19,29,78.0,659.0,164,20,38,58,224.0,82,6.05,85,480,2458,10.1,0.42802107
11418,11418,Jamie Lundmark,2007-08,27.0,5,13,68,68,7,6,13,81.0,801.0,232,27,44,71,305.0,82,5.76,70,398,2426,9.7,0.24754098
11419,11419,Jamie Lundmark,2009-10,29.0,6,16,27,27,8,8,16,50.0,378.0,259,35,52,87,355.0,82,5.7,65,341,2477,9.4,0.3672002
11420,11420,Jamie Lundmark,2010-11,30.0,7,12,36,36,5,7,12,52.0,496.0,295,40,59,99,407.0,82,5.53,56,304,2486,9.1,0.24617386
11421,11421,Jamie Macoun,1983-84,22.0,2,5,22,22,1,4,5,18.0,,22,1,4,5,18.0,80,7.73,71,310,2444,12.7,0.2507444
11422,11422,Jamie Macoun,1984-85,23.0,3,32,72,72,9,23,32,165.0,,94,10,27,37,183.0,80,7.89,74,336,2448,12.9,0.52345556
11423,11423,Jamie Macoun,1985-86,24.0,4,39,70,70,9,30,39,129.0,,164,19,57,76,312.0,80,7.77,71,321,2447,12.7,0.51630044
11424,11424,Jamie Macoun,1986-87,25.0,5,32,77,77,11,21,32,133.0,,241,30,78,108,445.0,80,7.94,82,370,2484,12.8,0.4376288
11425,11425,Jamie Macoun,1987-88,26.0,6,40,79,79,7,33,40,137.0,,320,37,111,148,582.0,80,7.34,72,344,2400,12.2,0.5194271
11426,11426,Jamie Macoun,1989-90,28.0,7,27,72,72,8,19,27,89.0,,392,45,130,175,671.0,80,7.48,85,403,2430,12.3,0.37630436
11427,11427,Jamie Macoun,1990-91,29.0,8,35,78,78,8,27,35,120.0,,470,53,157,210,791.0,80,7.37,76,367,2421,12.2,0.4114178
11428,11428,Jamie Macoun,1991-92,30.0,9,22,79,79,7,15,22,117.0,,549,60,172,232,908.0,80,6.91,71,366,2385,11.6,0.30133837
11429,11429,Jamie Macoun,1992-93,31.0,10,30,76,76,5,25,30,129.0,,625,65,197,262,1037.0,80,6.96,77,402,2440,11.4,0.3676002
11430,11430,Jamie Macoun,1993-94,32.0,11,19,77,77,4,15,19,114.0,,702,69,212,281,1151.0,84,7.25,87,443,2603,11.7,0.25266534
11431,11431,Jamie Macoun,1994-95,33.0,12,30,82,82,3,27,30,122.0,,784,72,239,311,1273.0,84,6.48,76,407,2545,10.7,0.31731614
11432,11432,Jamie Macoun,1995-96,34.0,13,10,46,46,2,8,10,84.0,,830,74,247,321,1357.0,48,5.97,37,209,1408,10.2,0.27616566
11433,11433,Jamie Macoun,1996-97,35.0,14,8,82,82,0,8,8,74.0,,912,74,255,329,1431.0,82,6.29,74,413,2481,10.4,0.14881709
11434,11434,Jamie Macoun,1997-98,36.0,15,11,73,73,1,10,11,64.0,,985,75,265,340,1495.0,82,5.83,55,336,2444,9.8,0.1363104
11435,11435,Jamie Macoun,1998-99,37.0,16,7,74,74,0,7,7,78.0,,1059,75,272,347,1573.0,82,5.28,57,380,2242,9.6,0.14793852
11436,11436,Jamie Macoun,1999-00,38.0,17,11,69,69,1,10,11,62.0,1208.0,1128,76,282,358,1635.0,82,5.27,57,359,2285,9.4,0.14771396
11437,11437,Jamie McBain,2010-11,22.0,2,10,14,14,3,7,10,29.0,361.0,14,3,7,10,29.0,82,5.53,56,304,2486,9.1,0.3200876
11438,11438,Jamie McBain,2011-12,23.0,3,30,76,76,7,23,30,95.0,1452.0,90,10,30,40,124.0,82,5.46,52,291,2492,9.0,0.4346174
11439,11439,Jamie McBain,2012-13,24.0,4,27,76,76,8,19,27,127.0,1505.0,166,18,49,67,251.0,82,5.32,47,271,2439,8.9,0.3415467
11440,11440,Jamie McBain,2013-14,25.0,5,8,40,40,1,7,8,46.0,737.0,206,19,56,75,297.0,48,5.31,29,160,1399,9.1,0.26361015
11441,11441,Jamie McBain,2014-15,26.0,6,17,69,69,6,11,17,98.0,1391.0,275,25,67,92,395.0,82,5.34,48,269,2463,8.9,0.27324373
11442,11442,Jamie McBain,2015-16,27.0,7,9,26,26,3,6,9,18.0,330.0,301,28,73,101,413.0,82,5.32,47,251,2453,8.9,0.22310218
11443,11443,Jamie McBain,2016-17,28.0,8,9,44,44,2,7,9,32.0,538.0,345,30,80,110,445.0,82,5.34,48,255,2438,9.0,0.17359072
11444,11444,Jamie McBain,2017-18,29.0,9,0,3,3,0,0,0,3.0,50.0,348,30,80,110,448.0,82,5.45,47,245,2478,9.0,0.21200833
11445,11445,Jamie McGinn,2009-10,21.0,2,6,35,35,4,2,6,27.0,312.0,35,4,2,6,27.0,82,5.7,65,341,2477,9.4,0.3116213
11446,11446,Jamie McGinn,2010-11,22.0,3,13,59,59,10,3,13,76.0,590.0,94,14,5,19,103.0,82,5.53,56,304,2486,9.1,0.28285417
11447,11447,Jamie McGinn,2011-12,23.0,4,6,49,49,1,5,6,63.0,568.0,143,15,10,25,166.0,82,5.46,52,291,2492,9.0,0.23139685
11448,11448,Jamie McGinn,2012-13,24.0,5,37,78,78,20,17,37,159.0,1049.0,221,35,27,62,325.0,82,5.32,47,271,2439,8.9,0.45752653
11449,11449,Jamie McGinn,2013-14,25.0,6,22,47,47,11,11,22,128.0,812.0,268,46,38,84,453.0,48,5.31,29,160,1399,9.1,0.46249655
11450,11450,Jamie McGinn,2014-15,26.0,7,38,79,79,19,19,38,167.0,1247.0,347,65,57,122,620.0,82,5.34,48,269,2463,8.9,0.4658796
11451,11451,Jamie McGinn,2015-16,27.0,8,6,19,19,4,2,6,36.0,281.0,366,69,59,128,656.0,82,5.32,47,251,2453,8.9,0.32151508
11452,11452,Jamie McGinn,2016-17,28.0,9,39,84,84,22,17,39,156.0,1201.0,450,91,76,167,812.0,82,5.34,48,255,2438,9.0,0.4410242
11453,11453,Jamie McGinn,2017-18,29.0,10,17,72,72,9,8,17,116.0,948.0,522,100,84,184,928.0,82,5.45,47,245,2478,9.0,0.28201354
11454,11454,Jamie McGinn,2018-19,30.0,11,29,76,76,13,16,29,116.0,1023.0,598,113,100,213,1044.0,82,5.86,50,250,2620,9.2,0.33044732
11455,11455,Jamie McGinn,2019-20,31.0,12,7,19,19,4,3,7,23.0,203.0,617,117,103,220,1067.0,82,5.96,47,239,2579,9.5,0.28213516
11456,11456,Jamie Oleksiak,2013-14,21.0,2,2,16,16,0,2,2,11.0,237.0,16,0,2,2,11.0,48,5.31,29,160,1399,9.1,0.24325714
11457,11457,Jamie Oleksiak,2014-15,22.0,3,0,7,7,0,0,0,5.0,125.0,23,0,2,2,16.0,82,5.34,48,269,2463,8.9,0.1604146
11458,11458,Jamie Oleksiak,2015-16,23.0,4,8,36,36,1,7,8,36.0,482.0,59,1,9,10,52.0,82,5.32,47,251,2453,8.9,0.19965854
11459,11459,Jamie Oleksiak,2016-17,24.0,5,2,19,19,0,2,2,13.0,242.0,78,1,11,12,65.0,82,5.34,48,255,2438,9.0,0.11797476
11460,11460,Jamie Oleksiak,2017-18,25.0,6,7,41,41,5,2,7,33.0,665.0,119,6,13,19,98.0,82,5.45,47,245,2478,9.0,0.17833337
11461,11461,Jamie Oleksiak,2018-19,26.0,7,17,68,68,5,12,17,81.0,1133.0,187,11,25,36,179.0,82,5.86,50,250,2620,9.2,0.2148886
11462,11462,Jamie Oleksiak,2019-20,27.0,8,12,57,57,4,8,12,55.0,840.0,244,15,33,48,234.0,82,5.96,47,239,2579,9.5,0.17564014
11463,11463,Jamie Oleksiak,2020-21,28.0,9,10,69,69,3,7,10,76.0,1091.0,313,18,40,58,310.0,70,5.96,42,208,2192,9.5,0.22578335
11464,11464,Jamie Pushor,1996-97,23.0,2,1,5,5,0,1,1,6.0,,5,0,1,1,6.0,82,6.29,74,413,2481,10.4,0.19743371
11465,11465,Jamie Pushor,1997-98,24.0,3,11,75,75,4,7,11,63.0,,80,4,8,12,69.0,82,5.83,55,336,2444,9.8,0.17325154
11466,11466,Jamie Pushor,1998-99,25.0,4,9,64,64,2,7,9,51.0,,144,6,15,21,120.0,82,5.28,57,380,2242,9.6,0.15574741
11467,11467,Jamie Pushor,1999-00,26.0,5,3,70,70,1,2,3,75.0,1349.0,214,7,17,24,195.0,82,5.27,57,359,2285,9.4,0.16420409
11468,11468,Jamie Pushor,2000-01,27.0,6,8,62,62,0,8,8,27.0,719.0,276,7,25,32,222.0,82,5.49,53,331,2294,9.8,0.11508462
11469,11469,Jamie Pushor,2001-02,28.0,7,13,75,75,3,10,13,64.0,1561.0,351,10,35,45,286.0,82,5.51,63,376,2272,9.9,0.15974799
11470,11470,Jamie Pushor,2002-03,29.0,8,8,76,76,0,8,8,60.0,1329.0,427,10,43,53,346.0,82,5.24,53,338,2262,9.5,0.14195076
11471,11471,Jamie Pushor,2003-04,30.0,9,4,76,76,3,1,4,54.0,1290.0,503,13,44,57,400.0,82,5.31,60,363,2326,9.4,0.13456059
11472,11472,Jamie Pushor,2004-05,31.0,10,0,14,14,0,0,0,10.0,184.0,517,13,44,57,410.0,82,5.14,57,348,2300,9.2,0.19204742
11473,11473,Jamie Pushor,2006-07,33.0,11,3,4,4,1,2,3,2.0,73.0,521,14,46,60,412.0,82,6.05,85,480,2458,10.1,0.15819159
11474,11474,Jamie Rivers,1996-97,21.0,2,0,3,3,0,0,0,5.0,,3,0,0,0,5.0,82,6.29,74,413,2481,10.4,0.21502173
11475,11475,Jamie Rivers,1997-98,22.0,3,7,15,15,2,5,7,9.0,,18,2,5,7,14.0,82,5.83,55,336,2444,9.8,0.2682694
11476,11476,Jamie Rivers,1998-99,23.0,4,6,59,59,2,4,6,53.0,,77,4,9,13,67.0,82,5.28,57,380,2242,9.6,0.19793382
11477,11477,Jamie Rivers,1999-00,24.0,5,7,76,76,2,5,7,78.0,1077.0,153,6,14,20,145.0,82,5.27,57,359,2285,9.4,0.19263196
11478,11478,Jamie Rivers,2000-01,25.0,6,17,75,75,1,16,17,95.0,1474.0,228,7,30,37,240.0,82,5.49,53,331,2294,9.8,0.21127787
11479,11479,Jamie Rivers,2001-02,26.0,7,6,45,45,2,4,6,41.0,631.0,273,9,34,43,281.0,82,5.51,63,376,2272,9.9,0.17100975
11480,11480,Jamie Rivers,2002-03,27.0,8,6,66,66,4,2,6,51.0,564.0,339,13,36,49,332.0,82,5.24,53,338,2262,9.5,0.1460557
11481,11481,Jamie Rivers,2003-04,28.0,9,0,1,1,0,0,0,2.0,18.0,340,13,36,49,334.0,82,5.31,60,363,2326,9.4,0.18749446
11482,11482,Jamie Rivers,2004-05,29.0,10,7,50,50,3,4,7,31.0,512.0,390,16,40,56,365.0,82,5.14,57,348,2300,9.2,0.14731735
11483,11483,Jamie Rivers,2006-07,31.0,11,6,33,33,0,6,6,36.0,495.0,423,16,46,62,401.0,82,6.05,85,480,2458,10.1,0.14054647
11484,11484,Jamie Rivers,2007-08,32.0,12,4,31,31,1,3,4,17.0,440.0,454,17,49,66,418.0,82,5.76,70,398,2426,9.7,0.116092026
11485,11485,Jamie Tardif,2013-14,29.0,2,0,2,2,0,0,0,1.0,10.0,2,0,0,0,1.0,48,5.31,29,160,1399,9.1,0.1721259
11486,11486,Jamie Wright,1998-99,22.0,2,6,21,21,4,2,6,15.0,,21,4,2,6,15.0,82,5.28,57,380,2242,9.6,0.26875806
11487,11487,Jamie Wright,1999-00,23.0,3,0,11,11,0,0,0,10.0,84.0,32,4,2,6,25.0,82,5.27,57,359,2285,9.4,0.21946546
11488,11488,Jamie Wright,2000-01,24.0,4,5,23,23,1,4,5,15.0,226.0,55,5,6,11,40.0,82,5.49,53,331,2294,9.8,0.17402586
11489,11489,Jamie Wright,2001-02,25.0,5,1,2,2,1,0,1,4.0,22.0,57,6,6,12,44.0,82,5.51,63,376,2272,9.9,0.18831366
11490,11490,Jamie Wright,2002-03,26.0,6,16,44,44,4,12,16,64.0,604.0,101,10,18,28,108.0,82,5.24,53,338,2262,9.5,0.27282703
11491,11491,Jamie Wright,2003-04,27.0,7,4,23,23,2,2,4,18.0,260.0,124,12,20,32,126.0,82,5.31,60,363,2326,9.4,0.16410503
11492,11492,Jan Benda,1998-99,26.0,2,3,9,9,0,3,3,8.0,,9,0,3,3,8.0,82,5.28,57,380,2242,9.6,0.18858424
11493,11493,Jan Bulis,1998-99,20.0,2,16,48,48,5,11,16,37.0,,48,5,11,16,37.0,82,5.28,57,380,2242,9.6,0.3384053
11494,11494,Jan Bulis,1999-00,21.0,3,23,38,38,7,16,23,57.0,549.0,86,12,27,39,94.0,82,5.27,57,359,2285,9.4,0.4859841
11495,11495,Jan Bulis,2000-01,22.0,4,31,56,56,9,22,31,92.0,780.0,142,21,49,70,186.0,82,5.49,53,331,2294,9.8,0.51511675
11496,11496,Jan Bulis,2001-02,23.0,5,23,51,51,5,18,23,61.0,685.0,193,26,67,93,247.0,82,5.51,63,376,2272,9.9,0.40319178
11497,11497,Jan Bulis,2002-03,24.0,6,19,53,53,9,10,19,87.0,719.0,246,35,77,112,334.0,82,5.24,53,338,2262,9.5,0.43495354
11498,11498,Jan Bulis,2003-04,25.0,7,40,82,82,16,24,40,160.0,1288.0,328,51,101,152,494.0,82,5.31,60,363,2326,9.4,0.54697776
11499,11499,Jan Bulis,2004-05,26.0,8,30,72,72,13,17,30,147.0,1232.0,400,64,118,182,641.0,82,5.14,57,348,2300,9.2,0.53065866
11500,11500,Jan Bulis,2006-07,28.0,9,40,73,73,20,20,40,131.0,1141.0,473,84,138,222,772.0,82,6.05,85,480,2458,10.1,0.4741193
11501,11501,Jan Bulis,2007-08,29.0,10,23,79,79,12,11,23,122.0,1136.0,552,96,149,245,894.0,82,5.76,70,398,2426,9.7,0.297014
11502,11502,Jan Caloun,1996-97,24.0,2,11,11,11,8,3,11,20.0,,11,8,3,11,20.0,82,6.29,74,413,2481,10.4,0.37920517
11503,11503,Jan Caloun,1997-98,25.0,3,0,2,2,0,0,0,3.0,,13,8,3,11,23.0,82,5.83,55,336,2444,9.8,0.16054052
11504,11504,Jan Caloun,2001-02,29.0,4,3,11,11,0,3,3,14.0,139.0,24,8,6,14,37.0,82,5.51,63,376,2272,9.9,0.20307305
11505,11505,Jan Erixon,1984-85,22.0,2,30,75,75,5,25,30,94.0,,75,5,25,30,94.0,80,7.89,74,336,2448,12.9,0.4396545
11506,11506,Jan Erixon,1985-86,23.0,3,29,66,66,7,22,29,72.0,,141,12,47,59,166.0,80,7.77,71,321,2447,12.7,0.42477486
11507,11507,Jan Erixon,1986-87,24.0,4,19,31,31,2,17,19,33.0,,172,14,64,78,199.0,80,7.94,82,370,2484,12.8,0.45781857
11508,11508,Jan Erixon,1987-88,25.0,5,26,68,68,8,18,26,73.0,,240,22,82,104,272.0,80,7.34,72,344,2400,12.2,0.39635462
11509,11509,Jan Erixon,1988-89,26.0,6,26,70,70,7,19,26,99.0,,310,29,101,130,371.0,80,7.43,89,437,2435,12.2,0.442825
11510,11510,Jan Erixon,1989-90,27.0,7,15,44,44,4,11,15,41.0,,354,33,112,145,412.0,80,7.48,85,403,2430,12.3,0.34622002
11511,11511,Jan Erixon,1990-91,28.0,8,13,58,58,4,9,13,61.0,,412,37,121,158,473.0,80,7.37,76,367,2421,12.2,0.2721194
11512,11512,Jan Erixon,1991-92,29.0,9,25,53,53,7,18,25,40.0,,465,44,139,183,513.0,80,6.91,71,366,2385,11.6,0.40002245
11513,11513,Jan Erixon,1992-93,30.0,10,17,46,46,8,9,17,51.0,,511,52,148,200,564.0,80,6.96,77,402,2440,11.4,0.34236962
11514,11514,Jan Erixon,1993-94,31.0,11,16,45,45,5,11,16,36.0,,556,57,159,216,600.0,84,7.25,87,443,2603,11.7,0.26641324
11515,11515,Jan Hejda,2007-08,29.0,2,9,39,39,1,8,9,33.0,795.0,39,1,8,9,33.0,82,5.76,70,398,2426,9.7,0.16733506
11516,11516,Jan Hejda,2008-09,30.0,3,13,81,81,0,13,13,71.0,1711.0,120,1,21,22,104.0,82,5.44,62,351,2383,9.4,0.14273757
11517,11517,Jan Hejda,2009-10,31.0,4,21,82,82,3,18,21,66.0,1835.0,202,4,39,43,170.0,82,5.7,65,341,2477,9.4,0.20248583
11518,11518,Jan Hejda,2010-11,32.0,5,13,62,62,3,10,13,63.0,1280.0,264,7,49,56,233.0,82,5.53,56,304,2486,9.1,0.16651192
11519,11519,Jan Hejda,2011-12,33.0,6,20,77,77,5,15,20,79.0,1626.0,341,12,64,76,312.0,82,5.46,52,291,2492,9.0,0.22760439
11520,11520,Jan Hejda,2012-13,34.0,7,19,81,81,5,14,19,78.0,1675.0,422,17,78,95,390.0,82,5.32,47,271,2439,8.9,0.22283876
11521,11521,Jan Hejda,2013-14,35.0,8,10,46,46,1,9,10,50.0,906.0,468,18,87,105,440.0,48,5.31,29,160,1399,9.1,0.21195221
11522,11522,Jan Hejda,2014-15,36.0,9,17,78,78,6,11,17,75.0,1741.0,546,24,98,122,515.0,82,5.34,48,269,2463,8.9,0.21222469
11523,11523,Jan Hejda,2015-16,37.0,10,13,81,81,1,12,13,84.0,1673.0,627,25,110,135,599.0,82,5.32,47,251,2453,8.9,0.14779663
11524,11524,Jan Hlavac,2000-01,24.0,2,42,67,67,19,23,42,134.0,1015.0,67,19,23,42,134.0,82,5.49,53,331,2294,9.8,0.5860688
11525,11525,Jan Hlavac,2001-02,25.0,3,64,79,79,28,36,64,195.0,1314.0,146,47,59,106,329.0,82,5.51,63,376,2272,9.9,0.71596026
11526,11526,Jan Hlavac,2002-03,26.0,4,31,77,77,16,15,31,132.0,1070.0,223,63,74,137,461.0,82,5.24,53,338,2262,9.5,0.50760907
11527,11527,Jan Hlavac,2003-04,27.0,5,26,61,61,10,16,26,123.0,991.0,284,73,90,163,584.0,82,5.31,60,363,2326,9.4,0.45779282
11528,11528,Jan Hlavac,2004-05,28.0,6,26,72,72,5,21,26,125.0,999.0,356,78,111,189,709.0,82,5.14,57,348,2300,9.2,0.4543165
11529,11529,Jan Hlavac,2008-09,32.0,7,35,80,80,12,23,35,152.0,1212.0,436,90,134,224,861.0,82,5.44,62,351,2383,9.4,0.41265365
11530,11530,Jan Hrdina,1999-00,23.0,2,42,82,82,13,29,42,94.0,1348.0,82,13,29,42,94.0,82,5.27,57,359,2285,9.4,0.52211976
11531,11531,Jan Hrdina,2000-01,24.0,3,46,70,70,13,33,46,84.0,1315.0,152,26,62,88,178.0,82,5.49,53,331,2294,9.8,0.56985474
11532,11532,Jan Hrdina,2001-02,25.0,4,43,78,78,15,28,43,89.0,1242.0,230,41,90,131,267.0,82,5.51,63,376,2272,9.9,0.5576177
11533,11533,Jan Hrdina,2002-03,26.0,5,57,79,79,24,33,57,115.0,1568.0,309,65,123,188,382.0,82,5.24,53,338,2262,9.5,0.6954973
11534,11534,Jan Hrdina,2003-04,27.0,6,43,61,61,14,29,43,86.0,1199.0,370,79,152,231,468.0,82,5.31,60,363,2326,9.4,0.54482025
11535,11535,Jan Hrdina,2004-05,28.0,7,33,68,68,12,21,33,73.0,1155.0,438,91,173,264,541.0,82,5.14,57,348,2300,9.2,0.5108076
11536,11536,Jan Hrdina,2006-07,30.0,8,33,75,75,10,23,33,78.0,1272.0,513,101,196,297,619.0,82,6.05,85,480,2458,10.1,0.42151278
11537,11537,Jan Ludvig,1983-84,22.0,2,17,51,51,7,10,17,105.0,,51,7,10,17,105.0,80,7.73,71,310,2444,12.7,0.42892012
11538,11538,Jan Ludvig,1984-85,23.0,3,54,74,74,22,32,54,176.0,,125,29,42,71,281.0,80,7.89,74,336,2448,12.9,0.66568094
11539,11539,Jan Ludvig,1985-86,24.0,4,31,74,74,12,19,31,134.0,,199,41,61,102,415.0,80,7.77,71,321,2447,12.7,0.4790827
11540,11540,Jan Ludvig,1986-87,25.0,5,14,42,42,5,9,14,72.0,,241,46,70,116,487.0,80,7.94,82,370,2484,12.8,0.39396513
11541,11541,Jan Ludvig,1987-88,26.0,6,16,47,47,7,9,16,56.0,,288,53,79,132,543.0,80,7.34,72,344,2400,12.2,0.37830558
11542,11542,Jan Ludvig,1988-89,27.0,7,7,13,13,1,6,7,13.0,,301,54,85,139,556.0,80,7.43,89,437,2435,12.2,0.25798196
11543,11543,Jan Ludvig,1989-90,28.0,8,2,13,13,0,2,2,11.0,,314,54,87,141,567.0,80,7.48,85,403,2430,12.3,0.23908395
11544,11544,Jan Mertzig,1999-00,29.0,2,2,23,23,0,2,2,10.0,277.0,23,0,2,2,10.0,82,5.27,57,359,2285,9.4,0.1141198
11545,11545,Jan Mursak ,2011-12,24.0,2,1,19,19,1,0,1,20.0,156.0,19,1,0,1,20.0,82,5.46,52,291,2492,9.0,0.17317122
11546,11546,Jan Mursak ,2012-13,25.0,3,3,25,25,1,2,3,22.0,189.0,44,2,2,4,42.0,82,5.32,47,271,2439,8.9,0.16113585
11547,11547,Jan Mursak ,2013-14,26.0,4,0,2,2,0,0,0,0.0,11.0,46,2,2,4,42.0,48,5.31,29,160,1399,9.1,0.15980726
11548,11548,Jan Nemecek,1999-00,23.0,2,1,6,6,1,0,1,8.0,100.0,6,1,0,1,8.0,82,5.27,57,359,2285,9.4,0.22954798
11549,11549,Jan Nemecek,2000-01,24.0,3,0,1,1,0,0,0,0.0,10.0,7,1,0,1,8.0,82,5.49,53,331,2294,9.8,0.15365982
11550,11550,Jan Rutta,2018-19,28.0,2,20,57,57,6,14,20,71.0,1098.0,57,6,14,20,71.0,82,5.86,50,250,2620,9.2,0.28524235
11551,11551,Jan Rutta,2019-20,29.0,3,8,37,37,2,6,8,42.0,577.0,94,8,20,28,113.0,82,5.96,47,239,2579,9.5,0.204916
11552,11552,Jan Rutta,2020-21,30.0,4,7,33,33,1,6,7,43.0,513.0,127,9,26,35,156.0,70,5.96,42,208,2192,9.5,0.20184475
11553,11553,Jan Vopat,1996-97,23.0,2,5,11,11,1,4,5,13.0,,11,1,4,5,13.0,82,6.29,74,413,2481,10.4,0.2433044
11554,11554,Jan Vopat,1997-98,24.0,3,9,33,33,4,5,9,44.0,,44,5,9,14,57.0,82,5.83,55,336,2444,9.8,0.23405167
11555,11555,Jan Vopat,1998-99,25.0,4,6,21,21,1,5,6,13.0,,65,6,14,20,70.0,82,5.28,57,380,2242,9.6,0.16140574
11556,11556,Jan Vopat,1999-00,26.0,5,11,55,55,5,6,11,46.0,995.0,120,11,20,31,116.0,82,5.27,57,359,2285,9.4,0.21217293
11557,11557,Jan Vopat,2000-01,27.0,6,0,6,6,0,0,0,3.0,108.0,126,11,20,31,119.0,82,5.49,53,331,2294,9.8,0.12513375
11558,11558,Jani Hakanpaa,2020-21,28.0,2,1,5,5,1,0,1,4.0,91.0,5,1,0,1,4.0,70,5.96,42,208,2192,9.5,0.19446155
11559,11559,Jani Rita,2002-03,21.0,2,0,1,1,0,0,0,0.0,6.0,1,0,0,0,0.0,82,5.24,53,338,2262,9.5,0.17350736
11560,11560,Jani Rita,2003-04,22.0,3,4,12,12,3,1,4,18.0,114.0,13,3,1,4,18.0,82,5.31,60,363,2326,9.4,0.27699047
11561,11561,Jani Rita,2004-05,23.0,4,0,2,2,0,0,0,1.0,9.0,15,3,1,4,19.0,82,5.14,57,348,2300,9.2,0.18934488
11562,11562,Jani Rita,2006-07,25.0,5,10,51,51,6,4,10,49.0,445.0,66,9,5,14,68.0,82,6.05,85,480,2458,10.1,0.21197334
11563,11563,Janis Sprukts,2007-08,26.0,2,3,13,13,1,2,3,10.0,82.0,13,1,2,3,10.0,82,5.76,70,398,2426,9.7,0.21209735
11564,11564,Janis Sprukts,2009-10,28.0,3,0,1,1,0,0,0,1.0,12.0,14,1,2,3,11.0,82,5.7,65,341,2477,9.4,0.15920332
11565,11565,Janne Kuokkanen,2018-19,20.0,2,0,4,4,0,0,0,6.0,44.0,4,0,0,0,6.0,82,5.86,50,250,2620,9.2,0.23370415
11566,11566,Janne Kuokkanen,2019-20,21.0,3,0,7,7,0,0,0,6.0,76.0,11,0,0,0,12.0,82,5.96,47,239,2579,9.5,0.21496105
11567,11567,Janne Kuokkanen,2020-21,22.0,4,0,1,1,0,0,0,0.0,12.0,12,0,0,0,12.0,70,5.96,42,208,2192,9.5,0.19275656
11568,11568,Janne Laukkanen,1995-96,25.0,2,3,11,11,0,3,3,12.0,,11,0,3,3,12.0,48,5.97,37,209,1408,10.2,0.22948867
11569,11569,Janne Laukkanen,1996-97,26.0,3,3,23,23,1,2,3,35.0,,34,1,5,6,47.0,82,6.29,74,413,2481,10.4,0.19814852
11570,11570,Janne Laukkanen,1997-98,27.0,4,21,76,76,3,18,21,109.0,,110,4,23,27,156.0,82,5.83,55,336,2444,9.8,0.24908566
11571,11571,Janne Laukkanen,1998-99,28.0,5,21,60,60,4,17,21,69.0,,170,8,40,48,225.0,82,5.28,57,380,2242,9.6,0.25882185
11572,11572,Janne Laukkanen,1999-00,29.0,6,12,50,50,1,11,12,46.0,931.0,220,9,51,60,271.0,82,5.27,57,359,2285,9.4,0.19288877
11573,11573,Janne Laukkanen,2000-01,30.0,7,20,71,71,2,18,20,81.0,1373.0,291,11,69,80,352.0,82,5.49,53,331,2294,9.8,0.25146306
11574,11574,Janne Laukkanen,2001-02,31.0,8,20,50,50,3,17,20,58.0,923.0,341,14,86,100,410.0,82,5.51,63,376,2272,9.9,0.30424654
11575,11575,Janne Laukkanen,2002-03,32.0,9,13,47,47,6,7,13,66.0,839.0,388,20,93,113,476.0,82,5.24,53,338,2262,9.5,0.27726787
11576,11576,Janne Laukkanen,2003-04,33.0,10,8,19,19,2,6,8,12.0,323.0,407,22,99,121,488.0,82,5.31,60,363,2326,9.4,0.1965048
11577,11577,Janne Niinimaa,1997-98,22.0,2,44,77,77,4,40,44,141.0,,77,4,40,44,141.0,82,5.83,55,336,2444,9.8,0.5173516
11578,11578,Janne Niinimaa,1998-99,23.0,3,43,77,77,4,39,43,134.0,,154,8,79,87,275.0,82,5.28,57,380,2242,9.6,0.48783022
11579,11579,Janne Niinimaa,1999-00,24.0,4,28,81,81,4,24,28,142.0,1936.0,235,12,103,115,417.0,82,5.27,57,359,2285,9.4,0.43126214
11580,11580,Janne Niinimaa,2000-01,25.0,5,33,81,81,8,25,33,133.0,1982.0,316,20,128,148,550.0,82,5.49,53,331,2294,9.8,0.4893272
11581,11581,Janne Niinimaa,2001-02,26.0,6,46,82,82,12,34,46,122.0,2078.0,398,32,162,194,672.0,82,5.51,63,376,2272,9.9,0.5428748
11582,11582,Janne Niinimaa,2002-03,27.0,7,44,81,81,5,39,44,119.0,2108.0,479,37,201,238,791.0,82,5.24,53,338,2262,9.5,0.51425177
11583,11583,Janne Niinimaa,2003-04,28.0,8,34,76,76,5,29,34,101.0,1988.0,555,42,230,272,892.0,82,5.31,60,363,2326,9.4,0.41469765
11584,11584,Janne Niinimaa,2004-05,29.0,9,28,82,82,9,19,28,97.0,1907.0,637,51,249,300,989.0,82,5.14,57,348,2300,9.2,0.36654124
11585,11585,Janne Niinimaa,2006-07,31.0,10,16,63,63,3,13,16,49.0,1246.0,700,54,262,316,1038.0,82,6.05,85,480,2458,10.1,0.2168532
11586,11586,Janne Niinimaa,2007-08,32.0,11,3,41,41,0,3,3,29.0,609.0,741,54,265,319,1067.0,82,5.76,70,398,2426,9.7,0.15432951
11587,11587,Janne Niskala,2009-10,28.0,2,3,6,6,1,2,3,10.0,82.0,6,1,2,3,10.0,82,5.7,65,341,2477,9.4,0.23340863
11588,11588,Janne Ojanen,1989-90,21.0,2,1,3,3,0,1,1,1.0,,3,0,1,1,1.0,80,7.48,85,403,2430,12.3,0.28862292
11589,11589,Janne Ojanen,1990-91,22.0,3,30,64,64,17,13,30,76.0,,67,17,14,31,77.0,80,7.37,76,367,2421,12.2,0.4708395
11590,11590,Janne Ojanen,1993-94,25.0,4,13,31,31,4,9,13,44.0,,98,21,23,44,121.0,84,7.25,87,443,2603,11.7,0.33689922
11591,11591,Janne Pesonen,2009-10,27.0,2,0,7,7,0,0,0,3.0,52.0,7,0,0,0,3.0,82,5.7,65,341,2477,9.4,0.1468429
11592,11592,Jannik Hansen,2008-09,22.0,2,0,5,5,0,0,0,3.0,58.0,5,0,0,0,3.0,82,5.44,62,351,2383,9.4,0.18366352
11593,11593,Jannik Hansen,2009-10,23.0,3,21,55,55,6,15,21,64.0,688.0,60,6,15,21,67.0,82,5.7,65,341,2477,9.4,0.35201442
11594,11594,Jannik Hansen,2010-11,24.0,4,15,47,47,9,6,15,67.0,580.0,107,15,21,36,134.0,82,5.53,56,304,2486,9.1,0.32148677
11595,11595,Jannik Hansen,2011-12,25.0,5,29,82,82,9,20,29,113.0,1206.0,189,24,41,65,247.0,82,5.46,52,291,2492,9.0,0.34960026
11596,11596,Jannik Hansen,2012-13,26.0,6,39,82,82,16,23,39,137.0,1222.0,271,40,64,104,384.0,82,5.32,47,271,2439,8.9,0.48829758
11597,11597,Jannik Hansen,2013-14,27.0,7,27,47,47,10,17,27,99.0,825.0,318,50,81,131,483.0,48,5.31,29,160,1399,9.1,0.4847224
11598,11598,Jannik Hansen,2014-15,28.0,8,20,71,71,11,9,20,112.0,1112.0,389,61,90,151,595.0,82,5.34,48,269,2463,8.9,0.31979603
11599,11599,Jannik Hansen,2015-16,29.0,9,33,81,81,16,17,33,145.0,1132.0,470,77,107,184,740.0,82,5.32,47,251,2453,8.9,0.41767064
11600,11600,Jannik Hansen,2016-17,30.0,10,38,67,67,22,16,38,117.0,1101.0,537,99,123,222,857.0,82,5.34,48,255,2438,9.0,0.4559828
11601,11601,Jannik Hansen,2017-18,31.0,11,20,43,43,8,12,20,73.0,690.0,580,107,135,242,930.0,82,5.45,47,245,2478,9.0,0.38383856
11602,11602,Jannik Hansen,2018-19,32.0,12,14,46,46,2,12,14,54.0,554.0,626,109,147,256,984.0,82,5.86,50,250,2620,9.2,0.23640892
11603,11603,Jansen Harkins,2020-21,23.0,2,7,29,29,2,5,7,29.0,308.0,29,2,5,7,29.0,70,5.96,42,208,2192,9.5,0.26643783
11604,11604,Jared Aulin,2003-04,21.0,2,4,17,17,2,2,4,21.0,169.0,17,2,2,4,21.0,82,5.31,60,363,2326,9.4,0.2964036
11605,11605,Jared Boll,2008-09,22.0,2,10,75,75,5,5,10,63.0,601.0,75,5,5,10,63.0,82,5.44,62,351,2383,9.4,0.21713647
11606,11606,Jared Boll,2009-10,23.0,3,14,75,75,4,10,14,73.0,667.0,150,9,15,24,136.0,82,5.7,65,341,2477,9.4,0.21996942
11607,11607,Jared Boll,2010-11,24.0,4,7,68,68,4,3,7,56.0,490.0,218,13,18,31,192.0,82,5.53,56,304,2486,9.1,0.17546928
11608,11608,Jared Boll,2011-12,25.0,5,12,73,73,7,5,12,66.0,560.0,291,20,23,43,258.0,82,5.46,52,291,2492,9.0,0.19174886
11609,11609,Jared Boll,2012-13,26.0,6,3,54,54,2,1,3,35.0,438.0,345,22,24,46,293.0,82,5.32,47,271,2439,8.9,0.15372398
11610,11610,Jared Boll,2013-14,27.0,7,6,43,43,2,4,6,19.0,348.0,388,24,28,52,312.0,48,5.31,29,160,1399,9.1,0.1287516
11611,11611,Jared Boll,2014-15,28.0,8,2,28,28,1,1,2,12.0,214.0,416,25,29,54,324.0,82,5.34,48,269,2463,8.9,0.116427034
11612,11612,Jared Boll,2015-16,29.0,9,5,72,72,1,4,5,28.0,524.0,488,26,33,59,352.0,82,5.32,47,251,2453,8.9,0.10538033
11613,11613,Jared Boll,2016-17,30.0,10,3,30,30,1,2,3,11.0,200.0,518,27,35,62,363.0,82,5.34,48,255,2438,9.0,0.11758354
11614,11614,Jared Boll,2017-18,31.0,11,3,51,51,0,3,3,13.0,297.0,569,27,38,65,376.0,82,5.45,47,245,2478,9.0,0.06815061
11615,11615,Jared Boll,2018-19,32.0,12,1,10,10,1,0,1,4.0,44.0,579,28,38,66,380.0,82,5.86,50,250,2620,9.2,0.13411787
11616,11616,Jared Cowen,2010-11,20.0,2,0,1,1,0,0,0,0.0,7.0,1,0,0,0,0.0,82,5.53,56,304,2486,9.1,0.23860925
11617,11617,Jared Cowen,2012-13,22.0,3,17,82,82,5,12,17,58.0,1549.0,83,5,12,17,58.0,82,5.32,47,271,2439,8.9,0.22905514
11618,11618,Jared Cowen,2013-14,23.0,4,1,7,7,1,0,1,8.0,142.0,90,6,12,18,66.0,48,5.31,29,160,1399,9.1,0.22973108
11619,11619,Jared Cowen,2014-15,24.0,5,15,68,68,6,9,15,68.0,1395.0,158,12,21,33,134.0,82,5.34,48,269,2463,8.9,0.2005328
11620,11620,Jared Cowen,2015-16,25.0,6,9,54,54,3,6,9,47.0,980.0,212,15,27,42,181.0,82,5.32,47,251,2453,8.9,0.1559042
11621,11621,Jared Cowen,2016-17,26.0,7,4,37,37,0,4,4,23.0,628.0,249,15,31,46,204.0,82,5.34,48,255,2438,9.0,0.14374349
11622,11622,Jared McCann,2016-17,20.0,2,18,69,69,9,9,18,106.0,864.0,69,9,9,18,106.0,82,5.34,48,255,2438,9.0,0.3371927
11623,11623,Jared McCann,2017-18,21.0,3,7,29,29,1,6,7,44.0,337.0,98,10,15,25,150.0,82,5.45,47,245,2478,9.0,0.3542194
11624,11624,Jared McCann,2018-19,22.0,4,28,68,68,9,19,28,143.0,901.0,166,19,34,53,293.0,82,5.86,50,250,2620,9.2,0.41429406
11625,11625,Jared McCann,2019-20,23.0,5,35,78,78,19,16,35,150.0,1133.0,244,38,50,88,443.0,82,5.96,47,239,2579,9.5,0.48187768
11626,11626,Jared McCann,2020-21,24.0,6,35,66,66,14,21,35,150.0,1006.0,310,52,71,123,593.0,70,5.96,42,208,2192,9.5,0.49914822
11627,11627,Jared Ross,2009-10,27.0,2,0,10,10,0,0,0,12.0,77.0,10,0,0,0,12.0,82,5.7,65,341,2477,9.4,0.19238669
11628,11628,Jared Ross,2010-11,28.0,3,0,3,3,0,0,0,4.0,23.0,13,0,0,0,16.0,82,5.53,56,304,2486,9.1,0.15754405
11629,11629,Jared Spurgeon,2011-12,22.0,2,12,53,53,4,8,12,38.0,799.0,53,4,8,12,38.0,82,5.46,52,291,2492,9.0,0.2287167
11630,11630,Jared Spurgeon,2012-13,23.0,3,23,70,70,3,20,23,92.0,1512.0,123,7,28,35,130.0,82,5.32,47,271,2439,8.9,0.28627956
11631,11631,Jared Spurgeon,2013-14,24.0,4,15,39,39,5,10,15,67.0,840.0,162,12,38,50,197.0,48,5.31,29,160,1399,9.1,0.36804098
11632,11632,Jared Spurgeon,2014-15,25.0,5,26,67,67,5,21,26,91.0,1517.0,229,17,59,76,288.0,82,5.34,48,269,2463,8.9,0.3222646
11633,11633,Jared Spurgeon,2015-16,26.0,6,25,66,66,9,16,25,128.0,1493.0,295,26,75,101,416.0,82,5.32,47,251,2453,8.9,0.33562374
11634,11634,Jared Spurgeon,2016-17,27.0,7,29,77,77,11,18,29,122.0,1746.0,372,37,93,130,538.0,82,5.34,48,255,2438,9.0,0.35578594
11635,11635,Jared Spurgeon,2017-18,28.0,8,38,76,76,10,28,38,144.0,1827.0,448,47,121,168,682.0,82,5.45,47,245,2478,9.0,0.4518329
11636,11636,Jared Spurgeon,2018-19,29.0,9,37,61,61,9,28,37,110.0,1497.0,509,56,149,205,792.0,82,5.86,50,250,2620,9.2,0.4948739
11637,11637,Jared Spurgeon,2019-20,30.0,10,43,82,82,14,29,43,152.0,1980.0,591,70,178,248,944.0,82,5.96,47,239,2579,9.5,0.4769571
11638,11638,Jared Spurgeon,2020-21,31.0,11,32,62,62,12,20,32,112.0,1400.0,653,82,198,280,1056.0,70,5.96,42,208,2192,9.5,0.45831323
11639,11639,Jared Staal,2013-14,23.0,2,0,2,2,0,0,0,3.0,27.0,2,0,0,0,3.0,48,5.31,29,160,1399,9.1,0.19961703
11640,11640,Jaret Anderson-Dolan,2019-20,20.0,2,1,5,5,0,1,1,6.0,58.0,5,0,1,1,6.0,82,5.96,47,239,2579,9.5,0.2861248
11641,11641,Jaret Anderson-Dolan,2020-21,21.0,3,0,4,4,0,0,0,2.0,41.0,9,0,1,1,8.0,70,5.96,42,208,2192,9.5,0.23359078
11642,11642,Jari Gronstrand,1987-88,25.0,2,7,47,47,1,6,7,32.0,,47,1,6,7,32.0,80,7.34,72,344,2400,12.2,0.19664216
11643,11643,Jari Gronstrand,1988-89,26.0,3,14,62,62,3,11,14,65.0,,109,4,17,21,97.0,80,7.43,89,437,2435,12.2,0.25021958
11644,11644,Jari Gronstrand,1989-90,27.0,4,4,25,25,1,3,4,18.0,,134,5,20,25,115.0,80,7.48,85,403,2430,12.3,0.1610522
11645,11645,Jari Gronstrand,1990-91,28.0,5,8,48,48,3,5,8,26.0,,182,8,25,33,141.0,80,7.37,76,367,2421,12.2,0.1442982
11646,11646,Jari Gronstrand,1991-92,29.0,6,1,3,3,0,1,1,1.0,,185,8,26,34,142.0,80,6.91,71,366,2385,11.6,0.15003657
11647,11647,Jari Kurri,1981-82,21.0,2,75,75,75,32,43,75,202.0,,75,32,43,75,202.0,80,7.69,77,340,2441,12.6,1.0524471
11648,11648,Jari Kurri,1982-83,22.0,3,86,71,71,32,54,86,211.0,,146,64,97,161,413.0,80,8.03,73,320,2489,12.9,1.1424797
11649,11649,Jari Kurri,1983-84,23.0,4,104,80,80,45,59,104,218.0,,226,109,156,265,631.0,80,7.73,71,310,2444,12.7,1.2960467
11650,11650,Jari Kurri,1984-85,24.0,5,113,64,64,52,61,113,195.0,,290,161,217,378,826.0,80,7.89,74,336,2448,12.9,1.6949376
11651,11651,Jari Kurri,1985-86,25.0,6,135,73,73,71,64,135,267.0,,363,232,281,513,1093.0,80,7.77,71,321,2447,12.7,1.6209882
11652,11652,Jari Kurri,1986-87,26.0,7,131,78,78,68,63,131,236.0,,441,300,344,644,1329.0,80,7.94,82,370,2484,12.8,1.3249556
11653,11653,Jari Kurri,1987-88,27.0,8,108,79,79,54,54,108,211.0,,520,354,398,752,1540.0,80,7.34,72,344,2400,12.2,1.2446893
11654,11654,Jari Kurri,1988-89,28.0,9,96,80,80,43,53,96,207.0,,600,397,451,848,1747.0,80,7.43,89,437,2435,12.2,1.1394758
11655,11655,Jari Kurri,1989-90,29.0,10,102,76,76,44,58,102,214.0,,676,441,509,950,1961.0,80,7.48,85,403,2430,12.3,1.1992326
11656,11656,Jari Kurri,1990-91,30.0,11,93,78,78,33,60,93,201.0,,754,474,569,1043,2162.0,80,7.37,76,367,2421,12.2,1.0802424
11657,11657,Jari Kurri,1992-93,32.0,12,60,73,73,23,37,60,167.0,,827,497,606,1103,2329.0,80,6.96,77,402,2440,11.4,0.83065546
11658,11658,Jari Kurri,1993-94,33.0,13,87,82,82,27,60,87,210.0,,909,524,666,1190,2539.0,84,7.25,87,443,2603,11.7,0.9096215
11659,11659,Jari Kurri,1994-95,34.0,14,77,81,81,31,46,77,198.0,,990,555,712,1267,2737.0,84,6.48,76,407,2545,10.7,0.80209154
11660,11660,Jari Kurri,1995-96,35.0,15,29,38,38,10,19,29,84.0,,1028,565,731,1296,2821.0,48,5.97,37,209,1408,10.2,0.6462182
11661,11661,Jari Kurri,1996-97,36.0,16,45,71,71,18,27,45,158.0,,1099,583,758,1341,2979.0,82,6.29,74,413,2481,10.4,0.5377755
11662,11662,Jari Kurri,1997-98,37.0,17,35,82,82,13,22,35,109.0,,1181,596,780,1376,3088.0,82,5.83,55,336,2444,9.8,0.4286337
11663,11663,Jari Kurri,1998-99,38.0,18,22,70,70,5,17,22,61.0,,1251,601,797,1398,3149.0,82,5.28,57,380,2242,9.6,0.3436278
11664,11664,Jari Torkki,1989-90,24.0,2,1,4,4,1,0,1,2.0,,4,1,0,1,2.0,80,7.48,85,403,2430,12.3,0.2544242
11665,11665,Jarkko Immonen,2006-07,24.0,2,2,6,6,2,0,2,8.0,62.0,6,2,0,2,8.0,82,6.05,85,480,2458,10.1,0.23103046
11666,11666,Jarkko Immonen,2007-08,25.0,3,6,14,14,1,5,6,14.0,145.0,20,3,5,8,22.0,82,5.76,70,398,2426,9.7,0.20560277
11667,11667,Jarkko Ruutu,2000-01,25.0,2,1,8,8,0,1,1,4.0,70.0,8,0,1,1,4.0,82,5.49,53,331,2294,9.8,0.17461655
11668,11668,Jarkko Ruutu,2001-02,26.0,3,6,21,21,3,3,6,23.0,224.0,29,3,4,7,27.0,82,5.51,63,376,2272,9.9,0.23123765
11669,11669,Jarkko Ruutu,2002-03,27.0,4,9,49,49,2,7,9,37.0,499.0,78,5,11,16,64.0,82,5.24,53,338,2262,9.5,0.15498751
11670,11670,Jarkko Ruutu,2003-04,28.0,5,4,36,36,2,2,4,36.0,323.0,114,7,13,20,100.0,82,5.31,60,363,2326,9.4,0.17962694
11671,11671,Jarkko Ruutu,2004-05,29.0,6,14,71,71,6,8,14,70.0,815.0,185,13,21,34,170.0,82,5.14,57,348,2300,9.2,0.1964994
11672,11672,Jarkko Ruutu,2006-07,31.0,7,17,82,82,10,7,17,85.0,960.0,267,23,28,51,255.0,82,6.05,85,480,2458,10.1,0.21106818
11673,11673,Jarkko Ruutu,2007-08,32.0,8,16,81,81,7,9,16,63.0,756.0,348,30,37,67,318.0,82,5.76,70,398,2426,9.7,0.1859068
11674,11674,Jarkko Ruutu,2008-09,33.0,9,16,71,71,6,10,16,55.0,725.0,419,36,47,83,373.0,82,5.44,62,351,2383,9.4,0.1885857
11675,11675,Jarkko Ruutu,2009-10,34.0,10,21,78,78,7,14,21,89.0,913.0,497,43,61,104,462.0,82,5.7,65,341,2477,9.4,0.23782587
11676,11676,Jarkko Ruutu,2010-11,35.0,11,26,82,82,12,14,26,106.0,1095.0,579,55,75,130,568.0,82,5.53,56,304,2486,9.1,0.27368835
11677,11677,Jarkko Ruutu,2011-12,36.0,12,12,73,73,3,9,12,66.0,830.0,652,58,84,142,634.0,82,5.46,52,291,2492,9.0,0.15182531
11678,11678,Jarkko Varvio,1994-95,22.0,2,5,8,8,2,3,5,17.0,,8,2,3,5,17.0,84,6.48,76,407,2545,10.7,0.30314195
11679,11679,Jarkko Varvio,1995-96,23.0,3,2,5,5,1,1,2,9.0,,13,3,4,7,26.0,48,5.97,37,209,1408,10.2,0.25995153
11680,11680,Jarmo Kekalainen,1990-91,24.0,2,4,11,11,2,2,4,7.0,,11,2,2,4,7.0,80,7.37,76,367,2421,12.2,0.2926686
11681,11681,Jarmo Kekalainen,1991-92,25.0,3,3,16,16,2,1,3,12.0,,27,4,3,7,19.0,80,6.91,71,366,2385,11.6,0.26196563
11682,11682,Jarmo Kekalainen,1994-95,28.0,4,6,28,28,1,5,6,18.0,,55,5,8,13,37.0,84,6.48,76,407,2545,10.7,0.15766829
11683,11683,Jarno Kultanen,2001-02,29.0,2,10,62,62,2,8,10,76.0,1208.0,62,2,8,10,76.0,82,5.51,63,376,2272,9.9,0.17970464
11684,11684,Jarno Kultanen,2002-03,30.0,3,3,38,38,0,3,3,31.0,493.0,100,2,11,13,107.0,82,5.24,53,338,2262,9.5,0.12088725
11685,11685,Jarno Kultanen,2003-04,31.0,4,0,2,2,0,0,0,3.0,21.0,102,2,11,13,110.0,82,5.31,60,363,2326,9.4,0.14030132
11686,11686,Jarod Palmer,2012-13,26.0,2,1,6,6,1,0,1,14.0,80.0,6,1,0,1,14.0,82,5.32,47,271,2439,8.9,0.1998446
11687,11687,Jarome Iginla,1997-98,20.0,2,50,82,82,21,29,50,169.0,,82,21,29,50,169.0,82,5.83,55,336,2444,9.8,0.64500904
11688,11688,Jarome Iginla,1998-99,21.0,3,32,70,70,13,19,32,154.0,,152,34,48,82,323.0,82,5.28,57,380,2242,9.6,0.5557777
11689,11689,Jarome Iginla,1999-00,22.0,4,51,82,82,28,23,51,211.0,1353.0,234,62,71,133,534.0,82,5.27,57,359,2285,9.4,0.71185434
11690,11690,Jarome Iginla,2000-01,23.0,5,63,77,77,29,34,63,256.0,1417.0,311,91,105,196,790.0,82,5.49,53,331,2294,9.8,0.8371854
11691,11691,Jarome Iginla,2001-02,24.0,6,71,77,77,31,40,71,229.0,1537.0,388,122,145,267,1019.0,82,5.51,63,376,2272,9.9,0.8763163
11692,11692,Jarome Iginla,2002-03,25.0,7,96,82,82,52,44,96,311.0,1834.0,470,174,189,363,1330.0,82,5.24,53,338,2262,9.5,1.0341123
11693,11693,Jarome Iginla,2003-04,26.0,8,67,75,75,35,32,67,316.0,1607.0,545,209,221,430,1646.0,82,5.31,60,363,2326,9.4,0.92879546
11694,11694,Jarome Iginla,2004-05,27.0,9,73,81,81,41,32,73,265.0,1725.0,626,250,253,503,1911.0,82,5.14,57,348,2300,9.2,0.9345929
11695,11695,Jarome Iginla,2006-07,29.0,10,67,82,82,35,32,67,293.0,1779.0,708,285,285,570,2204.0,82,6.05,85,480,2458,10.1,0.84691143
11696,11696,Jarome Iginla,2007-08,30.0,11,94,70,70,39,55,94,264.0,1544.0,778,324,340,664,2468.0,82,5.76,70,398,2426,9.7,1.1118684
11697,11697,Jarome Iginla,2008-09,31.0,12,98,82,82,50,48,98,338.0,1758.0,860,374,388,762,2806.0,82,5.44,62,351,2383,9.4,0.98638403
11698,11698,Jarome Iginla,2009-10,32.0,13,89,82,82,35,54,89,289.0,1772.0,942,409,442,851,3095.0,82,5.7,65,341,2477,9.4,0.93812776
11699,11699,Jarome Iginla,2010-11,33.0,14,69,82,82,32,37,69,257.0,1689.0,1024,441,479,920,3352.0,82,5.53,56,304,2486,9.1,0.83407617
11700,11700,Jarome Iginla,2011-12,34.0,15,86,82,82,43,43,86,289.0,1717.0,1106,484,522,1006,3641.0,82,5.46,52,291,2492,9.0,0.9153894
11701,11701,Jarome Iginla,2012-13,35.0,16,67,82,82,32,35,67,251.0,1690.0,1188,516,557,1073,3892.0,82,5.32,47,271,2439,8.9,0.7233444
11702,11702,Jarome Iginla,2013-14,36.0,17,33,44,44,14,19,33,134.0,828.0,1232,530,576,1106,4026.0,48,5.31,29,160,1399,9.1,0.7278643
11703,11703,Jarome Iginla,2014-15,37.0,18,61,78,78,30,31,61,209.0,1421.0,1310,560,607,1167,4235.0,82,5.34,48,269,2463,8.9,0.6541157
11704,11704,Jarome Iginla,2015-16,38.0,19,59,82,82,29,30,59,189.0,1487.0,1392,589,637,1226,4424.0,82,5.32,47,251,2453,8.9,0.60586405
11705,11705,Jarome Iginla,2016-17,39.0,20,47,82,82,22,25,47,182.0,1301.0,1474,611,662,1273,4606.0,82,5.34,48,255,2438,9.0,0.5438502
11706,11706,Jarome Iginla,2017-18,40.0,21,27,80,80,14,13,27,153.0,1210.0,1554,625,675,1300,4759.0,82,5.45,47,245,2478,9.0,0.33310992
11707,11707,Jaromir Jagr,1991-92,19.0,2,57,80,80,27,30,57,136.0,,80,27,30,57,136.0,80,6.91,71,366,2385,11.6,0.7968588
11708,11708,Jaromir Jagr,1992-93,20.0,3,69,70,70,32,37,69,194.0,,150,59,67,126,330.0,80,6.96,77,402,2440,11.4,1.0125616
11709,11709,Jaromir Jagr,1993-94,21.0,4,94,81,81,34,60,94,242.0,,231,93,127,220,572.0,84,7.25,87,443,2603,11.7,1.1149638
11710,11710,Jaromir Jagr,1994-95,22.0,5,99,80,80,32,67,99,298.0,,311,125,194,319,870.0,84,6.48,76,407,2545,10.7,1.2171295
11711,11711,Jaromir Jagr,1995-96,23.0,6,70,48,48,32,38,70,192.0,,359,157,232,389,1062.0,48,5.97,37,209,1408,10.2,1.4801929
11712,11712,Jaromir Jagr,1996-97,24.0,7,149,82,82,62,87,149,403.0,,441,219,319,538,1465.0,82,6.29,74,413,2481,10.4,1.411113
11713,11713,Jaromir Jagr,1997-98,25.0,8,95,63,63,47,48,95,234.0,,504,266,367,633,1699.0,82,5.83,55,336,2444,9.8,1.3238155
11714,11714,Jaromir Jagr,1998-99,26.0,9,102,77,77,35,67,102,262.0,,581,301,434,735,1961.0,82,5.28,57,380,2242,9.6,1.2786629
11715,11715,Jaromir Jagr,1999-00,27.0,10,127,81,81,44,83,127,343.0,2094.0,662,345,517,862,2304.0,82,5.27,57,359,2285,9.4,1.4155633
11716,11716,Jaromir Jagr,2000-01,28.0,11,96,63,63,42,54,96,290.0,1462.0,725,387,571,958,2594.0,82,5.49,53,331,2294,9.8,1.4344779
11717,11717,Jaromir Jagr,2001-02,29.0,12,121,81,81,52,69,121,317.0,1888.0,806,439,640,1079,2911.0,82,5.51,63,376,2272,9.9,1.1928927
11718,11718,Jaromir Jagr,2002-03,30.0,13,79,69,69,31,48,79,197.0,1498.0,875,470,688,1158,3108.0,82,5.24,53,338,2262,9.5,1.0122817
11719,11719,Jaromir Jagr,2003-04,31.0,14,77,75,75,36,41,77,290.0,1598.0,950,506,729,1235,3398.0,82,5.31,60,363,2326,9.4,0.8922061
11720,11720,Jaromir Jagr,2004-05,32.0,15,74,77,77,31,43,74,257.0,1613.0,1027,537,772,1309,3655.0,82,5.14,57,348,2300,9.2,1.0840247
11721,11721,Jaromir Jagr,2006-07,34.0,16,123,82,82,54,69,123,368.0,1810.0,1109,591,841,1432,4023.0,82,6.05,85,480,2458,10.1,1.1860929
11722,11722,Jaromir Jagr,2007-08,35.0,17,96,82,82,30,66,96,324.0,1784.0,1191,621,907,1528,4347.0,82,5.76,70,398,2426,9.7,0.9978977
11723,11723,Jaromir Jagr,2008-09,36.0,18,71,82,82,25,46,71,249.0,1678.0,1273,646,953,1599,4596.0,82,5.44,62,351,2383,9.4,0.78126955
11724,11724,Jaromir Jagr,2012-13,40.0,19,54,73,73,19,35,54,170.0,1193.0,1346,665,988,1653,4766.0,82,5.32,47,271,2439,8.9,0.6552088
11725,11725,Jaromir Jagr,2013-14,41.0,20,35,45,45,16,19,35,115.0,825.0,1391,681,1007,1688,4881.0,48,5.31,29,160,1399,9.1,0.68836004
11726,11726,Jaromir Jagr,2014-15,42.0,21,67,82,82,24,43,67,231.0,1571.0,1473,705,1050,1755,5112.0,82,5.34,48,269,2463,8.9,0.68703604
11727,11727,Jaromir Jagr,2015-16,43.0,22,47,77,77,17,30,47,169.0,1353.0,1550,722,1080,1802,5281.0,82,5.32,47,251,2453,8.9,0.5885191
11728,11728,Jaromir Jagr,2016-17,44.0,23,66,79,79,27,39,66,143.0,1349.0,1629,749,1119,1868,5424.0,82,5.34,48,255,2438,9.0,0.6619324
11729,11729,Jaromir Jagr,2017-18,45.0,24,46,82,82,16,30,46,181.0,1394.0,1711,765,1149,1914,5605.0,82,5.45,47,245,2478,9.0,0.5361021
11730,11730,Jaromir Jagr,2018-19,46.0,25,7,22,22,1,6,7,32.0,287.0,1733,766,1155,1921,5637.0,82,5.86,50,250,2620,9.2,0.48310566
11731,11731,Jaroslav Balastik,2006-07,27.0,2,22,66,66,12,10,22,158.0,847.0,66,12,10,22,158.0,82,6.05,85,480,2458,10.1,0.3309757
11732,11732,Jaroslav Balastik,2007-08,28.0,3,2,8,8,1,1,2,6.0,65.0,74,13,11,24,164.0,82,5.76,70,398,2426,9.7,0.19510782
11733,11733,Jaroslav Bednar,2002-03,26.0,2,6,22,22,4,2,6,20.0,235.0,22,4,2,6,20.0,82,5.24,53,338,2262,9.5,0.22654188
11734,11734,Jaroslav Bednar,2003-04,27.0,3,27,67,67,5,22,27,95.0,946.0,89,9,24,33,115.0,82,5.31,60,363,2326,9.4,0.32230958
11735,11735,Jaroslav Bednar,2004-05,28.0,4,2,13,13,1,1,2,19.0,169.0,102,10,25,35,134.0,82,5.14,57,348,2300,9.2,0.22903419
11736,11736,Jaroslav Hlinka,2008-09,32.0,2,28,63,63,8,20,28,90.0,877.0,63,8,20,28,90.0,82,5.44,62,351,2383,9.4,0.38671637
11737,11737,Jaroslav Kristek,2003-04,23.0,2,0,6,6,0,0,0,4.0,70.0,6,0,0,0,4.0,82,5.31,60,363,2326,9.4,0.17296138
11738,11738,Jaroslav Modry,1994-95,23.0,2,17,41,41,2,15,17,35.0,,41,2,15,17,35.0,84,6.48,76,407,2545,10.7,0.30137217
11739,11739,Jaroslav Modry,1995-96,24.0,3,0,11,11,0,0,0,10.0,,52,2,15,17,45.0,48,5.97,37,209,1408,10.2,0.1944822
11740,11740,Jaroslav Modry,1996-97,25.0,4,21,73,73,4,17,21,106.0,,125,6,32,38,151.0,82,6.29,74,413,2481,10.4,0.25465524
11741,11741,Jaroslav Modry,1997-98,26.0,5,6,30,30,3,3,6,32.0,,155,9,35,44,183.0,82,5.83,55,336,2444,9.8,0.22909185
11742,11742,Jaroslav Modry,1999-00,28.0,6,1,5,5,0,1,1,11.0,130.0,160,9,36,45,194.0,82,5.27,57,359,2285,9.4,0.23248655
11743,11743,Jaroslav Modry,2000-01,29.0,7,9,26,26,5,4,9,32.0,500.0,186,14,40,54,226.0,82,5.49,53,331,2294,9.8,0.23123556
11744,11744,Jaroslav Modry,2001-02,30.0,8,19,63,63,4,15,19,72.0,1157.0,249,18,55,73,298.0,82,5.51,63,376,2272,9.9,0.25625044
11745,11745,Jaroslav Modry,2002-03,31.0,9,42,80,80,4,38,42,119.0,1561.0,329,22,93,115,417.0,82,5.24,53,338,2262,9.5,0.4275418
11746,11746,Jaroslav Modry,2003-04,32.0,10,38,82,82,13,25,38,205.0,1857.0,411,35,118,153,622.0,82,5.31,60,363,2326,9.4,0.4645254
11747,11747,Jaroslav Modry,2004-05,33.0,11,32,79,79,5,27,32,196.0,1928.0,490,40,145,185,818.0,82,5.14,57,348,2300,9.2,0.44177225
11748,11748,Jaroslav Modry,2006-07,35.0,12,38,79,79,7,31,38,143.0,1643.0,569,47,176,223,961.0,82,6.05,85,480,2458,10.1,0.37885153
11749,11749,Jaroslav Modry,2007-08,36.0,13,18,76,76,1,17,18,89.0,1434.0,645,48,193,241,1050.0,82,5.76,70,398,2426,9.7,0.20893756
11750,11750,Jaroslav Modry,2008-09,37.0,14,9,80,80,1,8,9,56.0,1525.0,725,49,201,250,1106.0,82,5.44,62,351,2383,9.4,0.13002288
11751,11751,Jaroslav Obsut,2001-02,25.0,2,0,4,4,0,0,0,3.0,74.0,4,0,0,0,3.0,82,5.51,63,376,2272,9.9,0.15821433
11752,11752,Jaroslav Obsut,2002-03,26.0,3,0,3,3,0,0,0,3.0,29.0,7,0,0,0,6.0,82,5.24,53,338,2262,9.5,0.16171265
11753,11753,Jaroslav Otevrel,1993-94,25.0,2,2,7,7,0,2,2,4.0,,7,0,2,2,4.0,84,7.25,87,443,2603,11.7,0.21408847
11754,11754,Jaroslav Otevrel,1994-95,26.0,3,5,9,9,3,2,5,11.0,,16,3,4,7,15.0,84,6.48,76,407,2545,10.7,0.26076645
11755,11755,Jaroslav Pouzar,1983-84,32.0,2,33,74,74,15,18,33,86.0,,74,15,18,33,86.0,80,7.73,71,310,2444,12.7,0.40464985
11756,11756,Jaroslav Pouzar,1984-85,33.0,3,32,67,67,13,19,32,87.0,,141,28,37,65,173.0,80,7.89,74,336,2448,12.9,0.37015548
11757,11757,Jaroslav Pouzar,1985-86,34.0,4,12,33,33,4,8,12,37.0,,174,32,45,77,210.0,80,7.77,71,321,2447,12.7,0.34105605
11758,11758,Jaroslav Pouzar,1987-88,36.0,5,5,12,12,2,3,5,11.0,,186,34,48,82,221.0,80,7.34,72,344,2400,12.2,0.32408124
11759,11759,Jaroslav Sevcik,1990-91,25.0,2,2,13,13,0,2,2,9.0,,13,0,2,2,9.0,80,7.37,76,367,2421,12.2,0.22028863
11760,11760,Jaroslav Spacek,1999-00,25.0,2,15,63,63,3,12,15,92.0,1225.0,63,3,12,15,92.0,82,5.27,57,359,2285,9.4,0.25113878
11761,11761,Jaroslav Spacek,2000-01,26.0,3,36,82,82,10,26,36,111.0,1858.0,145,13,38,51,203.0,82,5.49,53,331,2294,9.8,0.4036157
11762,11762,Jaroslav Spacek,2001-02,27.0,4,26,62,62,7,19,26,106.0,1306.0,207,20,57,77,309.0,82,5.51,63,376,2272,9.9,0.37066984
11763,11763,Jaroslav Spacek,2002-03,28.0,5,18,74,74,5,13,18,93.0,1316.0,281,25,70,95,402.0,82,5.24,53,338,2262,9.5,0.28136963
11764,11764,Jaroslav Spacek,2003-04,29.0,6,45,81,81,9,36,45,166.0,2007.0,362,34,106,140,568.0,82,5.31,60,363,2326,9.4,0.51564527
11765,11765,Jaroslav Spacek,2004-05,30.0,7,22,58,58,5,17,22,108.0,1359.0,420,39,123,162,676.0,82,5.14,57,348,2300,9.2,0.38950068
11766,11766,Jaroslav Spacek,2006-07,32.0,8,43,76,76,12,31,43,150.0,1798.0,496,51,154,205,826.0,82,6.05,85,480,2458,10.1,0.45352024
11767,11767,Jaroslav Spacek,2007-08,33.0,9,21,65,65,5,16,21,78.0,1245.0,561,56,170,226,904.0,82,5.76,70,398,2426,9.7,0.285383
11768,11768,Jaroslav Spacek,2008-09,34.0,10,32,60,60,9,23,32,95.0,1379.0,621,65,193,258,999.0,82,5.44,62,351,2383,9.4,0.41386837
11769,11769,Jaroslav Spacek,2009-10,35.0,11,45,80,80,8,37,45,130.0,1782.0,701,73,230,303,1129.0,82,5.7,65,341,2477,9.4,0.46682099
11770,11770,Jaroslav Spacek,2010-11,36.0,12,21,74,74,3,18,21,99.0,1613.0,775,76,248,324,1228.0,82,5.53,56,304,2486,9.1,0.26419592
11771,11771,Jaroslav Spacek,2011-12,37.0,13,16,59,59,1,15,16,65.0,1135.0,834,77,263,340,1293.0,82,5.46,52,291,2492,9.0,0.22073537
11772,11772,Jaroslav Spacek,2012-13,38.0,14,15,46,46,5,10,15,42.0,740.0,880,82,273,355,1335.0,82,5.32,47,271,2439,8.9,0.23183396
11773,11773,Jaroslav Svejkovsky,1997-98,21.0,2,10,19,19,7,3,10,30.0,,19,7,3,10,30.0,82,5.83,55,336,2444,9.8,0.36314315
11774,11774,Jaroslav Svejkovsky,1998-99,22.0,3,5,17,17,4,1,5,29.0,,36,11,4,15,59.0,82,5.28,57,380,2242,9.6,0.32064745
11775,11775,Jaroslav Svejkovsky,1999-00,23.0,4,14,25,25,6,8,14,50.0,340.0,61,17,12,29,109.0,82,5.27,57,359,2285,9.4,0.36708122
11776,11776,Jaroslav Svejkovsky,2000-01,24.0,5,13,52,52,6,7,13,60.0,565.0,113,23,19,42,169.0,82,5.49,53,331,2294,9.8,0.3035249
11777,11777,Jaroslav Svoboda,2002-03,22.0,2,4,10,10,2,2,4,12.0,94.0,10,2,2,4,12.0,82,5.24,53,338,2262,9.5,0.2591756
11778,11778,Jaroslav Svoboda,2003-04,23.0,3,14,48,48,3,11,14,63.0,699.0,58,5,13,18,75.0,82,5.31,60,363,2326,9.4,0.2878947
11779,11779,Jaroslav Svoboda,2004-05,24.0,4,4,33,33,3,1,4,27.0,301.0,91,8,14,22,102.0,82,5.14,57,348,2300,9.2,0.25453475
11780,11780,Jaroslav Svoboda,2006-07,26.0,5,7,43,43,4,3,7,33.0,304.0,134,12,17,29,135.0,82,6.05,85,480,2458,10.1,0.14726228
11781,11781,Jarred Tinordi,2013-14,21.0,2,2,8,8,0,2,2,5.0,94.0,8,0,2,2,5.0,48,5.31,29,160,1399,9.1,0.25336546
11782,11782,Jarred Tinordi,2014-15,22.0,3,2,22,22,0,2,2,10.0,320.0,30,0,4,4,15.0,82,5.34,48,269,2463,8.9,0.12336674
11783,11783,Jarred Tinordi,2015-16,23.0,4,2,13,13,0,2,2,5.0,157.0,43,0,6,6,20.0,82,5.32,47,251,2453,8.9,0.16103631
11784,11784,Jarred Tinordi,2016-17,24.0,5,0,10,10,0,0,0,3.0,143.0,53,0,6,6,23.0,82,5.34,48,255,2438,9.0,0.13397914
11785,11785,Jarred Tinordi,2020-21,28.0,6,5,28,28,1,4,5,20.0,465.0,81,1,10,11,43.0,70,5.96,42,208,2192,9.5,0.14908403
11786,11786,Jarret Stoll,2003-04,21.0,2,1,4,4,0,1,1,5.0,31.0,4,0,1,1,5.0,82,5.31,60,363,2326,9.4,0.2516763
11787,11787,Jarret Stoll,2004-05,22.0,3,21,68,68,10,11,21,107.0,945.0,72,10,12,22,112.0,82,5.14,57,348,2300,9.2,0.5650001
11788,11788,Jarret Stoll,2006-07,24.0,4,68,82,82,22,46,68,243.0,1507.0,154,32,58,90,355.0,82,6.05,85,480,2458,10.1,0.8035127
11789,11789,Jarret Stoll,2007-08,25.0,5,39,51,51,13,26,39,115.0,928.0,205,45,84,129,470.0,82,5.76,70,398,2426,9.7,0.6964978
11790,11790,Jarret Stoll,2008-09,26.0,6,36,81,81,14,22,36,187.0,1453.0,286,59,106,165,657.0,82,5.44,62,351,2383,9.4,0.5725461
11791,11791,Jarret Stoll,2009-10,27.0,7,41,74,74,18,23,41,155.0,1264.0,360,77,129,206,812.0,82,5.7,65,341,2477,9.4,0.54555756
11792,11792,Jarret Stoll,2010-11,28.0,8,47,73,73,16,31,47,164.0,1272.0,433,93,160,253,976.0,82,5.53,56,304,2486,9.1,0.56127936
11793,11793,Jarret Stoll,2011-12,29.0,9,43,82,82,20,23,43,187.0,1407.0,515,113,183,296,1163.0,82,5.46,52,291,2492,9.0,0.5653635
11794,11794,Jarret Stoll,2012-13,30.0,10,21,78,78,6,15,21,133.0,1301.0,593,119,198,317,1296.0,82,5.32,47,271,2439,8.9,0.3233304
11795,11795,Jarret Stoll,2013-14,31.0,11,18,48,48,7,11,18,73.0,793.0,641,126,209,335,1369.0,48,5.31,29,160,1399,9.1,0.41430587
11796,11796,Jarret Stoll,2014-15,32.0,12,27,78,78,8,19,27,109.0,1237.0,719,134,228,362,1478.0,82,5.34,48,269,2463,8.9,0.29777765
11797,11797,Jarret Stoll,2015-16,33.0,13,17,73,73,6,11,17,83.0,1131.0,792,140,239,379,1561.0,82,5.32,47,251,2453,8.9,0.25352627
11798,11798,Jarret Stoll,2016-17,34.0,14,9,80,80,4,5,9,49.0,974.0,872,144,244,388,1610.0,82,5.34,48,255,2438,9.0,0.14548507
11799,11799,Jarrett Deuling,1996-97,22.0,2,1,14,14,0,1,1,11.0,,14,0,1,1,11.0,82,6.29,74,413,2481,10.4,0.18686873
11800,11800,Jarrett Deuling,1997-98,23.0,3,0,1,1,0,0,0,0.0,,15,0,1,1,11.0,82,5.83,55,336,2444,9.8,0.14788413
11801,11801,Jarrod Skalde,1991-92,20.0,2,1,1,1,0,1,1,2.0,,1,0,1,1,2.0,80,6.91,71,366,2385,11.6,0.2882866
11802,11802,Jarrod Skalde,1992-93,21.0,3,6,15,15,2,4,6,25.0,,16,2,5,7,27.0,80,6.96,77,402,2440,11.4,0.3860459
11803,11803,Jarrod Skalde,1993-94,22.0,4,2,11,11,0,2,2,11.0,,27,2,7,9,38.0,84,7.25,87,443,2603,11.7,0.23930052
11804,11804,Jarrod Skalde,1994-95,23.0,5,9,20,20,5,4,9,25.0,,47,7,11,18,63.0,84,6.48,76,407,2545,10.7,0.3066506
11805,11805,Jarrod Skalde,1996-97,25.0,6,0,1,1,0,0,0,0.0,,48,7,11,18,63.0,82,6.29,74,413,2481,10.4,0.16381234
11806,11806,Jarrod Skalde,1998-99,27.0,7,11,30,30,4,7,11,34.0,,78,11,18,29,97.0,82,5.28,57,380,2242,9.6,0.22510457
11807,11807,Jarrod Skalde,1999-00,28.0,8,2,17,17,1,1,2,17.0,172.0,95,12,19,31,114.0,82,5.27,57,359,2285,9.4,0.18940935
11808,11808,Jarrod Skalde,2001-02,30.0,9,3,19,19,1,2,3,24.0,265.0,114,13,21,34,138.0,82,5.51,63,376,2272,9.9,0.19501472
11809,11809,Jarrod Skalde,2002-03,31.0,10,0,1,1,0,0,0,5.0,12.0,115,13,21,34,143.0,82,5.24,53,338,2262,9.5,0.17349732
11810,11810,Jason Akeson,2013-14,23.0,2,1,1,1,1,0,1,2.0,12.0,1,1,0,1,2.0,48,5.31,29,160,1399,9.1,0.2925951
11811,11811,Jason Akeson,2014-15,24.0,3,1,1,1,0,1,1,2.0,13.0,2,1,1,2,4.0,82,5.34,48,269,2463,8.9,0.18374214
11812,11812,Jason Akeson,2015-16,25.0,4,0,13,13,0,0,0,9.0,105.0,15,1,1,2,13.0,82,5.32,47,251,2453,8.9,0.1548199
11813,11813,Jason Allison,1994-95,19.0,2,1,2,2,0,1,1,5.0,,2,0,1,1,5.0,84,6.48,76,407,2545,10.7,0.26907057
11814,11814,Jason Allison,1995-96,20.0,3,3,12,12,2,1,3,9.0,,14,2,2,4,14.0,48,5.97,37,209,1408,10.2,0.34133488
11815,11815,Jason Allison,1996-97,21.0,4,3,19,19,0,3,3,18.0,,33,2,5,7,32.0,82,6.29,74,413,2481,10.4,0.23075792
11816,11816,Jason Allison,1997-98,22.0,5,34,72,72,8,26,34,99.0,,105,10,31,41,131.0,82,5.83,55,336,2444,9.8,0.44575468
11817,11817,Jason Allison,1998-99,23.0,6,83,81,81,33,50,83,158.0,,186,43,81,124,289.0,82,5.28,57,380,2242,9.6,0.90858805
11818,11818,Jason Allison,1999-00,24.0,7,76,82,82,23,53,76,158.0,1835.0,268,66,134,200,447.0,82,5.27,57,359,2285,9.4,0.85583544
11819,11819,Jason Allison,2000-01,25.0,8,28,37,37,10,18,28,66.0,797.0,305,76,152,228,513.0,82,5.49,53,331,2294,9.8,0.70370775
11820,11820,Jason Allison,2001-02,26.0,9,95,82,82,36,59,95,185.0,1915.0,387,112,211,323,698.0,82,5.51,63,376,2272,9.9,0.96534514
11821,11821,Jason Allison,2002-03,27.0,10,74,73,73,19,55,74,139.0,1591.0,460,131,266,397,837.0,82,5.24,53,338,2262,9.5,0.88372624
11822,11822,Jason Allison,2003-04,28.0,11,28,26,26,6,22,28,46.0,562.0,486,137,288,425,883.0,82,5.31,60,363,2326,9.4,0.8404907
11823,11823,Jason Allison,2006-07,31.0,12,60,66,66,17,43,60,111.0,1234.0,552,154,331,485,994.0,82,6.05,85,480,2458,10.1,0.7541101
11824,11824,Jason Arnott,1994-95,20.0,2,68,78,78,33,35,68,194.0,,78,33,35,68,194.0,84,6.48,76,407,2545,10.7,0.85430586
11825,11825,Jason Arnott,1995-96,21.0,3,37,42,42,15,22,37,156.0,,120,48,57,105,350.0,48,5.97,37,209,1408,10.2,0.84447706
11826,11826,Jason Arnott,1996-97,22.0,4,59,64,64,28,31,59,244.0,,184,76,88,164,594.0,82,6.29,74,413,2481,10.4,0.88460696
11827,11827,Jason Arnott,1997-98,23.0,5,57,67,67,19,38,57,248.0,,251,95,126,221,842.0,82,5.83,55,336,2444,9.8,0.8085582
11828,11828,Jason Arnott,1998-99,24.0,6,33,70,70,10,23,33,199.0,,321,105,149,254,1041.0,82,5.28,57,380,2242,9.6,0.6505884
11829,11829,Jason Arnott,1999-00,25.0,7,54,74,74,27,27,54,200.0,1140.0,395,132,176,308,1241.0,82,5.27,57,359,2285,9.4,0.73067844
11830,11830,Jason Arnott,2000-01,26.0,8,56,76,76,22,34,56,244.0,1299.0,471,154,210,364,1485.0,82,5.49,53,331,2294,9.8,0.7559434
11831,11831,Jason Arnott,2001-02,27.0,9,55,54,54,21,34,55,138.0,875.0,525,175,244,419,1623.0,82,5.51,63,376,2272,9.9,0.84016705
11832,11832,Jason Arnott,2002-03,28.0,10,45,73,73,25,20,45,197.0,1267.0,598,200,264,464,1820.0,82,5.24,53,338,2262,9.5,0.64335936
11833,11833,Jason Arnott,2003-04,29.0,11,47,72,72,23,24,47,169.0,1166.0,670,223,288,511,1989.0,82,5.31,60,363,2326,9.4,0.6147338
11834,11834,Jason Arnott,2004-05,30.0,12,57,73,73,21,36,57,143.0,1241.0,743,244,324,568,2132.0,82,5.14,57,348,2300,9.2,0.7955353
11835,11835,Jason Arnott,2006-07,32.0,13,76,81,81,32,44,76,167.0,1393.0,824,276,368,644,2299.0,82,6.05,85,480,2458,10.1,0.78999496
11836,11836,Jason Arnott,2007-08,33.0,14,54,68,68,27,27,54,190.0,1223.0,892,303,395,698,2489.0,82,5.76,70,398,2426,9.7,0.698895
11837,11837,Jason Arnott,2008-09,34.0,15,72,79,79,28,44,72,248.0,1500.0,971,331,439,770,2737.0,82,5.44,62,351,2383,9.4,0.79229426
11838,11838,Jason Arnott,2009-10,35.0,16,57,65,65,33,24,57,196.0,1229.0,1036,364,463,827,2933.0,82,5.7,65,341,2477,9.4,0.7229009
11839,11839,Jason Arnott,2010-11,36.0,17,46,63,63,19,27,46,216.0,1178.0,1099,383,490,873,3149.0,82,5.53,56,304,2486,9.1,0.6405519
11840,11840,Jason Arnott,2011-12,37.0,18,31,73,73,17,14,31,169.0,1133.0,1172,400,504,904,3318.0,82,5.46,52,291,2492,9.0,0.4450498
11841,11841,Jason Arnott,2012-13,38.0,19,34,72,72,17,17,34,142.0,1014.0,1244,417,521,938,3460.0,82,5.32,47,271,2439,8.9,0.4447868
11842,11842,Jason Blake,1999-00,26.0,2,1,1,1,1,0,1,5.0,17.0,1,1,0,1,5.0,82,5.27,57,359,2285,9.4,0.22122979
11843,11843,Jason Blake,2000-01,27.0,3,23,64,64,5,18,23,131.0,722.0,65,6,18,24,136.0,82,5.49,53,331,2294,9.8,0.32092845
11844,11844,Jason Blake,2001-02,28.0,4,16,47,47,5,11,16,100.0,642.0,112,11,29,40,236.0,82,5.51,63,376,2272,9.9,0.30947304
11845,11845,Jason Blake,2002-03,29.0,5,18,82,82,8,10,18,136.0,1057.0,194,19,39,58,372.0,82,5.24,53,338,2262,9.5,0.3181889
11846,11846,Jason Blake,2003-04,30.0,6,55,81,81,25,30,55,253.0,1429.0,275,44,69,113,625.0,82,5.31,60,363,2326,9.4,0.63355577
11847,11847,Jason Blake,2004-05,31.0,7,47,75,75,22,25,47,243.0,1411.0,350,66,94,160,868.0,82,5.14,57,348,2300,9.2,0.66598654
11848,11848,Jason Blake,2006-07,33.0,8,57,76,76,28,29,57,304.0,1427.0,426,94,123,217,1172.0,82,6.05,85,480,2458,10.1,0.6687717
11849,11849,Jason Blake,2007-08,34.0,9,69,82,82,40,29,69,305.0,1488.0,508,134,152,286,1477.0,82,5.76,70,398,2426,9.7,0.7558748
11850,11850,Jason Blake,2008-09,35.0,10,52,82,82,15,37,52,332.0,1461.0,590,149,189,338,1809.0,82,5.44,62,351,2383,9.4,0.6151394
11851,11851,Jason Blake,2009-10,36.0,11,63,78,78,25,38,63,302.0,1431.0,668,174,227,401,2111.0,82,5.7,65,341,2477,9.4,0.66434
11852,11852,Jason Blake,2010-11,37.0,12,41,82,82,16,25,41,239.0,1304.0,750,190,252,442,2350.0,82,5.53,56,304,2486,9.1,0.51117903
11853,11853,Jason Blake,2011-12,38.0,13,32,76,76,16,16,32,187.0,1122.0,826,206,268,474,2537.0,82,5.46,52,291,2492,9.0,0.39988714
11854,11854,Jason Blake,2012-13,39.0,14,12,45,45,7,5,12,109.0,636.0,871,213,273,486,2646.0,82,5.32,47,271,2439,8.9,0.2875979
11855,11855,Jason Bonsignore,1995-96,19.0,2,1,1,1,1,0,1,3.0,,1,1,0,1,3.0,48,5.97,37,209,1408,10.2,0.26865554
11856,11856,Jason Bonsignore,1996-97,20.0,3,2,20,20,0,2,2,13.0,,21,1,2,3,16.0,82,6.29,74,413,2481,10.4,0.20196441
11857,11857,Jason Bonsignore,1998-99,22.0,4,10,35,35,2,8,10,29.0,,56,3,10,13,45.0,82,5.28,57,380,2242,9.6,0.24026817
11858,11858,Jason Bonsignore,1999-00,23.0,5,3,23,23,0,3,3,12.0,171.0,79,3,13,16,57.0,82,5.27,57,359,2285,9.4,0.16298205
11859,11859,Jason Botterill,1998-99,22.0,2,0,4,4,0,0,0,2.0,,4,0,0,0,2.0,82,5.28,57,380,2242,9.6,0.16508633
11860,11860,Jason Botterill,1999-00,23.0,3,0,17,17,0,0,0,8.0,141.0,21,0,0,0,10.0,82,5.27,57,359,2285,9.4,0.15201235
11861,11861,Jason Botterill,2000-01,24.0,4,5,27,27,1,4,5,19.0,298.0,48,1,4,5,29.0,82,5.49,53,331,2294,9.8,0.16074666
11862,11862,Jason Botterill,2002-03,26.0,5,1,4,4,1,0,1,4.0,38.0,52,2,4,6,33.0,82,5.24,53,338,2262,9.5,0.15842557
11863,11863,Jason Botterill,2003-04,27.0,6,5,17,17,1,4,5,20.0,184.0,69,3,8,11,53.0,82,5.31,60,363,2326,9.4,0.18376565
11864,11864,Jason Botterill,2004-05,28.0,7,3,19,19,2,1,3,20.0,217.0,88,5,9,14,73.0,82,5.14,57,348,2300,9.2,0.1981977
11865,11865,Jason Bowen,1993-94,20.0,2,1,7,7,1,0,1,3.0,,7,1,0,1,3.0,84,7.25,87,443,2603,11.7,0.279364
11866,11866,Jason Bowen,1994-95,21.0,3,6,56,56,1,5,6,50.0,,63,2,5,7,53.0,84,6.48,76,407,2545,10.7,0.2165063
11867,11867,Jason Bowen,1995-96,22.0,4,0,4,4,0,0,0,2.0,,67,2,5,7,55.0,48,5.97,37,209,1408,10.2,0.18492484
11868,11868,Jason Bowen,1996-97,23.0,5,0,2,2,0,0,0,2.0,,69,2,5,7,57.0,82,6.29,74,413,2481,10.4,0.1586852
11869,11869,Jason Bowen,1997-98,24.0,6,1,4,4,0,1,1,1.0,,73,2,6,8,58.0,82,5.83,55,336,2444,9.8,0.15687722
11870,11870,Jason Bowen,1998-99,25.0,7,0,4,4,0,0,0,3.0,,77,2,6,8,61.0,82,5.28,57,380,2242,9.6,0.14461893
11871,11871,Jason Chimera,2001-02,22.0,2,0,1,1,0,0,0,0.0,7.0,1,0,0,0,0.0,82,5.51,63,376,2272,9.9,0.1581175
11872,11872,Jason Chimera,2002-03,23.0,3,1,3,3,1,0,1,3.0,38.0,4,1,0,1,3.0,82,5.24,53,338,2262,9.5,0.22056413
11873,11873,Jason Chimera,2003-04,24.0,4,23,66,66,14,9,23,90.0,710.0,70,15,9,24,93.0,82,5.31,60,363,2326,9.4,0.35273317
11874,11874,Jason Chimera,2004-05,25.0,5,12,60,60,4,8,12,79.0,607.0,130,19,17,36,172.0,82,5.14,57,348,2300,9.2,0.24270785
11875,11875,Jason Chimera,2006-07,27.0,6,30,80,80,17,13,30,127.0,1014.0,210,36,30,66,299.0,82,6.05,85,480,2458,10.1,0.37070003
11876,11876,Jason Chimera,2007-08,28.0,7,36,82,82,15,21,36,151.0,1260.0,292,51,51,102,450.0,82,5.76,70,398,2426,9.7,0.4341522
11877,11877,Jason Chimera,2008-09,29.0,8,31,81,81,14,17,31,198.0,1417.0,373,65,68,133,648.0,82,5.44,62,351,2383,9.4,0.4150904
11878,11878,Jason Chimera,2009-10,30.0,9,22,49,49,8,14,22,115.0,796.0,422,73,82,155,763.0,82,5.7,65,341,2477,9.4,0.39426848
11879,11879,Jason Chimera,2010-11,31.0,10,34,78,78,15,19,34,160.0,1068.0,500,88,101,189,923.0,82,5.53,56,304,2486,9.1,0.38070726
11880,11880,Jason Chimera,2011-12,32.0,11,26,81,81,10,16,26,162.0,1074.0,581,98,117,215,1085.0,82,5.46,52,291,2492,9.0,0.31236857
11881,11881,Jason Chimera,2012-13,33.0,12,39,82,82,20,19,39,205.0,1184.0,663,118,136,254,1290.0,82,5.32,47,271,2439,8.9,0.48046792
11882,11882,Jason Chimera,2013-14,34.0,13,14,47,47,3,11,14,92.0,596.0,710,121,147,268,1382.0,48,5.31,29,160,1399,9.1,0.2888354
11883,11883,Jason Chimera,2014-15,35.0,14,42,82,82,15,27,42,167.0,1264.0,792,136,174,310,1549.0,82,5.34,48,269,2463,8.9,0.4054007
11884,11884,Jason Chimera,2015-16,36.0,15,19,77,77,7,12,19,96.0,996.0,869,143,186,329,1645.0,82,5.32,47,251,2453,8.9,0.22713783
11885,11885,Jason Chimera,2016-17,37.0,16,40,82,82,20,20,40,165.0,1152.0,951,163,206,369,1810.0,82,5.34,48,255,2438,9.0,0.3796188
11886,11886,Jason Chimera,2017-18,38.0,17,33,82,82,20,13,33,121.0,1071.0,1033,183,219,402,1931.0,82,5.45,47,245,2478,9.0,0.3072856
11887,11887,Jason Chimera,2018-19,39.0,18,13,74,74,3,10,13,79.0,762.0,1107,186,229,415,2010.0,82,5.86,50,250,2620,9.2,0.17978555
11888,11888,Jason Cirone,1992-93,21.0,2,0,3,3,0,0,0,1.0,,3,0,0,0,1.0,80,6.96,77,402,2440,11.4,0.2253857
11889,11889,Jason Dawe,1994-95,21.0,2,13,32,32,6,7,13,35.0,,32,6,7,13,35.0,84,6.48,76,407,2545,10.7,0.35667092
11890,11890,Jason Dawe,1995-96,22.0,3,11,42,42,7,4,11,51.0,,74,13,11,24,86.0,48,5.97,37,209,1408,10.2,0.34677625
11891,11891,Jason Dawe,1996-97,23.0,4,50,67,67,25,25,50,130.0,,141,38,36,74,216.0,82,6.29,74,413,2481,10.4,0.64834327
11892,11892,Jason Dawe,1997-98,24.0,5,48,81,81,22,26,48,136.0,,222,60,62,122,352.0,82,5.83,55,336,2444,9.8,0.59331334
11893,11893,Jason Dawe,1998-99,25.0,6,39,81,81,20,19,39,134.0,,303,80,81,161,486.0,82,5.28,57,380,2242,9.6,0.5085566
11894,11894,Jason Dawe,1999-00,26.0,7,14,59,59,6,8,14,81.0,669.0,362,86,89,175,567.0,82,5.27,57,359,2285,9.4,0.35728592
11895,11895,Jason Dawe,2000-01,27.0,8,1,3,3,0,1,1,8.0,41.0,365,86,90,176,575.0,82,5.49,53,331,2294,9.8,0.3107784
11896,11896,Jason Dawe,2002-03,29.0,9,0,1,1,0,0,0,1.0,9.0,366,86,90,176,576.0,82,5.24,53,338,2262,9.5,0.40277046
11897,11897,Jason Demers,2010-11,22.0,2,21,51,51,4,17,21,52.0,787.0,51,4,17,21,52.0,82,5.53,56,304,2486,9.1,0.34376025
11898,11898,Jason Demers,2011-12,23.0,3,24,75,75,2,22,24,105.0,1462.0,126,6,39,45,157.0,82,5.46,52,291,2492,9.0,0.30893946
11899,11899,Jason Demers,2012-13,24.0,4,13,57,57,4,9,13,73.0,960.0,183,10,48,58,230.0,82,5.32,47,271,2439,8.9,0.25735235
11900,11900,Jason Demers,2013-14,25.0,5,3,22,22,1,2,3,27.0,410.0,205,11,50,61,257.0,48,5.31,29,160,1399,9.1,0.2521522
11901,11901,Jason Demers,2014-15,26.0,6,34,75,75,5,29,34,105.0,1462.0,280,16,79,95,362.0,82,5.34,48,269,2463,8.9,0.40020436
11902,11902,Jason Demers,2015-16,27.0,7,25,81,81,5,20,25,99.0,1549.0,361,21,99,120,461.0,82,5.32,47,251,2453,8.9,0.31733584
11903,11903,Jason Demers,2016-17,28.0,8,23,62,62,7,16,23,94.0,1294.0,423,28,115,143,555.0,82,5.34,48,255,2438,9.0,0.31667113
11904,11904,Jason Demers,2017-18,29.0,9,28,81,81,9,19,28,98.0,1588.0,504,37,134,171,653.0,82,5.45,47,245,2478,9.0,0.32445163
11905,11905,Jason Demers,2018-19,30.0,10,20,69,69,6,14,20,95.0,1458.0,573,43,148,191,748.0,82,5.86,50,250,2620,9.2,0.29650038
11906,11906,Jason Demers,2019-20,31.0,11,8,35,35,2,6,8,39.0,700.0,608,45,154,199,787.0,82,5.96,47,239,2579,9.5,0.20742798
11907,11907,Jason Demers,2020-21,32.0,12,11,50,50,0,11,11,53.0,1025.0,658,45,165,210,840.0,70,5.96,42,208,2192,9.5,0.18125662
11908,11908,Jason Dickinson,2016-17,21.0,2,1,1,1,1,0,1,2.0,12.0,1,1,0,1,2.0,82,5.34,48,255,2438,9.0,0.23645389
11909,11909,Jason Dickinson,2017-18,22.0,3,2,10,10,2,0,2,9.0,118.0,11,3,0,3,11.0,82,5.45,47,245,2478,9.0,0.2590412
11910,11910,Jason Dickinson,2018-19,23.0,4,2,27,27,0,2,2,16.0,230.0,38,3,2,5,27.0,82,5.86,50,250,2620,9.2,0.17117646
11911,11911,Jason Dickinson,2019-20,24.0,5,22,67,67,6,16,22,94.0,896.0,105,9,18,27,121.0,82,5.96,47,239,2579,9.5,0.2993014
11912,11912,Jason Dickinson,2020-21,25.0,6,21,65,65,9,12,21,85.0,973.0,170,18,30,48,206.0,70,5.96,42,208,2192,9.5,0.2886693
11913,11913,Jason Doig,1996-97,20.0,2,2,15,15,1,1,2,7.0,,15,1,1,2,7.0,82,6.29,74,413,2481,10.4,0.23280826
11914,11914,Jason Doig,1998-99,22.0,3,1,4,4,0,1,1,1.0,,19,1,2,3,8.0,82,5.28,57,380,2242,9.6,0.18498477
11915,11915,Jason Doig,1999-00,23.0,4,1,9,9,0,1,1,0.0,46.0,28,1,3,4,8.0,82,5.27,57,359,2285,9.4,0.17212206
11916,11916,Jason Doig,2000-01,24.0,5,1,7,7,0,1,1,3.0,62.0,35,1,4,5,11.0,82,5.49,53,331,2294,9.8,0.1516779
11917,11917,Jason Doig,2001-02,25.0,6,0,3,3,0,0,0,1.0,20.0,38,1,4,5,12.0,82,5.51,63,376,2272,9.9,0.14214626
11918,11918,Jason Doig,2003-04,27.0,7,8,55,55,3,5,8,41.0,780.0,93,4,9,13,53.0,82,5.31,60,363,2326,9.4,0.14232728
11919,11919,Jason Doig,2004-05,28.0,8,11,65,65,2,9,11,59.0,1244.0,158,6,18,24,112.0,82,5.14,57,348,2300,9.2,0.17341042
11920,11920,Jason Garrison,2009-10,25.0,2,0,1,1,0,0,0,0.0,12.0,1,0,0,0,0.0,82,5.7,65,341,2477,9.4,0.1539588
11921,11921,Jason Garrison,2010-11,26.0,3,8,39,39,2,6,8,24.0,590.0,40,2,6,8,24.0,82,5.53,56,304,2486,9.1,0.17492783
11922,11922,Jason Garrison,2011-12,27.0,4,18,73,73,5,13,18,116.0,1627.0,113,7,19,26,140.0,82,5.46,52,291,2492,9.0,0.24892485
11923,11923,Jason Garrison,2012-13,28.0,5,33,77,77,16,17,33,168.0,1825.0,190,23,36,59,308.0,82,5.32,47,271,2439,8.9,0.41920546
11924,11924,Jason Garrison,2013-14,29.0,6,16,47,47,8,8,16,94.0,1019.0,237,31,44,75,402.0,48,5.31,29,160,1399,9.1,0.35816994
11925,11925,Jason Garrison,2014-15,30.0,7,33,81,81,7,26,33,181.0,1693.0,318,38,70,108,583.0,82,5.34,48,269,2463,8.9,0.41510636
11926,11926,Jason Garrison,2015-16,31.0,8,30,70,70,4,26,30,111.0,1401.0,388,42,96,138,694.0,82,5.32,47,251,2453,8.9,0.34503323
11927,11927,Jason Garrison,2016-17,32.0,9,11,72,72,5,6,11,99.0,1329.0,460,47,102,149,793.0,82,5.34,48,255,2438,9.0,0.2246097
11928,11928,Jason Garrison,2017-18,33.0,10,9,70,70,1,8,9,96.0,1300.0,530,48,110,158,889.0,82,5.45,47,245,2478,9.0,0.1964216
11929,11929,Jason Garrison,2018-19,34.0,11,1,8,8,0,1,1,7.0,153.0,538,48,111,159,896.0,82,5.86,50,250,2620,9.2,0.15067318
11930,11930,Jason Garrison,2019-20,35.0,12,1,17,17,1,0,1,16.0,216.0,555,49,111,160,912.0,82,5.96,47,239,2579,9.5,0.17939702
11931,11931,Jason Herter,1996-97,26.0,2,1,1,1,0,1,1,1.0,,1,0,1,1,1.0,82,6.29,74,413,2481,10.4,0.17214727
11932,11932,Jason Holland,1997-98,21.0,2,1,4,4,1,0,1,3.0,,4,1,0,1,3.0,82,5.83,55,336,2444,9.8,0.24363232
11933,11933,Jason Holland,1998-99,22.0,3,0,8,8,0,0,0,6.0,,12,1,0,1,9.0,82,5.28,57,380,2242,9.6,0.1729855
11934,11934,Jason Holland,1999-00,23.0,4,0,3,3,0,0,0,2.0,33.0,15,1,0,1,11.0,82,5.27,57,359,2285,9.4,0.16494945
11935,11935,Jason Holland,2000-01,24.0,5,1,9,9,0,1,1,8.0,140.0,24,1,1,2,19.0,82,5.49,53,331,2294,9.8,0.15056223
11936,11936,Jason Holland,2002-03,26.0,6,0,3,3,0,0,0,1.0,48.0,27,1,1,2,20.0,82,5.24,53,338,2262,9.5,0.1368998
11937,11937,Jason Holland,2003-04,27.0,7,1,2,2,0,1,1,0.0,27.0,29,1,2,3,20.0,82,5.31,60,363,2326,9.4,0.1424877
11938,11938,Jason Holland,2004-05,28.0,8,6,52,52,3,3,6,64.0,920.0,81,4,5,9,84.0,82,5.14,57,348,2300,9.2,0.17567745
11939,11939,Jason Jaffray,2008-09,27.0,2,6,19,19,2,4,6,15.0,239.0,19,2,4,6,15.0,82,5.44,62,351,2383,9.4,0.2186619
11940,11940,Jason Jaffray,2009-10,28.0,3,4,14,14,2,2,4,11.0,127.0,33,4,6,10,26.0,82,5.7,65,341,2477,9.4,0.21595553
11941,11941,Jason Jaffray,2010-11,29.0,4,0,3,3,0,0,0,4.0,20.0,36,4,6,10,30.0,82,5.53,56,304,2486,9.1,0.14682943
11942,11942,Jason Jaffray,2012-13,31.0,5,1,13,13,0,1,1,10.0,85.0,49,4,7,11,40.0,82,5.32,47,271,2439,8.9,0.13717574
11943,11943,Jason Jaspers,2002-03,21.0,2,1,4,4,0,1,1,1.0,32.0,4,0,1,1,1.0,82,5.24,53,338,2262,9.5,0.22629747
11944,11944,Jason Jaspers,2003-04,22.0,3,0,2,2,0,0,0,0.0,15.0,6,0,1,1,1.0,82,5.31,60,363,2326,9.4,0.16531813
11945,11945,Jason Jaspers,2004-05,23.0,4,0,3,3,0,0,0,3.0,34.0,9,0,1,1,4.0,82,5.14,57,348,2300,9.2,0.23151141
11946,11946,Jason King,2003-04,22.0,2,2,8,8,0,2,2,12.0,90.0,8,0,2,2,12.0,82,5.31,60,363,2326,9.4,0.2081016
11947,11947,Jason King,2004-05,23.0,3,21,47,47,12,9,21,107.0,597.0,55,12,11,23,119.0,82,5.14,57,348,2300,9.2,0.52776915
11948,11948,Jason King,2008-09,27.0,4,0,4,4,0,0,0,2.0,44.0,59,12,11,23,121.0,82,5.44,62,351,2383,9.4,0.17994475
11949,11949,Jason Krog,2000-01,25.0,2,6,17,17,2,4,6,22.0,171.0,17,2,4,6,22.0,82,5.49,53,331,2294,9.8,0.22808328
11950,11950,Jason Krog,2001-02,26.0,3,3,9,9,0,3,3,7.0,95.0,26,2,7,9,29.0,82,5.51,63,376,2272,9.9,0.17023104
11951,11951,Jason Krog,2002-03,27.0,4,0,2,2,0,0,0,0.0,13.0,28,2,7,9,29.0,82,5.24,53,338,2262,9.5,0.14788228
11952,11952,Jason Krog,2003-04,28.0,5,25,67,67,10,15,25,92.0,923.0,95,12,22,34,121.0,82,5.31,60,363,2326,9.4,0.30027354
11953,11953,Jason Krog,2004-05,29.0,6,18,80,80,6,12,18,111.0,958.0,175,18,34,52,232.0,82,5.14,57,348,2300,9.2,0.28762853
11954,11954,Jason Krog,2007-08,32.0,7,6,23,23,3,3,6,22.0,285.0,198,21,37,58,254.0,82,5.76,70,398,2426,9.7,0.22073206
11955,11955,Jason Krog,2009-10,34.0,8,1,4,4,1,0,1,5.0,41.0,202,22,37,59,259.0,82,5.7,65,341,2477,9.4,0.18668821
11956,11956,Jason Lafreniere,1987-88,21.0,2,28,56,56,13,15,28,55.0,,56,13,15,28,55.0,80,7.34,72,344,2400,12.2,0.5161609
11957,11957,Jason Lafreniere,1988-89,22.0,3,29,40,40,10,19,29,54.0,,96,23,34,57,109.0,80,7.43,89,437,2435,12.2,0.5840894
11958,11958,Jason Lafreniere,1989-90,23.0,4,24,38,38,8,16,24,42.0,,134,31,50,81,151.0,80,7.48,85,403,2430,12.3,0.56386423
11959,11959,Jason Lafreniere,1993-94,27.0,5,6,11,11,3,3,6,17.0,,145,34,53,87,168.0,84,7.25,87,443,2603,11.7,0.304034
11960,11960,Jason Lafreniere,1994-95,28.0,6,0,1,1,0,0,0,2.0,,146,34,53,87,170.0,84,6.48,76,407,2545,10.7,0.24521539
11961,11961,Jason MacDonald,2004-05,30.0,2,0,4,4,0,0,0,3.0,33.0,4,0,0,0,3.0,82,5.14,57,348,2300,9.2,0.19323951
11962,11962,Jason Marshall,1992-93,21.0,2,1,2,2,1,0,1,2.0,,2,1,0,1,2.0,80,6.96,77,402,2440,11.4,0.2651846
11963,11963,Jason Marshall,1995-96,24.0,3,0,1,1,0,0,0,1.0,,3,1,0,1,3.0,48,5.97,37,209,1408,10.2,0.19212008
11964,11964,Jason Marshall,1996-97,25.0,4,1,24,24,0,1,1,9.0,,27,1,1,2,12.0,82,6.29,74,413,2481,10.4,0.111398846
11965,11965,Jason Marshall,1997-98,26.0,5,10,73,73,1,9,10,34.0,,100,2,10,12,46.0,82,5.83,55,336,2444,9.8,0.140562
11966,11966,Jason Marshall,1998-99,27.0,6,9,72,72,3,6,9,68.0,,172,5,16,21,114.0,82,5.28,57,380,2242,9.6,0.15125969
11967,11967,Jason Marshall,1999-00,28.0,7,8,72,72,1,7,8,63.0,1375.0,244,6,23,29,177.0,82,5.27,57,359,2285,9.4,0.14112094
11968,11968,Jason Marshall,2000-01,29.0,8,3,55,55,0,3,3,41.0,910.0,299,6,26,32,218.0,82,5.49,53,331,2294,9.8,0.11128509
11969,11969,Jason Marshall,2001-02,30.0,9,7,55,55,3,4,7,43.0,789.0,354,9,30,39,261.0,82,5.51,63,376,2272,9.9,0.120610416
11970,11970,Jason Marshall,2002-03,31.0,10,11,80,80,5,6,11,73.0,1304.0,434,14,36,50,334.0,82,5.24,53,338,2262,9.5,0.17006594
11971,11971,Jason Marshall,2003-04,32.0,11,6,45,45,1,5,6,40.0,513.0,479,15,41,56,374.0,82,5.31,60,363,2326,9.4,0.13165447
11972,11972,Jason Marshall,2004-05,33.0,12,7,24,24,1,6,7,30.0,379.0,503,16,47,63,404.0,82,5.14,57,348,2300,9.2,0.18051434
11973,11973,Jason Marshall,2006-07,35.0,13,4,23,23,0,4,4,25.0,271.0,526,16,51,67,429.0,82,6.05,85,480,2458,10.1,0.1415213
11974,11974,Jason McBain,1996-97,22.0,2,0,3,3,0,0,0,0.0,,3,0,0,0,0.0,82,6.29,74,413,2481,10.4,0.14985338
11975,11975,Jason McBain,1997-98,23.0,3,0,6,6,0,0,0,1.0,,9,0,0,0,1.0,82,5.83,55,336,2444,9.8,0.15911222
11976,11976,Jason Miller,1991-92,20.0,2,0,1,1,0,0,0,0.0,,1,0,0,0,0.0,80,6.91,71,366,2385,11.6,0.25950444
11977,11977,Jason Miller,1992-93,21.0,3,0,3,3,0,0,0,1.0,,4,0,0,0,1.0,80,6.96,77,402,2440,11.4,0.20916888
11978,11978,Jason Miller,1993-94,22.0,4,0,2,2,0,0,0,1.0,,6,0,0,0,2.0,84,7.25,87,443,2603,11.7,0.18833888
11979,11979,Jason Morgan,1997-98,21.0,2,0,3,3,0,0,0,4.0,,3,0,0,0,4.0,82,5.83,55,336,2444,9.8,0.21138316
11980,11980,Jason Morgan,1998-99,22.0,3,1,11,11,1,0,1,5.0,,14,1,0,1,9.0,82,5.28,57,380,2242,9.6,0.19400534
11981,11981,Jason Morgan,2004-05,28.0,4,4,19,19,0,4,4,20.0,187.0,33,1,4,5,29.0,82,5.14,57,348,2300,9.2,0.17192662
11982,11982,Jason Morgan,2006-07,30.0,5,2,7,7,1,1,2,6.0,71.0,40,2,5,7,35.0,82,6.05,85,480,2458,10.1,0.15188244
11983,11983,Jason Morgan,2007-08,31.0,6,0,4,4,0,0,0,0.0,30.0,44,2,5,7,35.0,82,5.76,70,398,2426,9.7,0.1296278
11984,11984,Jason Podollan,1997-98,21.0,2,5,29,29,1,4,5,30.0,,29,1,4,5,30.0,82,5.83,55,336,2444,9.8,0.24021497
11985,11985,Jason Podollan,1999-00,23.0,3,0,10,10,0,0,0,9.0,87.0,39,1,4,5,39.0,82,5.27,57,359,2285,9.4,0.17017323
11986,11986,Jason Podollan,2000-01,24.0,4,1,1,1,0,1,1,2.0,16.0,40,1,5,6,41.0,82,5.49,53,331,2294,9.8,0.16360283
11987,11987,Jason Podollan,2002-03,26.0,5,0,1,1,0,0,0,1.0,4.0,41,1,5,6,42.0,82,5.24,53,338,2262,9.5,0.14421028
11988,11988,Jason Pominville,2004-05,22.0,2,0,1,1,0,0,0,3.0,14.0,1,0,0,0,3.0,82,5.14,57,348,2300,9.2,0.31195343
11989,11989,Jason Pominville,2006-07,24.0,3,30,57,57,18,12,30,124.0,805.0,58,18,12,30,127.0,82,6.05,85,480,2458,10.1,0.503833
11990,11990,Jason Pominville,2007-08,25.0,4,68,82,82,34,34,68,212.0,1428.0,140,52,46,98,339.0,82,5.76,70,398,2426,9.7,0.7889885
11991,11991,Jason Pominville,2008-09,26.0,5,80,82,82,27,53,80,232.0,1637.0,222,79,99,178,571.0,82,5.44,62,351,2383,9.4,0.91698694
11992,11992,Jason Pominville,2009-10,27.0,6,66,82,82,20,46,66,239.0,1620.0,304,99,145,244,810.0,82,5.7,65,341,2477,9.4,0.7771304
11993,11993,Jason Pominville,2010-11,28.0,7,62,82,82,24,38,62,252.0,1537.0,386,123,183,306,1062.0,82,5.53,56,304,2486,9.1,0.71723044
11994,11994,Jason Pominville,2011-12,29.0,8,52,73,73,22,30,52,215.0,1325.0,459,145,213,358,1277.0,82,5.46,52,291,2492,9.0,0.6633477
11995,11995,Jason Pominville,2012-13,30.0,9,73,82,82,30,43,73,235.0,1614.0,541,175,256,431,1512.0,82,5.32,47,271,2439,8.9,0.8447627
11996,11996,Jason Pominville,2013-14,31.0,10,34,47,47,14,20,34,118.0,948.0,588,189,276,465,1630.0,48,5.31,29,160,1399,9.1,0.66007787
11997,11997,Jason Pominville,2014-15,32.0,11,60,82,82,30,30,60,226.0,1524.0,670,219,306,525,1856.0,82,5.34,48,269,2463,8.9,0.6657183
11998,11998,Jason Pominville,2015-16,33.0,12,54,82,82,18,36,54,252.0,1499.0,752,237,342,579,2108.0,82,5.32,47,251,2453,8.9,0.6659295
11999,11999,Jason Pominville,2016-17,34.0,13,36,75,75,11,25,36,187.0,1227.0,827,248,367,615,2295.0,82,5.34,48,255,2438,9.0,0.49674764
12000,12000,Jason Pominville,2017-18,35.0,14,47,78,78,13,34,47,176.0,1110.0,905,261,401,662,2471.0,82,5.45,47,245,2478,9.0,0.5478017
12001,12001,Jason Pominville,2018-19,36.0,15,34,82,82,16,18,34,168.0,1222.0,987,277,419,696,2639.0,82,5.86,50,250,2620,9.2,0.41313195
12002,12002,Jason Pominville,2019-20,37.0,16,31,73,73,16,15,31,134.0,910.0,1060,293,434,727,2773.0,82,5.96,47,239,2579,9.5,0.40420878
12003,12003,Jason Robertson,2020-21,21.0,2,1,3,3,0,1,1,4.0,37.0,3,0,1,1,4.0,70,5.96,42,208,2192,9.5,0.25606358
12004,12004,Jason Ruff,1993-94,24.0,2,3,8,8,2,1,3,8.0,,8,2,1,3,8.0,84,7.25,87,443,2603,11.7,0.28437096
12005,12005,Jason Ruff,1994-95,25.0,3,3,6,6,1,2,3,14.0,,14,3,3,6,22.0,84,6.48,76,407,2545,10.7,0.20894286
12006,12006,Jason Ryznar,2006-07,23.0,2,0,8,8,0,0,0,1.0,43.0,8,0,0,0,1.0,82,6.05,85,480,2458,10.1,0.16485354
12007,12007,Jason Simon,1994-95,25.0,2,0,4,4,0,0,0,0.0,,4,0,0,0,0.0,84,6.48,76,407,2545,10.7,0.14460874
12008,12008,Jason Simon,1997-98,28.0,3,0,1,1,0,0,0,0.0,,5,0,0,0,0.0,82,5.83,55,336,2444,9.8,0.13082495
12009,12009,Jason Smith,1994-95,21.0,2,5,41,41,0,5,5,47.0,,41,0,5,5,47.0,84,6.48,76,407,2545,10.7,0.20156667
12010,12010,Jason Smith,1995-96,22.0,3,0,2,2,0,0,0,5.0,,43,0,5,5,52.0,48,5.97,37,209,1408,10.2,0.16728023
12011,12011,Jason Smith,1996-97,23.0,4,3,64,64,2,1,3,52.0,,107,2,6,8,104.0,82,6.29,74,413,2481,10.4,0.18982136
12012,12012,Jason Smith,1997-98,24.0,5,8,78,78,1,7,8,74.0,,185,3,13,16,178.0,82,5.83,55,336,2444,9.8,0.1688605
12013,12013,Jason Smith,1998-99,25.0,6,16,81,81,3,13,16,97.0,,266,6,26,32,275.0,82,5.28,57,380,2242,9.6,0.21999037
12014,12014,Jason Smith,1999-00,26.0,7,15,72,72,3,12,15,68.0,1296.0,338,9,38,47,343.0,82,5.27,57,359,2285,9.4,0.18499449
12015,12015,Jason Smith,2000-01,27.0,8,14,80,80,3,11,14,96.0,1700.0,418,12,49,61,439.0,82,5.49,53,331,2294,9.8,0.1936073
12016,12016,Jason Smith,2001-02,28.0,9,20,82,82,5,15,20,140.0,1776.0,500,17,64,81,579.0,82,5.51,63,376,2272,9.9,0.26789075
12017,12017,Jason Smith,2002-03,29.0,10,18,74,74,5,13,18,85.0,1554.0,574,22,77,99,664.0,82,5.24,53,338,2262,9.5,0.23050177
12018,12018,Jason Smith,2003-04,30.0,11,12,68,68,4,8,12,93.0,1480.0,642,26,85,111,757.0,82,5.31,60,363,2326,9.4,0.17961138
12019,12019,Jason Smith,2004-05,31.0,12,19,68,68,7,12,19,84.0,1452.0,710,33,97,130,841.0,82,5.14,57,348,2300,9.2,0.2607879
12020,12020,Jason Smith,2006-07,33.0,13,17,76,76,4,13,17,79.0,1493.0,786,37,110,147,920.0,82,6.05,85,480,2458,10.1,0.17626852
12021,12021,Jason Smith,2007-08,34.0,14,11,82,82,2,9,11,61.0,1733.0,868,39,119,158,981.0,82,5.76,70,398,2426,9.7,0.1257428
12022,12022,Jason Smith,2008-09,35.0,15,10,77,77,1,9,10,58.0,1381.0,945,40,128,168,1039.0,82,5.44,62,351,2383,9.4,0.110452235
12023,12023,Jason Smith,2009-10,36.0,16,1,63,63,1,0,1,53.0,1105.0,1008,41,128,169,1092.0,82,5.7,65,341,2477,9.4,0.112475306
12024,12024,Jason Spezza,2003-04,20.0,2,21,33,33,7,14,21,65.0,418.0,33,7,14,21,65.0,82,5.31,60,363,2326,9.4,0.49651325
12025,12025,Jason Spezza,2004-05,21.0,3,55,78,78,22,33,55,142.0,1142.0,111,29,47,76,207.0,82,5.14,57,348,2300,9.2,0.90370035
12026,12026,Jason Spezza,2006-07,23.0,4,90,68,68,19,71,90,156.0,1292.0,179,48,118,166,363.0,82,6.05,85,480,2458,10.1,1.1697841
12027,12027,Jason Spezza,2007-08,24.0,5,87,67,67,34,53,87,162.0,1292.0,246,82,171,253,525.0,82,5.76,70,398,2426,9.7,1.1170424
12028,12028,Jason Spezza,2008-09,25.0,6,92,76,76,34,58,92,210.0,1571.0,322,116,229,345,735.0,82,5.44,62,351,2383,9.4,1.0605686
12029,12029,Jason Spezza,2009-10,26.0,7,73,82,82,32,41,73,246.0,1615.0,404,148,270,418,981.0,82,5.7,65,341,2477,9.4,0.95894706
12030,12030,Jason Spezza,2010-11,27.0,8,57,60,60,23,34,57,165.0,1144.0,464,171,304,475,1146.0,82,5.53,56,304,2486,9.1,0.877746
12031,12031,Jason Spezza,2011-12,28.0,9,57,62,62,21,36,57,188.0,1252.0,526,192,340,532,1334.0,82,5.46,52,291,2492,9.0,0.8661257
12032,12032,Jason Spezza,2012-13,29.0,10,84,80,80,34,50,84,232.0,1594.0,606,226,390,616,1566.0,82,5.32,47,271,2439,8.9,1.0068036
12033,12033,Jason Spezza,2013-14,30.0,11,5,5,5,2,3,5,12.0,96.0,611,228,393,621,1578.0,48,5.31,29,160,1399,9.1,0.70388997
12034,12034,Jason Spezza,2014-15,31.0,12,66,75,75,23,43,66,223.0,1366.0,686,251,436,687,1801.0,82,5.34,48,269,2463,8.9,0.7836865
12035,12035,Jason Spezza,2015-16,32.0,13,62,82,82,17,45,62,204.0,1412.0,768,268,481,749,2005.0,82,5.32,47,251,2453,8.9,0.75681496
12036,12036,Jason Spezza,2016-17,33.0,14,63,75,75,33,30,63,202.0,1239.0,843,301,511,812,2207.0,82,5.34,48,255,2438,9.0,0.76221025
12037,12037,Jason Spezza,2017-18,34.0,15,50,68,68,15,35,50,149.0,1100.0,911,316,546,862,2356.0,82,5.45,47,245,2478,9.0,0.60883856
12038,12038,Jason Spezza,2018-19,35.0,16,26,78,78,8,18,26,138.0,1014.0,989,324,564,888,2494.0,82,5.86,50,250,2620,9.2,0.33801877
12039,12039,Jason Spezza,2019-20,36.0,17,27,76,76,8,19,27,121.0,1009.0,1065,332,583,915,2615.0,82,5.96,47,239,2579,9.5,0.33237076
12040,12040,Jason Spezza,2020-21,37.0,18,25,58,58,9,16,25,73.0,628.0,1123,341,599,940,2688.0,70,5.96,42,208,2192,9.5,0.34874833
12041,12041,Jason Strudwick,1996-97,21.0,2,0,1,1,0,0,0,0.0,,1,0,0,0,0.0,82,6.29,74,413,2481,10.4,0.18428248
12042,12042,Jason Strudwick,1998-99,23.0,3,2,28,28,0,2,2,8.0,,29,0,2,2,8.0,82,5.28,57,380,2242,9.6,0.12800834
12043,12043,Jason Strudwick,1999-00,24.0,4,3,65,65,0,3,3,25.0,833.0,94,0,5,5,33.0,82,5.27,57,359,2285,9.4,0.10415515
12044,12044,Jason Strudwick,2000-01,25.0,5,4,63,63,1,3,4,18.0,958.0,157,1,8,9,51.0,82,5.49,53,331,2294,9.8,0.08621174
12045,12045,Jason Strudwick,2001-02,26.0,6,5,60,60,1,4,5,21.0,599.0,217,2,12,14,72.0,82,5.51,63,376,2272,9.9,0.08827284
12046,12046,Jason Strudwick,2002-03,27.0,7,6,44,44,2,4,6,13.0,429.0,261,4,16,20,85.0,82,5.24,53,338,2262,9.5,0.10675323
12047,12047,Jason Strudwick,2003-04,28.0,8,5,48,48,2,3,5,19.0,409.0,309,6,19,25,104.0,82,5.31,60,363,2326,9.4,0.10216409
12048,12048,Jason Strudwick,2004-05,29.0,9,4,54,54,1,3,4,32.0,805.0,363,7,22,29,136.0,82,5.14,57,348,2300,9.2,0.118698865
12049,12049,Jason Strudwick,2006-07,31.0,10,7,65,65,3,4,7,31.0,1009.0,428,10,26,36,167.0,82,6.05,85,480,2458,10.1,0.09070116
12050,12050,Jason Strudwick,2007-08,32.0,11,0,8,8,0,0,0,3.0,109.0,436,10,26,36,170.0,82,5.76,70,398,2426,9.7,0.093723804
12051,12051,Jason Strudwick,2008-09,33.0,12,2,52,52,1,1,2,21.0,673.0,488,11,27,38,191.0,82,5.44,62,351,2383,9.4,0.06801009
12052,12052,Jason Strudwick,2009-10,34.0,13,9,71,71,2,7,9,32.0,896.0,559,13,34,47,223.0,82,5.7,65,341,2477,9.4,0.1020453
12053,12053,Jason Strudwick,2010-11,35.0,14,6,72,72,0,6,6,19.0,1219.0,631,13,40,53,242.0,82,5.53,56,304,2486,9.1,0.07838133
12054,12054,Jason Strudwick,2011-12,36.0,15,2,43,43,0,2,2,9.0,648.0,674,13,42,55,251.0,82,5.46,52,291,2492,9.0,0.06035316
12055,12055,Jason Ward,2000-01,22.0,2,3,32,32,2,1,3,24.0,294.0,32,2,1,3,24.0,82,5.49,53,331,2294,9.8,0.240892
12056,12056,Jason Ward,2001-02,23.0,3,0,12,12,0,0,0,4.0,99.0,44,2,1,3,28.0,82,5.51,63,376,2272,9.9,0.15226415
12057,12057,Jason Ward,2003-04,25.0,4,5,8,8,3,2,5,10.0,90.0,52,5,3,8,38.0,82,5.31,60,363,2326,9.4,0.23264498
12058,12058,Jason Ward,2004-05,26.0,5,12,53,53,5,7,12,56.0,671.0,105,10,10,20,94.0,82,5.14,57,348,2300,9.2,0.22953355
12059,12059,Jason Ward,2006-07,28.0,6,28,81,81,10,18,28,125.0,1069.0,186,20,28,48,219.0,82,6.05,85,480,2458,10.1,0.28805518
12060,12060,Jason Ward,2007-08,29.0,7,19,70,70,8,11,19,108.0,883.0,256,28,39,67,327.0,82,5.76,70,398,2426,9.7,0.2667703
12061,12061,Jason Ward,2008-09,30.0,8,14,79,79,8,6,14,85.0,991.0,335,36,45,81,412.0,82,5.44,62,351,2383,9.4,0.18807092
12062,12062,Jason Ward,2009-10,31.0,9,0,1,1,0,0,0,1.0,10.0,336,36,45,81,413.0,82,5.7,65,341,2477,9.4,0.21178672
12063,12063,Jason Widmer,1995-96,22.0,2,0,1,1,0,0,0,0.0,,1,0,0,0,0.0,48,5.97,37,209,1408,10.2,0.18721476
12064,12064,Jason Widmer,1996-97,23.0,3,0,4,4,0,0,0,1.0,,5,0,0,0,1.0,82,6.29,74,413,2481,10.4,0.1561605
12065,12065,Jason Widmer,1997-98,24.0,4,1,2,2,0,1,1,0.0,,7,0,1,1,1.0,82,5.83,55,336,2444,9.8,0.17654854
12066,12066,Jason Wiemer,1995-96,19.0,2,5,36,36,1,4,5,10.0,,36,1,4,5,10.0,48,5.97,37,209,1408,10.2,0.21551982
12067,12067,Jason Wiemer,1996-97,20.0,3,18,66,66,9,9,18,89.0,,102,10,13,23,99.0,82,6.29,74,413,2481,10.4,0.335316
12068,12068,Jason Wiemer,1997-98,21.0,4,14,63,63,9,5,14,103.0,,165,19,18,37,202.0,82,5.83,55,336,2444,9.8,0.2918747
12069,12069,Jason Wiemer,1998-99,22.0,5,22,79,79,12,10,22,122.0,,244,31,28,59,324.0,82,5.28,57,380,2242,9.6,0.32744014
12070,12070,Jason Wiemer,1999-00,23.0,6,21,78,78,8,13,21,128.0,1036.0,322,39,41,80,452.0,82,5.27,57,359,2285,9.4,0.38772744
12071,12071,Jason Wiemer,2000-01,24.0,7,22,64,64,11,11,22,104.0,940.0,386,50,52,102,556.0,82,5.49,53,331,2294,9.8,0.34383637
12072,12072,Jason Wiemer,2001-02,25.0,8,15,65,65,10,5,15,76.0,905.0,451,60,57,117,632.0,82,5.51,63,376,2272,9.9,0.27470368
12073,12073,Jason Wiemer,2002-03,26.0,9,31,70,70,11,20,31,115.0,1201.0,521,71,77,148,747.0,82,5.24,53,338,2262,9.5,0.40616912
12074,12074,Jason Wiemer,2003-04,27.0,10,28,81,81,9,19,28,139.0,1008.0,602,80,96,176,886.0,82,5.31,60,363,2326,9.4,0.3395785
12075,12075,Jason Wiemer,2004-05,28.0,11,22,75,75,8,14,22,103.0,1015.0,677,88,110,198,989.0,82,5.14,57,348,2300,9.2,0.29623556
12076,12076,Jason Wiemer,2006-07,30.0,12,4,49,49,2,2,4,37.0,396.0,726,90,112,202,1026.0,82,6.05,85,480,2458,10.1,0.16965261
12077,12077,Jason Williams,2001-02,21.0,2,3,5,5,0,3,3,7.0,62.0,5,0,3,3,7.0,82,5.51,63,376,2272,9.9,0.23552033
12078,12078,Jason Williams,2002-03,22.0,3,10,25,25,8,2,10,32.0,271.0,30,8,5,13,39.0,82,5.24,53,338,2262,9.5,0.33226398
12079,12079,Jason Williams,2003-04,23.0,4,6,16,16,3,3,6,20.0,171.0,46,11,8,19,59.0,82,5.31,60,363,2326,9.4,0.29692245
12080,12080,Jason Williams,2004-05,24.0,5,13,49,49,6,7,13,44.0,463.0,95,17,15,32,103.0,82,5.14,57,348,2300,9.2,0.28788066
12081,12081,Jason Williams,2006-07,26.0,6,58,80,80,21,37,58,177.0,1193.0,175,38,52,90,280.0,82,6.05,85,480,2458,10.1,0.6268649
12082,12082,Jason Williams,2007-08,27.0,7,32,78,78,15,17,32,149.0,1203.0,253,53,69,122,429.0,82,5.76,70,398,2426,9.7,0.4385693
12083,12083,Jason Williams,2008-09,28.0,8,36,43,43,13,23,36,101.0,713.0,296,66,92,158,530.0,82,5.44,62,351,2383,9.4,0.61619663
12084,12084,Jason Williams,2009-10,29.0,9,47,80,80,19,28,47,153.0,1269.0,376,85,120,205,683.0,82,5.7,65,341,2477,9.4,0.5355626
12085,12085,Jason Williams,2010-11,30.0,10,15,44,44,6,9,15,96.0,595.0,420,91,129,220,779.0,82,5.53,56,304,2486,9.1,0.34989995
12086,12086,Jason Williams,2011-12,31.0,11,5,27,27,2,3,5,18.0,219.0,447,93,132,225,797.0,82,5.46,52,291,2492,9.0,0.2230255
12087,12087,Jason Williams,2012-13,32.0,12,2,8,8,1,1,2,4.0,85.0,455,94,133,227,801.0,82,5.32,47,271,2439,8.9,0.18860662
12088,12088,Jason Woolley,1992-93,23.0,2,0,1,1,0,0,0,2.0,,1,0,0,0,2.0,80,6.96,77,402,2440,11.4,0.21579227
12089,12089,Jason Woolley,1993-94,24.0,3,2,26,26,0,2,2,11.0,,27,0,2,2,13.0,84,7.25,87,443,2603,11.7,0.15171072
12090,12090,Jason Woolley,1994-95,25.0,4,3,10,10,1,2,3,15.0,,37,1,4,5,28.0,84,6.48,76,407,2545,10.7,0.19844809
12091,12091,Jason Woolley,1995-96,26.0,5,13,34,34,4,9,13,76.0,,71,5,13,18,104.0,48,5.97,37,209,1408,10.2,0.32894674
12092,12092,Jason Woolley,1996-97,27.0,6,34,52,52,6,28,34,98.0,,123,11,41,52,202.0,82,6.29,74,413,2481,10.4,0.4476493
12093,12093,Jason Woolley,1997-98,28.0,7,36,60,60,6,30,36,86.0,,183,17,71,88,288.0,82,5.83,55,336,2444,9.8,0.40871277
12094,12094,Jason Woolley,1998-99,29.0,8,35,71,71,9,26,35,129.0,,254,26,97,123,417.0,82,5.28,57,380,2242,9.6,0.45061436
12095,12095,Jason Woolley,1999-00,30.0,9,43,80,80,10,33,43,154.0,1497.0,334,36,130,166,571.0,82,5.27,57,359,2285,9.4,0.4890441
12096,12096,Jason Woolley,2000-01,31.0,10,33,74,74,8,25,33,113.0,1321.0,408,44,155,199,684.0,82,5.49,53,331,2294,9.8,0.37313187
12097,12097,Jason Woolley,2001-02,32.0,11,23,67,67,5,18,23,92.0,1164.0,475,49,173,222,776.0,82,5.51,63,376,2272,9.9,0.27720648
12098,12098,Jason Woolley,2002-03,33.0,12,28,59,59,8,20,28,90.0,1014.0,534,57,193,250,866.0,82,5.24,53,338,2262,9.5,0.39892456
12099,12099,Jason Woolley,2003-04,34.0,13,26,76,76,6,20,26,81.0,1276.0,610,63,213,276,947.0,82,5.31,60,363,2326,9.4,0.2833931
12100,12100,Jason Woolley,2004-05,35.0,14,19,55,55,4,15,19,60.0,864.0,665,67,228,295,1007.0,82,5.14,57,348,2300,9.2,0.33632225
12101,12101,Jason Woolley,2006-07,37.0,15,19,53,53,1,18,19,43.0,631.0,718,68,246,314,1050.0,82,6.05,85,480,2458,10.1,0.27221963
12102,12102,Jason York,1993-94,23.0,2,0,2,2,0,0,0,1.0,,2,0,0,0,1.0,84,7.25,87,443,2603,11.7,0.20706484
12103,12103,Jason York,1994-95,24.0,3,3,7,7,1,2,3,9.0,,9,1,2,3,10.0,84,6.48,76,407,2545,10.7,0.23525307
12104,12104,Jason York,1995-96,25.0,4,11,25,25,1,10,11,28.0,,34,2,12,14,38.0,48,5.97,37,209,1408,10.2,0.23866394
12105,12105,Jason York,1996-97,26.0,5,24,79,79,3,21,24,106.0,,113,5,33,38,144.0,82,6.29,74,413,2481,10.4,0.27988288
12106,12106,Jason York,1997-98,27.0,6,21,75,75,4,17,21,121.0,,188,9,50,59,265.0,82,5.83,55,336,2444,9.8,0.24420336
12107,12107,Jason York,1998-99,28.0,7,16,73,73,3,13,16,109.0,,261,12,63,75,374.0,82,5.28,57,380,2242,9.6,0.24542564
12108,12108,Jason York,1999-00,29.0,8,35,79,79,4,31,35,177.0,1882.0,340,16,94,110,551.0,82,5.27,57,359,2285,9.4,0.40125692
12109,12109,Jason York,2000-01,30.0,9,30,79,79,8,22,30,159.0,1843.0,419,24,116,140,710.0,82,5.49,53,331,2294,9.8,0.37185952
12110,12110,Jason York,2001-02,31.0,10,22,74,74,6,16,22,133.0,1762.0,493,30,132,162,843.0,82,5.51,63,376,2272,9.9,0.29761696
12111,12111,Jason York,2002-03,32.0,11,25,74,74,5,20,25,104.0,1430.0,567,35,152,187,947.0,82,5.24,53,338,2262,9.5,0.28309
12112,12112,Jason York,2003-04,33.0,12,19,74,74,4,15,19,107.0,1477.0,641,39,167,206,1054.0,82,5.31,60,363,2326,9.4,0.25642854
12113,12113,Jason York,2004-05,34.0,13,15,67,67,2,13,15,80.0,1426.0,708,41,180,221,1134.0,82,5.14,57,348,2300,9.2,0.21771285
12114,12114,Jason York,2007-08,37.0,14,8,49,49,1,7,8,27.0,641.0,757,42,187,229,1161.0,82,5.76,70,398,2426,9.7,0.115173936
12115,12115,Jason Zent,1997-98,26.0,2,6,22,22,3,3,6,20.0,,22,3,3,6,20.0,82,5.83,55,336,2444,9.8,0.2246534
12116,12116,Jason Zent,1998-99,27.0,3,0,3,3,0,0,0,1.0,,25,3,3,6,21.0,82,5.28,57,380,2242,9.6,0.15057269
12117,12117,Jason Zent,1999-00,28.0,4,0,2,2,0,0,0,1.0,6.0,27,3,3,6,22.0,82,5.27,57,359,2285,9.4,0.14911368
12118,12118,Jason Zucker,2012-13,21.0,2,2,6,6,0,2,2,10.0,66.0,6,0,2,2,10.0,82,5.32,47,271,2439,8.9,0.26854056
12119,12119,Jason Zucker,2013-14,22.0,3,5,20,20,4,1,5,34.0,225.0,26,4,3,7,44.0,48,5.31,29,160,1399,9.1,0.31861508
12120,12120,Jason Zucker,2014-15,23.0,4,5,21,21,4,1,5,40.0,273.0,47,8,4,12,84.0,82,5.34,48,269,2463,8.9,0.29052123
12121,12121,Jason Zucker,2015-16,24.0,5,26,51,51,21,5,26,124.0,768.0,98,29,9,38,208.0,82,5.32,47,251,2453,8.9,0.51688796
12122,12122,Jason Zucker,2016-17,25.0,6,23,71,71,13,10,23,158.0,1106.0,169,42,19,61,366.0,82,5.34,48,255,2438,9.0,0.3519671
12123,12123,Jason Zucker,2017-18,26.0,7,47,79,79,22,25,47,172.0,1208.0,248,64,44,108,538.0,82,5.45,47,245,2478,9.0,0.56976587
12124,12124,Jason Zucker,2018-19,27.0,8,64,82,82,33,31,64,222.0,1391.0,330,97,75,172,760.0,82,5.86,50,250,2620,9.2,0.6414525
12125,12125,Jason Zucker,2019-20,28.0,9,42,81,81,21,21,42,214.0,1383.0,411,118,96,214,974.0,82,5.96,47,239,2579,9.5,0.5372894
12126,12126,Jason Zucker,2020-21,29.0,10,41,60,60,20,21,41,111.0,980.0,471,138,117,255,1085.0,70,5.96,42,208,2192,9.5,0.5751177
12127,12127,Jassen Cullimore,1995-96,23.0,2,3,34,34,1,2,3,30.0,,34,1,2,3,30.0,48,5.97,37,209,1408,10.2,0.20665744
12128,12128,Jassen Cullimore,1996-97,24.0,3,2,27,27,1,1,2,12.0,,61,2,3,5,42.0,82,6.29,74,413,2481,10.4,0.13141751
12129,12129,Jassen Cullimore,1997-98,25.0,4,8,52,52,2,6,8,54.0,,113,4,9,13,96.0,82,5.83,55,336,2444,9.8,0.16878515
12130,12130,Jassen Cullimore,1998-99,26.0,5,3,28,28,1,2,3,18.0,,141,5,11,16,114.0,82,5.28,57,380,2242,9.6,0.14351526
12131,12131,Jassen Cullimore,1999-00,27.0,6,17,78,78,5,12,17,73.0,1578.0,219,10,23,33,187.0,82,5.27,57,359,2285,9.4,0.19574744
12132,12132,Jassen Cullimore,2000-01,28.0,7,2,46,46,1,1,2,23.0,719.0,265,11,24,35,210.0,82,5.49,53,331,2294,9.8,0.10837403
12133,12133,Jassen Cullimore,2001-02,29.0,8,7,74,74,1,6,7,56.0,1458.0,339,12,30,42,266.0,82,5.51,63,376,2272,9.9,0.13008144
12134,12134,Jassen Cullimore,2002-03,30.0,9,13,78,78,4,9,13,84.0,1568.0,417,16,39,55,350.0,82,5.24,53,338,2262,9.5,0.16720006
12135,12135,Jassen Cullimore,2003-04,31.0,10,4,28,28,1,3,4,23.0,516.0,445,17,42,59,373.0,82,5.31,60,363,2326,9.4,0.15970096
12136,12136,Jassen Cullimore,2004-05,32.0,11,7,79,79,2,5,7,78.0,1503.0,524,19,47,66,451.0,82,5.14,57,348,2300,9.2,0.16013378
12137,12137,Jassen Cullimore,2006-07,34.0,12,7,54,54,1,6,7,23.0,916.0,578,20,53,73,474.0,82,6.05,85,480,2458,10.1,0.094200134
12138,12138,Jassen Cullimore,2007-08,35.0,13,7,65,65,1,6,7,17.0,1058.0,643,21,59,80,491.0,82,5.76,70,398,2426,9.7,0.09512949
12139,12139,Jassen Cullimore,2008-09,36.0,14,13,65,65,3,10,13,55.0,1175.0,708,24,69,93,546.0,82,5.44,62,351,2383,9.4,0.13809457
12140,12140,Jassen Cullimore,2009-10,37.0,15,10,68,68,2,8,10,52.0,1142.0,776,26,77,103,598.0,82,5.7,65,341,2477,9.4,0.13446054
12141,12141,Jassen Cullimore,2011-12,39.0,16,8,36,36,0,8,8,22.0,455.0,812,26,85,111,620.0,82,5.46,52,291,2492,9.0,0.119986355
12142,12142,Jay Beagle,2009-10,24.0,2,0,3,3,0,0,0,5.0,23.0,3,0,0,0,5.0,82,5.7,65,341,2477,9.4,0.17479372
12143,12143,Jay Beagle,2010-11,25.0,3,2,7,7,1,1,2,10.0,65.0,10,1,1,2,15.0,82,5.53,56,304,2486,9.1,0.20163757
12144,12144,Jay Beagle,2011-12,26.0,4,3,31,31,2,1,3,27.0,326.0,41,3,2,5,42.0,82,5.46,52,291,2492,9.0,0.18301535
12145,12145,Jay Beagle,2012-13,27.0,5,5,41,41,4,1,5,49.0,486.0,82,7,3,10,91.0,82,5.32,47,271,2439,8.9,0.16394204
12146,12146,Jay Beagle,2013-14,28.0,6,8,48,48,2,6,8,56.0,581.0,130,9,9,18,147.0,48,5.31,29,160,1399,9.1,0.16957828
12147,12147,Jay Beagle,2014-15,29.0,7,9,62,62,4,5,9,60.0,697.0,192,13,14,27,207.0,82,5.34,48,269,2463,8.9,0.13310069
12148,12148,Jay Beagle,2015-16,30.0,8,20,62,62,10,10,20,84.0,794.0,254,23,24,47,291.0,82,5.32,47,251,2453,8.9,0.24635082
12149,12149,Jay Beagle,2016-17,31.0,9,17,57,57,8,9,17,74.0,799.0,311,31,33,64,365.0,82,5.34,48,255,2438,9.0,0.22536355
12150,12150,Jay Beagle,2017-18,32.0,10,30,81,81,13,17,30,100.0,1104.0,392,44,50,94,465.0,82,5.45,47,245,2478,9.0,0.31885839
12151,12151,Jay Beagle,2018-19,33.0,11,22,79,79,7,15,22,65.0,983.0,471,51,65,116,530.0,82,5.86,50,250,2620,9.2,0.22877938
12152,12152,Jay Beagle,2019-20,34.0,12,13,57,57,3,10,13,45.0,778.0,528,54,75,129,575.0,82,5.96,47,239,2579,9.5,0.17770219
12153,12153,Jay Beagle,2020-21,35.0,13,8,55,55,2,6,8,49.0,691.0,583,56,81,137,624.0,70,5.96,42,208,2192,9.5,0.1600307
12154,12154,Jay Bouwmeester,2003-04,20.0,2,16,82,82,4,12,16,110.0,1652.0,82,4,12,16,110.0,82,5.31,60,363,2326,9.4,0.30112362
12155,12155,Jay Bouwmeester,2004-05,21.0,3,20,61,61,2,18,20,85.0,1405.0,143,6,30,36,195.0,82,5.14,57,348,2300,9.2,0.4545103
12156,12156,Jay Bouwmeester,2006-07,23.0,4,46,82,82,5,41,46,189.0,2090.0,225,11,71,82,384.0,82,6.05,85,480,2458,10.1,0.53807384
12157,12157,Jay Bouwmeester,2007-08,24.0,5,42,82,82,12,30,42,174.0,2144.0,307,23,101,124,558.0,82,5.76,70,398,2426,9.7,0.55679715
12158,12158,Jay Bouwmeester,2008-09,25.0,6,37,82,82,15,22,37,182.0,2252.0,389,38,123,161,740.0,82,5.44,62,351,2383,9.4,0.5699754
12159,12159,Jay Bouwmeester,2009-10,26.0,7,42,82,82,15,27,42,182.0,2213.0,471,53,150,203,922.0,82,5.7,65,341,2477,9.4,0.5555545
12160,12160,Jay Bouwmeester,2010-11,27.0,8,29,82,82,3,26,29,130.0,2125.0,553,56,176,232,1052.0,82,5.53,56,304,2486,9.1,0.36767268
12161,12161,Jay Bouwmeester,2011-12,28.0,9,24,82,82,4,20,24,121.0,2131.0,635,60,196,256,1173.0,82,5.46,52,291,2492,9.0,0.30283323
12162,12162,Jay Bouwmeester,2012-13,29.0,10,29,82,82,5,24,29,107.0,2129.0,717,65,220,285,1280.0,82,5.32,47,271,2439,8.9,0.3581089
12163,12163,Jay Bouwmeester,2013-14,30.0,11,22,47,47,7,15,22,79.0,1158.0,764,72,235,307,1359.0,48,5.31,29,160,1399,9.1,0.44732016
12164,12164,Jay Bouwmeester,2014-15,31.0,12,37,82,82,4,33,37,152.0,1972.0,846,76,268,344,1511.0,82,5.34,48,269,2463,8.9,0.40961033
12165,12165,Jay Bouwmeester,2015-16,32.0,13,13,72,72,2,11,13,92.0,1632.0,918,78,279,357,1603.0,82,5.32,47,251,2453,8.9,0.22459698
12166,12166,Jay Bouwmeester,2016-17,33.0,14,19,72,72,3,16,19,105.0,1664.0,990,81,295,376,1708.0,82,5.34,48,255,2438,9.0,0.26478904
12167,12167,Jay Bouwmeester,2017-18,34.0,15,15,81,81,1,14,15,106.0,1815.0,1071,82,309,391,1814.0,82,5.45,47,245,2478,9.0,0.19802508
12168,12168,Jay Bouwmeester,2018-19,35.0,16,7,35,35,2,5,7,45.0,705.0,1106,84,314,398,1859.0,82,5.86,50,250,2620,9.2,0.18484357
12169,12169,Jay Bouwmeester,2019-20,36.0,17,17,78,78,3,14,17,82.0,1617.0,1184,87,328,415,1941.0,82,5.96,47,239,2579,9.5,0.18989497
12170,12170,Jay Bouwmeester,2020-21,37.0,18,9,56,56,1,8,9,53.0,1208.0,1240,88,336,424,1994.0,70,5.96,42,208,2192,9.5,0.19473684
12171,12171,Jay Caufield,1987-88,27.0,2,3,13,13,2,1,3,8.0,,13,2,1,3,8.0,80,7.34,72,344,2400,12.2,0.3191663
12172,12172,Jay Caufield,1988-89,28.0,3,0,1,1,0,0,0,0.0,,14,2,1,3,8.0,80,7.43,89,437,2435,12.2,0.1774176
12173,12173,Jay Caufield,1989-90,29.0,4,5,58,58,1,4,5,10.0,,72,3,5,8,18.0,80,7.48,85,403,2430,12.3,0.11236808
12174,12174,Jay Caufield,1990-91,30.0,5,3,37,37,1,2,3,6.0,,109,4,7,11,24.0,80,7.37,76,367,2421,12.2,0.12180579
12175,12175,Jay Caufield,1991-92,31.0,6,2,23,23,1,1,2,5.0,,132,5,8,13,29.0,80,6.91,71,366,2385,11.6,0.12987056
12176,12176,Jay Caufield,1992-93,32.0,7,0,50,50,0,0,0,16.0,,182,5,8,13,45.0,80,6.96,77,402,2440,11.4,0.07950458
12177,12177,Jay Caufield,1993-94,33.0,8,0,26,26,0,0,0,6.0,,208,5,8,13,51.0,84,7.25,87,443,2603,11.7,0.10310966
12178,12178,Jay Harrison,2006-07,24.0,2,1,8,8,0,1,1,7.0,151.0,8,0,1,1,7.0,82,6.05,85,480,2458,10.1,0.18355358
12179,12179,Jay Harrison,2007-08,25.0,3,0,5,5,0,0,0,3.0,42.0,13,0,1,1,10.0,82,5.76,70,398,2426,9.7,0.16180822
12180,12180,Jay Harrison,2009-10,27.0,4,1,7,7,0,1,1,6.0,121.0,20,0,2,2,16.0,82,5.7,65,341,2477,9.4,0.15670127
12181,12181,Jay Harrison,2010-11,28.0,5,6,38,38,1,5,6,30.0,559.0,58,1,7,8,46.0,82,5.53,56,304,2486,9.1,0.12911624
12182,12182,Jay Harrison,2011-12,29.0,6,10,72,72,3,7,10,49.0,1100.0,130,4,14,18,95.0,82,5.46,52,291,2492,9.0,0.131459
12183,12183,Jay Harrison,2012-13,30.0,7,23,72,72,9,14,23,128.0,1480.0,202,13,28,41,223.0,82,5.32,47,271,2439,8.9,0.24716887
12184,12184,Jay Harrison,2013-14,31.0,8,10,47,47,3,7,10,54.0,936.0,249,16,35,51,277.0,48,5.31,29,160,1399,9.1,0.22898749
12185,12185,Jay Harrison,2014-15,32.0,9,15,68,68,4,11,15,103.0,1131.0,317,20,46,66,380.0,82,5.34,48,269,2463,8.9,0.19065416
12186,12186,Jay Harrison,2015-16,33.0,10,9,55,55,3,6,9,50.0,876.0,372,23,52,75,430.0,82,5.32,47,251,2453,8.9,0.13599217
12187,12187,Jay Henderson,1999-00,21.0,2,0,4,4,0,0,0,4.0,23.0,4,0,0,0,4.0,82,5.27,57,359,2285,9.4,0.19822276
12188,12188,Jay Henderson,2000-01,22.0,3,4,16,16,1,3,4,18.0,86.0,20,1,3,4,22.0,82,5.49,53,331,2294,9.8,0.21263075
12189,12189,Jay Henderson,2001-02,23.0,4,0,13,13,0,0,0,12.0,90.0,33,1,3,4,34.0,82,5.51,63,376,2272,9.9,0.16467267
12190,12190,Jay Johnston,1981-82,23.0,2,0,2,2,0,0,0,0.0,,2,0,0,0,0.0,80,7.69,77,340,2441,12.6,0.19254631
12191,12191,Jay Johnston,1982-83,24.0,3,0,6,6,0,0,0,3.0,,8,0,0,0,3.0,80,8.03,73,320,2489,12.9,0.20360401
12192,12192,Jay Leach,2006-07,27.0,2,0,2,2,0,0,0,0.0,13.0,2,0,0,0,0.0,82,6.05,85,480,2458,10.1,0.14065385
12193,12193,Jay Leach,2008-09,29.0,3,0,2,2,0,0,0,0.0,9.0,4,0,0,0,0.0,82,5.44,62,351,2383,9.4,0.16037819
12194,12194,Jay Leach,2009-10,30.0,4,1,24,24,0,1,1,5.0,356.0,28,0,1,1,5.0,82,5.7,65,341,2477,9.4,0.0952456
12195,12195,Jay Leach,2010-11,31.0,5,2,35,35,1,1,2,30.0,517.0,63,1,2,3,35.0,82,5.53,56,304,2486,9.1,0.11671054
12196,12196,Jay Leach,2011-12,32.0,6,0,7,7,0,0,0,2.0,100.0,70,1,2,3,37.0,82,5.46,52,291,2492,9.0,0.105617344
12197,12197,Jay Mazur,1989-90,25.0,2,0,1,1,0,0,0,0.0,,1,0,0,0,0.0,80,7.48,85,403,2430,12.3,0.1660105
12198,12198,Jay Mazur,1990-91,26.0,3,0,5,5,0,0,0,4.0,,6,0,0,0,4.0,80,7.37,76,367,2421,12.2,0.19869587
12199,12199,Jay Mazur,1991-92,27.0,4,18,36,36,11,7,18,59.0,,42,11,7,18,63.0,80,6.91,71,366,2385,11.6,0.39688283
12200,12200,Jay Mazur,1992-93,28.0,5,0,5,5,0,0,0,3.0,,47,11,7,18,66.0,80,6.96,77,402,2440,11.4,0.18000692
12201,12201,Jay McClement,2006-07,23.0,2,27,67,67,6,21,27,76.0,934.0,67,6,21,27,76.0,82,6.05,85,480,2458,10.1,0.38859355
12202,12202,Jay McClement,2007-08,24.0,3,36,81,81,8,28,36,104.0,1125.0,148,14,49,63,180.0,82,5.76,70,398,2426,9.7,0.400741
12203,12203,Jay McClement,2008-09,25.0,4,22,81,81,9,13,22,110.0,1128.0,229,23,62,85,290.0,82,5.44,62,351,2383,9.4,0.31135684
12204,12204,Jay McClement,2009-10,26.0,5,26,82,82,12,14,26,137.0,1361.0,311,35,76,111,427.0,82,5.7,65,341,2477,9.4,0.3595936
12205,12205,Jay McClement,2010-11,27.0,6,29,82,82,11,18,29,109.0,1372.0,393,46,94,140,536.0,82,5.53,56,304,2486,9.1,0.36149922
12206,12206,Jay McClement,2011-12,28.0,7,20,80,80,7,13,20,127.0,1335.0,473,53,107,160,663.0,82,5.46,52,291,2492,9.0,0.30808055
12207,12207,Jay McClement,2012-13,29.0,8,17,80,80,10,7,17,95.0,1100.0,553,63,114,177,758.0,82,5.32,47,271,2439,8.9,0.28221142
12208,12208,Jay McClement,2013-14,30.0,9,17,48,48,8,9,17,48.0,732.0,601,71,123,194,806.0,48,5.31,29,160,1399,9.1,0.3488024
12209,12209,Jay McClement,2014-15,31.0,10,10,81,81,4,6,10,67.0,1196.0,682,75,129,204,873.0,82,5.34,48,269,2463,8.9,0.2165896
12210,12210,Jay McClement,2015-16,32.0,11,21,82,82,7,14,21,68.0,1113.0,764,82,143,225,941.0,82,5.32,47,251,2453,8.9,0.22932044
12211,12211,Jay McClement,2016-17,33.0,12,11,77,77,3,8,11,64.0,893.0,841,85,151,236,1005.0,82,5.34,48,255,2438,9.0,0.15675876
12212,12212,Jay McClement,2017-18,34.0,13,8,65,65,5,3,8,37.0,740.0,906,90,154,244,1042.0,82,5.45,47,245,2478,9.0,0.14328298
12213,12213,Jay McKee,1996-97,19.0,2,1,1,1,0,1,1,2.0,,1,0,1,1,2.0,82,6.29,74,413,2481,10.4,0.2558233
12214,12214,Jay McKee,1997-98,20.0,3,10,43,43,1,9,10,29.0,,44,1,10,11,31.0,82,5.83,55,336,2444,9.8,0.23062363
12215,12215,Jay McKee,1998-99,21.0,4,14,56,56,1,13,14,55.0,,100,2,23,25,86.0,82,5.28,57,380,2242,9.6,0.23716107
12216,12216,Jay McKee,1999-00,22.0,5,6,72,72,0,6,6,57.0,1474.0,172,2,29,31,143.0,82,5.27,57,359,2285,9.4,0.17437506
12217,12217,Jay McKee,2000-01,23.0,6,17,78,78,5,12,17,84.0,1635.0,250,7,41,48,227.0,82,5.49,53,331,2294,9.8,0.2638698
12218,12218,Jay McKee,2001-02,24.0,7,11,74,74,1,10,11,62.0,1435.0,324,8,51,59,289.0,82,5.51,63,376,2272,9.9,0.19100222
12219,12219,Jay McKee,2002-03,25.0,8,13,81,81,2,11,13,50.0,1574.0,405,10,62,72,339.0,82,5.24,53,338,2262,9.5,0.1780464
12220,12220,Jay McKee,2003-04,26.0,9,5,59,59,0,5,5,44.0,1106.0,464,10,67,77,383.0,82,5.31,60,363,2326,9.4,0.16773984
12221,12221,Jay McKee,2004-05,27.0,10,5,43,43,2,3,5,29.0,763.0,507,12,70,82,412.0,82,5.14,57,348,2300,9.2,0.1569989
12222,12222,Jay McKee,2006-07,29.0,11,16,75,75,5,11,16,50.0,1354.0,582,17,81,98,462.0,82,6.05,85,480,2458,10.1,0.16902515
12223,12223,Jay McKee,2007-08,30.0,12,0,23,23,0,0,0,19.0,465.0,605,17,81,98,481.0,82,5.76,70,398,2426,9.7,0.13097936
12224,12224,Jay McKee,2008-09,31.0,13,9,66,66,2,7,9,42.0,1181.0,671,19,88,107,523.0,82,5.44,62,351,2383,9.4,0.14516076
12225,12225,Jay McKee,2009-10,32.0,14,8,69,69,1,7,8,43.0,1195.0,740,20,95,115,566.0,82,5.7,65,341,2477,9.4,0.12743306
12226,12226,Jay McKee,2010-11,33.0,15,10,62,62,1,9,10,42.0,957.0,802,21,104,125,608.0,82,5.53,56,304,2486,9.1,0.113014966
12227,12227,Jay Miller,1986-87,26.0,2,3,46,46,3,0,3,21.0,,46,3,0,3,21.0,80,7.94,82,370,2484,12.8,0.13830778
12228,12228,Jay Miller,1987-88,27.0,3,5,55,55,1,4,5,26.0,,101,4,4,8,47.0,80,7.34,72,344,2400,12.2,0.14027715
12229,12229,Jay Miller,1988-89,28.0,4,19,78,78,7,12,19,44.0,,179,11,16,27,91.0,80,7.43,89,437,2435,12.2,0.21131912
12230,12230,Jay Miller,1989-90,29.0,5,14,66,66,7,7,14,30.0,,245,18,23,41,121.0,80,7.48,85,403,2430,12.3,0.18833247
12231,12231,Jay Miller,1990-91,30.0,6,12,68,68,10,2,12,44.0,,313,28,25,53,165.0,80,7.37,76,367,2421,12.2,0.19905943
12232,12232,Jay Miller,1991-92,31.0,7,20,66,66,8,12,20,35.0,,379,36,37,73,200.0,80,6.91,71,366,2385,11.6,0.23799512
12233,12233,Jay Miller,1992-93,32.0,8,11,67,67,4,7,11,32.0,,446,40,44,84,232.0,80,6.96,77,402,2440,11.4,0.17340913
12234,12234,Jay More,1989-90,21.0,2,0,1,1,0,0,0,0.0,,1,0,0,0,0.0,80,7.48,85,403,2430,12.3,0.20433158
12235,12235,Jay More,1990-91,22.0,3,0,5,5,0,0,0,4.0,,6,0,0,0,4.0,80,7.37,76,367,2421,12.2,0.22075012
12236,12236,Jay More,1992-93,24.0,4,17,46,46,4,13,17,60.0,,52,4,13,17,64.0,80,6.96,77,402,2440,11.4,0.30178285
12237,12237,Jay More,1993-94,25.0,5,11,73,73,5,6,11,107.0,,125,9,19,28,171.0,84,7.25,87,443,2603,11.7,0.21763557
12238,12238,Jay More,1994-95,26.0,6,7,49,49,1,6,7,38.0,,174,10,25,35,209.0,84,6.48,76,407,2545,10.7,0.15011016
12239,12239,Jay More,1995-96,27.0,7,6,45,45,0,6,6,25.0,,219,10,31,41,234.0,48,5.97,37,209,1408,10.2,0.12641531
12240,12240,Jay More,1996-97,28.0,8,9,74,74,2,7,9,67.0,,293,12,38,50,301.0,82,6.29,74,413,2481,10.4,0.15657583
12241,12241,Jay More,1997-98,29.0,9,8,37,37,1,7,8,28.0,,330,13,45,58,329.0,82,5.83,55,336,2444,9.8,0.15981895
12242,12242,Jay More,1998-99,30.0,10,12,58,58,5,7,12,57.0,,388,18,52,70,386.0,82,5.28,57,380,2242,9.6,0.17624098
12243,12243,Jay More,1999-00,31.0,11,2,18,18,0,2,2,24.0,297.0,406,18,54,72,410.0,82,5.27,57,359,2285,9.4,0.1666539
12244,12244,Jay Pandolfo,1997-98,23.0,2,14,46,46,6,8,14,61.0,,46,6,8,14,61.0,82,5.83,55,336,2444,9.8,0.29160154
12245,12245,Jay Pandolfo,1998-99,24.0,3,4,23,23,1,3,4,23.0,,69,7,11,18,84.0,82,5.28,57,380,2242,9.6,0.22497568
12246,12246,Jay Pandolfo,1999-00,25.0,4,27,70,70,14,13,27,100.0,1065.0,139,21,24,45,184.0,82,5.27,57,359,2285,9.4,0.38853267
12247,12247,Jay Pandolfo,2000-01,26.0,5,15,71,71,7,8,15,86.0,953.0,210,28,32,60,270.0,82,5.49,53,331,2294,9.8,0.24854344
12248,12248,Jay Pandolfo,2001-02,27.0,6,16,63,63,4,12,16,57.0,887.0,273,32,44,76,327.0,82,5.51,63,376,2272,9.9,0.2255772
12249,12249,Jay Pandolfo,2002-03,28.0,7,14,65,65,4,10,14,72.0,909.0,338,36,54,90,399.0,82,5.24,53,338,2262,9.5,0.19555151
12250,12250,Jay Pandolfo,2003-04,29.0,8,17,68,68,6,11,17,92.0,1097.0,406,42,65,107,491.0,82,5.31,60,363,2326,9.4,0.25665706
12251,12251,Jay Pandolfo,2004-05,30.0,9,26,82,82,13,13,26,140.0,1313.0,488,55,78,133,631.0,82,5.14,57,348,2300,9.2,0.37479442
12252,12252,Jay Pandolfo,2006-07,32.0,10,20,82,82,10,10,20,116.0,1479.0,570,65,88,153,747.0,82,6.05,85,480,2458,10.1,0.25376636
12253,12253,Jay Pandolfo,2007-08,33.0,11,27,82,82,13,14,27,109.0,1526.0,652,78,102,180,856.0,82,5.76,70,398,2426,9.7,0.28888816
12254,12254,Jay Pandolfo,2008-09,34.0,12,24,54,54,12,12,24,78.0,933.0,706,90,114,204,934.0,82,5.44,62,351,2383,9.4,0.37274402
12255,12255,Jay Pandolfo,2009-10,35.0,13,10,61,61,5,5,10,63.0,905.0,767,95,119,214,997.0,82,5.7,65,341,2477,9.4,0.17609084
12256,12256,Jay Pandolfo,2010-11,36.0,14,9,52,52,4,5,9,71.0,724.0,819,99,124,223,1068.0,82,5.53,56,304,2486,9.1,0.16825777
12257,12257,Jay Pandolfo,2012-13,38.0,15,3,62,62,1,2,3,44.0,677.0,881,100,126,226,1112.0,82,5.32,47,271,2439,8.9,0.131228
12258,12258,Jay Pandolfo,2013-14,39.0,16,0,18,18,0,0,0,11.0,163.0,899,100,126,226,1123.0,48,5.31,29,160,1399,9.1,0.1780251
12259,12259,Jay Rosehill,2010-11,25.0,2,2,15,15,1,1,2,6.0,94.0,15,1,1,2,6.0,82,5.53,56,304,2486,9.1,0.17999473
12260,12260,Jay Rosehill,2011-12,26.0,3,3,26,26,1,2,3,12.0,135.0,41,2,3,5,18.0,82,5.46,52,291,2492,9.0,0.12090075
12261,12261,Jay Rosehill,2012-13,27.0,4,0,31,31,0,0,0,15.0,183.0,72,2,3,5,33.0,82,5.32,47,271,2439,8.9,0.09708366
12262,12262,Jay Rosehill,2013-14,28.0,5,1,11,11,1,0,1,7.0,75.0,83,3,3,6,40.0,48,5.31,29,160,1399,9.1,0.15924007
12263,12263,Jay Rosehill,2014-15,29.0,6,2,34,34,2,0,2,14.0,168.0,117,5,3,8,54.0,82,5.34,48,269,2463,8.9,0.1288403
12264,12264,Jay Wells,1980-81,21.0,2,0,43,43,0,0,0,22.0,,43,0,0,0,22.0,80,7.03,61,280,2352,12.0,0.17337623
12265,12265,Jay Wells,1981-82,22.0,3,18,72,72,5,13,18,75.0,,115,5,13,18,97.0,80,7.69,77,340,2441,12.6,0.3103796
12266,12266,Jay Wells,1982-83,23.0,4,9,60,60,1,8,9,84.0,,175,6,21,27,181.0,80,8.03,73,320,2489,12.9,0.22711313
12267,12267,Jay Wells,1983-84,24.0,5,15,69,69,3,12,15,101.0,,244,9,33,42,282.0,80,7.73,71,310,2444,12.7,0.27051145
12268,12268,Jay Wells,1984-85,25.0,6,21,69,69,3,18,21,96.0,,313,12,51,63,378.0,80,7.89,74,336,2448,12.9,0.2715391
12269,12269,Jay Wells,1985-86,26.0,7,11,77,77,2,9,11,72.0,,390,14,60,74,450.0,80,7.77,71,321,2447,12.7,0.2211084
12270,12270,Jay Wells,1986-87,27.0,8,42,79,79,11,31,42,113.0,,469,25,91,116,563.0,80,7.94,82,370,2484,12.8,0.42313632
12271,12271,Jay Wells,1987-88,28.0,9,36,77,77,7,29,36,115.0,,546,32,120,152,678.0,80,7.34,72,344,2400,12.2,0.3838932
12272,12272,Jay Wells,1988-89,29.0,10,25,58,58,2,23,25,76.0,,604,34,143,177,754.0,80,7.43,89,437,2435,12.2,0.32506537
12273,12273,Jay Wells,1989-90,30.0,11,21,67,67,2,19,21,67.0,,671,36,162,198,821.0,80,7.48,85,403,2430,12.3,0.25516254
12274,12274,Jay Wells,1990-91,31.0,12,20,60,60,3,17,20,76.0,,731,39,179,218,897.0,80,7.37,76,367,2421,12.2,0.24122503
12275,12275,Jay Wells,1991-92,32.0,13,3,43,43,1,2,3,36.0,,774,40,181,221,933.0,80,6.91,71,366,2385,11.6,0.14104319
12276,12276,Jay Wells,1992-93,33.0,14,11,52,52,2,9,11,30.0,,826,42,190,232,963.0,80,6.96,77,402,2440,11.4,0.20017985
12277,12277,Jay Wells,1993-94,34.0,15,10,53,53,1,9,10,32.0,,879,43,199,242,995.0,84,7.25,87,443,2603,11.7,0.13500875
12278,12278,Jay Wells,1994-95,35.0,16,9,79,79,2,7,9,64.0,,958,45,206,251,1059.0,84,6.48,76,407,2545,10.7,0.11788449
12279,12279,Jay Wells,1995-96,36.0,17,9,43,43,2,7,9,38.0,,1001,47,213,260,1097.0,48,5.97,37,209,1408,10.2,0.14254707
12280,12280,Jay Wells,1996-97,37.0,18,3,76,76,0,3,3,24.0,,1077,47,216,263,1121.0,82,6.29,74,413,2481,10.4,0.082966596
12281,12281,Jay Wells,1997-98,38.0,19,0,21,21,0,0,0,16.0,,1098,47,216,263,1137.0,82,5.83,55,336,2444,9.8,0.1229206
12282,12282,Jayce Hawryluk,2019-20,24.0,2,12,42,42,7,5,12,35.0,396.0,42,7,5,12,35.0,82,5.96,47,239,2579,9.5,0.25432625
12283,12283,Jayce Hawryluk,2020-21,25.0,3,10,26,26,3,7,10,26.0,288.0,68,10,12,22,61.0,70,5.96,42,208,2192,9.5,0.29425165
12284,12284,Jaycob Megna,2017-18,25.0,2,0,1,1,0,0,0,0.0,15.0,1,0,0,0,0.0,82,5.45,47,245,2478,9.0,0.1562587
12285,12285,Jaycob Megna,2018-19,26.0,3,1,14,14,0,1,1,7.0,220.0,15,0,1,1,7.0,82,5.86,50,250,2620,9.2,0.15571544
12286,12286,Jaycob Megna,2019-20,27.0,4,4,28,28,1,3,4,31.0,407.0,43,1,4,5,38.0,82,5.96,47,239,2579,9.5,0.16286972
12287,12287,Jayson Megna,2014-15,24.0,2,9,36,36,5,4,9,36.0,377.0,36,5,4,9,36.0,82,5.34,48,269,2463,8.9,0.23439589
12288,12288,Jayson Megna,2015-16,25.0,3,1,12,12,0,1,1,13.0,132.0,48,5,5,10,49.0,82,5.32,47,251,2453,8.9,0.16847286
12289,12289,Jayson Megna,2016-17,26.0,4,2,6,6,1,1,2,9.0,73.0,54,6,6,12,58.0,82,5.34,48,255,2438,9.0,0.18654084
12290,12290,Jayson Megna,2017-18,27.0,5,8,58,58,4,4,8,72.0,721.0,112,10,10,20,130.0,82,5.45,47,245,2478,9.0,0.1918864
12291,12291,Jayson Megna,2018-19,28.0,6,0,1,1,0,0,0,0.0,4.0,113,10,10,20,130.0,82,5.86,50,250,2620,9.2,0.15048054
12292,12292,Jayson Megna,2020-21,30.0,7,0,8,8,0,0,0,4.0,54.0,121,10,10,20,134.0,70,5.96,42,208,2192,9.5,0.13460559
12293,12293,Jean-Francois Fortin,2002-03,23.0,2,4,36,36,1,3,4,24.0,699.0,36,1,3,4,24.0,82,5.24,53,338,2262,9.5,0.19825295
12294,12294,Jean-Francois Fortin,2003-04,24.0,3,1,33,33,0,1,1,20.0,503.0,69,1,4,5,44.0,82,5.31,60,363,2326,9.4,0.14107138
12295,12295,Jean-Francois Fortin,2004-05,25.0,4,0,2,2,0,0,0,0.0,16.0,71,1,4,5,44.0,82,5.14,57,348,2300,9.2,0.15867606
12296,12296,Jean-Francois Jacques,2006-07,21.0,2,0,7,7,0,0,0,8.0,47.0,7,0,0,0,8.0,82,6.05,85,480,2458,10.1,0.20375195
12297,12297,Jean-Francois Jacques,2007-08,22.0,3,0,37,37,0,0,0,23.0,293.0,44,0,0,0,31.0,82,5.76,70,398,2426,9.7,0.13859904
12298,12298,Jean-Francois Jacques,2008-09,23.0,4,0,9,9,0,0,0,2.0,55.0,53,0,0,0,33.0,82,5.44,62,351,2383,9.4,0.14391601
12299,12299,Jean-Francois Jacques,2009-10,24.0,5,1,7,7,1,0,1,3.0,52.0,60,1,0,1,36.0,82,5.7,65,341,2477,9.4,0.15852654
12300,12300,Jean-Francois Jacques,2010-11,25.0,6,11,49,49,4,7,11,49.0,549.0,109,5,7,12,85.0,82,5.53,56,304,2486,9.1,0.19718847
12301,12301,Jean-Francois Jacques,2011-12,26.0,7,5,51,51,4,1,5,28.0,361.0,160,9,8,17,113.0,82,5.46,52,291,2492,9.0,0.10441834
12302,12302,Jean-Francois Jacques,2012-13,27.0,8,0,6,6,0,0,0,7.0,40.0,166,9,8,17,120.0,82,5.32,47,271,2439,8.9,0.120459884
12303,12303,Jean-Francois Jomphe,1996-97,24.0,2,14,31,31,2,12,14,46.0,,31,2,12,14,46.0,82,6.29,74,413,2481,10.4,0.26672804
12304,12304,Jean-Francois Jomphe,1997-98,25.0,3,21,64,64,7,14,21,81.0,,95,9,26,35,127.0,82,5.83,55,336,2444,9.8,0.3039804
12305,12305,Jean-Francois Jomphe,1998-99,26.0,4,4,9,9,1,3,4,8.0,,104,10,29,39,135.0,82,5.28,57,380,2242,9.6,0.21759114
12306,12306,Jean-Francois Jomphe,1999-00,27.0,5,0,7,7,0,0,0,4.0,62.0,111,10,29,39,139.0,82,5.27,57,359,2285,9.4,0.1619224
12307,12307,Jean-Francois Quintin,1992-93,23.0,2,3,8,8,3,0,3,12.0,,8,3,0,3,12.0,80,6.96,77,402,2440,11.4,0.3463837
12308,12308,Jean-Francois Quintin,1993-94,24.0,3,7,14,14,2,5,7,12.0,,22,5,5,10,24.0,84,7.25,87,443,2603,11.7,0.28926694
12309,12309,Jean-Gabriel Pageau,2013-14,21.0,2,4,9,9,2,2,4,14.0,103.0,9,2,2,4,14.0,48,5.31,29,160,1399,9.1,0.3245137
12310,12310,Jean-Gabriel Pageau,2014-15,22.0,3,2,28,28,2,0,2,31.0,287.0,37,4,2,6,45.0,82,5.34,48,269,2463,8.9,0.2493465
12311,12311,Jean-Gabriel Pageau,2015-16,23.0,4,19,50,50,10,9,19,97.0,709.0,87,14,11,25,142.0,82,5.32,47,251,2453,8.9,0.39560255
12312,12312,Jean-Gabriel Pageau,2016-17,24.0,5,43,82,82,19,24,43,133.0,1370.0,169,33,35,68,275.0,82,5.34,48,255,2438,9.0,0.5045466
12313,12313,Jean-Gabriel Pageau,2017-18,25.0,6,33,82,82,12,21,33,169.0,1323.0,251,45,56,101,444.0,82,5.45,47,245,2478,9.0,0.46472612
12314,12314,Jean-Gabriel Pageau,2018-19,26.0,7,29,78,78,14,15,29,147.0,1306.0,329,59,71,130,591.0,82,5.86,50,250,2620,9.2,0.396743
12315,12315,Jean-Gabriel Pageau,2019-20,27.0,8,12,39,39,4,8,12,83.0,696.0,368,63,79,142,674.0,82,5.96,47,239,2579,9.5,0.32202667
12316,12316,Jean-Gabriel Pageau,2020-21,28.0,9,42,67,67,26,16,42,151.0,1284.0,435,89,95,184,825.0,70,5.96,42,208,2192,9.5,0.57523286
12317,12317,Jean-Guy Trudel,2000-01,25.0,2,0,1,1,0,0,0,0.0,5.0,1,0,0,0,0.0,82,5.49,53,331,2294,9.8,0.15208486
12318,12318,Jean-Guy Trudel,2002-03,27.0,3,0,3,3,0,0,0,1.0,26.0,4,0,0,0,1.0,82,5.24,53,338,2262,9.5,0.1561951
12319,12319,Jean-Guy Trudel,2003-04,28.0,4,0,1,1,0,0,0,0.0,6.0,5,0,0,0,1.0,82,5.31,60,363,2326,9.4,0.13884526
12320,12320,Jean-Luc Grand-Pierre,1999-00,22.0,2,1,16,16,0,1,1,11.0,218.0,16,0,1,1,11.0,82,5.27,57,359,2285,9.4,0.17788672
12321,12321,Jean-Luc Grand-Pierre,2000-01,23.0,3,0,11,11,0,0,0,10.0,167.0,27,0,1,1,21.0,82,5.49,53,331,2294,9.8,0.16999269
12322,12322,Jean-Luc Grand-Pierre,2001-02,24.0,4,5,64,64,1,4,5,33.0,822.0,91,1,5,6,54.0,82,5.51,63,376,2272,9.9,0.12813708
12323,12323,Jean-Luc Grand-Pierre,2002-03,25.0,5,8,81,81,2,6,8,62.0,1243.0,172,3,11,14,116.0,82,5.24,53,338,2262,9.5,0.14948279
12324,12324,Jean-Luc Grand-Pierre,2003-04,26.0,6,1,41,41,1,0,1,32.0,559.0,213,4,11,15,148.0,82,5.31,60,363,2326,9.4,0.13093367
12325,12325,Jean-Luc Grand-Pierre,2004-05,27.0,7,5,56,56,3,2,5,53.0,685.0,269,7,13,20,201.0,82,5.14,57,348,2300,9.2,0.15761122
12326,12326,Jean-Marc Gaulin,1983-84,21.0,2,0,1,1,0,0,0,0.0,,1,0,0,0,0.0,80,7.73,71,310,2444,12.7,0.21353588
12327,12327,Jean-Marc Gaulin,1984-85,22.0,3,0,2,2,0,0,0,0.0,,3,0,0,0,0.0,80,7.89,74,336,2448,12.9,0.20100296
12328,12328,Jean-Marc Gaulin,1985-86,23.0,4,6,22,22,3,3,6,24.0,,25,3,3,6,24.0,80,7.77,71,321,2447,12.7,0.34548026
12329,12329,Jean-Marc Gaulin,1986-87,24.0,5,1,1,1,1,0,1,2.0,,26,4,3,7,26.0,80,7.94,82,370,2484,12.8,0.22937295
12330,12330,Jean-Marc Lanthier,1984-85,21.0,2,3,11,11,2,1,3,9.0,,11,2,1,3,9.0,80,7.89,74,336,2448,12.9,0.37102503
12331,12331,Jean-Marc Lanthier,1985-86,22.0,3,10,27,27,6,4,10,24.0,,38,8,5,13,33.0,80,7.77,71,321,2447,12.7,0.36768594
12332,12332,Jean-Marc Lanthier,1986-87,23.0,4,17,62,62,7,10,17,50.0,,100,15,15,30,83.0,80,7.94,82,370,2484,12.8,0.3194763
12333,12333,Jean-Marc Lanthier,1988-89,25.0,5,2,5,5,1,1,2,3.0,,105,16,16,32,86.0,80,7.43,89,437,2435,12.2,0.26163197
12334,12334,Jean-Marc Richard,1988-89,22.0,2,3,4,4,2,1,3,5.0,,4,2,1,3,5.0,80,7.43,89,437,2435,12.2,0.33773094
12335,12335,Jean-Marc Richard,1990-91,24.0,3,0,1,1,0,0,0,0.0,,5,2,1,3,5.0,80,7.37,76,367,2421,12.2,0.2009041
12336,12336,Jean-Marc Routhier,1990-91,22.0,2,0,8,8,0,0,0,8.0,,8,0,0,0,8.0,80,7.37,76,367,2421,12.2,0.21682093
12337,12337,Jean-Philippe Cote,2006-07,24.0,2,0,8,8,0,0,0,2.0,88.0,8,0,0,0,2.0,82,6.05,85,480,2458,10.1,0.16396457
12338,12338,Jean-Philippe Cote,2014-15,32.0,3,4,19,19,0,4,4,12.0,190.0,27,0,4,4,14.0,82,5.34,48,269,2463,8.9,0.10076204
12339,12339,Jean-Sebastien Dea,2017-18,23.0,2,0,1,1,0,0,0,1.0,11.0,1,0,0,0,1.0,82,5.45,47,245,2478,9.0,0.18257251
12340,12340,Jean-Sebastien Dea,2018-19,24.0,3,1,5,5,1,0,1,1.0,27.0,6,1,0,1,2.0,82,5.86,50,250,2620,9.2,0.20033765
12341,12341,Jean-Sebastien Dea,2019-20,25.0,4,6,23,23,4,2,6,29.0,236.0,29,5,2,7,31.0,82,5.96,47,239,2579,9.5,0.23953703
12342,12342,Jean-Sebastien Dea,2020-21,26.0,5,0,3,3,0,0,0,0.0,23.0,32,5,2,7,31.0,70,5.96,42,208,2192,9.5,0.22647125
12343,12343,Jean-Yves Leroux,1997-98,21.0,2,1,1,1,0,1,1,0.0,,1,0,1,1,0.0,82,5.83,55,336,2444,9.8,0.23498014
12344,12344,Jean-Yves Leroux,1998-99,22.0,3,13,66,66,6,7,13,57.0,,67,6,8,14,57.0,82,5.28,57,380,2242,9.6,0.2152659
12345,12345,Jean-Yves Leroux,1999-00,23.0,4,8,40,40,3,5,8,47.0,509.0,107,9,13,22,104.0,82,5.27,57,359,2285,9.4,0.27276093
12346,12346,Jean-Yves Leroux,2000-01,24.0,5,8,54,54,3,5,8,36.0,579.0,161,12,18,30,140.0,82,5.49,53,331,2294,9.8,0.16107646
12347,12347,Jean-Yves Leroux,2001-02,25.0,6,8,59,59,4,4,8,60.0,601.0,220,16,22,38,200.0,82,5.51,63,376,2272,9.9,0.17151639
12348,12348,Jean-Yves Roy,1995-96,26.0,2,1,3,3,1,0,1,8.0,,3,1,0,1,8.0,48,5.97,37,209,1408,10.2,0.23180893
12349,12349,Jean-Yves Roy,1996-97,27.0,3,2,4,4,1,1,2,6.0,,7,2,1,3,14.0,82,6.29,74,413,2481,10.4,0.20948187
12350,12350,Jean-Yves Roy,1997-98,28.0,4,25,52,52,10,15,25,100.0,,59,12,16,28,114.0,82,5.83,55,336,2444,9.8,0.40398228
12351,12351,Jean-Yves Roy,1998-99,29.0,5,0,2,2,0,0,0,1.0,,61,12,16,28,115.0,82,5.28,57,380,2242,9.6,0.16474465
12352,12352,Jed Ortmeyer,2004-05,26.0,2,6,58,58,2,4,6,48.0,572.0,58,2,4,6,48.0,82,5.14,57,348,2300,9.2,0.17857516
12353,12353,Jed Ortmeyer,2006-07,28.0,3,7,78,78,5,2,7,90.0,866.0,136,7,6,13,138.0,82,6.05,85,480,2458,10.1,0.16976118
12354,12354,Jed Ortmeyer,2007-08,29.0,4,11,41,41,2,9,11,67.0,516.0,177,9,15,24,205.0,82,5.76,70,398,2426,9.7,0.20362341
12355,12355,Jed Ortmeyer,2008-09,30.0,5,8,51,51,4,4,8,68.0,635.0,228,13,19,32,273.0,82,5.44,62,351,2383,9.4,0.16708383
12356,12356,Jed Ortmeyer,2009-10,31.0,6,0,2,2,0,0,0,4.0,22.0,230,13,19,32,277.0,82,5.7,65,341,2477,9.4,0.14081743
12357,12357,Jed Ortmeyer,2010-11,32.0,7,19,76,76,8,11,19,131.0,875.0,306,21,30,51,408.0,82,5.53,56,304,2486,9.1,0.2473689
12358,12358,Jed Ortmeyer,2011-12,33.0,8,0,4,4,0,0,0,5.0,38.0,310,21,30,51,413.0,82,5.46,52,291,2492,9.0,0.13793397
12359,12359,Jed Ortmeyer,2012-13,34.0,9,2,35,35,1,1,2,41.0,340.0,345,22,31,53,454.0,82,5.32,47,271,2439,8.9,0.12901509
12360,12360,Jeff Bandura,1981-82,24.0,2,1,2,2,0,1,1,2.0,,2,0,1,1,2.0,80,7.69,77,340,2441,12.6,0.24307808
12361,12361,Jeff Batters,1994-95,24.0,2,0,6,6,0,0,0,1.0,,6,0,0,0,1.0,84,6.48,76,407,2545,10.7,0.16493872
12362,12362,Jeff Batters,1995-96,25.0,3,0,10,10,0,0,0,3.0,,16,0,0,0,4.0,48,5.97,37,209,1408,10.2,0.16722682
12363,12363,Jeff Beukeboom,1987-88,22.0,2,11,44,44,3,8,11,24.0,,44,3,8,11,24.0,80,7.34,72,344,2400,12.2,0.2763329
12364,12364,Jeff Beukeboom,1988-89,23.0,3,25,73,73,5,20,25,76.0,,117,8,28,36,100.0,80,7.43,89,437,2435,12.2,0.3585359
12365,12365,Jeff Beukeboom,1989-90,24.0,4,5,36,36,0,5,5,26.0,,153,8,33,41,126.0,80,7.48,85,403,2430,12.3,0.18687835
12366,12366,Jeff Beukeboom,1990-91,25.0,5,13,46,46,1,12,13,36.0,,199,9,45,54,162.0,80,7.37,76,367,2421,12.2,0.23307508
12367,12367,Jeff Beukeboom,1991-92,26.0,6,10,67,67,3,7,10,48.0,,266,12,52,64,210.0,80,6.91,71,366,2385,11.6,0.22541761
12368,12368,Jeff Beukeboom,1992-93,27.0,7,16,74,74,1,15,16,48.0,,340,13,67,80,258.0,80,6.96,77,402,2440,11.4,0.19583383
12369,12369,Jeff Beukeboom,1993-94,28.0,8,19,82,82,2,17,19,54.0,,422,15,84,99,312.0,84,7.25,87,443,2603,11.7,0.20402485
12370,12370,Jeff Beukeboom,1994-95,29.0,9,16,68,68,8,8,16,58.0,,490,23,92,115,370.0,84,6.48,76,407,2545,10.7,0.2211225
12371,12371,Jeff Beukeboom,1995-96,30.0,10,4,44,44,1,3,4,29.0,,534,24,95,119,399.0,48,5.97,37,209,1408,10.2,0.1340062
12372,12372,Jeff Beukeboom,1996-97,31.0,11,14,82,82,3,11,14,65.0,,616,27,106,133,464.0,82,6.29,74,413,2481,10.4,0.15370199
12373,12373,Jeff Beukeboom,1997-98,32.0,12,12,80,80,3,9,12,55.0,,696,30,115,145,519.0,82,5.83,55,336,2444,9.8,0.13295516
12374,12374,Jeff Beukeboom,1998-99,33.0,13,5,63,63,0,5,5,23.0,,759,30,120,150,542.0,82,5.28,57,380,2242,9.6,0.10456672
12375,12375,Jeff Beukeboom,1999-00,34.0,14,9,45,45,0,9,9,8.0,628.0,804,30,129,159,550.0,82,5.27,57,359,2285,9.4,0.08962238
12376,12376,Jeff Bloemberg,1989-90,22.0,2,0,9,9,0,0,0,9.0,,9,0,0,0,9.0,80,7.48,85,403,2430,12.3,0.229462
12377,12377,Jeff Bloemberg,1990-91,23.0,3,6,28,28,3,3,6,20.0,,37,3,3,6,29.0,80,7.37,76,367,2421,12.2,0.27307704
12378,12378,Jeff Bloemberg,1991-92,24.0,4,2,3,3,0,2,2,4.0,,40,3,5,8,33.0,80,6.91,71,366,2385,11.6,0.2240592
12379,12379,Jeff Bloemberg,1992-93,25.0,5,1,3,3,0,1,1,5.0,,43,3,6,9,38.0,80,6.96,77,402,2440,11.4,0.1979689
12380,12380,Jeff Brown,1986-87,20.0,2,5,8,8,3,2,5,16.0,,8,3,2,5,16.0,80,7.94,82,370,2484,12.8,0.38951337
12381,12381,Jeff Brown,1987-88,21.0,3,29,44,44,7,22,29,99.0,,52,10,24,34,115.0,80,7.34,72,344,2400,12.2,0.5860504
12382,12382,Jeff Brown,1988-89,22.0,4,52,78,78,16,36,52,208.0,,130,26,60,86,323.0,80,7.43,89,437,2435,12.2,0.73446226
12383,12383,Jeff Brown,1989-90,23.0,5,68,78,78,21,47,68,276.0,,208,47,107,154,599.0,80,7.48,85,403,2430,12.3,0.87859434
12384,12384,Jeff Brown,1990-91,24.0,6,54,77,77,16,38,54,284.0,,285,63,145,208,883.0,80,7.37,76,367,2421,12.2,0.79333746
12385,12385,Jeff Brown,1991-92,25.0,7,59,67,67,12,47,59,176.0,,352,75,192,267,1059.0,80,6.91,71,366,2385,11.6,0.80878234
12386,12386,Jeff Brown,1992-93,26.0,8,59,80,80,20,39,59,214.0,,432,95,231,326,1273.0,80,6.96,77,402,2440,11.4,0.81629753
12387,12387,Jeff Brown,1993-94,27.0,9,78,71,71,25,53,78,220.0,,503,120,284,404,1493.0,84,7.25,87,443,2603,11.7,0.8599223
12388,12388,Jeff Brown,1994-95,28.0,10,66,74,74,14,52,66,237.0,,577,134,336,470,1730.0,84,6.48,76,407,2545,10.7,0.77645296
12389,12389,Jeff Brown,1995-96,29.0,11,31,33,33,8,23,31,111.0,,610,142,359,501,1841.0,48,5.97,37,209,1408,10.2,0.8774222
12390,12390,Jeff Brown,1996-97,30.0,12,55,76,76,8,47,55,177.0,,686,150,406,556,2018.0,82,6.29,74,413,2481,10.4,0.5999886
12391,12391,Jeff Brown,1997-98,31.0,13,0,1,1,0,0,0,0.0,,687,150,406,556,2018.0,82,5.83,55,336,2444,9.8,0.4872603
12392,12392,Jeff Brown,1998-99,32.0,14,28,60,60,4,24,28,102.0,,747,154,430,584,2120.0,82,5.28,57,380,2242,9.6,0.43832654
12393,12393,Jeff Brownschidle,1982-83,23.0,2,1,3,3,0,1,1,4.0,,3,0,1,1,4.0,80,8.03,73,320,2489,12.9,0.2510293
12394,12394,Jeff Brownschidle,1983-84,24.0,3,0,4,4,0,0,0,0.0,,7,0,1,1,4.0,80,7.73,71,310,2444,12.7,0.19009557
12395,12395,Jeff Brubaker,1980-81,22.0,2,1,3,3,0,1,1,2.0,,3,0,1,1,2.0,80,7.03,61,280,2352,12.0,0.25082597
12396,12396,Jeff Brubaker,1981-82,23.0,3,8,43,43,5,3,8,29.0,,46,5,4,9,31.0,80,7.69,77,340,2441,12.6,0.22593516
12397,12397,Jeff Brubaker,1982-83,24.0,4,1,3,3,0,1,1,3.0,,49,5,5,10,34.0,80,8.03,73,320,2489,12.9,0.2195054
12398,12398,Jeff Brubaker,1984-85,26.0,5,0,4,4,0,0,0,2.0,,53,5,5,10,36.0,80,7.89,74,336,2448,12.9,0.18053767
12399,12399,Jeff Brubaker,1985-86,27.0,6,12,68,68,8,4,12,39.0,,121,13,9,22,75.0,80,7.77,71,321,2447,12.7,0.19987032
12400,12400,Jeff Brubaker,1986-87,28.0,7,1,25,25,1,0,1,12.0,,146,14,9,23,87.0,80,7.94,82,370,2484,12.8,0.13777757
12401,12401,Jeff Brubaker,1988-89,30.0,8,2,31,31,2,0,2,9.0,,177,16,9,25,96.0,80,7.43,89,437,2435,12.2,0.1772047
12402,12402,Jeff Brubaker,1989-90,31.0,9,0,1,1,0,0,0,0.0,,178,16,9,25,96.0,80,7.48,85,403,2430,12.3,0.15756008
12403,12403,Jeff Buchanan,1999-00,28.0,2,0,6,6,0,0,0,1.0,25.0,6,0,0,0,1.0,82,5.27,57,359,2285,9.4,0.14585838
12404,12404,Jeff Carter,2006-07,22.0,2,42,81,81,23,19,42,189.0,978.0,81,23,19,42,189.0,82,6.05,85,480,2458,10.1,0.58728063
12405,12405,Jeff Carter,2007-08,23.0,3,37,62,62,14,23,37,215.0,1178.0,143,37,42,79,404.0,82,5.76,70,398,2426,9.7,0.61405355
12406,12406,Jeff Carter,2008-09,24.0,4,53,82,82,29,24,53,260.0,1545.0,225,66,66,132,664.0,82,5.44,62,351,2383,9.4,0.76599973
12407,12407,Jeff Carter,2009-10,25.0,5,84,82,82,46,38,84,342.0,1718.0,307,112,104,216,1006.0,82,5.7,65,341,2477,9.4,1.0028777
12408,12408,Jeff Carter,2010-11,26.0,6,61,74,74,33,28,61,319.0,1428.0,381,145,132,277,1325.0,82,5.53,56,304,2486,9.1,0.73392266
12409,12409,Jeff Carter,2011-12,27.0,7,66,80,80,36,30,66,335.0,1460.0,461,181,162,343,1660.0,82,5.46,52,291,2492,9.0,0.7626072
12410,12410,Jeff Carter,2012-13,28.0,8,34,55,55,21,13,34,184.0,1055.0,516,202,175,377,1844.0,82,5.32,47,271,2439,8.9,0.6570486
12411,12411,Jeff Carter,2013-14,29.0,9,33,48,48,26,7,33,133.0,844.0,564,228,182,410,1977.0,48,5.31,29,160,1399,9.1,0.7031875
12412,12412,Jeff Carter,2014-15,30.0,10,50,72,72,27,23,50,256.0,1365.0,636,255,205,460,2233.0,82,5.34,48,269,2463,8.9,0.6677495
12413,12413,Jeff Carter,2015-16,31.0,11,62,82,82,28,34,62,218.0,1474.0,718,283,239,522,2451.0,82,5.32,47,251,2453,8.9,0.70821035
12414,12414,Jeff Carter,2016-17,32.0,12,62,77,77,24,38,62,242.0,1416.0,795,307,277,584,2693.0,82,5.34,48,255,2438,9.0,0.70511264
12415,12415,Jeff Carter,2017-18,33.0,13,66,82,82,32,34,66,250.0,1479.0,877,339,311,650,2943.0,82,5.45,47,245,2478,9.0,0.7583671
12416,12416,Jeff Carter,2018-19,34.0,14,22,27,27,13,9,22,85.0,482.0,904,352,320,672,3028.0,82,5.86,50,250,2620,9.2,0.5964123
12417,12417,Jeff Carter,2019-20,35.0,15,33,76,76,13,20,33,174.0,1380.0,980,365,340,705,3202.0,82,5.96,47,239,2579,9.5,0.414387
12418,12418,Jeff Carter,2020-21,36.0,16,27,60,60,17,10,27,182.0,1016.0,1040,382,350,732,3384.0,70,5.96,42,208,2192,9.5,0.46486908
12419,12419,Jeff Christian,1992-93,22.0,2,0,2,2,0,0,0,1.0,,2,0,0,0,1.0,80,6.96,77,402,2440,11.4,0.21508399
12420,12420,Jeff Christian,1995-96,25.0,3,0,1,1,0,0,0,2.0,,3,0,0,0,3.0,48,5.97,37,209,1408,10.2,0.18149829
12421,12421,Jeff Christian,1996-97,26.0,4,0,3,3,0,0,0,0.0,,6,0,0,0,3.0,82,6.29,74,413,2481,10.4,0.15126833
12422,12422,Jeff Christian,1997-98,27.0,5,4,11,11,2,2,4,18.0,,17,2,2,4,21.0,82,5.83,55,336,2444,9.8,0.20200896
12423,12423,Jeff Christian,1998-99,28.0,6,0,1,1,0,0,0,0.0,,18,2,2,4,21.0,82,5.28,57,380,2242,9.6,0.15428248
12424,12424,Jeff Chychrun,1987-88,21.0,2,0,1,1,0,0,0,1.0,,1,0,0,0,1.0,80,7.34,72,344,2400,12.2,0.24449232
12425,12425,Jeff Chychrun,1988-89,22.0,3,0,3,3,0,0,0,1.0,,4,0,0,0,2.0,80,7.43,89,437,2435,12.2,0.19674054
12426,12426,Jeff Chychrun,1989-90,23.0,4,5,80,80,1,4,5,53.0,,84,1,4,5,55.0,80,7.48,85,403,2430,12.3,0.16992012
12427,12427,Jeff Chychrun,1990-91,24.0,5,9,79,79,2,7,9,52.0,,163,3,11,14,107.0,80,7.37,76,367,2421,12.2,0.16901991
12428,12428,Jeff Chychrun,1991-92,25.0,6,6,36,36,0,6,6,25.0,,199,3,17,20,132.0,80,6.91,71,366,2385,11.6,0.1464842
12429,12429,Jeff Chychrun,1992-93,26.0,7,4,43,43,0,4,4,26.0,,242,3,21,24,158.0,80,6.96,77,402,2440,11.4,0.11863217
12430,12430,Jeff Chychrun,1993-94,27.0,8,1,18,18,0,1,1,3.0,,260,3,22,25,161.0,84,7.25,87,443,2603,11.7,0.13247794
12431,12431,Jeff Chychrun,1994-95,28.0,9,0,2,2,0,0,0,2.0,,262,3,22,25,163.0,84,6.48,76,407,2545,10.7,0.12678537
12432,12432,Jeff Cowan,2000-01,24.0,2,5,13,13,4,1,5,26.0,135.0,13,4,1,5,26.0,82,5.49,53,331,2294,9.8,0.29642525
12433,12433,Jeff Cowan,2001-02,25.0,3,13,51,51,9,4,13,48.0,465.0,64,13,5,18,74.0,82,5.51,63,376,2272,9.9,0.2473011
12434,12434,Jeff Cowan,2002-03,26.0,4,6,57,57,5,1,6,64.0,620.0,121,18,6,24,138.0,82,5.24,53,338,2262,9.5,0.19179824
12435,12435,Jeff Cowan,2003-04,27.0,5,8,66,66,3,5,8,52.0,554.0,187,21,11,32,190.0,82,5.31,60,363,2326,9.4,0.16659465
12436,12436,Jeff Cowan,2004-05,28.0,6,27,71,71,11,16,27,89.0,736.0,258,32,27,59,279.0,82,5.14,57,348,2300,9.2,0.33347404
12437,12437,Jeff Cowan,2006-07,30.0,7,9,46,46,8,1,9,53.0,388.0,304,40,28,68,332.0,82,6.05,85,480,2458,10.1,0.1831137
12438,12438,Jeff Cowan,2007-08,31.0,8,12,63,63,7,5,12,74.0,507.0,367,47,33,80,406.0,82,5.76,70,398,2426,9.7,0.19761792
12439,12439,Jeff Cowan,2008-09,32.0,9,1,46,46,0,1,1,35.0,402.0,413,47,34,81,441.0,82,5.44,62,351,2383,9.4,0.14111975
12440,12440,Jeff Daniels,1991-92,23.0,2,2,11,11,0,2,2,6.0,,11,0,2,2,6.0,80,6.91,71,366,2385,11.6,0.21796897
12441,12441,Jeff Daniels,1992-93,24.0,3,0,2,2,0,0,0,0.0,,13,0,2,2,6.0,80,6.96,77,402,2440,11.4,0.1892071
12442,12442,Jeff Daniels,1993-94,25.0,4,9,58,58,5,4,9,30.0,,71,5,6,11,36.0,84,7.25,87,443,2603,11.7,0.14260966
12443,12443,Jeff Daniels,1994-95,26.0,5,8,70,70,3,5,8,52.0,,141,8,11,19,88.0,84,6.48,76,407,2545,10.7,0.14873174
12444,12444,Jeff Daniels,1995-96,27.0,6,0,3,3,0,0,0,0.0,,144,8,11,19,88.0,48,5.97,37,209,1408,10.2,0.14206237
12445,12445,Jeff Daniels,1997-98,29.0,7,2,10,10,0,2,2,6.0,,154,8,13,21,94.0,82,5.83,55,336,2444,9.8,0.121905684
12446,12446,Jeff Daniels,1998-99,30.0,8,0,2,2,0,0,0,1.0,,156,8,13,21,95.0,82,5.28,57,380,2242,9.6,0.1247659
12447,12447,Jeff Daniels,1999-00,31.0,9,4,9,9,1,3,4,8.0,98.0,165,9,16,25,103.0,82,5.27,57,359,2285,9.4,0.17017138
12448,12448,Jeff Daniels,2000-01,32.0,10,7,69,69,3,4,7,28.0,531.0,234,12,20,32,131.0,82,5.49,53,331,2294,9.8,0.09543088
12449,12449,Jeff Daniels,2001-02,33.0,11,2,67,67,1,1,2,42.0,502.0,301,13,21,34,173.0,82,5.51,63,376,2272,9.9,0.09950155
12450,12450,Jeff Daniels,2002-03,34.0,12,5,65,65,4,1,5,40.0,527.0,366,17,22,39,213.0,82,5.24,53,338,2262,9.5,0.09848356
12451,12451,Jeff Daniels,2003-04,35.0,13,4,59,59,0,4,4,41.0,497.0,425,17,26,43,254.0,82,5.31,60,363,2326,9.4,0.10894349
12452,12452,Jeff Daw,2002-03,30.0,2,1,1,1,0,1,1,2.0,13.0,1,0,1,1,2.0,82,5.24,53,338,2262,9.5,0.18169644
12453,12453,Jeff Eatough,1982-83,19.0,2,0,1,1,0,0,0,0.0,,1,0,0,0,0.0,80,8.03,73,320,2489,12.9,0.25628674
12454,12454,Jeff Farkas,2001-02,24.0,2,0,2,2,0,0,0,1.0,28.0,2,0,0,0,1.0,82,5.51,63,376,2272,9.9,0.16672665
12455,12455,Jeff Farkas,2002-03,25.0,3,2,6,6,0,2,2,3.0,58.0,8,0,2,2,4.0,82,5.24,53,338,2262,9.5,0.17613205
12456,12456,Jeff Farkas,2003-04,26.0,4,0,3,3,0,0,0,5.0,41.0,11,0,2,2,9.0,82,5.31,60,363,2326,9.4,0.15605167
12457,12457,Jeff Finger,2007-08,28.0,2,5,22,22,1,4,5,16.0,304.0,22,1,4,5,16.0,82,5.76,70,398,2426,9.7,0.17290422
12458,12458,Jeff Finger,2008-09,29.0,3,19,72,72,8,11,19,93.0,1437.0,94,9,15,24,109.0,82,5.44,62,351,2383,9.4,0.2827241
12459,12459,Jeff Finger,2009-10,30.0,4,23,66,66,6,17,23,68.0,1352.0,160,15,32,47,177.0,82,5.7,65,341,2477,9.4,0.26593012
12460,12460,Jeff Finger,2010-11,31.0,5,10,39,39,2,8,10,29.0,538.0,199,17,40,57,206.0,82,5.53,56,304,2486,9.1,0.17790538
12461,12461,Jeff Finley,1988-89,21.0,2,5,10,10,0,5,5,9.0,,10,0,5,5,9.0,80,7.43,89,437,2435,12.2,0.30832767
12462,12462,Jeff Finley,1989-90,22.0,3,0,4,4,0,0,0,1.0,,14,0,5,5,10.0,80,7.48,85,403,2430,12.3,0.20405233
12463,12463,Jeff Finley,1990-91,23.0,4,1,11,11,0,1,1,7.0,,25,0,6,6,17.0,80,7.37,76,367,2421,12.2,0.20121789
12464,12464,Jeff Finley,1991-92,24.0,5,0,11,11,0,0,0,0.0,,36,0,6,6,17.0,80,6.91,71,366,2385,11.6,0.15929043
12465,12465,Jeff Finley,1992-93,25.0,6,11,51,51,1,10,11,25.0,,87,1,16,17,42.0,80,6.96,77,402,2440,11.4,0.19986957
12466,12466,Jeff Finley,1994-95,27.0,7,9,55,55,1,8,9,43.0,,142,2,24,26,85.0,84,6.48,76,407,2545,10.7,0.1261478
12467,12467,Jeff Finley,1996-97,29.0,8,6,65,65,1,5,6,27.0,,207,3,29,32,112.0,82,6.29,74,413,2481,10.4,0.09995231
12468,12468,Jeff Finley,1997-98,30.0,9,10,65,65,3,7,10,38.0,,272,6,36,42,150.0,82,5.83,55,336,2444,9.8,0.13563946
12469,12469,Jeff Finley,1998-99,31.0,10,7,63,63,1,6,7,32.0,,335,7,42,49,182.0,82,5.28,57,380,2242,9.6,0.11613572
12470,12470,Jeff Finley,1999-00,32.0,11,3,32,32,1,2,3,16.0,551.0,367,8,44,52,198.0,82,5.27,57,359,2285,9.4,0.12534705
12471,12471,Jeff Finley,2000-01,33.0,12,10,74,74,2,8,10,31.0,1318.0,441,10,52,62,229.0,82,5.49,53,331,2294,9.8,0.12054655
12472,12472,Jeff Finley,2001-02,34.0,13,10,72,72,2,8,10,35.0,1359.0,513,12,60,72,264.0,82,5.51,63,376,2272,9.9,0.13102847
12473,12473,Jeff Finley,2002-03,35.0,14,6,78,78,0,6,6,39.0,1445.0,591,12,66,78,303.0,82,5.24,53,338,2262,9.5,0.11670688
12474,12474,Jeff Finley,2003-04,36.0,15,4,64,64,1,3,4,30.0,1000.0,655,13,69,82,333.0,82,5.31,60,363,2326,9.4,0.101047724
12475,12475,Jeff Finley,2004-05,37.0,16,1,53,53,0,1,1,25.0,906.0,708,13,70,83,358.0,82,5.14,57,348,2300,9.2,0.098102
12476,12476,Jeff Friesen,1995-96,19.0,2,25,48,48,15,10,25,86.0,,48,15,10,25,86.0,48,5.97,37,209,1408,10.2,0.5541861
12477,12477,Jeff Friesen,1996-97,20.0,3,46,79,79,15,31,46,123.0,,127,30,41,71,209.0,82,6.29,74,413,2481,10.4,0.5906666
12478,12478,Jeff Friesen,1997-98,21.0,4,62,82,82,28,34,62,200.0,,209,58,75,133,409.0,82,5.83,55,336,2444,9.8,0.78789485
12479,12479,Jeff Friesen,1998-99,22.0,5,63,79,79,31,32,63,186.0,,288,89,107,196,595.0,82,5.28,57,380,2242,9.6,0.79891276
12480,12480,Jeff Friesen,1999-00,23.0,6,57,78,78,22,35,57,215.0,1515.0,366,111,142,253,810.0,82,5.27,57,359,2285,9.4,0.73794293
12481,12481,Jeff Friesen,2000-01,24.0,7,61,82,82,26,35,61,191.0,1623.0,448,137,177,314,1001.0,82,5.49,53,331,2294,9.8,0.7879819
12482,12482,Jeff Friesen,2001-02,25.0,8,48,79,79,14,34,48,149.0,1528.0,527,151,211,362,1150.0,82,5.51,63,376,2272,9.9,0.6241934
12483,12483,Jeff Friesen,2002-03,26.0,9,43,81,81,17,26,43,161.0,1457.0,608,168,237,405,1311.0,82,5.24,53,338,2262,9.5,0.5921432
12484,12484,Jeff Friesen,2003-04,27.0,10,51,81,81,23,28,51,179.0,1259.0,689,191,265,456,1490.0,82,5.31,60,363,2326,9.4,0.6147679
12485,12485,Jeff Friesen,2004-05,28.0,11,37,81,81,17,20,37,177.0,1226.0,770,208,285,493,1667.0,82,5.14,57,348,2300,9.2,0.55654883
12486,12486,Jeff Friesen,2006-07,30.0,12,11,51,51,4,7,11,75.0,682.0,821,212,292,504,1742.0,82,6.05,85,480,2458,10.1,0.30521882
12487,12487,Jeff Friesen,2007-08,31.0,13,12,72,72,6,6,12,55.0,877.0,893,218,298,516,1797.0,82,5.76,70,398,2426,9.7,0.2277042
12488,12488,Jeff Giuliano,2006-07,27.0,2,7,48,48,3,4,7,32.0,468.0,48,3,4,7,32.0,82,6.05,85,480,2458,10.1,0.1500149
12489,12489,Jeff Giuliano,2008-09,29.0,3,6,53,53,0,6,6,30.0,627.0,101,3,10,13,62.0,82,5.44,62,351,2383,9.4,0.11411291
12490,12490,Jeff Greenlaw,1987-88,19.0,2,3,22,22,0,3,3,11.0,,22,0,3,3,11.0,80,7.34,72,344,2400,12.2,0.24476993
12491,12491,Jeff Greenlaw,1991-92,23.0,3,2,10,10,2,0,2,9.0,,32,2,3,5,20.0,80,6.91,71,366,2385,11.6,0.28084898
12492,12492,Jeff Greenlaw,1992-93,24.0,4,1,5,5,0,1,1,3.0,,37,2,4,6,23.0,80,6.96,77,402,2440,11.4,0.20280164
12493,12493,Jeff Greenlaw,1993-94,25.0,5,2,16,16,1,1,2,15.0,,53,3,5,8,38.0,84,7.25,87,443,2603,11.7,0.19697362
12494,12494,Jeff Greenlaw,1994-95,26.0,6,1,4,4,0,1,1,6.0,,57,3,6,9,44.0,84,6.48,76,407,2545,10.7,0.16195226
12495,12495,Jeff Halpern,2000-01,24.0,2,29,79,79,18,11,29,108.0,1046.0,79,18,11,29,108.0,82,5.49,53,331,2294,9.8,0.3963993
12496,12496,Jeff Halpern,2001-02,25.0,3,42,80,80,21,21,42,110.0,1291.0,159,39,32,71,218.0,82,5.51,63,376,2272,9.9,0.4840693
12497,12497,Jeff Halpern,2002-03,26.0,4,19,48,48,5,14,19,74.0,735.0,207,44,46,90,292.0,82,5.24,53,338,2262,9.5,0.408433
12498,12498,Jeff Halpern,2003-04,27.0,5,34,82,82,13,21,34,126.0,1429.0,289,57,67,124,418.0,82,5.31,60,363,2326,9.4,0.44495326
12499,12499,Jeff Halpern,2004-05,28.0,6,46,79,79,19,27,46,114.0,1505.0,368,76,94,170,532.0,82,5.14,57,348,2300,9.2,0.5676489
12500,12500,Jeff Halpern,2006-07,30.0,7,44,70,70,11,33,44,151.0,1400.0,438,87,127,214,683.0,82,6.05,85,480,2458,10.1,0.49731615
12501,12501,Jeff Halpern,2007-08,31.0,8,25,76,76,8,17,25,106.0,1277.0,514,95,144,239,789.0,82,5.76,70,398,2426,9.7,0.31692058
12502,12502,Jeff Halpern,2008-09,32.0,9,42,83,83,20,22,42,132.0,1393.0,597,115,166,281,921.0,82,5.44,62,351,2383,9.4,0.44234425
12503,12503,Jeff Halpern,2009-10,33.0,10,16,52,52,7,9,16,60.0,885.0,649,122,175,297,981.0,82,5.7,65,341,2477,9.4,0.31491065
12504,12504,Jeff Halpern,2010-11,34.0,11,19,71,71,9,10,19,71.0,1031.0,720,131,185,316,1052.0,82,5.53,56,304,2486,9.1,0.24054164
12505,12505,Jeff Halpern,2011-12,35.0,12,26,72,72,11,15,26,62.0,917.0,792,142,200,342,1114.0,82,5.46,52,291,2492,9.0,0.25185817
12506,12506,Jeff Halpern,2012-13,36.0,13,16,69,69,4,12,16,63.0,870.0,861,146,212,358,1177.0,82,5.32,47,271,2439,8.9,0.19699189
12507,12507,Jeff Halpern,2013-14,37.0,14,3,46,46,1,2,3,26.0,468.0,907,147,214,361,1203.0,48,5.31,29,160,1399,9.1,0.1720205
12508,12508,Jeff Halpern,2014-15,38.0,15,12,69,69,5,7,12,45.0,710.0,976,152,221,373,1248.0,82,5.34,48,269,2463,8.9,0.1407437
12509,12509,Jeff Hamilton,2004-05,27.0,2,0,1,1,0,0,0,1.0,10.0,1,0,0,0,1.0,82,5.14,57,348,2300,9.2,0.31131017
12510,12510,Jeff Hamilton,2006-07,29.0,3,8,13,13,2,6,8,29.0,137.0,14,2,6,8,30.0,82,6.05,85,480,2458,10.1,0.2913192
12511,12511,Jeff Hamilton,2007-08,30.0,4,39,70,70,18,21,39,138.0,905.0,84,20,27,47,168.0,82,5.76,70,398,2426,9.7,0.5117041
12512,12512,Jeff Hamilton,2008-09,31.0,5,24,58,58,9,15,24,116.0,626.0,142,29,42,71,284.0,82,5.44,62,351,2383,9.4,0.38250452
12513,12513,Jeff Hamilton,2009-10,32.0,6,6,15,15,3,3,6,30.0,194.0,157,32,45,77,314.0,82,5.7,65,341,2477,9.4,0.28453565
12514,12514,Jeff Harding,1989-90,20.0,2,0,6,6,0,0,0,11.0,,6,0,0,0,11.0,80,7.48,85,403,2430,12.3,0.288634
12515,12515,Jeff Harding,1990-91,21.0,3,0,9,9,0,0,0,11.0,,15,0,0,0,22.0,80,7.37,76,367,2421,12.2,0.20769438
12516,12516,Jeff Heerema,2003-04,24.0,2,3,10,10,3,0,3,16.0,96.0,10,3,0,3,16.0,82,5.31,60,363,2326,9.4,0.25113195
12517,12517,Jeff Heerema,2004-05,25.0,3,3,22,22,1,2,3,28.0,230.0,32,4,2,6,44.0,82,5.14,57,348,2300,9.2,0.20128146
12518,12518,Jeff Hoggan,2006-07,28.0,2,8,52,52,2,6,8,60.0,457.0,52,2,6,8,60.0,82,6.05,85,480,2458,10.1,0.17353493
12519,12519,Jeff Hoggan,2007-08,29.0,3,2,46,46,0,2,2,53.0,325.0,98,2,8,10,113.0,82,5.76,70,398,2426,9.7,0.13946545
12520,12520,Jeff Hoggan,2008-09,30.0,4,0,1,1,0,0,0,0.0,8.0,99,2,8,10,113.0,82,5.44,62,351,2383,9.4,0.14637211
12521,12521,Jeff Hoggan,2009-10,31.0,5,1,4,4,0,1,1,7.0,48.0,103,2,9,11,120.0,82,5.7,65,341,2477,9.4,0.14148572
12522,12522,Jeff Hoggan,2010-11,32.0,6,0,4,4,0,0,0,5.0,28.0,107,2,9,11,125.0,82,5.53,56,304,2486,9.1,0.1371488
12523,12523,Jeff Jackson,1985-86,20.0,2,1,17,17,0,1,1,12.0,,17,0,1,1,12.0,80,7.77,71,321,2447,12.7,0.29425505
12524,12524,Jeff Jackson,1986-87,21.0,3,3,5,5,1,2,3,2.0,,22,1,3,4,14.0,80,7.94,82,370,2484,12.8,0.28885663
12525,12525,Jeff Jackson,1987-88,22.0,4,21,64,64,13,8,21,58.0,,86,14,11,25,72.0,80,7.34,72,344,2400,12.2,0.34786785
12526,12526,Jeff Jackson,1988-89,23.0,5,27,68,68,9,18,27,98.0,,154,23,29,52,170.0,80,7.43,89,437,2435,12.2,0.38232902
12527,12527,Jeff Jackson,1989-90,24.0,6,10,33,33,4,6,10,40.0,,187,27,35,62,210.0,80,7.48,85,403,2430,12.3,0.3299484
12528,12528,Jeff Jackson,1990-91,25.0,7,20,65,65,8,12,20,73.0,,252,35,47,82,283.0,80,7.37,76,367,2421,12.2,0.30983454
12529,12529,Jeff Jackson,1991-92,26.0,8,4,10,10,3,1,4,13.0,,262,38,48,86,296.0,80,6.91,71,366,2385,11.6,0.32732642
12530,12530,Jeff Jackson,1992-93,27.0,9,0,1,1,0,0,0,0.0,,263,38,48,86,296.0,80,6.96,77,402,2440,11.4,0.3531732
12531,12531,Jeff Jillson,2002-03,22.0,2,18,48,48,5,13,18,47.0,701.0,48,5,13,18,47.0,82,5.24,53,338,2262,9.5,0.34028256
12532,12532,Jeff Jillson,2003-04,23.0,3,6,26,26,0,6,6,22.0,358.0,74,5,19,24,69.0,82,5.31,60,363,2326,9.4,0.23629758
12533,12533,Jeff Jillson,2004-05,24.0,4,17,64,64,4,13,17,115.0,1151.0,138,9,32,41,184.0,82,5.14,57,348,2300,9.2,0.2757216
12534,12534,Jeff Jillson,2006-07,26.0,5,0,2,2,0,0,0,1.0,29.0,140,9,32,41,185.0,82,6.05,85,480,2458,10.1,0.16999063
12535,12535,Jeff Lank,2000-01,25.0,2,0,2,2,0,0,0,0.0,26.0,2,0,0,0,0.0,82,5.49,53,331,2294,9.8,0.15208486
12536,12536,Jeff Larmer,1982-83,20.0,2,2,8,8,1,1,2,9.0,,8,1,1,2,9.0,80,8.03,73,320,2489,12.9,0.34849983
12537,12537,Jeff Larmer,1983-84,21.0,3,45,65,65,21,24,45,124.0,,73,22,25,47,133.0,80,7.73,71,310,2444,12.7,0.66980505
12538,12538,Jeff Larmer,1984-85,22.0,4,41,76,76,15,26,41,120.0,,149,37,51,88,253.0,80,7.89,74,336,2448,12.9,0.5123048
12539,12539,Jeff Larmer,1985-86,23.0,5,0,7,7,0,0,0,5.0,,156,37,51,88,258.0,80,7.77,71,321,2447,12.7,0.35271645
12540,12540,Jeff Larmer,1986-87,24.0,6,0,2,2,0,0,0,1.0,,158,37,51,88,259.0,80,7.94,82,370,2484,12.8,0.34063658
12541,12541,Jeff Lazaro,1991-92,23.0,2,18,49,49,5,13,18,73.0,,49,5,13,18,73.0,80,6.91,71,366,2385,11.6,0.38683337
12542,12542,Jeff Lazaro,1992-93,24.0,3,9,27,27,3,6,9,46.0,,76,8,19,27,119.0,80,6.96,77,402,2440,11.4,0.3393869
12543,12543,Jeff Lazaro,1993-94,25.0,4,10,26,26,6,4,10,38.0,,102,14,23,37,157.0,84,7.25,87,443,2603,11.7,0.34362322
12544,12544,Jeff Libby,1998-99,24.0,2,0,1,1,0,0,0,0.0,,1,0,0,0,0.0,82,5.28,57,380,2242,9.6,0.15291435
12545,12545,Jeff MacMillan,2004-05,25.0,2,0,4,4,0,0,0,3.0,33.0,4,0,0,0,3.0,82,5.14,57,348,2300,9.2,0.19163993
12546,12546,Jeff Madill,1991-92,26.0,2,4,14,14,4,0,4,24.0,,14,4,0,4,24.0,80,6.91,71,366,2385,11.6,0.31252903
12547,12547,Jeff McLean,1994-95,25.0,2,1,6,6,1,0,1,5.0,,6,1,0,1,5.0,84,6.48,76,407,2545,10.7,0.20859784
12548,12548,Jeff Mitchell,1998-99,23.0,2,0,7,7,0,0,0,3.0,,7,0,0,0,3.0,82,5.28,57,380,2242,9.6,0.17743412
12549,12549,Jeff Nelson,1995-96,23.0,2,1,10,10,1,0,1,4.0,,10,1,0,1,4.0,48,5.97,37,209,1408,10.2,0.22833416
12550,12550,Jeff Nelson,1996-97,24.0,3,7,33,33,0,7,7,21.0,,43,1,7,8,25.0,82,6.29,74,413,2481,10.4,0.16937998
12551,12551,Jeff Nelson,1999-00,27.0,4,3,9,9,2,1,3,8.0,145.0,52,3,8,11,33.0,82,5.27,57,359,2285,9.4,0.19803509
12552,12552,Jeff Nielsen,1997-98,26.0,2,0,2,2,0,0,0,1.0,,2,0,0,0,1.0,82,5.83,55,336,2444,9.8,0.15797141
12553,12553,Jeff Nielsen,1998-99,27.0,3,9,32,32,4,5,9,36.0,,34,4,5,9,37.0,82,5.28,57,380,2242,9.6,0.21908867
12554,12554,Jeff Nielsen,1999-00,28.0,4,9,80,80,5,4,9,94.0,821.0,114,9,9,18,131.0,82,5.27,57,359,2285,9.4,0.19320855
12555,12555,Jeff Nielsen,2000-01,29.0,5,18,79,79,8,10,18,113.0,946.0,193,17,19,36,244.0,82,5.49,53,331,2294,9.8,0.23494923
12556,12556,Jeff Nielsen,2001-02,30.0,6,11,59,59,3,8,11,82.0,800.0,252,20,27,47,326.0,82,5.51,63,376,2272,9.9,0.21172214
12557,12557,Jeff Norton,1988-89,23.0,2,7,15,15,1,6,7,18.0,,15,1,6,7,18.0,80,7.43,89,437,2435,12.2,0.28780344
12558,12558,Jeff Norton,1989-90,24.0,3,31,69,69,1,30,31,126.0,,84,2,36,38,144.0,80,7.48,85,403,2430,12.3,0.4250946
12559,12559,Jeff Norton,1990-91,25.0,4,53,60,60,4,49,53,104.0,,144,6,85,91,248.0,80,7.37,76,367,2421,12.2,0.6570821
12560,12560,Jeff Norton,1991-92,26.0,5,28,44,44,3,25,28,87.0,,188,9,110,119,335.0,80,6.91,71,366,2385,11.6,0.5465612
12561,12561,Jeff Norton,1992-93,27.0,6,19,28,28,1,18,19,34.0,,216,10,128,138,369.0,80,6.96,77,402,2440,11.4,0.5766018
12562,12562,Jeff Norton,1993-94,28.0,7,50,66,66,12,38,50,127.0,,282,22,166,188,496.0,84,7.25,87,443,2603,11.7,0.5832735
12563,12563,Jeff Norton,1994-95,29.0,8,40,64,64,7,33,40,92.0,,346,29,199,228,588.0,84,6.48,76,407,2545,10.7,0.5311906
12564,12564,Jeff Norton,1995-96,30.0,9,30,48,48,3,27,30,48.0,,394,32,226,258,636.0,48,5.97,37,209,1408,10.2,0.5080474
12565,12565,Jeff Norton,1996-97,31.0,10,31,66,66,8,23,31,85.0,,460,40,249,289,721.0,82,6.29,74,413,2481,10.4,0.3954242
12566,12566,Jeff Norton,1997-98,32.0,11,18,75,75,2,16,18,81.0,,535,42,265,307,802.0,82,5.83,55,336,2444,9.8,0.26948476
12567,12567,Jeff Norton,1998-99,33.0,12,17,56,56,4,13,17,61.0,,591,46,278,324,863.0,82,5.28,57,380,2242,9.6,0.2525729
12568,12568,Jeff Norton,1999-00,34.0,13,22,72,72,4,18,22,70.0,1496.0,663,50,296,346,933.0,82,5.27,57,359,2285,9.4,0.2533634
12569,12569,Jeff Norton,2000-01,35.0,14,20,62,62,0,20,20,45.0,1212.0,725,50,316,366,978.0,82,5.49,53,331,2294,9.8,0.24510682
12570,12570,Jeff Norton,2001-02,36.0,15,13,42,42,2,11,13,22.0,785.0,767,52,327,379,1000.0,82,5.51,63,376,2272,9.9,0.16148773
12571,12571,Jeff Norton,2002-03,37.0,16,5,32,32,0,5,5,15.0,644.0,799,52,332,384,1015.0,82,5.24,53,338,2262,9.5,0.14366734
12572,12572,Jeff O'Neill,1996-97,20.0,2,27,65,65,8,19,27,65.0,,65,8,19,27,65.0,82,6.29,74,413,2481,10.4,0.3822718
12573,12573,Jeff O'Neill,1997-98,21.0,3,30,72,72,14,16,30,101.0,,137,22,35,57,166.0,82,5.83,55,336,2444,9.8,0.47547385
12574,12574,Jeff O'Neill,1998-99,22.0,4,39,74,74,19,20,39,114.0,,211,41,55,96,280.0,82,5.28,57,380,2242,9.6,0.5396556
12575,12575,Jeff O'Neill,1999-00,23.0,5,31,75,75,16,15,31,121.0,1255.0,286,57,70,127,401.0,82,5.27,57,359,2285,9.4,0.52068526
12576,12576,Jeff O'Neill,2000-01,24.0,6,63,80,80,25,38,63,189.0,1546.0,366,82,108,190,590.0,82,5.49,53,331,2294,9.8,0.78593934
12577,12577,Jeff O'Neill,2001-02,25.0,7,67,82,82,41,26,67,242.0,1504.0,448,123,134,257,832.0,82,5.51,63,376,2272,9.9,0.7861545
12578,12578,Jeff O'Neill,2002-03,26.0,8,64,76,76,31,33,64,272.0,1500.0,524,154,167,321,1104.0,82,5.24,53,338,2262,9.5,0.7790368
12579,12579,Jeff O'Neill,2003-04,27.0,9,61,82,82,30,31,61,316.0,1571.0,606,184,198,382,1420.0,82,5.31,60,363,2326,9.4,0.7144376
12580,12580,Jeff O'Neill,2004-05,28.0,10,34,67,67,14,20,34,207.0,1171.0,673,198,218,416,1627.0,82,5.14,57,348,2300,9.2,0.6012164
12581,12581,Jeff O'Neill,2006-07,30.0,11,38,74,74,19,19,38,169.0,936.0,747,217,237,454,1796.0,82,6.05,85,480,2458,10.1,0.5047547
12582,12582,Jeff O'Neill,2007-08,31.0,12,42,74,74,20,22,42,165.0,1016.0,821,237,259,496,1961.0,82,5.76,70,398,2426,9.7,0.48239836
12583,12583,Jeff Odgers,1992-93,23.0,2,11,61,61,7,4,11,64.0,,61,7,4,11,64.0,80,6.96,77,402,2440,11.4,0.26751113
12584,12584,Jeff Odgers,1993-94,24.0,3,27,66,66,12,15,27,100.0,,127,19,19,38,164.0,84,7.25,87,443,2603,11.7,0.38256025
12585,12585,Jeff Odgers,1994-95,25.0,4,21,81,81,13,8,21,73.0,,208,32,27,59,237.0,84,6.48,76,407,2545,10.7,0.28200465
12586,12586,Jeff Odgers,1995-96,26.0,5,7,48,48,4,3,7,47.0,,256,36,30,66,284.0,48,5.97,37,209,1408,10.2,0.2318089
12587,12587,Jeff Odgers,1996-97,27.0,6,16,78,78,12,4,16,84.0,,334,48,34,82,368.0,82,6.29,74,413,2481,10.4,0.21732435
12588,12588,Jeff Odgers,1997-98,28.0,7,15,80,80,7,8,15,84.0,,414,55,42,97,452.0,82,5.83,55,336,2444,9.8,0.21583709
12589,12589,Jeff Odgers,1998-99,29.0,8,13,68,68,5,8,13,47.0,,482,60,50,110,499.0,82,5.28,57,380,2242,9.6,0.18691829
12590,12590,Jeff Odgers,1999-00,30.0,9,5,75,75,2,3,5,39.0,384.0,557,62,53,115,538.0,82,5.27,57,359,2285,9.4,0.18105921
12591,12591,Jeff Odgers,2000-01,31.0,10,3,62,62,1,2,3,29.0,334.0,619,63,55,118,567.0,82,5.49,53,331,2294,9.8,0.14300263
12592,12592,Jeff Odgers,2001-02,32.0,11,13,82,82,6,7,13,67.0,709.0,701,69,62,131,634.0,82,5.51,63,376,2272,9.9,0.16305315
12593,12593,Jeff Odgers,2002-03,33.0,12,8,46,46,4,4,8,34.0,397.0,747,73,66,139,668.0,82,5.24,53,338,2262,9.5,0.14527032
12594,12594,Jeff Odgers,2003-04,34.0,13,6,74,74,2,4,6,48.0,577.0,821,75,70,145,716.0,82,5.31,60,363,2326,9.4,0.15259486
12595,12595,Jeff Parker,1987-88,23.0,2,6,15,15,3,3,6,10.0,,15,3,3,6,10.0,80,7.34,72,344,2400,12.2,0.35350478
12596,12596,Jeff Parker,1988-89,24.0,3,2,4,4,0,2,2,0.0,,19,3,5,8,10.0,80,7.43,89,437,2435,12.2,0.22975582
12597,12597,Jeff Parker,1989-90,25.0,4,18,57,57,9,9,18,78.0,,76,12,14,26,88.0,80,7.48,85,403,2430,12.3,0.31802917
12598,12598,Jeff Parker,1990-91,26.0,5,9,61,61,4,5,9,61.0,,137,16,19,35,149.0,80,7.37,76,367,2421,12.2,0.19746238
12599,12599,Jeff Parker,1991-92,27.0,6,0,4,4,0,0,0,4.0,,141,16,19,35,153.0,80,6.91,71,366,2385,11.6,0.16119549
12600,12600,Jeff Paul,2003-04,25.0,2,0,2,2,0,0,0,0.0,7.0,2,0,0,0,0.0,82,5.31,60,363,2326,9.4,0.16297561
12601,12601,Jeff Penner,2010-11,23.0,2,0,2,2,0,0,0,1.0,28.0,2,0,0,0,1.0,82,5.53,56,304,2486,9.1,0.17624307
12602,12602,Jeff Petry,2011-12,24.0,2,5,35,35,1,4,5,41.0,713.0,35,1,4,5,41.0,82,5.46,52,291,2492,9.0,0.19065276
12603,12603,Jeff Petry,2012-13,25.0,3,25,73,73,2,23,25,111.0,1589.0,108,3,27,30,152.0,82,5.32,47,271,2439,8.9,0.33538318
12604,12604,Jeff Petry,2013-14,26.0,4,12,48,48,3,9,12,66.0,1052.0,156,6,36,42,218.0,48,5.31,29,160,1399,9.1,0.28380495
12605,12605,Jeff Petry,2014-15,27.0,5,17,80,80,7,10,17,96.0,1727.0,236,13,46,59,314.0,82,5.34,48,269,2463,8.9,0.23101354
12606,12606,Jeff Petry,2015-16,28.0,6,22,78,78,7,15,22,126.0,1658.0,314,20,61,81,440.0,82,5.32,47,251,2453,8.9,0.24364701
12607,12607,Jeff Petry,2016-17,29.0,7,16,51,51,5,11,16,98.0,1089.0,365,25,72,97,538.0,82,5.34,48,255,2438,9.0,0.29652733
12608,12608,Jeff Petry,2017-18,30.0,8,28,80,80,8,20,28,172.0,1769.0,445,33,92,125,710.0,82,5.45,47,245,2478,9.0,0.393359
12609,12609,Jeff Petry,2018-19,31.0,9,42,82,82,12,30,42,178.0,1927.0,527,45,122,167,888.0,82,5.86,50,250,2620,9.2,0.47120848
12610,12610,Jeff Petry,2019-20,32.0,10,46,82,82,13,33,46,172.0,1896.0,609,58,155,213,1060.0,82,5.96,47,239,2579,9.5,0.48393697
12611,12611,Jeff Petry,2020-21,33.0,11,40,71,71,11,29,40,158.0,1679.0,680,69,184,253,1218.0,70,5.96,42,208,2192,9.5,0.4646022
12612,12612,Jeff Rohlicek,1988-89,23.0,2,0,7,7,0,0,0,2.0,,7,0,0,0,2.0,80,7.43,89,437,2435,12.2,0.22999275
12613,12613,Jeff Rohlicek,1989-90,24.0,3,0,2,2,0,0,0,2.0,,9,0,0,0,4.0,80,7.48,85,403,2430,12.3,0.2039561
12614,12614,Jeff Schultz,2007-08,21.0,2,3,38,38,0,3,3,22.0,692.0,38,0,3,3,22.0,82,5.76,70,398,2426,9.7,0.16173574
12615,12615,Jeff Schultz,2008-09,22.0,3,18,72,72,5,13,18,36.0,1303.0,110,5,16,21,58.0,82,5.44,62,351,2383,9.4,0.26760942
12616,12616,Jeff Schultz,2009-10,23.0,4,12,64,64,1,11,12,40.0,1265.0,174,6,27,33,98.0,82,5.7,65,341,2477,9.4,0.20745549
12617,12617,Jeff Schultz,2010-11,24.0,5,23,73,73,3,20,23,43.0,1450.0,247,9,47,56,141.0,82,5.53,56,304,2486,9.1,0.24839708
12618,12618,Jeff Schultz,2011-12,25.0,6,10,72,72,1,9,10,34.0,1424.0,319,10,56,66,175.0,82,5.46,52,291,2492,9.0,0.15711194
12619,12619,Jeff Schultz,2012-13,26.0,7,6,54,54,1,5,6,22.0,826.0,373,11,61,72,197.0,82,5.32,47,271,2439,8.9,0.11687845
12620,12620,Jeff Schultz,2013-14,27.0,8,3,26,26,0,3,3,12.0,371.0,399,11,64,75,209.0,48,5.31,29,160,1399,9.1,0.13578561
12621,12621,Jeff Schultz,2015-16,29.0,9,1,9,9,0,1,1,7.0,151.0,408,11,65,76,216.0,82,5.32,47,251,2453,8.9,0.15161455
12622,12622,Jeff Schultz,2016-17,30.0,10,0,1,1,0,0,0,1.0,18.0,409,11,65,76,217.0,82,5.34,48,255,2438,9.0,0.16621375
12623,12623,Jeff Serowik,1991-92,25.0,2,0,1,1,0,0,0,1.0,,1,0,0,0,1.0,80,6.91,71,366,2385,11.6,0.19545361
12624,12624,Jeff Serowik,1995-96,29.0,3,0,1,1,0,0,0,0.0,,2,0,0,0,1.0,48,5.97,37,209,1408,10.2,0.16591963
12625,12625,Jeff Serowik,1999-00,33.0,4,6,26,26,0,6,6,26.0,414.0,28,0,6,6,27.0,82,5.27,57,359,2285,9.4,0.17374134
12626,12626,Jeff Shantz,1994-95,21.0,2,16,52,52,3,13,16,56.0,,52,3,13,16,56.0,84,6.48,76,407,2545,10.7,0.31911182
12627,12627,Jeff Shantz,1995-96,22.0,3,18,45,45,6,12,18,58.0,,97,9,25,34,114.0,48,5.97,37,209,1408,10.2,0.4332839
12628,12628,Jeff Shantz,1996-97,23.0,4,20,78,78,6,14,20,72.0,,175,15,39,54,186.0,82,6.29,74,413,2481,10.4,0.30417004
12629,12629,Jeff Shantz,1997-98,24.0,5,30,69,69,9,21,30,86.0,,244,24,60,84,272.0,82,5.83,55,336,2444,9.8,0.40137178
12630,12630,Jeff Shantz,1998-99,25.0,6,31,61,61,11,20,31,69.0,,305,35,80,115,341.0,82,5.28,57,380,2242,9.6,0.4596229
12631,12631,Jeff Shantz,1999-00,26.0,7,30,76,76,13,17,30,82.0,1265.0,381,48,97,145,423.0,82,5.27,57,359,2285,9.4,0.4269404
12632,12632,Jeff Shantz,2000-01,27.0,8,31,74,74,13,18,31,112.0,1350.0,455,61,115,176,535.0,82,5.49,53,331,2294,9.8,0.42756394
12633,12633,Jeff Shantz,2001-02,28.0,9,20,73,73,5,15,20,88.0,1084.0,528,66,130,196,623.0,82,5.51,63,376,2272,9.9,0.2798217
12634,12634,Jeff Shantz,2002-03,29.0,10,6,40,40,3,3,6,37.0,457.0,568,69,133,202,660.0,82,5.24,53,338,2262,9.5,0.27720302
12635,12635,Jeff Shantz,2003-04,30.0,11,9,74,74,3,6,9,68.0,848.0,642,72,139,211,728.0,82,5.31,60,363,2326,9.4,0.207838
12636,12636,Jeff Sharples,1987-88,20.0,2,1,3,3,0,1,1,1.0,,3,0,1,1,1.0,80,7.34,72,344,2400,12.2,0.31247482
12637,12637,Jeff Sharples,1988-89,21.0,3,35,56,56,10,25,35,94.0,,59,10,26,36,95.0,80,7.43,89,437,2435,12.2,0.572034
12638,12638,Jeff Sharples,1989-90,22.0,4,13,46,46,4,9,13,48.0,,105,14,35,49,143.0,80,7.48,85,403,2430,12.3,0.35852244
12639,12639,Jeff Shevalier,1995-96,21.0,2,1,1,1,1,0,1,1.0,,1,1,0,1,1.0,48,5.97,37,209,1408,10.2,0.24969625
12640,12640,Jeff Shevalier,1997-98,23.0,3,13,26,26,4,9,13,42.0,,27,5,9,14,43.0,82,5.83,55,336,2444,9.8,0.30481407
12641,12641,Jeff Shevalier,2000-01,26.0,4,0,5,5,0,0,0,2.0,11.0,32,5,9,14,45.0,82,5.49,53,331,2294,9.8,0.1579842
12642,12642,Jeff Skinner,2011-12,19.0,2,63,82,82,31,32,63,215.0,1372.0,82,31,32,63,215.0,82,5.46,52,291,2492,9.0,0.7908337
12643,12643,Jeff Skinner,2012-13,20.0,3,44,64,64,20,24,44,210.0,1192.0,146,51,56,107,425.0,82,5.32,47,271,2439,8.9,0.7114794
12644,12644,Jeff Skinner,2013-14,21.0,4,24,42,42,13,11,24,159.0,775.0,188,64,67,131,584.0,48,5.31,29,160,1399,9.1,0.7126497
12645,12645,Jeff Skinner,2014-15,22.0,5,54,71,71,33,21,54,274.0,1221.0,259,97,88,185,858.0,82,5.34,48,269,2463,8.9,0.7885969
12646,12646,Jeff Skinner,2015-16,23.0,6,31,77,77,18,13,31,235.0,1236.0,336,115,101,216,1093.0,82,5.32,47,251,2453,8.9,0.57856256
12647,12647,Jeff Skinner,2016-17,24.0,7,51,82,82,28,23,51,258.0,1336.0,418,143,124,267,1351.0,82,5.34,48,255,2438,9.0,0.70091933
12648,12648,Jeff Skinner,2017-18,25.0,8,63,79,79,37,26,63,281.0,1401.0,497,180,150,330,1632.0,82,5.45,47,245,2478,9.0,0.7794521
12649,12649,Jeff Skinner,2018-19,26.0,9,49,82,82,24,25,49,277.0,1370.0,579,204,175,379,1909.0,82,5.86,50,250,2620,9.2,0.69349384
12650,12650,Jeff Skinner,2019-20,27.0,10,63,82,82,40,23,63,268.0,1518.0,661,244,198,442,2177.0,82,5.96,47,239,2579,9.5,0.7596085
12651,12651,Jeff Skinner,2020-21,28.0,11,23,59,59,14,9,23,183.0,973.0,720,258,207,465,2360.0,70,5.96,42,208,2192,9.5,0.5067242
12652,12652,Jeff Taffe,2003-04,22.0,2,4,20,20,3,1,4,18.0,231.0,20,3,1,4,18.0,82,5.31,60,363,2326,9.4,0.24802491
12653,12653,Jeff Taffe,2004-05,23.0,3,18,59,59,8,10,18,67.0,651.0,79,11,11,22,85.0,82,5.14,57,348,2300,9.2,0.42682508
12654,12654,Jeff Taffe,2006-07,25.0,4,0,4,4,0,0,0,3.0,26.0,83,11,11,22,88.0,82,6.05,85,480,2458,10.1,0.18456444
12655,12655,Jeff Taffe,2007-08,26.0,5,6,17,17,4,2,6,34.0,241.0,100,15,13,28,122.0,82,5.76,70,398,2426,9.7,0.26452217
12656,12656,Jeff Taffe,2008-09,27.0,6,12,45,45,5,7,12,56.0,431.0,145,20,20,40,178.0,82,5.44,62,351,2383,9.4,0.2360861
12657,12657,Jeff Taffe,2009-10,28.0,7,2,8,8,0,2,2,5.0,68.0,153,20,22,42,183.0,82,5.7,65,341,2477,9.4,0.17091483
12658,12658,Jeff Taffe,2010-11,29.0,8,2,21,21,1,1,2,18.0,177.0,174,21,23,44,201.0,82,5.53,56,304,2486,9.1,0.15158567
12659,12659,Jeff Taffe,2011-12,30.0,9,0,1,1,0,0,0,0.0,4.0,175,21,23,44,201.0,82,5.46,52,291,2492,9.0,0.21595755
12660,12660,Jeff Taffe,2012-13,31.0,10,2,5,5,0,2,2,7.0,65.0,180,21,25,46,208.0,82,5.32,47,271,2439,8.9,0.15889597
12661,12661,Jeff Tambellini,2006-07,22.0,2,4,25,25,1,3,4,17.0,246.0,25,1,3,4,17.0,82,6.05,85,480,2458,10.1,0.18506774
12662,12662,Jeff Tambellini,2007-08,23.0,3,9,23,23,2,7,9,20.0,166.0,48,3,10,13,37.0,82,5.76,70,398,2426,9.7,0.26066035
12663,12663,Jeff Tambellini,2008-09,24.0,4,4,31,31,1,3,4,43.0,323.0,79,4,13,17,80.0,82,5.44,62,351,2383,9.4,0.21174207
12664,12664,Jeff Tambellini,2009-10,25.0,5,15,65,65,7,8,15,98.0,852.0,144,11,21,32,178.0,82,5.7,65,341,2477,9.4,0.23325306
12665,12665,Jeff Tambellini,2010-11,26.0,6,14,36,36,7,7,14,55.0,413.0,180,18,28,46,233.0,82,5.53,56,304,2486,9.1,0.28492886
12666,12666,Jeff Tambellini,2011-12,27.0,7,17,62,62,9,8,17,114.0,731.0,242,27,36,63,347.0,82,5.46,52,291,2492,9.0,0.25688595
12667,12667,Jeff Teal,1985-86,25.0,2,1,6,6,0,1,1,4.0,,6,0,1,1,4.0,80,7.77,71,321,2447,12.7,0.22252873
12668,12668,Jeff Toms,1996-97,22.0,2,0,1,1,0,0,0,1.0,,1,0,0,0,1.0,82,6.29,74,413,2481,10.4,0.16458139
12669,12669,Jeff Toms,1997-98,23.0,3,10,34,34,2,8,10,53.0,,35,2,8,10,54.0,82,5.83,55,336,2444,9.8,0.25701156
12670,12670,Jeff Toms,1998-99,24.0,4,10,46,46,4,6,10,69.0,,81,6,14,20,123.0,82,5.28,57,380,2242,9.6,0.25204533
12671,12671,Jeff Toms,1999-00,25.0,5,6,21,21,1,5,6,30.0,285.0,102,7,19,26,153.0,82,5.27,57,359,2285,9.4,0.22576138
12672,12672,Jeff Toms,2000-01,26.0,6,3,20,20,1,2,3,18.0,169.0,122,8,21,29,171.0,82,5.49,53,331,2294,9.8,0.1481677
12673,12673,Jeff Toms,2001-02,27.0,7,8,54,54,3,5,8,49.0,478.0,176,11,26,37,220.0,82,5.51,63,376,2272,9.9,0.14119074
12674,12674,Jeff Toms,2002-03,28.0,8,14,52,52,9,5,14,84.0,572.0,228,20,31,51,304.0,82,5.24,53,338,2262,9.5,0.26973552
12675,12675,Jeff Toms,2003-04,29.0,9,4,8,8,2,2,4,12.0,93.0,236,22,33,55,316.0,82,5.31,60,363,2326,9.4,0.2630666
12676,12676,Jeff Ulmer,2001-02,24.0,2,3,21,21,3,0,3,22.0,218.0,21,3,0,3,22.0,82,5.51,63,376,2272,9.9,0.21832386
12677,12677,Jeff Ware,1997-98,20.0,2,0,13,13,0,0,0,4.0,,13,0,0,0,4.0,82,5.83,55,336,2444,9.8,0.2054852
12678,12678,Jeff Ware,1998-99,21.0,3,0,2,2,0,0,0,0.0,,15,0,0,0,4.0,82,5.28,57,380,2242,9.6,0.17510745
12679,12679,Jeff Ware,1999-00,22.0,4,1,6,6,0,1,1,1.0,96.0,21,0,1,1,5.0,82,5.27,57,359,2285,9.4,0.16904375
12680,12680,Jeff Woywitka,2006-07,23.0,2,2,26,26,0,2,2,23.0,277.0,26,0,2,2,23.0,82,6.05,85,480,2458,10.1,0.1948139
12681,12681,Jeff Woywitka,2007-08,24.0,3,7,34,34,1,6,7,28.0,502.0,60,1,8,9,51.0,82,5.76,70,398,2426,9.7,0.18240967
12682,12682,Jeff Woywitka,2008-09,25.0,4,8,27,27,2,6,8,25.0,434.0,87,3,14,17,76.0,82,5.44,62,351,2383,9.4,0.22534049
12683,12683,Jeff Woywitka,2009-10,26.0,5,18,65,65,3,15,18,71.0,1201.0,152,6,29,35,147.0,82,5.7,65,341,2477,9.4,0.2231287
12684,12684,Jeff Woywitka,2010-11,27.0,6,3,36,36,0,3,3,44.0,508.0,188,6,32,38,191.0,82,5.53,56,304,2486,9.1,0.14887637
12685,12685,Jeff Woywitka,2011-12,28.0,7,11,63,63,2,9,11,72.0,1131.0,251,8,41,49,263.0,82,5.46,52,291,2492,9.0,0.17975181
12686,12686,Jeff Woywitka,2012-13,29.0,8,6,27,27,1,5,6,13.0,281.0,278,9,46,55,276.0,82,5.32,47,271,2439,8.9,0.13270348
12687,12687,Jeff Zehr,2000-01,22.0,2,0,4,4,0,0,0,3.0,30.0,4,0,0,0,3.0,82,5.49,53,331,2294,9.8,0.18394265
12688,12688,Jere Karalahti,2000-01,25.0,2,16,48,48,6,10,16,69.0,820.0,48,6,10,16,69.0,82,5.49,53,331,2294,9.8,0.31089342
12689,12689,Jere Karalahti,2001-02,26.0,3,9,56,56,2,7,9,26.0,956.0,104,8,17,25,95.0,82,5.51,63,376,2272,9.9,0.1495252
12690,12690,Jere Karalahti,2002-03,27.0,4,2,45,45,0,2,2,27.0,762.0,149,8,19,27,122.0,82,5.24,53,338,2262,9.5,0.109577686
12691,12691,Jere Lehtinen,1996-97,23.0,2,28,57,57,6,22,28,109.0,,57,6,22,28,109.0,82,6.29,74,413,2481,10.4,0.4770529
12692,12692,Jere Lehtinen,1997-98,24.0,3,43,63,63,16,27,43,134.0,,120,22,49,71,243.0,82,5.83,55,336,2444,9.8,0.58680934
12693,12693,Jere Lehtinen,1998-99,25.0,4,42,72,72,23,19,42,201.0,,192,45,68,113,444.0,82,5.28,57,380,2242,9.6,0.604236
12694,12694,Jere Lehtinen,1999-00,26.0,5,52,74,74,20,32,52,173.0,1450.0,266,65,100,165,617.0,82,5.27,57,359,2285,9.4,0.65742135
12695,12695,Jere Lehtinen,2000-01,27.0,6,8,17,17,3,5,8,29.0,298.0,283,68,105,173,646.0,82,5.49,53,331,2294,9.8,0.4677814
12696,12696,Jere Lehtinen,2001-02,28.0,7,45,74,74,20,25,45,148.0,1427.0,357,88,130,218,794.0,82,5.51,63,376,2272,9.9,0.5464597
12697,12697,Jere Lehtinen,2002-03,29.0,8,49,73,73,25,24,49,198.0,1448.0,430,113,154,267,992.0,82,5.24,53,338,2262,9.5,0.60273343
12698,12698,Jere Lehtinen,2003-04,30.0,9,48,80,80,31,17,48,238.0,1503.0,510,144,171,315,1230.0,82,5.31,60,363,2326,9.4,0.6029164
12699,12699,Jere Lehtinen,2004-05,31.0,10,26,58,58,13,13,26,138.0,1128.0,568,157,184,341,1368.0,82,5.14,57,348,2300,9.2,0.5519402
12700,12700,Jere Lehtinen,2006-07,33.0,11,52,80,80,33,19,52,216.0,1496.0,648,190,203,393,1584.0,82,6.05,85,480,2458,10.1,0.6041446
12701,12701,Jere Lehtinen,2007-08,34.0,12,43,73,73,26,17,43,194.0,1418.0,721,216,220,436,1778.0,82,5.76,70,398,2426,9.7,0.5865791
12702,12702,Jere Lehtinen,2008-09,35.0,13,37,48,48,15,22,37,118.0,908.0,769,231,242,473,1896.0,82,5.44,62,351,2383,9.4,0.62990916
12703,12703,Jere Lehtinen,2009-10,36.0,14,24,48,48,8,16,24,119.0,912.0,817,239,258,497,2015.0,82,5.7,65,341,2477,9.4,0.44726977
12704,12704,Jere Lehtinen,2010-11,37.0,15,17,58,58,4,13,17,87.0,855.0,875,243,271,514,2102.0,82,5.53,56,304,2486,9.1,0.2720852
12705,12705,Jeremy Colliton,2006-07,22.0,2,2,19,19,1,1,2,9.0,120.0,19,1,1,2,9.0,82,6.05,85,480,2458,10.1,0.15846205
12706,12706,Jeremy Colliton,2007-08,23.0,3,0,1,1,0,0,0,0.0,5.0,20,1,1,2,9.0,82,5.76,70,398,2426,9.7,0.16093773
12707,12707,Jeremy Colliton,2008-09,24.0,4,0,16,16,0,0,0,16.0,140.0,36,1,1,2,25.0,82,5.44,62,351,2383,9.4,0.16166252
12708,12708,Jeremy Colliton,2009-10,25.0,5,1,6,6,0,1,1,4.0,66.0,42,1,2,3,29.0,82,5.7,65,341,2477,9.4,0.15087444
12709,12709,Jeremy Colliton,2011-12,27.0,6,3,15,15,2,1,3,7.0,178.0,57,3,3,6,36.0,82,5.46,52,291,2492,9.0,0.1769267
12710,12710,Jeremy Lauzon,2019-20,22.0,2,1,16,16,1,0,1,11.0,249.0,16,1,0,1,11.0,82,5.96,47,239,2579,9.5,0.21253982
12711,12711,Jeremy Lauzon,2020-21,23.0,3,2,19,19,1,1,2,20.0,293.0,35,2,1,3,31.0,70,5.96,42,208,2192,9.5,0.22368899
12712,12712,Jeremy Morin,2011-12,20.0,2,3,9,9,2,1,3,13.0,109.0,9,2,1,3,13.0,82,5.46,52,291,2492,9.0,0.29437566
12713,12713,Jeremy Morin,2012-13,21.0,3,0,3,3,0,0,0,2.0,27.0,12,2,1,3,15.0,82,5.32,47,271,2439,8.9,0.24758056
12714,12714,Jeremy Morin,2013-14,22.0,4,2,3,3,1,1,2,7.0,39.0,15,3,2,5,22.0,48,5.31,29,160,1399,9.1,0.25980765
12715,12715,Jeremy Morin,2014-15,23.0,5,11,24,24,5,6,11,46.0,220.0,39,8,8,16,68.0,82,5.34,48,269,2463,8.9,0.31415382
12716,12716,Jeremy Morin,2015-16,24.0,6,6,43,43,2,4,6,73.0,439.0,82,10,12,22,141.0,82,5.32,47,251,2453,8.9,0.24487701
12717,12717,Jeremy Reich,2004-05,25.0,2,1,9,9,0,1,1,3.0,69.0,9,0,1,1,3.0,82,5.14,57,348,2300,9.2,0.1783087
12718,12718,Jeremy Reich,2007-08,28.0,3,1,32,32,0,1,1,27.0,263.0,41,0,2,2,30.0,82,5.76,70,398,2426,9.7,0.13824016
12719,12719,Jeremy Reich,2008-09,29.0,4,4,58,58,2,2,4,39.0,479.0,99,2,4,6,69.0,82,5.44,62,351,2383,9.4,0.13656077
12720,12720,Jeremy Roenick,1989-90,20.0,2,18,20,20,9,9,18,52.0,,20,9,9,18,52.0,80,7.48,85,403,2430,12.3,0.7393563
12721,12721,Jeremy Roenick,1990-91,21.0,3,66,78,78,26,40,66,173.0,,98,35,49,84,225.0,80,7.37,76,367,2421,12.2,0.9322292
12722,12722,Jeremy Roenick,1991-92,22.0,4,94,79,79,41,53,94,194.0,,177,76,102,178,419.0,80,6.91,71,366,2385,11.6,1.187767
12723,12723,Jeremy Roenick,1992-93,23.0,5,103,80,80,53,50,103,234.0,,257,129,152,281,653.0,80,6.96,77,402,2440,11.4,1.27216
12724,12724,Jeremy Roenick,1993-94,24.0,6,107,84,84,50,57,107,255.0,,341,179,209,388,908.0,84,7.25,87,443,2603,11.7,1.2093352
12725,12725,Jeremy Roenick,1994-95,25.0,7,107,84,84,46,61,107,281.0,,425,225,270,495,1189.0,84,6.48,76,407,2545,10.7,1.0707598
12726,12726,Jeremy Roenick,1995-96,26.0,8,34,33,33,10,24,34,93.0,,458,235,294,529,1282.0,48,5.97,37,209,1408,10.2,0.9770637
12727,12727,Jeremy Roenick,1996-97,27.0,9,67,66,66,32,35,67,171.0,,524,267,329,596,1453.0,82,6.29,74,413,2481,10.4,0.8781714
12728,12728,Jeremy Roenick,1997-98,28.0,10,69,72,72,29,40,69,228.0,,596,296,369,665,1681.0,82,5.83,55,336,2444,9.8,0.87389255
12729,12729,Jeremy Roenick,1998-99,29.0,11,56,79,79,24,32,56,182.0,,675,320,401,721,1863.0,82,5.28,57,380,2242,9.6,0.749783
12730,12730,Jeremy Roenick,1999-00,30.0,12,72,78,78,24,48,72,203.0,1573.0,753,344,449,793,2066.0,82,5.27,57,359,2285,9.4,0.8692454
12731,12731,Jeremy Roenick,2000-01,31.0,13,78,75,75,34,44,78,192.0,1564.0,828,378,493,871,2258.0,82,5.49,53,331,2294,9.8,0.88493323
12732,12732,Jeremy Roenick,2001-02,32.0,14,76,80,80,30,46,76,192.0,1680.0,908,408,539,947,2450.0,82,5.51,63,376,2272,9.9,0.8227916
12733,12733,Jeremy Roenick,2002-03,33.0,15,67,75,75,21,46,67,167.0,1367.0,983,429,585,1014,2617.0,82,5.24,53,338,2262,9.5,0.81267977
12734,12734,Jeremy Roenick,2003-04,34.0,16,59,79,79,27,32,59,197.0,1485.0,1062,456,617,1073,2814.0,82,5.31,60,363,2326,9.4,0.69759697
12735,12735,Jeremy Roenick,2004-05,35.0,17,47,62,62,19,28,47,128.0,1093.0,1124,475,645,1120,2942.0,82,5.14,57,348,2300,9.2,0.6667107
12736,12736,Jeremy Roenick,2006-07,37.0,18,22,58,58,9,13,22,111.0,1007.0,1182,484,658,1142,3053.0,82,6.05,85,480,2458,10.1,0.39962906
12737,12737,Jeremy Roenick,2007-08,38.0,19,28,70,70,11,17,28,89.0,973.0,1252,495,675,1170,3142.0,82,5.76,70,398,2426,9.7,0.36237866
12738,12738,Jeremy Roenick,2008-09,39.0,20,33,69,69,14,19,33,89.0,949.0,1321,509,694,1203,3231.0,82,5.44,62,351,2383,9.4,0.4071114
12739,12739,Jeremy Roenick,2009-10,40.0,21,13,42,42,4,9,13,50.0,489.0,1363,513,703,1216,3281.0,82,5.7,65,341,2477,9.4,0.30998492
12740,12740,Jeremy Stevenson,1996-97,22.0,2,1,3,3,0,1,1,1.0,,3,0,1,1,1.0,82,6.29,74,413,2481,10.4,0.18879038
12741,12741,Jeremy Stevenson,1997-98,23.0,3,0,5,5,0,0,0,1.0,,8,0,1,1,2.0,82,5.83,55,336,2444,9.8,0.15911222
12742,12742,Jeremy Stevenson,1998-99,24.0,4,8,45,45,3,5,8,43.0,,53,3,6,9,45.0,82,5.28,57,380,2242,9.6,0.17322773
12743,12743,Jeremy Stevenson,2000-01,26.0,5,0,3,3,0,0,0,2.0,21.0,56,3,6,9,47.0,82,5.49,53,331,2294,9.8,0.14244401
12744,12744,Jeremy Stevenson,2001-02,27.0,6,1,8,8,1,0,1,6.0,51.0,64,4,6,10,53.0,82,5.51,63,376,2272,9.9,0.14404333
12745,12745,Jeremy Stevenson,2002-03,28.0,7,0,4,4,0,0,0,0.0,24.0,68,4,6,10,53.0,82,5.24,53,338,2262,9.5,0.13970023
12746,12746,Jeremy Stevenson,2003-04,29.0,8,11,32,32,5,6,11,29.0,345.0,100,9,12,21,82.0,82,5.31,60,363,2326,9.4,0.22160423
12747,12747,Jeremy Stevenson,2004-05,30.0,9,9,56,56,5,4,9,67.0,567.0,156,14,16,30,149.0,82,5.14,57,348,2300,9.2,0.17885765
12748,12748,Jeremy Stevenson,2006-07,32.0,10,8,51,51,5,3,8,48.0,369.0,207,19,19,38,197.0,82,6.05,85,480,2458,10.1,0.1480746
12749,12749,Jeremy Welsh,2012-13,24.0,2,0,1,1,0,0,0,2.0,17.0,1,0,0,0,2.0,82,5.32,47,271,2439,8.9,0.16555953
12750,12750,Jeremy Welsh,2013-14,25.0,3,1,5,5,0,1,1,4.0,29.0,6,0,1,1,6.0,48,5.31,29,160,1399,9.1,0.19484851
12751,12751,Jeremy Welsh,2014-15,26.0,4,1,19,19,1,0,1,13.0,130.0,25,1,1,2,19.0,82,5.34,48,269,2463,8.9,0.12492746
12752,12752,Jeremy Welsh,2016-17,28.0,5,0,2,2,0,0,0,0.0,17.0,27,1,1,2,19.0,82,5.34,48,255,2438,9.0,0.12901577
12753,12753,Jeremy Williams,2006-07,23.0,2,1,1,1,1,0,1,1.0,10.0,1,1,0,1,1.0,82,6.05,85,480,2458,10.1,0.28506753
12754,12754,Jeremy Williams,2007-08,24.0,3,1,1,1,1,0,1,3.0,7.0,2,2,0,2,4.0,82,5.76,70,398,2426,9.7,0.20604634
12755,12755,Jeremy Williams,2008-09,25.0,4,2,18,18,2,0,2,16.0,132.0,20,4,0,4,20.0,82,5.44,62,351,2383,9.4,0.20217013
12756,12756,Jeremy Williams,2009-10,26.0,5,7,11,11,5,2,7,21.0,148.0,31,9,2,11,41.0,82,5.7,65,341,2477,9.4,0.26555207
12757,12757,Jeremy Williams,2011-12,28.0,6,0,1,1,0,0,0,0.0,4.0,32,9,2,11,41.0,82,5.46,52,291,2492,9.0,0.12961131
12758,12758,Jeremy Yablonski,2004-05,24.0,2,0,1,1,0,0,0,1.0,8.0,1,0,0,0,1.0,82,5.14,57,348,2300,9.2,0.25496042
12759,12759,Jergus Baca,1991-92,27.0,2,2,9,9,0,2,2,15.0,,9,0,2,2,15.0,80,6.91,71,366,2385,11.6,0.2240488
12760,12760,Jergus Baca,1992-93,28.0,3,0,1,1,0,0,0,1.0,,10,0,2,2,16.0,80,6.96,77,402,2440,11.4,0.18382719
12761,12761,Jerome Dupont,1982-83,20.0,2,4,34,34,0,4,4,22.0,,34,0,4,4,22.0,80,8.03,73,320,2489,12.9,0.24804777
12762,12762,Jerome Dupont,1983-84,21.0,3,0,1,1,0,0,0,0.0,,35,0,4,4,22.0,80,7.73,71,310,2444,12.7,0.21966588
12763,12763,Jerome Dupont,1984-85,22.0,4,4,36,36,2,2,4,28.0,,71,2,6,8,50.0,80,7.89,74,336,2448,12.9,0.1981548
12764,12764,Jerome Dupont,1985-86,23.0,5,13,55,55,3,10,13,55.0,,126,5,16,21,105.0,80,7.77,71,321,2447,12.7,0.2519315
12765,12765,Jerome Dupont,1986-87,24.0,6,15,75,75,2,13,15,69.0,,201,7,29,36,174.0,80,7.94,82,370,2484,12.8,0.2080113
12766,12766,Jerome Dupont,1987-88,25.0,7,0,13,13,0,0,0,5.0,,214,7,29,36,179.0,80,7.34,72,344,2400,12.2,0.17273602
12767,12767,Jerome Samson,2010-11,23.0,2,2,7,7,0,2,2,17.0,59.0,7,0,2,2,17.0,82,5.53,56,304,2486,9.1,0.21224108
12768,12768,Jerome Samson,2011-12,24.0,3,2,23,23,0,2,2,28.0,158.0,30,0,4,4,45.0,82,5.46,52,291,2492,9.0,0.17291251
12769,12769,Jerome Samson,2012-13,25.0,4,5,16,16,2,3,5,31.0,196.0,46,2,7,9,76.0,82,5.32,47,271,2439,8.9,0.23772398
12770,12770,Jerred Smithson,2003-04,24.0,2,2,22,22,0,2,2,9.0,194.0,22,0,2,2,9.0,82,5.31,60,363,2326,9.4,0.11776596
12771,12771,Jerred Smithson,2004-05,25.0,3,1,8,8,0,1,1,2.0,85.0,30,0,3,3,11.0,82,5.14,57,348,2300,9.2,0.17873827
12772,12772,Jerred Smithson,2006-07,27.0,4,14,66,66,5,9,14,50.0,781.0,96,5,12,17,61.0,82,6.05,85,480,2458,10.1,0.17923516
12773,12773,Jerred Smithson,2007-08,28.0,5,12,64,64,5,7,12,47.0,707.0,160,10,19,29,108.0,82,5.76,70,398,2426,9.7,0.15448007
12774,12774,Jerred Smithson,2008-09,29.0,6,16,81,81,7,9,16,61.0,979.0,241,17,28,45,169.0,82,5.44,62,351,2383,9.4,0.18988565
12775,12775,Jerred Smithson,2009-10,30.0,7,13,82,82,4,9,13,74.0,1135.0,323,21,37,58,243.0,82,5.7,65,341,2477,9.4,0.17645767
12776,12776,Jerred Smithson,2010-11,31.0,8,13,69,69,9,4,13,54.0,964.0,392,30,41,71,297.0,82,5.53,56,304,2486,9.1,0.168899
12777,12777,Jerred Smithson,2011-12,32.0,9,13,82,82,5,8,13,73.0,1218.0,474,35,49,84,370.0,82,5.46,52,291,2492,9.0,0.17256239
12778,12778,Jerred Smithson,2012-13,33.0,10,6,69,69,1,5,6,37.0,808.0,543,36,54,90,407.0,82,5.32,47,271,2439,8.9,0.1320191
12779,12779,Jerred Smithson,2013-14,34.0,11,6,45,45,3,3,6,29.0,480.0,588,39,57,96,436.0,48,5.31,29,160,1399,9.1,0.11283943
12780,12780,Jerred Smithson,2014-15,35.0,12,0,18,18,0,0,0,2.0,158.0,606,39,57,96,438.0,82,5.34,48,269,2463,8.9,0.12810636
12781,12781,Jerry D'Amigo,2014-15,23.0,2,3,22,22,1,2,3,12.0,177.0,22,1,2,3,12.0,82,5.34,48,269,2463,8.9,0.15959156
12782,12782,Jerry D'Amigo,2015-16,24.0,3,0,9,9,0,0,0,7.0,88.0,31,1,2,3,19.0,82,5.32,47,251,2453,8.9,0.15480742
12783,12783,Jesper Boqvist,2020-21,22.0,2,4,35,35,4,0,4,41.0,383.0,35,4,0,4,41.0,70,5.96,42,208,2192,9.5,0.2628736
12784,12784,Jesper Bratt,2018-19,20.0,2,35,74,74,13,22,35,100.0,1129.0,74,13,22,35,100.0,82,5.86,50,250,2620,9.2,0.5112016
12785,12785,Jesper Bratt,2019-20,21.0,3,33,51,51,8,25,33,91.0,774.0,125,21,47,68,191.0,82,5.96,47,239,2579,9.5,0.5358695
12786,12786,Jesper Bratt,2020-21,22.0,4,32,60,60,16,16,32,101.0,839.0,185,37,63,100,292.0,70,5.96,42,208,2192,9.5,0.54867613
12787,12787,Jesper Fast,2014-15,23.0,2,0,11,11,0,0,0,7.0,124.0,11,0,0,0,7.0,82,5.34,48,269,2463,8.9,0.16541308
12788,12788,Jesper Fast,2015-16,24.0,3,14,58,58,6,8,14,52.0,685.0,69,6,8,14,59.0,82,5.32,47,251,2453,8.9,0.21451396
12789,12789,Jesper Fast,2016-17,25.0,4,30,79,79,10,20,30,75.0,1180.0,148,16,28,44,134.0,82,5.34,48,255,2438,9.0,0.33953434
12790,12790,Jesper Fast,2017-18,26.0,5,21,68,68,6,15,21,56.0,938.0,216,22,43,65,190.0,82,5.45,47,245,2478,9.0,0.2854892
12791,12791,Jesper Fast,2018-19,27.0,6,33,71,71,13,20,33,80.0,1057.0,287,35,63,98,270.0,82,5.86,50,250,2620,9.2,0.39648354
12792,12792,Jesper Fast,2019-20,28.0,7,20,66,66,8,12,20,80.0,1038.0,353,43,75,118,350.0,82,5.96,47,239,2579,9.5,0.28439367
12793,12793,Jesper Fast,2020-21,29.0,8,29,69,69,12,17,29,84.0,1146.0,422,55,92,147,434.0,70,5.96,42,208,2192,9.5,0.35120207
12794,12794,Jesperi Kotkaniemi,2019-20,19.0,2,34,79,79,11,23,34,134.0,1086.0,79,11,23,34,134.0,82,5.96,47,239,2579,9.5,0.4725662
12795,12795,Jesperi Kotkaniemi,2020-21,20.0,3,8,36,36,6,2,8,55.0,468.0,115,17,25,42,189.0,70,5.96,42,208,2192,9.5,0.3490023
12796,12796,Jesse Belanger,1992-93,23.0,2,0,4,4,0,0,0,4.0,,4,0,0,0,4.0,80,6.96,77,402,2440,11.4,0.22100326
12797,12797,Jesse Belanger,1993-94,24.0,3,6,19,19,4,2,6,24.0,,23,4,2,6,28.0,84,7.25,87,443,2603,11.7,0.30284137
12798,12798,Jesse Belanger,1994-95,25.0,4,50,70,70,17,33,50,104.0,,93,21,35,56,132.0,84,6.48,76,407,2545,10.7,0.549849
12799,12799,Jesse Belanger,1995-96,26.0,5,29,47,47,15,14,29,89.0,,140,36,49,85,221.0,48,5.97,37,209,1408,10.2,0.5211448
12800,12800,Jesse Belanger,1996-97,27.0,6,41,72,72,20,21,41,151.0,,212,56,70,126,372.0,82,6.29,74,413,2481,10.4,0.484979
12801,12801,Jesse Belanger,1997-98,28.0,7,0,6,6,0,0,0,8.0,,218,56,70,126,380.0,82,5.83,55,336,2444,9.8,0.33790416
12802,12802,Jesse Belanger,2000-01,31.0,8,9,16,16,3,6,9,21.0,171.0,234,59,76,135,401.0,82,5.49,53,331,2294,9.8,0.28680742
12803,12803,Jesse Belanger,2001-02,32.0,9,0,12,12,0,0,0,7.0,70.0,246,59,76,135,408.0,82,5.51,63,376,2272,9.9,0.23004666
12804,12804,Jesse Blacker,2015-16,24.0,2,0,1,1,0,0,0,0.0,6.0,1,0,0,0,0.0,82,5.32,47,251,2453,8.9,0.1370357
12805,12805,Jesse Boulerice,2002-03,24.0,2,0,3,3,0,0,0,1.0,13.0,3,0,0,0,1.0,82,5.24,53,338,2262,9.5,0.15924224
12806,12806,Jesse Boulerice,2003-04,25.0,3,3,48,48,2,1,3,12.0,187.0,51,2,1,3,13.0,82,5.31,60,363,2326,9.4,0.1128833
12807,12807,Jesse Boulerice,2004-05,26.0,4,7,76,76,6,1,7,46.0,497.0,127,8,2,10,59.0,82,5.14,57,348,2300,9.2,0.15716678
12808,12808,Jesse Boulerice,2006-07,28.0,5,0,38,38,0,0,0,5.0,97.0,165,8,2,10,64.0,82,6.05,85,480,2458,10.1,0.066559404
12809,12809,Jesse Boulerice,2008-09,30.0,6,0,5,5,0,0,0,1.0,19.0,170,8,2,10,65.0,82,5.44,62,351,2383,9.4,0.109479696
12810,12810,Jesse Boulerice,2009-10,31.0,7,0,2,2,0,0,0,0.0,7.0,172,8,2,10,65.0,82,5.7,65,341,2477,9.4,0.11517763
12811,12811,Jesse Fibiger,2003-04,25.0,2,0,16,16,0,0,0,2.0,97.0,16,0,0,0,2.0,82,5.31,60,363,2326,9.4,0.14846021
12812,12812,Jesse Joensuu,2009-10,22.0,2,3,7,7,1,2,3,9.0,85.0,7,1,2,3,9.0,82,5.7,65,341,2477,9.4,0.24976602
12813,12813,Jesse Joensuu,2010-11,23.0,3,1,11,11,1,0,1,13.0,123.0,18,2,2,4,22.0,82,5.53,56,304,2486,9.1,0.22413945
12814,12814,Jesse Joensuu,2011-12,24.0,4,9,42,42,6,3,9,41.0,486.0,60,8,5,13,63.0,82,5.46,52,291,2492,9.0,0.20755237
12815,12815,Jesse Joensuu,2013-14,26.0,5,2,7,7,0,2,2,15.0,71.0,67,8,7,15,78.0,48,5.31,29,160,1399,9.1,0.221661
12816,12816,Jesse Joensuu,2014-15,27.0,6,5,42,42,3,2,5,41.0,392.0,109,11,9,20,119.0,82,5.34,48,269,2463,8.9,0.16073245
12817,12817,Jesse Joensuu,2015-16,28.0,7,4,20,20,2,2,4,18.0,213.0,129,13,11,24,137.0,82,5.32,47,251,2453,8.9,0.14505959
12818,12818,Jesse Puljujarvi,2017-18,19.0,2,8,28,28,1,7,8,41.0,315.0,28,1,7,8,41.0,82,5.45,47,245,2478,9.0,0.31515688
12819,12819,Jesse Puljujarvi,2018-19,20.0,3,20,65,65,12,8,20,136.0,869.0,93,13,15,28,177.0,82,5.86,50,250,2620,9.2,0.3732224
12820,12820,Jesse Puljujarvi,2019-20,21.0,4,9,46,46,4,5,9,53.0,550.0,139,17,20,37,230.0,82,5.96,47,239,2579,9.5,0.2922347
12821,12821,Jesse Schultz,2007-08,25.0,2,0,2,2,0,0,0,6.0,20.0,2,0,0,0,6.0,82,5.76,70,398,2426,9.7,0.1686536
12822,12822,Jesse Wallin,2000-01,22.0,2,0,1,1,0,0,0,0.0,19.0,1,0,0,0,0.0,82,5.49,53,331,2294,9.8,0.157395
12823,12823,Jesse Wallin,2001-02,23.0,3,0,1,1,0,0,0,1.0,4.0,2,0,0,0,1.0,82,5.51,63,376,2272,9.9,0.16867617
12824,12824,Jesse Wallin,2002-03,24.0,4,1,15,15,0,1,1,8.0,160.0,17,0,1,1,9.0,82,5.24,53,338,2262,9.5,0.15391833
12825,12825,Jesse Wallin,2003-04,25.0,5,1,32,32,0,1,1,23.0,425.0,49,0,2,2,32.0,82,5.31,60,363,2326,9.4,0.1455856
12826,12826,Jesse Winchester,2008-09,25.0,2,0,1,1,0,0,0,1.0,14.0,1,0,0,0,1.0,82,5.44,62,351,2383,9.4,0.17475912
12827,12827,Jesse Winchester,2009-10,26.0,3,18,76,76,3,15,18,115.0,805.0,77,3,15,18,116.0,82,5.7,65,341,2477,9.4,0.26135415
12828,12828,Jesse Winchester,2010-11,27.0,4,13,52,52,2,11,13,77.0,521.0,129,5,26,31,193.0,82,5.53,56,304,2486,9.1,0.22201443
12829,12829,Jesse Winchester,2011-12,28.0,5,13,72,72,4,9,13,118.0,780.0,201,9,35,44,311.0,82,5.46,52,291,2492,9.0,0.20450163
12830,12830,Jesse Winchester,2012-13,29.0,6,8,32,32,2,6,8,52.0,340.0,233,11,41,52,363.0,82,5.32,47,271,2439,8.9,0.2192713
12831,12831,Jesse Winchester,2014-15,31.0,7,18,52,52,9,9,18,100.0,662.0,285,20,50,70,463.0,82,5.34,48,269,2463,8.9,0.32177776
12832,12832,Jim Agnew,1987-88,21.0,2,0,4,4,0,0,0,1.0,,4,0,0,0,1.0,80,7.34,72,344,2400,12.2,0.2345947
12833,12833,Jim Agnew,1988-89,22.0,3,1,10,10,0,1,1,4.0,,14,0,1,1,5.0,80,7.43,89,437,2435,12.2,0.2136178
12834,12834,Jim Agnew,1990-91,24.0,4,0,7,7,0,0,0,3.0,,21,0,1,1,8.0,80,7.37,76,367,2421,12.2,0.18793356
12835,12835,Jim Agnew,1991-92,25.0,5,0,20,20,0,0,0,12.0,,41,0,1,1,20.0,80,6.91,71,366,2385,11.6,0.11856246
12836,12836,Jim Agnew,1992-93,26.0,6,0,24,24,0,0,0,9.0,,65,0,1,1,29.0,80,6.96,77,402,2440,11.4,0.116058916
12837,12837,Jim Agnew,1993-94,27.0,7,0,16,16,0,0,0,3.0,,81,0,1,1,32.0,84,7.25,87,443,2603,11.7,0.12595218
12838,12838,Jim Archibald,1985-86,24.0,2,3,4,4,1,2,3,12.0,,4,1,2,3,12.0,80,7.77,71,321,2447,12.7,0.292432
12839,12839,Jim Archibald,1986-87,25.0,3,0,11,11,0,0,0,7.0,,15,1,2,3,19.0,80,7.94,82,370,2484,12.8,0.17799789
12840,12840,Jim Archibald,1987-88,26.0,4,0,1,1,0,0,0,1.0,,16,1,2,3,20.0,80,7.34,72,344,2400,12.2,0.19329947
12841,12841,Jim Benning,1982-83,19.0,2,31,74,74,7,24,31,90.0,,74,7,24,31,90.0,80,8.03,73,320,2489,12.9,0.48445445
12842,12842,Jim Benning,1983-84,20.0,3,22,74,74,5,17,22,68.0,,148,12,41,53,158.0,80,7.73,71,310,2444,12.7,0.37178135
12843,12843,Jim Benning,1984-85,21.0,4,51,79,79,12,39,51,136.0,,227,24,80,104,294.0,80,7.89,74,336,2448,12.9,0.6370872
12844,12844,Jim Benning,1985-86,22.0,5,44,80,80,9,35,44,161.0,,307,33,115,148,455.0,80,7.77,71,321,2447,12.7,0.6312551
12845,12845,Jim Benning,1986-87,23.0,6,25,52,52,4,21,25,76.0,,359,37,136,173,531.0,80,7.94,82,370,2484,12.8,0.45131168
12846,12846,Jim Benning,1987-88,24.0,7,13,59,59,2,11,13,62.0,,418,39,147,186,593.0,80,7.34,72,344,2400,12.2,0.30595958
12847,12847,Jim Benning,1988-89,25.0,8,33,77,77,7,26,33,102.0,,495,46,173,219,695.0,80,7.43,89,437,2435,12.2,0.4470933
12848,12848,Jim Benning,1989-90,26.0,9,12,65,65,3,9,12,55.0,,560,49,182,231,750.0,80,7.48,85,403,2430,12.3,0.24227524
12849,12849,Jim Benning,1990-91,27.0,10,12,45,45,3,9,12,49.0,,605,52,191,243,799.0,80,7.37,76,367,2421,12.2,0.25270802
12850,12850,Jim Brown,1983-84,23.0,2,1,3,3,0,1,1,0.0,,3,0,1,1,0.0,80,7.73,71,310,2444,12.7,0.23781902
12851,12851,Jim Campbell,1996-97,23.0,2,5,16,16,2,3,5,25.0,,16,2,3,5,25.0,82,6.29,74,413,2481,10.4,0.29146567
12852,12852,Jim Campbell,1997-98,24.0,3,43,68,68,23,20,43,169.0,,84,25,23,48,194.0,82,5.83,55,336,2444,9.8,0.58607435
12853,12853,Jim Campbell,1998-99,25.0,4,41,76,76,22,19,41,147.0,,160,47,42,89,341.0,82,5.28,57,380,2242,9.6,0.5179135
12854,12854,Jim Campbell,1999-00,26.0,5,25,55,55,4,21,25,99.0,746.0,215,51,63,114,440.0,82,5.27,57,359,2285,9.4,0.42978325
12855,12855,Jim Campbell,2000-01,27.0,6,0,2,2,0,0,0,6.0,31.0,217,51,63,114,446.0,82,5.49,53,331,2294,9.8,0.33921814
12856,12856,Jim Campbell,2001-02,28.0,7,20,57,57,9,11,20,81.0,588.0,274,60,74,134,527.0,82,5.51,63,376,2272,9.9,0.31791848
12857,12857,Jim Campbell,2002-03,29.0,8,2,9,9,1,1,2,12.0,120.0,283,61,75,136,539.0,82,5.24,53,338,2262,9.5,0.274012
12858,12858,Jim Campbell,2003-04,30.0,9,0,1,1,0,0,0,3.0,9.0,284,61,75,136,542.0,82,5.31,60,363,2326,9.4,0.24336126
12859,12859,Jim Campbell,2006-07,33.0,10,0,1,1,0,0,0,0.0,9.0,285,61,75,136,542.0,82,6.05,85,480,2458,10.1,0.24640054
12860,12860,Jim Culhane,1990-91,25.0,2,1,6,6,0,1,1,6.0,,6,0,1,1,6.0,80,7.37,76,367,2421,12.2,0.22506642
12861,12861,Jim Cummins,1992-93,22.0,2,0,1,1,0,0,0,0.0,,1,0,0,0,0.0,80,6.96,77,402,2440,11.4,0.1837619
12862,12862,Jim Cummins,1993-94,23.0,3,2,7,7,1,1,2,5.0,,8,1,1,2,5.0,84,7.25,87,443,2603,11.7,0.24669042
12863,12863,Jim Cummins,1994-95,24.0,4,3,26,26,1,2,3,20.0,,34,2,3,5,25.0,84,6.48,76,407,2545,10.7,0.18883324
12864,12864,Jim Cummins,1995-96,25.0,5,5,37,37,4,1,5,23.0,,71,6,4,10,48.0,48,5.97,37,209,1408,10.2,0.1861226
12865,12865,Jim Cummins,1996-97,26.0,6,6,52,52,2,4,6,34.0,,123,8,8,16,82.0,82,6.29,74,413,2481,10.4,0.14385599
12866,12866,Jim Cummins,1997-98,27.0,7,12,65,65,6,6,12,61.0,,188,14,14,28,143.0,82,5.83,55,336,2444,9.8,0.15465766
12867,12867,Jim Cummins,1998-99,28.0,8,2,75,75,0,2,2,43.0,,263,14,16,30,186.0,82,5.28,57,380,2242,9.6,0.12077737
12868,12868,Jim Cummins,1999-00,29.0,9,8,55,55,1,7,8,26.0,391.0,318,15,23,38,212.0,82,5.27,57,359,2285,9.4,0.103826046
12869,12869,Jim Cummins,2000-01,30.0,10,8,47,47,3,5,8,33.0,422.0,365,18,28,46,245.0,82,5.49,53,331,2294,9.8,0.12864819
12870,12870,Jim Cummins,2001-02,31.0,11,11,79,79,5,6,11,45.0,572.0,444,23,34,57,290.0,82,5.51,63,376,2272,9.9,0.1287457
12871,12871,Jim Cummins,2002-03,32.0,12,0,12,12,0,0,0,3.0,59.0,456,23,34,57,293.0,82,5.24,53,338,2262,9.5,0.11335972
12872,12872,Jim Cummins,2004-05,34.0,13,3,55,55,1,2,3,25.0,321.0,511,24,36,60,318.0,82,5.14,57,348,2300,9.2,0.11969927
12873,12873,Jim Dobson,1980-81,20.0,2,0,1,1,0,0,0,0.0,,1,0,0,0,0.0,80,7.03,61,280,2352,12.0,0.2607314
12874,12874,Jim Dobson,1981-82,21.0,3,0,1,1,0,0,0,0.0,,2,0,0,0,0.0,80,7.69,77,340,2441,12.6,0.21042055
12875,12875,Jim Dobson,1982-83,22.0,4,0,9,9,0,0,0,10.0,,11,0,0,0,10.0,80,8.03,73,320,2489,12.9,0.21323767
12876,12876,Jim Dobson,1984-85,24.0,5,0,1,1,0,0,0,1.0,,12,0,0,0,11.0,80,7.89,74,336,2448,12.9,0.1892631
12877,12877,Jim Dowd,1992-93,24.0,2,0,1,1,0,0,0,0.0,,1,0,0,0,0.0,80,6.96,77,402,2440,11.4,0.17426091
12878,12878,Jim Dowd,1993-94,25.0,3,0,1,1,0,0,0,1.0,,2,0,0,0,1.0,84,7.25,87,443,2603,11.7,0.18108302
12879,12879,Jim Dowd,1994-95,26.0,4,15,15,15,5,10,15,26.0,,17,5,10,15,27.0,84,6.48,76,407,2545,10.7,0.41659176
12880,12880,Jim Dowd,1995-96,27.0,5,5,10,10,1,4,5,14.0,,27,6,14,20,41.0,48,5.97,37,209,1408,10.2,0.2573474
12881,12881,Jim Dowd,1996-97,28.0,6,20,66,66,5,15,20,76.0,,93,11,29,40,117.0,82,6.29,74,413,2481,10.4,0.24741659
12882,12882,Jim Dowd,1997-98,29.0,7,0,3,3,0,0,0,0.0,,96,11,29,40,117.0,82,5.83,55,336,2444,9.8,0.16873592
12883,12883,Jim Dowd,1998-99,30.0,8,14,48,48,6,8,14,58.0,,144,17,37,54,175.0,82,5.28,57,380,2242,9.6,0.23507726
12884,12884,Jim Dowd,1999-00,31.0,9,0,1,1,0,0,0,1.0,10.0,145,17,37,54,176.0,82,5.27,57,359,2285,9.4,0.20123532
12885,12885,Jim Dowd,2000-01,32.0,10,23,69,69,5,18,23,103.0,906.0,214,22,55,77,279.0,82,5.49,53,331,2294,9.8,0.28988945
12886,12886,Jim Dowd,2001-02,33.0,11,29,68,68,7,22,29,92.0,1213.0,282,29,77,106,371.0,82,5.51,63,376,2272,9.9,0.32792443
12887,12887,Jim Dowd,2002-03,34.0,12,43,82,82,13,30,43,111.0,1276.0,364,42,107,149,482.0,82,5.24,53,338,2262,9.5,0.42949358
12888,12888,Jim Dowd,2003-04,35.0,13,25,78,78,8,17,25,78.0,1018.0,442,50,124,174,560.0,82,5.31,60,363,2326,9.4,0.26557067
12889,12889,Jim Dowd,2004-05,36.0,14,29,69,69,7,22,29,54.0,965.0,511,57,146,203,614.0,82,5.14,57,348,2300,9.2,0.3708824
12890,12890,Jim Dowd,2006-07,38.0,15,18,78,78,5,13,18,67.0,980.0,589,62,159,221,681.0,82,6.05,85,480,2458,10.1,0.18776771
12891,12891,Jim Dowd,2007-08,39.0,16,8,66,66,4,4,8,44.0,547.0,655,66,163,229,725.0,82,5.76,70,398,2426,9.7,0.13355121
12892,12892,Jim Dowd,2008-09,40.0,17,10,73,73,5,5,10,41.0,616.0,728,71,168,239,766.0,82,5.44,62,351,2383,9.4,0.13740644
12893,12893,Jim Ennis,1988-89,21.0,2,1,5,5,1,0,1,9.0,,5,1,0,1,9.0,80,7.43,89,437,2435,12.2,0.28184772
12894,12894,Jim Fahey,2003-04,24.0,2,20,43,43,1,19,20,66.0,788.0,43,1,19,20,66.0,82,5.31,60,363,2326,9.4,0.33741266
12895,12895,Jim Fahey,2004-05,25.0,3,2,15,15,0,2,2,19.0,254.0,58,1,21,22,85.0,82,5.14,57,348,2300,9.2,0.22957137
12896,12896,Jim Fahey,2006-07,27.0,4,2,21,21,0,2,2,22.0,266.0,79,1,23,24,107.0,82,6.05,85,480,2458,10.1,0.16423059
12897,12897,Jim Fahey,2007-08,28.0,5,1,13,13,0,1,1,7.0,140.0,92,1,24,25,114.0,82,5.76,70,398,2426,9.7,0.15954152
12898,12898,Jim Fox,1981-82,21.0,2,43,71,71,18,25,43,92.0,,71,18,25,43,92.0,80,7.69,77,340,2441,12.6,0.6462549
12899,12899,Jim Fox,1982-83,22.0,3,68,77,77,30,38,68,157.0,,148,48,63,111,249.0,80,8.03,73,320,2489,12.9,0.81746805
12900,12900,Jim Fox,1983-84,23.0,4,68,77,77,28,40,68,137.0,,225,76,103,179,386.0,80,7.73,71,310,2444,12.7,0.87767476
12901,12901,Jim Fox,1984-85,24.0,5,72,80,80,30,42,72,153.0,,305,106,145,251,539.0,80,7.89,74,336,2448,12.9,0.88437283
12902,12902,Jim Fox,1985-86,25.0,6,83,79,79,30,53,83,173.0,,384,136,198,334,712.0,80,7.77,71,321,2447,12.7,0.95709777
12903,12903,Jim Fox,1986-87,26.0,7,31,39,39,14,17,31,81.0,,423,150,215,365,793.0,80,7.94,82,370,2484,12.8,0.72655314
12904,12904,Jim Fox,1987-88,27.0,8,61,76,76,19,42,61,162.0,,499,169,257,426,955.0,80,7.34,72,344,2400,12.2,0.7927408
12905,12905,Jim Fox,1988-89,28.0,9,51,68,68,16,35,51,120.0,,567,185,292,477,1075.0,80,7.43,89,437,2435,12.2,0.6173644
12906,12906,Jim Fox,1990-91,30.0,10,2,11,11,1,1,2,7.0,,578,186,293,479,1082.0,80,7.37,76,367,2421,12.2,0.4497432
12907,12907,Jim Hiller,1993-94,24.0,2,20,61,61,8,12,20,83.0,,61,8,12,20,83.0,84,7.25,87,443,2603,11.7,0.32586175
12908,12908,Jim Hiller,1994-95,25.0,3,0,2,2,0,0,0,0.0,,63,8,12,20,83.0,84,6.48,76,407,2545,10.7,0.18635714
12909,12909,Jim Hofford,1986-87,22.0,2,0,5,5,0,0,0,3.0,,5,0,0,0,3.0,80,7.94,82,370,2484,12.8,0.22778124
12910,12910,Jim Hofford,1987-88,23.0,3,0,12,12,0,0,0,8.0,,17,0,0,0,11.0,80,7.34,72,344,2400,12.2,0.19252583
12911,12911,Jim Hofford,1989-90,25.0,4,0,1,1,0,0,0,0.0,,18,0,0,0,11.0,80,7.48,85,403,2430,12.3,0.17888802
12912,12912,Jim Jackson,1983-84,23.0,2,20,48,48,8,12,20,85.0,,48,8,12,20,85.0,80,7.73,71,310,2444,12.7,0.4506674
12913,12913,Jim Jackson,1984-85,24.0,3,20,49,49,6,14,20,66.0,,97,14,26,40,151.0,80,7.89,74,336,2448,12.9,0.43122897
12914,12914,Jim Jackson,1985-86,25.0,4,5,10,10,1,4,5,10.0,,107,15,30,45,161.0,80,7.77,71,321,2447,12.7,0.3282535
12915,12915,Jim Jackson,1988-89,28.0,5,2,5,5,2,0,2,11.0,,112,17,30,47,172.0,80,7.43,89,437,2435,12.2,0.2934333
12916,12916,Jim Johnson,1986-87,24.0,2,29,80,80,3,26,29,118.0,,80,3,26,29,118.0,80,7.94,82,370,2484,12.8,0.35913047
12917,12917,Jim Johnson,1987-88,25.0,3,30,80,80,5,25,30,88.0,,160,8,51,59,206.0,80,7.34,72,344,2400,12.2,0.39068365
12918,12918,Jim Johnson,1988-89,26.0,4,13,55,55,1,12,13,44.0,,215,9,63,72,250.0,80,7.43,89,437,2435,12.2,0.2608159
12919,12919,Jim Johnson,1989-90,27.0,5,16,76,76,2,14,16,70.0,,291,11,77,88,320.0,80,7.48,85,403,2430,12.3,0.2205936
12920,12920,Jim Johnson,1990-91,28.0,6,16,75,75,3,13,16,72.0,,366,14,90,104,392.0,80,7.37,76,367,2421,12.2,0.24921638
12921,12921,Jim Johnson,1991-92,29.0,7,15,68,68,1,14,15,83.0,,434,15,104,119,475.0,80,6.91,71,366,2385,11.6,0.24415383
12922,12922,Jim Johnson,1992-93,30.0,8,14,71,71,4,10,14,86.0,,505,19,114,133,561.0,80,6.96,77,402,2440,11.4,0.24064589
12923,12923,Jim Johnson,1993-94,31.0,9,23,79,79,3,20,23,67.0,,584,22,134,156,628.0,84,7.25,87,443,2603,11.7,0.21193433
12924,12924,Jim Johnson,1994-95,32.0,10,7,61,61,0,7,7,49.0,,645,22,141,163,677.0,84,6.48,76,407,2545,10.7,0.1585728
12925,12925,Jim Johnson,1995-96,33.0,11,13,47,47,0,13,13,46.0,,692,22,154,176,723.0,48,5.97,37,209,1408,10.2,0.18331143
12926,12926,Jim Johnson,1996-97,34.0,12,6,66,66,2,4,6,49.0,,758,24,158,182,772.0,82,6.29,74,413,2481,10.4,0.12937558
12927,12927,Jim Johnson,1997-98,35.0,13,10,55,55,3,7,10,51.0,,813,27,165,192,823.0,82,5.83,55,336,2444,9.8,0.14894387
12928,12928,Jim Johnson,1998-99,36.0,14,3,16,16,2,1,3,17.0,,829,29,166,195,840.0,82,5.28,57,380,2242,9.6,0.1531184
12929,12929,Jim Korn,1980-81,23.0,2,18,63,63,5,13,18,58.0,,63,5,13,18,58.0,80,7.03,61,280,2352,12.0,0.30503038
12930,12930,Jim Korn,1981-82,24.0,3,20,63,63,5,15,20,82.0,,126,10,28,38,140.0,80,7.69,77,340,2441,12.6,0.30283082
12931,12931,Jim Korn,1982-83,25.0,4,12,70,70,2,10,12,51.0,,196,12,38,50,191.0,80,8.03,73,320,2489,12.9,0.2418297
12932,12932,Jim Korn,1983-84,26.0,5,29,80,80,8,21,29,103.0,,276,20,59,79,294.0,80,7.73,71,310,2444,12.7,0.3778063
12933,12933,Jim Korn,1984-85,27.0,6,26,65,65,12,14,26,92.0,,341,32,73,105,386.0,80,7.89,74,336,2448,12.9,0.31370002
12934,12934,Jim Korn,1985-86,28.0,7,10,41,41,5,5,10,48.0,,382,37,78,115,434.0,80,7.77,71,321,2447,12.7,0.29146641
12935,12935,Jim Korn,1987-88,30.0,8,14,52,52,4,10,14,35.0,,434,41,88,129,469.0,80,7.34,72,344,2400,12.2,0.2698441
12936,12936,Jim Korn,1988-89,31.0,9,21,52,52,8,13,21,49.0,,486,49,101,150,518.0,80,7.43,89,437,2435,12.2,0.36697182
12937,12937,Jim Korn,1989-90,32.0,10,31,65,65,15,16,31,65.0,,551,64,117,181,583.0,80,7.48,85,403,2430,12.3,0.32448906
12938,12938,Jim Korn,1990-91,33.0,11,7,46,46,2,5,7,21.0,,597,66,122,188,604.0,80,7.37,76,367,2421,12.2,0.14910257
12939,12939,Jim Kyte,1983-84,19.0,2,0,2,2,0,0,0,0.0,,2,0,0,0,0.0,80,7.73,71,310,2444,12.7,0.24393094
12940,12940,Jim Kyte,1984-85,20.0,3,3,58,58,1,2,3,7.0,,60,1,2,3,7.0,80,7.89,74,336,2448,12.9,0.2008209
12941,12941,Jim Kyte,1985-86,21.0,4,3,71,71,0,3,3,32.0,,131,1,5,6,39.0,80,7.77,71,321,2447,12.7,0.19245467
12942,12942,Jim Kyte,1986-87,22.0,5,4,71,71,1,3,4,28.0,,202,2,8,10,67.0,80,7.94,82,370,2484,12.8,0.12624156
12943,12943,Jim Kyte,1987-88,23.0,6,10,72,72,5,5,10,62.0,,274,7,13,20,129.0,80,7.34,72,344,2400,12.2,0.21684322
12944,12944,Jim Kyte,1988-89,24.0,7,4,51,51,1,3,4,59.0,,325,8,16,24,188.0,80,7.43,89,437,2435,12.2,0.1771878
12945,12945,Jim Kyte,1989-90,25.0,8,12,74,74,3,9,12,56.0,,399,11,25,36,244.0,80,7.48,85,403,2430,12.3,0.17399275
12946,12946,Jim Kyte,1990-91,26.0,9,4,56,56,3,1,4,23.0,,455,14,26,40,267.0,80,7.37,76,367,2421,12.2,0.118652225
12947,12947,Jim Kyte,1991-92,27.0,10,9,43,43,0,9,9,29.0,,498,14,35,49,296.0,80,6.91,71,366,2385,11.6,0.13410568
12948,12948,Jim Kyte,1992-93,28.0,11,1,21,21,0,1,1,13.0,,519,14,36,50,309.0,80,6.96,77,402,2440,11.4,0.13623935
12949,12949,Jim Kyte,1993-94,29.0,12,1,4,4,0,1,1,1.0,,523,14,37,51,310.0,84,7.25,87,443,2603,11.7,0.16269454
12950,12950,Jim Kyte,1995-96,31.0,13,7,18,18,2,5,7,14.0,,541,16,42,58,324.0,48,5.97,37,209,1408,10.2,0.23155487
12951,12951,Jim Kyte,1996-97,32.0,14,8,57,57,1,7,8,32.0,,598,17,49,66,356.0,82,6.29,74,413,2481,10.4,0.10150048
12952,12952,Jim Leavins,1986-87,26.0,2,13,37,37,2,11,13,63.0,,37,2,11,13,63.0,80,7.94,82,370,2484,12.8,0.27435538
12953,12953,Jim Leavins,1987-88,27.0,3,1,4,4,0,1,1,4.0,,41,2,12,14,67.0,80,7.34,72,344,2400,12.2,0.19123426
12954,12954,Jim Mathieson,1990-91,21.0,2,0,2,2,0,0,0,0.0,,2,0,0,0,0.0,80,7.37,76,367,2421,12.2,0.21253276
12955,12955,Jim Mayer,1980-81,26.0,2,0,4,4,0,0,0,2.0,,4,0,0,0,2.0,80,7.03,61,280,2352,12.0,0.22364223
12956,12956,Jim McGeough,1982-83,19.0,2,0,4,4,0,0,0,7.0,,4,0,0,0,7.0,80,8.03,73,320,2489,12.9,0.27901208
12957,12957,Jim McGeough,1985-86,22.0,3,7,25,25,3,4,7,56.0,,29,3,4,7,63.0,80,7.77,71,321,2447,12.7,0.34936628
12958,12958,Jim McGeough,1986-87,23.0,4,5,17,17,3,2,5,29.0,,46,6,6,12,92.0,80,7.94,82,370,2484,12.8,0.36227462
12959,12959,Jim McGeough,1987-88,24.0,5,5,11,11,1,4,5,24.0,,57,7,10,17,116.0,80,7.34,72,344,2400,12.2,0.33392125
12960,12960,Jim McKenzie,1990-91,21.0,2,0,5,5,0,0,0,0.0,,5,0,0,0,0.0,80,7.37,76,367,2421,12.2,0.20794284
12961,12961,Jim McKenzie,1991-92,22.0,3,7,41,41,4,3,7,16.0,,46,4,3,7,16.0,80,6.91,71,366,2385,11.6,0.2106266
12962,12962,Jim McKenzie,1992-93,23.0,4,6,67,67,5,1,6,34.0,,113,9,4,13,50.0,80,6.96,77,402,2440,11.4,0.18671069
12963,12963,Jim McKenzie,1993-94,24.0,5,9,64,64,3,6,9,36.0,,177,12,10,22,86.0,84,7.25,87,443,2603,11.7,0.1583116
12964,12964,Jim McKenzie,1994-95,25.0,6,8,71,71,3,5,8,33.0,,248,15,15,30,119.0,84,6.48,76,407,2545,10.7,0.14402026
12965,12965,Jim McKenzie,1995-96,26.0,7,3,39,39,2,1,3,16.0,,287,17,16,33,135.0,48,5.97,37,209,1408,10.2,0.13031259
12966,12966,Jim McKenzie,1996-97,27.0,8,6,73,73,4,2,6,28.0,,360,21,18,39,163.0,82,6.29,74,413,2481,10.4,0.10719749
12967,12967,Jim McKenzie,1997-98,28.0,9,8,65,65,5,3,8,38.0,,425,26,21,47,201.0,82,5.83,55,336,2444,9.8,0.13792711
12968,12968,Jim McKenzie,1998-99,29.0,10,7,64,64,3,4,7,35.0,,489,29,25,54,236.0,82,5.28,57,380,2242,9.6,0.13619691
12969,12969,Jim McKenzie,1999-00,30.0,11,9,73,73,5,4,9,59.0,757.0,562,34,29,63,295.0,82,5.27,57,359,2285,9.4,0.14148605
12970,12970,Jim McKenzie,2000-01,31.0,12,9,61,61,4,5,9,32.0,514.0,623,38,34,72,327.0,82,5.49,53,331,2294,9.8,0.09886223
12971,12971,Jim McKenzie,2001-02,32.0,13,4,53,53,2,2,4,32.0,420.0,676,40,36,76,359.0,82,5.51,63,376,2272,9.9,0.10189855
12972,12972,Jim McKenzie,2002-03,33.0,14,8,67,67,3,5,8,33.0,490.0,743,43,41,84,392.0,82,5.24,53,338,2262,9.5,0.120924175
12973,12973,Jim McKenzie,2003-04,34.0,15,12,76,76,4,8,12,42.0,585.0,819,47,49,96,434.0,82,5.31,60,363,2326,9.4,0.1188373
12974,12974,Jim McKenzie,2004-05,35.0,16,4,61,61,1,3,4,10.0,381.0,880,48,52,100,444.0,82,5.14,57,348,2300,9.2,0.08813357
12975,12975,Jim McTaggart,1981-82,21.0,2,7,52,52,1,6,7,40.0,,52,1,6,7,40.0,80,7.69,77,340,2441,12.6,0.26078236
12976,12976,Jim McTaggart,1982-83,22.0,3,6,19,19,2,4,6,24.0,,71,3,10,13,64.0,80,8.03,73,320,2489,12.9,0.30743694
12977,12977,Jim Montgomery,1994-95,25.0,2,20,67,67,6,14,20,67.0,,67,6,14,20,67.0,84,6.48,76,407,2545,10.7,0.26480395
12978,12978,Jim Montgomery,1995-96,26.0,3,2,13,13,1,1,2,13.0,,80,7,15,22,80.0,48,5.97,37,209,1408,10.2,0.2570638
12979,12979,Jim Montgomery,1996-97,27.0,4,3,5,5,1,2,3,4.0,,85,8,17,25,84.0,82,6.29,74,413,2481,10.4,0.19911402
12980,12980,Jim Montgomery,2001-02,32.0,5,7,28,28,1,6,7,17.0,255.0,113,9,23,32,101.0,82,5.51,63,376,2272,9.9,0.18807614
12981,12981,Jim Montgomery,2002-03,33.0,6,2,8,8,0,2,2,8.0,69.0,121,9,25,34,109.0,82,5.24,53,338,2262,9.5,0.15979648
12982,12982,Jim Montgomery,2003-04,34.0,7,0,1,1,0,0,0,0.0,7.0,122,9,25,34,109.0,82,5.31,60,363,2326,9.4,0.14055917
12983,12983,Jim Nill,1982-83,24.0,2,24,69,69,10,14,24,71.0,,69,10,14,24,71.0,80,8.03,73,320,2489,12.9,0.34468466
12984,12984,Jim Nill,1983-84,25.0,3,22,65,65,7,15,22,53.0,,134,17,29,46,124.0,80,7.73,71,310,2444,12.7,0.29078496
12985,12985,Jim Nill,1984-85,26.0,4,20,78,78,12,8,20,73.0,,212,29,37,66,197.0,80,7.89,74,336,2448,12.9,0.3085689
12986,12986,Jim Nill,1985-86,27.0,5,26,69,69,9,17,26,45.0,,281,38,54,92,242.0,80,7.77,71,321,2447,12.7,0.33945322
12987,12987,Jim Nill,1986-87,28.0,6,14,61,61,6,8,14,35.0,,342,44,62,106,277.0,80,7.94,82,370,2484,12.8,0.25893745
12988,12988,Jim Nill,1987-88,29.0,7,7,36,36,3,4,7,12.0,,378,47,66,113,289.0,80,7.34,72,344,2400,12.2,0.21560031
12989,12989,Jim Nill,1988-89,30.0,8,15,60,60,3,12,15,38.0,,438,50,78,128,327.0,80,7.43,89,437,2435,12.2,0.24346307
12990,12990,Jim Nill,1989-90,31.0,9,15,71,71,8,7,15,39.0,,509,58,85,143,366.0,80,7.48,85,403,2430,12.3,0.2076047
12991,12991,Jim Nill,1990-91,32.0,10,2,15,15,0,2,2,10.0,,524,58,87,145,376.0,80,7.37,76,367,2421,12.2,0.15436837
12992,12992,Jim O'Brien,2011-12,23.0,2,0,6,6,0,0,0,11.0,58.0,6,0,0,0,11.0,82,5.46,52,291,2492,9.0,0.18487921
12993,12993,Jim O'Brien,2012-13,24.0,3,6,28,28,3,3,6,37.0,329.0,34,3,3,6,48.0,82,5.32,47,271,2439,8.9,0.22276807
12994,12994,Jim O'Brien,2013-14,25.0,4,6,29,29,5,1,6,38.0,331.0,63,8,4,12,86.0,48,5.31,29,160,1399,9.1,0.27116066
12995,12995,Jim O'Brien,2016-17,28.0,5,0,4,4,0,0,0,3.0,54.0,67,8,4,12,89.0,82,5.34,48,255,2438,9.0,0.13737473
12996,12996,Jim O'Brien,2018-19,30.0,6,1,10,10,0,1,1,11.0,88.0,77,8,5,13,100.0,82,5.86,50,250,2620,9.2,0.15710554
12997,12997,Jim Paek,1991-92,24.0,2,0,3,3,0,0,0,0.0,,3,0,0,0,0.0,80,6.91,71,366,2385,11.6,0.18373993
12998,12998,Jim Paek,1992-93,25.0,3,8,49,49,1,7,8,33.0,,52,1,7,8,33.0,80,6.96,77,402,2440,11.4,0.18404493
12999,12999,Jim Paek,1993-94,26.0,4,18,77,77,3,15,18,57.0,,129,4,22,26,90.0,84,7.25,87,443,2603,11.7,0.19056365
13000,13000,Jim Paek,1994-95,27.0,5,6,59,59,1,5,6,35.0,,188,5,27,32,125.0,84,6.48,76,407,2545,10.7,0.1315307
13001,13001,Jim Paek,1995-96,28.0,6,2,29,29,0,2,2,16.0,,217,5,29,34,141.0,48,5.97,37,209,1408,10.2,0.1062479
13002,13002,Jim Pavese,1982-83,20.0,2,11,42,42,2,9,11,29.0,,42,2,9,11,29.0,80,8.03,73,320,2489,12.9,0.2923271
13003,13003,Jim Pavese,1983-84,21.0,3,2,24,24,0,2,2,9.0,,66,2,11,13,38.0,80,7.73,71,310,2444,12.7,0.23759836
13004,13004,Jim Pavese,1984-85,22.0,4,1,4,4,0,1,1,1.0,,70,2,12,14,39.0,80,7.89,74,336,2448,12.9,0.21645981
13005,13005,Jim Pavese,1985-86,23.0,5,7,51,51,2,5,7,27.0,,121,4,17,21,66.0,80,7.77,71,321,2447,12.7,0.1818076
13006,13006,Jim Pavese,1986-87,24.0,6,11,69,69,4,7,11,51.0,,190,8,24,32,117.0,80,7.94,82,370,2484,12.8,0.21660835
13007,13007,Jim Pavese,1987-88,25.0,7,11,69,69,2,9,11,45.0,,259,10,33,43,162.0,80,7.34,72,344,2400,12.2,0.21539453
13008,13008,Jim Pavese,1988-89,26.0,8,5,25,25,0,5,5,20.0,,284,10,38,48,182.0,80,7.43,89,437,2435,12.2,0.18879306
13009,13009,Jim Pavese,1989-90,27.0,9,9,44,44,3,6,9,33.0,,328,13,44,57,215.0,80,7.48,85,403,2430,12.3,0.16463748
13010,13010,Jim Peplinski,1981-82,21.0,2,38,80,80,13,25,38,107.0,,80,13,25,38,107.0,80,7.69,77,340,2441,12.6,0.6088842
13011,13011,Jim Peplinski,1982-83,22.0,3,67,74,74,30,37,67,141.0,,154,43,62,105,248.0,80,8.03,73,320,2489,12.9,0.8272809
13012,13012,Jim Peplinski,1983-84,23.0,4,41,80,80,15,26,41,145.0,,234,58,88,146,393.0,80,7.73,71,310,2444,12.7,0.5852075
13013,13013,Jim Peplinski,1984-85,24.0,5,33,74,74,11,22,33,149.0,,308,69,110,179,542.0,80,7.89,74,336,2448,12.9,0.5400119
13014,13014,Jim Peplinski,1985-86,25.0,6,45,80,80,16,29,45,174.0,,388,85,139,224,716.0,80,7.77,71,321,2447,12.7,0.61133206
13015,13015,Jim Peplinski,1986-87,26.0,7,59,77,77,24,35,59,161.0,,465,109,174,283,877.0,80,7.94,82,370,2484,12.8,0.6605453
13016,13016,Jim Peplinski,1987-88,27.0,8,50,80,80,18,32,50,144.0,,545,127,206,333,1021.0,80,7.34,72,344,2400,12.2,0.6424046
13017,13017,Jim Peplinski,1988-89,28.0,9,51,75,75,20,31,51,128.0,,620,147,237,384,1149.0,80,7.43,89,437,2435,12.2,0.5788801
13018,13018,Jim Peplinski,1989-90,29.0,10,38,79,79,13,25,38,103.0,,699,160,262,422,1252.0,80,7.48,85,403,2430,12.3,0.44372535
13019,13019,Jim Peplinski,1990-91,30.0,11,1,6,6,1,0,1,12.0,,705,161,262,423,1264.0,80,7.37,76,367,2421,12.2,0.393409
13020,13020,Jim Peplinski,1995-96,35.0,12,1,6,6,0,1,1,5.0,,711,161,263,424,1269.0,48,5.97,37,209,1408,10.2,0.23953325
13021,13021,Jim Playfair,1984-85,20.0,2,2,2,2,1,1,2,2.0,,2,1,1,2,2.0,80,7.89,74,336,2448,12.9,0.3544423
13022,13022,Jim Playfair,1988-89,24.0,3,4,12,12,1,3,4,11.0,,14,2,4,6,13.0,80,7.43,89,437,2435,12.2,0.24373019
13023,13023,Jim Playfair,1989-90,25.0,4,0,7,7,0,0,0,1.0,,21,2,4,6,14.0,80,7.48,85,403,2430,12.3,0.18558803
13024,13024,Jim Sandlak,1986-87,20.0,2,4,23,23,1,3,4,34.0,,23,1,3,4,34.0,80,7.94,82,370,2484,12.8,0.35064876
13025,13025,Jim Sandlak,1987-88,21.0,3,36,78,78,15,21,36,114.0,,101,16,24,40,148.0,80,7.34,72,344,2400,12.2,0.52882576
13026,13026,Jim Sandlak,1988-89,22.0,4,31,49,49,16,15,31,96.0,,150,32,39,71,244.0,80,7.43,89,437,2435,12.2,0.60049134
13027,13027,Jim Sandlak,1989-90,23.0,5,40,72,72,20,20,40,164.0,,222,52,59,111,408.0,80,7.48,85,403,2430,12.3,0.5565021
13028,13028,Jim Sandlak,1990-91,24.0,6,23,70,70,15,8,23,135.0,,292,67,67,134,543.0,80,7.37,76,367,2421,12.2,0.37573877
13029,13029,Jim Sandlak,1991-92,25.0,7,13,59,59,7,6,13,88.0,,351,74,73,147,631.0,80,6.91,71,366,2385,11.6,0.34635025
13030,13030,Jim Sandlak,1992-93,26.0,8,40,66,66,16,24,40,122.0,,417,90,97,187,753.0,80,6.96,77,402,2440,11.4,0.5131196
13031,13031,Jim Sandlak,1993-94,27.0,9,28,59,59,10,18,28,104.0,,476,100,115,215,857.0,84,7.25,87,443,2603,11.7,0.38833022
13032,13032,Jim Sandlak,1994-95,28.0,10,8,27,27,6,2,8,32.0,,503,106,117,223,889.0,84,6.48,76,407,2545,10.7,0.32404304
13033,13033,Jim Sandlak,1995-96,29.0,11,0,13,13,0,0,0,13.0,,516,106,117,223,902.0,48,5.97,37,209,1408,10.2,0.26909143
13034,13034,Jim Sandlak,1996-97,30.0,12,6,33,33,4,2,6,44.0,,549,110,119,229,946.0,82,6.29,74,413,2481,10.4,0.27185017
13035,13035,Jim Slater,2006-07,24.0,2,20,71,71,10,10,20,108.0,717.0,71,10,10,20,108.0,82,6.05,85,480,2458,10.1,0.3155172
13036,13036,Jim Slater,2007-08,25.0,3,19,74,74,5,14,19,90.0,757.0,145,15,24,39,198.0,82,5.76,70,398,2426,9.7,0.26922983
13037,13037,Jim Slater,2008-09,26.0,4,13,69,69,8,5,13,95.0,717.0,214,23,29,52,293.0,82,5.44,62,351,2383,9.4,0.2401169
13038,13038,Jim Slater,2009-10,27.0,5,18,60,60,8,10,18,94.0,675.0,274,31,39,70,387.0,82,5.7,65,341,2477,9.4,0.29358
13039,13039,Jim Slater,2010-11,28.0,6,18,61,61,11,7,18,107.0,745.0,335,42,46,88,494.0,82,5.53,56,304,2486,9.1,0.28425962
13040,13040,Jim Slater,2011-12,29.0,7,12,36,36,5,7,12,53.0,381.0,371,47,53,100,547.0,82,5.46,52,291,2492,9.0,0.250314
13041,13041,Jim Slater,2012-13,30.0,8,21,78,78,13,8,21,118.0,1152.0,449,60,61,121,665.0,82,5.32,47,271,2439,8.9,0.27087188
13042,13042,Jim Slater,2013-14,31.0,9,2,26,26,1,1,2,22.0,272.0,475,61,62,123,687.0,48,5.31,29,160,1399,9.1,0.15577832
13043,13043,Jim Slater,2014-15,32.0,10,2,27,27,1,1,2,24.0,287.0,502,62,63,125,711.0,82,5.34,48,269,2463,8.9,0.19532737
13044,13044,Jim Slater,2015-16,33.0,11,13,82,82,5,8,13,51.0,755.0,584,67,71,138,762.0,82,5.32,47,251,2453,8.9,0.14345667
13045,13045,Jim Storm,1994-95,23.0,2,16,68,68,6,10,16,84.0,,68,6,10,16,84.0,84,6.48,76,407,2545,10.7,0.29344812
13046,13046,Jim Storm,1995-96,24.0,3,3,6,6,0,3,3,3.0,,74,6,13,19,87.0,48,5.97,37,209,1408,10.2,0.23815635
13047,13047,Jim Storm,1996-97,25.0,4,3,10,10,1,2,3,11.0,,84,7,15,22,98.0,82,6.29,74,413,2481,10.4,0.22980174
13048,13048,Jim Thomson,1987-88,22.0,2,0,10,10,0,0,0,5.0,,10,0,0,0,5.0,80,7.34,72,344,2400,12.2,0.21920612
13049,13049,Jim Thomson,1989-90,24.0,3,2,19,19,2,0,2,12.0,,29,2,0,2,17.0,80,7.48,85,403,2430,12.3,0.23333412
13050,13050,Jim Thomson,1990-91,25.0,4,0,3,3,0,0,0,3.0,,32,2,0,2,20.0,80,7.37,76,367,2421,12.2,0.18557891
13051,13051,Jim Thomson,1991-92,26.0,5,1,8,8,1,0,1,6.0,,40,3,0,3,26.0,80,6.91,71,366,2385,11.6,0.1865009
13052,13052,Jim Thomson,1992-93,27.0,6,3,45,45,1,2,3,24.0,,85,4,2,6,50.0,80,6.96,77,402,2440,11.4,0.12337637
13053,13053,Jim Thomson,1993-94,28.0,7,1,24,24,0,1,1,23.0,,109,4,3,7,73.0,84,7.25,87,443,2603,11.7,0.16120565
13054,13054,Jim Thomson,1994-95,29.0,8,0,6,6,0,0,0,1.0,,115,4,3,7,74.0,84,6.48,76,407,2545,10.7,0.12885773
13055,13055,Jim Vandermeer,2003-04,23.0,2,3,24,24,2,1,3,22.0,329.0,24,2,1,3,22.0,82,5.31,60,363,2326,9.4,0.24001157
13056,13056,Jim Vandermeer,2004-05,24.0,3,17,46,46,5,12,17,61.0,870.0,70,7,13,20,83.0,82,5.14,57,348,2300,9.2,0.31057507
13057,13057,Jim Vandermeer,2006-07,26.0,4,24,76,76,6,18,24,93.0,1655.0,146,13,31,44,176.0,82,6.05,85,480,2458,10.1,0.2805145
13058,13058,Jim Vandermeer,2007-08,27.0,5,7,46,46,1,6,7,50.0,820.0,192,14,37,51,226.0,82,5.76,70,398,2426,9.7,0.1705752
13059,13059,Jim Vandermeer,2008-09,28.0,6,17,75,75,3,14,17,72.0,1473.0,267,17,51,68,298.0,82,5.44,62,351,2383,9.4,0.21605885
13060,13060,Jim Vandermeer,2009-10,29.0,7,7,45,45,1,6,7,31.0,721.0,312,18,57,75,329.0,82,5.7,65,341,2477,9.4,0.14034197
13061,13061,Jim Vandermeer,2010-11,30.0,8,12,62,62,4,8,12,64.0,1096.0,374,22,65,87,393.0,82,5.53,56,304,2486,9.1,0.1751309
13062,13062,Jim Vandermeer,2011-12,31.0,9,14,62,62,2,12,14,57.0,1128.0,436,24,77,101,450.0,82,5.46,52,291,2492,9.0,0.16905466
13063,13063,Jim Vandermeer,2012-13,32.0,10,4,25,25,1,3,4,19.0,260.0,461,25,80,105,469.0,82,5.32,47,271,2439,8.9,0.15398455
13064,13064,Jim Vesey,1989-90,24.0,2,2,5,5,1,1,2,5.0,,5,1,1,2,5.0,80,7.48,85,403,2430,12.3,0.26637322
13065,13065,Jim Vesey,1990-91,25.0,3,1,6,6,0,1,1,3.0,,11,1,2,3,8.0,80,7.37,76,367,2421,12.2,0.20363179
13066,13066,Jim Vesey,1992-93,27.0,4,0,4,4,0,0,0,1.0,,15,1,2,3,9.0,80,6.96,77,402,2440,11.4,0.1836898
13067,13067,Jim Walsh,1982-83,26.0,2,1,4,4,0,1,1,8.0,,4,0,1,1,8.0,80,8.03,73,320,2489,12.9,0.23946947
13068,13068,Jim Warner,1980-81,26.0,2,3,32,32,0,3,3,26.0,,32,0,3,3,26.0,80,7.03,61,280,2352,12.0,0.21575192
13069,13069,Jim Wiemer,1984-85,24.0,2,20,64,64,5,15,20,90.0,,64,5,15,20,90.0,80,7.89,74,336,2448,12.9,0.31766748
13070,13070,Jim Wiemer,1985-86,25.0,3,12,32,32,7,5,12,72.0,,96,12,20,32,162.0,80,7.77,71,321,2447,12.7,0.41215748
13071,13071,Jim Wiemer,1986-87,26.0,4,3,7,7,3,0,3,22.0,,103,15,20,35,184.0,80,7.94,82,370,2484,12.8,0.34162542
13072,13072,Jim Wiemer,1988-89,28.0,5,3,12,12,1,2,3,24.0,,115,16,22,38,208.0,80,7.43,89,437,2435,12.2,0.29899418
13073,13073,Jim Wiemer,1989-90,29.0,6,5,9,9,2,3,5,17.0,,124,18,25,43,225.0,80,7.48,85,403,2430,12.3,0.3026067
13074,13074,Jim Wiemer,1990-91,30.0,7,19,61,61,5,14,19,90.0,,185,23,39,62,315.0,80,7.37,76,367,2421,12.2,0.2851838
13075,13075,Jim Wiemer,1991-92,31.0,8,23,61,61,4,19,23,86.0,,246,27,58,85,401.0,80,6.91,71,366,2385,11.6,0.30365425
13076,13076,Jim Wiemer,1992-93,32.0,9,9,47,47,1,8,9,60.0,,293,28,66,94,461.0,80,6.96,77,402,2440,11.4,0.18629315
13077,13077,Jim Wiemer,1993-94,33.0,10,7,28,28,1,6,7,39.0,,321,29,72,101,500.0,84,7.25,87,443,2603,11.7,0.20623726
13078,13078,Jim Wiemer,1994-95,34.0,11,0,4,4,0,0,0,8.0,,325,29,72,101,508.0,84,6.48,76,407,2545,10.7,0.16235098
13079,13079,Jimmie Olvestad,2002-03,22.0,2,14,74,74,3,11,14,99.0,1036.0,74,3,11,14,99.0,82,5.24,53,338,2262,9.5,0.22803122
13080,13080,Jimmie Olvestad,2003-04,23.0,3,3,37,37,0,3,3,30.0,387.0,111,3,14,17,129.0,82,5.31,60,363,2326,9.4,0.18475169
13081,13081,Jimmy Carson,1987-88,19.0,2,79,80,80,37,42,79,215.0,,80,37,42,79,215.0,80,7.34,72,344,2400,12.2,1.0327204
13082,13082,Jimmy Carson,1988-89,20.0,3,107,80,80,55,52,107,264.0,,160,92,94,186,479.0,80,7.43,89,437,2435,12.2,1.214644
13083,13083,Jimmy Carson,1989-90,21.0,4,100,80,80,49,51,100,240.0,,240,141,145,286,719.0,80,7.48,85,403,2430,12.3,1.1274481
13084,13084,Jimmy Carson,1990-91,22.0,5,39,48,48,21,18,39,138.0,,288,162,163,325,857.0,80,7.37,76,367,2421,12.2,0.8643586
13085,13085,Jimmy Carson,1991-92,23.0,6,46,64,64,21,25,46,175.0,,352,183,188,371,1032.0,80,6.91,71,366,2385,11.6,0.79289997
13086,13086,Jimmy Carson,1992-93,24.0,7,69,80,80,34,35,69,150.0,,432,217,223,440,1182.0,80,6.96,77,402,2440,11.4,0.89539754
13087,13087,Jimmy Carson,1993-94,25.0,8,73,86,86,37,36,73,189.0,,518,254,259,513,1371.0,84,7.25,87,443,2603,11.7,0.7706677
13088,13088,Jimmy Carson,1994-95,26.0,9,28,59,59,11,17,28,129.0,,577,265,276,541,1500.0,84,6.48,76,407,2545,10.7,0.5148643
13089,13089,Jimmy Carson,1995-96,27.0,10,19,38,38,9,10,19,58.0,,615,274,286,560,1558.0,48,5.97,37,209,1408,10.2,0.52391285
13090,13090,Jimmy Carson,1996-97,28.0,11,1,11,11,1,0,1,9.0,,626,275,286,561,1567.0,82,6.29,74,413,2481,10.4,0.44602233
13091,13091,Jimmy Hayes,2012-13,23.0,2,9,31,31,5,4,9,41.0,318.0,31,5,4,9,41.0,82,5.32,47,271,2439,8.9,0.29424018
13092,13092,Jimmy Hayes,2013-14,24.0,3,4,10,10,1,3,4,13.0,143.0,41,6,7,13,54.0,48,5.31,29,160,1399,9.1,0.24776942
13093,13093,Jimmy Hayes,2014-15,25.0,4,18,55,55,11,7,18,72.0,603.0,96,17,14,31,126.0,82,5.34,48,269,2463,8.9,0.32325703
13094,13094,Jimmy Hayes,2015-16,26.0,5,35,72,72,19,16,35,166.0,1090.0,168,36,30,66,292.0,82,5.32,47,251,2453,8.9,0.45153785
13095,13095,Jimmy Hayes,2016-17,27.0,6,29,75,75,13,16,29,127.0,1037.0,243,49,46,95,419.0,82,5.34,48,255,2438,9.0,0.3499033
13096,13096,Jimmy Hayes,2017-18,28.0,7,5,58,58,2,3,5,74.0,535.0,301,51,49,100,493.0,82,5.45,47,245,2478,9.0,0.19995344
13097,13097,Jimmy Hayes,2018-19,29.0,8,9,33,33,3,6,9,37.0,394.0,334,54,55,109,530.0,82,5.86,50,250,2620,9.2,0.26496512
13098,13098,Jimmy Mann,1980-81,21.0,2,8,72,72,3,5,8,60.0,,72,3,5,8,60.0,80,7.03,61,280,2352,12.0,0.22254285
13099,13099,Jimmy Mann,1981-82,22.0,3,6,37,37,3,3,6,30.0,,109,6,8,14,90.0,80,7.69,77,340,2441,12.6,0.23916474
13100,13100,Jimmy Mann,1982-83,23.0,4,5,37,37,3,2,5,22.0,,146,9,10,19,112.0,80,8.03,73,320,2489,12.9,0.1902861
13101,13101,Jimmy Mann,1983-84,24.0,5,1,40,40,0,1,1,20.0,,186,9,11,20,132.0,80,7.73,71,310,2444,12.7,0.13654217
13102,13102,Jimmy Mann,1984-85,25.0,6,3,38,38,1,2,3,20.0,,224,10,13,23,152.0,80,7.89,74,336,2448,12.9,0.13027942
13103,13103,Jimmy Mann,1985-86,26.0,7,4,25,25,0,4,4,12.0,,249,10,17,27,164.0,80,7.77,71,321,2447,12.7,0.14144742
13104,13104,Jimmy Mann,1986-87,27.0,8,3,35,35,0,3,3,4.0,,284,10,20,30,168.0,80,7.94,82,370,2484,12.8,0.10173112
13105,13105,Jimmy Mann,1988-89,29.0,9,0,9,9,0,0,0,1.0,,293,10,20,30,169.0,80,7.43,89,437,2435,12.2,0.121548444
13106,13106,Jimmy Schuldt,2019-20,24.0,2,1,1,1,0,1,1,1.0,21.0,1,0,1,1,1.0,82,5.96,47,239,2579,9.5,0.19618708
13107,13107,Jimmy Vesey,2017-18,24.0,2,27,80,80,16,11,27,116.0,1091.0,80,16,11,27,116.0,82,5.45,47,245,2478,9.0,0.3883303
13108,13108,Jimmy Vesey,2018-19,25.0,3,28,79,79,17,11,28,136.0,1132.0,159,33,22,55,252.0,82,5.86,50,250,2620,9.2,0.39892069
13109,13109,Jimmy Vesey,2019-20,26.0,4,35,81,81,17,18,35,154.0,1301.0,240,50,40,90,406.0,82,5.96,47,239,2579,9.5,0.44837666
13110,13110,Jimmy Vesey,2020-21,27.0,5,20,64,64,9,11,20,93.0,883.0,304,59,51,110,499.0,70,5.96,42,208,2192,9.5,0.33491826
13111,13111,Jiri Bicek,2001-02,23.0,2,1,5,5,1,0,1,10.0,65.0,5,1,0,1,10.0,82,5.51,63,376,2272,9.9,0.22382355
13112,13112,Jiri Bicek,2002-03,24.0,3,0,1,1,0,0,0,2.0,13.0,6,1,0,1,12.0,82,5.24,53,338,2262,9.5,0.16837019
13113,13113,Jiri Bicek,2003-04,25.0,4,11,44,44,5,6,11,63.0,519.0,50,6,6,12,75.0,82,5.31,60,363,2326,9.4,0.22861093
13114,13114,Jiri Bicek,2004-05,26.0,5,1,12,12,0,1,1,10.0,119.0,62,6,7,13,85.0,82,5.14,57,348,2300,9.2,0.20340773
13115,13115,Jiri Bubla,1982-83,33.0,2,2,23,23,1,1,2,23.0,,23,1,1,2,23.0,80,8.03,73,320,2489,12.9,0.26002046
13116,13116,Jiri Bubla,1983-84,34.0,3,30,72,72,2,28,30,92.0,,95,3,29,32,115.0,80,7.73,71,310,2444,12.7,0.40258107
13117,13117,Jiri Bubla,1984-85,35.0,4,39,62,62,6,33,39,84.0,,157,9,62,71,199.0,80,7.89,74,336,2448,12.9,0.44249937
13118,13118,Jiri Bubla,1985-86,36.0,5,17,56,56,2,15,17,73.0,,213,11,77,88,272.0,80,7.77,71,321,2447,12.7,0.3221919
13119,13119,Jiri Bubla,1986-87,37.0,6,30,43,43,6,24,30,62.0,,256,17,101,118,334.0,80,7.94,82,370,2484,12.8,0.4948681
13120,13120,Jiri Dopita,2002-03,34.0,2,27,52,52,11,16,27,79.0,792.0,52,11,16,27,79.0,82,5.24,53,338,2262,9.5,0.42228732
13121,13121,Jiri Dopita,2003-04,35.0,3,6,21,21,1,5,6,23.0,290.0,73,12,21,33,102.0,82,5.31,60,363,2326,9.4,0.22770602
13122,13122,Jiri Fischer,2000-01,20.0,2,8,52,52,0,8,8,41.0,564.0,52,0,8,8,41.0,82,5.49,53,331,2294,9.8,0.19482109
13123,13123,Jiri Fischer,2001-02,21.0,3,9,55,55,1,8,9,64.0,922.0,107,1,16,17,105.0,82,5.51,63,376,2272,9.9,0.20698988
13124,13124,Jiri Fischer,2002-03,22.0,4,10,80,80,2,8,10,103.0,1374.0,187,3,24,27,208.0,82,5.24,53,338,2262,9.5,0.21966505
13125,13125,Jiri Fischer,2003-04,23.0,5,6,15,15,1,5,6,19.0,321.0,202,4,29,33,227.0,82,5.31,60,363,2326,9.4,0.26004365
13126,13126,Jiri Fischer,2004-05,24.0,6,19,81,81,4,15,19,115.0,1499.0,283,8,44,52,342.0,82,5.14,57,348,2300,9.2,0.27596104
13127,13127,Jiri Fischer,2006-07,26.0,7,8,22,22,3,5,8,36.0,456.0,305,11,49,60,378.0,82,6.05,85,480,2458,10.1,0.24422857
13128,13128,Jiri Hrdina,1988-89,31.0,2,7,9,9,2,5,7,13.0,,9,2,5,7,13.0,80,7.43,89,437,2435,12.2,0.39075798
13129,13129,Jiri Hrdina,1989-90,32.0,3,54,70,70,22,32,54,147.0,,79,24,37,61,160.0,80,7.48,85,403,2430,12.3,0.6487288
13130,13130,Jiri Hrdina,1990-91,33.0,4,30,64,64,12,18,30,96.0,,143,36,55,91,256.0,80,7.37,76,367,2421,12.2,0.40570912
13131,13131,Jiri Hrdina,1991-92,34.0,5,23,51,51,6,17,23,66.0,,194,42,72,114,322.0,80,6.91,71,366,2385,11.6,0.3928029
13132,13132,Jiri Hrdina,1992-93,35.0,6,16,56,56,3,13,16,51.0,,250,45,85,130,373.0,80,6.96,77,402,2440,11.4,0.33336318
13133,13133,Jiri Hudler,2004-05,21.0,2,3,12,12,1,2,3,8.0,98.0,12,1,2,3,8.0,82,5.14,57,348,2300,9.2,0.26878518
13134,13134,Jiri Hudler,2006-07,23.0,3,0,4,4,0,0,0,3.0,29.0,16,1,2,3,11.0,82,6.05,85,480,2458,10.1,0.16413373
13135,13135,Jiri Hudler,2007-08,24.0,4,25,76,76,15,10,25,107.0,763.0,92,16,12,28,118.0,82,5.76,70,398,2426,9.7,0.3692922
13136,13136,Jiri Hudler,2008-09,25.0,5,42,81,81,13,29,42,131.0,1067.0,173,29,41,70,249.0,82,5.44,62,351,2383,9.4,0.5063522
13137,13137,Jiri Hudler,2009-10,26.0,6,57,82,82,23,34,57,155.0,1119.0,255,52,75,127,404.0,82,5.7,65,341,2477,9.4,0.6226499
13138,13138,Jiri Hudler,2011-12,28.0,7,37,73,73,10,27,37,105.0,997.0,328,62,102,164,509.0,82,5.46,52,291,2492,9.0,0.4775465
13139,13139,Jiri Hudler,2012-13,29.0,8,50,81,81,25,25,50,127.0,1269.0,409,87,127,214,636.0,82,5.32,47,271,2439,8.9,0.5386685
13140,13140,Jiri Hudler,2013-14,30.0,9,27,42,42,10,17,27,56.0,721.0,451,97,144,241,692.0,48,5.31,29,160,1399,9.1,0.56199056
13141,13141,Jiri Hudler,2014-15,31.0,10,54,75,75,17,37,54,109.0,1413.0,526,114,181,295,801.0,82,5.34,48,269,2463,8.9,0.6201431
13142,13142,Jiri Hudler,2015-16,32.0,11,76,78,78,31,45,76,158.0,1405.0,604,145,226,371,959.0,82,5.32,47,251,2453,8.9,0.77562636
13143,13143,Jiri Hudler,2016-17,33.0,12,46,72,72,16,30,46,109.0,1135.0,676,161,256,417,1068.0,82,5.34,48,255,2438,9.0,0.49239424
13144,13144,Jiri Hudler,2017-18,34.0,13,11,32,32,3,8,11,27.0,379.0,708,164,264,428,1095.0,82,5.45,47,245,2478,9.0,0.26665565
13145,13145,Jiri Latal,1990-91,23.0,2,19,32,32,6,13,19,59.0,,32,6,13,19,59.0,80,7.37,76,367,2421,12.2,0.46730483
13146,13146,Jiri Latal,1991-92,24.0,3,26,50,50,5,21,26,81.0,,82,11,34,45,140.0,80,6.91,71,366,2385,11.6,0.43630943
13147,13147,Jiri Latal,1992-93,25.0,4,3,10,10,1,2,3,22.0,,92,12,36,48,162.0,80,6.96,77,402,2440,11.4,0.33614293
13148,13148,Jiri Novotny,2006-07,23.0,2,3,14,14,2,1,3,15.0,171.0,14,2,1,3,15.0,82,6.05,85,480,2458,10.1,0.25470188
13149,13149,Jiri Novotny,2007-08,24.0,3,19,68,68,6,13,19,79.0,879.0,82,8,14,22,94.0,82,5.76,70,398,2426,9.7,0.30130988
13150,13150,Jiri Novotny,2008-09,25.0,4,22,65,65,8,14,22,91.0,1152.0,147,16,28,44,185.0,82,5.44,62,351,2383,9.4,0.28760993
13151,13151,Jiri Novotny,2009-10,26.0,5,7,42,42,4,3,7,56.0,560.0,189,20,31,51,241.0,82,5.7,65,341,2477,9.4,0.21356812
13152,13152,Jiri Sejba,1991-92,29.0,2,2,11,11,0,2,2,10.0,,11,0,2,2,10.0,80,6.91,71,366,2385,11.6,0.21187976
13153,13153,Jiri Sekac,2015-16,23.0,2,23,69,69,9,14,23,85.0,936.0,69,9,14,23,85.0,82,5.32,47,251,2453,8.9,0.3428495
13154,13154,Jiri Sekac,2016-17,24.0,3,6,39,39,1,5,6,49.0,455.0,108,10,19,29,134.0,82,5.34,48,255,2438,9.0,0.21677259
13155,13155,Jiri Slegr,1993-94,22.0,2,26,41,41,4,22,26,89.0,,41,4,22,26,89.0,84,7.25,87,443,2603,11.7,0.5566997
13156,13156,Jiri Slegr,1994-95,23.0,3,38,78,78,5,33,38,160.0,,119,9,55,64,249.0,84,6.48,76,407,2545,10.7,0.4586594
13157,13157,Jiri Slegr,1995-96,24.0,4,12,31,31,2,10,12,69.0,,150,11,65,76,318.0,48,5.97,37,209,1408,10.2,0.3538732
13158,13158,Jiri Slegr,1996-97,25.0,5,17,57,57,4,13,17,91.0,,207,15,78,93,409.0,82,6.29,74,413,2481,10.4,0.30071968
13159,13159,Jiri Slegr,1998-99,27.0,6,17,73,73,5,12,17,131.0,,280,20,90,110,540.0,82,5.28,57,380,2242,9.6,0.32449841
13160,13160,Jiri Slegr,1999-00,28.0,7,23,63,63,3,20,23,91.0,1178.0,343,23,110,133,631.0,82,5.27,57,359,2285,9.4,0.32171208
13161,13161,Jiri Slegr,2000-01,29.0,8,31,74,74,11,20,31,144.0,1581.0,417,34,130,164,775.0,82,5.49,53,331,2294,9.8,0.41880602
13162,13162,Jiri Slegr,2001-02,30.0,9,34,75,75,8,26,34,145.0,1452.0,492,42,156,198,920.0,82,5.51,63,376,2272,9.9,0.40001982
13163,13163,Jiri Slegr,2002-03,31.0,10,9,46,46,3,6,9,67.0,966.0,538,45,162,207,987.0,82,5.24,53,338,2262,9.5,0.23184544
13164,13164,Jiri Slegr,2004-05,33.0,11,26,52,52,6,20,26,98.0,918.0,590,51,182,233,1085.0,82,5.14,57,348,2300,9.2,0.47922122
13165,13165,Jiri Slegr,2006-07,35.0,12,16,32,32,5,11,16,59.0,524.0,622,56,193,249,1144.0,82,6.05,85,480,2458,10.1,0.3214464
13166,13166,Jiri Tlusty,2008-09,20.0,2,16,58,58,10,6,16,69.0,634.0,58,10,6,16,69.0,82,5.44,62,351,2383,9.4,0.3168285
13167,13167,Jiri Tlusty,2009-10,21.0,3,4,14,14,0,4,4,22.0,178.0,72,10,10,20,91.0,82,5.7,65,341,2477,9.4,0.35469407
13168,13168,Jiri Tlusty,2010-11,22.0,4,6,20,20,1,5,6,17.0,251.0,92,11,15,26,108.0,82,5.53,56,304,2486,9.1,0.2807726
13169,13169,Jiri Tlusty,2011-12,23.0,5,12,57,57,6,6,12,53.0,562.0,149,17,21,38,161.0,82,5.46,52,291,2492,9.0,0.24537247
13170,13170,Jiri Tlusty,2012-13,24.0,6,36,79,79,17,19,36,136.0,1178.0,228,34,40,74,297.0,82,5.32,47,271,2439,8.9,0.45339385
13171,13171,Jiri Tlusty,2013-14,25.0,7,38,48,48,23,15,38,117.0,876.0,276,57,55,112,414.0,48,5.31,29,160,1399,9.1,0.6572367
13172,13172,Jiri Tlusty,2014-15,26.0,8,30,68,68,16,14,30,131.0,1032.0,344,73,69,142,545.0,82,5.34,48,269,2463,8.9,0.43965998
13173,13173,Jiri Tlusty,2015-16,27.0,9,31,72,72,14,17,31,123.0,1154.0,416,87,86,173,668.0,82,5.32,47,251,2453,8.9,0.3901941
13174,13174,Jiri Tlusty,2016-17,28.0,10,4,30,30,2,2,4,38.0,411.0,446,89,88,177,706.0,82,5.34,48,255,2438,9.0,0.3086217
13175,13175,Joachim Blichfeld,2020-21,22.0,2,0,3,3,0,0,0,3.0,38.0,3,0,0,0,3.0,70,5.96,42,208,2192,9.5,0.20590216
13176,13176,Joakim Andersson,2012-13,23.0,2,0,5,5,0,0,0,3.0,33.0,5,0,0,0,3.0,82,5.32,47,271,2439,8.9,0.17154336
13177,13177,Joakim Andersson,2013-14,24.0,3,8,38,38,3,5,8,43.0,459.0,43,3,5,8,46.0,48,5.31,29,160,1399,9.1,0.21685073
13178,13178,Joakim Andersson,2014-15,25.0,4,17,65,65,8,9,17,78.0,899.0,108,11,14,25,124.0,82,5.34,48,269,2463,8.9,0.24630433
13179,13179,Joakim Andersson,2015-16,26.0,5,8,68,68,3,5,8,74.0,791.0,176,14,19,33,198.0,82,5.32,47,251,2453,8.9,0.17483103
13180,13180,Joakim Andersson,2016-17,27.0,6,3,29,29,1,2,3,17.0,262.0,205,15,21,36,215.0,82,5.34,48,255,2438,9.0,0.1291754
13181,13181,Joakim Lindstrom,2006-07,23.0,2,0,3,3,0,0,0,4.0,16.0,3,0,0,0,4.0,82,6.05,85,480,2458,10.1,0.1751594
13182,13182,Joakim Lindstrom,2007-08,24.0,3,1,9,9,1,0,1,9.0,76.0,12,1,0,1,13.0,82,5.76,70,398,2426,9.7,0.19881254
13183,13183,Joakim Lindstrom,2008-09,25.0,4,7,25,25,3,4,7,25.0,236.0,37,4,4,8,38.0,82,5.44,62,351,2383,9.4,0.22968015
13184,13184,Joakim Lindstrom,2009-10,26.0,5,20,44,44,9,11,20,77.0,654.0,81,13,15,28,115.0,82,5.7,65,341,2477,9.4,0.37313256
13185,13185,Joakim Lindstrom,2012-13,29.0,6,5,16,16,2,3,5,22.0,223.0,97,15,18,33,137.0,82,5.32,47,271,2439,8.9,0.22428608
13186,13186,Joakim Lindstrom,2015-16,32.0,7,10,53,53,4,6,10,61.0,576.0,150,19,24,43,198.0,82,5.32,47,251,2453,8.9,0.18796894
13187,13187,Joakim Nordstrom,2014-15,22.0,2,3,16,16,1,2,3,26.0,187.0,16,1,2,3,26.0,82,5.34,48,269,2463,8.9,0.23960179
13188,13188,Joakim Nordstrom,2015-16,23.0,3,3,38,38,0,3,3,42.0,417.0,54,1,5,6,68.0,82,5.32,47,251,2453,8.9,0.158909
13189,13189,Joakim Nordstrom,2016-17,24.0,4,24,71,71,10,14,24,81.0,1109.0,125,11,19,30,149.0,82,5.34,48,255,2438,9.0,0.30145466
13190,13190,Joakim Nordstrom,2017-18,25.0,5,12,82,82,7,5,12,104.0,1043.0,207,18,24,42,253.0,82,5.45,47,245,2478,9.0,0.21805245
13191,13191,Joakim Nordstrom,2018-19,26.0,6,7,75,75,2,5,7,97.0,793.0,282,20,29,49,350.0,82,5.86,50,250,2620,9.2,0.1831645
13192,13192,Joakim Nordstrom,2019-20,27.0,7,12,70,70,7,5,12,103.0,944.0,352,27,34,61,453.0,82,5.96,47,239,2579,9.5,0.20836863
13193,13193,Joakim Nordstrom,2020-21,28.0,8,7,48,48,4,3,7,49.0,581.0,400,31,37,68,502.0,70,5.96,42,208,2192,9.5,0.17810473
13194,13194,Joakim Nygard,2020-21,28.0,2,9,33,33,3,6,9,39.0,353.0,33,3,6,9,39.0,70,5.96,42,208,2192,9.5,0.2588437
13195,13195,Joakim Ryan,2018-19,25.0,2,12,62,62,3,9,12,79.0,1039.0,62,3,9,12,79.0,82,5.86,50,250,2620,9.2,0.20154467
13196,13196,Joakim Ryan,2019-20,26.0,3,7,44,44,0,7,7,35.0,562.0,106,3,16,19,114.0,82,5.96,47,239,2579,9.5,0.16557702
13197,13197,Joakim Ryan,2020-21,27.0,4,5,35,35,1,4,5,54.0,670.0,141,4,20,24,168.0,70,5.96,42,208,2192,9.5,0.19357723
13198,13198,Joby Messier,1993-94,23.0,2,0,11,11,0,0,0,11.0,,11,0,0,0,11.0,84,7.25,87,443,2603,11.7,0.22860709
13199,13199,Joby Messier,1994-95,24.0,3,2,4,4,0,2,2,7.0,,15,0,2,2,18.0,84,6.48,76,407,2545,10.7,0.18714225
13200,13200,Joby Messier,1995-96,25.0,4,2,10,10,0,2,2,4.0,,25,0,4,4,22.0,48,5.97,37,209,1408,10.2,0.18650165
13201,13201,Jocelyn Gauvreau,1984-85,20.0,2,0,2,2,0,0,0,0.0,,2,0,0,0,0.0,80,7.89,74,336,2448,12.9,0.27148372
13202,13202,Jocelyn Lemieux,1987-88,20.0,2,18,53,53,10,8,18,48.0,,53,10,8,18,48.0,80,7.34,72,344,2400,12.2,0.4034851
13203,13203,Jocelyn Lemieux,1988-89,21.0,3,1,23,23,1,0,1,19.0,,76,11,8,19,67.0,80,7.43,89,437,2435,12.2,0.39133108
13204,13204,Jocelyn Lemieux,1989-90,22.0,4,1,1,1,0,1,1,0.0,,77,11,9,20,67.0,80,7.48,85,403,2430,12.3,0.27029914
13205,13205,Jocelyn Lemieux,1990-91,23.0,5,27,73,73,14,13,27,112.0,,150,25,22,47,179.0,80,7.37,76,367,2421,12.2,0.384888
13206,13206,Jocelyn Lemieux,1991-92,24.0,6,13,67,67,6,7,13,89.0,,217,31,29,60,268.0,80,6.91,71,366,2385,11.6,0.26459277
13207,13207,Jocelyn Lemieux,1992-93,25.0,7,16,78,78,6,10,16,103.0,,295,37,39,76,371.0,80,6.96,77,402,2440,11.4,0.27228934
13208,13208,Jocelyn Lemieux,1993-94,26.0,8,31,81,81,10,21,31,117.0,,376,47,60,107,488.0,84,7.25,87,443,2603,11.7,0.36943865
13209,13209,Jocelyn Lemieux,1994-95,27.0,9,27,82,82,18,9,27,151.0,,458,65,69,134,639.0,84,6.48,76,407,2545,10.7,0.34387237
13210,13210,Jocelyn Lemieux,1995-96,28.0,10,11,41,41,6,5,11,78.0,,499,71,74,145,717.0,48,5.97,37,209,1408,10.2,0.3019236
13211,13211,Jocelyn Lemieux,1996-97,29.0,11,12,67,67,5,7,12,90.0,,566,76,81,157,807.0,82,6.29,74,413,2481,10.4,0.21217069
13212,13212,Jocelyn Lemieux,1997-98,30.0,12,1,2,2,1,0,1,4.0,,568,77,81,158,811.0,82,5.83,55,336,2444,9.8,0.21268997
13213,13213,Jocelyn Lemieux,1998-99,31.0,13,6,30,30,3,3,6,32.0,,598,80,84,164,843.0,82,5.28,57,380,2242,9.6,0.23474187
13214,13214,Jochen Hecht,1999-00,22.0,2,0,3,3,0,0,0,4.0,40.0,3,0,0,0,4.0,82,5.27,57,359,2285,9.4,0.19415745
13215,13215,Jochen Hecht,2000-01,23.0,3,34,63,63,13,21,34,140.0,971.0,66,13,21,34,144.0,82,5.49,53,331,2294,9.8,0.5512525
13216,13216,Jochen Hecht,2001-02,24.0,4,44,72,72,19,25,44,208.0,1291.0,138,32,46,78,352.0,82,5.51,63,376,2272,9.9,0.60704434
13217,13217,Jochen Hecht,2002-03,25.0,5,40,82,82,16,24,40,211.0,1230.0,220,48,70,118,563.0,82,5.24,53,338,2262,9.5,0.5775604
13218,13218,Jochen Hecht,2003-04,26.0,6,26,49,49,10,16,26,145.0,878.0,269,58,86,144,708.0,82,5.31,60,363,2326,9.4,0.5852471
13219,13219,Jochen Hecht,2004-05,27.0,7,52,64,64,15,37,52,174.0,1216.0,333,73,123,196,882.0,82,5.14,57,348,2300,9.2,0.71816224
13220,13220,Jochen Hecht,2006-07,29.0,8,42,64,64,18,24,42,179.0,1160.0,397,91,147,238,1061.0,82,6.05,85,480,2458,10.1,0.6486155
13221,13221,Jochen Hecht,2007-08,30.0,9,56,76,76,19,37,56,197.0,1432.0,473,110,184,294,1258.0,82,5.76,70,398,2426,9.7,0.6999456
13222,13222,Jochen Hecht,2008-09,31.0,10,49,75,75,22,27,49,229.0,1449.0,548,132,211,343,1487.0,82,5.44,62,351,2383,9.4,0.60618657
13223,13223,Jochen Hecht,2009-10,32.0,11,27,70,70,12,15,27,173.0,1218.0,618,144,226,370,1660.0,82,5.7,65,341,2477,9.4,0.41556877
13224,13224,Jochen Hecht,2010-11,33.0,12,42,79,79,21,21,42,224.0,1358.0,697,165,247,412,1884.0,82,5.53,56,304,2486,9.1,0.5291343
13225,13225,Jochen Hecht,2011-12,34.0,13,29,67,67,12,17,29,172.0,1144.0,764,177,264,441,2056.0,82,5.46,52,291,2492,9.0,0.4155582
13226,13226,Jochen Hecht,2012-13,35.0,14,8,22,22,4,4,8,40.0,370.0,786,181,268,449,2096.0,82,5.32,47,271,2439,8.9,0.33173156
13227,13227,Jochen Hecht,2013-14,36.0,15,14,47,47,5,9,14,69.0,644.0,833,186,277,463,2165.0,48,5.31,29,160,1399,9.1,0.2676434
13228,13228,Jock Callander,1988-89,27.0,2,27,41,41,11,16,27,59.0,,41,11,16,27,59.0,80,7.43,89,437,2435,12.2,0.48840922
13229,13229,Jock Callander,1989-90,28.0,3,11,30,30,6,5,11,35.0,,71,17,21,38,94.0,80,7.48,85,403,2430,12.3,0.338067
13230,13230,Jock Callander,1990-91,29.0,4,11,30,30,4,7,11,22.0,,101,21,28,49,116.0,80,7.37,76,367,2421,12.2,0.33392888
13231,13231,Jock Callander,1993-94,32.0,5,2,8,8,1,1,2,12.0,,109,22,29,51,128.0,84,7.25,87,443,2603,11.7,0.22615337
13232,13232,Jody Gage,1981-82,22.0,2,4,16,16,2,2,4,26.0,,16,2,2,4,26.0,80,7.69,77,340,2441,12.6,0.3688643
13233,13233,Jody Gage,1982-83,23.0,3,19,31,31,9,10,19,47.0,,47,11,12,23,73.0,80,8.03,73,320,2489,12.9,0.49086612
13234,13234,Jody Gage,1984-85,25.0,4,0,3,3,0,0,0,1.0,,50,11,12,23,74.0,80,7.89,74,336,2448,12.9,0.24764973
13235,13235,Jody Gage,1986-87,27.0,5,5,7,7,3,2,5,18.0,,57,14,14,28,92.0,80,7.94,82,370,2484,12.8,0.3021564
13236,13236,Jody Gage,1988-89,29.0,6,0,2,2,0,0,0,1.0,,59,14,14,28,93.0,80,7.43,89,437,2435,12.2,0.19969803
13237,13237,Jody Gage,1992-93,33.0,7,1,9,9,0,1,1,9.0,,68,14,15,29,102.0,80,6.96,77,402,2440,11.4,0.21757
13238,13238,Jody Hull,1989-90,20.0,2,34,60,60,16,18,34,82.0,,60,16,18,34,82.0,80,7.48,85,403,2430,12.3,0.57062393
13239,13239,Jody Hull,1990-91,21.0,3,17,38,38,7,10,17,46.0,,98,23,28,51,128.0,80,7.37,76,367,2421,12.2,0.46018416
13240,13240,Jody Hull,1991-92,22.0,4,13,47,47,5,8,13,57.0,,145,28,36,64,185.0,80,6.91,71,366,2385,11.6,0.35878688
13241,13241,Jody Hull,1992-93,23.0,5,0,3,3,0,0,0,4.0,,148,28,36,64,189.0,80,6.96,77,402,2440,11.4,0.38264415
13242,13242,Jody Hull,1993-94,24.0,6,34,69,69,13,21,34,134.0,,217,41,57,98,323.0,84,7.25,87,443,2603,11.7,0.46517318
13243,13243,Jody Hull,1994-95,25.0,7,26,69,69,13,13,26,100.0,,286,54,70,124,423.0,84,6.48,76,407,2545,10.7,0.3689565
13244,13244,Jody Hull,1995-96,26.0,8,19,46,46,11,8,19,63.0,,332,65,78,143,486.0,48,5.97,37,209,1408,10.2,0.41749227
13245,13245,Jody Hull,1996-97,27.0,9,37,78,78,20,17,37,120.0,,410,85,95,180,606.0,82,6.29,74,413,2481,10.4,0.40704703
13246,13246,Jody Hull,1997-98,28.0,10,16,67,67,10,6,16,92.0,,477,95,101,196,698.0,82,5.83,55,336,2444,9.8,0.29511023
13247,13247,Jody Hull,1998-99,29.0,11,8,49,49,4,4,8,51.0,,526,99,105,204,749.0,82,5.28,57,380,2242,9.6,0.20593238
13248,13248,Jody Hull,1999-00,30.0,12,14,72,72,3,11,14,73.0,935.0,598,102,116,218,822.0,82,5.27,57,359,2285,9.4,0.22158945
13249,13249,Jody Hull,2000-01,31.0,13,13,67,67,10,3,13,63.0,802.0,665,112,119,231,885.0,82,5.49,53,331,2294,9.8,0.19550496
13250,13250,Jody Hull,2001-02,32.0,14,15,71,71,7,8,15,78.0,938.0,736,119,127,246,963.0,82,5.51,63,376,2272,9.9,0.20174408
13251,13251,Jody Hull,2002-03,33.0,15,4,24,24,2,2,4,12.0,244.0,760,121,129,250,975.0,82,5.24,53,338,2262,9.5,0.16975501
13252,13252,Jody Hull,2003-04,34.0,16,11,70,70,3,8,11,42.0,737.0,830,124,137,261,1017.0,82,5.31,60,363,2326,9.4,0.14158237
13253,13253,Jody Hull,2004-05,35.0,17,0,1,1,0,0,0,0.0,3.0,831,124,137,261,1017.0,82,5.14,57,348,2300,9.2,0.2990722
13254,13254,Jody Shelley,2001-02,25.0,2,0,1,1,0,0,0,0.0,2.0,1,0,0,0,0.0,82,5.51,63,376,2272,9.9,0.15280735
13255,13255,Jody Shelley,2002-03,26.0,3,6,52,52,3,3,6,35.0,339.0,53,3,3,6,35.0,82,5.24,53,338,2262,9.5,0.15056783
13256,13256,Jody Shelley,2003-04,27.0,4,5,68,68,1,4,5,39.0,417.0,121,4,7,11,74.0,82,5.31,60,363,2326,9.4,0.13355795
13257,13257,Jody Shelley,2004-05,28.0,5,6,76,76,3,3,6,62.0,550.0,197,7,10,17,136.0,82,5.14,57,348,2300,9.2,0.16234484
13258,13258,Jody Shelley,2006-07,30.0,6,10,80,80,3,7,10,39.0,478.0,277,10,17,27,175.0,82,6.05,85,480,2458,10.1,0.124561965
13259,13259,Jody Shelley,2007-08,31.0,7,2,72,72,1,1,2,32.0,350.0,349,11,18,29,207.0,82,5.76,70,398,2426,9.7,0.088383704
13260,13260,Jody Shelley,2008-09,32.0,8,7,62,62,1,6,7,41.0,364.0,411,12,24,36,248.0,82,5.44,62,351,2383,9.4,0.12190831
13261,13261,Jody Shelley,2009-10,33.0,9,4,70,70,2,2,4,44.0,433.0,481,14,26,40,292.0,82,5.7,65,341,2477,9.4,0.12659582
13262,13262,Jody Shelley,2010-11,34.0,10,9,57,57,2,7,9,49.0,386.0,538,16,33,49,341.0,82,5.53,56,304,2486,9.1,0.12787515
13263,13263,Jody Shelley,2011-12,35.0,11,4,58,58,2,2,4,31.0,359.0,596,18,35,53,372.0,82,5.46,52,291,2492,9.0,0.087171555
13264,13264,Jody Shelley,2012-13,36.0,12,1,30,30,0,1,1,19.0,170.0,626,18,36,54,391.0,82,5.32,47,271,2439,8.9,0.086847395
13265,13265,Jody Shelley,2013-14,37.0,13,0,1,1,0,0,0,0.0,8.0,627,18,36,54,391.0,48,5.31,29,160,1399,9.1,0.18445951
13266,13266,Joe Callahan,2009-10,27.0,2,2,18,18,0,2,2,6.0,270.0,18,0,2,2,6.0,82,5.7,65,341,2477,9.4,0.16988692
13267,13267,Joe Callahan,2010-11,28.0,3,1,1,1,0,1,1,0.0,10.0,19,0,3,3,6.0,82,5.53,56,304,2486,9.1,0.15677541
13268,13268,Joe Callahan,2011-12,29.0,4,1,27,27,0,1,1,21.0,429.0,46,0,4,4,27.0,82,5.46,52,291,2492,9.0,0.117999405
13269,13269,Joe Cirella,1982-83,19.0,2,19,65,65,7,12,19,71.0,,65,7,12,19,71.0,80,8.03,73,320,2489,12.9,0.36440304
13270,13270,Joe Cirella,1983-84,20.0,3,1,2,2,0,1,1,3.0,,67,7,13,20,74.0,80,7.73,71,310,2444,12.7,0.3598163
13271,13271,Joe Cirella,1984-85,21.0,4,44,79,79,11,33,44,158.0,,146,18,46,64,232.0,80,7.89,74,336,2448,12.9,0.5621161
13272,13272,Joe Cirella,1985-86,22.0,5,24,66,66,6,18,24,97.0,,212,24,64,88,329.0,80,7.77,71,321,2447,12.7,0.38229817
13273,13273,Joe Cirella,1986-87,23.0,6,29,66,66,6,23,29,89.0,,278,30,87,117,418.0,80,7.94,82,370,2484,12.8,0.42501402
13274,13274,Joe Cirella,1987-88,24.0,7,31,65,65,9,22,31,115.0,,343,39,109,148,533.0,80,7.34,72,344,2400,12.2,0.47646025
13275,13275,Joe Cirella,1988-89,25.0,8,39,80,80,8,31,39,135.0,,423,47,140,187,668.0,80,7.43,89,437,2435,12.2,0.4961692
13276,13276,Joe Cirella,1989-90,26.0,9,22,80,80,3,19,22,84.0,,503,50,159,209,752.0,80,7.48,85,403,2430,12.3,0.28429195
13277,13277,Joe Cirella,1990-91,27.0,10,18,56,56,4,14,18,76.0,,559,54,173,227,828.0,80,7.37,76,367,2421,12.2,0.31721067
13278,13278,Joe Cirella,1991-92,28.0,11,13,58,58,3,10,13,82.0,,617,57,183,240,910.0,80,6.91,71,366,2385,11.6,0.28244072
13279,13279,Joe Cirella,1992-93,29.0,12,15,67,67,3,12,15,58.0,,684,60,195,255,968.0,80,6.96,77,402,2440,11.4,0.2139985
13280,13280,Joe Cirella,1993-94,30.0,13,9,55,55,3,6,9,37.0,,739,63,201,264,1005.0,84,7.25,87,443,2603,11.7,0.17837289
13281,13281,Joe Cirella,1994-95,31.0,14,10,63,63,1,9,10,63.0,,802,64,210,274,1068.0,84,6.48,76,407,2545,10.7,0.15282235
13282,13282,Joe Cirella,1995-96,32.0,15,1,20,20,0,1,1,13.0,,822,64,211,275,1081.0,48,5.97,37,209,1408,10.2,0.12422818
13283,13283,Joe Cirella,1996-97,33.0,16,0,6,6,0,0,0,3.0,,828,64,211,275,1084.0,82,6.29,74,413,2481,10.4,0.14330027
13284,13284,Joe Colborne,2011-12,22.0,2,1,1,1,0,1,1,1.0,19.0,1,0,1,1,1.0,82,5.46,52,291,2492,9.0,0.19925651
13285,13285,Joe Colborne,2012-13,23.0,3,5,10,10,1,4,5,7.0,137.0,11,1,5,6,8.0,82,5.32,47,271,2439,8.9,0.21858004
13286,13286,Joe Colborne,2013-14,24.0,4,0,5,5,0,0,0,4.0,46.0,16,1,5,6,12.0,48,5.31,29,160,1399,9.1,0.17775589
13287,13287,Joe Colborne,2014-15,25.0,5,28,80,80,10,18,28,80.0,1141.0,96,11,23,34,92.0,82,5.34,48,269,2463,8.9,0.31692487
13288,13288,Joe Colborne,2015-16,26.0,6,28,64,64,8,20,28,67.0,987.0,160,19,43,62,159.0,82,5.32,47,251,2453,8.9,0.35574597
13289,13289,Joe Colborne,2016-17,27.0,7,44,73,73,19,25,44,100.0,1107.0,233,38,68,106,259.0,82,5.34,48,255,2438,9.0,0.49477696
13290,13290,Joe Colborne,2017-18,28.0,8,8,62,62,4,4,8,48.0,663.0,295,42,72,114,307.0,82,5.45,47,245,2478,9.0,0.18440041
13291,13291,Joe Corvo,2003-04,26.0,2,12,50,50,5,7,12,84.0,931.0,50,5,7,12,84.0,82,5.31,60,363,2326,9.4,0.26885548
13292,13292,Joe Corvo,2004-05,27.0,3,25,72,72,8,17,25,150.0,1522.0,122,13,24,37,234.0,82,5.14,57,348,2300,9.2,0.45647275
13293,13293,Joe Corvo,2006-07,29.0,4,40,81,81,14,26,40,190.0,1619.0,203,27,50,77,424.0,82,6.05,85,480,2458,10.1,0.49386773
13294,13294,Joe Corvo,2007-08,30.0,5,37,76,76,8,29,37,160.0,1373.0,279,35,79,114,584.0,82,5.76,70,398,2426,9.7,0.44930092
13295,13295,Joe Corvo,2008-09,31.0,6,48,74,74,13,35,48,167.0,1380.0,353,48,114,162,751.0,82,5.44,62,351,2383,9.4,0.57675654
13296,13296,Joe Corvo,2009-10,32.0,7,38,81,81,14,24,38,213.0,1970.0,434,62,138,200,964.0,82,5.7,65,341,2477,9.4,0.486698
13297,13297,Joe Corvo,2010-11,33.0,8,18,52,52,6,12,18,99.0,1212.0,486,68,150,218,1063.0,82,5.53,56,304,2486,9.1,0.4036055
13298,13298,Joe Corvo,2011-12,34.0,9,40,82,82,11,29,40,191.0,2032.0,568,79,179,258,1254.0,82,5.46,52,291,2492,9.0,0.4571085
13299,13299,Joe Corvo,2012-13,35.0,10,25,75,75,4,21,25,168.0,1411.0,643,83,200,283,1422.0,82,5.32,47,271,2439,8.9,0.31711686
13300,13300,Joe Corvo,2013-14,36.0,11,17,40,40,6,11,17,71.0,750.0,683,89,211,300,1493.0,48,5.31,29,160,1399,9.1,0.37098455
13301,13301,Joe Corvo,2014-15,37.0,12,10,25,25,3,7,10,54.0,438.0,708,92,218,310,1547.0,82,5.34,48,269,2463,8.9,0.27164018
13302,13302,Joe Day,1992-93,24.0,2,3,24,24,0,3,3,13.0,,24,0,3,3,13.0,80,6.96,77,402,2440,11.4,0.17000559
13303,13303,Joe Day,1993-94,25.0,3,8,24,24,1,7,8,10.0,,48,1,10,11,23.0,84,7.25,87,443,2603,11.7,0.16922063
13304,13304,Joe Day,1994-95,26.0,4,0,24,24,0,0,0,16.0,,72,1,10,11,39.0,84,6.48,76,407,2545,10.7,0.12926391
13305,13305,Joe DiPenta,2003-04,24.0,2,2,3,3,1,1,2,2.0,47.0,3,1,1,2,2.0,82,5.31,60,363,2326,9.4,0.21484086
13306,13306,Joe DiPenta,2006-07,27.0,3,8,72,72,2,6,8,27.0,973.0,75,3,7,10,29.0,82,6.05,85,480,2458,10.1,0.11865237
13307,13307,Joe DiPenta,2007-08,28.0,4,8,76,76,2,6,8,33.0,924.0,151,5,13,18,62.0,82,5.76,70,398,2426,9.7,0.12675345
13308,13308,Joe DiPenta,2008-09,29.0,5,5,23,23,1,4,5,5.0,245.0,174,6,17,23,67.0,82,5.44,62,351,2383,9.4,0.13047472
13309,13309,Joe Dziedzic,1996-97,25.0,2,10,69,69,5,5,10,44.0,,69,5,5,10,44.0,82,6.29,74,413,2481,10.4,0.1743823
13310,13310,Joe Dziedzic,1997-98,26.0,3,18,59,59,9,9,18,85.0,,128,14,14,28,129.0,82,5.83,55,336,2444,9.8,0.26822305
13311,13311,Joe Dziedzic,1999-00,28.0,4,0,2,2,0,0,0,1.0,16.0,130,14,14,28,130.0,82,5.27,57,359,2285,9.4,0.14234915
13312,13312,Joe Finley,2012-13,25.0,2,0,5,5,0,0,0,1.0,39.0,5,0,0,0,1.0,82,5.32,47,271,2439,8.9,0.15149242
13313,13313,Joe Finley,2013-14,26.0,3,1,16,16,0,1,1,2.0,191.0,21,0,1,1,3.0,48,5.31,29,160,1399,9.1,0.17688939
13314,13314,Joe Hicketts,2018-19,22.0,2,3,5,5,0,3,3,2.0,87.0,5,0,3,3,2.0,82,5.86,50,250,2620,9.2,0.2026797
13315,13315,Joe Hicketts,2019-20,23.0,3,0,11,11,0,0,0,16.0,204.0,16,0,3,3,18.0,82,5.96,47,239,2579,9.5,0.1779795
13316,13316,Joe Hicketts,2020-21,24.0,4,2,6,6,0,2,2,6.0,110.0,22,0,5,5,24.0,70,5.96,42,208,2192,9.5,0.20155033
13317,13317,Joe Hulbig,1997-98,24.0,2,0,6,6,0,0,0,4.0,,6,0,0,0,4.0,82,5.83,55,336,2444,9.8,0.16744861
13318,13318,Joe Hulbig,1998-99,25.0,3,4,17,17,2,2,4,8.0,,23,2,2,4,12.0,82,5.28,57,380,2242,9.6,0.20731145
13319,13319,Joe Hulbig,1999-00,26.0,4,0,1,1,0,0,0,2.0,8.0,24,2,2,4,14.0,82,5.27,57,359,2285,9.4,0.15820381
13320,13320,Joe Hulbig,2000-01,27.0,5,4,24,24,2,2,4,15.0,199.0,48,4,4,8,29.0,82,5.49,53,331,2294,9.8,0.14157856
13321,13321,Joe Hulbig,2001-02,28.0,6,0,7,7,0,0,0,0.0,38.0,55,4,4,8,29.0,82,5.51,63,376,2272,9.9,0.11550975
13322,13322,Joe Jensen,2008-09,25.0,2,1,6,6,1,0,1,6.0,39.0,6,1,0,1,6.0,82,5.44,62,351,2383,9.4,0.20200497
13323,13323,Joe Juneau,1992-93,25.0,2,19,14,14,5,14,19,38.0,,14,5,14,19,38.0,80,6.96,77,402,2440,11.4,0.8252554
13324,13324,Joe Juneau,1993-94,26.0,3,102,84,84,32,70,102,229.0,,98,37,84,121,267.0,84,7.25,87,443,2603,11.7,1.1192875
13325,13325,Joe Juneau,1994-95,27.0,4,85,74,74,19,66,85,164.0,,172,56,150,206,431.0,84,6.48,76,407,2545,10.7,0.984969
13326,13326,Joe Juneau,1995-96,28.0,5,43,44,44,5,38,43,70.0,,216,61,188,249,501.0,48,5.97,37,209,1408,10.2,0.8508899
13327,13327,Joe Juneau,1996-97,29.0,6,64,80,80,14,50,64,176.0,,296,75,238,313,677.0,82,6.29,74,413,2481,10.4,0.7062171
13328,13328,Joe Juneau,1997-98,30.0,7,42,58,58,15,27,42,124.0,,354,90,265,355,801.0,82,5.83,55,336,2444,9.8,0.6285696
13329,13329,Joe Juneau,1998-99,31.0,8,31,56,56,9,22,31,87.0,,410,99,287,386,888.0,82,5.28,57,380,2242,9.6,0.50571245
13330,13330,Joe Juneau,1999-00,32.0,9,43,72,72,15,28,43,150.0,1381.0,482,114,315,429,1038.0,82,5.27,57,359,2285,9.4,0.5671391
13331,13331,Joe Juneau,2000-01,33.0,10,37,65,65,13,24,37,126.0,1200.0,547,127,339,466,1164.0,82,5.49,53,331,2294,9.8,0.5104159
13332,13332,Joe Juneau,2001-02,34.0,11,33,69,69,10,23,33,100.0,1202.0,616,137,362,499,1264.0,82,5.51,63,376,2272,9.9,0.43453497
13333,13333,Joe Juneau,2002-03,35.0,12,36,70,70,8,28,36,96.0,1303.0,686,145,390,535,1360.0,82,5.24,53,338,2262,9.5,0.44964236
13334,13334,Joe Juneau,2003-04,36.0,13,22,72,72,6,16,22,88.0,1208.0,758,151,406,557,1448.0,82,5.31,60,363,2326,9.4,0.33403504
13335,13335,Joe Juneau,2004-05,37.0,14,15,70,70,5,10,15,76.0,1105.0,828,156,416,572,1524.0,82,5.14,57,348,2300,9.2,0.36990392
13336,13336,Joe Kocur,1985-86,21.0,2,1,17,17,1,0,1,7.0,,17,1,0,1,7.0,80,7.77,71,321,2447,12.7,0.24106386
13337,13337,Joe Kocur,1986-87,22.0,3,15,59,59,9,6,15,65.0,,76,10,6,16,72.0,80,7.94,82,370,2484,12.8,0.29061463
13338,13338,Joe Kocur,1987-88,23.0,4,18,77,77,9,9,18,81.0,,153,19,15,34,153.0,80,7.34,72,344,2400,12.2,0.3156526
13339,13339,Joe Kocur,1988-89,24.0,5,14,63,63,7,7,14,41.0,,216,26,22,48,194.0,80,7.43,89,437,2435,12.2,0.26446632
13340,13340,Joe Kocur,1989-90,25.0,6,18,60,60,9,9,18,76.0,,276,35,31,66,270.0,80,7.48,85,403,2430,12.3,0.32053977
13341,13341,Joe Kocur,1990-91,26.0,7,36,71,71,16,20,36,128.0,,347,51,51,102,398.0,80,7.37,76,367,2421,12.2,0.43846634
13342,13342,Joe Kocur,1991-92,27.0,8,9,57,57,5,4,9,73.0,,404,56,55,111,471.0,80,6.91,71,366,2385,11.6,0.23176381
13343,13343,Joe Kocur,1992-93,28.0,9,11,51,51,7,4,11,72.0,,455,63,59,122,543.0,80,6.96,77,402,2440,11.4,0.28390354
13344,13344,Joe Kocur,1993-94,29.0,10,9,65,65,3,6,9,43.0,,520,66,65,131,586.0,84,7.25,87,443,2603,11.7,0.17922777
13345,13345,Joe Kocur,1994-95,30.0,11,3,71,71,2,1,3,43.0,,591,68,66,134,629.0,84,6.48,76,407,2545,10.7,0.16417208
13346,13346,Joe Kocur,1995-96,31.0,12,3,48,48,1,2,3,25.0,,639,69,68,137,654.0,48,5.97,37,209,1408,10.2,0.15935436
13347,13347,Joe Kocur,1996-97,32.0,13,4,45,45,1,3,4,20.0,,684,70,71,141,674.0,82,6.29,74,413,2481,10.4,0.12714246
13348,13348,Joe Kocur,1997-98,33.0,14,3,34,34,2,1,3,38.0,,718,72,72,144,712.0,82,5.83,55,336,2444,9.8,0.17501575
13349,13349,Joe Kocur,1998-99,34.0,15,11,63,63,6,5,11,53.0,,781,78,77,155,765.0,82,5.28,57,380,2242,9.6,0.1379534
13350,13350,Joe Kocur,1999-00,35.0,16,7,39,39,2,5,7,20.0,263.0,820,80,82,162,785.0,82,5.27,57,359,2285,9.4,0.14588958
13351,13351,Joe McDonnell,1982-83,21.0,2,1,7,7,0,1,1,6.0,,7,0,1,1,6.0,80,8.03,73,320,2489,12.9,0.28867698
13352,13352,Joe McDonnell,1985-86,24.0,3,11,40,40,2,9,11,75.0,,47,2,10,12,81.0,80,7.77,71,321,2447,12.7,0.3061136
13353,13353,Joe McDonnell,1986-87,25.0,4,0,3,3,0,0,0,1.0,,50,2,10,12,82.0,80,7.94,82,370,2484,12.8,0.20396441
13354,13354,Joe Micheletti,1980-81,26.0,2,18,54,54,2,16,18,68.0,,54,2,16,18,68.0,80,7.03,61,280,2352,12.0,0.34490564
13355,13355,Joe Micheletti,1981-82,27.0,3,31,63,63,4,27,31,102.0,,117,6,43,49,170.0,80,7.69,77,340,2441,12.6,0.47576275
13356,13356,Joe Micheletti,1982-83,28.0,4,22,41,41,5,17,22,71.0,,158,11,60,71,241.0,80,8.03,73,320,2489,12.9,0.4161395
13357,13357,Joe Motzko,2004-05,24.0,2,0,2,2,0,0,0,1.0,15.0,2,0,0,0,1.0,82,5.14,57,348,2300,9.2,0.19970238
13358,13358,Joe Motzko,2006-07,26.0,3,0,2,2,0,0,0,3.0,21.0,4,0,0,0,4.0,82,6.05,85,480,2458,10.1,0.16136006
13359,13359,Joe Motzko,2007-08,27.0,4,1,7,7,1,0,1,10.0,45.0,11,1,0,1,14.0,82,5.76,70,398,2426,9.7,0.20093432
13360,13360,Joe Motzko,2008-09,28.0,5,4,8,8,2,2,4,10.0,100.0,19,3,2,5,24.0,82,5.44,62,351,2383,9.4,0.20940292
13361,13361,Joe Motzko,2009-10,29.0,6,1,6,6,1,0,1,8.0,70.0,25,4,2,6,32.0,82,5.7,65,341,2477,9.4,0.15804198
13362,13362,Joe Mullen,1982-83,25.0,2,59,45,45,25,34,59,141.0,,45,25,34,59,141.0,80,8.03,73,320,2489,12.9,0.9875697
13363,13363,Joe Mullen,1983-84,26.0,3,47,49,49,17,30,47,128.0,,94,42,64,106,269.0,80,7.73,71,310,2444,12.7,0.8663184
13364,13364,Joe Mullen,1984-85,27.0,4,85,80,80,41,44,85,228.0,,174,83,108,191,497.0,80,7.89,74,336,2448,12.9,1.0520504
13365,13365,Joe Mullen,1985-86,28.0,5,92,79,79,40,52,92,253.0,,253,123,160,283,750.0,80,7.77,71,321,2447,12.7,1.0961804
13366,13366,Joe Mullen,1986-87,29.0,6,90,77,77,44,46,90,202.0,,330,167,206,373,952.0,80,7.94,82,370,2484,12.8,1.0210636
13367,13367,Joe Mullen,1987-88,30.0,7,87,79,79,47,40,87,206.0,,409,214,246,460,1158.0,80,7.34,72,344,2400,12.2,1.0477433
13368,13368,Joe Mullen,1988-89,31.0,8,84,80,80,40,44,84,205.0,,489,254,290,544,1363.0,80,7.43,89,437,2435,12.2,1.0719984
13369,13369,Joe Mullen,1989-90,32.0,9,110,79,79,51,59,110,270.0,,568,305,349,654,1633.0,80,7.48,85,403,2430,12.3,1.0958209
13370,13370,Joe Mullen,1990-91,33.0,10,69,78,78,36,33,69,236.0,,646,341,382,723,1869.0,80,7.37,76,367,2421,12.2,0.7754422
13371,13371,Joe Mullen,1991-92,34.0,11,39,47,47,17,22,39,85.0,,693,358,404,762,1954.0,80,6.91,71,366,2385,11.6,0.7554488
13372,13372,Joe Mullen,1992-93,35.0,12,87,77,77,42,45,87,226.0,,770,400,449,849,2180.0,80,6.96,77,402,2440,11.4,1.0849237
13373,13373,Joe Mullen,1993-94,36.0,13,70,72,72,33,37,70,175.0,,842,433,486,919,2355.0,84,7.25,87,443,2603,11.7,0.7590416
13374,13374,Joe Mullen,1994-95,37.0,14,70,84,84,38,32,70,231.0,,926,471,518,989,2586.0,84,6.48,76,407,2545,10.7,0.7487931
13375,13375,Joe Mullen,1995-96,38.0,15,37,45,45,16,21,37,78.0,,971,487,539,1026,2664.0,48,5.97,37,209,1408,10.2,0.6382767
13376,13376,Joe Mullen,1996-97,39.0,16,15,37,37,8,7,15,60.0,,1008,495,546,1041,2724.0,82,6.29,74,413,2481,10.4,0.41730794
13377,13377,Joe Mullen,1997-98,40.0,17,22,54,54,7,15,22,63.0,,1062,502,561,1063,2787.0,82,5.83,55,336,2444,9.8,0.40092355
13378,13378,Joe Murphy,1987-88,20.0,2,1,5,5,0,1,1,3.0,,5,0,1,1,3.0,80,7.34,72,344,2400,12.2,0.29313868
13379,13379,Joe Murphy,1988-89,21.0,3,19,50,50,10,9,19,82.0,,55,10,10,20,85.0,80,7.43,89,437,2435,12.2,0.43865547
13380,13380,Joe Murphy,1989-90,22.0,4,8,26,26,1,7,8,29.0,,81,11,17,28,114.0,80,7.48,85,403,2430,12.3,0.34803846
13381,13381,Joe Murphy,1990-91,23.0,5,29,71,71,10,19,29,117.0,,152,21,36,57,231.0,80,7.37,76,367,2421,12.2,0.41297084
13382,13382,Joe Murphy,1991-92,24.0,6,62,80,80,27,35,62,141.0,,232,48,71,119,372.0,80,6.91,71,366,2385,11.6,0.77967924
13383,13383,Joe Murphy,1992-93,25.0,7,82,80,80,35,47,82,193.0,,312,83,118,201,565.0,80,6.96,77,402,2440,11.4,0.9408928
13384,13384,Joe Murphy,1993-94,26.0,8,17,19,19,7,10,17,43.0,,331,90,128,218,608.0,84,7.25,87,443,2603,11.7,0.68063974
13385,13385,Joe Murphy,1994-95,27.0,9,70,81,81,31,39,70,222.0,,412,121,167,288,830.0,84,6.48,76,407,2545,10.7,0.7251255
13386,13386,Joe Murphy,1995-96,28.0,10,41,40,40,23,18,41,120.0,,452,144,185,329,950.0,48,5.97,37,209,1408,10.2,0.78742486
13387,13387,Joe Murphy,1996-97,29.0,11,51,70,70,22,29,51,212.0,,522,166,214,380,1162.0,82,6.29,74,413,2481,10.4,0.6686164
13388,13388,Joe Murphy,1997-98,30.0,12,45,75,75,20,25,45,151.0,,597,186,239,425,1313.0,82,5.83,55,336,2444,9.8,0.53330314
13389,13389,Joe Murphy,1998-99,31.0,13,22,37,37,9,13,22,81.0,,634,195,252,447,1394.0,82,5.28,57,380,2242,9.6,0.48614657
13390,13390,Joe Murphy,1999-00,32.0,14,48,76,76,25,23,48,176.0,1121.0,710,220,275,495,1570.0,82,5.27,57,359,2285,9.4,0.5455534
13391,13391,Joe Murphy,2000-01,33.0,15,27,55,55,12,15,27,118.0,815.0,765,232,290,522,1688.0,82,5.49,53,331,2294,9.8,0.48060435
13392,13392,Joe Murphy,2001-02,34.0,16,6,14,14,1,5,6,22.0,175.0,779,233,295,528,1710.0,82,5.51,63,376,2272,9.9,0.37682134
13393,13393,Joe Nieuwendyk,1987-88,21.0,2,6,9,9,5,1,6,16.0,,9,5,1,6,16.0,80,7.34,72,344,2400,12.2,0.47569576
13394,13394,Joe Nieuwendyk,1988-89,22.0,3,92,75,75,51,41,92,212.0,,84,56,42,98,228.0,80,7.43,89,437,2435,12.2,1.0719357
13395,13395,Joe Nieuwendyk,1989-90,23.0,4,82,77,77,51,31,82,215.0,,161,107,73,180,443.0,80,7.48,85,403,2430,12.3,0.9851619
13396,13396,Joe Nieuwendyk,1990-91,24.0,5,95,79,79,45,50,95,226.0,,240,152,123,275,669.0,80,7.37,76,367,2421,12.2,1.0646703
13397,13397,Joe Nieuwendyk,1991-92,25.0,6,85,79,79,45,40,85,222.0,,319,197,163,360,891.0,80,6.91,71,366,2385,11.6,1.0502294
13398,13398,Joe Nieuwendyk,1992-93,26.0,7,56,69,69,22,34,56,137.0,,388,219,197,416,1028.0,80,6.96,77,402,2440,11.4,0.87837267
13399,13399,Joe Nieuwendyk,1993-94,27.0,8,75,79,79,38,37,75,208.0,,467,257,234,491,1236.0,84,7.25,87,443,2603,11.7,0.8471993
13400,13400,Joe Nieuwendyk,1994-95,28.0,9,75,64,64,36,39,75,191.0,,531,293,273,566,1427.0,84,6.48,76,407,2545,10.7,1.0826558
13401,13401,Joe Nieuwendyk,1995-96,29.0,10,50,46,46,21,29,50,122.0,,577,314,302,616,1549.0,48,5.97,37,209,1408,10.2,0.9623872
13402,13402,Joe Nieuwendyk,1996-97,30.0,11,32,52,52,14,18,32,138.0,,629,328,320,648,1687.0,82,6.29,74,413,2481,10.4,0.68679935
13403,13403,Joe Nieuwendyk,1997-98,31.0,12,51,66,66,30,21,51,173.0,,695,358,341,699,1860.0,82,5.83,55,336,2444,9.8,0.7234023
13404,13404,Joe Nieuwendyk,1998-99,32.0,13,69,73,73,39,30,69,203.0,,768,397,371,768,2063.0,82,5.28,57,380,2242,9.6,0.8058493
13405,13405,Joe Nieuwendyk,1999-00,33.0,14,55,67,67,28,27,55,157.0,1042.0,835,425,398,823,2220.0,82,5.27,57,359,2285,9.4,0.7229946
13406,13406,Joe Nieuwendyk,2000-01,34.0,15,34,48,48,15,19,34,110.0,780.0,883,440,417,857,2330.0,82,5.49,53,331,2294,9.8,0.586627
13407,13407,Joe Nieuwendyk,2001-02,35.0,16,52,69,69,29,23,52,166.0,1116.0,952,469,440,909,2496.0,82,5.51,63,376,2272,9.9,0.6212446
13408,13408,Joe Nieuwendyk,2002-03,36.0,17,58,81,81,25,33,58,189.0,1367.0,1033,494,473,967,2685.0,82,5.24,53,338,2262,9.5,0.6161823
13409,13409,Joe Nieuwendyk,2003-04,37.0,18,45,80,80,17,28,45,201.0,1340.0,1113,511,501,1012,2886.0,82,5.31,60,363,2326,9.4,0.58175313
13410,13410,Joe Nieuwendyk,2004-05,38.0,19,50,64,64,22,28,50,131.0,1001.0,1177,533,529,1062,3017.0,82,5.14,57,348,2300,9.2,0.76401854
13411,13411,Joe Nieuwendyk,2006-07,40.0,20,56,65,65,26,30,56,195.0,1065.0,1242,559,559,1118,3212.0,82,6.05,85,480,2458,10.1,0.7289983
13412,13412,Joe Nieuwendyk,2007-08,41.0,21,8,15,15,5,3,8,30.0,201.0,1257,564,562,1126,3242.0,82,5.76,70,398,2426,9.7,0.46554622
13413,13413,Joe Paterson,1981-82,21.0,2,7,38,38,2,5,7,36.0,,38,2,5,7,36.0,80,7.69,77,340,2441,12.6,0.28708056
13414,13414,Joe Paterson,1982-83,22.0,3,0,3,3,0,0,0,1.0,,41,2,5,7,37.0,80,8.03,73,320,2489,12.9,0.20836666
13415,13415,Joe Paterson,1983-84,23.0,4,3,33,33,2,1,3,18.0,,74,4,6,10,55.0,80,7.73,71,310,2444,12.7,0.24062973
13416,13416,Joe Paterson,1984-85,24.0,5,7,41,41,2,5,7,26.0,,115,6,11,17,81.0,80,7.89,74,336,2448,12.9,0.19553897
13417,13417,Joe Paterson,1985-86,25.0,6,0,6,6,0,0,0,4.0,,121,6,11,17,85.0,80,7.77,71,321,2447,12.7,0.18331891
13418,13418,Joe Paterson,1986-87,26.0,7,27,52,52,9,18,27,79.0,,173,15,29,44,164.0,80,7.94,82,370,2484,12.8,0.3759026
13419,13419,Joe Paterson,1987-88,27.0,8,3,45,45,2,1,3,30.0,,218,17,30,47,194.0,80,7.34,72,344,2400,12.2,0.16351986
13420,13420,Joe Paterson,1988-89,28.0,9,8,53,53,2,6,8,29.0,,271,19,36,55,223.0,80,7.43,89,437,2435,12.2,0.17175755
13421,13421,Joe Paterson,1989-90,29.0,10,1,20,20,0,1,1,8.0,,291,19,37,56,231.0,80,7.48,85,403,2430,12.3,0.14124426
13422,13422,Joe Pavelski,2007-08,23.0,2,28,46,46,14,14,28,111.0,691.0,46,14,14,28,111.0,82,5.76,70,398,2426,9.7,0.51914483
13423,13423,Joe Pavelski,2008-09,24.0,3,40,82,82,19,21,40,207.0,1157.0,128,33,35,68,318.0,82,5.44,62,351,2383,9.4,0.56961626
13424,13424,Joe Pavelski,2009-10,25.0,4,59,80,80,25,34,59,266.0,1517.0,208,58,69,127,584.0,82,5.7,65,341,2477,9.4,0.705715
13425,13425,Joe Pavelski,2010-11,26.0,5,51,67,67,25,26,51,228.0,1305.0,275,83,95,178,812.0,82,5.53,56,304,2486,9.1,0.7156623
13426,13426,Joe Pavelski,2011-12,27.0,6,66,74,74,20,46,66,282.0,1454.0,349,103,141,244,1094.0,82,5.46,52,291,2492,9.0,0.7756369
13427,13427,Joe Pavelski,2012-13,28.0,7,61,82,82,31,30,61,269.0,1690.0,431,134,171,305,1363.0,82,5.32,47,271,2439,8.9,0.7129975
13428,13428,Joe Pavelski,2013-14,29.0,8,31,48,48,16,15,31,130.0,908.0,479,150,186,336,1493.0,48,5.31,29,160,1399,9.1,0.6941446
13429,13429,Joe Pavelski,2014-15,30.0,9,79,82,82,41,38,79,225.0,1628.0,561,191,224,415,1718.0,82,5.34,48,269,2463,8.9,0.86545783
13430,13430,Joe Pavelski,2015-16,31.0,10,70,82,82,37,33,70,261.0,1650.0,643,228,257,485,1979.0,82,5.32,47,251,2453,8.9,0.7874353
13431,13431,Joe Pavelski,2016-17,32.0,11,78,82,82,38,40,78,224.0,1625.0,725,266,297,563,2203.0,82,5.34,48,255,2438,9.0,0.8528181
13432,13432,Joe Pavelski,2017-18,33.0,12,68,81,81,29,39,68,233.0,1549.0,806,295,336,631,2436.0,82,5.45,47,245,2478,9.0,0.7812028
13433,13433,Joe Pavelski,2018-19,34.0,13,66,82,82,22,44,66,224.0,1579.0,888,317,380,697,2660.0,82,5.86,50,250,2620,9.2,0.73850137
13434,13434,Joe Pavelski,2019-20,35.0,14,64,75,75,38,26,64,188.0,1428.0,963,355,406,761,2848.0,82,5.96,47,239,2579,9.5,0.65708613
13435,13435,Joe Pavelski,2020-21,36.0,15,31,67,67,14,17,31,125.0,1134.0,1030,369,423,792,2973.0,70,5.96,42,208,2192,9.5,0.3901739
13436,13436,Joe Piskula,2007-08,23.0,2,0,5,5,0,0,0,4.0,50.0,5,0,0,0,4.0,82,5.76,70,398,2426,9.7,0.17841864
13437,13437,Joe Piskula,2012-13,28.0,3,0,5,5,0,0,0,2.0,54.0,10,0,0,0,6.0,82,5.32,47,271,2439,8.9,0.15216881
13438,13438,Joe Piskula,2014-15,30.0,4,0,2,2,0,0,0,2.0,24.0,12,0,0,0,8.0,82,5.34,48,269,2463,8.9,0.1480507
13439,13439,Joe Piskula,2015-16,31.0,5,0,1,1,0,0,0,0.0,16.0,13,0,0,0,8.0,82,5.32,47,251,2453,8.9,0.12933385
13440,13440,Joe Reekie,1986-87,21.0,2,0,3,3,0,0,0,1.0,,3,0,0,0,1.0,80,7.94,82,370,2484,12.8,0.22879618
13441,13441,Joe Reekie,1987-88,22.0,3,9,56,56,1,8,9,56.0,,59,1,8,9,57.0,80,7.34,72,344,2400,12.2,0.21449277
13442,13442,Joe Reekie,1988-89,23.0,4,5,30,30,1,4,5,23.0,,89,2,12,14,80.0,80,7.43,89,437,2435,12.2,0.22883347
13443,13443,Joe Reekie,1989-90,24.0,5,4,15,15,1,3,4,14.0,,104,3,15,18,94.0,80,7.48,85,403,2430,12.3,0.25374812
13444,13444,Joe Reekie,1990-91,25.0,6,9,31,31,1,8,9,22.0,,135,4,23,27,116.0,80,7.37,76,367,2421,12.2,0.1937927
13445,13445,Joe Reekie,1991-92,26.0,7,19,66,66,3,16,19,70.0,,201,7,39,46,186.0,80,6.91,71,366,2385,11.6,0.2540105
13446,13446,Joe Reekie,1992-93,27.0,8,16,54,54,4,12,16,59.0,,255,11,51,62,245.0,80,6.96,77,402,2440,11.4,0.27998966
13447,13447,Joe Reekie,1993-94,28.0,9,13,42,42,2,11,13,53.0,,297,13,62,75,298.0,84,7.25,87,443,2603,11.7,0.20858619
13448,13448,Joe Reekie,1994-95,29.0,10,17,85,85,1,16,17,98.0,,382,14,78,92,396.0,84,6.48,76,407,2545,10.7,0.20598507
13449,13449,Joe Reekie,1995-96,30.0,11,7,48,48,1,6,7,52.0,,430,15,84,99,448.0,48,5.97,37,209,1408,10.2,0.16641694
13450,13450,Joe Reekie,1996-97,31.0,12,10,78,78,3,7,10,52.0,,508,18,91,109,500.0,82,6.29,74,413,2481,10.4,0.13644159
13451,13451,Joe Reekie,1997-98,32.0,13,9,65,65,1,8,9,65.0,,573,19,99,118,565.0,82,5.83,55,336,2444,9.8,0.13321787
13452,13452,Joe Reekie,1998-99,33.0,14,10,68,68,2,8,10,59.0,,641,21,107,128,624.0,82,5.28,57,380,2242,9.6,0.14139175
13453,13453,Joe Reekie,1999-00,34.0,15,10,73,73,0,10,10,81.0,1597.0,714,21,117,138,705.0,82,5.27,57,359,2285,9.4,0.13415626
13454,13454,Joe Reekie,2000-01,35.0,16,7,59,59,0,7,7,32.0,1034.0,773,21,124,145,737.0,82,5.49,53,331,2294,9.8,0.0919857
13455,13455,Joe Reekie,2001-02,36.0,17,11,74,74,2,9,11,59.0,1392.0,847,23,133,156,796.0,82,5.51,63,376,2272,9.9,0.12933972
13456,13456,Joe Reekie,2002-03,37.0,18,8,55,55,2,6,8,33.0,812.0,902,25,139,164,829.0,82,5.24,53,338,2262,9.5,0.11228365
13457,13457,Joe Sacco,1991-92,22.0,2,5,20,20,0,5,5,20.0,,20,0,5,5,20.0,80,6.91,71,366,2385,11.6,0.23044857
13458,13458,Joe Sacco,1992-93,23.0,3,11,17,17,7,4,11,40.0,,37,7,9,16,60.0,80,6.96,77,402,2440,11.4,0.44956782
13459,13459,Joe Sacco,1993-94,24.0,4,8,23,23,4,4,8,38.0,,60,11,13,24,98.0,84,7.25,87,443,2603,11.7,0.340763
13460,13460,Joe Sacco,1994-95,25.0,5,37,84,84,19,18,37,206.0,,144,30,31,61,304.0,84,6.48,76,407,2545,10.7,0.47121271
13461,13461,Joe Sacco,1995-96,26.0,6,18,41,41,10,8,18,77.0,,185,40,39,79,381.0,48,5.97,37,209,1408,10.2,0.4219811
13462,13462,Joe Sacco,1996-97,27.0,7,27,76,76,13,14,27,132.0,,261,53,53,106,513.0,82,6.29,74,413,2481,10.4,0.34590974
13463,13463,Joe Sacco,1997-98,28.0,8,29,77,77,12,17,29,131.0,,338,65,70,135,644.0,82,5.83,55,336,2444,9.8,0.3401111
13464,13464,Joe Sacco,1998-99,29.0,9,25,80,80,11,14,25,122.0,,418,76,84,160,766.0,82,5.28,57,380,2242,9.6,0.30769414
13465,13465,Joe Sacco,1999-00,30.0,10,3,73,73,3,0,3,84.0,729.0,491,79,84,163,850.0,82,5.27,57,359,2285,9.4,0.23587555
13466,13466,Joe Sacco,2000-01,31.0,11,23,79,79,7,16,23,117.0,936.0,570,86,100,186,967.0,82,5.49,53,331,2294,9.8,0.2654986
13467,13467,Joe Sacco,2001-02,32.0,12,14,69,69,7,7,14,81.0,770.0,639,93,107,200,1048.0,82,5.51,63,376,2272,9.9,0.19846466
13468,13468,Joe Sacco,2002-03,33.0,13,7,65,65,0,7,7,57.0,496.0,704,93,114,207,1105.0,82,5.24,53,338,2262,9.5,0.16239122
13469,13469,Joe Sacco,2003-04,34.0,14,6,34,34,1,5,6,48.0,424.0,738,94,119,213,1153.0,82,5.31,60,363,2326,9.4,0.19600222
13470,13470,Joe Sakic,1989-90,20.0,2,62,70,70,23,39,62,148.0,,70,23,39,62,148.0,80,7.48,85,403,2430,12.3,0.9319791
13471,13471,Joe Sakic,1990-91,21.0,3,102,80,80,39,63,102,234.0,,150,62,102,164,382.0,80,7.37,76,367,2421,12.2,1.263005
13472,13472,Joe Sakic,1991-92,22.0,4,109,80,80,48,61,109,245.0,,230,110,163,273,627.0,80,6.91,71,366,2385,11.6,1.3077503
13473,13473,Joe Sakic,1992-93,23.0,5,94,69,69,29,65,94,217.0,,299,139,228,367,844.0,80,6.96,77,402,2440,11.4,1.3334444
13474,13474,Joe Sakic,1993-94,24.0,6,105,78,78,48,57,105,264.0,,377,187,285,472,1108.0,84,7.25,87,443,2603,11.7,1.2183135
13475,13475,Joe Sakic,1994-95,25.0,7,92,84,84,28,64,92,279.0,,461,215,349,564,1387.0,84,6.48,76,407,2545,10.7,1.0210644
13476,13476,Joe Sakic,1995-96,26.0,8,62,47,47,19,43,62,157.0,,508,234,392,626,1544.0,48,5.97,37,209,1408,10.2,1.3829459
13477,13477,Joe Sakic,1996-97,27.0,9,120,82,82,51,69,120,339.0,,590,285,461,746,1883.0,82,6.29,74,413,2481,10.4,1.1693274
13478,13478,Joe Sakic,1997-98,28.0,10,74,65,65,22,52,74,261.0,,655,307,513,820,2144.0,82,5.83,55,336,2444,9.8,1.0872324
13479,13479,Joe Sakic,1998-99,29.0,11,63,64,64,27,36,63,254.0,,719,334,549,883,2398.0,82,5.28,57,380,2242,9.6,1.1077701
13480,13480,Joe Sakic,1999-00,30.0,12,96,73,73,41,55,96,255.0,1868.0,792,375,604,979,2653.0,82,5.27,57,359,2285,9.4,1.1884019
13481,13481,Joe Sakic,2000-01,31.0,13,81,60,60,28,53,81,242.0,1396.0,852,403,657,1060,2895.0,82,5.49,53,331,2294,9.8,1.2817452
13482,13482,Joe Sakic,2001-02,32.0,14,118,82,82,54,64,118,332.0,1887.0,934,457,721,1178,3227.0,82,5.51,63,376,2272,9.9,1.1098727
13483,13483,Joe Sakic,2002-03,33.0,15,79,82,82,26,53,79,260.0,1805.0,1016,483,774,1257,3487.0,82,5.24,53,338,2262,9.5,0.98880523
13484,13484,Joe Sakic,2003-04,34.0,16,58,58,58,26,32,58,190.0,1230.0,1074,509,806,1315,3677.0,82,5.31,60,363,2326,9.4,1.0007823
13485,13485,Joe Sakic,2004-05,35.0,17,87,81,81,33,54,87,253.0,1641.0,1155,542,860,1402,3930.0,82,5.14,57,348,2300,9.2,1.012013
13486,13486,Joe Sakic,2006-07,37.0,18,87,82,82,32,55,87,263.0,1633.0,1237,574,915,1489,4193.0,82,6.05,85,480,2458,10.1,0.95879775
13487,13487,Joe Sakic,2007-08,38.0,19,100,82,82,36,64,100,258.0,1655.0,1319,610,979,1589,4451.0,82,5.76,70,398,2426,9.7,0.980632
13488,13488,Joe Sakic,2008-09,39.0,20,40,44,44,13,27,40,124.0,879.0,1363,623,1006,1629,4575.0,82,5.44,62,351,2383,9.4,0.7328423
13489,13489,Joe Sakic,2009-10,40.0,21,12,15,15,2,10,12,46.0,272.0,1378,625,1016,1641,4621.0,82,5.7,65,341,2477,9.4,0.48598242
13490,13490,Joe Thornton,1998-99,19.0,2,7,55,55,3,4,7,33.0,,55,3,4,7,33.0,82,5.28,57,380,2242,9.6,0.24229428
13491,13491,Joe Thornton,1999-00,20.0,3,41,81,81,16,25,41,128.0,1243.0,136,19,29,48,161.0,82,5.27,57,359,2285,9.4,0.5560447
13492,13492,Joe Thornton,2000-01,21.0,4,60,81,81,23,37,60,171.0,1725.0,217,42,66,108,332.0,82,5.49,53,331,2294,9.8,0.75138104
13493,13493,Joe Thornton,2001-02,22.0,5,71,72,72,37,34,71,181.0,1566.0,289,79,100,179,513.0,82,5.51,63,376,2272,9.9,0.8996296
13494,13494,Joe Thornton,2002-03,23.0,6,68,66,66,22,46,68,152.0,1319.0,355,101,146,247,665.0,82,5.24,53,338,2262,9.5,0.97283876
13495,13495,Joe Thornton,2003-04,24.0,7,101,77,77,36,65,101,196.0,1736.0,432,137,211,348,861.0,82,5.31,60,363,2326,9.4,1.0797472
13496,13496,Joe Thornton,2004-05,25.0,8,73,77,77,23,50,73,187.0,1666.0,509,160,261,421,1048.0,82,5.14,57,348,2300,9.2,1.0419414
13497,13497,Joe Thornton,2006-07,27.0,9,125,81,81,29,96,125,195.0,1728.0,590,189,357,546,1243.0,82,6.05,85,480,2458,10.1,1.2782776
13498,13498,Joe Thornton,2007-08,28.0,10,114,82,82,22,92,114,213.0,1666.0,672,211,449,660,1456.0,82,5.76,70,398,2426,9.7,1.1550816
13499,13499,Joe Thornton,2008-09,29.0,11,96,82,82,29,67,96,178.0,1754.0,754,240,516,756,1634.0,82,5.44,62,351,2383,9.4,1.034627
13500,13500,Joe Thornton,2009-10,30.0,12,86,82,82,25,61,86,139.0,1596.0,836,265,577,842,1773.0,82,5.7,65,341,2477,9.4,0.9803381
13501,13501,Joe Thornton,2010-11,31.0,13,89,79,79,20,69,89,141.0,1569.0,915,285,646,931,1914.0,82,5.53,56,304,2486,9.1,0.9488373
13502,13502,Joe Thornton,2011-12,32.0,14,70,80,80,21,49,70,149.0,1590.0,995,306,695,1001,2063.0,82,5.46,52,291,2492,9.0,0.8513515
13503,13503,Joe Thornton,2012-13,33.0,15,77,82,82,18,59,77,156.0,1678.0,1077,324,754,1078,2219.0,82,5.32,47,271,2439,8.9,0.88564587
13504,13504,Joe Thornton,2013-14,34.0,16,40,48,48,7,33,40,85.0,882.0,1125,331,787,1118,2304.0,48,5.31,29,160,1399,9.1,0.79798424
13505,13505,Joe Thornton,2014-15,35.0,17,76,82,82,11,65,76,122.0,1552.0,1207,342,852,1194,2426.0,82,5.34,48,269,2463,8.9,0.7657081
13506,13506,Joe Thornton,2015-16,36.0,18,65,78,78,16,49,65,131.0,1437.0,1285,358,901,1259,2557.0,82,5.32,47,251,2453,8.9,0.7836236
13507,13507,Joe Thornton,2016-17,37.0,19,82,82,82,19,63,82,121.0,1506.0,1367,377,964,1341,2678.0,82,5.34,48,255,2438,9.0,0.71155256
13508,13508,Joe Thornton,2017-18,38.0,20,50,79,79,7,43,50,81.0,1427.0,1446,384,1007,1391,2759.0,82,5.45,47,245,2478,9.0,0.57079834
13509,13509,Joe Thornton,2018-19,39.0,21,36,47,47,13,23,36,75.0,862.0,1493,397,1030,1427,2834.0,82,5.86,50,250,2620,9.2,0.5704151
13510,13510,Joe Thornton,2019-20,40.0,22,51,73,73,16,35,51,90.0,1135.0,1566,413,1065,1478,2924.0,82,5.96,47,239,2579,9.5,0.60103023
13511,13511,Joe Thornton,2020-21,41.0,23,31,70,70,7,24,31,76.0,1085.0,1636,420,1089,1509,3000.0,70,5.96,42,208,2192,9.5,0.4506156
13512,13512,Joe Vitale,2011-12,26.0,2,2,9,9,1,1,2,13.0,95.0,9,1,1,2,13.0,82,5.46,52,291,2492,9.0,0.20421943
13513,13513,Joe Vitale,2012-13,27.0,3,14,68,68,4,10,14,70.0,760.0,77,5,11,16,83.0,82,5.32,47,271,2439,8.9,0.18595612
13514,13514,Joe Vitale,2013-14,28.0,4,5,33,33,2,3,5,26.0,314.0,110,7,14,21,109.0,48,5.31,29,160,1399,9.1,0.22780585
13515,13515,Joe Vitale,2014-15,29.0,5,14,53,53,1,13,14,42.0,582.0,163,8,27,35,151.0,82,5.34,48,269,2463,8.9,0.16564536
13516,13516,Joe Vitale,2015-16,30.0,6,9,70,70,3,6,9,55.0,786.0,233,11,33,44,206.0,82,5.32,47,251,2453,8.9,0.14102703
13517,13517,Joe Vitale,2016-17,31.0,7,0,1,1,0,0,0,1.0,6.0,234,11,33,44,207.0,82,5.34,48,255,2438,9.0,0.15838632
13518,13518,Joe Ward,1981-82,20.0,2,0,4,4,0,0,0,2.0,,4,0,0,0,2.0,80,7.69,77,340,2441,12.6,0.2872134
13519,13519,Joe Whitney,2014-15,26.0,2,0,1,1,0,0,0,0.0,8.0,1,0,0,0,0.0,82,5.34,48,269,2463,8.9,0.1332545
13520,13520,Joe Whitney,2015-16,27.0,3,1,4,4,1,0,1,1.0,28.0,5,1,0,1,1.0,82,5.32,47,251,2453,8.9,0.20310655
13521,13521,Joel Armia,2015-16,22.0,2,0,1,1,0,0,0,0.0,15.0,1,0,0,0,0.0,82,5.32,47,251,2453,8.9,0.14922687
13522,13522,Joel Armia,2016-17,23.0,3,10,43,43,4,6,10,52.0,523.0,44,4,6,10,52.0,82,5.34,48,255,2438,9.0,0.24674523
13523,13523,Joel Armia,2017-18,24.0,4,19,57,57,10,9,19,111.0,863.0,101,14,15,29,163.0,82,5.45,47,245,2478,9.0,0.32489076
13524,13524,Joel Armia,2018-19,25.0,5,29,79,79,12,17,29,128.0,996.0,180,26,32,58,291.0,82,5.86,50,250,2620,9.2,0.34251213
13525,13525,Joel Armia,2019-20,26.0,6,23,57,57,13,10,23,134.0,900.0,237,39,42,81,425.0,82,5.96,47,239,2579,9.5,0.41243052
13526,13526,Joel Armia,2020-21,27.0,7,30,58,58,16,14,30,155.0,999.0,295,55,56,111,580.0,70,5.96,42,208,2192,9.5,0.49662334
13527,13527,Joel Baillargeon,1987-88,23.0,2,1,11,11,0,1,1,1.0,,11,0,1,1,1.0,80,7.34,72,344,2400,12.2,0.23237562
13528,13528,Joel Baillargeon,1988-89,24.0,3,1,4,4,0,1,1,3.0,,15,0,2,2,4.0,80,7.43,89,437,2435,12.2,0.21263042
13529,13529,Joel Baillargeon,1989-90,25.0,4,0,5,5,0,0,0,2.0,,20,0,2,2,6.0,80,7.48,85,403,2430,12.3,0.18780655
13530,13530,Joel Bouchard,1995-96,22.0,2,0,2,2,0,0,0,0.0,,2,0,0,0,0.0,48,5.97,37,209,1408,10.2,0.18721476
13531,13531,Joel Bouchard,1996-97,23.0,3,0,4,4,0,0,0,0.0,,6,0,0,0,0.0,82,6.29,74,413,2481,10.4,0.14796212
13532,13532,Joel Bouchard,1997-98,24.0,4,9,76,76,4,5,9,61.0,,82,4,5,9,61.0,82,5.83,55,336,2444,9.8,0.16939586
13533,13533,Joel Bouchard,1998-99,25.0,5,12,44,44,5,7,12,51.0,,126,9,12,21,112.0,82,5.28,57,380,2242,9.6,0.20472944
13534,13534,Joel Bouchard,1999-00,26.0,6,15,64,64,4,11,15,78.0,1444.0,190,13,23,36,190.0,82,5.27,57,359,2285,9.4,0.2064808
13535,13535,Joel Bouchard,2000-01,27.0,7,5,54,54,1,4,5,61.0,991.0,244,14,27,41,251.0,82,5.49,53,331,2294,9.8,0.13291949
13536,13536,Joel Bouchard,2001-02,28.0,8,3,32,32,1,2,3,26.0,463.0,276,15,29,44,277.0,82,5.51,63,376,2272,9.9,0.18832669
13537,13537,Joel Bouchard,2002-03,29.0,9,1,1,1,0,1,1,0.0,19.0,277,15,30,45,277.0,82,5.24,53,338,2262,9.5,0.19614309
13538,13538,Joel Bouchard,2003-04,30.0,10,13,34,34,5,8,13,47.0,696.0,311,20,38,58,324.0,82,5.31,60,363,2326,9.4,0.24040496
13539,13539,Joel Bouchard,2004-05,31.0,11,8,28,28,1,7,8,34.0,468.0,339,21,45,66,358.0,82,5.14,57,348,2300,9.2,0.19167763
13540,13540,Joel Bouchard,2006-07,33.0,12,9,25,25,1,8,9,45.0,548.0,364,22,53,75,403.0,82,6.05,85,480,2458,10.1,0.16996768
13541,13541,Joel Edmundson,2016-17,23.0,2,9,67,67,1,8,9,90.0,1000.0,67,1,8,9,90.0,82,5.34,48,255,2438,9.0,0.20646575
13542,13542,Joel Edmundson,2017-18,24.0,3,15,69,69,3,12,15,81.0,1226.0,136,4,20,24,171.0,82,5.45,47,245,2478,9.0,0.2423572
13543,13543,Joel Edmundson,2018-19,25.0,4,17,69,69,7,10,17,124.0,1431.0,205,11,30,41,295.0,82,5.86,50,250,2620,9.2,0.25285935
13544,13544,Joel Edmundson,2019-20,26.0,5,11,64,64,2,9,11,102.0,1241.0,269,13,39,52,397.0,82,5.96,47,239,2579,9.5,0.21743944
13545,13545,Joel Edmundson,2020-21,27.0,6,20,68,68,7,13,20,97.0,1255.0,337,20,52,72,494.0,70,5.96,42,208,2192,9.5,0.29822934
13546,13546,Joel Eriksson Ek,2017-18,21.0,2,7,15,15,3,4,7,15.0,159.0,15,3,4,7,15.0,82,5.45,47,245,2478,9.0,0.34902787
13547,13547,Joel Eriksson Ek,2018-19,22.0,3,16,75,75,6,10,16,124.0,958.0,90,9,14,23,139.0,82,5.86,50,250,2620,9.2,0.30231744
13548,13548,Joel Eriksson Ek,2019-20,23.0,4,14,58,58,7,7,14,111.0,783.0,148,16,21,37,250.0,82,5.96,47,239,2579,9.5,0.2957272
13549,13549,Joel Eriksson Ek,2020-21,24.0,5,29,62,62,8,21,29,102.0,974.0,210,24,42,66,352.0,70,5.96,42,208,2192,9.5,0.4518718
13550,13550,Joel Farabee,2020-21,20.0,2,21,52,52,8,13,21,81.0,733.0,52,8,13,21,81.0,70,5.96,42,208,2192,9.5,0.43724513
13551,13551,Joel Hanley,2016-17,25.0,2,6,10,10,0,6,6,10.0,160.0,10,0,6,6,10.0,82,5.34,48,255,2438,9.0,0.2035692
13552,13552,Joel Hanley,2017-18,26.0,3,0,7,7,0,0,0,5.0,71.0,17,0,6,6,15.0,82,5.45,47,245,2478,9.0,0.16131148
13553,13553,Joel Hanley,2018-19,27.0,4,0,5,5,0,0,0,2.0,56.0,22,0,6,6,17.0,82,5.86,50,250,2620,9.2,0.13757703
13554,13554,Joel Hanley,2019-20,28.0,5,0,16,16,0,0,0,9.0,219.0,38,0,6,6,26.0,82,5.96,47,239,2579,9.5,0.14018142
13555,13555,Joel Hanley,2020-21,29.0,6,2,8,8,0,2,2,4.0,91.0,46,0,8,8,30.0,70,5.96,42,208,2192,9.5,0.15165812
13556,13556,Joel Kellman,2020-21,26.0,2,7,31,31,3,4,7,31.0,359.0,31,3,4,7,31.0,70,5.96,42,208,2192,9.5,0.24702555
13557,13557,Joel Kiviranta,2020-21,24.0,2,1,11,11,1,0,1,13.0,117.0,11,1,0,1,13.0,70,5.96,42,208,2192,9.5,0.2303612
13558,13558,Joel Kwiatkowski,2001-02,24.0,2,1,4,4,1,0,1,2.0,48.0,4,1,0,1,2.0,82,5.51,63,376,2272,9.9,0.19964138
13559,13559,Joel Kwiatkowski,2002-03,25.0,3,0,11,11,0,0,0,9.0,150.0,15,1,0,1,11.0,82,5.24,53,338,2262,9.5,0.16082075
13560,13560,Joel Kwiatkowski,2003-04,26.0,4,5,54,54,0,5,5,56.0,773.0,69,1,5,6,67.0,82,5.31,60,363,2326,9.4,0.13517147
13561,13561,Joel Kwiatkowski,2004-05,27.0,5,12,80,80,6,6,12,90.0,1701.0,149,7,11,18,157.0,82,5.14,57,348,2300,9.2,0.20531183
13562,13562,Joel Kwiatkowski,2006-07,29.0,6,12,73,73,4,8,12,87.0,1193.0,222,11,19,30,244.0,82,6.05,85,480,2458,10.1,0.17522573
13563,13563,Joel Kwiatkowski,2007-08,30.0,7,10,42,42,5,5,10,46.0,412.0,264,16,24,40,290.0,82,5.76,70,398,2426,9.7,0.18658513
13564,13564,Joel Kwiatkowski,2008-09,31.0,8,5,18,18,0,5,5,24.0,301.0,282,16,29,45,314.0,82,5.44,62,351,2383,9.4,0.18176827
13565,13565,Joel L'Esperance,2019-20,24.0,2,2,18,18,2,0,2,24.0,220.0,18,2,0,2,24.0,82,5.96,47,239,2579,9.5,0.22925001
13566,13566,Joel L'Esperance,2020-21,25.0,3,1,3,3,1,0,1,2.0,22.0,21,3,0,3,26.0,70,5.96,42,208,2192,9.5,0.21003518
13567,13567,Joel Lundqvist,2007-08,25.0,2,6,36,36,3,3,6,36.0,408.0,36,3,3,6,36.0,82,5.76,70,398,2426,9.7,0.20269498
13568,13568,Joel Lundqvist,2008-09,26.0,3,14,55,55,3,11,14,48.0,598.0,91,6,14,20,84.0,82,5.44,62,351,2383,9.4,0.21854317
13569,13569,Joel Lundqvist,2009-10,27.0,4,6,43,43,1,5,6,32.0,465.0,134,7,19,26,116.0,82,5.7,65,341,2477,9.4,0.12947434
13570,13570,Joel Otto,1985-86,24.0,2,12,17,17,4,8,12,27.0,,17,4,8,12,27.0,80,7.77,71,321,2447,12.7,0.42845774
13571,13571,Joel Otto,1986-87,25.0,3,59,79,79,25,34,59,147.0,,96,29,42,71,174.0,80,7.94,82,370,2484,12.8,0.65212876
13572,13572,Joel Otto,1987-88,26.0,4,50,68,68,19,31,50,127.0,,164,48,73,121,301.0,80,7.34,72,344,2400,12.2,0.6700717
13573,13573,Joel Otto,1988-89,27.0,5,52,62,62,13,39,52,105.0,,226,61,112,173,406.0,80,7.43,89,437,2435,12.2,0.7327953
13574,13574,Joel Otto,1989-90,28.0,6,53,72,72,23,30,53,123.0,,298,84,142,226,529.0,80,7.48,85,403,2430,12.3,0.6469429
13575,13575,Joel Otto,1990-91,29.0,7,33,75,75,13,20,33,96.0,,373,97,162,259,625.0,80,7.37,76,367,2421,12.2,0.45001635
13576,13576,Joel Otto,1991-92,30.0,8,39,76,76,19,20,39,109.0,,449,116,182,298,734.0,80,6.91,71,366,2385,11.6,0.48992464
13577,13577,Joel Otto,1992-93,31.0,9,34,78,78,13,21,34,105.0,,527,129,203,332,839.0,80,6.96,77,402,2440,11.4,0.42333925
13578,13578,Joel Otto,1993-94,32.0,10,52,75,75,19,33,52,115.0,,602,148,236,384,954.0,84,7.25,87,443,2603,11.7,0.48043862
13579,13579,Joel Otto,1994-95,33.0,11,23,81,81,11,12,23,108.0,,683,159,248,407,1062.0,84,6.48,76,407,2545,10.7,0.27672613
13580,13580,Joel Otto,1995-96,34.0,12,21,47,47,8,13,21,46.0,,730,167,261,428,1108.0,48,5.97,37,209,1408,10.2,0.42756885
13581,13581,Joel Otto,1996-97,35.0,13,41,67,67,12,29,41,91.0,,797,179,290,469,1199.0,82,6.29,74,413,2481,10.4,0.45637155
13582,13582,Joel Otto,1997-98,36.0,14,32,78,78,13,19,32,105.0,,875,192,309,501,1304.0,82,5.83,55,336,2444,9.8,0.3412846
13583,13583,Joel Otto,1998-99,37.0,15,7,68,68,3,4,7,53.0,,943,195,313,508,1357.0,82,5.28,57,380,2242,9.6,0.1431885
13584,13584,Joel Perrault,2006-07,23.0,2,2,5,5,1,1,2,7.0,57.0,5,1,1,2,7.0,82,6.05,85,480,2458,10.1,0.23364133
13585,13585,Joel Perrault,2007-08,24.0,3,3,26,26,1,2,3,31.0,264.0,31,2,3,5,38.0,82,5.76,70,398,2426,9.7,0.19817209
13586,13586,Joel Perrault,2008-09,25.0,4,17,49,49,7,10,17,87.0,707.0,80,9,13,22,125.0,82,5.44,62,351,2383,9.4,0.34920335
13587,13587,Joel Perrault,2009-10,26.0,5,3,7,7,2,1,3,15.0,90.0,87,11,14,25,140.0,82,5.7,65,341,2477,9.4,0.24748564
13588,13588,Joel Perrault,2010-11,27.0,6,1,2,2,1,0,1,7.0,20.0,89,12,14,26,147.0,82,5.53,56,304,2486,9.1,0.17850229
13589,13589,Joel Perrault,2011-12,28.0,7,0,7,7,0,0,0,3.0,50.0,96,12,14,26,150.0,82,5.46,52,291,2492,9.0,0.14901462
13590,13590,Joel Persson,2020-21,26.0,2,2,13,13,0,2,2,17.0,199.0,13,0,2,2,17.0,70,5.96,42,208,2192,9.5,0.21897197
13591,13591,Joel Prpic,1998-99,24.0,2,0,1,1,0,0,0,0.0,,1,0,0,0,0.0,82,5.28,57,380,2242,9.6,0.15291435
13592,13592,Joel Prpic,2000-01,26.0,3,3,14,14,0,3,3,13.0,95.0,15,0,3,3,13.0,82,5.49,53,331,2294,9.8,0.17948002
13593,13593,Joel Prpic,2001-02,27.0,4,0,3,3,0,0,0,0.0,29.0,18,0,3,3,13.0,82,5.51,63,376,2272,9.9,0.14201969
13594,13594,Joel Rechlicz,2009-10,22.0,2,1,17,17,0,1,1,7.0,83.0,17,0,1,1,7.0,82,5.7,65,341,2477,9.4,0.1576055
13595,13595,Joel Rechlicz,2010-11,23.0,3,0,6,6,0,0,0,1.0,16.0,23,0,1,1,8.0,82,5.53,56,304,2486,9.1,0.15694657
13596,13596,Joel Rechlicz,2012-13,25.0,4,0,3,3,0,0,0,0.0,6.0,26,0,1,1,8.0,82,5.32,47,271,2439,8.9,0.13352963
13597,13597,Joel Savage,1991-92,22.0,2,1,3,3,0,1,1,2.0,,3,0,1,1,2.0,80,6.91,71,366,2385,11.6,0.22784156
13598,13598,Joel Vermin,2016-17,24.0,2,1,6,6,0,1,1,1.0,55.0,6,0,1,1,1.0,82,5.34,48,255,2438,9.0,0.1857931
13599,13599,Joel Vermin,2017-18,25.0,3,3,18,18,0,3,3,12.0,197.0,24,0,4,4,13.0,82,5.45,47,245,2478,9.0,0.18251374
13600,13600,Joel Ward,2007-08,27.0,2,1,11,11,0,1,1,12.0,85.0,11,0,1,1,12.0,82,5.76,70,398,2426,9.7,0.20282337
13601,13601,Joel Ward,2009-10,29.0,3,35,79,79,17,18,35,133.0,1265.0,90,17,19,36,145.0,82,5.7,65,341,2477,9.4,0.417545
13602,13602,Joel Ward,2010-11,30.0,4,34,71,71,13,21,34,134.0,1246.0,161,30,40,70,279.0,82,5.53,56,304,2486,9.1,0.4188884
13603,13603,Joel Ward,2011-12,31.0,5,29,80,80,10,19,29,157.0,1366.0,241,40,59,99,436.0,82,5.46,52,291,2492,9.0,0.35934633
13604,13604,Joel Ward,2012-13,32.0,6,18,73,73,6,12,18,79.0,907.0,314,46,71,117,515.0,82,5.32,47,271,2439,8.9,0.26908365
13605,13605,Joel Ward,2013-14,33.0,7,20,39,39,8,12,20,52.0,590.0,353,54,83,137,567.0,48,5.31,29,160,1399,9.1,0.47650284
13606,13606,Joel Ward,2014-15,34.0,8,49,82,82,24,25,49,133.0,1318.0,435,78,108,186,700.0,82,5.34,48,269,2463,8.9,0.51486075
13607,13607,Joel Ward,2015-16,35.0,9,34,82,82,19,15,34,138.0,1383.0,517,97,123,220,838.0,82,5.32,47,251,2453,8.9,0.37124622
13608,13608,Joel Ward,2016-17,36.0,10,43,79,79,21,22,43,138.0,1341.0,596,118,145,263,976.0,82,5.34,48,255,2438,9.0,0.45135012
13609,13609,Joel Ward,2017-18,37.0,11,29,78,78,10,19,29,105.0,1244.0,674,128,164,292,1081.0,82,5.45,47,245,2478,9.0,0.28124297
13610,13610,Joel Ward,2018-19,38.0,12,12,52,52,5,7,12,40.0,617.0,726,133,171,304,1121.0,82,5.86,50,250,2620,9.2,0.18143916
13611,13611,Joey Anderson,2019-20,21.0,2,7,34,34,4,3,7,49.0,439.0,34,4,3,7,49.0,82,5.96,47,239,2579,9.5,0.33070976
13612,13612,Joey Anderson,2020-21,22.0,3,6,18,18,4,2,6,21.0,238.0,52,8,5,13,70.0,70,5.96,42,208,2192,9.5,0.33056945
13613,13613,Joey Crabb,2009-10,26.0,2,9,29,29,4,5,9,33.0,354.0,29,4,5,9,33.0,82,5.7,65,341,2477,9.4,0.23825869
13614,13614,Joey Crabb,2011-12,28.0,3,15,48,48,3,12,15,51.0,623.0,77,7,17,24,84.0,82,5.46,52,291,2492,9.0,0.24124661
13615,13615,Joey Crabb,2012-13,29.0,4,26,67,67,11,15,26,75.0,901.0,144,18,32,50,159.0,82,5.32,47,271,2439,8.9,0.29111165
13616,13616,Joey Crabb,2013-14,30.0,5,2,26,26,2,0,2,20.0,245.0,170,20,32,52,179.0,48,5.31,29,160,1399,9.1,0.23132399
13617,13617,Joey Crabb,2014-15,31.0,6,1,9,9,0,1,1,5.0,129.0,179,20,33,53,184.0,82,5.34,48,269,2463,8.9,0.15803966
13618,13618,Joey Hishon,2015-16,24.0,2,2,13,13,1,1,2,19.0,131.0,13,1,1,2,19.0,82,5.32,47,251,2453,8.9,0.2074686
13619,13619,Joey Mormina,2008-09,26.0,2,0,1,1,0,0,0,1.0,8.0,1,0,0,0,1.0,82,5.44,62,351,2383,9.4,0.18182465
13620,13620,Joey Tenute,2006-07,23.0,2,0,1,1,0,0,0,1.0,7.0,1,0,0,0,1.0,82,6.05,85,480,2458,10.1,0.16944346
13621,13621,Joey Tetarenko,2001-02,23.0,2,4,29,29,3,1,4,21.0,180.0,29,3,1,4,21.0,82,5.51,63,376,2272,9.9,0.23267034
13622,13622,Joey Tetarenko,2002-03,24.0,3,1,38,38,1,0,1,10.0,195.0,67,4,1,5,31.0,82,5.24,53,338,2262,9.5,0.11010319
13623,13623,Joey Tetarenko,2003-04,25.0,4,0,4,4,0,0,0,3.0,26.0,71,4,1,5,34.0,82,5.31,60,363,2326,9.4,0.13764673
13624,13624,Joey Tetarenko,2004-05,26.0,5,0,2,2,0,0,0,0.0,7.0,73,4,1,5,34.0,82,5.14,57,348,2300,9.2,0.12968445
13625,13625,Joffrey Lupul,2004-05,21.0,2,34,75,75,13,21,34,137.0,1021.0,75,13,21,34,137.0,82,5.14,57,348,2300,9.2,0.7425069
13626,13626,Joffrey Lupul,2006-07,23.0,3,53,81,81,28,25,53,296.0,1347.0,156,41,46,87,433.0,82,6.05,85,480,2458,10.1,0.6711378
13627,13627,Joffrey Lupul,2007-08,24.0,4,28,81,81,16,12,28,172.0,1263.0,237,57,58,115,605.0,82,5.76,70,398,2426,9.7,0.4992934
13628,13628,Joffrey Lupul,2008-09,25.0,5,46,56,56,20,26,46,176.0,1020.0,293,77,84,161,781.0,82,5.44,62,351,2383,9.4,0.72520626
13629,13629,Joffrey Lupul,2009-10,26.0,6,50,79,79,25,25,50,194.0,1239.0,372,102,109,211,975.0,82,5.7,65,341,2477,9.4,0.63634545
13630,13630,Joffrey Lupul,2010-11,27.0,7,14,23,23,10,4,14,66.0,367.0,395,112,113,225,1041.0,82,5.53,56,304,2486,9.1,0.49608338
13631,13631,Joffrey Lupul,2011-12,28.0,8,31,54,54,14,17,31,129.0,844.0,449,126,130,256,1170.0,82,5.46,52,291,2492,9.0,0.6142806
13632,13632,Joffrey Lupul,2012-13,29.0,9,67,66,66,25,42,67,191.0,1228.0,515,151,172,323,1361.0,82,5.32,47,271,2439,8.9,0.8096422
13633,13633,Joffrey Lupul,2013-14,30.0,10,18,16,16,11,7,18,42.0,258.0,531,162,179,341,1403.0,48,5.31,29,160,1399,9.1,0.78442574
13634,13634,Joffrey Lupul,2014-15,31.0,11,44,69,69,22,22,44,191.0,1274.0,600,184,201,385,1594.0,82,5.34,48,269,2463,8.9,0.59883934
13635,13635,Joffrey Lupul,2015-16,32.0,12,21,55,55,10,11,21,97.0,852.0,655,194,212,406,1691.0,82,5.32,47,251,2453,8.9,0.3732775
13636,13636,Joffrey Lupul,2016-17,33.0,13,14,46,46,11,3,14,102.0,673.0,701,205,215,420,1793.0,82,5.34,48,255,2438,9.0,0.3204226
13637,13637,Johan Davidsson,1999-00,24.0,2,8,64,64,3,5,8,48.0,679.0,64,3,5,8,48.0,82,5.27,57,359,2285,9.4,0.17296523
13638,13638,Johan Davidsson,2000-01,25.0,3,7,19,19,3,4,7,29.0,215.0,83,6,9,15,77.0,82,5.49,53,331,2294,9.8,0.25252363
13639,13639,Johan Franzen,2006-07,27.0,2,16,80,80,12,4,16,119.0,996.0,80,12,4,16,119.0,82,6.05,85,480,2458,10.1,0.28566504
13640,13640,Johan Franzen,2007-08,28.0,3,30,69,69,10,20,30,151.0,1076.0,149,22,24,46,270.0,82,5.76,70,398,2426,9.7,0.41442508
13641,13641,Johan Franzen,2008-09,29.0,4,38,72,72,27,11,38,199.0,1276.0,221,49,35,84,469.0,82,5.44,62,351,2383,9.4,0.59574705
13642,13642,Johan Franzen,2009-10,30.0,5,59,71,71,34,25,59,246.0,1285.0,292,83,60,143,715.0,82,5.7,65,341,2477,9.4,0.67994815
13643,13643,Johan Franzen,2010-11,31.0,6,21,27,27,10,11,21,91.0,505.0,319,93,71,164,806.0,82,5.53,56,304,2486,9.1,0.6020283
13644,13644,Johan Franzen,2011-12,32.0,7,55,76,76,28,27,55,248.0,1325.0,395,121,98,219,1054.0,82,5.46,52,291,2492,9.0,0.61794144
13645,13645,Johan Franzen,2012-13,33.0,8,56,77,77,29,27,56,211.0,1363.0,472,150,125,275,1265.0,82,5.32,47,271,2439,8.9,0.62475574
13646,13646,Johan Franzen,2013-14,34.0,9,31,41,41,14,17,31,116.0,742.0,513,164,142,306,1381.0,48,5.31,29,160,1399,9.1,0.62264913
13647,13647,Johan Franzen,2014-15,35.0,10,41,54,54,16,25,41,149.0,954.0,567,180,167,347,1530.0,82,5.34,48,269,2463,8.9,0.6598952
13648,13648,Johan Franzen,2015-16,36.0,11,22,33,33,7,15,22,74.0,530.0,600,187,182,369,1604.0,82,5.32,47,251,2453,8.9,0.4625563
13649,13649,Johan Franzen,2016-17,37.0,12,1,2,2,0,1,1,3.0,26.0,602,187,183,370,1607.0,82,5.34,48,255,2438,9.0,0.20587006
13650,13650,Johan Garpenlov,1991-92,23.0,2,40,71,71,18,22,40,91.0,,71,18,22,40,91.0,80,6.91,71,366,2385,11.6,0.52394253
13651,13651,Johan Garpenlov,1992-93,24.0,3,13,28,28,6,7,13,34.0,,99,24,29,53,125.0,80,6.96,77,402,2440,11.4,0.45457122
13652,13652,Johan Garpenlov,1993-94,25.0,4,66,79,79,22,44,66,171.0,,178,46,73,119,296.0,84,7.25,87,443,2603,11.7,0.7037913
13653,13653,Johan Garpenlov,1994-95,26.0,5,53,80,80,18,35,53,125.0,,258,64,108,172,421.0,84,6.48,76,407,2545,10.7,0.61649734
13654,13654,Johan Garpenlov,1995-96,27.0,6,14,40,40,4,10,14,44.0,,298,68,118,186,465.0,48,5.97,37,209,1408,10.2,0.49098817
13655,13655,Johan Garpenlov,1996-97,28.0,7,51,82,82,23,28,51,130.0,,380,91,146,237,595.0,82,6.29,74,413,2481,10.4,0.55151814
13656,13656,Johan Garpenlov,1997-98,29.0,8,36,53,53,11,25,36,83.0,,433,102,171,273,678.0,82,5.83,55,336,2444,9.8,0.52857137
13657,13657,Johan Garpenlov,1998-99,30.0,9,5,39,39,2,3,5,43.0,,472,104,174,278,721.0,82,5.28,57,380,2242,9.6,0.27126306
13658,13658,Johan Garpenlov,1999-00,31.0,10,17,64,64,8,9,17,71.0,847.0,536,112,183,295,792.0,82,5.27,57,359,2285,9.4,0.2687894
13659,13659,Johan Garpenlov,2000-01,32.0,11,16,73,73,2,14,16,79.0,1118.0,609,114,197,311,871.0,82,5.49,53,331,2294,9.8,0.25569695
13660,13660,Johan Harju,2011-12,25.0,2,3,10,10,1,2,3,14.0,85.0,10,1,2,3,14.0,82,5.46,52,291,2492,9.0,0.2083211
13661,13661,Johan Larsson,2013-14,21.0,2,0,1,1,0,0,0,2.0,14.0,1,0,0,0,2.0,48,5.31,29,160,1399,9.1,0.20550153
13662,13662,Johan Larsson,2014-15,22.0,3,4,28,28,0,4,4,21.0,377.0,29,0,4,4,23.0,82,5.34,48,269,2463,8.9,0.17366332
13663,13663,Johan Larsson,2015-16,23.0,4,16,39,39,6,10,16,50.0,566.0,68,6,14,20,73.0,82,5.32,47,251,2453,8.9,0.3611938
13664,13664,Johan Larsson,2016-17,24.0,5,17,74,74,10,7,17,95.0,1097.0,142,16,21,37,168.0,82,5.34,48,255,2438,9.0,0.24303448
13665,13665,Johan Larsson,2017-18,25.0,6,11,36,36,6,5,11,49.0,607.0,178,22,26,48,217.0,82,5.45,47,245,2478,9.0,0.27578586
13666,13666,Johan Larsson,2018-19,26.0,7,17,80,80,4,13,17,86.0,1129.0,258,26,39,65,303.0,82,5.86,50,250,2620,9.2,0.22173765
13667,13667,Johan Larsson,2019-20,27.0,8,14,73,73,6,8,14,79.0,1043.0,331,32,47,79,382.0,82,5.96,47,239,2579,9.5,0.20881295
13668,13668,Johan Larsson,2020-21,28.0,9,18,62,62,6,12,18,60.0,924.0,393,38,59,97,442.0,70,5.96,42,208,2192,9.5,0.25849453
13669,13669,Johan Lindbom,1998-99,27.0,2,4,38,38,1,3,4,38.0,,38,1,3,4,38.0,82,5.28,57,380,2242,9.6,0.14497507
13670,13670,Johan Motin,2010-11,21.0,2,0,1,1,0,0,0,0.0,14.0,1,0,0,0,0.0,82,5.53,56,304,2486,9.1,0.19763052
13671,13671,Johan Sundstrom,2014-15,22.0,2,1,11,11,0,1,1,13.0,95.0,11,0,1,1,13.0,82,5.34,48,269,2463,8.9,0.19813243
13672,13672,Johan Witehall,1999-00,28.0,2,0,4,4,0,0,0,1.0,16.0,4,0,0,0,1.0,82,5.27,57,359,2285,9.4,0.1703665
13673,13673,Johan Witehall,2000-01,29.0,3,2,9,9,1,1,2,6.0,76.0,13,1,1,2,7.0,82,5.49,53,331,2294,9.8,0.1852982
13674,13674,Johan Witehall,2001-02,30.0,4,5,41,41,1,4,5,34.0,405.0,54,2,5,7,41.0,82,5.51,63,376,2272,9.9,0.10970706
13675,13675,John Albert,2014-15,26.0,2,1,9,9,1,0,1,5.0,46.0,9,1,0,1,5.0,82,5.34,48,269,2463,8.9,0.19004095
13676,13676,John Barrett,1981-82,23.0,2,13,56,56,3,10,13,97.0,,56,3,10,13,97.0,80,7.69,77,340,2441,12.6,0.32638887
13677,13677,John Barrett,1982-83,24.0,3,13,69,69,1,12,13,97.0,,125,4,22,26,194.0,80,8.03,73,320,2489,12.9,0.24761128
13678,13678,John Barrett,1983-84,25.0,4,14,79,79,4,10,14,75.0,,204,8,32,40,269.0,80,7.73,71,310,2444,12.7,0.24698883
13679,13679,John Barrett,1984-85,26.0,5,10,78,78,2,8,10,63.0,,282,10,40,50,332.0,80,7.89,74,336,2448,12.9,0.21516946
13680,13680,John Barrett,1985-86,27.0,6,25,71,71,6,19,25,73.0,,353,16,59,75,405.0,80,7.77,71,321,2447,12.7,0.29254788
13681,13681,John Barrett,1986-87,28.0,7,17,79,79,2,15,17,67.0,,432,18,74,92,472.0,80,7.94,82,370,2484,12.8,0.20949128
13682,13682,John Barrett,1987-88,29.0,8,4,55,55,2,2,4,37.0,,487,20,76,96,509.0,80,7.34,72,344,2400,12.2,0.191187
13683,13683,John Barrett,1988-89,30.0,9,1,1,1,0,1,1,0.0,,488,20,77,97,509.0,80,7.43,89,437,2435,12.2,0.40330663
13684,13684,John Bethel,1980-81,24.0,2,2,17,17,0,2,2,12.0,,17,0,2,2,12.0,80,7.03,61,280,2352,12.0,0.23822576
13685,13685,John Blum,1983-84,24.0,2,3,5,5,0,3,3,0.0,,5,0,3,3,0.0,80,7.73,71,310,2444,12.7,0.21056592
13686,13686,John Blum,1984-85,25.0,3,3,16,16,1,2,3,12.0,,21,1,5,6,12.0,80,7.89,74,336,2448,12.9,0.24053007
13687,13687,John Blum,1985-86,26.0,4,16,75,75,3,13,16,36.0,,96,4,18,22,48.0,80,7.77,71,321,2447,12.7,0.20906839
13688,13688,John Blum,1986-87,27.0,5,8,61,61,1,7,8,34.0,,157,5,25,30,82.0,80,7.94,82,370,2484,12.8,0.15082839
13689,13689,John Blum,1987-88,28.0,6,10,66,66,2,8,10,33.0,,223,7,33,40,115.0,80,7.34,72,344,2400,12.2,0.19475314
13690,13690,John Blum,1988-89,29.0,7,1,19,19,0,1,1,6.0,,242,7,34,41,121.0,80,7.43,89,437,2435,12.2,0.12439442
13691,13691,John Blum,1989-90,30.0,8,0,6,6,0,0,0,3.0,,248,7,34,41,124.0,80,7.48,85,403,2430,12.3,0.15182576
13692,13692,John Blum,1990-91,31.0,9,0,2,2,0,0,0,0.0,,250,7,34,41,124.0,80,7.37,76,367,2421,12.2,0.16336733
13693,13693,John Byce,1991-92,24.0,2,4,18,18,1,3,4,13.0,,18,1,3,4,13.0,80,6.91,71,366,2385,11.6,0.24293259
13694,13694,John Byce,1992-93,25.0,3,1,3,3,1,0,1,2.0,,21,2,3,5,15.0,80,6.96,77,402,2440,11.4,0.2200664
13695,13695,John Carlson,2010-11,21.0,2,6,22,22,1,5,6,21.0,335.0,22,1,5,6,21.0,82,5.53,56,304,2486,9.1,0.27393335
13696,13696,John Carlson,2011-12,22.0,3,37,82,82,7,30,37,144.0,1857.0,104,8,35,43,165.0,82,5.46,52,291,2492,9.0,0.47791636
13697,13697,John Carlson,2012-13,23.0,4,32,82,82,9,23,32,152.0,1792.0,186,17,58,75,317.0,82,5.32,47,271,2439,8.9,0.45203787
13698,13698,John Carlson,2013-14,24.0,5,22,48,48,6,16,22,97.0,1105.0,234,23,74,97,414.0,48,5.31,29,160,1399,9.1,0.46062168
13699,13699,John Carlson,2014-15,25.0,6,37,82,82,10,27,37,208.0,2010.0,316,33,101,134,622.0,82,5.34,48,269,2463,8.9,0.53746516
13700,13700,John Carlson,2015-16,26.0,7,55,82,82,12,43,55,193.0,1892.0,398,45,144,189,815.0,82,5.32,47,251,2453,8.9,0.6455279
13701,13701,John Carlson,2016-17,27.0,8,39,56,56,8,31,39,124.0,1327.0,454,53,175,228,939.0,82,5.34,48,255,2438,9.0,0.61707044
13702,13702,John Carlson,2017-18,28.0,9,37,72,72,9,28,37,180.0,1635.0,526,62,203,265,1119.0,82,5.45,47,245,2478,9.0,0.5424951
13703,13703,John Carlson,2018-19,29.0,10,68,82,82,15,53,68,237.0,2032.0,608,77,256,333,1356.0,82,5.86,50,250,2620,9.2,0.78358877
13704,13704,John Carlson,2019-20,30.0,11,70,80,80,13,57,70,185.0,2005.0,688,90,313,403,1541.0,82,5.96,47,239,2579,9.5,0.7505837
13705,13705,John Carlson,2020-21,31.0,12,75,69,69,15,60,75,189.0,1700.0,757,105,373,478,1730.0,70,5.96,42,208,2192,9.5,0.85533047
13706,13706,John Carter,1986-87,23.0,2,0,3,3,0,0,0,2.0,,3,0,0,0,2.0,80,7.94,82,370,2484,12.8,0.21727103
13707,13707,John Carter,1987-88,24.0,3,1,8,8,0,1,1,12.0,,11,0,1,1,14.0,80,7.34,72,344,2400,12.2,0.21928614
13708,13708,John Carter,1988-89,25.0,4,1,4,4,0,1,1,8.0,,15,0,2,2,22.0,80,7.43,89,437,2435,12.2,0.20264927
13709,13709,John Carter,1989-90,26.0,5,22,44,44,12,10,22,96.0,,59,12,12,24,118.0,80,7.48,85,403,2430,12.3,0.41932103
13710,13710,John Carter,1990-91,27.0,6,39,76,76,17,22,39,142.0,,135,29,34,63,260.0,80,7.37,76,367,2421,12.2,0.45837775
13711,13711,John Carter,1991-92,28.0,7,11,50,50,4,7,11,61.0,,185,33,41,74,321.0,80,6.91,71,366,2385,11.6,0.26903382
13712,13712,John Carter,1992-93,29.0,8,0,4,4,0,0,0,5.0,,189,33,41,74,326.0,80,6.96,77,402,2440,11.4,0.27079535
13713,13713,John Carter,1993-94,30.0,9,16,55,55,7,9,16,110.0,,244,40,50,90,436.0,84,7.25,87,443,2603,11.7,0.32005656
13714,13714,John Chabot,1984-85,22.0,2,43,56,56,18,25,43,69.0,,56,18,25,43,69.0,80,7.89,74,336,2448,12.9,0.6992982
13715,13715,John Chabot,1985-86,23.0,3,60,77,77,9,51,60,112.0,,133,27,76,103,181.0,80,7.77,71,321,2447,12.7,0.64608634
13716,13716,John Chabot,1986-87,24.0,4,45,77,77,14,31,45,89.0,,210,41,107,148,270.0,80,7.94,82,370,2484,12.8,0.6051762
13717,13717,John Chabot,1987-88,25.0,5,36,72,72,14,22,36,90.0,,282,55,129,184,360.0,80,7.34,72,344,2400,12.2,0.56901604
13718,13718,John Chabot,1988-89,26.0,6,57,78,78,13,44,57,83.0,,360,68,173,241,443.0,80,7.43,89,437,2435,12.2,0.6280155
13719,13719,John Chabot,1989-90,27.0,7,12,52,52,2,10,12,49.0,,412,70,183,253,492.0,80,7.48,85,403,2430,12.3,0.34255004
13720,13720,John Chabot,1990-91,28.0,8,49,69,69,9,40,49,91.0,,481,79,223,302,583.0,80,7.37,76,367,2421,12.2,0.5898243
13721,13721,John Chabot,1991-92,29.0,9,10,27,27,5,5,10,26.0,,508,84,228,312,609.0,80,6.91,71,366,2385,11.6,0.42435727
13722,13722,John Craighead,1997-98,26.0,2,0,5,5,0,0,0,0.0,,5,0,0,0,0.0,82,5.83,55,336,2444,9.8,0.13683271
13723,13723,John Cullen,1989-90,25.0,2,49,79,79,12,37,49,121.0,,79,12,37,49,121.0,80,7.48,85,403,2430,12.3,0.56821
13724,13724,John Cullen,1990-91,26.0,3,92,72,72,32,60,92,197.0,,151,44,97,141,318.0,80,7.37,76,367,2421,12.2,1.1578062
13725,13725,John Cullen,1991-92,27.0,4,110,78,78,39,71,110,205.0,,229,83,168,251,523.0,80,6.91,71,366,2385,11.6,1.1947732
13726,13726,John Cullen,1992-93,28.0,5,77,77,77,26,51,77,173.0,,306,109,219,328,696.0,80,6.96,77,402,2440,11.4,0.8890098
13727,13727,John Cullen,1993-94,29.0,6,50,66,66,18,32,50,124.0,,372,127,251,378,820.0,84,7.25,87,443,2603,11.7,0.62978846
13728,13728,John Cullen,1994-95,30.0,7,30,53,53,13,17,30,80.0,,425,140,268,408,900.0,84,6.48,76,407,2545,10.7,0.5827029
13729,13729,John Cullen,1995-96,31.0,8,37,46,46,13,24,37,88.0,,471,153,292,445,988.0,48,5.97,37,209,1408,10.2,0.70303655
13730,13730,John Cullen,1996-97,32.0,9,50,76,76,16,34,50,152.0,,547,169,326,495,1140.0,82,6.29,74,413,2481,10.4,0.6205066
13731,13731,John Cullen,1997-98,33.0,10,55,70,70,18,37,55,116.0,,617,187,363,550,1256.0,82,5.83,55,336,2444,9.8,0.6202334
13732,13732,John Cullen,1999-00,35.0,11,0,4,4,0,0,0,3.0,51.0,621,187,363,550,1259.0,82,5.27,57,359,2285,9.4,0.31371424
13733,13733,John Druce,1989-90,23.0,2,15,48,48,8,7,15,59.0,,48,8,7,15,59.0,80,7.48,85,403,2430,12.3,0.34091878
13734,13734,John Druce,1990-91,24.0,3,11,45,45,8,3,11,66.0,,93,16,10,26,125.0,80,7.37,76,367,2421,12.2,0.34241402
13735,13735,John Druce,1991-92,25.0,4,58,80,80,22,36,58,209.0,,173,38,46,84,334.0,80,6.91,71,366,2385,11.6,0.6809528
13736,13736,John Druce,1992-93,26.0,5,37,67,67,19,18,37,129.0,,240,57,64,121,463.0,80,6.96,77,402,2440,11.4,0.5133029
13737,13737,John Druce,1993-94,27.0,6,20,50,50,6,14,20,60.0,,290,63,78,141,523.0,84,7.25,87,443,2603,11.7,0.3953
13738,13738,John Druce,1994-95,28.0,7,31,55,55,14,17,31,104.0,,345,77,95,172,627.0,84,6.48,76,407,2545,10.7,0.49396265
13739,13739,John Druce,1995-96,29.0,8,20,43,43,15,5,20,75.0,,388,92,100,192,702.0,48,5.97,37,209,1408,10.2,0.49573526
13740,13740,John Druce,1996-97,30.0,9,29,77,77,13,16,29,128.0,,465,105,116,221,830.0,82,6.29,74,413,2481,10.4,0.3315819
13741,13741,John Druce,1997-98,31.0,10,15,43,43,7,8,15,73.0,,508,112,124,236,903.0,82,5.83,55,336,2444,9.8,0.3210124
13742,13742,John Druce,1998-99,32.0,11,3,23,23,1,2,3,18.0,,531,113,126,239,921.0,82,5.28,57,380,2242,9.6,0.19394916
13743,13743,John Emmons,2000-01,26.0,2,0,10,10,0,0,0,3.0,74.0,10,0,0,0,3.0,82,5.49,53,331,2294,9.8,0.15792888
13744,13744,John Emmons,2001-02,27.0,3,4,53,53,2,2,4,37.0,476.0,63,2,2,4,40.0,82,5.51,63,376,2272,9.9,0.11795688
13745,13745,John Emmons,2002-03,28.0,4,2,22,22,0,2,2,20.0,178.0,85,2,4,6,60.0,82,5.24,53,338,2262,9.5,0.13259104
13746,13746,John English,1988-89,22.0,2,4,3,3,1,3,4,5.0,,3,1,3,4,5.0,80,7.43,89,437,2435,12.2,0.30211192
13747,13747,John Erskine,2002-03,22.0,2,1,33,33,0,1,1,16.0,354.0,33,0,1,1,16.0,82,5.24,53,338,2262,9.5,0.14882657
13748,13748,John Erskine,2003-04,23.0,3,2,16,16,2,0,2,12.0,172.0,49,2,1,3,28.0,82,5.31,60,363,2326,9.4,0.23091504
13749,13749,John Erskine,2004-05,24.0,4,1,32,32,0,1,1,23.0,403.0,81,2,2,4,51.0,82,5.14,57,348,2300,9.2,0.15559274
13750,13750,John Erskine,2006-07,26.0,5,1,60,60,1,0,1,32.0,783.0,141,3,2,5,83.0,82,6.05,85,480,2458,10.1,0.12019795
13751,13751,John Erskine,2007-08,27.0,6,7,29,29,1,6,7,14.0,523.0,170,4,8,12,97.0,82,5.76,70,398,2426,9.7,0.122804195
13752,13752,John Erskine,2008-09,28.0,7,9,51,51,2,7,9,48.0,801.0,221,6,15,21,145.0,82,5.44,62,351,2383,9.4,0.14529774
13753,13753,John Erskine,2009-10,29.0,8,4,52,52,0,4,4,50.0,873.0,273,6,19,25,195.0,82,5.7,65,341,2477,9.4,0.12985611
13754,13754,John Erskine,2010-11,30.0,9,6,50,50,1,5,6,50.0,799.0,323,7,24,31,245.0,82,5.53,56,304,2486,9.1,0.11533943
13755,13755,John Erskine,2011-12,31.0,10,11,73,73,4,7,11,58.0,1083.0,396,11,31,42,303.0,82,5.46,52,291,2492,9.0,0.12781683
13756,13756,John Erskine,2012-13,32.0,11,2,28,28,0,2,2,20.0,339.0,424,11,33,44,323.0,82,5.32,47,271,2439,8.9,0.095286936
13757,13757,John Erskine,2013-14,33.0,12,6,30,30,3,3,6,32.0,554.0,454,14,36,50,355.0,48,5.31,29,160,1399,9.1,0.18183717
13758,13758,John Erskine,2014-15,34.0,13,4,37,37,1,3,4,38.0,577.0,491,15,39,54,393.0,82,5.34,48,269,2463,8.9,0.124908954
13759,13759,John Gibson,1981-82,22.0,2,0,4,4,0,0,0,5.0,,4,0,0,0,5.0,80,7.69,77,340,2441,12.6,0.2371569
13760,13760,John Gibson,1982-83,23.0,3,2,33,33,0,2,2,37.0,,37,0,2,2,42.0,80,8.03,73,320,2489,12.9,0.21344933
13761,13761,John Gibson,1984-85,25.0,4,0,11,11,0,0,0,4.0,,48,0,2,2,46.0,80,7.89,74,336,2448,12.9,0.17664963
13762,13762,John Gilmour,2018-19,25.0,2,5,28,28,2,3,5,61.0,481.0,28,2,3,5,61.0,82,5.86,50,250,2620,9.2,0.21806625
13763,13763,John Gilmour,2019-20,26.0,3,0,5,5,0,0,0,9.0,80.0,33,2,3,5,70.0,82,5.96,47,239,2579,9.5,0.1731168
13764,13764,John Gilmour,2020-21,27.0,4,0,4,4,0,0,0,5.0,68.0,37,2,3,5,75.0,70,5.96,42,208,2192,9.5,0.17023543
13765,13765,John Gruden,1994-95,24.0,2,1,7,7,0,1,1,8.0,,7,0,1,1,8.0,84,6.48,76,407,2545,10.7,0.1910843
13766,13766,John Gruden,1995-96,25.0,3,6,38,38,0,6,6,30.0,,45,0,7,7,38.0,48,5.97,37,209,1408,10.2,0.16088119
13767,13767,John Gruden,1996-97,26.0,4,0,14,14,0,0,0,12.0,,59,0,7,7,50.0,82,6.29,74,413,2481,10.4,0.15701446
13768,13768,John Gruden,1999-00,29.0,5,1,13,13,0,1,1,10.0,171.0,72,0,8,8,60.0,82,5.27,57,359,2285,9.4,0.14753485
13769,13769,John Gruden,2000-01,30.0,6,0,9,9,0,0,0,3.0,148.0,81,0,8,8,63.0,82,5.49,53,331,2294,9.8,0.114285946
13770,13770,John Gruden,2004-05,34.0,7,1,11,11,1,0,1,7.0,146.0,92,1,8,9,70.0,82,5.14,57,348,2300,9.2,0.17704546
13771,13771,John Hayden,2017-18,22.0,2,4,12,12,1,3,4,22.0,140.0,12,1,3,4,22.0,82,5.45,47,245,2478,9.0,0.26624507
13772,13772,John Hayden,2018-19,23.0,3,13,47,47,4,9,13,56.0,509.0,59,5,12,17,78.0,82,5.86,50,250,2620,9.2,0.2683195
13773,13773,John Hayden,2019-20,24.0,4,5,54,54,3,2,5,42.0,495.0,113,8,14,22,120.0,82,5.96,47,239,2579,9.5,0.19389078
13774,13774,John Hayden,2020-21,25.0,5,4,43,43,3,1,4,39.0,418.0,156,11,15,26,159.0,70,5.96,42,208,2192,9.5,0.1749427
13775,13775,John Hughes,1980-81,26.0,2,13,52,52,2,11,13,49.0,,52,2,11,13,49.0,80,7.03,61,280,2352,12.0,0.25906116
13776,13776,John Hughes,1981-82,27.0,3,3,18,18,0,3,3,9.0,,70,2,14,16,58.0,80,7.69,77,340,2441,12.6,0.20486546
13777,13777,John Jakopin,1998-99,23.0,2,0,2,2,0,0,0,1.0,,2,0,0,0,1.0,82,5.28,57,380,2242,9.6,0.16903627
13778,13778,John Jakopin,1999-00,24.0,3,0,3,3,0,0,0,0.0,41.0,5,0,0,0,1.0,82,5.27,57,359,2285,9.4,0.15273893
13779,13779,John Jakopin,2000-01,25.0,4,0,17,17,0,0,0,1.0,203.0,22,0,0,0,2.0,82,5.49,53,331,2294,9.8,0.13132071
13780,13780,John Jakopin,2001-02,26.0,5,3,60,60,1,2,3,23.0,774.0,82,1,2,3,25.0,82,5.51,63,376,2272,9.9,0.08467269
13781,13781,John Jakopin,2002-03,27.0,6,4,19,19,0,4,4,3.0,157.0,101,1,6,7,28.0,82,5.24,53,338,2262,9.5,0.0999693
13782,13782,John Jakopin,2003-04,28.0,7,0,12,12,0,0,0,3.0,98.0,113,1,6,7,31.0,82,5.31,60,363,2326,9.4,0.124682605
13783,13783,John Johannson,1984-85,23.0,2,0,5,5,0,0,0,4.0,,5,0,0,0,4.0,80,7.89,74,336,2448,12.9,0.22391903
13784,13784,John Klingberg,2015-16,23.0,2,40,65,65,11,29,40,98.0,1420.0,65,11,29,40,98.0,82,5.32,47,251,2453,8.9,0.51109856
13785,13785,John Klingberg,2016-17,24.0,3,58,76,76,10,48,58,171.0,1724.0,141,21,77,98,269.0,82,5.34,48,255,2438,9.0,0.6611343
13786,13786,John Klingberg,2017-18,25.0,4,49,80,80,13,36,49,124.0,1868.0,221,34,113,147,393.0,82,5.45,47,245,2478,9.0,0.68694717
13787,13787,John Klingberg,2018-19,26.0,5,67,82,82,8,59,67,204.0,1974.0,303,42,172,214,597.0,82,5.86,50,250,2620,9.2,0.8101046
13788,13788,John Klingberg,2019-20,27.0,6,45,64,64,10,35,45,153.0,1570.0,367,52,207,259,750.0,82,5.96,47,239,2579,9.5,0.6024119
13789,13789,John Klingberg,2020-21,28.0,7,32,58,58,6,26,32,120.0,1286.0,425,58,233,291,870.0,70,5.96,42,208,2192,9.5,0.55506116
13790,13790,John Kordic,1986-87,21.0,2,1,5,5,0,1,1,0.0,,5,0,1,1,0.0,80,7.94,82,370,2484,12.8,0.2568798
13791,13791,John Kordic,1987-88,22.0,3,8,44,44,5,3,8,32.0,,49,5,4,9,32.0,80,7.34,72,344,2400,12.2,0.22799659
13792,13792,John Kordic,1988-89,23.0,4,8,60,60,2,6,8,17.0,,109,7,10,17,49.0,80,7.43,89,437,2435,12.2,0.17603758
13793,13793,John Kordic,1989-90,24.0,5,3,52,52,1,2,3,35.0,,161,8,12,20,84.0,80,7.48,85,403,2430,12.3,0.16566929
13794,13794,John Kordic,1990-91,25.0,6,13,55,55,9,4,13,48.0,,216,17,16,33,132.0,80,7.37,76,367,2421,12.2,0.25837693
13795,13795,John Kordic,1991-92,26.0,7,0,10,10,0,0,0,1.0,,226,17,16,33,133.0,80,6.91,71,366,2385,11.6,0.15147847
13796,13796,John Kordic,1992-93,27.0,8,2,18,18,0,2,2,3.0,,244,17,18,35,136.0,80,6.96,77,402,2440,11.4,0.16374955
13797,13797,John LeBlanc,1987-88,24.0,2,1,2,2,1,0,1,4.0,,2,1,0,1,4.0,80,7.34,72,344,2400,12.2,0.28066877
13798,13798,John LeBlanc,1988-89,25.0,3,22,41,41,12,10,22,86.0,,43,13,10,23,90.0,80,7.43,89,437,2435,12.2,0.46643847
13799,13799,John LeBlanc,1989-90,26.0,4,1,2,2,1,0,1,5.0,,45,14,10,24,95.0,80,7.48,85,403,2430,12.3,0.28092122
13800,13800,John LeBlanc,1992-93,29.0,5,7,16,16,6,1,7,32.0,,61,20,11,31,127.0,80,6.96,77,402,2440,11.4,0.33918926
13801,13801,John LeBlanc,1993-94,30.0,6,0,3,3,0,0,0,5.0,,64,20,11,31,132.0,84,7.25,87,443,2603,11.7,0.19578868
13802,13802,John LeBlanc,1994-95,31.0,7,8,17,17,6,2,8,29.0,,81,26,13,39,161.0,84,6.48,76,407,2545,10.7,0.26155695
13803,13803,John LeBlanc,1995-96,32.0,8,0,2,2,0,0,0,0.0,,83,26,13,39,161.0,48,5.97,37,209,1408,10.2,0.21371469
13804,13804,John LeClair,1991-92,22.0,2,7,10,10,2,5,7,12.0,,10,2,5,7,12.0,80,6.91,71,366,2385,11.6,0.34238696
13805,13805,John LeClair,1992-93,23.0,3,19,59,59,8,11,19,73.0,,69,10,16,26,85.0,80,6.96,77,402,2440,11.4,0.38445675
13806,13806,John LeClair,1993-94,24.0,4,44,72,72,19,25,44,139.0,,141,29,41,70,224.0,84,7.25,87,443,2603,11.7,0.5249972
13807,13807,John LeClair,1994-95,25.0,5,43,74,74,19,24,43,153.0,,215,48,65,113,377.0,84,6.48,76,407,2545,10.7,0.52987075
13808,13808,John LeClair,1995-96,26.0,6,54,46,46,26,28,54,131.0,,261,74,93,167,508.0,48,5.97,37,209,1408,10.2,1.0260391
13809,13809,John LeClair,1996-97,27.0,7,97,82,82,51,46,97,270.0,,343,125,139,264,778.0,82,6.29,74,413,2481,10.4,0.9570738
13810,13810,John LeClair,1997-98,28.0,8,97,82,82,50,47,97,324.0,,425,175,186,361,1102.0,82,5.83,55,336,2444,9.8,1.0028799
13811,13811,John LeClair,1998-99,29.0,9,87,82,82,51,36,87,303.0,,507,226,222,448,1405.0,82,5.28,57,380,2242,9.6,0.9993072
13812,13812,John LeClair,1999-00,30.0,10,90,76,76,43,47,90,246.0,1600.0,583,269,269,538,1651.0,82,5.27,57,359,2285,9.4,0.9863957
13813,13813,John LeClair,2000-01,31.0,11,77,82,82,40,37,77,249.0,1664.0,665,309,306,615,1900.0,82,5.49,53,331,2294,9.8,0.86815417
13814,13814,John LeClair,2001-02,32.0,12,12,16,16,7,5,12,48.0,306.0,681,316,311,627,1948.0,82,5.51,63,376,2272,9.9,0.578555
13815,13815,John LeClair,2002-03,33.0,13,51,82,82,25,26,51,220.0,1435.0,763,341,337,678,2168.0,82,5.24,53,338,2262,9.5,0.6348513
13816,13816,John LeClair,2003-04,34.0,14,28,35,35,18,10,28,99.0,565.0,798,359,347,706,2267.0,82,5.31,60,363,2326,9.4,0.61938846
13817,13817,John LeClair,2004-05,35.0,15,55,75,75,23,32,55,182.0,1207.0,873,382,379,761,2449.0,82,5.14,57,348,2300,9.2,0.68632513
13818,13818,John LeClair,2006-07,37.0,16,51,73,73,22,29,51,135.0,1150.0,946,404,408,812,2584.0,82,6.05,85,480,2458,10.1,0.5234418
13819,13819,John LeClair,2007-08,38.0,17,7,21,21,2,5,7,27.0,249.0,967,406,413,819,2611.0,82,5.76,70,398,2426,9.7,0.45498267
13820,13820,John Lilley,1994-95,22.0,2,7,13,13,1,6,7,20.0,,13,1,6,7,20.0,84,6.48,76,407,2545,10.7,0.2742526
13821,13821,John Lilley,1995-96,23.0,3,4,9,9,2,2,4,10.0,,22,3,8,11,30.0,48,5.97,37,209,1408,10.2,0.3101719
13822,13822,John Lilley,1996-97,24.0,4,0,1,1,0,0,0,0.0,,23,3,8,11,30.0,82,6.29,74,413,2481,10.4,0.16303769
13823,13823,John MacLean,1984-85,20.0,2,1,23,23,1,0,1,22.0,,23,1,0,1,22.0,80,7.89,74,336,2448,12.9,0.30169424
13824,13824,John MacLean,1985-86,21.0,3,33,61,61,13,20,33,97.0,,84,14,20,34,119.0,80,7.77,71,321,2447,12.7,0.56761205
13825,13825,John MacLean,1986-87,22.0,4,57,74,74,21,36,57,139.0,,158,35,56,91,258.0,80,7.94,82,370,2484,12.8,0.7196655
13826,13826,John MacLean,1987-88,23.0,5,67,80,80,31,36,67,197.0,,238,66,92,158,455.0,80,7.34,72,344,2400,12.2,0.8785203
13827,13827,John MacLean,1988-89,24.0,6,39,76,76,23,16,39,204.0,,314,89,108,197,659.0,80,7.43,89,437,2435,12.2,0.6549351
13828,13828,John MacLean,1989-90,25.0,7,87,74,74,42,45,87,266.0,,388,131,153,284,925.0,80,7.48,85,403,2430,12.3,1.067827
13829,13829,John MacLean,1990-91,26.0,8,79,80,80,41,38,79,322.0,,468,172,191,363,1247.0,80,7.37,76,367,2421,12.2,0.9699664
13830,13830,John MacLean,1991-92,27.0,9,78,78,78,45,33,78,292.0,,546,217,224,441,1539.0,80,6.91,71,366,2385,11.6,0.9042209
13831,13831,John MacLean,1993-94,29.0,10,48,80,80,24,24,48,195.0,,626,241,248,489,1734.0,84,7.25,87,443,2603,11.7,0.637515
13832,13832,John MacLean,1994-95,30.0,11,70,80,80,37,33,70,277.0,,706,278,281,559,2011.0,84,6.48,76,407,2545,10.7,0.76544595
13833,13833,John MacLean,1995-96,31.0,12,29,46,46,17,12,29,139.0,,752,295,293,588,2150.0,48,5.97,37,209,1408,10.2,0.66626287
13834,13834,John MacLean,1996-97,32.0,13,48,76,76,20,28,48,237.0,,828,315,321,636,2387.0,82,6.29,74,413,2481,10.4,0.601074
13835,13835,John MacLean,1997-98,33.0,14,54,80,80,29,25,54,254.0,,908,344,346,690,2641.0,82,5.83,55,336,2444,9.8,0.631214
13836,13836,John MacLean,1998-99,34.0,15,43,77,77,16,27,43,213.0,,985,360,373,733,2854.0,82,5.28,57,380,2242,9.6,0.5743495
13837,13837,John MacLean,1999-00,35.0,16,55,82,82,28,27,55,231.0,1699.0,1067,388,400,788,3085.0,82,5.27,57,359,2285,9.4,0.61485076
13838,13838,John MacLean,2000-01,36.0,17,42,77,77,18,24,42,158.0,1134.0,1144,406,424,830,3243.0,82,5.49,53,331,2294,9.8,0.4537606
13839,13839,John MacLean,2001-02,37.0,18,6,30,30,4,2,6,41.0,378.0,1174,410,426,836,3284.0,82,5.51,63,376,2272,9.9,0.38192388
13840,13840,John MacLean,2002-03,38.0,19,6,20,20,3,3,6,40.0,251.0,1194,413,429,842,3324.0,82,5.24,53,338,2262,9.5,0.47281662
13841,13841,John Madden,1999-00,26.0,2,1,4,4,0,1,1,4.0,37.0,4,0,1,1,4.0,82,5.27,57,359,2285,9.4,0.19371617
13842,13842,John Madden,2000-01,27.0,3,25,74,74,16,9,25,115.0,863.0,78,16,10,26,119.0,82,5.49,53,331,2294,9.8,0.345781
13843,13843,John Madden,2001-02,28.0,4,38,80,80,23,15,38,163.0,1247.0,158,39,25,64,282.0,82,5.51,63,376,2272,9.9,0.46284634
13844,13844,John Madden,2002-03,29.0,5,23,82,82,15,8,23,170.0,1280.0,240,54,33,87,452.0,82,5.24,53,338,2262,9.5,0.38904175
13845,13845,John Madden,2003-04,30.0,6,41,80,80,19,22,41,207.0,1465.0,320,73,55,128,659.0,82,5.31,60,363,2326,9.4,0.52838045
13846,13846,John Madden,2004-05,31.0,7,35,80,80,12,23,35,210.0,1382.0,400,85,78,163,869.0,82,5.14,57,348,2300,9.2,0.49161115
13847,13847,John Madden,2006-07,33.0,8,36,82,82,16,20,36,194.0,1557.0,482,101,98,199,1063.0,82,6.05,85,480,2458,10.1,0.46913478
13848,13848,John Madden,2007-08,34.0,9,32,74,74,12,20,32,153.0,1397.0,556,113,118,231,1216.0,82,5.76,70,398,2426,9.7,0.37797928
13849,13849,John Madden,2008-09,35.0,10,43,80,80,20,23,43,185.0,1556.0,636,133,141,274,1401.0,82,5.44,62,351,2383,9.4,0.49100247
13850,13850,John Madden,2009-10,36.0,11,23,76,76,7,16,23,132.0,1248.0,712,140,157,297,1533.0,82,5.7,65,341,2477,9.4,0.2626179
13851,13851,John Madden,2010-11,37.0,12,23,79,79,10,13,23,127.0,1217.0,791,150,170,320,1660.0,82,5.53,56,304,2486,9.1,0.23825449
13852,13852,John Madden,2011-12,38.0,13,25,76,76,12,13,25,107.0,1166.0,867,162,183,345,1767.0,82,5.46,52,291,2492,9.0,0.27663076
13853,13853,John Madden,2012-13,39.0,14,3,31,31,3,0,3,33.0,371.0,898,165,183,348,1800.0,82,5.32,47,271,2439,8.9,0.21564367
13854,13854,John Marino,2020-21,23.0,2,26,56,56,6,20,26,61.0,1134.0,56,6,20,26,61.0,70,5.96,42,208,2192,9.5,0.446068
13855,13855,John Markell,1980-81,24.0,2,17,38,38,10,7,17,46.0,,38,10,7,17,46.0,80,7.03,61,280,2352,12.0,0.40710303
13856,13856,John Markell,1981-82,25.0,3,4,14,14,1,3,4,11.0,,52,11,10,21,57.0,80,7.69,77,340,2441,12.6,0.26869777
13857,13857,John Markell,1984-85,28.0,4,0,2,2,0,0,0,0.0,,54,11,10,21,57.0,80,7.89,74,336,2448,12.9,0.19904378
13858,13858,John Markell,1985-86,29.0,5,0,1,1,0,0,0,0.0,,55,11,10,21,57.0,80,7.77,71,321,2447,12.7,0.18943268
13859,13859,John McCarthy,2010-11,24.0,2,0,4,4,0,0,0,3.0,37.0,4,0,0,0,3.0,82,5.53,56,304,2486,9.1,0.17076418
13860,13860,John McCarthy,2011-12,25.0,3,4,37,37,2,2,4,41.0,323.0,41,2,2,4,44.0,82,5.46,52,291,2492,9.0,0.17452818
13861,13861,John McCarthy,2012-13,26.0,4,0,10,10,0,0,0,14.0,94.0,51,2,2,4,58.0,82,5.32,47,271,2439,8.9,0.1513325
13862,13862,John McCarthy,2014-15,28.0,5,2,36,36,1,1,2,49.0,398.0,87,3,3,6,107.0,82,5.34,48,269,2463,8.9,0.15627348
13863,13863,John McCarthy,2016-17,30.0,6,0,1,1,0,0,0,0.0,7.0,88,3,3,6,107.0,82,5.34,48,255,2438,9.0,0.12689728
13864,13864,John McFarland,2016-17,24.0,2,0,3,3,0,0,0,2.0,30.0,3,0,0,0,2.0,82,5.34,48,255,2438,9.0,0.16909173
13865,13865,John McIntyre,1990-91,21.0,2,17,59,59,5,12,17,44.0,,59,5,12,17,44.0,80,7.37,76,367,2421,12.2,0.31407753
13866,13866,John McIntyre,1991-92,22.0,3,16,69,69,8,8,16,33.0,,128,13,20,33,77.0,80,6.91,71,366,2385,11.6,0.26919043
13867,13867,John McIntyre,1992-93,23.0,4,24,73,73,5,19,24,40.0,,201,18,39,57,117.0,80,6.96,77,402,2440,11.4,0.3036483
13868,13868,John McIntyre,1993-94,24.0,5,8,60,60,3,5,8,36.0,,261,21,44,65,153.0,84,7.25,87,443,2603,11.7,0.22906643
13869,13869,John McIntyre,1994-95,25.0,6,9,62,62,3,6,9,30.0,,323,24,50,74,183.0,84,6.48,76,407,2545,10.7,0.14134037
13870,13870,John McIntyre,1995-96,26.0,7,4,28,28,0,4,4,6.0,,351,24,54,78,189.0,48,5.97,37,209,1408,10.2,0.1823858
13871,13871,John Miner,1988-89,23.0,2,5,14,14,2,3,5,16.0,,14,2,3,5,16.0,80,7.43,89,437,2435,12.2,0.32519233
13872,13872,John Mitchell,2009-10,25.0,2,29,76,76,12,17,29,98.0,1049.0,76,12,17,29,98.0,82,5.7,65,341,2477,9.4,0.3722934
13873,13873,John Mitchell,2010-11,26.0,3,23,60,60,6,17,23,90.0,949.0,136,18,34,52,188.0,82,5.53,56,304,2486,9.1,0.3356263
13874,13874,John Mitchell,2011-12,27.0,4,3,23,23,2,1,3,28.0,288.0,159,20,35,55,216.0,82,5.46,52,291,2492,9.0,0.23754263
13875,13875,John Mitchell,2012-13,28.0,5,16,63,63,5,11,16,64.0,640.0,222,25,46,71,280.0,82,5.32,47,271,2439,8.9,0.25089827
13876,13876,John Mitchell,2013-14,29.0,6,20,47,47,10,10,20,72.0,787.0,269,35,56,91,352.0,48,5.31,29,160,1399,9.1,0.39026785
13877,13877,John Mitchell,2014-15,30.0,7,32,75,75,11,21,32,107.0,1220.0,344,46,77,123,459.0,82,5.34,48,269,2463,8.9,0.35919106
13878,13878,John Mitchell,2015-16,31.0,8,26,68,68,11,15,26,105.0,1078.0,412,57,92,149,564.0,82,5.32,47,251,2453,8.9,0.30885193
13879,13879,John Mitchell,2016-17,32.0,9,21,71,71,10,11,21,101.0,1082.0,483,67,103,170,665.0,82,5.34,48,255,2438,9.0,0.2851017
13880,13880,John Mitchell,2017-18,33.0,10,7,65,65,3,4,7,57.0,816.0,548,70,107,177,722.0,82,5.45,47,245,2478,9.0,0.1940903
13881,13881,John Mokosak,1989-90,26.0,2,1,8,8,0,1,1,0.0,,8,0,1,1,0.0,80,7.48,85,403,2430,12.3,0.18063867
13882,13882,John Mokosak,1990-91,27.0,3,1,33,33,0,1,1,15.0,,41,0,2,2,15.0,80,7.37,76,367,2421,12.2,0.11839935
13883,13883,John Moore,2011-12,21.0,2,0,2,2,0,0,0,0.0,23.0,2,0,0,0,0.0,82,5.46,52,291,2492,9.0,0.19211695
13884,13884,John Moore,2012-13,22.0,3,7,67,67,2,5,7,64.0,1060.0,69,2,5,7,64.0,82,5.32,47,271,2439,8.9,0.17964727
13885,13885,John Moore,2013-14,23.0,4,7,30,30,1,6,7,29.0,400.0,99,3,11,14,93.0,48,5.31,29,160,1399,9.1,0.23228839
13886,13886,John Moore,2014-15,24.0,5,15,74,74,4,11,15,115.0,1134.0,173,7,22,29,208.0,82,5.34,48,269,2463,8.9,0.21909177
13887,13887,John Moore,2015-16,25.0,6,11,57,57,2,9,11,77.0,929.0,230,9,31,40,285.0,82,5.32,47,251,2453,8.9,0.20588359
13888,13888,John Moore,2016-17,26.0,7,19,73,73,4,15,19,106.0,1448.0,303,13,46,59,391.0,82,5.34,48,255,2438,9.0,0.24071857
13889,13889,John Moore,2017-18,27.0,8,22,63,63,12,10,22,102.0,1196.0,366,25,56,81,493.0,82,5.45,47,245,2478,9.0,0.29974592
13890,13890,John Moore,2018-19,28.0,9,18,81,81,7,11,18,141.0,1621.0,447,32,67,99,634.0,82,5.86,50,250,2620,9.2,0.26920745
13891,13891,John Moore,2019-20,29.0,10,13,61,61,4,9,13,97.0,1145.0,508,36,76,112,731.0,82,5.96,47,239,2579,9.5,0.22067195
13892,13892,John Moore,2020-21,30.0,11,3,24,24,2,1,3,33.0,397.0,532,38,77,115,764.0,70,5.96,42,208,2192,9.5,0.21101266
13893,13893,John Negrin,2009-10,20.0,2,1,3,3,0,1,1,3.0,30.0,3,0,1,1,3.0,82,5.7,65,341,2477,9.4,0.26838222
13894,13894,John Newberry,1984-85,22.0,2,0,3,3,0,0,0,2.0,,3,0,0,0,2.0,80,7.89,74,336,2448,12.9,0.22890192
13895,13895,John Newberry,1985-86,23.0,3,4,16,16,0,4,4,13.0,,19,0,4,4,15.0,80,7.77,71,321,2447,12.7,0.23619744
13896,13896,John Newberry,1986-87,24.0,4,0,3,3,0,0,0,4.0,,22,0,4,4,19.0,80,7.94,82,370,2484,12.8,0.18684202
13897,13897,John Ogrodnick,1980-81,21.0,2,32,41,41,8,24,32,121.0,,41,8,24,32,121.0,80,7.03,61,280,2352,12.0,0.72365797
13898,13898,John Ogrodnick,1981-82,22.0,3,70,80,80,35,35,70,276.0,,121,43,59,102,397.0,80,7.69,77,340,2441,12.6,0.93623805
13899,13899,John Ogrodnick,1982-83,23.0,4,54,80,80,28,26,54,254.0,,201,71,85,156,651.0,80,8.03,73,320,2489,12.9,0.80705255
13900,13900,John Ogrodnick,1983-84,24.0,5,85,80,80,41,44,85,254.0,,281,112,129,241,905.0,80,7.73,71,310,2444,12.7,1.0794709
13901,13901,John Ogrodnick,1984-85,25.0,6,78,64,64,42,36,78,254.0,,345,154,165,319,1159.0,80,7.89,74,336,2448,12.9,1.1963687
13902,13902,John Ogrodnick,1985-86,26.0,7,105,79,79,55,50,105,301.0,,424,209,215,424,1460.0,80,7.77,71,321,2447,12.7,1.1619642
13903,13903,John Ogrodnick,1986-87,27.0,8,70,76,76,38,32,70,208.0,,500,247,247,494,1668.0,80,7.94,82,370,2484,12.8,0.83311164
13904,13904,John Ogrodnick,1987-88,28.0,9,67,71,71,23,44,67,246.0,,571,270,291,561,1914.0,80,7.34,72,344,2400,12.2,0.8755406
13905,13905,John Ogrodnick,1988-89,29.0,10,54,64,64,22,32,54,152.0,,635,292,323,615,2066.0,80,7.43,89,437,2435,12.2,0.76832587
13906,13906,John Ogrodnick,1989-90,30.0,11,42,60,60,13,29,42,149.0,,695,305,352,657,2215.0,80,7.48,85,403,2430,12.3,0.6789655
13907,13907,John Ogrodnick,1990-91,31.0,12,74,80,80,43,31,74,215.0,,775,348,383,731,2430.0,80,7.37,76,367,2421,12.2,0.78597
13908,13908,John Ogrodnick,1991-92,32.0,13,54,79,79,31,23,54,250.0,,854,379,406,785,2680.0,80,6.91,71,366,2385,11.6,0.6802247
13909,13909,John Ogrodnick,1992-93,33.0,14,30,55,55,17,13,30,110.0,,909,396,419,815,2790.0,80,6.96,77,402,2440,11.4,0.5487887
13910,13910,John Ogrodnick,1993-94,34.0,15,12,19,19,6,6,12,25.0,,928,402,425,827,2815.0,84,7.25,87,443,2603,11.7,0.45895284
13911,13911,John Paul Kelly,1980-81,21.0,2,7,40,40,2,5,7,31.0,,40,2,5,7,31.0,80,7.03,61,280,2352,12.0,0.27985978
13912,13912,John Paul Kelly,1981-82,22.0,3,9,19,19,3,6,9,18.0,,59,5,11,16,49.0,80,7.69,77,340,2441,12.6,0.3439408
13913,13913,John Paul Kelly,1982-83,23.0,4,23,70,70,12,11,23,92.0,,129,17,22,39,141.0,80,8.03,73,320,2489,12.9,0.35874328
13914,13914,John Paul Kelly,1983-84,24.0,5,31,65,65,16,15,31,103.0,,194,33,37,70,244.0,80,7.73,71,310,2444,12.7,0.45099503
13915,13915,John Paul Kelly,1984-85,25.0,6,21,72,72,7,14,21,87.0,,266,40,51,91,331.0,80,7.89,74,336,2448,12.9,0.30295068
13916,13916,John Paul Kelly,1985-86,26.0,7,18,73,73,8,10,18,71.0,,339,48,61,109,402.0,80,7.77,71,321,2447,12.7,0.2792119
13917,13917,John Paul Kelly,1986-87,27.0,8,15,61,61,6,9,15,38.0,,400,54,70,124,440.0,80,7.94,82,370,2484,12.8,0.25795463
13918,13918,John Persson,2014-15,22.0,2,1,10,10,1,0,1,16.0,120.0,10,1,0,1,16.0,82,5.34,48,269,2463,8.9,0.22792634
13919,13919,John Pohl,2004-05,25.0,2,0,1,1,0,0,0,1.0,8.0,1,0,0,0,1.0,82,5.14,57,348,2300,9.2,0.30078804
13920,13920,John Pohl,2006-07,27.0,3,4,7,7,3,1,4,17.0,89.0,8,3,1,4,18.0,82,6.05,85,480,2458,10.1,0.24943
13921,13921,John Pohl,2007-08,28.0,4,29,74,74,13,16,29,105.0,840.0,82,16,17,33,123.0,82,5.76,70,398,2426,9.7,0.3439056
13922,13922,John Pohl,2008-09,29.0,5,5,33,33,1,4,5,23.0,234.0,115,17,21,38,146.0,82,5.44,62,351,2383,9.4,0.20915076
13923,13923,John Purves,1991-92,23.0,2,1,7,7,1,0,1,8.0,,7,1,0,1,8.0,80,6.91,71,366,2385,11.6,0.24949762
13924,13924,John Quenneville,2017-18,21.0,2,4,12,12,1,3,4,21.0,164.0,12,1,3,4,21.0,82,5.45,47,245,2478,9.0,0.30469513
13925,13925,John Quenneville,2018-19,22.0,3,0,2,2,0,0,0,5.0,27.0,14,1,3,4,26.0,82,5.86,50,250,2620,9.2,0.17201462
13926,13926,John Quenneville,2019-20,23.0,4,1,19,19,1,0,1,16.0,215.0,33,2,3,5,42.0,82,5.96,47,239,2579,9.5,0.19156972
13927,13927,John Quenneville,2020-21,24.0,5,0,9,9,0,0,0,14.0,99.0,42,2,3,5,56.0,70,5.96,42,208,2192,9.5,0.17487371
13928,13928,John Ramage,2015-16,24.0,2,0,1,1,0,0,0,4.0,18.0,1,0,0,0,4.0,82,5.32,47,251,2453,8.9,0.16720265
13929,13929,John Ramage,2016-17,25.0,3,0,1,1,0,0,0,0.0,14.0,2,0,0,0,4.0,82,5.34,48,255,2438,9.0,0.14962992
13930,13930,John Scott,2009-10,27.0,2,1,20,20,0,1,1,6.0,185.0,20,0,1,1,6.0,82,5.7,65,341,2477,9.4,0.13033548
13931,13931,John Scott,2010-11,28.0,3,2,51,51,1,1,2,22.0,439.0,71,1,2,3,28.0,82,5.53,56,304,2486,9.1,0.08949885
13932,13932,John Scott,2011-12,29.0,4,1,40,40,0,1,1,15.0,250.0,111,1,3,4,43.0,82,5.46,52,291,2492,9.0,0.07405689
13933,13933,John Scott,2012-13,30.0,5,1,35,35,0,1,1,9.0,235.0,146,1,4,5,52.0,82,5.32,47,271,2439,8.9,0.06397861
13934,13934,John Scott,2013-14,31.0,6,0,34,34,0,0,0,15.0,185.0,180,1,4,5,67.0,48,5.31,29,160,1399,9.1,0.07560697
13935,13935,John Scott,2014-15,32.0,7,1,56,56,1,0,1,16.0,378.0,236,2,4,6,83.0,82,5.34,48,269,2463,8.9,0.06453243
13936,13936,John Scott,2015-16,33.0,8,4,38,38,3,1,4,19.0,283.0,274,5,5,10,102.0,82,5.32,47,251,2453,8.9,0.11111221
13937,13937,John Scott,2016-17,34.0,9,1,12,12,0,1,1,6.0,78.0,286,5,6,11,108.0,82,5.34,48,255,2438,9.0,0.1100561
13938,13938,John Slaney,1994-95,22.0,2,16,47,47,7,9,16,70.0,,47,7,9,16,70.0,84,6.48,76,407,2545,10.7,0.35136986
13939,13939,John Slaney,1995-96,23.0,3,3,16,16,0,3,3,21.0,,63,7,12,19,91.0,48,5.97,37,209,1408,10.2,0.28092512
13940,13940,John Slaney,1996-97,24.0,4,20,38,38,6,14,20,75.0,,101,13,26,39,166.0,82,6.29,74,413,2481,10.4,0.41900232
13941,13941,John Slaney,1997-98,25.0,5,14,32,32,3,11,14,60.0,,133,16,37,53,226.0,82,5.83,55,336,2444,9.8,0.27488303
13942,13942,John Slaney,1998-99,26.0,6,17,55,55,3,14,17,74.0,,188,19,51,70,300.0,82,5.28,57,380,2242,9.6,0.30377603
13943,13943,John Slaney,1999-00,27.0,7,14,46,46,2,12,14,84.0,950.0,234,21,63,84,384.0,82,5.27,57,359,2285,9.4,0.26136965
13944,13944,John Slaney,2000-01,28.0,8,5,29,29,1,4,5,27.0,354.0,263,22,67,89,411.0,82,5.49,53,331,2294,9.8,0.21195674
13945,13945,John Slaney,2002-03,30.0,9,0,1,1,0,0,0,1.0,24.0,264,22,67,89,412.0,82,5.24,53,338,2262,9.5,0.26883423
13946,13946,John Slaney,2004-05,32.0,10,2,4,4,0,2,2,0.0,55.0,268,22,69,91,412.0,82,5.14,57,348,2300,9.2,0.2869606
13947,13947,John Stevens,1987-88,21.0,2,2,6,6,0,2,2,2.0,,6,0,2,2,2.0,80,7.34,72,344,2400,12.2,0.28105468
13948,13948,John Stevens,1988-89,22.0,3,0,3,3,0,0,0,0.0,,9,0,2,2,2.0,80,7.43,89,437,2435,12.2,0.18832695
13949,13949,John Stevens,1991-92,25.0,4,1,14,14,0,1,1,7.0,,23,0,3,3,9.0,80,6.91,71,366,2385,11.6,0.17819798
13950,13950,John Stevens,1992-93,26.0,5,4,21,21,0,4,4,13.0,,44,0,7,7,22.0,80,6.96,77,402,2440,11.4,0.16955656
13951,13951,John Stevens,1994-95,28.0,6,3,9,9,0,3,3,3.0,,53,0,10,10,25.0,84,6.48,76,407,2545,10.7,0.14990443
13952,13952,John Stewart,1980-81,27.0,2,0,2,2,0,0,0,4.0,,2,0,0,0,4.0,80,7.03,61,280,2352,12.0,0.21991226
13953,13953,John Tavares,2010-11,20.0,2,54,82,82,24,30,54,186.0,1477.0,82,24,30,54,186.0,82,5.53,56,304,2486,9.1,0.7255943
13954,13954,John Tavares,2011-12,21.0,3,67,79,79,29,38,67,243.0,1521.0,161,53,68,121,429.0,82,5.46,52,291,2492,9.0,0.8535424
13955,13955,John Tavares,2012-13,22.0,4,81,82,82,31,50,81,286.0,1687.0,243,84,118,202,715.0,82,5.32,47,271,2439,8.9,1.002725
13956,13956,John Tavares,2013-14,23.0,5,47,48,48,28,19,47,162.0,997.0,291,112,137,249,877.0,48,5.31,29,160,1399,9.1,1.0280664
13957,13957,John Tavares,2014-15,24.0,6,66,59,59,24,42,66,188.0,1253.0,350,136,179,315,1065.0,82,5.34,48,269,2463,8.9,1.0226734
13958,13958,John Tavares,2015-16,25.0,7,86,82,82,38,48,86,278.0,1695.0,432,174,227,401,1343.0,82,5.32,47,251,2453,8.9,1.0057139
13959,13959,John Tavares,2016-17,26.0,8,70,78,78,33,37,70,250.0,1560.0,510,207,264,471,1593.0,82,5.34,48,255,2438,9.0,0.93646526
13960,13960,John Tavares,2017-18,27.0,9,66,77,77,28,38,66,260.0,1572.0,587,235,302,537,1853.0,82,5.45,47,245,2478,9.0,0.8751339
13961,13961,John Tavares,2018-19,28.0,10,84,82,82,37,47,84,257.0,1634.0,669,272,349,621,2110.0,82,5.86,50,250,2620,9.2,0.9732122
13962,13962,John Tavares,2019-20,29.0,11,88,82,82,47,41,88,286.0,1565.0,751,319,390,709,2396.0,82,5.96,47,239,2579,9.5,0.9694495
13963,13963,John Tavares,2020-21,30.0,12,60,63,63,26,34,60,197.0,1232.0,814,345,424,769,2593.0,70,5.96,42,208,2192,9.5,0.9691439
13964,13964,John Tripp,2003-04,26.0,2,3,9,9,1,2,3,16.0,79.0,9,1,2,3,16.0,82,5.31,60,363,2326,9.4,0.22454324
13965,13965,John Tripp,2004-05,27.0,3,6,34,34,1,5,6,45.0,275.0,43,2,7,9,61.0,82,5.14,57,348,2300,9.2,0.18921593
13966,13966,John Tucker,1984-85,20.0,2,16,21,21,12,4,16,40.0,,21,12,4,16,40.0,80,7.89,74,336,2448,12.9,0.6427293
13967,13967,John Tucker,1985-86,21.0,3,49,64,64,22,27,49,112.0,,85,34,31,65,152.0,80,7.77,71,321,2447,12.7,0.76136
13968,13968,John Tucker,1986-87,22.0,4,65,75,75,31,34,65,146.0,,160,65,65,130,298.0,80,7.94,82,370,2484,12.8,0.83663607
13969,13969,John Tucker,1987-88,23.0,5,51,54,54,17,34,51,104.0,,214,82,99,181,402.0,80,7.34,72,344,2400,12.2,0.8886746
13970,13970,John Tucker,1988-89,24.0,6,38,45,45,19,19,38,93.0,,259,101,118,219,495.0,80,7.43,89,437,2435,12.2,0.75377905
13971,13971,John Tucker,1989-90,25.0,7,44,60,60,13,31,44,94.0,,319,114,149,263,589.0,80,7.48,85,403,2430,12.3,0.60340554
13972,13972,John Tucker,1990-91,26.0,8,31,46,46,10,21,31,69.0,,365,124,170,294,658.0,80,7.37,76,367,2421,12.2,0.59913504
13973,13973,John Tucker,1991-92,27.0,9,11,38,38,4,7,11,35.0,,403,128,177,305,693.0,80,6.91,71,366,2385,11.6,0.392077
13974,13974,John Tucker,1993-94,29.0,10,56,78,78,17,39,56,179.0,,481,145,216,361,872.0,84,7.25,87,443,2603,11.7,0.6233988
13975,13975,John Tucker,1994-95,30.0,11,40,66,66,17,23,40,126.0,,547,162,239,401,998.0,84,6.48,76,407,2545,10.7,0.5310897
13976,13976,John Tucker,1995-96,31.0,12,25,46,46,12,13,25,81.0,,593,174,252,426,1079.0,48,5.97,37,209,1408,10.2,0.50134003
13977,13977,John Tucker,1996-97,32.0,13,10,63,63,3,7,10,53.0,,656,177,259,436,1132.0,82,6.29,74,413,2481,10.4,0.21392524
13978,13978,John Zeiler,2007-08,25.0,2,3,23,23,1,2,3,12.0,198.0,23,1,2,3,12.0,82,5.76,70,398,2426,9.7,0.13615176
13979,13979,John Zeiler,2008-09,26.0,3,1,36,36,0,1,1,18.0,305.0,59,1,3,4,30.0,82,5.44,62,351,2383,9.4,0.11395109
13980,13980,John Zeiler,2009-10,27.0,4,1,27,27,0,1,1,3.0,177.0,86,1,4,5,33.0,82,5.7,65,341,2477,9.4,0.09369978
13981,13981,John Zeiler,2011-12,29.0,5,0,4,4,0,0,0,1.0,22.0,90,1,4,5,34.0,82,5.46,52,291,2492,9.0,0.1141257
13982,13982,John-Michael Liles,2004-05,24.0,2,34,79,79,10,24,34,115.0,1282.0,79,10,24,34,115.0,82,5.14,57,348,2300,9.2,0.4544734
13983,13983,John-Michael Liles,2006-07,26.0,3,49,82,82,14,35,49,154.0,1519.0,161,24,59,83,269.0,82,6.05,85,480,2458,10.1,0.5575931
13984,13984,John-Michael Liles,2007-08,27.0,4,44,71,71,14,30,44,128.0,1261.0,232,38,89,127,397.0,82,5.76,70,398,2426,9.7,0.52841884
13985,13985,John-Michael Liles,2008-09,28.0,5,32,81,81,6,26,32,163.0,1593.0,313,44,115,159,560.0,82,5.44,62,351,2383,9.4,0.48352876
13986,13986,John-Michael Liles,2009-10,29.0,6,39,75,75,12,27,39,146.0,1616.0,388,56,142,198,706.0,82,5.7,65,341,2477,9.4,0.4871206
13987,13987,John-Michael Liles,2010-11,30.0,7,31,59,59,6,25,31,96.0,1089.0,447,62,167,229,802.0,82,5.53,56,304,2486,9.1,0.4736699
13988,13988,John-Michael Liles,2011-12,31.0,8,46,76,76,6,40,46,163.0,1673.0,523,68,207,275,965.0,82,5.46,52,291,2492,9.0,0.5055005
13989,13989,John-Michael Liles,2012-13,32.0,9,27,66,66,7,20,27,106.0,1409.0,589,75,227,302,1071.0,82,5.32,47,271,2439,8.9,0.3509602
13990,13990,John-Michael Liles,2013-14,33.0,10,11,32,32,2,9,11,47.0,601.0,621,77,236,313,1118.0,48,5.31,29,160,1399,9.1,0.32884824
13991,13991,John-Michael Liles,2014-15,34.0,11,9,41,41,2,7,9,56.0,806.0,662,79,243,322,1174.0,82,5.34,48,269,2463,8.9,0.19374925
13992,13992,John-Michael Liles,2015-16,35.0,12,22,57,57,2,20,22,90.0,1091.0,719,81,263,344,1264.0,82,5.32,47,251,2453,8.9,0.30169356
13993,13993,John-Michael Liles,2016-17,36.0,13,21,81,81,6,15,21,111.0,1645.0,800,87,278,365,1375.0,82,5.34,48,255,2438,9.0,0.26760465
13994,13994,John-Michael Liles,2017-18,37.0,14,5,36,36,0,5,5,36.0,583.0,836,87,283,370,1411.0,82,5.45,47,245,2478,9.0,0.16335613
13995,13995,Johnathan Aitken,2000-01,22.0,2,0,3,3,0,0,0,2.0,57.0,3,0,0,0,2.0,82,5.49,53,331,2294,9.8,0.1732291
13996,13996,Johnathan Aitken,2004-05,26.0,3,1,41,41,0,1,1,37.0,707.0,44,0,1,1,39.0,82,5.14,57,348,2300,9.2,0.13452119
13997,13997,Johnny Boychuk,2008-09,25.0,2,0,4,4,0,0,0,3.0,36.0,4,0,0,0,3.0,82,5.44,62,351,2383,9.4,0.170028
13998,13998,Johnny Boychuk,2009-10,26.0,3,0,1,1,0,0,0,0.0,15.0,5,0,0,0,3.0,82,5.7,65,341,2477,9.4,0.15453216
13999,13999,Johnny Boychuk,2010-11,27.0,4,15,51,51,5,10,15,96.0,901.0,56,5,10,15,99.0,82,5.53,56,304,2486,9.1,0.28561473
14000,14000,Johnny Boychuk,2011-12,28.0,5,16,69,69,3,13,16,154.0,1415.0,125,8,23,31,253.0,82,5.46,52,291,2492,9.0,0.22699204
14001,14001,Johnny Boychuk,2012-13,29.0,6,15,77,77,5,10,15,171.0,1587.0,202,13,33,46,424.0,82,5.32,47,271,2439,8.9,0.23801148
14002,14002,Johnny Boychuk,2013-14,30.0,7,6,44,44,1,5,6,75.0,898.0,246,14,38,52,499.0,48,5.31,29,160,1399,9.1,0.18834886
14003,14003,Johnny Boychuk,2014-15,31.0,8,23,75,75,5,18,23,142.0,1589.0,321,19,56,75,641.0,82,5.34,48,269,2463,8.9,0.26096398
14004,14004,Johnny Boychuk,2015-16,32.0,9,35,72,72,9,26,35,192.0,1561.0,393,28,82,110,833.0,82,5.32,47,251,2453,8.9,0.41175276
14005,14005,Johnny Boychuk,2016-17,33.0,10,25,70,70,9,16,25,165.0,1496.0,463,37,98,135,998.0,82,5.34,48,255,2438,9.0,0.3080412
14006,14006,Johnny Boychuk,2017-18,34.0,11,23,66,66,6,17,23,155.0,1368.0,529,43,115,158,1153.0,82,5.45,47,245,2478,9.0,0.30132812
14007,14007,Johnny Boychuk,2018-19,35.0,12,18,58,58,6,12,18,141.0,1171.0,587,49,127,176,1294.0,82,5.86,50,250,2620,9.2,0.3016109
14008,14008,Johnny Boychuk,2019-20,36.0,13,19,74,74,3,16,19,157.0,1393.0,661,52,143,195,1451.0,82,5.96,47,239,2579,9.5,0.26279593
14009,14009,Johnny Boychuk,2020-21,37.0,14,11,64,64,2,9,11,96.0,1106.0,725,54,152,206,1547.0,70,5.96,42,208,2192,9.5,0.194776
14010,14010,Johnny Gaudreau,2014-15,21.0,2,1,1,1,1,0,1,1.0,15.0,1,1,0,1,1.0,82,5.34,48,269,2463,8.9,0.2938677
14011,14011,Johnny Gaudreau,2015-16,22.0,3,64,80,80,24,40,64,167.0,1417.0,81,25,40,65,168.0,82,5.32,47,251,2453,8.9,0.7430371
14012,14012,Johnny Gaudreau,2016-17,23.0,4,78,79,79,30,48,78,217.0,1575.0,160,55,88,143,385.0,82,5.34,48,255,2438,9.0,0.91063154
14013,14013,Johnny Gaudreau,2017-18,24.0,5,61,72,72,18,43,61,182.0,1331.0,232,73,131,204,567.0,82,5.45,47,245,2478,9.0,0.85404456
14014,14014,Johnny Gaudreau,2018-19,25.0,6,84,80,80,24,60,84,227.0,1554.0,312,97,191,288,794.0,82,5.86,50,250,2620,9.2,1.0515789
14015,14015,Johnny Gaudreau,2019-20,26.0,7,99,82,82,36,63,99,245.0,1646.0,394,133,254,387,1039.0,82,5.96,47,239,2579,9.5,1.0253456
14016,14016,Johnny Gaudreau,2020-21,27.0,8,58,70,70,18,40,58,209.0,1315.0,464,151,294,445,1248.0,70,5.96,42,208,2192,9.5,0.8601426
14017,14017,Johnny Oduya,2007-08,26.0,2,11,76,76,2,9,11,55.0,1407.0,76,2,9,11,55.0,82,5.76,70,398,2426,9.7,0.16119683
14018,14018,Johnny Oduya,2008-09,27.0,3,26,75,75,6,20,26,63.0,1427.0,151,8,29,37,118.0,82,5.44,62,351,2383,9.4,0.28617063
14019,14019,Johnny Oduya,2009-10,28.0,4,29,82,82,7,22,29,108.0,1712.0,233,15,51,66,226.0,82,5.7,65,341,2477,9.4,0.31461912
14020,14020,Johnny Oduya,2010-11,29.0,5,13,67,67,3,10,13,68.0,1424.0,300,18,61,79,294.0,82,5.53,56,304,2486,9.1,0.17902854
14021,14021,Johnny Oduya,2011-12,30.0,6,17,82,82,2,15,17,90.0,1699.0,382,20,76,96,384.0,82,5.46,52,291,2492,9.0,0.22497827
14022,14022,Johnny Oduya,2012-13,31.0,7,18,81,81,3,15,18,82.0,1657.0,463,23,91,114,466.0,82,5.32,47,271,2439,8.9,0.23476076
14023,14023,Johnny Oduya,2013-14,32.0,8,12,48,48,3,9,12,52.0,985.0,511,26,100,126,518.0,48,5.31,29,160,1399,9.1,0.24403262
14024,14024,Johnny Oduya,2014-15,33.0,9,16,77,77,3,13,16,83.0,1548.0,588,29,113,142,601.0,82,5.34,48,269,2463,8.9,0.1938754
14025,14025,Johnny Oduya,2015-16,34.0,10,10,76,76,2,8,10,76.0,1542.0,664,31,121,152,677.0,82,5.32,47,251,2453,8.9,0.17798173
14026,14026,Johnny Oduya,2016-17,35.0,11,21,82,82,4,17,21,63.0,1671.0,746,35,138,173,740.0,82,5.34,48,255,2438,9.0,0.19961345
14027,14027,Johnny Oduya,2017-18,36.0,12,9,52,52,2,7,9,37.0,950.0,798,37,145,182,777.0,82,5.45,47,245,2478,9.0,0.12754819
14028,14028,Johnny Oduya,2018-19,37.0,13,8,52,52,4,4,8,59.0,890.0,850,41,149,190,836.0,82,5.86,50,250,2620,9.2,0.14247659
14029,14029,Jon DiSalvatore,2006-07,25.0,2,0,5,5,0,0,0,3.0,42.0,5,0,0,0,3.0,82,6.05,85,480,2458,10.1,0.16539437
14030,14030,Jon DiSalvatore,2012-13,31.0,3,0,1,1,0,0,0,2.0,14.0,6,0,0,0,5.0,82,5.32,47,271,2439,8.9,0.14871338
14031,14031,Jon Fontas,1980-81,25.0,2,0,1,1,0,0,0,0.0,,1,0,0,0,0.0,80,7.03,61,280,2352,12.0,0.18752244
14032,14032,Jon Fontas,1981-82,26.0,3,0,1,1,0,0,0,0.0,,2,0,0,0,0.0,80,7.69,77,340,2441,12.6,0.17794076
14033,14033,Jon Kalinski,2009-10,22.0,2,3,12,12,1,2,3,7.0,91.0,12,1,2,3,7.0,82,5.7,65,341,2477,9.4,0.21107471
14034,14034,Jon Kalinski,2010-11,23.0,3,2,10,10,0,2,2,9.0,70.0,22,1,4,5,16.0,82,5.53,56,304,2486,9.1,0.18726766
14035,14035,Jon Klemm,1992-93,23.0,2,1,4,4,0,1,1,2.0,,4,0,1,1,2.0,80,6.96,77,402,2440,11.4,0.23771632
14036,14036,Jon Klemm,1994-95,25.0,3,0,7,7,0,0,0,11.0,,11,0,1,1,13.0,84,6.48,76,407,2545,10.7,0.18033752
14037,14037,Jon Klemm,1995-96,26.0,4,1,4,4,1,0,1,5.0,,15,1,1,2,18.0,48,5.97,37,209,1408,10.2,0.20244086
14038,14038,Jon Klemm,1996-97,27.0,5,15,56,56,3,12,15,61.0,,71,4,13,17,79.0,82,6.29,74,413,2481,10.4,0.22189614
14039,14039,Jon Klemm,1997-98,28.0,6,24,80,80,9,15,24,103.0,,151,13,28,41,182.0,82,5.83,55,336,2444,9.8,0.24910909
14040,14040,Jon Klemm,1998-99,29.0,7,14,67,67,6,8,14,60.0,,218,19,36,55,242.0,82,5.28,57,380,2242,9.6,0.19977182
14041,14041,Jon Klemm,1999-00,30.0,8,3,39,39,1,2,3,28.0,535.0,257,20,38,58,270.0,82,5.27,57,359,2285,9.4,0.15147305
14042,14042,Jon Klemm,2000-01,31.0,9,12,73,73,5,7,12,64.0,1267.0,330,25,45,70,334.0,82,5.49,53,331,2294,9.8,0.1733059
14043,14043,Jon Klemm,2001-02,32.0,10,15,78,78,4,11,15,97.0,1554.0,408,29,56,85,431.0,82,5.51,63,376,2272,9.9,0.19460532
14044,14044,Jon Klemm,2002-03,33.0,11,20,82,82,4,16,20,111.0,1955.0,490,33,72,105,542.0,82,5.24,53,338,2262,9.5,0.23380142
14045,14045,Jon Klemm,2003-04,34.0,12,16,70,70,2,14,16,74.0,1537.0,560,35,86,121,616.0,82,5.31,60,363,2326,9.4,0.20304951
14046,14046,Jon Klemm,2004-05,35.0,13,7,77,77,2,5,7,71.0,1333.0,637,37,91,128,687.0,82,5.14,57,348,2300,9.2,0.13864657
14047,14047,Jon Klemm,2006-07,37.0,14,11,76,76,4,7,11,57.0,1287.0,713,41,98,139,744.0,82,6.05,85,480,2458,10.1,0.117129534
14048,14048,Jon Klemm,2007-08,38.0,15,3,38,38,1,2,3,25.0,496.0,751,42,100,142,769.0,82,5.76,70,398,2426,9.7,0.10199565
14049,14049,Jon Klemm,2008-09,39.0,16,0,22,22,0,0,0,6.0,241.0,773,42,100,142,775.0,82,5.44,62,351,2383,9.4,0.095736325
14050,14050,Jon Matsumoto,2011-12,25.0,2,2,13,13,2,0,2,11.0,92.0,13,2,0,2,11.0,82,5.46,52,291,2492,9.0,0.21181622
14051,14051,Jon Matsumoto,2012-13,26.0,3,0,1,1,0,0,0,0.0,5.0,14,2,0,2,11.0,82,5.32,47,271,2439,8.9,0.1433017
14052,14052,Jon Morris,1989-90,23.0,2,2,4,4,0,2,2,1.0,,4,0,2,2,1.0,80,7.48,85,403,2430,12.3,0.25773853
14053,14053,Jon Morris,1990-91,24.0,3,13,20,20,6,7,13,17.0,,24,6,9,15,18.0,80,7.37,76,367,2421,12.2,0.40816295
14054,14054,Jon Morris,1991-92,25.0,4,28,53,53,9,19,28,44.0,,77,15,28,43,62.0,80,6.91,71,366,2385,11.6,0.40280536
14055,14055,Jon Morris,1992-93,26.0,5,3,7,7,1,2,3,5.0,,84,16,30,46,67.0,80,6.96,77,402,2440,11.4,0.26173037
14056,14056,Jon Morris,1993-94,27.0,6,3,15,15,0,3,3,12.0,,99,16,33,49,79.0,84,7.25,87,443,2603,11.7,0.24357122
14057,14057,Jon Morris,1994-95,28.0,7,0,4,4,0,0,0,3.0,,103,16,33,49,82.0,84,6.48,76,407,2545,10.7,0.18965134
14058,14058,Jon Rheault,2013-14,27.0,2,0,5,5,0,0,0,5.0,53.0,5,0,0,0,5.0,48,5.31,29,160,1399,9.1,0.1943996
14059,14059,Jon Rohloff,1995-96,26.0,2,11,34,34,3,8,11,51.0,,34,3,8,11,51.0,48,5.97,37,209,1408,10.2,0.2778302
14060,14060,Jon Rohloff,1996-97,27.0,3,13,79,79,1,12,13,106.0,,113,4,20,24,157.0,82,6.29,74,413,2481,10.4,0.19376016
14061,14061,Jon Rohloff,1997-98,28.0,4,8,37,37,3,5,8,69.0,,150,7,25,32,226.0,82,5.83,55,336,2444,9.8,0.2128641
14062,14062,Jon Sim,1999-00,22.0,2,1,7,7,1,0,1,8.0,80.0,7,1,0,1,8.0,82,5.27,57,359,2285,9.4,0.23059416
14063,14063,Jon Sim,2000-01,23.0,3,8,25,25,5,3,8,44.0,271.0,32,6,3,9,52.0,82,5.49,53,331,2294,9.8,0.2997393
14064,14064,Jon Sim,2001-02,24.0,4,3,15,15,0,3,3,18.0,132.0,47,6,6,12,70.0,82,5.51,63,376,2272,9.9,0.1919057
14065,14065,Jon Sim,2002-03,25.0,5,3,26,26,3,0,3,43.0,247.0,73,9,6,15,113.0,82,5.24,53,338,2262,9.5,0.21102494
14066,14066,Jon Sim,2003-04,26.0,6,3,22,22,1,2,3,39.0,243.0,95,10,8,18,152.0,82,5.31,60,363,2326,9.4,0.1982269
14067,14067,Jon Sim,2004-05,27.0,7,18,63,63,8,10,18,100.0,686.0,158,18,18,36,252.0,82,5.14,57,348,2300,9.2,0.28841096
14068,14068,Jon Sim,2006-07,29.0,8,32,72,72,17,15,32,172.0,840.0,230,35,33,68,424.0,82,6.05,85,480,2458,10.1,0.44024786
14069,14069,Jon Sim,2007-08,30.0,9,29,77,77,17,12,29,141.0,904.0,307,52,45,97,565.0,82,5.76,70,398,2426,9.7,0.35841143
14070,14070,Jon Sim,2008-09,31.0,10,1,2,2,0,1,1,8.0,29.0,309,52,46,98,573.0,82,5.44,62,351,2383,9.4,0.23781145
14071,14071,Jon Sim,2009-10,32.0,11,15,49,49,9,6,15,90.0,596.0,358,61,52,113,663.0,82,5.7,65,341,2477,9.4,0.2826848
14072,14072,Jon Sim,2010-11,33.0,12,22,77,77,13,9,22,128.0,897.0,435,74,61,135,791.0,82,5.53,56,304,2486,9.1,0.25179228
14073,14073,Jon Sim,2011-12,34.0,13,4,34,34,1,3,4,38.0,388.0,469,75,64,139,829.0,82,5.46,52,291,2492,9.0,0.17078799
14074,14074,Jonas Andersson,2002-03,21.0,2,0,5,5,0,0,0,4.0,46.0,5,0,0,0,4.0,82,5.24,53,338,2262,9.5,0.1963087
14075,14075,Jonas Andersson,2011-12,30.0,3,0,4,4,0,0,0,1.0,24.0,9,0,0,0,5.0,82,5.46,52,291,2492,9.0,0.16188526
14076,14076,Jonas Bergqvist,1990-91,28.0,2,7,22,22,2,5,7,30.0,,22,2,5,7,30.0,80,7.37,76,367,2421,12.2,0.32931188
14077,14077,Jonas Brodin,2013-14,20.0,2,11,45,45,2,9,11,51.0,1045.0,45,2,9,11,51.0,48,5.31,29,160,1399,9.1,0.30144227
14078,14078,Jonas Brodin,2014-15,21.0,3,19,79,79,8,11,19,74.0,1888.0,124,10,20,30,125.0,82,5.34,48,269,2463,8.9,0.33424693
14079,14079,Jonas Brodin,2015-16,22.0,4,17,71,71,3,14,17,95.0,1716.0,195,13,34,47,220.0,82,5.32,47,251,2453,8.9,0.2619092
14080,14080,Jonas Brodin,2016-17,23.0,5,7,68,68,2,5,7,58.0,1389.0,263,15,39,54,278.0,82,5.34,48,255,2438,9.0,0.22339627
14081,14081,Jonas Brodin,2017-18,24.0,6,25,68,68,3,22,25,85.0,1331.0,331,18,61,79,363.0,82,5.45,47,245,2478,9.0,0.30707854
14082,14082,Jonas Brodin,2018-19,25.0,7,21,73,73,6,15,21,77.0,1577.0,404,24,76,100,440.0,82,5.86,50,250,2620,9.2,0.28775746
14083,14083,Jonas Brodin,2019-20,26.0,8,18,82,82,4,14,18,111.0,1685.0,486,28,90,118,551.0,82,5.96,47,239,2579,9.5,0.2719372
14084,14084,Jonas Brodin,2020-21,27.0,9,28,69,69,2,26,28,103.0,1487.0,555,30,116,146,654.0,70,5.96,42,208,2192,9.5,0.35100764
14085,14085,Jonas Frogren,2009-10,29.0,2,7,41,41,1,6,7,12.0,551.0,41,1,6,7,12.0,82,5.7,65,341,2477,9.4,0.133778
14086,14086,Jonas Hoglund,1997-98,25.0,2,35,68,68,19,16,35,189.0,,68,19,16,35,189.0,82,5.83,55,336,2444,9.8,0.49426165
14087,14087,Jonas Hoglund,1998-99,26.0,3,25,78,78,12,13,25,186.0,,146,31,29,60,375.0,82,5.28,57,380,2242,9.6,0.39439234
14088,14088,Jonas Hoglund,1999-00,27.0,4,18,74,74,8,10,18,122.0,876.0,220,39,39,78,497.0,82,5.27,57,359,2285,9.4,0.35420853
14089,14089,Jonas Hoglund,2000-01,28.0,5,56,82,82,29,27,56,215.0,1407.0,302,68,66,134,712.0,82,5.49,53,331,2294,9.8,0.6473905
14090,14090,Jonas Hoglund,2001-02,29.0,6,49,82,82,23,26,49,196.0,1241.0,384,91,92,183,908.0,82,5.51,63,376,2272,9.9,0.54493964
14091,14091,Jonas Hoglund,2002-03,30.0,7,47,82,82,13,34,47,199.0,1277.0,466,104,126,230,1107.0,82,5.24,53,338,2262,9.5,0.5722133
14092,14092,Jonas Hoglund,2003-04,31.0,8,32,79,79,13,19,32,157.0,1010.0,545,117,145,262,1264.0,82,5.31,60,363,2326,9.4,0.40325642
14093,14093,Jonas Holos,2011-12,24.0,2,6,39,39,0,6,6,36.0,704.0,39,0,6,6,36.0,82,5.46,52,291,2492,9.0,0.16650146
14094,14094,Jonas Johansson,2006-07,22.0,2,0,1,1,0,0,0,0.0,4.0,1,0,0,0,0.0,82,6.05,85,480,2458,10.1,0.15910202
14095,14095,Jonas Junland,2009-10,22.0,2,0,1,1,0,0,0,0.0,12.0,1,0,0,0,0.0,82,5.7,65,341,2477,9.4,0.17280087
14096,14096,Jonas Junland,2010-11,23.0,3,2,3,3,0,2,2,7.0,52.0,4,0,2,2,7.0,82,5.53,56,304,2486,9.1,0.20677635
14097,14097,Jonas Nordqvist,2007-08,25.0,2,2,3,3,0,2,2,2.0,42.0,3,0,2,2,2.0,82,5.76,70,398,2426,9.7,0.18331045
14098,14098,Jonas Ronnqvist,2001-02,28.0,2,4,38,38,0,4,4,30.0,404.0,38,0,4,4,30.0,82,5.51,63,376,2272,9.9,0.1151872
14099,14099,Jonas Siegenthaler,2019-20,22.0,2,4,26,26,0,4,4,12.0,368.0,26,0,4,4,12.0,82,5.96,47,239,2579,9.5,0.14260885
14100,14100,Jonas Siegenthaler,2020-21,23.0,3,9,64,64,2,7,9,49.0,1007.0,90,2,11,13,61.0,70,5.96,42,208,2192,9.5,0.19137311
14101,14101,Jonathan Cheechoo,2003-04,23.0,2,16,66,66,9,7,16,94.0,707.0,66,9,7,16,94.0,82,5.31,60,363,2326,9.4,0.3220651
14102,14102,Jonathan Cheechoo,2004-05,24.0,3,47,81,81,28,19,47,175.0,1312.0,147,37,26,63,269.0,82,5.14,57,348,2300,9.2,0.7318164
14103,14103,Jonathan Cheechoo,2006-07,26.0,4,93,82,82,56,37,93,317.0,1637.0,229,93,63,156,586.0,82,6.05,85,480,2458,10.1,1.0075865
14104,14104,Jonathan Cheechoo,2007-08,27.0,5,69,76,76,37,32,69,250.0,1334.0,305,130,95,225,836.0,82,5.76,70,398,2426,9.7,0.7661404
14105,14105,Jonathan Cheechoo,2008-09,28.0,6,37,69,69,23,14,37,220.0,1145.0,374,153,109,262,1056.0,82,5.44,62,351,2383,9.4,0.62670726
14106,14106,Jonathan Cheechoo,2009-10,29.0,7,29,66,66,12,17,29,152.0,1011.0,440,165,126,291,1208.0,82,5.7,65,341,2477,9.4,0.43648154
14107,14107,Jonathan Cheechoo,2010-11,30.0,8,14,61,61,5,9,14,117.0,729.0,501,170,135,305,1325.0,82,5.53,56,304,2486,9.1,0.3403138
14108,14108,Jonathan Davidsson,2020-21,23.0,2,1,6,6,0,1,1,3.0,33.0,6,0,1,1,3.0,70,5.96,42,208,2192,9.5,0.21753478
14109,14109,Jonathan Delisle,1999-00,22.0,2,0,1,1,0,0,0,0.0,5.0,1,0,0,0,0.0,82,5.27,57,359,2285,9.4,0.17280087
14110,14110,Jonathan Drouin,2015-16,20.0,2,32,70,70,4,28,32,76.0,927.0,70,4,28,32,76.0,82,5.32,47,251,2453,8.9,0.468511
14111,14111,Jonathan Drouin,2016-17,21.0,3,10,21,21,4,6,10,25.0,303.0,91,8,34,42,101.0,82,5.34,48,255,2438,9.0,0.3947501
14112,14112,Jonathan Drouin,2017-18,22.0,4,53,73,73,21,32,53,183.0,1293.0,164,29,66,95,284.0,82,5.45,47,245,2478,9.0,0.70009816
14113,14113,Jonathan Drouin,2018-19,23.0,5,46,77,77,13,33,46,164.0,1355.0,241,42,99,141,448.0,82,5.86,50,250,2620,9.2,0.6390419
14114,14114,Jonathan Drouin,2019-20,24.0,6,53,81,81,18,35,53,190.0,1371.0,322,60,134,194,638.0,82,5.96,47,239,2579,9.5,0.68300617
14115,14115,Jonathan Drouin,2020-21,25.0,7,15,27,27,7,8,15,51.0,424.0,349,67,142,209,689.0,70,5.96,42,208,2192,9.5,0.6204547
14116,14116,Jonathan Ericsson,2008-09,24.0,2,1,8,8,1,0,1,19.0,128.0,8,1,0,1,19.0,82,5.44,62,351,2383,9.4,0.22357032
14117,14117,Jonathan Ericsson,2009-10,25.0,3,4,19,19,1,3,4,25.0,336.0,27,2,3,5,44.0,82,5.7,65,341,2477,9.4,0.20163506
14118,14118,Jonathan Ericsson,2010-11,26.0,4,13,62,62,4,9,13,55.0,1036.0,89,6,12,18,99.0,82,5.53,56,304,2486,9.1,0.1869955
14119,14119,Jonathan Ericsson,2011-12,27.0,5,15,74,74,3,12,15,89.0,1394.0,163,9,24,33,188.0,82,5.46,52,291,2492,9.0,0.18679842
14120,14120,Jonathan Ericsson,2012-13,28.0,6,11,69,69,1,10,11,63.0,1179.0,232,10,34,44,251.0,82,5.32,47,271,2439,8.9,0.1512484
14121,14121,Jonathan Ericsson,2013-14,29.0,7,13,45,45,3,10,13,34.0,960.0,277,13,44,57,285.0,48,5.31,29,160,1399,9.1,0.21508521
14122,14122,Jonathan Ericsson,2014-15,30.0,8,11,48,48,1,10,11,66.0,1020.0,325,14,54,68,351.0,82,5.34,48,269,2463,8.9,0.17805564
14123,14123,Jonathan Ericsson,2015-16,31.0,9,15,82,82,3,12,15,82.0,1606.0,407,17,66,83,433.0,82,5.32,47,251,2453,8.9,0.17446306
14124,14124,Jonathan Ericsson,2016-17,32.0,10,15,71,71,3,12,15,68.0,1316.0,478,20,78,98,501.0,82,5.34,48,255,2438,9.0,0.17412466
14125,14125,Jonathan Ericsson,2017-18,33.0,11,9,51,51,1,8,9,43.0,980.0,529,21,86,107,544.0,82,5.45,47,245,2478,9.0,0.1317432
14126,14126,Jonathan Ericsson,2018-19,34.0,12,13,81,81,3,10,13,86.0,1564.0,610,24,96,120,630.0,82,5.86,50,250,2620,9.2,0.15765548
14127,14127,Jonathan Ericsson,2019-20,35.0,13,5,52,52,3,2,5,48.0,895.0,662,27,98,125,678.0,82,5.96,47,239,2579,9.5,0.13406014
14128,14128,Jonathan Ericsson,2020-21,36.0,14,0,18,18,0,0,0,16.0,256.0,680,27,98,125,694.0,70,5.96,42,208,2192,9.5,0.1539782
14129,14129,Jonathan Ferland,2006-07,23.0,2,1,7,7,1,0,1,9.0,46.0,7,1,0,1,9.0,82,6.05,85,480,2458,10.1,0.23644412
14130,14130,Jonathan Filewich,2008-09,24.0,2,0,5,5,0,0,0,3.0,43.0,5,0,0,0,3.0,82,5.44,62,351,2383,9.4,0.16862297
14131,14131,Jonathan Girard,1999-00,19.0,2,0,3,3,0,0,0,3.0,28.0,3,0,0,0,3.0,82,5.27,57,359,2285,9.4,0.21444535
14132,14132,Jonathan Girard,2000-01,20.0,3,3,23,23,1,2,3,17.0,219.0,26,1,2,3,20.0,82,5.49,53,331,2294,9.8,0.22341642
14133,14133,Jonathan Girard,2001-02,21.0,4,16,31,31,3,13,16,42.0,513.0,57,4,15,19,62.0,82,5.51,63,376,2272,9.9,0.35139075
14134,14134,Jonathan Girard,2002-03,22.0,5,3,20,20,0,3,3,28.0,294.0,77,4,18,22,90.0,82,5.24,53,338,2262,9.5,0.24705577
14135,14135,Jonathan Girard,2003-04,23.0,6,22,73,73,6,16,22,123.0,1521.0,150,10,34,44,213.0,82,5.31,60,363,2326,9.4,0.32240427
14136,14136,Jonathan Hedstrom,2003-04,26.0,2,0,4,4,0,0,0,3.0,31.0,4,0,0,0,3.0,82,5.31,60,363,2326,9.4,0.17544812
14137,14137,Jonathan Hedstrom,2006-07,29.0,3,27,79,79,13,14,27,99.0,1286.0,83,13,14,27,102.0,82,6.05,85,480,2458,10.1,0.32380995
14138,14138,Jonathan Huberdeau,2013-14,20.0,2,31,48,48,14,17,31,112.0,813.0,48,14,17,31,112.0,48,5.31,29,160,1399,9.1,0.5999518
14139,14139,Jonathan Huberdeau,2014-15,21.0,3,28,69,69,9,19,28,108.0,1081.0,117,23,36,59,220.0,82,5.34,48,269,2463,8.9,0.4188606
14140,14140,Jonathan Huberdeau,2015-16,22.0,4,54,79,79,15,39,54,169.0,1323.0,196,38,75,113,389.0,82,5.32,47,251,2453,8.9,0.668745
14141,14141,Jonathan Huberdeau,2016-17,23.0,5,59,76,76,20,39,59,174.0,1379.0,272,58,114,172,563.0,82,5.34,48,255,2438,9.0,0.73273057
14142,14142,Jonathan Huberdeau,2017-18,24.0,6,26,31,31,10,16,26,86.0,556.0,303,68,130,198,649.0,82,5.45,47,245,2478,9.0,0.8187518
14143,14143,Jonathan Huberdeau,2018-19,25.0,7,69,82,82,27,42,69,204.0,1575.0,385,95,172,267,853.0,82,5.86,50,250,2620,9.2,0.8541051
14144,14144,Jonathan Huberdeau,2019-20,26.0,8,92,82,82,30,62,92,226.0,1546.0,467,125,234,359,1079.0,82,5.96,47,239,2579,9.5,1.0069988
14145,14145,Jonathan Huberdeau,2020-21,27.0,9,78,69,69,23,55,78,152.0,1295.0,536,148,289,437,1231.0,70,5.96,42,208,2192,9.5,0.89786345
14146,14146,Jonathan Marchessault,2013-14,23.0,2,0,2,2,0,0,0,0.0,22.0,2,0,0,0,0.0,48,5.31,29,160,1399,9.1,0.19164318
14147,14147,Jonathan Marchessault,2015-16,25.0,3,1,2,2,1,0,1,3.0,24.0,4,1,0,1,3.0,82,5.32,47,251,2453,8.9,0.19187155
14148,14148,Jonathan Marchessault,2016-17,26.0,4,18,45,45,7,11,18,81.0,544.0,49,8,11,19,84.0,82,5.34,48,255,2438,9.0,0.3617922
14149,14149,Jonathan Marchessault,2017-18,27.0,5,51,75,75,30,21,51,193.0,1268.0,124,38,32,70,277.0,82,5.45,47,245,2478,9.0,0.6088599
14150,14150,Jonathan Marchessault,2018-19,28.0,6,75,77,77,27,48,75,268.0,1348.0,201,65,80,145,545.0,82,5.86,50,250,2620,9.2,0.8135637
14151,14151,Jonathan Marchessault,2019-20,29.0,7,59,82,82,25,34,59,278.0,1488.0,283,90,114,204,823.0,82,5.96,47,239,2579,9.5,0.7154319
14152,14152,Jonathan Marchessault,2020-21,30.0,8,47,66,66,22,25,47,235.0,1141.0,349,112,139,251,1058.0,70,5.96,42,208,2192,9.5,0.72088516
14153,14153,Jonathan Racine,2014-15,21.0,2,0,1,1,0,0,0,0.0,16.0,1,0,0,0,0.0,82,5.34,48,269,2463,8.9,0.1823057
14154,14154,Jonathan Sigalet,2007-08,21.0,2,0,1,1,0,0,0,1.0,15.0,1,0,0,0,1.0,82,5.76,70,398,2426,9.7,0.19067428
14155,14155,Jonathan Toews,2008-09,20.0,2,54,64,64,24,30,54,144.0,1195.0,64,24,30,54,144.0,82,5.44,62,351,2383,9.4,0.84573823
14156,14156,Jonathan Toews,2009-10,21.0,3,69,82,82,34,35,69,195.0,1527.0,146,58,65,123,339.0,82,5.7,65,341,2477,9.4,0.86914897
14157,14157,Jonathan Toews,2010-11,22.0,4,68,76,76,25,43,68,202.0,1520.0,222,83,108,191,541.0,82,5.53,56,304,2486,9.1,0.86040163
14158,14158,Jonathan Toews,2011-12,23.0,5,76,80,80,32,44,76,233.0,1661.0,302,115,152,267,774.0,82,5.46,52,291,2492,9.0,0.8888686
14159,14159,Jonathan Toews,2012-13,24.0,6,57,59,59,29,28,57,185.0,1230.0,361,144,180,324,959.0,82,5.32,47,271,2439,8.9,0.90370893
14160,14160,Jonathan Toews,2013-14,25.0,7,48,47,47,23,25,48,143.0,909.0,408,167,205,372,1102.0,48,5.31,29,160,1399,9.1,1.0171309
14161,14161,Jonathan Toews,2014-15,26.0,8,68,76,76,28,40,68,193.0,1555.0,484,195,245,440,1295.0,82,5.34,48,269,2463,8.9,0.9100375
14162,14162,Jonathan Toews,2015-16,27.0,9,66,81,81,28,38,66,192.0,1585.0,565,223,283,506,1487.0,82,5.32,47,251,2453,8.9,0.83163524
14163,14163,Jonathan Toews,2016-17,28.0,10,58,80,80,28,30,58,179.0,1540.0,645,251,313,564,1666.0,82,5.34,48,255,2438,9.0,0.7227341
14164,14164,Jonathan Toews,2017-18,29.0,11,58,72,72,21,37,58,199.0,1451.0,717,272,350,622,1865.0,82,5.45,47,245,2478,9.0,0.7633667
14165,14165,Jonathan Toews,2018-19,30.0,12,52,74,74,20,32,52,211.0,1457.0,791,292,382,674,2076.0,82,5.86,50,250,2620,9.2,0.7154496
14166,14166,Jonathan Toews,2019-20,31.0,13,81,82,82,35,46,81,235.0,1723.0,873,327,428,755,2311.0,82,5.96,47,239,2579,9.5,0.8674217
14167,14167,Jonathan Toews,2020-21,32.0,14,60,70,70,18,42,60,172.0,1384.0,943,345,470,815,2483.0,70,5.96,42,208,2192,9.5,0.7961173
14168,14168,Jonathon Blum,2011-12,23.0,2,8,23,23,3,5,8,18.0,408.0,23,3,5,8,18.0,82,5.46,52,291,2492,9.0,0.2557236
14169,14169,Jonathon Blum,2012-13,24.0,3,7,33,33,3,4,7,25.0,592.0,56,6,9,15,43.0,82,5.32,47,271,2439,8.9,0.23156092
14170,14170,Jonathon Blum,2013-14,25.0,4,7,35,35,1,6,7,26.0,500.0,91,7,15,22,69.0,48,5.31,29,160,1399,9.1,0.20903307
14171,14171,Jonathon Blum,2014-15,26.0,5,1,15,15,0,1,1,11.0,175.0,106,7,16,23,80.0,82,5.34,48,269,2463,8.9,0.18523759
14172,14172,Jonathon Blum,2015-16,27.0,6,1,4,4,0,1,1,3.0,39.0,110,7,17,24,83.0,82,5.32,47,251,2453,8.9,0.16037938
14173,14173,Jonathon Merrill,2014-15,22.0,2,11,52,52,2,9,11,45.0,1000.0,52,2,9,11,45.0,82,5.34,48,269,2463,8.9,0.22467032
14174,14174,Jonathon Merrill,2015-16,23.0,3,14,66,66,2,12,14,47.0,1357.0,118,4,21,25,92.0,82,5.32,47,251,2453,8.9,0.22722712
14175,14175,Jonathon Merrill,2016-17,24.0,4,5,47,47,1,4,5,30.0,794.0,165,5,25,30,122.0,82,5.34,48,255,2438,9.0,0.14591926
14176,14176,Jonathon Merrill,2017-18,25.0,5,6,51,51,1,5,6,48.0,947.0,216,6,30,36,170.0,82,5.45,47,245,2478,9.0,0.16785431
14177,14177,Jonathon Merrill,2018-19,26.0,6,3,34,34,1,2,3,30.0,547.0,250,7,32,39,200.0,82,5.86,50,250,2620,9.2,0.1637767
14178,14178,Jonathon Merrill,2019-20,27.0,7,15,57,57,3,12,15,72.0,1019.0,307,10,44,54,272.0,82,5.96,47,239,2579,9.5,0.2095232
14179,14179,Jonathon Merrill,2020-21,28.0,8,7,49,49,2,5,7,37.0,890.0,356,12,49,61,309.0,70,5.96,42,208,2192,9.5,0.16900721
14180,14180,Joni Pitkanen,2004-05,21.0,2,27,71,71,8,19,27,133.0,1177.0,71,8,19,27,133.0,82,5.14,57,348,2300,9.2,0.6517111
14181,14181,Joni Pitkanen,2006-07,23.0,3,46,58,58,13,33,46,118.0,1375.0,129,21,52,73,251.0,82,6.05,85,480,2458,10.1,0.5972114
14182,14182,Joni Pitkanen,2007-08,24.0,4,43,77,77,4,39,43,137.0,1890.0,206,25,91,116,388.0,82,5.76,70,398,2426,9.7,0.50734115
14183,14183,Joni Pitkanen,2008-09,25.0,5,26,63,63,8,18,26,101.0,1520.0,269,33,109,142,489.0,82,5.44,62,351,2383,9.4,0.45857978
14184,14184,Joni Pitkanen,2009-10,26.0,6,33,71,71,7,26,33,147.0,1761.0,340,40,135,175,636.0,82,5.7,65,341,2477,9.4,0.5281457
14185,14185,Joni Pitkanen,2010-11,27.0,7,46,71,71,6,40,46,161.0,1944.0,411,46,175,221,797.0,82,5.53,56,304,2486,9.1,0.512517
14186,14186,Joni Pitkanen,2011-12,28.0,8,35,72,72,5,30,35,144.0,1802.0,483,51,205,256,941.0,82,5.46,52,291,2492,9.0,0.4505007
14187,14187,Joni Pitkanen,2012-13,29.0,9,17,30,30,5,12,17,62.0,669.0,513,56,217,273,1003.0,82,5.32,47,271,2439,8.9,0.44885448
14188,14188,Joni Pitkanen,2013-14,30.0,10,9,22,22,1,8,9,34.0,502.0,535,57,225,282,1037.0,48,5.31,29,160,1399,9.1,0.34417772
14189,14189,Jonny Brodzinski,2017-18,24.0,2,2,6,6,0,2,2,17.0,74.0,6,0,2,2,17.0,82,5.45,47,245,2478,9.0,0.20528045
14190,14190,Jonny Brodzinski,2018-19,25.0,3,6,35,35,4,2,6,53.0,333.0,41,4,4,8,70.0,82,5.86,50,250,2620,9.2,0.21320161
14191,14191,Jonny Brodzinski,2019-20,26.0,4,3,13,13,2,1,3,17.0,129.0,54,6,5,11,87.0,82,5.96,47,239,2579,9.5,0.2421732
14192,14192,Jonny Brodzinski,2020-21,27.0,5,1,3,3,0,1,1,5.0,22.0,57,6,6,12,92.0,70,5.96,42,208,2192,9.5,0.18194136
14193,14193,Joona Luoto,2020-21,23.0,2,0,16,16,0,0,0,9.0,105.0,16,0,0,0,9.0,70,5.96,42,208,2192,9.5,0.18014771
14194,14194,Joonas Donskoi,2016-17,24.0,2,36,76,76,11,25,36,107.0,1076.0,76,11,25,36,107.0,82,5.34,48,255,2438,9.0,0.4173828
14195,14195,Joonas Donskoi,2017-18,25.0,3,17,61,61,6,11,17,95.0,842.0,137,17,36,53,202.0,82,5.45,47,245,2478,9.0,0.3052507
14196,14196,Joonas Donskoi,2018-19,26.0,4,32,66,66,14,18,32,129.0,988.0,203,31,54,85,331.0,82,5.86,50,250,2620,9.2,0.43655849
14197,14197,Joonas Donskoi,2019-20,27.0,5,37,80,80,14,23,37,115.0,1074.0,283,45,77,122,446.0,82,5.96,47,239,2579,9.5,0.46537197
14198,14198,Joonas Donskoi,2020-21,28.0,6,33,65,65,16,17,33,111.0,1056.0,348,61,94,155,557.0,70,5.96,42,208,2192,9.5,0.44824505
14199,14199,Joonas Kemppainen,2016-17,28.0,2,5,44,44,2,3,5,35.0,552.0,44,2,3,5,35.0,82,5.34,48,255,2438,9.0,0.14530262
14200,14200,Joonas Nattinen,2014-15,24.0,2,0,1,1,0,0,0,0.0,2.0,1,0,0,0,0.0,82,5.34,48,269,2463,8.9,0.1370357
14201,14201,Joonas Rask,2013-14,23.0,2,1,2,2,0,1,1,0.0,16.0,2,0,1,1,0.0,48,5.31,29,160,1399,9.1,0.21996444
14202,14202,Jordan Caron,2011-12,21.0,2,7,23,23,3,4,7,27.0,291.0,23,3,4,7,27.0,82,5.46,52,291,2492,9.0,0.335383
14203,14203,Jordan Caron,2012-13,22.0,3,15,48,48,7,8,15,57.0,553.0,71,10,12,22,84.0,82,5.32,47,271,2439,8.9,0.32653385
14204,14204,Jordan Caron,2013-14,23.0,4,3,17,17,1,2,3,20.0,160.0,88,11,14,25,104.0,48,5.31,29,160,1399,9.1,0.29738003
14205,14205,Jordan Caron,2014-15,24.0,5,3,35,35,1,2,3,52.0,382.0,123,12,16,28,156.0,82,5.34,48,269,2463,8.9,0.19230601
14206,14206,Jordan Caron,2015-16,25.0,6,0,30,30,0,0,0,12.0,241.0,153,12,16,28,168.0,82,5.32,47,251,2453,8.9,0.105550796
14207,14207,Jordan Caron,2016-17,26.0,7,0,4,4,0,0,0,1.0,33.0,157,12,16,28,169.0,82,5.34,48,255,2438,9.0,0.13838083
14208,14208,Jordan Eberle,2011-12,21.0,2,43,69,69,18,25,43,158.0,1220.0,69,18,25,43,158.0,82,5.46,52,291,2492,9.0,0.6937647
14209,14209,Jordan Eberle,2012-13,22.0,3,76,78,78,34,42,76,180.0,1373.0,147,52,67,119,338.0,82,5.32,47,271,2439,8.9,0.8936901
14210,14210,Jordan Eberle,2013-14,23.0,4,37,48,48,16,21,37,133.0,912.0,195,68,88,156,471.0,48,5.31,29,160,1399,9.1,0.80818546
14211,14211,Jordan Eberle,2014-15,24.0,5,65,80,80,28,37,65,200.0,1564.0,275,96,125,221,671.0,82,5.34,48,269,2463,8.9,0.85689354
14212,14212,Jordan Eberle,2015-16,25.0,6,63,81,81,24,39,63,183.0,1542.0,356,120,164,284,854.0,82,5.32,47,251,2453,8.9,0.734162
14213,14213,Jordan Eberle,2016-17,26.0,7,47,69,69,25,22,47,173.0,1232.0,425,145,186,331,1027.0,82,5.34,48,255,2438,9.0,0.69665456
14214,14214,Jordan Eberle,2017-18,27.0,8,51,82,82,20,31,51,208.0,1375.0,507,165,217,382,1235.0,82,5.45,47,245,2478,9.0,0.6653453
14215,14215,Jordan Eberle,2018-19,28.0,9,59,81,81,25,34,59,183.0,1302.0,588,190,251,441,1418.0,82,5.86,50,250,2620,9.2,0.7141015
14216,14216,Jordan Eberle,2019-20,29.0,10,37,78,78,19,18,37,160.0,1289.0,666,209,269,478,1578.0,82,5.96,47,239,2579,9.5,0.4862776
14217,14217,Jordan Eberle,2020-21,30.0,11,40,58,58,16,24,40,136.0,1033.0,724,225,293,518,1714.0,70,5.96,42,208,2192,9.5,0.6320344
14218,14218,Jordan Greenway,2018-19,21.0,2,1,6,6,0,1,1,4.0,69.0,6,0,1,1,4.0,82,5.86,50,250,2620,9.2,0.24860835
14219,14219,Jordan Greenway,2019-20,22.0,3,24,81,81,12,12,24,109.0,1104.0,87,12,13,25,113.0,82,5.96,47,239,2579,9.5,0.36932603
14220,14220,Jordan Greenway,2020-21,23.0,4,28,67,67,8,20,28,93.0,949.0,154,20,33,53,206.0,70,5.96,42,208,2192,9.5,0.42326084
14221,14221,Jordan Gross,2020-21,25.0,2,1,2,2,0,1,1,3.0,32.0,2,0,1,1,3.0,70,5.96,42,208,2192,9.5,0.20883432
14222,14222,Jordan Hendry,2008-09,24.0,2,4,40,40,1,3,4,32.0,689.0,40,1,3,4,32.0,82,5.44,62,351,2383,9.4,0.15713632
14223,14223,Jordan Hendry,2009-10,25.0,3,0,9,9,0,0,0,1.0,91.0,49,1,3,4,33.0,82,5.7,65,341,2477,9.4,0.15034842
14224,14224,Jordan Hendry,2010-11,26.0,4,8,43,43,2,6,8,42.0,510.0,92,3,9,12,75.0,82,5.53,56,304,2486,9.1,0.16577458
14225,14225,Jordan Hendry,2011-12,27.0,5,1,37,37,1,0,1,35.0,396.0,129,4,9,13,110.0,82,5.46,52,291,2492,9.0,0.12680915
14226,14226,Jordan Hendry,2013-14,29.0,6,0,2,2,0,0,0,0.0,35.0,131,4,9,13,110.0,48,5.31,29,160,1399,9.1,0.13165385
14227,14227,Jordan Krestanovich,2002-03,21.0,2,2,8,8,0,2,2,6.0,69.0,8,0,2,2,6.0,82,5.24,53,338,2262,9.5,0.22307485
14228,14228,Jordan Krestanovich,2004-05,23.0,3,0,14,14,0,0,0,25.0,142.0,22,0,2,2,31.0,82,5.14,57,348,2300,9.2,0.23024979
14229,14229,Jordan Kyrou,2019-20,21.0,2,3,16,16,1,2,3,16.0,155.0,16,1,2,3,16.0,82,5.96,47,239,2579,9.5,0.27377003
14230,14230,Jordan Kyrou,2020-21,22.0,3,9,28,28,4,5,9,39.0,305.0,44,5,7,12,55.0,70,5.96,42,208,2192,9.5,0.30340976
14231,14231,Jordan Leopold,2003-04,23.0,2,14,58,58,4,10,14,78.0,1195.0,58,4,10,14,78.0,82,5.31,60,363,2326,9.4,0.2648419
14232,14232,Jordan Leopold,2004-05,24.0,3,33,82,82,9,24,33,138.0,1822.0,140,13,34,47,216.0,82,5.14,57,348,2300,9.2,0.44538033
14233,14233,Jordan Leopold,2006-07,26.0,4,20,74,74,2,18,20,87.0,1652.0,214,15,52,67,303.0,82,6.05,85,480,2458,10.1,0.2559747
14234,14234,Jordan Leopold,2007-08,27.0,5,5,15,15,2,3,5,19.0,297.0,229,17,55,72,322.0,82,5.76,70,398,2426,9.7,0.23495483
14235,14235,Jordan Leopold,2008-09,28.0,6,13,43,43,5,8,13,35.0,687.0,272,22,63,85,357.0,82,5.44,62,351,2383,9.4,0.24258313
14236,14236,Jordan Leopold,2009-10,29.0,7,24,83,83,7,17,24,107.0,1561.0,355,29,80,109,464.0,82,5.7,65,341,2477,9.4,0.2914086
14237,14237,Jordan Leopold,2010-11,30.0,8,26,81,81,11,15,26,95.0,1777.0,436,40,95,135,559.0,82,5.53,56,304,2486,9.1,0.29179406
14238,14238,Jordan Leopold,2011-12,31.0,9,35,71,71,13,22,35,134.0,1656.0,507,53,117,170,693.0,82,5.46,52,291,2492,9.0,0.39847016
14239,14239,Jordan Leopold,2012-13,32.0,10,24,79,79,10,14,24,110.0,1767.0,586,63,131,194,803.0,82,5.32,47,271,2439,8.9,0.2732601
14240,14240,Jordan Leopold,2013-14,33.0,11,10,39,39,2,8,10,60.0,783.0,625,65,139,204,863.0,48,5.31,29,160,1399,9.1,0.24354953
14241,14241,Jordan Leopold,2014-15,34.0,12,6,27,27,1,5,6,40.0,421.0,652,66,144,210,903.0,82,5.34,48,269,2463,8.9,0.19826624
14242,14242,Jordan Leopold,2015-16,35.0,13,4,43,43,1,3,4,39.0,642.0,695,67,147,214,942.0,82,5.32,47,251,2453,8.9,0.15187669
14243,14243,Jordan Martinook,2015-16,23.0,2,1,8,8,0,1,1,8.0,94.0,8,0,1,1,8.0,82,5.32,47,251,2453,8.9,0.19220155
14244,14244,Jordan Martinook,2016-17,24.0,3,24,81,81,9,15,24,109.0,1230.0,89,9,16,25,117.0,82,5.34,48,255,2438,9.0,0.32463053
14245,14245,Jordan Martinook,2017-18,25.0,4,25,77,77,11,14,25,109.0,1207.0,166,20,30,50,226.0,82,5.45,47,245,2478,9.0,0.32246774
14246,14246,Jordan Martinook,2018-19,26.0,5,15,81,81,6,9,15,112.0,1135.0,247,26,39,65,338.0,82,5.86,50,250,2620,9.2,0.24882582
14247,14247,Jordan Martinook,2019-20,27.0,6,25,82,82,15,10,25,146.0,1188.0,329,41,49,90,484.0,82,5.96,47,239,2579,9.5,0.3568684
14248,14248,Jordan Martinook,2020-21,28.0,7,13,45,45,2,11,13,44.0,507.0,374,43,60,103,528.0,70,5.96,42,208,2192,9.5,0.24648222
14249,14249,Jordan Nolan,2012-13,23.0,2,4,26,26,2,2,4,19.0,243.0,26,2,2,4,19.0,82,5.32,47,271,2439,8.9,0.211391
14250,14250,Jordan Nolan,2013-14,24.0,3,6,44,44,2,4,6,23.0,373.0,70,4,6,10,42.0,48,5.31,29,160,1399,9.1,0.17120409
14251,14251,Jordan Nolan,2014-15,25.0,4,10,64,64,6,4,10,58.0,576.0,134,10,10,20,100.0,82,5.34,48,269,2463,8.9,0.16756397
14252,14252,Jordan Nolan,2015-16,26.0,5,9,60,60,6,3,9,44.0,598.0,194,16,13,29,144.0,82,5.32,47,251,2453,8.9,0.15598917
14253,14253,Jordan Nolan,2016-17,27.0,6,5,52,52,0,5,5,49.0,463.0,246,16,18,34,193.0,82,5.34,48,255,2438,9.0,0.12601396
14254,14254,Jordan Nolan,2017-18,28.0,7,8,46,46,4,4,8,39.0,499.0,292,20,22,42,232.0,82,5.45,47,245,2478,9.0,0.13417253
14255,14255,Jordan Nolan,2018-19,29.0,8,8,69,69,4,4,8,50.0,676.0,361,24,26,50,282.0,82,5.86,50,250,2620,9.2,0.13893363
14256,14256,Jordan Nolan,2019-20,30.0,9,2,14,14,0,2,2,17.0,111.0,375,24,28,52,299.0,82,5.96,47,239,2579,9.5,0.1719934
14257,14257,Jordan Oesterle,2015-16,23.0,2,1,6,6,0,1,1,7.0,88.0,6,0,1,1,7.0,82,5.32,47,251,2453,8.9,0.19220155
14258,14258,Jordan Oesterle,2016-17,24.0,3,5,17,17,0,5,5,24.0,369.0,23,0,6,6,31.0,82,5.34,48,255,2438,9.0,0.21187821
14259,14259,Jordan Oesterle,2017-18,25.0,4,0,2,2,0,0,0,2.0,35.0,25,0,6,6,33.0,82,5.45,47,245,2478,9.0,0.16429418
14260,14260,Jordan Oesterle,2018-19,26.0,5,15,55,55,5,10,15,99.0,1128.0,80,5,16,21,132.0,82,5.86,50,250,2620,9.2,0.26048103
14261,14261,Jordan Oesterle,2019-20,27.0,6,20,71,71,6,14,20,77.0,1342.0,151,11,30,41,209.0,82,5.96,47,239,2579,9.5,0.24661046
14262,14262,Jordan Oesterle,2020-21,28.0,7,13,58,58,3,10,13,69.0,987.0,209,14,40,54,278.0,70,5.96,42,208,2192,9.5,0.2547021
14263,14263,Jordan Schmaltz,2017-18,24.0,2,2,9,9,0,2,2,5.0,129.0,9,0,2,2,5.0,82,5.45,47,245,2478,9.0,0.19383368
14264,14264,Jordan Schmaltz,2018-19,25.0,3,1,13,13,0,1,1,5.0,143.0,22,0,3,3,10.0,82,5.86,50,250,2620,9.2,0.15316996
14265,14265,Jordan Schmaltz,2019-20,26.0,4,2,20,20,0,2,2,11.0,230.0,42,0,5,5,21.0,82,5.96,47,239,2579,9.5,0.11227578
14266,14266,Jordan Schroeder,2013-14,23.0,2,9,31,31,3,6,9,28.0,425.0,31,3,6,9,28.0,48,5.31,29,160,1399,9.1,0.27868986
14267,14267,Jordan Schroeder,2014-15,24.0,3,6,25,25,3,3,6,25.0,300.0,56,6,9,15,53.0,82,5.34,48,269,2463,8.9,0.23704123
14268,14268,Jordan Schroeder,2015-16,25.0,4,8,25,25,3,5,8,48.0,271.0,81,9,14,23,101.0,82,5.32,47,251,2453,8.9,0.26280364
14269,14269,Jordan Schroeder,2016-17,26.0,5,4,26,26,2,2,4,30.0,245.0,107,11,16,27,131.0,82,5.34,48,255,2438,9.0,0.21523377
14270,14270,Jordan Schroeder,2017-18,27.0,6,13,37,37,6,7,13,37.0,362.0,144,17,23,40,168.0,82,5.45,47,245,2478,9.0,0.23206112
14271,14271,Jordan Schroeder,2018-19,28.0,7,2,21,21,1,1,2,20.0,157.0,165,18,24,42,188.0,82,5.86,50,250,2620,9.2,0.14614174
14272,14272,Jordan Smotherman,2008-09,22.0,2,2,2,2,1,1,2,1.0,23.0,2,1,1,2,1.0,82,5.44,62,351,2383,9.4,0.24805957
14273,14273,Jordan Smotherman,2009-10,23.0,3,0,2,2,0,0,0,1.0,13.0,4,1,1,2,2.0,82,5.7,65,341,2477,9.4,0.17831007
14274,14274,Jordan Staal,2007-08,19.0,2,42,81,81,29,13,42,131.0,1210.0,81,29,13,42,131.0,82,5.76,70,398,2426,9.7,0.6011438
14275,14275,Jordan Staal,2008-09,20.0,3,28,82,82,12,16,28,183.0,1498.0,163,41,29,70,314.0,82,5.44,62,351,2383,9.4,0.49739188
14276,14276,Jordan Staal,2009-10,21.0,4,49,82,82,22,27,49,166.0,1627.0,245,63,56,119,480.0,82,5.7,65,341,2477,9.4,0.6450964
14277,14277,Jordan Staal,2010-11,22.0,5,49,82,82,21,28,49,195.0,1590.0,327,84,84,168,675.0,82,5.53,56,304,2486,9.1,0.66052294
14278,14278,Jordan Staal,2011-12,23.0,6,30,42,42,11,19,30,91.0,897.0,369,95,103,198,766.0,82,5.46,52,291,2492,9.0,0.67807966
14279,14279,Jordan Staal,2012-13,24.0,7,50,62,62,25,25,50,149.0,1243.0,431,120,128,248,915.0,82,5.32,47,271,2439,8.9,0.7707548
14280,14280,Jordan Staal,2013-14,25.0,8,31,48,48,10,21,31,114.0,965.0,479,130,149,279,1029.0,48,5.31,29,160,1399,9.1,0.6592434
14281,14281,Jordan Staal,2014-15,26.0,9,40,82,82,15,25,40,165.0,1554.0,561,145,174,319,1194.0,82,5.34,48,269,2463,8.9,0.54925644
14282,14282,Jordan Staal,2015-16,27.0,10,24,46,46,6,18,24,92.0,853.0,607,151,192,343,1286.0,82,5.32,47,251,2453,8.9,0.4600323
14283,14283,Jordan Staal,2016-17,28.0,11,48,82,82,20,28,48,151.0,1501.0,689,171,220,391,1437.0,82,5.34,48,255,2438,9.0,0.5828947
14284,14284,Jordan Staal,2017-18,29.0,12,45,75,75,16,29,45,164.0,1400.0,764,187,249,436,1601.0,82,5.45,47,245,2478,9.0,0.538537
14285,14285,Jordan Staal,2018-19,30.0,13,46,79,79,19,27,46,160.0,1521.0,843,206,276,482,1761.0,82,5.86,50,250,2620,9.2,0.5174192
14286,14286,Jordan Staal,2019-20,31.0,14,28,50,50,11,17,28,121.0,914.0,893,217,293,510,1882.0,82,5.96,47,239,2579,9.5,0.51767844
14287,14287,Jordan Staal,2020-21,32.0,15,27,68,68,8,19,27,125.0,1190.0,961,225,312,537,2007.0,70,5.96,42,208,2192,9.5,0.33622485
14288,14288,Jordan Szwarz,2014-15,23.0,2,3,26,26,3,0,3,25.0,225.0,26,3,0,3,25.0,82,5.34,48,269,2463,8.9,0.24369952
14289,14289,Jordan Szwarz,2015-16,24.0,3,1,9,9,1,0,1,8.0,121.0,35,4,0,4,33.0,82,5.32,47,251,2453,8.9,0.20233518
14290,14290,Jordan Szwarz,2018-19,27.0,4,3,12,12,0,3,3,19.0,138.0,47,4,3,7,52.0,82,5.86,50,250,2620,9.2,0.16543394
14291,14291,Jordan Szwarz,2020-21,29.0,5,0,3,3,0,0,0,2.0,15.0,50,4,3,7,54.0,70,5.96,42,208,2192,9.5,0.14300033
14292,14292,Jordan Weal,2016-17,24.0,2,0,14,14,0,0,0,4.0,131.0,14,0,0,0,4.0,82,5.34,48,255,2438,9.0,0.15447003
14293,14293,Jordan Weal,2017-18,25.0,3,12,23,23,8,4,12,49.0,329.0,37,8,4,12,53.0,82,5.45,47,245,2478,9.0,0.30009562
14294,14294,Jordan Weal,2018-19,26.0,4,21,69,69,8,13,21,102.0,894.0,106,16,17,33,155.0,82,5.86,50,250,2620,9.2,0.2869836
14295,14295,Jordan Weal,2019-20,27.0,5,21,63,63,8,13,21,75.0,848.0,169,24,30,54,230.0,82,5.96,47,239,2579,9.5,0.2844748
14296,14296,Jordan Weal,2020-21,28.0,6,15,49,49,8,7,15,86.0,667.0,218,32,37,69,316.0,70,5.96,42,208,2192,9.5,0.3482427
14297,14297,Jordie Benn,2012-13,25.0,2,2,3,3,0,2,2,1.0,42.0,3,0,2,2,1.0,82,5.32,47,271,2439,8.9,0.1918875
14298,14298,Jordie Benn,2013-14,26.0,3,6,26,26,1,5,6,31.0,450.0,29,1,7,8,32.0,48,5.31,29,160,1399,9.1,0.20149642
14299,14299,Jordie Benn,2014-15,27.0,4,20,78,78,3,17,20,91.0,1494.0,107,4,24,28,123.0,82,5.34,48,269,2463,8.9,0.23173577
14300,14300,Jordie Benn,2015-16,28.0,5,16,73,73,2,14,16,70.0,1319.0,180,6,38,44,193.0,82,5.32,47,251,2453,8.9,0.19448215
14301,14301,Jordie Benn,2016-17,29.0,6,12,64,64,3,9,12,58.0,1001.0,244,9,47,56,251.0,82,5.34,48,255,2438,9.0,0.16141722
14302,14302,Jordie Benn,2017-18,30.0,7,17,71,71,4,13,17,68.0,1298.0,315,13,60,73,319.0,82,5.45,47,245,2478,9.0,0.1886583
14303,14303,Jordie Benn,2018-19,31.0,8,15,77,77,4,11,15,106.0,1461.0,392,17,71,88,425.0,82,5.86,50,250,2620,9.2,0.20732841
14304,14304,Jordie Benn,2019-20,32.0,9,22,81,81,5,17,22,93.0,1474.0,473,22,88,110,518.0,82,5.96,47,239,2579,9.5,0.25024527
14305,14305,Jordie Benn,2020-21,33.0,10,7,44,44,1,6,7,58.0,717.0,517,23,94,117,576.0,70,5.96,42,208,2192,9.5,0.17706555
14306,14306,Jordin Tootoo,2004-05,21.0,2,8,70,70,4,4,8,92.0,594.0,70,4,4,8,92.0,82,5.14,57,348,2300,9.2,0.329387
14307,14307,Jordin Tootoo,2006-07,23.0,3,10,34,34,4,6,10,61.0,315.0,104,8,10,18,153.0,82,6.05,85,480,2458,10.1,0.28691775
14308,14308,Jordin Tootoo,2007-08,24.0,4,9,65,65,3,6,9,77.0,546.0,169,11,16,27,230.0,82,5.76,70,398,2426,9.7,0.20317268
14309,14309,Jordin Tootoo,2008-09,25.0,5,18,63,63,11,7,18,98.0,624.0,232,22,23,45,328.0,82,5.44,62,351,2383,9.4,0.29247898
14310,14310,Jordin Tootoo,2009-10,26.0,6,16,72,72,4,12,16,138.0,870.0,304,26,35,61,466.0,82,5.7,65,341,2477,9.4,0.25664806
14311,14311,Jordin Tootoo,2010-11,27.0,7,16,51,51,6,10,16,101.0,553.0,355,32,45,77,567.0,82,5.53,56,304,2486,9.1,0.29815257
14312,14312,Jordin Tootoo,2011-12,28.0,8,18,54,54,8,10,18,85.0,641.0,409,40,55,95,652.0,82,5.46,52,291,2492,9.0,0.32836223
14313,14313,Jordin Tootoo,2012-13,29.0,9,30,77,77,6,24,30,136.0,1013.0,486,46,79,125,788.0,82,5.32,47,271,2439,8.9,0.35591567
14314,14314,Jordin Tootoo,2013-14,30.0,10,8,42,42,3,5,8,45.0,381.0,528,49,84,133,833.0,48,5.31,29,160,1399,9.1,0.17558897
14315,14315,Jordin Tootoo,2014-15,31.0,11,1,11,11,0,1,1,11.0,77.0,539,49,85,134,844.0,82,5.34,48,269,2463,8.9,0.17461345
14316,14316,Jordin Tootoo,2015-16,32.0,12,15,68,68,10,5,15,75.0,711.0,607,59,90,149,919.0,82,5.32,47,251,2453,8.9,0.20291364
14317,14317,Jordin Tootoo,2016-17,33.0,13,9,66,66,4,5,9,90.0,761.0,673,63,95,158,1009.0,82,5.34,48,255,2438,9.0,0.15954018
14318,14318,Jordin Tootoo,2017-18,34.0,14,3,50,50,2,1,3,43.0,337.0,723,65,96,161,1052.0,82,5.45,47,245,2478,9.0,0.12878734
14319,14319,Jordy Douglas,1980-81,23.0,2,57,77,77,33,24,57,188.0,,77,33,24,57,188.0,80,7.03,61,280,2352,12.0,0.72460985
14320,14320,Jordy Douglas,1981-82,24.0,3,22,55,55,13,9,22,98.0,,132,46,33,79,286.0,80,7.69,77,340,2441,12.6,0.47260618
14321,14321,Jordy Douglas,1982-83,25.0,4,17,30,30,10,7,17,74.0,,162,56,40,96,360.0,80,8.03,73,320,2489,12.9,0.518616
14322,14322,Jordy Douglas,1983-84,26.0,5,27,68,68,13,14,27,86.0,,230,69,54,123,446.0,80,7.73,71,310,2444,12.7,0.4136393
14323,14323,Jordy Douglas,1984-85,27.0,6,13,31,31,7,6,13,35.0,,261,76,60,136,481.0,80,7.89,74,336,2448,12.9,0.37029117
14324,14324,Jordy Douglas,1985-86,28.0,7,2,7,7,0,2,2,6.0,,268,76,62,138,487.0,80,7.77,71,321,2447,12.7,0.4226635
14325,14325,Jorgen Jonsson,2000-01,28.0,2,31,81,81,12,19,31,116.0,1263.0,81,12,19,31,116.0,82,5.49,53,331,2294,9.8,0.37418002
14326,14326,Jorgen Pettersson,1981-82,25.0,2,73,62,62,37,36,73,172.0,,62,37,36,73,172.0,80,7.69,77,340,2441,12.6,0.9814857
14327,14327,Jorgen Pettersson,1982-83,26.0,3,69,77,77,38,31,69,227.0,,139,75,67,142,399.0,80,8.03,73,320,2489,12.9,0.8492247
14328,14328,Jorgen Pettersson,1983-84,27.0,4,73,74,74,35,38,73,201.0,,213,110,105,215,600.0,80,7.73,71,310,2444,12.7,0.8690146
14329,14329,Jorgen Pettersson,1984-85,28.0,5,62,77,77,28,34,62,203.0,,290,138,139,277,803.0,80,7.89,74,336,2448,12.9,0.7443186
14330,14330,Jorgen Pettersson,1985-86,29.0,6,55,75,75,23,32,55,180.0,,365,161,171,332,983.0,80,7.77,71,321,2447,12.7,0.65500885
14331,14331,Jorgen Pettersson,1986-87,30.0,7,34,70,70,13,21,34,101.0,,435,174,192,366,1084.0,80,7.94,82,370,2484,12.8,0.47461227
14332,14332,Jori Lehtera,2015-16,28.0,2,44,75,75,14,30,44,103.0,1216.0,75,14,30,44,103.0,82,5.32,47,251,2453,8.9,0.4873548
14333,14333,Jori Lehtera,2016-17,29.0,3,34,79,79,9,25,34,83.0,1271.0,154,23,55,78,186.0,82,5.34,48,255,2438,9.0,0.39408088
14334,14334,Jori Lehtera,2017-18,30.0,4,22,64,64,7,15,22,67.0,971.0,218,30,70,100,253.0,82,5.45,47,245,2478,9.0,0.2985399
14335,14335,Jori Lehtera,2018-19,31.0,5,8,62,62,3,5,8,45.0,652.0,280,33,75,108,298.0,82,5.86,50,250,2620,9.2,0.1793266
14336,14336,Jori Lehtera,2019-20,32.0,6,3,27,27,1,2,3,17.0,246.0,307,34,77,111,315.0,82,5.96,47,239,2579,9.5,0.18243551
14337,14337,Jose Charbonneau,1988-89,22.0,2,2,16,16,0,2,2,22.0,,16,0,2,2,22.0,80,7.43,89,437,2435,12.2,0.2664073
14338,14338,Jose Charbonneau,1989-90,23.0,3,5,22,22,1,4,5,31.0,,38,1,6,7,53.0,80,7.48,85,403,2430,12.3,0.282508
14339,14339,Jose Charbonneau,1994-95,28.0,4,14,30,30,7,7,14,28.0,,68,8,13,21,81.0,84,6.48,76,407,2545,10.7,0.2806303
14340,14340,Jose Charbonneau,1995-96,29.0,5,1,3,3,1,0,1,2.0,,71,9,13,22,83.0,48,5.97,37,209,1408,10.2,0.20653903
14341,14341,Josef Beranek,1992-93,23.0,2,28,58,58,12,16,28,79.0,,58,12,16,28,79.0,80,6.96,77,402,2440,11.4,0.46424752
14342,14342,Josef Beranek,1993-94,24.0,3,33,66,66,15,18,33,130.0,,124,27,34,61,209.0,84,7.25,87,443,2603,11.7,0.44682628
14343,14343,Josef Beranek,1994-95,25.0,4,49,80,80,28,21,49,182.0,,204,55,55,110,391.0,84,6.48,76,407,2545,10.7,0.5972676
14344,14344,Josef Beranek,1995-96,26.0,5,31,51,51,13,18,31,134.0,,255,68,73,141,525.0,48,5.97,37,209,1408,10.2,0.6647728
14345,14345,Josef Beranek,1996-97,27.0,6,20,61,61,6,14,20,131.0,,316,74,87,161,656.0,82,6.29,74,413,2481,10.4,0.4248705
14346,14346,Josef Beranek,1997-98,28.0,7,4,8,8,3,1,4,15.0,,324,77,88,165,671.0,82,5.83,55,336,2444,9.8,0.38931203
14347,14347,Josef Beranek,1999-00,30.0,8,49,66,66,19,30,49,160.0,1084.0,390,96,118,214,831.0,82,5.27,57,359,2285,9.4,0.60204506
14348,14348,Josef Beranek,2000-01,31.0,9,25,71,71,13,12,25,139.0,1029.0,461,109,130,239,970.0,82,5.49,53,331,2294,9.8,0.359905
14349,14349,Josef Beranek,2001-02,32.0,10,23,70,70,9,14,23,152.0,1011.0,531,118,144,262,1122.0,82,5.51,63,376,2272,9.9,0.31262654
14350,14350,Josef Boumedienne,2002-03,25.0,2,1,4,4,1,0,1,1.0,53.0,4,1,0,1,1.0,82,5.24,53,338,2262,9.5,0.23102605
14351,14351,Josef Boumedienne,2003-04,26.0,3,1,6,6,1,0,1,7.0,117.0,10,2,0,2,8.0,82,5.31,60,363,2326,9.4,0.18585163
14352,14352,Josef Boumedienne,2004-05,27.0,4,14,37,37,2,12,14,44.0,852.0,47,4,12,16,52.0,82,5.14,57,348,2300,9.2,0.23216102
14353,14353,Josef Marha,1996-97,20.0,2,1,2,2,0,1,1,2.0,,2,0,1,1,2.0,82,6.29,74,413,2481,10.4,0.2558233
14354,14354,Josef Marha,1997-98,21.0,3,1,6,6,0,1,1,6.0,,8,0,2,2,8.0,82,5.83,55,336,2444,9.8,0.24144581
14355,14355,Josef Marha,1998-99,22.0,4,18,23,23,9,9,18,31.0,,31,9,11,20,39.0,82,5.28,57,380,2242,9.6,0.44803983
14356,14356,Josef Marha,1999-00,23.0,5,8,32,32,2,6,8,45.0,442.0,63,11,17,28,84.0,82,5.27,57,359,2285,9.4,0.2992757
14357,14357,Josef Marha,2000-01,24.0,6,22,81,81,10,12,22,91.0,1080.0,144,21,29,50,175.0,82,5.49,53,331,2294,9.8,0.28032595
14358,14358,Josef Marha,2001-02,25.0,7,3,15,15,0,3,3,17.0,191.0,159,21,32,53,192.0,82,5.51,63,376,2272,9.9,0.25255328
14359,14359,Josef Melichar,2001-02,23.0,2,2,18,18,0,2,2,9.0,268.0,18,0,2,2,9.0,82,5.51,63,376,2272,9.9,0.16783246
14360,14360,Josef Melichar,2002-03,24.0,3,3,60,60,0,3,3,46.0,1006.0,78,0,5,5,55.0,82,5.24,53,338,2262,9.5,0.12942252
14361,14361,Josef Melichar,2003-04,25.0,4,0,8,8,0,0,0,6.0,122.0,86,0,5,5,61.0,82,5.31,60,363,2326,9.4,0.13627025
14362,14362,Josef Melichar,2004-05,26.0,5,8,82,82,3,5,8,78.0,1559.0,168,3,10,13,139.0,82,5.14,57,348,2300,9.2,0.18620199
14363,14363,Josef Melichar,2006-07,28.0,6,15,72,72,3,12,15,53.0,1256.0,240,6,22,28,192.0,82,6.05,85,480,2458,10.1,0.1632565
14364,14364,Josef Melichar,2007-08,29.0,7,12,70,70,1,11,12,57.0,1317.0,310,7,33,40,249.0,82,5.76,70,398,2426,9.7,0.13266087
14365,14365,Josef Melichar,2009-10,31.0,8,9,39,39,0,9,9,19.0,537.0,349,7,42,49,268.0,82,5.7,65,341,2477,9.4,0.1086109
14366,14366,Josef Vasicek,2001-02,21.0,2,21,76,76,8,13,21,103.0,898.0,76,8,13,21,103.0,82,5.51,63,376,2272,9.9,0.3289057
14367,14367,Josef Vasicek,2002-03,22.0,3,31,78,78,14,17,31,117.0,1107.0,154,22,30,52,220.0,82,5.24,53,338,2262,9.5,0.43500692
14368,14368,Josef Vasicek,2003-04,23.0,4,20,57,57,10,10,20,87.0,909.0,211,32,40,72,307.0,82,5.31,60,363,2326,9.4,0.42294872
14369,14369,Josef Vasicek,2004-05,24.0,5,45,82,82,19,26,45,161.0,1402.0,293,51,66,117,468.0,82,5.14,57,348,2300,9.2,0.5922574
14370,14370,Josef Vasicek,2006-07,26.0,6,9,23,23,4,5,9,41.0,354.0,316,55,71,126,509.0,82,6.05,85,480,2458,10.1,0.32493144
14371,14371,Josef Vasicek,2007-08,27.0,7,22,63,63,6,16,22,77.0,843.0,379,61,87,148,586.0,82,5.76,70,398,2426,9.7,0.33262283
14372,14372,Josef Vasicek,2008-09,28.0,8,35,81,81,16,19,35,126.0,1284.0,460,77,106,183,712.0,82,5.44,62,351,2383,9.4,0.43748066
14373,14373,Joseph Blandisi,2016-17,22.0,2,17,41,41,5,12,17,43.0,640.0,41,5,12,17,43.0,82,5.34,48,255,2438,9.0,0.3336097
14374,14374,Joseph Blandisi,2017-18,23.0,3,9,27,27,3,6,9,24.0,361.0,68,8,18,26,67.0,82,5.45,47,245,2478,9.0,0.28273946
14375,14375,Joseph Blandisi,2018-19,24.0,4,0,3,3,0,0,0,4.0,35.0,71,8,18,26,71.0,82,5.86,50,250,2620,9.2,0.18096417
14376,14376,Joseph Blandisi,2019-20,25.0,5,0,9,9,0,0,0,8.0,67.0,80,8,18,26,79.0,82,5.96,47,239,2579,9.5,0.18345788
14377,14377,Joseph Blandisi,2020-21,26.0,6,5,21,21,2,3,5,12.0,172.0,101,10,21,31,91.0,70,5.96,42,208,2192,9.5,0.22964099
14378,14378,Joseph Cramarossa,2017-18,25.0,2,10,59,59,4,6,10,36.0,587.0,59,4,6,10,36.0,82,5.45,47,245,2478,9.0,0.17960057
14379,14379,Joseph Gambardella,2019-20,26.0,2,3,15,15,0,3,3,7.0,122.0,15,0,3,3,7.0,82,5.96,47,239,2579,9.5,0.174712
14380,14380,Joseph Labate,2017-18,24.0,2,0,13,13,0,0,0,5.0,88.0,13,0,0,0,5.0,82,5.45,47,245,2478,9.0,0.16383997
14381,14381,Joseph Morrow,2015-16,23.0,2,1,15,15,1,0,1,20.0,250.0,15,1,0,1,20.0,82,5.32,47,251,2453,8.9,0.21861437
14382,14382,Joseph Morrow,2016-17,24.0,3,7,33,33,1,6,7,44.0,525.0,48,2,6,8,64.0,82,5.34,48,255,2438,9.0,0.19247052
14383,14383,Joseph Morrow,2017-18,25.0,4,1,17,17,0,1,1,19.0,264.0,65,2,7,9,83.0,82,5.45,47,245,2478,9.0,0.18236154
14384,14384,Joseph Morrow,2018-19,26.0,5,16,56,56,6,10,16,83.0,937.0,121,8,17,25,166.0,82,5.86,50,250,2620,9.2,0.2759419
14385,14385,Joseph Morrow,2019-20,27.0,6,7,41,41,1,6,7,40.0,572.0,162,9,23,32,206.0,82,5.96,47,239,2579,9.5,0.14111766
14386,14386,Josh Anderson,2015-16,21.0,2,1,6,6,0,1,1,10.0,81.0,6,0,1,1,10.0,82,5.32,47,251,2453,8.9,0.26745385
14387,14387,Josh Anderson,2016-17,22.0,3,4,12,12,1,3,4,11.0,128.0,18,1,4,5,21.0,82,5.34,48,255,2438,9.0,0.22052652
14388,14388,Josh Anderson,2017-18,23.0,4,29,78,78,17,12,29,119.0,938.0,96,18,16,34,140.0,82,5.45,47,245,2478,9.0,0.40323678
14389,14389,Josh Anderson,2018-19,24.0,5,30,63,63,19,11,30,188.0,1136.0,159,37,27,64,328.0,82,5.86,50,250,2620,9.2,0.5213803
14390,14390,Josh Anderson,2019-20,25.0,6,47,82,82,27,20,47,230.0,1396.0,241,64,47,111,558.0,82,5.96,47,239,2579,9.5,0.59813106
14391,14391,Josh Anderson,2020-21,26.0,7,4,26,26,1,3,4,63.0,418.0,267,65,50,115,621.0,70,5.96,42,208,2192,9.5,0.27903795
14392,14392,Josh Archibald,2016-17,24.0,2,0,1,1,0,0,0,0.0,5.0,1,0,0,0,0.0,82,5.34,48,255,2438,9.0,0.14684695
14393,14393,Josh Archibald,2017-18,25.0,3,3,10,10,3,0,3,11.0,109.0,11,3,0,3,11.0,82,5.45,47,245,2478,9.0,0.23786294
14394,14394,Josh Archibald,2018-19,26.0,4,11,42,42,5,6,11,42.0,502.0,53,8,6,14,53.0,82,5.86,50,250,2620,9.2,0.20593512
14395,14395,Josh Archibald,2019-20,27.0,5,22,68,68,12,10,22,92.0,923.0,121,20,16,36,145.0,82,5.96,47,239,2579,9.5,0.28755695
14396,14396,Josh Archibald,2020-21,28.0,6,21,62,62,12,9,21,64.0,820.0,183,32,25,57,209.0,70,5.96,42,208,2192,9.5,0.27966657
14397,14397,Josh Bailey,2009-10,20.0,2,25,68,68,7,18,25,74.0,1053.0,68,7,18,25,74.0,82,5.7,65,341,2477,9.4,0.41007978
14398,14398,Josh Bailey,2010-11,21.0,3,35,73,73,16,19,35,112.0,1106.0,141,23,37,60,186.0,82,5.53,56,304,2486,9.1,0.4761262
14399,14399,Josh Bailey,2011-12,22.0,4,28,70,70,11,17,28,102.0,1248.0,211,34,54,88,288.0,82,5.46,52,291,2492,9.0,0.46184745
14400,14400,Josh Bailey,2012-13,23.0,5,32,80,80,13,19,32,104.0,1218.0,291,47,73,120,392.0,82,5.32,47,271,2439,8.9,0.47492608
14401,14401,Josh Bailey,2013-14,24.0,6,19,38,38,11,8,19,76.0,622.0,329,58,81,139,468.0,48,5.31,29,160,1399,9.1,0.57435876
14402,14402,Josh Bailey,2014-15,25.0,7,38,77,77,8,30,38,98.0,1220.0,406,66,111,177,566.0,82,5.34,48,269,2463,8.9,0.48657507
14403,14403,Josh Bailey,2015-16,26.0,8,41,70,70,15,26,41,140.0,1175.0,476,81,137,218,706.0,82,5.32,47,251,2453,8.9,0.5684138
14404,14404,Josh Bailey,2016-17,27.0,9,32,81,81,12,20,32,105.0,1284.0,557,93,157,250,811.0,82,5.34,48,255,2438,9.0,0.4116994
14405,14405,Josh Bailey,2017-18,28.0,10,56,82,82,13,43,56,173.0,1506.0,639,106,200,306,984.0,82,5.45,47,245,2478,9.0,0.653023
14406,14406,Josh Bailey,2018-19,29.0,11,71,76,76,18,53,71,151.0,1359.0,715,124,253,377,1135.0,82,5.86,50,250,2620,9.2,0.7728535
14407,14407,Josh Bailey,2019-20,30.0,12,56,82,82,16,40,56,126.0,1380.0,797,140,293,433,1261.0,82,5.96,47,239,2579,9.5,0.6369734
14408,14408,Josh Bailey,2020-21,31.0,13,43,68,68,14,29,43,94.0,1149.0,865,154,322,476,1355.0,70,5.96,42,208,2192,9.5,0.51055753
14409,14409,Josh Brown,2019-20,26.0,2,2,37,37,1,1,2,28.0,492.0,37,1,1,2,28.0,82,5.96,47,239,2579,9.5,0.17304334
14410,14410,Josh Brown,2020-21,27.0,3,8,56,56,3,5,8,48.0,751.0,93,4,6,10,76.0,70,5.96,42,208,2192,9.5,0.17573988
14411,14411,Josh Currie,2019-20,27.0,2,5,21,21,2,3,5,19.0,183.0,21,2,3,5,19.0,82,5.96,47,239,2579,9.5,0.19440264
14412,14412,Josh Gorges,2006-07,22.0,2,6,49,49,0,6,6,25.0,864.0,49,0,6,6,25.0,82,6.05,85,480,2458,10.1,0.14369169
14413,14413,Josh Gorges,2007-08,23.0,3,4,54,54,1,3,4,40.0,924.0,103,1,9,10,65.0,82,5.76,70,398,2426,9.7,0.16864654
14414,14414,Josh Gorges,2008-09,24.0,4,9,62,62,0,9,9,41.0,1013.0,165,1,18,19,106.0,82,5.44,62,351,2383,9.4,0.14695045
14415,14415,Josh Gorges,2009-10,25.0,5,23,81,81,4,19,23,63.0,1630.0,246,5,37,42,169.0,82,5.7,65,341,2477,9.4,0.22936523
14416,14416,Josh Gorges,2010-11,26.0,6,10,82,82,3,7,10,52.0,1723.0,328,8,44,52,221.0,82,5.53,56,304,2486,9.1,0.16182008
14417,14417,Josh Gorges,2011-12,27.0,7,7,36,36,1,6,7,20.0,762.0,364,9,50,59,241.0,82,5.46,52,291,2492,9.0,0.14753741
14418,14418,Josh Gorges,2012-13,28.0,8,16,82,82,2,14,16,59.0,1856.0,446,11,64,75,300.0,82,5.32,47,271,2439,8.9,0.18051198
14419,14419,Josh Gorges,2013-14,29.0,9,9,48,48,2,7,9,40.0,1027.0,494,13,71,84,340.0,48,5.31,29,160,1399,9.1,0.1737999
14420,14420,Josh Gorges,2014-15,30.0,10,14,66,66,1,13,14,35.0,1402.0,560,14,84,98,375.0,82,5.34,48,269,2463,8.9,0.13026297
14421,14421,Josh Gorges,2015-16,31.0,11,6,46,46,0,6,6,28.0,1029.0,606,14,90,104,403.0,82,5.32,47,251,2453,8.9,0.1054934
14422,14422,Josh Gorges,2016-17,32.0,12,12,77,77,2,10,12,57.0,1576.0,683,16,100,116,460.0,82,5.34,48,255,2438,9.0,0.13343018
14423,14423,Josh Gorges,2017-18,33.0,13,6,66,66,1,5,6,40.0,1218.0,749,17,105,122,500.0,82,5.45,47,245,2478,9.0,0.11823937
14424,14424,Josh Gorges,2018-19,34.0,14,2,34,34,0,2,2,15.0,508.0,783,17,107,124,515.0,82,5.86,50,250,2620,9.2,0.096060246
14425,14425,Josh Gratton,2006-07,24.0,2,1,14,14,1,0,1,17.0,103.0,14,1,0,1,17.0,82,6.05,85,480,2458,10.1,0.19980866
14426,14426,Josh Gratton,2007-08,25.0,3,2,52,52,1,1,2,29.0,307.0,66,2,1,3,46.0,82,5.76,70,398,2426,9.7,0.11145896
14427,14427,Josh Gratton,2008-09,26.0,4,0,1,1,0,0,0,0.0,10.0,67,2,1,3,46.0,82,5.44,62,351,2383,9.4,0.14042446
14428,14428,Josh Gratton,2009-10,27.0,5,3,19,19,1,2,3,14.0,119.0,86,3,3,6,60.0,82,5.7,65,341,2477,9.4,0.12133703
14429,14429,Josh Green,1999-00,22.0,2,4,27,27,1,3,4,35.0,317.0,27,1,3,4,35.0,82,5.27,57,359,2285,9.4,0.22135833
14430,14430,Josh Green,2000-01,23.0,3,26,49,49,12,14,26,109.0,666.0,76,13,17,30,144.0,82,5.49,53,331,2294,9.8,0.49199858
14431,14431,Josh Green,2002-03,25.0,4,15,61,61,10,5,15,78.0,615.0,137,23,22,45,222.0,82,5.24,53,338,2262,9.5,0.2663985
14432,14432,Josh Green,2003-04,26.0,5,5,45,45,1,4,5,43.0,414.0,182,24,26,50,265.0,82,5.31,60,363,2326,9.4,0.18064454
14433,14433,Josh Green,2004-05,27.0,6,11,50,50,5,6,11,76.0,607.0,232,29,32,61,341.0,82,5.14,57,348,2300,9.2,0.2814371
14434,14434,Josh Green,2006-07,29.0,7,6,33,33,4,2,6,35.0,283.0,265,33,34,67,376.0,82,6.05,85,480,2458,10.1,0.21951571
14435,14435,Josh Green,2007-08,30.0,8,7,57,57,2,5,7,74.0,650.0,322,35,39,74,450.0,82,5.76,70,398,2426,9.7,0.1714541
14436,14436,Josh Green,2011-12,34.0,9,0,12,12,0,0,0,10.0,120.0,334,35,39,74,460.0,82,5.46,52,291,2492,9.0,0.20036227
14437,14437,Josh Green,2012-13,35.0,10,2,7,7,1,1,2,14.0,83.0,341,36,40,76,474.0,82,5.32,47,271,2439,8.9,0.16848043
14438,14438,Josh Hennessy,2007-08,22.0,2,1,10,10,1,0,1,6.0,57.0,10,1,0,1,6.0,82,5.76,70,398,2426,9.7,0.21320233
14439,14439,Josh Hennessy,2008-09,23.0,3,0,5,5,0,0,0,2.0,19.0,15,1,0,1,8.0,82,5.44,62,351,2383,9.4,0.16725525
14440,14440,Josh Hennessy,2009-10,24.0,4,0,1,1,0,0,0,0.0,14.0,16,1,0,1,8.0,82,5.7,65,341,2477,9.4,0.15349486
14441,14441,Josh Hennessy,2010-11,25.0,5,0,4,4,0,0,0,2.0,24.0,20,1,0,1,10.0,82,5.53,56,304,2486,9.1,0.14735559
14442,14442,Josh Hennessy,2012-13,27.0,6,0,3,3,0,0,0,2.0,20.0,23,1,0,1,12.0,82,5.32,47,271,2439,8.9,0.13431615
14443,14443,Josh Holden,1999-00,22.0,2,6,30,30,2,4,6,44.0,382.0,30,2,4,6,44.0,82,5.27,57,359,2285,9.4,0.26447123
14444,14444,Josh Holden,2000-01,23.0,3,6,6,6,1,5,6,5.0,63.0,36,3,9,12,49.0,82,5.49,53,331,2294,9.8,0.23566458
14445,14445,Josh Holden,2001-02,24.0,4,1,10,10,1,0,1,12.0,94.0,46,4,9,13,61.0,82,5.51,63,376,2272,9.9,0.20146182
14446,14446,Josh Holden,2002-03,25.0,5,0,8,8,0,0,0,3.0,42.0,54,4,9,13,64.0,82,5.24,53,338,2262,9.5,0.14744118
14447,14447,Josh Holden,2003-04,26.0,6,1,5,5,1,0,1,6.0,40.0,59,5,9,14,70.0,82,5.31,60,363,2326,9.4,0.16653365
14448,14448,Josh Holden,2004-05,27.0,7,0,1,1,0,0,0,0.0,11.0,60,5,9,14,70.0,82,5.14,57,348,2300,9.2,0.1774742
14449,14449,Josh Jooris,2015-16,25.0,2,24,60,60,12,12,24,89.0,870.0,60,12,12,24,89.0,82,5.32,47,251,2453,8.9,0.3594375
14450,14450,Josh Jooris,2016-17,26.0,3,13,59,59,4,9,13,80.0,725.0,119,16,21,37,169.0,82,5.34,48,255,2438,9.0,0.24614155
14451,14451,Josh Jooris,2017-18,27.0,4,12,54,54,4,8,12,75.0,659.0,173,20,29,49,244.0,82,5.45,47,245,2478,9.0,0.24833182
14452,14452,Josh Jooris,2018-19,28.0,5,6,40,40,3,3,6,50.0,391.0,213,23,32,55,294.0,82,5.86,50,250,2620,9.2,0.21496609
14453,14453,Josh Langfeld,2002-03,25.0,2,0,1,1,0,0,0,5.0,8.0,1,0,0,0,5.0,82,5.24,53,338,2262,9.5,0.16791895
14454,14454,Josh Langfeld,2003-04,26.0,3,1,12,12,0,1,1,16.0,134.0,13,0,1,1,21.0,82,5.31,60,363,2326,9.4,0.17892686
14455,14455,Josh Langfeld,2004-05,27.0,4,17,38,38,7,10,17,59.0,414.0,51,7,11,18,80.0,82,5.14,57,348,2300,9.2,0.35507733
14456,14456,Josh Langfeld,2006-07,29.0,5,12,57,57,2,10,12,85.0,628.0,108,9,21,30,165.0,82,6.05,85,480,2458,10.1,0.212087
14457,14457,Josh Langfeld,2007-08,30.0,6,2,33,33,0,2,2,37.0,183.0,141,9,23,32,202.0,82,5.76,70,398,2426,9.7,0.1339083
14458,14458,Josh Langfeld,2008-09,31.0,7,0,2,2,0,0,0,5.0,20.0,143,9,23,32,207.0,82,5.44,62,351,2383,9.4,0.13934916
14459,14459,Josh Leivo,2014-15,21.0,2,2,7,7,1,1,2,4.0,69.0,7,1,1,2,4.0,82,5.34,48,269,2463,8.9,0.2520967
14460,14460,Josh Leivo,2015-16,22.0,3,1,9,9,1,0,1,10.0,69.0,16,2,1,3,14.0,82,5.32,47,251,2453,8.9,0.2271387
14461,14461,Josh Leivo,2016-17,23.0,4,5,12,12,5,0,5,20.0,148.0,28,7,1,8,34.0,82,5.34,48,255,2438,9.0,0.32246116
14462,14462,Josh Leivo,2017-18,24.0,5,10,13,13,2,8,10,27.0,163.0,41,9,9,18,61.0,82,5.45,47,245,2478,9.0,0.3052262
14463,14463,Josh Leivo,2018-19,25.0,6,4,16,16,1,3,4,25.0,169.0,57,10,12,22,86.0,82,5.86,50,250,2620,9.2,0.24207675
14464,14464,Josh Leivo,2019-20,26.0,7,24,76,76,14,10,24,151.0,1066.0,133,24,22,46,237.0,82,5.96,47,239,2579,9.5,0.3413224
14465,14465,Josh Leivo,2020-21,27.0,8,19,36,36,7,12,19,69.0,540.0,169,31,34,65,306.0,70,5.96,42,208,2192,9.5,0.4164765
14466,14466,Josh Mahura,2019-20,21.0,2,5,17,17,1,4,5,20.0,243.0,17,1,4,5,20.0,82,5.96,47,239,2579,9.5,0.2865321
14467,14467,Josh Mahura,2020-21,22.0,3,4,11,11,1,3,4,11.0,179.0,28,2,7,9,31.0,70,5.96,42,208,2192,9.5,0.27548063
14468,14468,Josh Manson,2015-16,24.0,2,3,28,28,0,3,3,26.0,516.0,28,0,3,3,26.0,82,5.32,47,251,2453,8.9,0.17733097
14469,14469,Josh Manson,2016-17,25.0,3,15,71,71,5,10,15,88.0,1334.0,99,5,13,18,114.0,82,5.34,48,255,2438,9.0,0.23591366
14470,14470,Josh Manson,2017-18,26.0,4,17,82,82,5,12,17,88.0,1527.0,181,10,25,35,202.0,82,5.45,47,245,2478,9.0,0.22762987
14471,14471,Josh Manson,2018-19,27.0,5,37,80,80,7,30,37,117.0,1628.0,261,17,55,72,319.0,82,5.86,50,250,2620,9.2,0.38527647
14472,14472,Josh Manson,2019-20,28.0,6,16,74,74,3,13,16,96.0,1651.0,335,20,68,88,415.0,82,5.96,47,239,2579,9.5,0.24332353
14473,14473,Josh Manson,2020-21,29.0,7,9,50,50,1,8,9,64.0,1032.0,385,21,76,97,479.0,70,5.96,42,208,2192,9.5,0.19643942
14474,14474,Josh Morrissey,2016-17,21.0,2,0,1,1,0,0,0,1.0,16.0,1,0,0,0,1.0,82,5.34,48,255,2438,9.0,0.19850874
14475,14475,Josh Morrissey,2017-18,22.0,3,20,82,82,6,14,20,99.0,1598.0,83,6,14,20,100.0,82,5.45,47,245,2478,9.0,0.32160586
14476,14476,Josh Morrissey,2018-19,23.0,4,26,81,81,7,19,26,102.0,1657.0,164,13,33,46,202.0,82,5.86,50,250,2620,9.2,0.3571737
14477,14477,Josh Morrissey,2019-20,24.0,5,31,59,59,6,25,31,95.0,1322.0,223,19,58,77,297.0,82,5.96,47,239,2579,9.5,0.47471538
14478,14478,Josh Morrissey,2020-21,25.0,6,31,65,65,5,26,31,120.0,1480.0,288,24,84,108,417.0,70,5.96,42,208,2192,9.5,0.46289825
14479,14479,Josh Olson,2004-05,23.0,2,1,5,5,1,0,1,6.0,41.0,5,1,0,1,6.0,82,5.14,57,348,2300,9.2,0.26211506
14480,14480,Josh Teves,2019-20,24.0,2,0,1,1,0,0,0,0.0,14.0,1,0,0,0,0.0,82,5.96,47,239,2579,9.5,0.16006637
14481,14481,Joshua Ho-Sang,2017-18,22.0,2,10,21,21,4,6,10,22.0,346.0,21,4,6,10,22.0,82,5.45,47,245,2478,9.0,0.3227095
14482,14482,Joshua Ho-Sang,2018-19,23.0,3,12,22,22,2,10,12,18.0,314.0,43,6,16,22,40.0,82,5.86,50,250,2620,9.2,0.292098
14483,14483,Joshua Ho-Sang,2019-20,24.0,4,2,10,10,1,1,2,10.0,145.0,53,7,17,24,50.0,82,5.96,47,239,2579,9.5,0.23206481
14484,14484,Joshua Jacobs,2019-20,23.0,2,0,1,1,0,0,0,1.0,15.0,1,0,0,0,1.0,82,5.96,47,239,2579,9.5,0.18259898
14485,14485,Joshua Jacobs,2020-21,24.0,3,0,2,2,0,0,0,3.0,33.0,3,0,0,0,4.0,70,5.96,42,208,2192,9.5,0.18707949
14486,14486,Joshua Norris,2020-21,21.0,2,0,3,3,0,0,0,9.0,54.0,3,0,0,0,9.0,70,5.96,42,208,2192,9.5,0.2214064
14487,14487,Jozef Balej,2004-05,22.0,2,5,17,17,1,4,5,29.0,221.0,17,1,4,5,29.0,82,5.14,57,348,2300,9.2,0.31585288
14488,14488,Jozef Balej,2006-07,24.0,3,1,1,1,0,1,1,3.0,8.0,18,1,5,6,32.0,82,6.05,85,480,2458,10.1,0.1750597
14489,14489,Jozef Cierny,1994-95,20.0,2,0,1,1,0,0,0,0.0,,1,0,0,0,0.0,84,6.48,76,407,2545,10.7,0.23598891
14490,14490,Jozef Stumpel,1992-93,20.0,2,1,4,4,1,0,1,3.0,,4,1,0,1,3.0,80,6.96,77,402,2440,11.4,0.31183448
14491,14491,Jozef Stumpel,1993-94,21.0,3,4,13,13,1,3,4,8.0,,17,2,3,5,11.0,84,7.25,87,443,2603,11.7,0.28152537
14492,14492,Jozef Stumpel,1994-95,22.0,4,23,59,59,8,15,23,62.0,,76,10,18,28,73.0,84,6.48,76,407,2545,10.7,0.3589493
14493,14493,Jozef Stumpel,1995-96,23.0,5,18,44,44,5,13,18,46.0,,120,15,31,46,119.0,48,5.97,37,209,1408,10.2,0.41171458
14494,14494,Jozef Stumpel,1996-97,24.0,6,54,76,76,18,36,54,158.0,,196,33,67,100,277.0,82,6.29,74,413,2481,10.4,0.6148207
14495,14495,Jozef Stumpel,1997-98,25.0,7,76,78,78,21,55,76,168.0,,274,54,122,176,445.0,82,5.83,55,336,2444,9.8,0.83888984
14496,14496,Jozef Stumpel,1998-99,26.0,8,79,77,77,21,58,79,162.0,,351,75,180,255,607.0,82,5.28,57,380,2242,9.6,0.84093547
14497,14497,Jozef Stumpel,1999-00,27.0,9,34,64,64,13,21,34,131.0,1263.0,415,88,201,289,738.0,82,5.27,57,359,2285,9.4,0.6142511
14498,14498,Jozef Stumpel,2000-01,28.0,10,58,57,57,17,41,58,126.0,1098.0,472,105,242,347,864.0,82,5.49,53,331,2294,9.8,0.87443197
14499,14499,Jozef Stumpel,2001-02,29.0,11,55,63,63,16,39,55,95.0,1234.0,535,121,281,402,959.0,82,5.51,63,376,2272,9.9,0.72714484
14500,14500,Jozef Stumpel,2002-03,30.0,12,58,81,81,8,50,58,100.0,1520.0,616,129,331,460,1059.0,82,5.24,53,338,2262,9.5,0.6464769
14501,14501,Jozef Stumpel,2003-04,31.0,13,51,78,78,14,37,51,110.0,1439.0,694,143,368,511,1169.0,82,5.31,60,363,2326,9.4,0.6076724
14502,14502,Jozef Stumpel,2004-05,32.0,14,37,64,64,8,29,37,78.0,1201.0,758,151,397,548,1247.0,82,5.14,57,348,2300,9.2,0.6073203
14503,14503,Jozef Stumpel,2006-07,34.0,15,52,74,74,15,37,52,115.0,1316.0,832,166,434,600,1362.0,82,6.05,85,480,2458,10.1,0.5978921
14504,14504,Jozef Stumpel,2007-08,35.0,16,57,73,73,23,34,57,131.0,1396.0,905,189,468,657,1493.0,82,5.76,70,398,2426,9.7,0.5868116
14505,14505,Jozef Stumpel,2008-09,36.0,17,20,52,52,7,13,20,64.0,903.0,957,196,481,677,1557.0,82,5.44,62,351,2383,9.4,0.38843733
14506,14506,Juha Lind,1998-99,25.0,2,5,39,39,2,3,5,27.0,,39,2,3,5,27.0,82,5.28,57,380,2242,9.6,0.15358925
14507,14507,Juha Lind,2000-01,27.0,3,10,47,47,4,6,10,42.0,493.0,86,6,9,15,69.0,82,5.49,53,331,2294,9.8,0.1840435
14508,14508,Juha Lind,2001-02,28.0,4,7,47,47,3,4,7,36.0,367.0,133,9,13,22,105.0,82,5.51,63,376,2272,9.9,0.13885185
14509,14509,Juha Ylonen,1997-98,25.0,2,0,2,2,0,0,0,2.0,,2,0,0,0,2.0,82,5.83,55,336,2444,9.8,0.16366741
14510,14510,Juha Ylonen,1998-99,26.0,3,12,55,55,1,11,12,60.0,,57,1,11,12,62.0,82,5.28,57,380,2242,9.6,0.1733762
14511,14511,Juha Ylonen,1999-00,27.0,4,23,59,59,6,17,23,66.0,939.0,116,7,28,35,128.0,82,5.27,57,359,2285,9.4,0.31224883
14512,14512,Juha Ylonen,2000-01,28.0,5,29,76,76,6,23,29,82.0,1270.0,192,13,51,64,210.0,82,5.49,53,331,2294,9.8,0.34153527
14513,14513,Juha Ylonen,2001-02,29.0,6,23,69,69,9,14,23,72.0,987.0,261,22,65,87,282.0,82,5.51,63,376,2272,9.9,0.2885327
14514,14514,Juha Ylonen,2002-03,30.0,7,15,80,80,4,11,15,97.0,1253.0,341,26,76,102,379.0,82,5.24,53,338,2262,9.5,0.22455677
14515,14515,Juho Lammikko,2019-20,24.0,2,6,40,40,0,6,6,39.0,437.0,40,0,6,6,39.0,82,5.96,47,239,2579,9.5,0.17306238
14516,14516,Jujhar Khaira,2016-17,22.0,2,2,15,15,0,2,2,14.0,155.0,15,0,2,2,14.0,82,5.34,48,255,2438,9.0,0.18089569
14517,14517,Jujhar Khaira,2017-18,23.0,3,1,10,10,1,0,1,10.0,93.0,25,1,2,3,24.0,82,5.45,47,245,2478,9.0,0.22106695
14518,14518,Jujhar Khaira,2018-19,24.0,4,21,69,69,11,10,21,73.0,877.0,94,12,12,24,97.0,82,5.86,50,250,2620,9.2,0.30097696
14519,14519,Jujhar Khaira,2019-20,25.0,5,18,60,60,3,15,18,64.0,754.0,154,15,27,42,161.0,82,5.96,47,239,2579,9.5,0.24677745
14520,14520,Jujhar Khaira,2020-21,26.0,6,10,64,64,6,4,10,69.0,802.0,218,21,31,52,230.0,70,5.96,42,208,2192,9.5,0.24329436
14521,14521,Jukka Hentunen,2002-03,28.0,2,9,38,38,4,5,9,50.0,440.0,38,4,5,9,50.0,82,5.24,53,338,2262,9.5,0.20560801
14522,14522,Jukka Porvari,1982-83,29.0,2,8,31,31,2,6,8,45.0,,31,2,6,8,45.0,80,8.03,73,320,2489,12.9,0.28389084
14523,14523,Jukka Porvari,1983-84,30.0,3,4,8,8,1,3,4,10.0,,39,3,9,12,55.0,80,7.73,71,310,2444,12.7,0.24014512
14524,14524,Julian Melchiori,2014-15,23.0,2,0,1,1,0,0,0,0.0,9.0,1,0,0,0,0.0,82,5.34,48,269,2463,8.9,0.14718214
14525,14525,Julian Melchiori,2016-17,25.0,3,0,11,11,0,0,0,12.0,150.0,12,0,0,0,12.0,82,5.34,48,255,2438,9.0,0.17272297
14526,14526,Julian Melchiori,2017-18,26.0,4,2,18,18,0,2,2,15.0,331.0,30,0,2,2,27.0,82,5.45,47,245,2478,9.0,0.17512155
14527,14527,Julien Brouillette,2014-15,28.0,2,2,10,10,1,1,2,4.0,156.0,10,1,1,2,4.0,82,5.34,48,269,2463,8.9,0.16214105
14528,14528,Julien Brouillette,2015-16,29.0,3,0,1,1,0,0,0,0.0,10.0,11,1,1,2,4.0,82,5.32,47,251,2453,8.9,0.13660237
14529,14529,Julien Gauthier,2020-21,23.0,2,3,17,17,0,3,3,10.0,141.0,17,0,3,3,10.0,70,5.96,42,208,2192,9.5,0.22488222
14530,14530,Julien Vauclair,2004-05,25.0,2,0,1,1,0,0,0,0.0,13.0,1,0,0,0,0.0,82,5.14,57,348,2300,9.2,0.29285395
14531,14531,Julius Honka,2017-18,22.0,2,5,16,16,1,4,5,34.0,270.0,16,1,4,5,34.0,82,5.45,47,245,2478,9.0,0.25493693
14532,14532,Julius Honka,2018-19,23.0,3,4,42,42,1,3,4,42.0,546.0,58,2,7,9,76.0,82,5.86,50,250,2620,9.2,0.19382104
14533,14533,Julius Honka,2019-20,24.0,4,4,29,29,0,4,4,38.0,398.0,87,2,11,13,114.0,82,5.96,47,239,2579,9.5,0.18130818
14534,14534,Junior Lessard,2006-07,26.0,2,1,5,5,1,0,1,6.0,37.0,5,1,0,1,6.0,82,6.05,85,480,2458,10.1,0.20106712
14535,14535,Junior Lessard,2007-08,27.0,3,1,1,1,1,0,1,3.0,12.0,6,2,0,2,9.0,82,5.76,70,398,2426,9.7,0.18837908
14536,14536,Junior Lessard,2008-09,28.0,4,2,21,21,1,1,2,21.0,207.0,27,3,1,4,30.0,82,5.44,62,351,2383,9.4,0.16811457
14537,14537,Juraj Kolnik,2001-02,21.0,2,7,29,29,4,3,7,38.0,303.0,29,4,3,7,38.0,82,5.51,63,376,2272,9.9,0.29421866
14538,14538,Juraj Kolnik,2002-03,22.0,3,2,7,7,2,0,2,10.0,56.0,36,6,3,9,48.0,82,5.24,53,338,2262,9.5,0.26437786
14539,14539,Juraj Kolnik,2003-04,23.0,4,1,10,10,0,1,1,14.0,106.0,46,6,4,10,62.0,82,5.31,60,363,2326,9.4,0.2176345
14540,14540,Juraj Kolnik,2004-05,24.0,5,25,53,53,14,11,25,100.0,852.0,99,20,15,35,162.0,82,5.14,57,348,2300,9.2,0.48470932
14541,14541,Juraj Kolnik,2006-07,26.0,6,35,77,77,15,20,35,145.0,1102.0,176,35,35,70,307.0,82,6.05,85,480,2458,10.1,0.424097
14542,14542,Juraj Kolnik,2007-08,27.0,7,25,64,64,11,14,25,113.0,774.0,240,46,49,95,420.0,82,5.76,70,398,2426,9.7,0.34821182
14543,14543,Jussi Jokinen,2006-07,23.0,2,55,81,81,17,38,55,107.0,1099.0,81,17,38,55,107.0,82,6.05,85,480,2458,10.1,0.6366509
14544,14544,Jussi Jokinen,2007-08,24.0,3,48,82,82,14,34,48,121.0,1140.0,163,31,72,103,228.0,82,5.76,70,398,2426,9.7,0.5705607
14545,14545,Jussi Jokinen,2008-09,25.0,4,42,72,72,16,26,42,131.0,1041.0,235,47,98,145,359.0,82,5.44,62,351,2383,9.4,0.5606898
14546,14546,Jussi Jokinen,2009-10,26.0,5,27,71,71,7,20,27,101.0,1087.0,306,54,118,172,460.0,82,5.7,65,341,2477,9.4,0.46045536
14547,14547,Jussi Jokinen,2010-11,27.0,6,65,81,81,30,35,65,160.0,1362.0,387,84,153,237,620.0,82,5.53,56,304,2486,9.1,0.7028375
14548,14548,Jussi Jokinen,2011-12,28.0,7,52,70,70,19,33,52,136.0,1206.0,457,103,186,289,756.0,82,5.46,52,291,2492,9.0,0.6269207
14549,14549,Jussi Jokinen,2012-13,29.0,8,46,79,79,12,34,46,118.0,1396.0,536,115,220,335,874.0,82,5.32,47,271,2439,8.9,0.53354174
14550,14550,Jussi Jokinen,2013-14,30.0,9,22,43,43,13,9,22,74.0,664.0,579,128,229,357,948.0,48,5.31,29,160,1399,9.1,0.5365031
14551,14551,Jussi Jokinen,2014-15,31.0,10,57,81,81,21,36,57,172.0,1272.0,660,149,265,414,1120.0,82,5.34,48,269,2463,8.9,0.64151824
14552,14552,Jussi Jokinen,2015-16,32.0,11,44,81,81,8,36,44,134.0,1356.0,741,157,301,458,1254.0,82,5.32,47,251,2453,8.9,0.5098691
14553,14553,Jussi Jokinen,2016-17,33.0,12,60,81,81,18,42,60,153.0,1482.0,822,175,343,518,1407.0,82,5.34,48,255,2438,9.0,0.6503022
14554,14554,Jussi Jokinen,2017-18,34.0,13,28,69,69,11,17,28,118.0,1201.0,891,186,360,546,1525.0,82,5.45,47,245,2478,9.0,0.35920876
14555,14555,Jussi Jokinen,2018-19,35.0,14,17,60,60,5,12,17,73.0,695.0,951,191,372,563,1598.0,82,5.86,50,250,2620,9.2,0.27566335
14556,14556,Jussi Timonen,2007-08,24.0,2,4,14,14,0,4,4,8.0,199.0,14,0,4,4,8.0,82,5.76,70,398,2426,9.7,0.17639616
14557,14557,Justin Abdelkader,2008-09,21.0,2,0,2,2,0,0,0,6.0,24.0,2,0,0,0,6.0,82,5.44,62,351,2383,9.4,0.21860492
14558,14558,Justin Abdelkader,2009-10,22.0,3,0,2,2,0,0,0,2.0,19.0,4,0,0,0,8.0,82,5.7,65,341,2477,9.4,0.18931857
14559,14559,Justin Abdelkader,2010-11,23.0,4,6,50,50,3,3,6,79.0,530.0,54,3,3,6,87.0,82,5.53,56,304,2486,9.1,0.2556656
14560,14560,Justin Abdelkader,2011-12,24.0,5,19,74,74,7,12,19,129.0,910.0,128,10,15,25,216.0,82,5.46,52,291,2492,9.0,0.2964161
14561,14561,Justin Abdelkader,2012-13,25.0,6,22,81,81,8,14,22,121.0,997.0,209,18,29,47,337.0,82,5.32,47,271,2439,8.9,0.24995431
14562,14562,Justin Abdelkader,2013-14,26.0,7,13,48,48,10,3,13,96.0,711.0,257,28,32,60,433.0,48,5.31,29,160,1399,9.1,0.32117695
14563,14563,Justin Abdelkader,2014-15,27.0,8,28,70,70,10,18,28,147.0,1070.0,327,38,50,88,580.0,82,5.34,48,269,2463,8.9,0.354021
14564,14564,Justin Abdelkader,2015-16,28.0,9,44,71,71,23,21,44,154.0,1272.0,398,61,71,132,734.0,82,5.32,47,251,2453,8.9,0.47852266
14565,14565,Justin Abdelkader,2016-17,29.0,10,42,82,82,19,23,42,155.0,1512.0,480,80,94,174,889.0,82,5.34,48,255,2438,9.0,0.47228482
14566,14566,Justin Abdelkader,2017-18,30.0,11,21,64,64,7,14,21,104.0,1066.0,544,87,108,195,993.0,82,5.45,47,245,2478,9.0,0.30853432
14567,14567,Justin Abdelkader,2018-19,31.0,12,35,75,75,13,22,35,110.0,1241.0,619,100,130,230,1103.0,82,5.86,50,250,2620,9.2,0.3548516
14568,14568,Justin Abdelkader,2019-20,32.0,13,19,71,71,6,13,19,95.0,1093.0,690,106,143,249,1198.0,82,5.96,47,239,2579,9.5,0.25979906
14569,14569,Justin Abdelkader,2020-21,33.0,14,3,49,49,0,3,3,40.0,565.0,739,106,146,252,1238.0,70,5.96,42,208,2192,9.5,0.17888656
14570,14570,Justin Auger,2018-19,24.0,2,0,2,2,0,0,0,1.0,16.0,2,0,0,0,1.0,82,5.86,50,250,2620,9.2,0.16339573
14571,14571,Justin Bailey,2016-17,21.0,2,0,8,8,0,0,0,22.0,93.0,8,0,0,0,22.0,82,5.34,48,255,2438,9.0,0.22730789
14572,14572,Justin Bailey,2017-18,22.0,3,4,32,32,2,2,4,36.0,340.0,40,2,2,4,58.0,82,5.45,47,245,2478,9.0,0.23991358
14573,14573,Justin Bailey,2018-19,23.0,4,4,12,12,3,1,4,19.0,135.0,52,5,3,8,77.0,82,5.86,50,250,2620,9.2,0.28401166
14574,14574,Justin Bailey,2019-20,24.0,5,1,11,11,0,1,1,5.0,63.0,63,5,4,9,82.0,82,5.96,47,239,2579,9.5,0.16760454
14575,14575,Justin Bailey,2020-21,25.0,6,0,2,2,0,0,0,1.0,11.0,65,5,4,9,83.0,70,5.96,42,208,2192,9.5,0.15645975
14576,14576,Justin Braun,2011-12,24.0,2,11,28,28,2,9,11,44.0,462.0,28,2,9,11,44.0,82,5.46,52,291,2492,9.0,0.235903
14577,14577,Justin Braun,2012-13,25.0,3,11,66,66,2,9,11,113.0,1092.0,94,4,18,22,157.0,82,5.32,47,271,2439,8.9,0.21759626
14578,14578,Justin Braun,2013-14,26.0,4,7,41,41,0,7,7,48.0,771.0,135,4,25,29,205.0,48,5.31,29,160,1399,9.1,0.19306082
14579,14579,Justin Braun,2014-15,27.0,5,17,82,82,4,13,17,121.0,1721.0,217,8,38,46,326.0,82,5.34,48,269,2463,8.9,0.21558556
14580,14580,Justin Braun,2015-16,28.0,6,23,70,70,1,22,23,94.0,1472.0,287,9,60,69,420.0,82,5.32,47,251,2453,8.9,0.24961102
14581,14581,Justin Braun,2016-17,29.0,7,23,80,80,4,19,23,114.0,1645.0,367,13,79,92,534.0,82,5.34,48,255,2438,9.0,0.26272556
14582,14582,Justin Braun,2017-18,30.0,8,13,81,81,4,9,13,95.0,1626.0,448,17,88,105,629.0,82,5.45,47,245,2478,9.0,0.21057811
14583,14583,Justin Braun,2018-19,31.0,9,33,81,81,5,28,33,115.0,1728.0,529,22,116,138,744.0,82,5.86,50,250,2620,9.2,0.3270724
14584,14584,Justin Braun,2019-20,32.0,10,16,78,78,2,14,16,105.0,1584.0,607,24,130,154,849.0,82,5.96,47,239,2579,9.5,0.216097
14585,14585,Justin Braun,2020-21,33.0,11,19,62,62,3,16,19,70.0,1071.0,669,27,146,173,919.0,70,5.96,42,208,2192,9.5,0.2514069
14586,14586,Justin Dibenedetto,2011-12,23.0,2,1,8,8,0,1,1,6.0,73.0,8,0,1,1,6.0,82,5.46,52,291,2492,9.0,0.19244751
14587,14587,Justin Dowling,2017-18,27.0,2,2,9,9,0,2,2,11.0,94.0,9,0,2,2,11.0,82,5.45,47,245,2478,9.0,0.20322794
14588,14588,Justin Dowling,2019-20,29.0,3,1,11,11,0,1,1,9.0,139.0,20,0,3,3,20.0,82,5.96,47,239,2579,9.5,0.1593759
14589,14589,Justin Dowling,2020-21,30.0,4,6,29,29,3,3,6,29.0,318.0,49,3,6,9,49.0,70,5.96,42,208,2192,9.5,0.21508226
14590,14590,Justin Duberman,1994-95,24.0,2,0,4,4,0,0,0,2.0,,4,0,0,0,2.0,84,6.48,76,407,2545,10.7,0.17003357
14591,14591,Justin Falk,2010-11,22.0,2,0,3,3,0,0,0,1.0,23.0,3,0,0,0,1.0,82,5.53,56,304,2486,9.1,0.17144981
14592,14592,Justin Falk,2011-12,23.0,3,3,22,22,0,3,3,7.0,311.0,25,0,3,3,8.0,82,5.46,52,291,2492,9.0,0.13292229
14593,14593,Justin Falk,2012-13,24.0,4,9,47,47,1,8,9,46.0,916.0,72,1,11,12,54.0,82,5.32,47,271,2439,8.9,0.16060224
14594,14594,Justin Falk,2013-14,25.0,5,3,36,36,0,3,3,27.0,476.0,108,1,14,15,81.0,48,5.31,29,160,1399,9.1,0.15742436
14595,14595,Justin Falk,2014-15,26.0,6,2,21,21,0,2,2,10.0,252.0,129,1,16,17,91.0,82,5.34,48,269,2463,8.9,0.099191695
14596,14596,Justin Falk,2015-16,27.0,7,2,18,18,1,1,2,18.0,195.0,147,2,17,19,109.0,82,5.32,47,251,2453,8.9,0.14706945
14597,14597,Justin Falk,2016-17,28.0,8,4,24,24,0,4,4,16.0,341.0,171,2,21,23,125.0,82,5.34,48,255,2438,9.0,0.1166814
14598,14598,Justin Falk,2017-18,29.0,9,8,52,52,0,8,8,33.0,712.0,223,2,29,31,158.0,82,5.45,47,245,2478,9.0,0.10996261
14599,14599,Justin Falk,2018-19,30.0,10,2,46,46,1,1,2,36.0,740.0,269,3,30,33,194.0,82,5.86,50,250,2620,9.2,0.10863137
14600,14600,Justin Falk,2019-20,31.0,11,0,10,10,0,0,0,7.0,129.0,279,3,30,33,201.0,82,5.96,47,239,2579,9.5,0.09374651
14601,14601,Justin Faulk,2012-13,20.0,2,22,66,66,8,14,22,101.0,1508.0,66,8,14,22,101.0,82,5.32,47,271,2439,8.9,0.36957386
14602,14602,Justin Faulk,2013-14,21.0,3,15,38,38,5,10,15,76.0,912.0,104,13,24,37,177.0,48,5.31,29,160,1399,9.1,0.4455017
14603,14603,Justin Faulk,2014-15,22.0,4,32,76,76,5,27,32,152.0,1779.0,180,18,51,69,329.0,82,5.34,48,269,2463,8.9,0.42811504
14604,14604,Justin Faulk,2015-16,23.0,5,49,82,82,15,34,49,238.0,2003.0,262,33,85,118,567.0,82,5.32,47,251,2453,8.9,0.6701695
14605,14605,Justin Faulk,2016-17,24.0,6,37,64,64,16,21,37,184.0,1539.0,326,49,106,155,751.0,82,5.34,48,255,2438,9.0,0.5989101
14606,14606,Justin Faulk,2017-18,25.0,7,37,75,75,17,20,37,225.0,1736.0,401,66,126,192,976.0,82,5.45,47,245,2478,9.0,0.5734712
14607,14607,Justin Faulk,2018-19,26.0,8,31,76,76,8,23,31,211.0,1692.0,477,74,149,223,1187.0,82,5.86,50,250,2620,9.2,0.49076942
14608,14608,Justin Faulk,2019-20,27.0,9,35,82,82,11,24,35,217.0,1839.0,559,85,173,258,1404.0,82,5.96,47,239,2579,9.5,0.4627192
14609,14609,Justin Faulk,2020-21,28.0,10,16,69,69,5,11,16,147.0,1419.0,628,90,184,274,1551.0,70,5.96,42,208,2192,9.5,0.347818
14610,14610,Justin Florek,2014-15,24.0,2,2,4,4,1,1,2,5.0,47.0,4,1,1,2,5.0,82,5.34,48,269,2463,8.9,0.20733425
14611,14611,Justin Fontaine,2014-15,27.0,2,21,66,66,13,8,21,79.0,809.0,66,13,8,21,79.0,82,5.34,48,269,2463,8.9,0.30247706
14612,14612,Justin Fontaine,2015-16,28.0,3,31,71,71,9,22,31,104.0,849.0,137,22,30,52,183.0,82,5.32,47,251,2453,8.9,0.38160264
14613,14613,Justin Fontaine,2016-17,29.0,4,16,60,60,5,11,16,54.0,711.0,197,27,41,68,237.0,82,5.34,48,255,2438,9.0,0.26875395
14614,14614,Justin Hocking,1994-95,21.0,2,0,1,1,0,0,0,0.0,,1,0,0,0,0.0,84,6.48,76,407,2545,10.7,0.19501022
14615,14615,Justin Hodgman,2015-16,27.0,2,1,5,5,1,0,1,3.0,57.0,5,1,0,1,3.0,82,5.32,47,251,2453,8.9,0.1680133
14616,14616,Justin Holl,2018-19,27.0,2,2,2,2,2,0,2,2.0,35.0,2,2,0,2,2.0,82,5.86,50,250,2620,9.2,0.19945806
14617,14617,Justin Holl,2019-20,28.0,3,1,11,11,0,1,1,6.0,137.0,13,2,1,3,8.0,82,5.96,47,239,2579,9.5,0.17547467
14618,14618,Justin Holl,2020-21,29.0,4,18,68,68,2,16,18,89.0,1259.0,81,4,17,21,97.0,70,5.96,42,208,2192,9.5,0.27126405
14619,14619,Justin Johnson,2014-15,33.0,2,0,2,2,0,0,0,0.0,13.0,2,0,0,0,0.0,82,5.34,48,269,2463,8.9,0.12137434
14620,14620,Justin Kloos,2018-19,25.0,2,0,1,1,0,0,0,0.0,9.0,1,0,0,0,0.0,82,5.86,50,250,2620,9.2,0.14306575
14621,14621,Justin Kloos,2019-20,26.0,3,0,1,1,0,0,0,2.0,7.0,2,0,0,0,2.0,82,5.96,47,239,2579,9.5,0.16930458
14622,14622,Justin Kurtz,2002-03,26.0,2,8,27,27,3,5,8,30.0,431.0,27,3,5,8,30.0,82,5.24,53,338,2262,9.5,0.22637936
14623,14623,Justin Mapletoft,2003-04,23.0,2,4,11,11,2,2,4,12.0,135.0,11,2,2,4,12.0,82,5.31,60,363,2326,9.4,0.25698256
14624,14624,Justin Mapletoft,2004-05,24.0,3,5,27,27,1,4,5,15.0,166.0,38,3,6,9,27.0,82,5.14,57,348,2300,9.2,0.18835813
14625,14625,Justin Mercier,2010-11,23.0,2,2,9,9,1,1,2,5.0,65.0,9,1,1,2,5.0,82,5.53,56,304,2486,9.1,0.22617671
14626,14626,Justin Papineau,2002-03,23.0,2,0,1,1,0,0,0,0.0,9.0,1,0,0,0,0.0,82,5.24,53,338,2262,9.5,0.16184989
14627,14627,Justin Papineau,2003-04,24.0,3,6,16,16,3,3,6,23.0,195.0,17,3,3,6,23.0,82,5.31,60,363,2326,9.4,0.265614
14628,14628,Justin Papineau,2004-05,25.0,4,13,64,64,8,5,13,44.0,492.0,81,11,8,19,67.0,82,5.14,57,348,2300,9.2,0.21195412
14629,14629,Justin Schultz,2013-14,23.0,2,27,48,48,8,19,27,85.0,1030.0,48,8,19,27,85.0,48,5.31,29,160,1399,9.1,0.50974965
14630,14630,Justin Schultz,2014-15,24.0,3,33,74,74,11,22,33,109.0,1728.0,122,19,41,60,194.0,82,5.34,48,269,2463,8.9,0.40168664
14631,14631,Justin Schultz,2015-16,25.0,4,31,81,81,6,25,31,122.0,1832.0,203,25,66,91,316.0,82,5.32,47,251,2453,8.9,0.40560743
14632,14632,Justin Schultz,2016-17,26.0,5,18,63,63,4,14,18,82.0,1162.0,266,29,80,109,398.0,82,5.34,48,255,2438,9.0,0.3145315
14633,14633,Justin Schultz,2017-18,27.0,6,51,78,78,12,39,51,154.0,1595.0,344,41,119,160,552.0,82,5.45,47,245,2478,9.0,0.5639686
14634,14634,Justin Schultz,2018-19,28.0,7,27,63,63,4,23,27,109.0,1229.0,407,45,142,187,661.0,82,5.86,50,250,2620,9.2,0.40975088
14635,14635,Justin Schultz,2019-20,29.0,8,15,29,29,2,13,15,47.0,595.0,436,47,155,202,708.0,82,5.96,47,239,2579,9.5,0.4043804
14636,14636,Justin Schultz,2020-21,30.0,9,12,46,46,3,9,12,86.0,914.0,482,50,164,214,794.0,70,5.96,42,208,2192,9.5,0.3259023
14637,14637,Justin Shugg,2015-16,24.0,2,0,3,3,0,0,0,3.0,17.0,3,0,0,0,3.0,82,5.32,47,251,2453,8.9,0.16720265
14638,14638,Justin Williams,2001-02,20.0,2,25,63,63,12,13,25,99.0,789.0,63,12,13,25,99.0,82,5.51,63,376,2272,9.9,0.42466938
14639,14639,Justin Williams,2002-03,21.0,3,40,75,75,17,23,40,162.0,1084.0,138,29,36,65,261.0,82,5.24,53,338,2262,9.5,0.58733284
14640,14640,Justin Williams,2003-04,22.0,4,24,41,41,8,16,24,105.0,654.0,179,37,52,89,366.0,82,5.31,60,363,2326,9.4,0.5672662
14641,14641,Justin Williams,2004-05,23.0,5,44,79,79,11,33,44,203.0,1332.0,258,48,85,133,569.0,82,5.14,57,348,2300,9.2,0.71753216
14642,14642,Justin Williams,2006-07,25.0,6,76,82,82,31,45,76,255.0,1733.0,340,79,130,209,824.0,82,6.05,85,480,2458,10.1,0.86428547
14643,14643,Justin Williams,2007-08,26.0,7,67,82,82,33,34,67,258.0,1710.0,422,112,164,276,1082.0,82,5.76,70,398,2426,9.7,0.8351513
14644,14644,Justin Williams,2008-09,27.0,8,30,37,37,9,21,30,106.0,714.0,459,121,185,306,1188.0,82,5.44,62,351,2383,9.4,0.6663211
14645,14645,Justin Williams,2009-10,28.0,9,14,44,44,4,10,14,108.0,699.0,503,125,195,320,1296.0,82,5.7,65,341,2477,9.4,0.39486068
14646,14646,Justin Williams,2010-11,29.0,10,29,49,49,10,19,29,140.0,802.0,552,135,214,349,1436.0,82,5.53,56,304,2486,9.1,0.5812233
14647,14647,Justin Williams,2011-12,30.0,11,57,73,73,22,35,57,213.0,1259.0,625,157,249,406,1649.0,82,5.46,52,291,2492,9.0,0.7006189
14648,14648,Justin Williams,2012-13,31.0,12,59,82,82,22,37,59,241.0,1406.0,707,179,286,465,1890.0,82,5.32,47,271,2439,8.9,0.6742394
14649,14649,Justin Williams,2013-14,32.0,13,33,48,48,11,22,33,142.0,816.0,755,190,308,498,2032.0,48,5.31,29,160,1399,9.1,0.63903975
14650,14650,Justin Williams,2014-15,33.0,14,43,82,82,19,24,43,239.0,1390.0,837,209,332,541,2271.0,82,5.34,48,269,2463,8.9,0.54646707
14651,14651,Justin Williams,2015-16,34.0,15,41,81,81,18,23,41,174.0,1281.0,918,227,355,582,2445.0,82,5.32,47,251,2453,8.9,0.47577444
14652,14652,Justin Williams,2016-17,35.0,16,52,82,82,22,30,52,201.0,1366.0,1000,249,385,634,2646.0,82,5.34,48,255,2438,9.0,0.57775754
14653,14653,Justin Williams,2017-18,36.0,17,48,80,80,24,24,48,167.0,1238.0,1080,273,409,682,2813.0,82,5.45,47,245,2478,9.0,0.53133273
14654,14654,Justin Williams,2018-19,37.0,18,51,82,82,16,35,51,198.0,1360.0,1162,289,444,733,3011.0,82,5.86,50,250,2620,9.2,0.57273054
14655,14655,Justin Williams,2019-20,38.0,19,53,82,82,23,30,53,237.0,1430.0,1244,312,474,786,3248.0,82,5.96,47,239,2579,9.5,0.6035422
14656,14656,Justin Williams,2020-21,39.0,20,11,20,20,8,3,11,60.0,272.0,1264,320,477,797,3308.0,70,5.96,42,208,2192,9.5,0.52457947
14657,14657,Juuso Riikola,2019-20,26.0,2,5,37,37,2,3,5,43.0,617.0,37,2,3,5,43.0,82,5.96,47,239,2579,9.5,0.18975845
14658,14658,Juuso Riikola,2020-21,27.0,3,7,36,36,1,6,7,38.0,500.0,73,3,9,12,81.0,70,5.96,42,208,2192,9.5,0.18685794
14659,14659,Juuso Valimaki,2019-20,21.0,2,3,24,24,1,2,3,28.0,372.0,24,1,2,3,28.0,82,5.96,47,239,2579,9.5,0.26958808
14660,14660,Jyrki Jokipakka,2015-16,24.0,2,10,51,51,0,10,10,40.0,842.0,51,0,10,10,40.0,82,5.32,47,251,2453,8.9,0.16409552
14661,14661,Jyrki Jokipakka,2016-17,25.0,3,12,58,58,2,10,12,45.0,902.0,109,2,20,22,85.0,82,5.34,48,255,2438,9.0,0.20854107
14662,14662,Jyrki Jokipakka,2017-18,26.0,4,6,41,41,1,5,6,29.0,592.0,150,3,25,28,114.0,82,5.45,47,245,2478,9.0,0.14805019
14663,14663,Jyrki Lumme,1989-90,23.0,2,4,21,21,1,3,4,18.0,,21,1,3,4,18.0,80,7.48,85,403,2430,12.3,0.23274228
14664,14664,Jyrki Lumme,1990-91,24.0,3,30,65,65,4,26,30,109.0,,86,5,29,34,127.0,80,7.37,76,367,2421,12.2,0.41058215
14665,14665,Jyrki Lumme,1991-92,25.0,4,32,80,80,5,27,32,157.0,,166,10,56,66,284.0,80,6.91,71,366,2385,11.6,0.44843552
14666,14666,Jyrki Lumme,1992-93,26.0,5,44,75,75,12,32,44,106.0,,241,22,88,110,390.0,80,6.96,77,402,2440,11.4,0.54472804
14667,14667,Jyrki Lumme,1993-94,27.0,6,44,74,74,8,36,44,123.0,,315,30,124,154,513.0,84,7.25,87,443,2603,11.7,0.49828172
14668,14668,Jyrki Lumme,1994-95,28.0,7,55,83,83,13,42,55,161.0,,398,43,166,209,674.0,84,6.48,76,407,2545,10.7,0.5263983
14669,14669,Jyrki Lumme,1995-96,29.0,8,17,36,36,5,12,17,78.0,,434,48,178,226,752.0,48,5.97,37,209,1408,10.2,0.45032743
14670,14670,Jyrki Lumme,1996-97,30.0,9,54,80,80,17,37,54,192.0,,514,65,215,280,944.0,82,6.29,74,413,2481,10.4,0.6259543
14671,14671,Jyrki Lumme,1997-98,31.0,10,35,66,66,11,24,35,107.0,,580,76,239,315,1051.0,82,5.83,55,336,2444,9.8,0.3894018
14672,14672,Jyrki Lumme,1998-99,32.0,11,30,74,74,9,21,30,117.0,,654,85,260,345,1168.0,82,5.28,57,380,2242,9.6,0.3779965
14673,14673,Jyrki Lumme,1999-00,33.0,12,28,60,60,7,21,28,121.0,1400.0,714,92,281,373,1289.0,82,5.27,57,359,2285,9.4,0.44125658
14674,14674,Jyrki Lumme,2000-01,34.0,13,40,74,74,8,32,40,142.0,1746.0,788,100,313,413,1431.0,82,5.49,53,331,2294,9.8,0.45985538
14675,14675,Jyrki Lumme,2001-02,35.0,14,25,58,58,4,21,25,77.0,1260.0,846,104,334,438,1508.0,82,5.51,63,376,2272,9.9,0.2836185
14676,14676,Jyrki Lumme,2002-03,36.0,15,13,66,66,4,9,13,73.0,1222.0,912,108,343,451,1581.0,82,5.24,53,338,2262,9.5,0.16931555
14677,14677,Jyrki Lumme,2003-04,37.0,16,17,73,73,6,11,17,72.0,1505.0,985,114,354,468,1653.0,82,5.31,60,363,2326,9.4,0.22635567
14678,14678,Jyrki Seppa,1984-85,23.0,2,2,13,13,0,2,2,7.0,,13,0,2,2,7.0,80,7.89,74,336,2448,12.9,0.24199656
14679,14679,Kaapo Kakko,2020-21,19.0,2,23,66,66,10,13,23,109.0,942.0,66,10,13,23,109.0,70,5.96,42,208,2192,9.5,0.3986989
14680,14680,Kael Mouillierat,2015-16,28.0,2,2,6,6,1,1,2,1.0,52.0,6,1,1,2,1.0,82,5.32,47,251,2453,8.9,0.16193277
14681,14681,Kael Mouillierat,2016-17,29.0,3,0,1,1,0,0,0,1.0,11.0,7,1,1,2,2.0,82,5.34,48,255,2438,9.0,0.13951951
14682,14682,Kai Nurminen,1997-98,28.0,2,27,67,67,16,11,27,112.0,,67,16,11,27,112.0,82,5.83,55,336,2444,9.8,0.3765972
14683,14683,Kai Nurminen,2001-02,32.0,3,1,2,2,1,0,1,1.0,31.0,69,17,11,28,113.0,82,5.51,63,376,2272,9.9,0.18475336
14684,14684,Kai Suikkanen,1982-83,23.0,2,0,1,1,0,0,0,0.0,,1,0,0,0,0.0,80,8.03,73,320,2489,12.9,0.20492265
14685,14685,Kai Suikkanen,1983-84,24.0,3,0,1,1,0,0,0,1.0,,2,0,0,0,1.0,80,7.73,71,310,2444,12.7,0.2082853
14686,14686,Kailer Yamamoto,2018-19,20.0,2,3,9,9,0,3,3,23.0,136.0,9,0,3,3,23.0,82,5.86,50,250,2620,9.2,0.29538798
14687,14687,Kailer Yamamoto,2019-20,21.0,3,2,17,17,1,1,2,13.0,222.0,26,1,4,5,36.0,82,5.96,47,239,2579,9.5,0.28036532
14688,14688,Kailer Yamamoto,2020-21,22.0,4,26,27,27,11,15,26,44.0,469.0,53,12,19,31,80.0,70,5.96,42,208,2192,9.5,0.6256116
14689,14689,Kale Clague,2020-21,22.0,2,0,4,4,0,0,0,2.0,58.0,4,0,0,0,2.0,70,5.96,42,208,2192,9.5,0.1978578
14690,14690,Kalle Kossila,2017-18,24.0,2,0,1,1,0,0,0,1.0,7.0,1,0,0,0,1.0,82,5.45,47,245,2478,9.0,0.17658868
14691,14691,Kalle Kossila,2018-19,25.0,3,2,10,10,1,1,2,9.0,91.0,11,1,1,2,10.0,82,5.86,50,250,2620,9.2,0.18985751
14692,14692,Kalle Kossila,2019-20,26.0,4,1,8,8,1,0,1,11.0,82.0,19,2,1,3,21.0,82,5.96,47,239,2579,9.5,0.19164473
14693,14693,Kamil Kreps,2007-08,23.0,2,2,14,14,1,1,2,20.0,157.0,14,1,1,2,20.0,82,5.76,70,398,2426,9.7,0.23373806
14694,14694,Kamil Kreps,2008-09,24.0,3,25,76,76,8,17,25,99.0,986.0,90,9,18,27,119.0,82,5.44,62,351,2383,9.4,0.34983012
14695,14695,Kamil Kreps,2009-10,25.0,4,19,66,66,4,15,19,77.0,922.0,156,13,33,46,196.0,82,5.7,65,341,2477,9.4,0.25858015
14696,14696,Kamil Kreps,2010-11,26.0,5,14,76,76,5,9,14,83.0,966.0,232,18,42,60,279.0,82,5.53,56,304,2486,9.1,0.22139627
14697,14697,Kamil Piros,2002-03,24.0,2,1,8,8,0,1,1,4.0,98.0,8,0,1,1,4.0,82,5.24,53,338,2262,9.5,0.18390617
14698,14698,Kamil Piros,2003-04,25.0,3,5,3,3,3,2,5,8.0,51.0,11,3,3,6,12.0,82,5.31,60,363,2326,9.4,0.24264494
14699,14699,Kamil Piros,2004-05,26.0,4,2,17,17,1,1,2,11.0,160.0,28,4,4,8,23.0,82,5.14,57,348,2300,9.2,0.21026194
14700,14700,Karel Betik,1999-00,21.0,2,2,3,3,0,2,2,2.0,40.0,3,0,2,2,2.0,82,5.27,57,359,2285,9.4,0.24096
14701,14701,Karel Pilar,2002-03,25.0,2,4,23,23,1,3,4,32.0,369.0,23,1,3,4,32.0,82,5.24,53,338,2262,9.5,0.19459462
14702,14702,Karel Pilar,2003-04,26.0,3,7,17,17,3,4,7,22.0,314.0,40,4,7,11,54.0,82,5.31,60,363,2326,9.4,0.25246373
14703,14703,Karel Pilar,2004-05,27.0,4,19,50,50,2,17,19,74.0,903.0,90,6,24,30,128.0,82,5.14,57,348,2300,9.2,0.3537832
14704,14704,Karel Rachunek,2000-01,21.0,2,0,6,6,0,0,0,3.0,48.0,6,0,0,0,3.0,82,5.49,53,331,2294,9.8,0.1963087
14705,14705,Karel Rachunek,2001-02,22.0,3,33,71,71,3,30,33,77.0,1483.0,77,3,30,33,80.0,82,5.51,63,376,2272,9.9,0.40914953
14706,14706,Karel Rachunek,2002-03,23.0,4,18,51,51,3,15,18,55.0,985.0,128,6,45,51,135.0,82,5.24,53,338,2262,9.5,0.34319526
14707,14707,Karel Rachunek,2003-04,24.0,5,29,58,58,4,25,29,110.0,1262.0,186,10,70,80,245.0,82,5.31,60,363,2326,9.4,0.44054562
14708,14708,Karel Rachunek,2004-05,25.0,6,21,72,72,2,19,21,120.0,1412.0,258,12,89,101,365.0,82,5.14,57,348,2300,9.2,0.34867412
14709,14709,Karel Rachunek,2007-08,28.0,7,26,66,66,6,20,26,99.0,1279.0,324,18,109,127,464.0,82,5.76,70,398,2426,9.7,0.3630246
14710,14710,Karel Rachunek,2008-09,29.0,8,13,47,47,4,9,13,68.0,911.0,371,22,118,140,532.0,82,5.44,62,351,2383,9.4,0.26871282
14711,14711,Kari Eloranta,1982-83,26.0,2,13,31,31,1,12,13,33.0,,31,1,12,13,33.0,80,8.03,73,320,2489,12.9,0.2598921
14712,14712,Kari Eloranta,1983-84,27.0,3,44,80,80,4,40,44,68.0,,111,5,52,57,101.0,80,7.73,71,310,2444,12.7,0.45127818
14713,14713,Kari Eloranta,1984-85,28.0,4,39,78,78,5,34,39,59.0,,189,10,86,96,160.0,80,7.89,74,336,2448,12.9,0.42545375
14714,14714,Kari Eloranta,1985-86,29.0,5,13,65,65,2,11,13,46.0,,254,12,97,109,206.0,80,7.77,71,321,2447,12.7,0.27366054
14715,14715,Kari Eloranta,1987-88,31.0,6,7,13,13,1,6,7,11.0,,267,13,103,116,217.0,80,7.34,72,344,2400,12.2,0.32967782
14716,14716,Kari Haakana,2003-04,30.0,2,0,13,13,0,0,0,2.0,103.0,13,0,0,0,2.0,82,5.31,60,363,2326,9.4,0.12823033
14717,14717,Kari Jalonen,1983-84,24.0,2,12,25,25,9,3,12,32.0,,25,9,3,12,32.0,80,7.73,71,310,2444,12.7,0.40141279
14718,14718,Kari Jalonen,1984-85,25.0,3,3,12,12,0,3,3,4.0,,37,9,6,15,36.0,80,7.89,74,336,2448,12.9,0.23319656
14719,14719,Kari Makkonen,1980-81,26.0,2,4,9,9,2,2,4,11.0,,9,2,2,4,11.0,80,7.03,61,280,2352,12.0,0.320652
14720,14720,Karl Alzner,2009-10,21.0,2,5,30,30,1,4,5,31.0,583.0,30,1,4,5,31.0,82,5.7,65,341,2477,9.4,0.24874279
14721,14721,Karl Alzner,2010-11,22.0,3,5,21,21,0,5,5,16.0,344.0,51,1,9,10,47.0,82,5.53,56,304,2486,9.1,0.17081288
14722,14722,Karl Alzner,2011-12,23.0,4,12,82,82,2,10,12,64.0,1641.0,133,3,19,22,111.0,82,5.46,52,291,2492,9.0,0.18797341
14723,14723,Karl Alzner,2012-13,24.0,5,17,82,82,1,16,17,56.0,1712.0,215,4,35,39,167.0,82,5.32,47,271,2439,8.9,0.18781438
14724,14724,Karl Alzner,2013-14,25.0,6,5,48,48,1,4,5,39.0,1006.0,263,5,39,44,206.0,48,5.31,29,160,1399,9.1,0.18298775
14725,14725,Karl Alzner,2014-15,26.0,7,18,82,82,2,16,18,95.0,1684.0,345,7,55,62,301.0,82,5.34,48,269,2463,8.9,0.23521128
14726,14726,Karl Alzner,2015-16,27.0,8,21,82,82,5,16,21,72.0,1593.0,427,12,71,83,373.0,82,5.32,47,251,2453,8.9,0.22481996
14727,14727,Karl Alzner,2016-17,28.0,9,21,82,82,4,17,21,75.0,1753.0,509,16,88,104,448.0,82,5.34,48,255,2438,9.0,0.22763431
14728,14728,Karl Alzner,2017-18,29.0,10,13,82,82,3,10,13,81.0,1623.0,591,19,98,117,529.0,82,5.45,47,245,2478,9.0,0.18394428
14729,14729,Karl Alzner,2018-19,30.0,11,12,82,82,1,11,12,84.0,1647.0,673,20,109,129,613.0,82,5.86,50,250,2620,9.2,0.14577028
14730,14730,Karl Alzner,2019-20,31.0,12,1,9,9,0,1,1,8.0,156.0,682,20,110,130,621.0,82,5.96,47,239,2579,9.5,0.11836219
14731,14731,Karl Alzner,2020-21,32.0,13,0,4,4,0,0,0,4.0,56.0,686,20,110,130,625.0,70,5.96,42,208,2192,9.5,0.12479752
14732,14732,Karl Dykhuis,1992-93,20.0,2,4,6,6,1,3,4,12.0,,6,1,3,4,12.0,80,6.96,77,402,2440,11.4,0.33417648
14733,14733,Karl Dykhuis,1993-94,21.0,3,5,12,12,0,5,5,10.0,,18,1,8,9,22.0,84,7.25,87,443,2603,11.7,0.27693382
14734,14734,Karl Dykhuis,1995-96,23.0,4,8,33,33,2,6,8,46.0,,51,3,14,17,68.0,48,5.97,37,209,1408,10.2,0.28922486
14735,14735,Karl Dykhuis,1996-97,24.0,5,20,82,82,5,15,20,104.0,,133,8,29,37,172.0,82,6.29,74,413,2481,10.4,0.24795178
14736,14736,Karl Dykhuis,1997-98,25.0,6,19,62,62,4,15,19,101.0,,195,12,44,56,273.0,82,5.83,55,336,2444,9.8,0.26450562
14737,14737,Karl Dykhuis,1998-99,26.0,7,14,78,78,5,9,14,91.0,,273,17,53,70,364.0,82,5.28,57,380,2242,9.6,0.22165576
14738,14738,Karl Dykhuis,1999-00,27.0,8,9,78,78,4,5,9,88.0,1489.0,351,21,58,79,452.0,82,5.27,57,359,2285,9.4,0.17738625
14739,14739,Karl Dykhuis,2000-01,28.0,9,20,72,72,7,13,20,69.0,1406.0,423,28,71,99,521.0,82,5.49,53,331,2294,9.8,0.25625557
14740,14740,Karl Dykhuis,2001-02,29.0,10,17,67,67,8,9,17,66.0,1049.0,490,36,80,116,587.0,82,5.51,63,376,2272,9.9,0.21776041
14741,14741,Karl Dykhuis,2002-03,30.0,11,12,80,80,5,7,12,85.0,1592.0,570,41,87,128,672.0,82,5.24,53,338,2262,9.5,0.19023317
14742,14742,Karl Dykhuis,2003-04,31.0,12,5,65,65,1,4,5,24.0,975.0,635,42,91,133,696.0,82,5.31,60,363,2326,9.4,0.11714777
14743,14743,Karl Dykhuis,2004-05,32.0,13,0,9,9,0,0,0,6.0,117.0,644,42,91,133,702.0,82,5.14,57,348,2300,9.2,0.15616316
14744,14744,Karl Stewart,2004-05,21.0,2,1,5,5,0,1,1,2.0,22.0,5,0,1,1,2.0,82,5.14,57,348,2300,9.2,0.2531303
14745,14745,Karl Stewart,2006-07,23.0,3,0,8,8,0,0,0,6.0,45.0,13,0,1,1,8.0,82,6.05,85,480,2458,10.1,0.16529462
14746,14746,Karl Stewart,2007-08,24.0,4,5,47,47,2,3,5,21.0,407.0,60,2,4,6,29.0,82,5.76,70,398,2426,9.7,0.12394473
14747,14747,Karl Stewart,2008-09,25.0,5,0,9,9,0,0,0,2.0,37.0,69,2,4,6,31.0,82,5.44,62,351,2383,9.4,0.13359234
14748,14748,Karl Stollery,2014-15,27.0,2,0,2,2,0,0,0,1.0,13.0,2,0,0,0,1.0,82,5.34,48,269,2463,8.9,0.1505166
14749,14749,Karl Stollery,2015-16,28.0,3,0,10,10,0,0,0,9.0,147.0,12,0,0,0,10.0,82,5.32,47,251,2453,8.9,0.16887245
14750,14750,Karl Stollery,2017-18,30.0,4,3,11,11,0,3,3,11.0,186.0,23,0,3,3,21.0,82,5.45,47,245,2478,9.0,0.18149036
14751,14751,Karlis Skrastins,1999-00,25.0,2,1,2,2,0,1,1,0.0,24.0,2,0,1,1,0.0,82,5.27,57,359,2285,9.4,0.1817486
14752,14752,Karlis Skrastins,2000-01,26.0,3,11,59,59,5,6,11,51.0,1230.0,61,5,7,12,51.0,82,5.49,53,331,2294,9.8,0.19304007
14753,14753,Karlis Skrastins,2001-02,27.0,4,12,82,82,1,11,12,66.0,1574.0,143,6,18,24,117.0,82,5.51,63,376,2272,9.9,0.13974512
14754,14754,Karlis Skrastins,2002-03,28.0,5,17,82,82,4,13,17,84.0,1679.0,225,10,31,41,201.0,82,5.24,53,338,2262,9.5,0.18751973
14755,14755,Karlis Skrastins,2003-04,29.0,6,13,82,82,3,10,13,86.0,1664.0,307,13,41,54,287.0,82,5.31,60,363,2326,9.4,0.18463984
14756,14756,Karlis Skrastins,2004-05,30.0,7,13,82,82,5,8,13,102.0,1789.0,389,18,49,67,389.0,82,5.14,57,348,2300,9.2,0.19678283
14757,14757,Karlis Skrastins,2006-07,32.0,8,14,82,82,3,11,14,58.0,1789.0,471,21,60,81,447.0,82,6.05,85,480,2458,10.1,0.1511263
14758,14758,Karlis Skrastins,2007-08,33.0,9,11,68,68,0,11,11,65.0,1443.0,539,21,71,92,512.0,82,5.76,70,398,2426,9.7,0.15258402
14759,14759,Karlis Skrastins,2008-09,34.0,10,5,60,60,2,3,5,45.0,1116.0,599,23,74,97,557.0,82,5.44,62,351,2383,9.4,0.14988959
14760,14760,Karlis Skrastins,2009-10,35.0,11,18,80,80,4,14,18,55.0,1645.0,679,27,88,115,612.0,82,5.7,65,341,2477,9.4,0.18787083
14761,14761,Karlis Skrastins,2010-11,36.0,12,13,79,79,2,11,13,53.0,1546.0,758,29,99,128,665.0,82,5.53,56,304,2486,9.1,0.13079932
14762,14762,Karlis Skrastins,2011-12,37.0,13,8,74,74,3,5,8,30.0,1328.0,832,32,104,136,695.0,82,5.46,52,291,2492,9.0,0.10545662
14763,14763,Karson Kuhlman,2019-20,24.0,2,5,11,11,3,2,5,15.0,134.0,11,3,2,5,15.0,82,5.96,47,239,2579,9.5,0.25969452
14764,14764,Karson Kuhlman,2020-21,25.0,3,6,25,25,1,5,6,45.0,313.0,36,4,7,11,60.0,70,5.96,42,208,2192,9.5,0.20659357
14765,14765,Kaspars Astashenko,2000-01,25.0,2,1,8,8,0,1,1,3.0,134.0,8,0,1,1,3.0,82,5.49,53,331,2294,9.8,0.17461655
14766,14766,Kaspars Astashenko,2001-02,26.0,3,2,15,15,1,1,2,4.0,103.0,23,1,2,3,7.0,82,5.51,63,376,2272,9.9,0.16315046
14767,14767,Kaspars Daugavins,2010-11,22.0,2,0,1,1,0,0,0,2.0,8.0,1,0,0,0,2.0,82,5.53,56,304,2486,9.1,0.17654467
14768,14768,Kaspars Daugavins,2012-13,24.0,3,11,65,65,5,6,11,77.0,737.0,66,5,6,11,79.0,82,5.32,47,271,2439,8.9,0.2257604
14769,14769,Kaspars Daugavins,2013-14,25.0,4,4,25,25,1,3,4,36.0,275.0,91,6,9,15,115.0,48,5.31,29,160,1399,9.1,0.21047664
14770,14770,Kasperi Kapanen,2016-17,20.0,2,0,9,9,0,0,0,14.0,133.0,9,0,0,0,14.0,82,5.34,48,255,2438,9.0,0.2557155
14771,14771,Kasperi Kapanen,2017-18,21.0,3,1,8,8,1,0,1,11.0,86.0,17,1,0,1,25.0,82,5.45,47,245,2478,9.0,0.23750663
14772,14772,Kasperi Kapanen,2018-19,22.0,4,9,38,38,7,2,9,55.0,427.0,55,8,2,10,80.0,82,5.86,50,250,2620,9.2,0.2960993
14773,14773,Kasperi Kapanen,2019-20,23.0,5,44,78,78,20,24,44,174.0,1296.0,133,28,26,54,254.0,82,5.96,47,239,2579,9.5,0.5626666
14774,14774,Kasperi Kapanen,2020-21,24.0,6,36,69,69,13,23,36,121.0,1090.0,202,41,49,90,375.0,70,5.96,42,208,2192,9.5,0.47659042
14775,14775,Keaton Ellerby,2010-11,22.0,2,0,22,22,0,0,0,5.0,119.0,22,0,0,0,5.0,82,5.53,56,304,2486,9.1,0.1272107
14776,14776,Keaton Ellerby,2011-12,23.0,3,12,54,54,2,10,12,56.0,869.0,76,2,10,12,61.0,82,5.46,52,291,2492,9.0,0.21364206
14777,14777,Keaton Ellerby,2012-13,24.0,4,5,40,40,0,5,5,45.0,616.0,116,2,15,17,106.0,82,5.32,47,271,2439,8.9,0.159401
14778,14778,Keaton Ellerby,2013-14,25.0,5,3,44,44,0,3,3,23.0,637.0,160,2,18,20,129.0,48,5.31,29,160,1399,9.1,0.12697622
14779,14779,Keaton Ellerby,2014-15,26.0,6,6,51,51,2,4,6,33.0,709.0,211,4,22,26,162.0,82,5.34,48,269,2463,8.9,0.15110856
14780,14780,Keaton Ellerby,2015-16,27.0,7,1,1,1,0,1,1,0.0,17.0,212,4,23,27,162.0,82,5.32,47,251,2453,8.9,0.1428957
14781,14781,Keegan Kolesar,2020-21,23.0,2,0,1,1,0,0,0,1.0,12.0,1,0,0,0,1.0,70,5.96,42,208,2192,9.5,0.20180774
14782,14782,Keegan Lowe,2015-16,22.0,2,0,2,2,0,0,0,0.0,28.0,2,0,0,0,0.0,82,5.32,47,251,2453,8.9,0.14922687
14783,14783,Keegan Lowe,2018-19,25.0,3,0,2,2,0,0,0,4.0,28.0,4,0,0,0,4.0,82,5.86,50,250,2620,9.2,0.16127622
14784,14784,Keith Acton,1980-81,22.0,2,1,2,2,0,1,1,1.0,,2,0,1,1,1.0,80,7.03,61,280,2352,12.0,0.25082597
14785,14785,Keith Acton,1981-82,23.0,3,39,61,61,15,24,39,101.0,,63,15,25,40,102.0,80,7.69,77,340,2441,12.6,0.6166862
14786,14786,Keith Acton,1982-83,24.0,4,88,78,78,36,52,88,218.0,,141,51,77,128,320.0,80,8.03,73,320,2489,12.9,0.9837816
14787,14787,Keith Acton,1983-84,25.0,5,50,78,78,24,26,50,154.0,,219,75,103,178,474.0,80,7.73,71,310,2444,12.7,0.72857404
14788,14788,Keith Acton,1984-85,26.0,6,65,71,71,20,45,65,165.0,,290,95,148,243,639.0,80,7.89,74,336,2448,12.9,0.78964025
14789,14789,Keith Acton,1985-86,27.0,7,58,78,78,20,38,58,168.0,,368,115,186,301,807.0,80,7.77,71,321,2447,12.7,0.71251976
14790,14790,Keith Acton,1986-87,28.0,8,58,79,79,26,32,58,169.0,,447,141,218,359,976.0,80,7.94,82,370,2484,12.8,0.7186876
14791,14791,Keith Acton,1987-88,29.0,9,45,78,78,16,29,45,126.0,,525,157,247,404,1102.0,80,7.34,72,344,2400,12.2,0.56344056
14792,14792,Keith Acton,1988-89,30.0,10,28,72,72,11,17,28,75.0,,597,168,264,432,1177.0,80,7.43,89,437,2435,12.2,0.3874073
14793,14793,Keith Acton,1989-90,31.0,11,39,71,71,14,25,39,112.0,,668,182,289,471,1289.0,80,7.48,85,403,2430,12.3,0.46260977
14794,14794,Keith Acton,1990-91,32.0,12,27,69,69,13,14,27,94.0,,737,195,303,498,1383.0,80,7.37,76,367,2421,12.2,0.38323385
14795,14795,Keith Acton,1991-92,33.0,13,37,76,76,14,23,37,120.0,,813,209,326,535,1503.0,80,6.91,71,366,2385,11.6,0.4711668
14796,14796,Keith Acton,1992-93,34.0,14,17,50,50,7,10,17,79.0,,863,216,336,552,1582.0,80,6.96,77,402,2440,11.4,0.36728662
14797,14797,Keith Acton,1993-94,35.0,15,23,83,83,8,15,23,74.0,,946,224,351,575,1656.0,84,7.25,87,443,2603,11.7,0.24209514
14798,14798,Keith Acton,1994-95,36.0,16,9,77,77,2,7,9,35.0,,1023,226,358,584,1691.0,84,6.48,76,407,2545,10.7,0.199794
14799,14799,Keith Aldridge,2000-01,27.0,2,0,4,4,0,0,0,6.0,44.0,4,0,0,0,6.0,82,5.49,53,331,2294,9.8,0.17779654
14800,14800,Keith Aucoin,2006-07,28.0,2,1,7,7,0,1,1,3.0,37.0,7,0,1,1,3.0,82,6.05,85,480,2458,10.1,0.15777573
14801,14801,Keith Aucoin,2007-08,29.0,3,1,8,8,0,1,1,6.0,50.0,15,0,2,2,9.0,82,5.76,70,398,2426,9.7,0.15308857
14802,14802,Keith Aucoin,2008-09,30.0,4,13,38,38,5,8,13,65.0,511.0,53,5,10,15,74.0,82,5.44,62,351,2383,9.4,0.26268503
14803,14803,Keith Aucoin,2009-10,31.0,5,6,12,12,2,4,6,15.0,124.0,65,7,14,21,89.0,82,5.7,65,341,2477,9.4,0.23321426
14804,14804,Keith Aucoin,2010-11,32.0,6,5,9,9,1,4,5,4.0,79.0,74,8,18,26,93.0,82,5.53,56,304,2486,9.1,0.18290049
14805,14805,Keith Aucoin,2011-12,33.0,7,0,1,1,0,0,0,0.0,12.0,75,8,18,26,93.0,82,5.46,52,291,2492,9.0,0.15325913
14806,14806,Keith Aucoin,2012-13,34.0,8,11,27,27,3,8,11,21.0,299.0,102,11,26,37,114.0,82,5.32,47,271,2439,8.9,0.22021815
14807,14807,Keith Aucoin,2013-14,35.0,9,12,41,41,6,6,12,50.0,512.0,143,17,32,49,164.0,48,5.31,29,160,1399,9.1,0.26836947
14808,14808,Keith Aucoin,2014-15,36.0,10,0,2,2,0,0,0,1.0,27.0,145,17,32,49,165.0,82,5.34,48,269,2463,8.9,0.13844901
14809,14809,Keith Aulie,2011-12,22.0,2,2,40,40,2,0,2,32.0,765.0,40,2,0,2,32.0,82,5.46,52,291,2492,9.0,0.19666824
14810,14810,Keith Aulie,2012-13,23.0,3,3,36,36,0,3,3,18.0,484.0,76,2,3,5,50.0,82,5.32,47,271,2439,8.9,0.13677385
14811,14811,Keith Aulie,2013-14,24.0,4,7,45,45,2,5,7,37.0,577.0,121,4,8,12,87.0,48,5.31,29,160,1399,9.1,0.18987742
14812,14812,Keith Aulie,2014-15,25.0,5,1,15,15,0,1,1,6.0,147.0,136,4,9,13,93.0,82,5.34,48,269,2463,8.9,0.13016164
14813,14813,Keith Aulie,2015-16,26.0,6,1,31,31,0,1,1,25.0,443.0,167,4,10,14,118.0,82,5.32,47,251,2453,8.9,0.13560882
14814,14814,Keith Ballard,2006-07,24.0,2,39,82,82,8,31,39,102.0,1638.0,82,8,31,39,102.0,82,6.05,85,480,2458,10.1,0.4370601
14815,14815,Keith Ballard,2007-08,25.0,3,27,69,69,5,22,27,79.0,1518.0,151,13,53,66,181.0,82,5.76,70,398,2426,9.7,0.3414755
14816,14816,Keith Ballard,2008-09,26.0,4,21,82,82,6,15,21,105.0,1744.0,233,19,68,87,286.0,82,5.44,62,351,2383,9.4,0.31175297
14817,14817,Keith Ballard,2009-10,27.0,5,34,82,82,6,28,34,106.0,1835.0,315,25,96,121,392.0,82,5.7,65,341,2477,9.4,0.4145862
14818,14818,Keith Ballard,2010-11,28.0,6,28,82,82,8,20,28,90.0,1837.0,397,33,116,149,482.0,82,5.53,56,304,2486,9.1,0.3600842
14819,14819,Keith Ballard,2011-12,29.0,7,7,65,65,2,5,7,53.0,1034.0,462,35,121,156,535.0,82,5.46,52,291,2492,9.0,0.18856248
14820,14820,Keith Ballard,2012-13,30.0,8,7,47,47,1,6,7,41.0,731.0,509,36,127,163,576.0,82,5.32,47,271,2439,8.9,0.17880744
14821,14821,Keith Ballard,2013-14,31.0,9,2,36,36,0,2,2,35.0,557.0,545,36,129,165,611.0,48,5.31,29,160,1399,9.1,0.17267078
14822,14822,Keith Ballard,2014-15,32.0,10,9,45,45,2,7,9,29.0,612.0,590,38,136,174,640.0,82,5.34,48,269,2463,8.9,0.15579861
14823,14823,Keith Ballard,2015-16,33.0,11,1,14,14,0,1,1,5.0,169.0,604,38,137,175,645.0,82,5.32,47,251,2453,8.9,0.12228444
14824,14824,Keith Brown,1980-81,20.0,2,20,76,76,2,18,20,105.0,,76,2,18,20,105.0,80,7.03,61,280,2352,12.0,0.35905862
14825,14825,Keith Brown,1981-82,21.0,3,43,80,80,9,34,43,130.0,,156,11,52,63,235.0,80,7.69,77,340,2441,12.6,0.58006406
14826,14826,Keith Brown,1982-83,22.0,4,24,33,33,4,20,24,87.0,,189,15,72,87,322.0,80,8.03,73,320,2489,12.9,0.5551671
14827,14827,Keith Brown,1983-84,23.0,5,31,50,50,4,27,31,115.0,,239,19,99,118,437.0,80,7.73,71,310,2444,12.7,0.5607303
14828,14828,Keith Brown,1984-85,24.0,6,35,74,74,10,25,35,144.0,,313,29,124,153,581.0,80,7.89,74,336,2448,12.9,0.48183405
14829,14829,Keith Brown,1985-86,25.0,7,23,56,56,1,22,23,100.0,,369,30,146,176,681.0,80,7.77,71,321,2447,12.7,0.42077342
14830,14830,Keith Brown,1986-87,26.0,8,40,70,70,11,29,40,151.0,,439,41,175,216,832.0,80,7.94,82,370,2484,12.8,0.5216027
14831,14831,Keith Brown,1987-88,27.0,9,27,73,73,4,23,27,99.0,,512,45,198,243,931.0,80,7.34,72,344,2400,12.2,0.35209343
14832,14832,Keith Brown,1988-89,28.0,10,9,24,24,3,6,9,39.0,,536,48,204,252,970.0,80,7.43,89,437,2435,12.2,0.33588934
14833,14833,Keith Brown,1989-90,29.0,11,18,74,74,2,16,18,105.0,,610,50,220,270,1075.0,80,7.48,85,403,2430,12.3,0.2736704
14834,14834,Keith Brown,1990-91,30.0,12,25,67,67,5,20,25,111.0,,677,55,240,295,1186.0,80,7.37,76,367,2421,12.2,0.31301388
14835,14835,Keith Brown,1991-92,31.0,13,11,45,45,1,10,11,71.0,,722,56,250,306,1257.0,80,6.91,71,366,2385,11.6,0.22185329
14836,14836,Keith Brown,1992-93,32.0,14,16,57,57,6,10,16,105.0,,779,62,260,322,1362.0,80,6.96,77,402,2440,11.4,0.30708835
14837,14837,Keith Brown,1993-94,33.0,15,8,33,33,2,6,8,47.0,,812,64,266,330,1409.0,84,7.25,87,443,2603,11.7,0.2471
14838,14838,Keith Brown,1994-95,34.0,16,12,51,51,4,8,12,52.0,,863,68,274,342,1461.0,84,6.48,76,407,2545,10.7,0.16480267
14839,14839,Keith Brown,1995-96,35.0,17,0,13,13,0,0,0,10.0,,876,68,274,342,1471.0,48,5.97,37,209,1408,10.2,0.16456208
14840,14840,Keith Carney,1992-93,22.0,2,3,14,14,1,2,3,17.0,,14,1,2,3,17.0,80,6.96,77,402,2440,11.4,0.2697161
14841,14841,Keith Carney,1993-94,23.0,3,6,30,30,2,4,6,26.0,,44,3,6,9,43.0,84,7.25,87,443,2603,11.7,0.25714296
14842,14842,Keith Carney,1994-95,24.0,4,12,37,37,4,8,12,37.0,,81,7,14,21,80.0,84,6.48,76,407,2545,10.7,0.2469719
14843,14843,Keith Carney,1995-96,25.0,5,1,18,18,1,0,1,14.0,,99,8,14,22,94.0,48,5.97,37,209,1408,10.2,0.222518
14844,14844,Keith Carney,1996-97,26.0,6,19,82,82,5,14,19,69.0,,181,13,28,41,163.0,82,6.29,74,413,2481,10.4,0.21303079
14845,14845,Keith Carney,1997-98,27.0,7,18,81,81,3,15,18,77.0,,262,16,43,59,240.0,82,5.83,55,336,2444,9.8,0.21315283
14846,14846,Keith Carney,1998-99,28.0,8,22,80,80,3,19,22,71.0,,342,19,62,81,311.0,82,5.28,57,380,2242,9.6,0.22489199
14847,14847,Keith Carney,1999-00,29.0,9,16,82,82,2,14,16,62.0,1867.0,424,21,76,97,373.0,82,5.27,57,359,2285,9.4,0.19600877
14848,14848,Keith Carney,2000-01,30.0,10,24,82,82,4,20,24,73.0,1738.0,506,25,96,121,446.0,82,5.49,53,331,2294,9.8,0.23841047
14849,14849,Keith Carney,2001-02,31.0,11,16,82,82,2,14,16,65.0,1712.0,588,27,110,137,511.0,82,5.51,63,376,2272,9.9,0.17234644
14850,14850,Keith Carney,2002-03,32.0,12,14,60,60,5,9,14,66.0,1247.0,648,32,119,151,577.0,82,5.24,53,338,2262,9.5,0.19177914
14851,14851,Keith Carney,2003-04,33.0,13,22,81,81,4,18,22,87.0,1828.0,729,36,137,173,664.0,82,5.31,60,363,2326,9.4,0.21101665
14852,14852,Keith Carney,2004-05,34.0,14,7,69,69,2,5,7,58.0,1498.0,798,38,142,180,722.0,82,5.14,57,348,2300,9.2,0.12728703
14853,14853,Keith Carney,2006-07,36.0,15,20,79,79,2,18,20,85.0,1619.0,877,40,160,200,807.0,82,6.05,85,480,2458,10.1,0.1963304
14854,14854,Keith Carney,2007-08,37.0,16,17,80,80,4,13,17,31.0,1242.0,957,44,173,217,838.0,82,5.76,70,398,2426,9.7,0.13622105
14855,14855,Keith Carney,2008-09,38.0,17,11,61,61,1,10,11,27.0,816.0,1018,45,183,228,865.0,82,5.44,62,351,2383,9.4,0.11539048
14856,14856,Keith Crowder,1981-82,23.0,2,25,47,47,13,12,25,69.0,,47,13,12,25,69.0,80,7.69,77,340,2441,12.6,0.4795316
14857,14857,Keith Crowder,1982-83,24.0,3,44,71,71,23,21,44,130.0,,118,36,33,69,199.0,80,8.03,73,320,2489,12.9,0.5768002
14858,14858,Keith Crowder,1983-84,25.0,4,74,74,74,35,39,74,158.0,,192,71,72,143,357.0,80,7.73,71,310,2444,12.7,0.881305
14859,14859,Keith Crowder,1984-85,26.0,5,52,63,63,24,28,52,110.0,,255,95,100,195,467.0,80,7.89,74,336,2448,12.9,0.79262346
14860,14860,Keith Crowder,1985-86,27.0,6,70,79,79,32,38,70,173.0,,334,127,138,265,640.0,80,7.77,71,321,2447,12.7,0.8053752
14861,14861,Keith Crowder,1986-87,28.0,7,84,78,78,38,46,84,181.0,,412,165,184,349,821.0,80,7.94,82,370,2484,12.8,0.9447366
14862,14862,Keith Crowder,1987-88,29.0,8,52,58,58,22,30,52,114.0,,470,187,214,401,935.0,80,7.34,72,344,2400,12.2,0.76451015
14863,14863,Keith Crowder,1988-89,30.0,9,43,68,68,17,26,43,123.0,,538,204,240,444,1058.0,80,7.43,89,437,2435,12.2,0.57550097
14864,14864,Keith Crowder,1989-90,31.0,10,33,69,69,15,18,33,121.0,,607,219,258,477,1179.0,80,7.48,85,403,2430,12.3,0.4281414
14865,14865,Keith Crowder,1990-91,32.0,11,17,55,55,4,13,17,48.0,,662,223,271,494,1227.0,80,7.37,76,367,2421,12.2,0.3454582
14866,14866,Keith Hanson,1984-85,27.0,2,2,25,25,0,2,2,19.0,,25,0,2,2,19.0,80,7.89,74,336,2448,12.9,0.18767902
14867,14867,Keith Jones,1993-94,25.0,2,26,71,71,12,14,26,73.0,,71,12,14,26,73.0,84,7.25,87,443,2603,11.7,0.36182708
14868,14868,Keith Jones,1994-95,26.0,3,35,68,68,16,19,35,97.0,,139,28,33,61,170.0,84,6.48,76,407,2545,10.7,0.41168895
14869,14869,Keith Jones,1995-96,27.0,4,20,40,40,14,6,20,85.0,,179,42,39,81,255.0,48,5.97,37,209,1408,10.2,0.51275134
14870,14870,Keith Jones,1996-97,28.0,5,41,68,68,18,23,41,155.0,,247,60,62,122,410.0,82,6.29,74,413,2481,10.4,0.5504031
14871,14871,Keith Jones,1997-98,29.0,6,48,78,78,25,23,48,170.0,,325,85,85,170,580.0,82,5.83,55,336,2444,9.8,0.56400573
14872,14872,Keith Jones,1998-99,30.0,7,10,23,23,3,7,10,31.0,,348,88,92,180,611.0,82,5.28,57,380,2242,9.6,0.4225328
14873,14873,Keith Jones,1999-00,31.0,8,53,78,78,20,33,53,135.0,1287.0,426,108,125,233,746.0,82,5.27,57,359,2285,9.4,0.55120623
14874,14874,Keith Jones,2000-01,32.0,9,25,57,57,9,16,25,92.0,778.0,483,117,141,258,838.0,82,5.49,53,331,2294,9.8,0.33316135
14875,14875,Keith Jones,2001-02,33.0,10,0,8,8,0,0,0,11.0,88.0,491,117,141,258,849.0,82,5.51,63,376,2272,9.9,0.24936074
14876,14876,Keith Osborne,1990-91,21.0,2,2,5,5,0,2,2,4.0,,5,0,2,2,4.0,80,7.37,76,367,2421,12.2,0.30884156
14877,14877,Keith Osborne,1993-94,24.0,3,2,11,11,1,1,2,11.0,,16,1,3,4,15.0,84,7.25,87,443,2603,11.7,0.22069791
14878,14878,Keith Primeau,1991-92,20.0,2,15,58,58,3,12,15,33.0,,58,3,12,15,33.0,80,6.91,71,366,2385,11.6,0.31268883
14879,14879,Keith Primeau,1992-93,21.0,3,16,35,35,6,10,16,27.0,,93,9,22,31,60.0,80,6.96,77,402,2440,11.4,0.40975562
14880,14880,Keith Primeau,1993-94,22.0,4,32,73,73,15,17,32,75.0,,166,24,39,63,135.0,84,7.25,87,443,2603,11.7,0.45539016
14881,14881,Keith Primeau,1994-95,23.0,5,73,78,78,31,42,73,155.0,,244,55,81,136,290.0,84,6.48,76,407,2545,10.7,0.782617
14882,14882,Keith Primeau,1995-96,24.0,6,42,45,45,15,27,42,96.0,,289,70,108,178,386.0,48,5.97,37,209,1408,10.2,0.86812145
14883,14883,Keith Primeau,1996-97,25.0,7,52,74,74,27,25,52,150.0,,363,97,133,230,536.0,82,6.29,74,413,2481,10.4,0.63271475
14884,14884,Keith Primeau,1997-98,26.0,8,51,75,75,26,25,51,169.0,,438,123,158,281,705.0,82,5.83,55,336,2444,9.8,0.6484217
14885,14885,Keith Primeau,1998-99,27.0,9,63,81,81,26,37,63,180.0,,519,149,195,344,885.0,82,5.28,57,380,2242,9.6,0.7321156
14886,14886,Keith Primeau,1999-00,28.0,10,62,78,78,30,32,62,178.0,1665.0,597,179,227,406,1063.0,82,5.27,57,359,2285,9.4,0.7206521
14887,14887,Keith Primeau,2000-01,29.0,11,17,23,23,7,10,17,51.0,406.0,620,186,237,423,1114.0,82,5.49,53,331,2294,9.8,0.75675106
14888,14888,Keith Primeau,2001-02,30.0,12,73,71,71,34,39,73,165.0,1418.0,691,220,276,496,1279.0,82,5.51,63,376,2272,9.9,0.7605016
14889,14889,Keith Primeau,2002-03,31.0,13,48,75,75,19,29,48,151.0,1350.0,766,239,305,544,1430.0,82,5.24,53,338,2262,9.5,0.57751095
14890,14890,Keith Primeau,2003-04,32.0,14,46,80,80,19,27,46,171.0,1542.0,846,258,332,590,1601.0,82,5.31,60,363,2326,9.4,0.5053867
14891,14891,Keith Primeau,2004-05,33.0,15,22,54,54,7,15,22,86.0,897.0,900,265,347,612,1687.0,82,5.14,57,348,2300,9.2,0.58185613
14892,14892,Keith Primeau,2006-07,35.0,16,7,9,9,1,6,7,12.0,143.0,909,266,353,619,1699.0,82,6.05,85,480,2458,10.1,0.3610766
14893,14893,Keith Redmond,1994-95,22.0,2,1,12,12,1,0,1,9.0,,12,1,0,1,9.0,84,6.48,76,407,2545,10.7,0.21729228
14894,14894,Keith Tkachuk,1992-93,20.0,2,8,17,17,3,5,8,22.0,,17,3,5,8,22.0,80,6.96,77,402,2440,11.4,0.42896312
14895,14895,Keith Tkachuk,1993-94,21.0,3,51,83,83,28,23,51,199.0,,100,31,28,59,221.0,84,7.25,87,443,2603,11.7,0.7506607
14896,14896,Keith Tkachuk,1994-95,22.0,4,81,84,84,41,40,81,218.0,,184,72,68,140,439.0,84,6.48,76,407,2545,10.7,0.88077736
14897,14897,Keith Tkachuk,1995-96,23.0,5,51,48,48,22,29,51,129.0,,232,94,97,191,568.0,48,5.97,37,209,1408,10.2,1.0660441
14898,14898,Keith Tkachuk,1996-97,24.0,6,98,76,76,50,48,98,249.0,,308,144,145,289,817.0,82,6.29,74,413,2481,10.4,1.0307362
14899,14899,Keith Tkachuk,1997-98,25.0,7,86,81,81,52,34,86,296.0,,389,196,179,375,1113.0,82,5.83,55,336,2444,9.8,0.9939414
14900,14900,Keith Tkachuk,1998-99,26.0,8,66,69,69,40,26,66,232.0,,458,236,205,441,1345.0,82,5.28,57,380,2242,9.6,1.0018497
14901,14901,Keith Tkachuk,1999-00,27.0,9,68,68,68,36,32,68,258.0,1427.0,526,272,237,509,1603.0,82,5.27,57,359,2285,9.4,0.9259442
14902,14902,Keith Tkachuk,2000-01,28.0,10,43,50,50,22,21,43,183.0,967.0,576,294,258,552,1786.0,82,5.49,53,331,2294,9.8,0.8527228
14903,14903,Keith Tkachuk,2001-02,29.0,11,79,76,76,35,44,79,271.0,1527.0,652,329,302,631,2057.0,82,5.51,63,376,2272,9.9,0.87695074
14904,14904,Keith Tkachuk,2002-03,30.0,12,75,73,73,38,37,75,244.0,1433.0,725,367,339,706,2301.0,82,5.24,53,338,2262,9.5,0.89340407
14905,14905,Keith Tkachuk,2003-04,31.0,13,55,56,56,31,24,55,185.0,1079.0,781,398,363,761,2486.0,82,5.31,60,363,2326,9.4,0.8709508
14906,14906,Keith Tkachuk,2004-05,32.0,14,71,75,75,33,38,71,233.0,1474.0,856,431,401,832,2719.0,82,5.14,57,348,2300,9.2,0.92442966
14907,14907,Keith Tkachuk,2006-07,34.0,15,36,41,41,15,21,36,133.0,798.0,897,446,422,868,2852.0,82,6.05,85,480,2458,10.1,0.6839882
14908,14908,Keith Tkachuk,2007-08,35.0,16,58,79,79,27,31,58,196.0,1382.0,976,473,453,926,3048.0,82,5.76,70,398,2426,9.7,0.64055854
14909,14909,Keith Tkachuk,2008-09,36.0,17,58,79,79,27,31,58,177.0,1331.0,1055,500,484,984,3225.0,82,5.44,62,351,2383,9.4,0.6252646
14910,14910,Keith Tkachuk,2009-10,37.0,18,49,79,79,25,24,49,185.0,1340.0,1134,525,508,1033,3410.0,82,5.7,65,341,2477,9.4,0.5854275
14911,14911,Keith Tkachuk,2010-11,38.0,19,32,67,67,13,19,32,120.0,905.0,1201,538,527,1065,3530.0,82,5.53,56,304,2486,9.1,0.40304983
14912,14912,Keith Yandle,2007-08,21.0,2,2,7,7,0,2,2,10.0,141.0,7,0,2,2,10.0,82,5.76,70,398,2426,9.7,0.25578022
14913,14913,Keith Yandle,2008-09,22.0,3,12,43,43,5,7,12,72.0,605.0,50,5,9,14,82.0,82,5.44,62,351,2383,9.4,0.30903918
14914,14914,Keith Yandle,2009-10,23.0,4,30,69,69,4,26,30,118.0,1147.0,119,9,35,44,200.0,82,5.7,65,341,2477,9.4,0.40291902
14915,14915,Keith Yandle,2010-11,24.0,5,41,82,82,12,29,41,145.0,1659.0,201,21,64,85,345.0,82,5.53,56,304,2486,9.1,0.48843014
14916,14916,Keith Yandle,2011-12,25.0,6,59,82,82,11,48,59,199.0,1999.0,283,32,112,144,544.0,82,5.46,52,291,2492,9.0,0.65846705
14917,14917,Keith Yandle,2012-13,26.0,7,43,82,82,11,32,43,196.0,1832.0,365,43,144,187,740.0,82,5.32,47,271,2439,8.9,0.5539371
14918,14918,Keith Yandle,2013-14,27.0,8,30,48,48,10,20,30,130.0,1068.0,413,53,164,217,870.0,48,5.31,29,160,1399,9.1,0.5985173
14919,14919,Keith Yandle,2014-15,28.0,9,53,82,82,8,45,53,241.0,1980.0,495,61,209,270,1111.0,82,5.34,48,269,2463,8.9,0.6470016
14920,14920,Keith Yandle,2015-16,29.0,10,52,84,84,6,46,52,232.0,1925.0,579,67,255,322,1343.0,82,5.32,47,251,2453,8.9,0.598399
14921,14921,Keith Yandle,2016-17,30.0,11,47,82,82,5,42,47,160.0,1637.0,661,72,297,369,1503.0,82,5.34,48,255,2438,9.0,0.5490974
14922,14922,Keith Yandle,2017-18,31.0,12,41,82,82,5,36,41,178.0,1807.0,743,77,333,410,1681.0,82,5.45,47,245,2478,9.0,0.5143789
14923,14923,Keith Yandle,2018-19,32.0,13,56,82,82,8,48,56,179.0,2008.0,825,85,381,466,1860.0,82,5.86,50,250,2620,9.2,0.6825166
14924,14924,Keith Yandle,2019-20,33.0,14,62,82,82,9,53,62,199.0,1840.0,907,94,434,528,2059.0,82,5.96,47,239,2579,9.5,0.667937
14925,14925,Keith Yandle,2020-21,34.0,15,45,69,69,5,40,45,129.0,1359.0,976,99,474,573,2188.0,70,5.96,42,208,2192,9.5,0.55290115
14926,14926,Kellan Lain,2014-15,25.0,2,1,9,9,1,0,1,7.0,47.0,9,1,0,1,7.0,82,5.34,48,269,2463,8.9,0.19004095
14927,14927,Kelly Buchberger,1988-89,22.0,2,1,19,19,1,0,1,10.0,,19,1,0,1,10.0,80,7.43,89,437,2435,12.2,0.2048079
14928,14928,Kelly Buchberger,1989-90,23.0,3,14,66,66,5,9,14,57.0,,85,6,9,15,67.0,80,7.48,85,403,2430,12.3,0.23920897
14929,14929,Kelly Buchberger,1990-91,24.0,4,8,55,55,2,6,8,35.0,,140,8,15,23,102.0,80,7.37,76,367,2421,12.2,0.18535796
14930,14930,Kelly Buchberger,1991-92,25.0,5,4,64,64,3,1,4,54.0,,204,11,16,27,156.0,80,6.91,71,366,2385,11.6,0.17139754
14931,14931,Kelly Buchberger,1992-93,26.0,6,44,79,79,20,24,44,90.0,,283,31,40,71,246.0,80,6.96,77,402,2440,11.4,0.45959193
14932,14932,Kelly Buchberger,1993-94,27.0,7,30,83,83,12,18,30,92.0,,366,43,58,101,338.0,84,7.25,87,443,2603,11.7,0.35165262
14933,14933,Kelly Buchberger,1994-95,28.0,8,21,84,84,3,18,21,93.0,,450,46,76,122,431.0,84,6.48,76,407,2545,10.7,0.23984471
14934,14934,Kelly Buchberger,1995-96,29.0,9,24,48,48,7,17,24,73.0,,498,53,93,146,504.0,48,5.97,37,209,1408,10.2,0.3899427
14935,14935,Kelly Buchberger,1996-97,30.0,10,25,82,82,11,14,25,119.0,,580,64,107,171,623.0,82,6.29,74,413,2481,10.4,0.28882086
14936,14936,Kelly Buchberger,1997-98,31.0,11,38,81,81,8,30,38,78.0,,661,72,137,209,701.0,82,5.83,55,336,2444,9.8,0.37184244
14937,14937,Kelly Buchberger,1998-99,32.0,12,23,82,82,6,17,23,86.0,,743,78,154,232,787.0,82,5.28,57,380,2242,9.6,0.24254161
14938,14938,Kelly Buchberger,1999-00,33.0,13,8,52,52,4,4,8,29.0,614.0,795,82,158,240,816.0,82,5.27,57,359,2285,9.4,0.14461991
14939,14939,Kelly Buchberger,2000-01,34.0,14,20,81,81,7,13,20,76.0,1303.0,876,89,171,260,892.0,82,5.49,53,331,2294,9.8,0.240491
14940,14940,Kelly Buchberger,2001-02,35.0,15,20,82,82,6,14,20,66.0,1183.0,958,95,185,280,958.0,82,5.51,63,376,2272,9.9,0.18862268
14941,14941,Kelly Buchberger,2002-03,36.0,16,13,74,74,6,7,13,39.0,765.0,1032,101,192,293,997.0,82,5.24,53,338,2262,9.5,0.13918492
14942,14942,Kelly Buchberger,2003-04,37.0,17,12,79,79,3,9,12,32.0,788.0,1111,104,201,305,1029.0,82,5.31,60,363,2326,9.4,0.13234812
14943,14943,Kelly Buchberger,2004-05,38.0,18,4,71,71,1,3,4,34.0,735.0,1182,105,204,309,1063.0,82,5.14,57,348,2300,9.2,0.18024856
14944,14944,Kelly Chase,1990-91,23.0,2,4,43,43,1,3,4,9.0,,43,1,3,4,9.0,80,7.37,76,367,2421,12.2,0.14966494
14945,14945,Kelly Chase,1991-92,24.0,3,1,2,2,1,0,1,1.0,,45,2,3,5,10.0,80,6.91,71,366,2385,11.6,0.20313856
14946,14946,Kelly Chase,1992-93,25.0,4,3,46,46,1,2,3,29.0,,91,3,5,8,39.0,80,6.96,77,402,2440,11.4,0.13647854
14947,14947,Kelly Chase,1993-94,26.0,5,7,49,49,2,5,7,28.0,,140,5,10,15,67.0,84,7.25,87,443,2603,11.7,0.12683171
14948,14948,Kelly Chase,1994-95,27.0,6,7,68,68,2,5,7,57.0,,208,7,15,22,124.0,84,6.48,76,407,2545,10.7,0.1402744
14949,14949,Kelly Chase,1995-96,28.0,7,4,28,28,0,4,4,15.0,,236,7,19,26,139.0,48,5.97,37,209,1408,10.2,0.10856399
14950,14950,Kelly Chase,1996-97,29.0,8,6,55,55,2,4,6,19.0,,291,9,23,32,158.0,82,6.29,74,413,2481,10.4,0.09273189
14951,14951,Kelly Chase,1997-98,30.0,9,3,30,30,1,2,3,6.0,,321,10,25,35,164.0,82,5.83,55,336,2444,9.8,0.09734923
14952,14952,Kelly Chase,1998-99,31.0,10,7,67,67,4,3,7,29.0,,388,14,28,42,193.0,82,5.28,57,380,2242,9.6,0.093399644
14953,14953,Kelly Chase,1999-00,32.0,11,10,45,45,3,7,10,25.0,267.0,433,17,35,52,218.0,82,5.27,57,359,2285,9.4,0.14154601
14954,14954,Kelly Chase,2000-01,33.0,12,1,25,25,0,1,1,14.0,194.0,458,17,36,53,232.0,82,5.49,53,331,2294,9.8,0.082930714
14955,14955,Kelly Fairchild,1996-97,23.0,2,1,1,1,0,1,1,1.0,,1,0,1,1,1.0,82,6.29,74,413,2481,10.4,0.18899372
14956,14956,Kelly Fairchild,1997-98,24.0,3,2,22,22,0,2,2,14.0,,23,0,3,3,15.0,82,5.83,55,336,2444,9.8,0.11165723
14957,14957,Kelly Fairchild,1999-00,26.0,4,0,1,1,0,0,0,4.0,13.0,24,0,3,3,19.0,82,5.27,57,359,2285,9.4,0.15084878
14958,14958,Kelly Fairchild,2002-03,29.0,5,2,10,10,2,0,2,6.0,66.0,34,2,3,5,25.0,82,5.24,53,338,2262,9.5,0.18585509
14959,14959,Kelly Kisio,1983-84,24.0,2,7,15,15,4,3,7,16.0,,15,4,3,7,16.0,80,7.73,71,310,2444,12.7,0.35658753
14960,14960,Kelly Kisio,1984-85,25.0,3,60,70,70,23,37,60,146.0,,85,27,40,67,162.0,80,7.89,74,336,2448,12.9,0.72671306
14961,14961,Kelly Kisio,1985-86,26.0,4,61,75,75,20,41,61,126.0,,160,47,81,128,288.0,80,7.77,71,321,2447,12.7,0.71843857
14962,14962,Kelly Kisio,1986-87,27.0,5,69,76,76,21,48,69,140.0,,236,68,129,197,428.0,80,7.94,82,370,2484,12.8,0.7715553
14963,14963,Kelly Kisio,1987-88,28.0,6,64,70,70,24,40,64,136.0,,306,92,169,261,564.0,80,7.34,72,344,2400,12.2,0.808334
14964,14964,Kelly Kisio,1988-89,29.0,7,78,77,77,23,55,78,145.0,,383,115,224,339,709.0,80,7.43,89,437,2435,12.2,0.8201263
14965,14965,Kelly Kisio,1989-90,30.0,8,62,70,70,26,36,62,128.0,,453,141,260,401,837.0,80,7.48,85,403,2430,12.3,0.8018599
14966,14966,Kelly Kisio,1990-91,31.0,9,66,68,68,22,44,66,128.0,,521,163,304,467,965.0,80,7.37,76,367,2421,12.2,0.73354733
14967,14967,Kelly Kisio,1991-92,32.0,10,35,51,51,15,20,35,74.0,,572,178,324,502,1039.0,80,6.91,71,366,2385,11.6,0.6140868
14968,14968,Kelly Kisio,1992-93,33.0,11,37,48,48,11,26,37,68.0,,620,189,350,539,1107.0,80,6.96,77,402,2440,11.4,0.64364254
14969,14969,Kelly Kisio,1993-94,34.0,12,78,78,78,26,52,78,152.0,,698,215,402,617,1259.0,84,7.25,87,443,2603,11.7,0.740791
14970,14970,Kelly Kisio,1994-95,35.0,13,30,51,51,7,23,30,62.0,,749,222,425,647,1321.0,84,6.48,76,407,2545,10.7,0.5539651
14971,14971,Kelly Kisio,1995-96,36.0,14,11,12,12,7,4,11,26.0,,761,229,429,658,1347.0,48,5.97,37,209,1408,10.2,0.68077934
14972,14972,Kelly Miller,1985-86,22.0,2,2,5,5,0,2,2,5.0,,5,0,2,2,5.0,80,7.77,71,321,2447,12.7,0.26169223
14973,14973,Kelly Miller,1986-87,23.0,3,33,74,74,13,20,33,111.0,,79,13,22,35,116.0,80,7.94,82,370,2484,12.8,0.49426013
14974,14974,Kelly Miller,1987-88,24.0,4,42,77,77,16,26,42,108.0,,156,29,48,77,224.0,80,7.34,72,344,2400,12.2,0.5065555
14975,14975,Kelly Miller,1988-89,25.0,5,32,80,80,9,23,32,96.0,,236,38,71,109,320.0,80,7.43,89,437,2435,12.2,0.45297578
14976,14976,Kelly Miller,1989-90,26.0,6,40,78,78,19,21,40,121.0,,314,57,92,149,441.0,80,7.48,85,403,2430,12.3,0.46266857
14977,14977,Kelly Miller,1990-91,27.0,7,40,80,80,18,22,40,107.0,,394,75,114,189,548.0,80,7.37,76,367,2421,12.2,0.49804768
14978,14978,Kelly Miller,1991-92,28.0,8,50,80,80,24,26,50,155.0,,474,99,140,239,703.0,80,6.91,71,366,2385,11.6,0.5712696
14979,14979,Kelly Miller,1992-93,29.0,9,52,78,78,14,38,52,144.0,,552,113,178,291,847.0,80,6.96,77,402,2440,11.4,0.5792545
14980,14980,Kelly Miller,1993-94,30.0,10,45,84,84,18,27,45,144.0,,636,131,205,336,991.0,84,7.25,87,443,2603,11.7,0.48309135
14981,14981,Kelly Miller,1994-95,31.0,11,39,84,84,14,25,39,138.0,,720,145,230,375,1129.0,84,6.48,76,407,2545,10.7,0.43338993
14982,14982,Kelly Miller,1995-96,32.0,12,23,48,48,10,13,23,70.0,,768,155,243,398,1199.0,48,5.97,37,209,1408,10.2,0.41386193
14983,14983,Kelly Miller,1996-97,33.0,13,20,74,74,7,13,20,93.0,,842,162,256,418,1292.0,82,6.29,74,413,2481,10.4,0.27588606
14984,14984,Kelly Miller,1997-98,34.0,14,24,77,77,10,14,24,95.0,,919,172,270,442,1387.0,82,5.83,55,336,2444,9.8,0.25119478
14985,14985,Kelly Miller,1998-99,35.0,15,14,76,76,7,7,14,68.0,,995,179,277,456,1455.0,82,5.28,57,380,2242,9.6,0.16856089
14986,14986,Kelly Miller,1999-00,36.0,16,7,62,62,2,5,7,49.0,693.0,1057,181,282,463,1504.0,82,5.27,57,359,2285,9.4,0.17229503
14987,14987,Ken Baumgartner,1988-89,22.0,2,5,30,30,2,3,5,17.0,,30,2,3,5,17.0,80,7.43,89,437,2435,12.2,0.2708438
14988,14988,Ken Baumgartner,1989-90,23.0,3,4,49,49,1,3,4,15.0,,79,3,6,9,32.0,80,7.48,85,403,2430,12.3,0.1630862
14989,14989,Ken Baumgartner,1990-91,24.0,4,6,65,65,1,5,6,48.0,,144,4,11,15,80.0,80,7.37,76,367,2421,12.2,0.16922075
14990,14990,Ken Baumgartner,1991-92,25.0,5,7,78,78,1,6,7,41.0,,222,5,17,22,121.0,80,6.91,71,366,2385,11.6,0.15855011
14991,14991,Ken Baumgartner,1992-93,26.0,6,1,55,55,0,1,1,16.0,,277,5,18,23,137.0,80,6.96,77,402,2440,11.4,0.09577429
14992,14992,Ken Baumgartner,1993-94,27.0,7,1,63,63,1,0,1,23.0,,340,6,18,24,160.0,84,7.25,87,443,2603,11.7,0.09113532
14993,14993,Ken Baumgartner,1994-95,28.0,8,8,64,64,4,4,8,34.0,,404,10,22,32,194.0,84,6.48,76,407,2545,10.7,0.11217055
14994,14994,Ken Baumgartner,1995-96,29.0,9,0,2,2,0,0,0,1.0,,406,10,22,32,195.0,48,5.97,37,209,1408,10.2,0.11895767
14995,14995,Ken Baumgartner,1996-97,30.0,10,6,72,72,2,4,6,32.0,,478,12,26,38,227.0,82,6.29,74,413,2481,10.4,0.09529191
14996,14996,Ken Baumgartner,1997-98,31.0,11,11,67,67,0,11,11,20.0,,545,12,37,49,247.0,82,5.83,55,336,2444,9.8,0.08497435
14997,14997,Ken Baumgartner,1998-99,32.0,12,1,82,82,0,1,1,28.0,,627,12,38,50,275.0,82,5.28,57,380,2242,9.6,0.078112364
14998,14998,Ken Baumgartner,1999-00,33.0,13,4,69,69,1,3,4,15.0,354.0,696,13,41,54,290.0,82,5.27,57,359,2285,9.4,0.08678919
14999,14999,Ken Belanger,1995-96,21.0,2,0,3,3,0,0,0,1.0,,3,0,0,0,1.0,48,5.97,37,209,1408,10.2,0.20043314
15000,15000,Ken Belanger,1996-97,22.0,3,0,7,7,0,0,0,0.0,,10,0,0,0,1.0,82,6.29,74,413,2481,10.4,0.14637053
15001,15001,Ken Belanger,1997-98,23.0,4,2,18,18,0,2,2,5.0,,28,0,2,2,6.0,82,5.83,55,336,2444,9.8,0.16494545
15002,15002,Ken Belanger,1998-99,24.0,5,4,37,37,3,1,4,10.0,,65,3,3,6,16.0,82,5.28,57,380,2242,9.6,0.14415738
15003,15003,Ken Belanger,1999-00,25.0,6,7,54,54,2,5,7,19.0,254.0,119,5,8,13,35.0,82,5.27,57,359,2285,9.4,0.118733615
15004,15004,Ken Belanger,2000-01,26.0,7,4,37,37,2,2,4,20.0,196.0,156,7,10,17,55.0,82,5.49,53,331,2294,9.8,0.13774532
15005,15005,Ken Belanger,2001-02,27.0,8,4,40,40,2,2,4,35.0,284.0,196,9,12,21,90.0,82,5.51,63,376,2272,9.9,0.1406357
15006,15006,Ken Belanger,2002-03,28.0,9,2,43,43,2,0,2,22.0,188.0,239,11,12,23,112.0,82,5.24,53,338,2262,9.5,0.1010457
15007,15007,Ken Belanger,2003-04,29.0,10,0,4,4,0,0,0,0.0,16.0,243,11,12,23,112.0,82,5.31,60,363,2326,9.4,0.13379699
15008,15008,Ken Belanger,2006-07,32.0,11,0,5,5,0,0,0,0.0,18.0,248,11,12,23,112.0,82,6.05,85,480,2458,10.1,0.10412365
15009,15009,Ken Berry,1982-83,22.0,2,5,15,15,2,3,5,9.0,,15,2,3,5,9.0,80,8.03,73,320,2489,12.9,0.35186845
15010,15010,Ken Berry,1984-85,24.0,3,5,13,13,2,3,5,18.0,,28,4,6,10,27.0,80,7.89,74,336,2448,12.9,0.2982418
15011,15011,Ken Berry,1988-89,28.0,4,5,14,14,2,3,5,26.0,,42,6,9,15,53.0,80,7.43,89,437,2435,12.2,0.29462567
15012,15012,Ken Berry,1989-90,29.0,5,3,13,13,2,1,3,10.0,,55,8,10,18,63.0,80,7.48,85,403,2430,12.3,0.27625197
15013,15013,Ken Daneyko,1984-85,20.0,2,5,11,11,1,4,5,17.0,,11,1,4,5,17.0,80,7.89,74,336,2448,12.9,0.33763987
15014,15014,Ken Daneyko,1985-86,21.0,3,0,1,1,0,0,0,1.0,,12,1,4,5,18.0,80,7.77,71,321,2447,12.7,0.2624135
15015,15015,Ken Daneyko,1986-87,22.0,4,10,44,44,0,10,10,48.0,,56,1,14,15,66.0,80,7.94,82,370,2484,12.8,0.22099328
15016,15016,Ken Daneyko,1987-88,23.0,5,14,79,79,2,12,14,112.0,,135,3,26,29,178.0,80,7.34,72,344,2400,12.2,0.26252016
15017,15017,Ken Daneyko,1988-89,24.0,6,12,80,80,5,7,12,82.0,,215,8,33,41,260.0,80,7.43,89,437,2435,12.2,0.25257468
15018,15018,Ken Daneyko,1989-90,25.0,7,10,80,80,5,5,10,108.0,,295,13,38,51,368.0,80,7.48,85,403,2430,12.3,0.25688663
15019,15019,Ken Daneyko,1990-91,26.0,8,21,74,74,6,15,21,64.0,,369,19,53,72,432.0,80,7.37,76,367,2421,12.2,0.25725424
15020,15020,Ken Daneyko,1991-92,27.0,9,20,80,80,4,16,20,106.0,,449,23,69,92,538.0,80,6.91,71,366,2385,11.6,0.24343994
15021,15021,Ken Daneyko,1992-93,28.0,10,8,80,80,1,7,8,57.0,,529,24,76,100,595.0,80,6.96,77,402,2440,11.4,0.16338068
15022,15022,Ken Daneyko,1993-94,29.0,11,13,84,84,2,11,13,71.0,,613,26,87,113,666.0,84,7.25,87,443,2603,11.7,0.15513062
15023,15023,Ken Daneyko,1994-95,30.0,12,10,78,78,1,9,10,60.0,,691,27,96,123,726.0,84,6.48,76,407,2545,10.7,0.11599171
15024,15024,Ken Daneyko,1995-96,31.0,13,3,25,25,1,2,3,27.0,,716,28,98,126,753.0,48,5.97,37,209,1408,10.2,0.14421341
15025,15025,Ken Daneyko,1996-97,32.0,14,6,80,80,2,4,6,67.0,,796,30,102,132,820.0,82,6.29,74,413,2481,10.4,0.13597155
15026,15026,Ken Daneyko,1997-98,33.0,15,9,77,77,2,7,9,63.0,,873,32,109,141,883.0,82,5.83,55,336,2444,9.8,0.12383336
15027,15027,Ken Daneyko,1998-99,34.0,16,1,37,37,0,1,1,18.0,,910,32,110,142,901.0,82,5.28,57,380,2242,9.6,0.092244476
15028,15028,Ken Daneyko,1999-00,35.0,17,11,82,82,2,9,11,63.0,1644.0,992,34,119,153,964.0,82,5.27,57,359,2285,9.4,0.12717304
15029,15029,Ken Daneyko,2000-01,36.0,18,6,78,78,0,6,6,74.0,1411.0,1070,34,125,159,1038.0,82,5.49,53,331,2294,9.8,0.110705554
15030,15030,Ken Daneyko,2001-02,37.0,19,4,77,77,0,4,4,50.0,1330.0,1147,34,129,163,1088.0,82,5.51,63,376,2272,9.9,0.10380584
15031,15031,Ken Daneyko,2002-03,38.0,20,6,67,67,0,6,6,44.0,1040.0,1214,34,135,169,1132.0,82,5.24,53,338,2262,9.5,0.103596896
15032,15032,Ken Daneyko,2003-04,39.0,21,9,69,69,2,7,9,38.0,1077.0,1283,36,142,178,1170.0,82,5.31,60,363,2326,9.4,0.118717015
15033,15033,Ken Duggan,1988-89,25.0,2,0,1,1,0,0,0,0.0,,1,0,0,0,0.0,80,7.43,89,437,2435,12.2,0.1660105
15034,15034,Ken Gernander,1996-97,27.0,2,5,10,10,2,3,5,10.0,,10,2,3,5,10.0,82,6.29,74,413,2481,10.4,0.25279504
15035,15035,Ken Gernander,2004-05,35.0,3,0,2,2,0,0,0,0.0,13.0,12,2,3,5,10.0,82,5.14,57,348,2300,9.2,0.18129063
15036,15036,Ken Hammond,1985-86,22.0,2,1,3,3,1,0,1,3.0,,3,1,0,1,3.0,80,7.77,71,321,2447,12.7,0.29302087
15037,15037,Ken Hammond,1986-87,23.0,3,1,3,3,0,1,1,2.0,,6,1,1,2,5.0,80,7.94,82,370,2484,12.8,0.2258547
15038,15038,Ken Hammond,1987-88,24.0,4,2,10,10,0,2,2,7.0,,16,1,3,4,12.0,80,7.34,72,344,2400,12.2,0.21830642
15039,15039,Ken Hammond,1988-89,25.0,5,16,46,46,7,9,16,52.0,,62,8,12,20,64.0,80,7.43,89,437,2435,12.2,0.31511042
15040,15040,Ken Hammond,1989-90,26.0,6,3,22,22,0,3,3,12.0,,84,8,15,23,76.0,80,7.48,85,403,2430,12.3,0.20580387
15041,15041,Ken Hammond,1991-92,28.0,7,1,1,1,1,0,1,3.0,,85,9,15,24,79.0,80,6.91,71,366,2385,11.6,0.21286198
15042,15042,Ken Hammond,1992-93,29.0,8,15,46,46,5,10,15,93.0,,131,14,25,39,172.0,80,6.96,77,402,2440,11.4,0.27032095
15043,15043,Ken Hammond,1993-94,30.0,9,8,62,62,4,4,8,64.0,,193,18,29,47,236.0,84,7.25,87,443,2603,11.7,0.16615349
15044,15044,Ken Hodge,1989-90,23.0,2,2,5,5,1,1,2,6.0,,5,1,1,2,6.0,80,7.48,85,403,2430,12.3,0.27430385
15045,15045,Ken Hodge,1991-92,25.0,3,59,70,70,30,29,59,137.0,,75,31,30,61,143.0,80,6.91,71,366,2385,11.6,0.7762998
15046,15046,Ken Hodge,1992-93,26.0,4,17,42,42,6,11,17,62.0,,117,37,41,78,205.0,80,6.96,77,402,2440,11.4,0.42588252
15047,15047,Ken Hodge,1993-94,27.0,5,9,25,25,2,7,9,32.0,,142,39,48,87,237.0,84,7.25,87,443,2603,11.7,0.31809452
15048,15048,Ken Klee,1995-96,24.0,2,4,23,23,3,1,4,18.0,,23,3,1,4,18.0,48,5.97,37,209,1408,10.2,0.2690909
15049,15049,Ken Klee,1996-97,25.0,3,11,66,66,8,3,11,76.0,,89,11,4,15,94.0,82,6.29,74,413,2481,10.4,0.22573307
15050,15050,Ken Klee,1997-98,26.0,4,11,80,80,3,8,11,108.0,,169,14,12,26,202.0,82,5.83,55,336,2444,9.8,0.19254896
15051,15051,Ken Klee,1998-99,27.0,5,6,51,51,4,2,6,44.0,,220,18,14,32,246.0,82,5.28,57,380,2242,9.6,0.15492436
15052,15052,Ken Klee,1999-00,28.0,6,20,78,78,7,13,20,132.0,1491.0,298,25,27,52,378.0,82,5.27,57,359,2285,9.4,0.27695137
15053,15053,Ken Klee,2000-01,29.0,7,20,80,80,7,13,20,113.0,1638.0,378,32,40,72,491.0,82,5.49,53,331,2294,9.8,0.24631172
15054,15054,Ken Klee,2001-02,30.0,8,6,54,54,2,4,6,58.0,932.0,432,34,44,78,549.0,82,5.51,63,376,2272,9.9,0.15415004
15055,15055,Ken Klee,2002-03,31.0,9,16,68,68,8,8,16,85.0,1319.0,500,42,52,94,634.0,82,5.24,53,338,2262,9.5,0.22421691
15056,15056,Ken Klee,2003-04,32.0,10,17,70,70,1,16,17,67.0,1527.0,570,43,68,111,701.0,82,5.31,60,363,2326,9.4,0.19663
15057,15057,Ken Klee,2004-05,33.0,11,29,66,66,4,25,29,85.0,1461.0,636,47,93,140,786.0,82,5.14,57,348,2300,9.2,0.32884395
15058,15058,Ken Klee,2006-07,35.0,12,15,74,74,3,12,15,70.0,1393.0,710,50,105,155,856.0,82,6.05,85,480,2458,10.1,0.16002753
15059,15059,Ken Klee,2007-08,36.0,13,19,81,81,3,16,19,90.0,1671.0,791,53,121,174,946.0,82,5.76,70,398,2426,9.7,0.20811814
15060,15060,Ken Klee,2008-09,37.0,14,10,72,72,1,9,10,56.0,1443.0,863,54,130,184,1002.0,82,5.44,62,351,2383,9.4,0.1305094
15061,15061,Ken Klee,2009-10,38.0,15,11,71,71,1,10,11,51.0,1096.0,934,55,140,195,1053.0,82,5.7,65,341,2477,9.4,0.12403309
15062,15062,Ken Leiter,1985-86,24.0,2,2,5,5,0,2,2,9.0,,5,0,2,2,9.0,80,7.77,71,321,2447,12.7,0.2481462
15063,15063,Ken Leiter,1986-87,25.0,3,2,9,9,1,1,2,9.0,,14,1,3,4,18.0,80,7.94,82,370,2484,12.8,0.22006333
15064,15064,Ken Leiter,1987-88,26.0,4,29,74,74,9,20,29,160.0,,88,10,23,33,178.0,80,7.34,72,344,2400,12.2,0.4269368
15065,15065,Ken Leiter,1988-89,27.0,5,17,51,51,4,13,17,104.0,,139,14,36,50,282.0,80,7.43,89,437,2435,12.2,0.31729177
15066,15066,Ken Leiter,1990-91,29.0,6,0,4,4,0,0,0,5.0,,143,14,36,50,287.0,80,7.37,76,367,2421,12.2,0.21809581
15067,15067,Ken Lovsin,1991-92,25.0,2,0,1,1,0,0,0,2.0,,1,0,0,0,2.0,80,6.91,71,366,2385,11.6,0.19595855
15068,15068,Ken McRae,1988-89,20.0,2,0,1,1,0,0,0,1.0,,1,0,0,0,1.0,80,7.43,89,437,2435,12.2,0.27996272
15069,15069,Ken McRae,1989-90,21.0,3,17,37,37,6,11,17,47.0,,38,6,11,17,48.0,80,7.48,85,403,2430,12.3,0.43481988
15070,15070,Ken McRae,1990-91,22.0,4,15,66,66,7,8,15,83.0,,104,13,19,32,131.0,80,7.37,76,367,2421,12.2,0.32546794
15071,15071,Ken McRae,1991-92,23.0,5,0,12,12,0,0,0,6.0,,116,13,19,32,137.0,80,6.91,71,366,2385,11.6,0.24204895
15072,15072,Ken McRae,1992-93,24.0,6,1,10,10,0,1,1,10.0,,126,13,20,33,147.0,80,6.96,77,402,2440,11.4,0.23379445
15073,15073,Ken McRae,1993-94,25.0,7,0,2,2,0,0,0,3.0,,128,13,20,33,150.0,84,7.25,87,443,2603,11.7,0.1923087
15074,15074,Ken McRae,1994-95,26.0,8,2,9,9,1,1,2,11.0,,137,14,21,35,161.0,84,6.48,76,407,2545,10.7,0.19916564
15075,15075,Ken Morrow,1980-81,24.0,2,3,18,18,0,3,3,19.0,,18,0,3,3,19.0,80,7.03,61,280,2352,12.0,0.2473571
15076,15076,Ken Morrow,1981-82,25.0,3,13,80,80,2,11,13,69.0,,98,2,14,16,88.0,80,7.69,77,340,2441,12.6,0.24313909
15077,15077,Ken Morrow,1982-83,26.0,4,19,75,75,1,18,19,91.0,,173,3,32,35,179.0,80,8.03,73,320,2489,12.9,0.2478672
15078,15078,Ken Morrow,1983-84,27.0,5,16,79,79,5,11,16,135.0,,252,8,43,51,314.0,80,7.73,71,310,2444,12.7,0.28013188
15079,15079,Ken Morrow,1984-85,28.0,6,14,63,63,3,11,14,71.0,,315,11,54,65,385.0,80,7.89,74,336,2448,12.9,0.22097182
15080,15080,Ken Morrow,1985-86,29.0,7,8,15,15,1,7,8,15.0,,330,12,61,73,400.0,80,7.77,71,321,2447,12.7,0.2724724
15081,15081,Ken Morrow,1986-87,30.0,8,12,69,69,0,12,12,55.0,,399,12,73,85,455.0,80,7.94,82,370,2484,12.8,0.18267855
15082,15082,Ken Morrow,1987-88,31.0,9,11,64,64,3,8,11,52.0,,463,15,81,96,507.0,80,7.34,72,344,2400,12.2,0.19561988
15083,15083,Ken Morrow,1988-89,32.0,10,5,53,53,1,4,5,50.0,,516,16,85,101,557.0,80,7.43,89,437,2435,12.2,0.1599938
15084,15084,Ken Morrow,1989-90,33.0,11,4,34,34,1,3,4,27.0,,550,17,88,105,584.0,80,7.48,85,403,2430,12.3,0.14744952
15085,15085,Ken Priestlay,1987-88,20.0,2,17,34,34,11,6,17,49.0,,34,11,6,17,49.0,80,7.34,72,344,2400,12.2,0.4769876
15086,15086,Ken Priestlay,1988-89,21.0,3,17,33,33,5,12,17,63.0,,67,16,18,34,112.0,80,7.43,89,437,2435,12.2,0.44412127
15087,15087,Ken Priestlay,1989-90,22.0,4,2,15,15,2,0,2,20.0,,82,18,18,36,132.0,80,7.48,85,403,2430,12.3,0.39914793
15088,15088,Ken Priestlay,1990-91,23.0,5,14,35,35,7,7,14,66.0,,117,25,25,50,198.0,80,7.37,76,367,2421,12.2,0.4245798
15089,15089,Ken Priestlay,1991-92,24.0,6,1,2,2,0,1,1,2.0,,119,25,26,51,200.0,80,6.91,71,366,2385,11.6,0.27099666
15090,15090,Ken Priestlay,1992-93,25.0,7,10,49,49,2,8,10,20.0,,168,27,34,61,220.0,80,6.96,77,402,2440,11.4,0.24955204
15091,15091,Ken Quinney,1987-88,22.0,2,9,25,25,2,7,9,22.0,,25,2,7,9,22.0,80,7.34,72,344,2400,12.2,0.34374267
15092,15092,Ken Quinney,1988-89,23.0,3,4,15,15,2,2,4,20.0,,40,4,9,13,42.0,80,7.43,89,437,2435,12.2,0.30743182
15093,15093,Ken Quinney,1991-92,26.0,4,7,19,19,3,4,7,19.0,,59,7,13,20,61.0,80,6.91,71,366,2385,11.6,0.2824071
15094,15094,Ken Sabourin,1989-90,23.0,2,1,6,6,0,1,1,2.0,,6,0,1,1,2.0,80,7.48,85,403,2430,12.3,0.23549059
15095,15095,Ken Sabourin,1990-91,24.0,3,0,5,5,0,0,0,3.0,,11,0,1,1,5.0,80,7.37,76,367,2421,12.2,0.1958327
15096,15096,Ken Sabourin,1991-92,25.0,4,9,44,44,2,7,9,23.0,,55,2,8,10,28.0,80,6.91,71,366,2385,11.6,0.1655531
15097,15097,Ken Sabourin,1992-93,26.0,5,0,19,19,0,0,0,12.0,,74,2,8,10,40.0,80,6.96,77,402,2440,11.4,0.15310284
15098,15098,Ken Solheim,1981-82,20.0,2,5,10,10,4,1,5,17.0,,10,4,1,5,17.0,80,7.69,77,340,2441,12.6,0.41838625
15099,15099,Ken Solheim,1982-83,21.0,3,9,29,29,4,5,9,46.0,,39,8,6,14,63.0,80,8.03,73,320,2489,12.9,0.34567425
15100,15100,Ken Solheim,1983-84,22.0,4,6,35,35,2,4,6,39.0,,74,10,10,20,102.0,80,7.73,71,310,2444,12.7,0.29569477
15101,15101,Ken Solheim,1985-86,24.0,5,18,55,55,8,10,18,87.0,,129,18,20,38,189.0,80,7.77,71,321,2447,12.7,0.34884506
15102,15102,Ken Solheim,1986-87,25.0,6,1,6,6,1,0,1,8.0,,135,19,20,39,197.0,80,7.94,82,370,2484,12.8,0.24085546
15103,15103,Ken Strong,1983-84,20.0,2,0,2,2,0,0,0,2.0,,2,0,0,0,2.0,80,7.73,71,310,2444,12.7,0.28967196
15104,15104,Ken Strong,1984-85,21.0,3,2,2,2,0,2,2,3.0,,4,0,2,2,5.0,80,7.89,74,336,2448,12.9,0.31528705
15105,15105,Ken Strong,1985-86,22.0,4,2,11,11,2,0,2,19.0,,15,2,2,4,24.0,80,7.77,71,321,2447,12.7,0.3172307
15106,15106,Ken Sutton,1991-92,22.0,2,9,15,15,3,6,9,26.0,,15,3,6,9,26.0,80,6.91,71,366,2385,11.6,0.39258125
15107,15107,Ken Sutton,1992-93,23.0,3,20,64,64,2,18,20,81.0,,79,5,24,29,107.0,80,6.96,77,402,2440,11.4,0.33134207
15108,15108,Ken Sutton,1993-94,24.0,4,22,63,63,8,14,22,77.0,,142,13,38,51,184.0,84,7.25,87,443,2603,11.7,0.321114
15109,15109,Ken Sutton,1994-95,25.0,5,24,78,78,4,20,24,95.0,,220,17,58,75,279.0,84,6.48,76,407,2545,10.7,0.28373516
15110,15110,Ken Sutton,1995-96,26.0,6,7,24,24,4,3,7,40.0,,244,21,61,82,319.0,48,5.97,37,209,1408,10.2,0.31762844
15111,15111,Ken Sutton,1996-97,27.0,7,8,38,38,0,8,8,41.0,,282,21,69,90,360.0,82,6.29,74,413,2481,10.4,0.18412551
15112,15112,Ken Sutton,1998-99,29.0,8,0,21,21,0,0,0,12.0,,303,21,69,90,372.0,82,5.28,57,380,2242,9.6,0.16874966
15113,15113,Ken Sutton,1999-00,30.0,9,1,5,5,1,0,1,5.0,65.0,308,22,69,91,377.0,82,5.27,57,359,2285,9.4,0.18954396
15114,15114,Ken Sutton,2000-01,31.0,10,2,6,6,0,2,2,10.0,104.0,314,22,71,93,387.0,82,5.49,53,331,2294,9.8,0.2229459
15115,15115,Ken Sutton,2001-02,32.0,11,8,53,53,1,7,8,35.0,834.0,367,23,78,101,422.0,82,5.51,63,376,2272,9.9,0.14924994
15116,15116,Ken Sutton,2002-03,33.0,12,2,21,21,0,2,2,22.0,267.0,388,23,80,103,444.0,82,5.24,53,338,2262,9.5,0.16174254
15117,15117,Ken Yaremchuk,1984-85,21.0,2,13,47,47,6,7,13,49.0,,47,6,7,13,49.0,80,7.89,74,336,2448,12.9,0.33219063
15118,15118,Ken Yaremchuk,1985-86,22.0,3,26,63,63,10,16,26,73.0,,110,16,23,39,122.0,80,7.77,71,321,2447,12.7,0.43542975
15119,15119,Ken Yaremchuk,1986-87,23.0,4,34,78,78,14,20,34,81.0,,188,30,43,73,203.0,80,7.94,82,370,2484,12.8,0.4575607
15120,15120,Ken Yaremchuk,1987-88,24.0,5,11,20,20,3,8,11,33.0,,208,33,51,84,236.0,80,7.34,72,344,2400,12.2,0.4465408
15121,15121,Ken Yaremchuk,1988-89,25.0,6,7,16,16,2,5,7,14.0,,224,35,56,91,250.0,80,7.43,89,437,2435,12.2,0.35014772
15122,15122,Ken Yaremchuk,1989-90,26.0,7,1,11,11,1,0,1,13.0,,235,36,56,92,263.0,80,7.48,85,403,2430,12.3,0.2748242
15123,15123,Kenndal McArdle,2009-10,23.0,2,0,3,3,0,0,0,1.0,23.0,3,0,0,0,1.0,82,5.7,65,341,2477,9.4,0.1756827
15124,15124,Kenndal McArdle,2010-11,24.0,3,3,19,19,1,2,3,10.0,169.0,22,1,2,3,11.0,82,5.53,56,304,2486,9.1,0.14049682
15125,15125,Kenndal McArdle,2011-12,25.0,4,0,11,11,0,0,0,6.0,109.0,33,1,2,3,17.0,82,5.46,52,291,2492,9.0,0.14605588
15126,15126,Kenndal McArdle,2012-13,26.0,5,0,9,9,0,0,0,3.0,55.0,42,1,2,3,20.0,82,5.32,47,271,2439,8.9,0.13024127
15127,15127,Kenny Agostino,2014-15,22.0,2,2,8,8,1,1,2,12.0,89.0,8,1,1,2,12.0,82,5.34,48,269,2463,8.9,0.23261705
15128,15128,Kenny Agostino,2016-17,24.0,3,0,2,2,0,0,0,3.0,27.0,10,1,1,2,15.0,82,5.34,48,255,2438,9.0,0.16538829
15129,15129,Kenny Agostino,2017-18,25.0,4,3,7,7,1,2,3,17.0,89.0,17,2,3,5,32.0,82,5.45,47,245,2478,9.0,0.20697454
15130,15130,Kenny Agostino,2018-19,26.0,5,1,5,5,0,1,1,11.0,60.0,22,2,4,6,43.0,82,5.86,50,250,2620,9.2,0.16516551
15131,15131,Kenny Agostino,2019-20,27.0,6,24,63,63,6,18,24,79.0,814.0,85,8,22,30,122.0,82,5.96,47,239,2579,9.5,0.29975498
15132,15132,Kenny Jonsson,1995-96,21.0,2,9,39,39,2,7,9,50.0,,39,2,7,9,50.0,48,5.97,37,209,1408,10.2,0.2958358
15133,15133,Kenny Jonsson,1996-97,22.0,3,30,66,66,4,26,30,130.0,,105,6,33,39,180.0,82,6.29,74,413,2481,10.4,0.42297143
15134,15134,Kenny Jonsson,1997-98,23.0,4,21,81,81,3,18,21,92.0,,186,9,51,60,272.0,82,5.83,55,336,2444,9.8,0.26901865
15135,15135,Kenny Jonsson,1998-99,24.0,5,40,81,81,14,26,40,108.0,,267,23,77,100,380.0,82,5.28,57,380,2242,9.6,0.48011345
15136,15136,Kenny Jonsson,1999-00,25.0,6,26,63,63,8,18,26,91.0,1574.0,330,31,95,126,471.0,82,5.27,57,359,2285,9.4,0.4052291
15137,15137,Kenny Jonsson,2000-01,26.0,7,25,65,65,1,24,25,84.0,1592.0,395,32,119,151,555.0,82,5.49,53,331,2294,9.8,0.34947526
15138,15138,Kenny Jonsson,2001-02,27.0,8,29,65,65,8,21,29,91.0,1564.0,460,40,140,180,646.0,82,5.51,63,376,2272,9.9,0.39522347
15139,15139,Kenny Jonsson,2002-03,28.0,9,32,76,76,10,22,32,107.0,1943.0,536,50,162,212,753.0,82,5.24,53,338,2262,9.5,0.41269594
15140,15140,Kenny Jonsson,2003-04,29.0,10,26,71,71,8,18,26,108.0,1647.0,607,58,180,238,861.0,82,5.31,60,363,2326,9.4,0.3367271
15141,15141,Kenny Jonsson,2004-05,30.0,11,29,79,79,5,24,29,106.0,1812.0,686,63,204,267,967.0,82,5.14,57,348,2300,9.2,0.37494904
15142,15142,Kent Carlson,1984-85,23.0,2,10,65,65,3,7,10,42.0,,65,3,7,10,42.0,80,7.89,74,336,2448,12.9,0.22010365
15143,15143,Kent Carlson,1985-86,24.0,3,2,18,18,1,1,2,5.0,,83,4,8,12,47.0,80,7.77,71,321,2447,12.7,0.22641966
15144,15144,Kent Carlson,1986-87,25.0,4,5,28,28,2,3,5,14.0,,111,6,11,17,61.0,80,7.94,82,370,2484,12.8,0.23644036
15145,15145,Kent Carlson,1989-90,28.0,5,1,2,2,1,0,1,1.0,,113,7,11,18,62.0,80,7.48,85,403,2430,12.3,0.20018828
15146,15146,Kent Huskins,2007-08,28.0,2,3,33,33,0,3,3,16.0,464.0,33,0,3,3,16.0,82,5.76,70,398,2426,9.7,0.14581782
15147,15147,Kent Huskins,2008-09,29.0,3,19,76,76,4,15,19,46.0,1222.0,109,4,18,22,62.0,82,5.44,62,351,2383,9.4,0.21347156
15148,15148,Kent Huskins,2009-10,30.0,4,6,33,33,2,4,6,20.0,620.0,142,6,22,28,82.0,82,5.7,65,341,2477,9.4,0.17825511
15149,15149,Kent Huskins,2010-11,31.0,5,22,82,82,3,19,22,47.0,1434.0,224,9,41,50,129.0,82,5.53,56,304,2486,9.1,0.1992124
15150,15150,Kent Huskins,2011-12,32.0,6,10,50,50,2,8,10,38.0,831.0,274,11,49,60,167.0,82,5.46,52,291,2492,9.0,0.17626232
15151,15151,Kent Huskins,2012-13,33.0,7,7,25,25,2,5,7,16.0,387.0,299,13,54,67,183.0,82,5.32,47,271,2439,8.9,0.16135535
15152,15152,Kent Huskins,2013-14,34.0,8,1,19,19,0,1,1,4.0,298.0,318,13,55,68,187.0,48,5.31,29,160,1399,9.1,0.13727182
15153,15153,Kent Manderville,1992-93,21.0,2,4,15,15,0,4,4,14.0,,15,0,4,4,14.0,80,6.96,77,402,2440,11.4,0.29129565
15154,15154,Kent Manderville,1993-94,22.0,3,2,18,18,1,1,2,15.0,,33,1,5,6,29.0,84,7.25,87,443,2603,11.7,0.2393117
15155,15155,Kent Manderville,1994-95,23.0,4,16,67,67,7,9,16,81.0,,100,8,14,22,110.0,84,6.48,76,407,2545,10.7,0.28119388
15156,15156,Kent Manderville,1995-96,24.0,5,1,36,36,0,1,1,43.0,,136,8,15,23,153.0,48,5.97,37,209,1408,10.2,0.17467171
15157,15157,Kent Manderville,1996-97,25.0,6,8,37,37,3,5,8,63.0,,173,11,20,31,216.0,82,6.29,74,413,2481,10.4,0.22387439
15158,15158,Kent Manderville,1997-98,26.0,7,11,44,44,6,5,11,51.0,,217,17,25,42,267.0,82,5.83,55,336,2444,9.8,0.21739009
15159,15159,Kent Manderville,1998-99,27.0,8,8,77,77,4,4,8,80.0,,294,21,29,50,347.0,82,5.28,57,380,2242,9.6,0.16725716
15160,15160,Kent Manderville,1999-00,28.0,9,16,81,81,5,11,16,71.0,657.0,375,26,40,66,418.0,82,5.27,57,359,2285,9.4,0.19391438
15161,15161,Kent Manderville,2000-01,29.0,10,8,69,69,1,7,8,62.0,617.0,444,27,47,74,480.0,82,5.49,53,331,2294,9.8,0.15320191
15162,15162,Kent Manderville,2001-02,30.0,11,15,82,82,5,10,15,136.0,1035.0,526,32,57,89,616.0,82,5.51,63,376,2272,9.9,0.21084106
15163,15163,Kent Manderville,2002-03,31.0,12,8,38,38,3,5,8,43.0,352.0,564,35,62,97,659.0,82,5.24,53,338,2262,9.5,0.15516475
15164,15164,Kent Manderville,2003-04,32.0,13,7,82,82,2,5,7,72.0,909.0,646,37,67,104,731.0,82,5.31,60,363,2326,9.4,0.14581051
15165,15165,Kent McDonell,2003-04,24.0,2,0,3,3,0,0,0,4.0,26.0,3,0,0,0,4.0,82,5.31,60,363,2326,9.4,0.17216378
15166,15166,Kent McDonell,2004-05,25.0,3,3,29,29,1,2,3,23.0,299.0,32,1,2,3,27.0,82,5.14,57,348,2300,9.2,0.19158506
15167,15167,Kent Nilsson,1980-81,24.0,2,93,80,80,40,53,93,217.0,,80,40,53,93,217.0,80,7.03,61,280,2352,12.0,1.1850059
15168,15168,Kent Nilsson,1981-82,25.0,3,131,80,80,49,82,131,217.0,,160,89,135,224,434.0,80,7.69,77,340,2441,12.6,1.4655075
15169,15169,Kent Nilsson,1982-83,26.0,4,55,41,41,26,29,55,103.0,,201,115,164,279,537.0,80,8.03,73,320,2489,12.9,1.1049881
15170,15170,Kent Nilsson,1983-84,27.0,5,104,80,80,46,58,104,217.0,,281,161,222,383,754.0,80,7.73,71,310,2444,12.7,1.2419524
15171,15171,Kent Nilsson,1984-85,28.0,6,80,67,67,31,49,80,181.0,,348,192,271,463,935.0,80,7.89,74,336,2448,12.9,1.0533135
15172,15172,Kent Nilsson,1985-86,29.0,7,99,77,77,37,62,99,201.0,,425,229,333,562,1136.0,80,7.77,71,321,2447,12.7,1.1541498
15173,15173,Kent Nilsson,1986-87,30.0,8,60,61,61,16,44,60,122.0,,486,245,377,622,1258.0,80,7.94,82,370,2484,12.8,0.8388285
15174,15174,Kent Nilsson,1987-88,31.0,9,63,61,61,18,45,63,114.0,,547,263,422,685,1372.0,80,7.34,72,344,2400,12.2,0.8597837
15175,15175,Kent Nilsson,1995-96,39.0,10,1,6,6,1,0,1,2.0,,553,264,422,686,1374.0,48,5.97,37,209,1408,10.2,0.49290448
15176,15176,Kent Paynter,1988-89,23.0,2,0,2,2,0,0,0,0.0,,2,0,0,0,0.0,80,7.43,89,437,2435,12.2,0.18171716
15177,15177,Kent Paynter,1989-90,24.0,3,0,1,1,0,0,0,0.0,,3,0,0,0,0.0,80,7.48,85,403,2430,12.3,0.16910106
15178,15178,Kent Paynter,1990-91,25.0,4,3,13,13,1,2,3,15.0,,16,1,2,3,15.0,80,7.37,76,367,2421,12.2,0.2246038
15179,15179,Kent Paynter,1991-92,26.0,5,0,1,1,0,0,0,0.0,,17,1,2,3,15.0,80,6.91,71,366,2385,11.6,0.1651873
15180,15180,Kent Paynter,1992-93,27.0,6,0,5,5,0,0,0,6.0,,22,1,2,3,21.0,80,6.96,77,402,2440,11.4,0.17850837
15181,15181,Kent Paynter,1993-94,28.0,7,0,6,6,0,0,0,3.0,,28,1,2,3,24.0,84,7.25,87,443,2603,11.7,0.16690516
15182,15182,Kent Paynter,1994-95,29.0,8,1,9,9,0,1,1,8.0,,37,1,3,4,32.0,84,6.48,76,407,2545,10.7,0.1392251
15183,15183,Kerby Rychel,2015-16,21.0,2,3,5,5,0,3,3,4.0,53.0,5,0,3,3,4.0,82,5.32,47,251,2453,8.9,0.26479948
15184,15184,Kerby Rychel,2016-17,22.0,3,9,32,32,2,7,9,32.0,304.0,37,2,10,12,36.0,82,5.34,48,255,2438,9.0,0.2572614
15185,15185,Kerby Rychel,2018-19,24.0,4,2,4,4,1,1,2,7.0,44.0,41,3,11,14,43.0,82,5.86,50,250,2620,9.2,0.19270623
15186,15186,Kerby Rychel,2019-20,25.0,5,0,2,2,0,0,0,1.0,18.0,43,3,11,14,44.0,82,5.96,47,239,2579,9.5,0.15742844
15187,15187,Kerry Huffman,1987-88,20.0,2,0,9,9,0,0,0,3.0,,9,0,0,0,3.0,80,7.34,72,344,2400,12.2,0.2679317
15188,15188,Kerry Huffman,1988-89,21.0,3,23,52,52,6,17,23,84.0,,61,6,17,23,87.0,80,7.43,89,437,2435,12.2,0.45349902
15189,15189,Kerry Huffman,1989-90,22.0,4,11,29,29,0,11,11,23.0,,90,6,28,34,110.0,80,7.48,85,403,2430,12.3,0.2957
15190,15190,Kerry Huffman,1990-91,23.0,5,13,43,43,1,12,13,70.0,,133,7,40,47,180.0,80,7.37,76,367,2421,12.2,0.30012652
15191,15191,Kerry Huffman,1991-92,24.0,6,3,10,10,1,2,3,14.0,,143,8,42,50,194.0,80,6.91,71,366,2385,11.6,0.31696445
15192,15192,Kerry Huffman,1992-93,25.0,7,32,60,60,14,18,32,123.0,,203,22,60,82,317.0,80,6.96,77,402,2440,11.4,0.47346732
15193,15193,Kerry Huffman,1993-94,26.0,8,22,52,52,4,18,22,86.0,,255,26,78,104,403.0,84,7.25,87,443,2603,11.7,0.35594735
15194,15194,Kerry Huffman,1994-95,27.0,9,18,62,62,4,14,18,112.0,,317,30,92,122,515.0,84,6.48,76,407,2545,10.7,0.28403783
15195,15195,Kerry Huffman,1995-96,28.0,10,6,37,37,2,4,6,68.0,,354,32,96,128,583.0,48,5.97,37,209,1408,10.2,0.24486873
15196,15196,Kerry Huffman,1996-97,29.0,11,17,47,47,5,12,17,91.0,,401,37,108,145,674.0,82,6.29,74,413,2481,10.4,0.3046614
15197,15197,Kevan Guy,1987-88,22.0,2,4,24,24,0,4,4,24.0,,24,0,4,4,24.0,80,7.34,72,344,2400,12.2,0.23395988
15198,15198,Kevan Guy,1988-89,23.0,3,3,11,11,0,3,3,4.0,,35,0,7,7,28.0,80,7.43,89,437,2435,12.2,0.22885725
15199,15199,Kevan Guy,1989-90,24.0,4,4,45,45,2,2,4,40.0,,80,2,9,11,68.0,80,7.48,85,403,2430,12.3,0.18091658
15200,15200,Kevan Guy,1990-91,25.0,5,7,30,30,2,5,7,44.0,,110,4,14,18,112.0,80,7.37,76,367,2421,12.2,0.25428587
15201,15201,Kevan Guy,1991-92,26.0,6,7,43,43,1,6,7,43.0,,153,5,20,25,155.0,80,6.91,71,366,2385,11.6,0.18128675
15202,15202,Kevan Guy,1992-93,27.0,7,0,3,3,0,0,0,3.0,,156,5,20,25,158.0,80,6.96,77,402,2440,11.4,0.15341255
15203,15203,Kevan Miller,2014-15,27.0,2,6,47,47,1,5,6,41.0,821.0,47,1,5,6,41.0,82,5.34,48,269,2463,8.9,0.14789781
15204,15204,Kevan Miller,2015-16,28.0,3,7,41,41,2,5,7,37.0,739.0,88,3,10,13,78.0,82,5.32,47,251,2453,8.9,0.16101587
15205,15205,Kevan Miller,2016-17,29.0,4,18,71,71,5,13,18,64.0,1353.0,159,8,23,31,142.0,82,5.34,48,255,2438,9.0,0.20659333
15206,15206,Kevan Miller,2017-18,30.0,5,13,58,58,3,10,13,49.0,1032.0,217,11,33,44,191.0,82,5.45,47,245,2478,9.0,0.1937694
15207,15207,Kevan Miller,2018-19,31.0,6,16,68,68,1,15,16,64.0,1323.0,285,12,48,60,255.0,82,5.86,50,250,2620,9.2,0.17417657
15208,15208,Kevan Miller,2019-20,32.0,7,7,39,39,0,7,7,32.0,692.0,324,12,55,67,287.0,82,5.96,47,239,2579,9.5,0.124319196
15209,15209,Kevin Bieksa,2006-07,25.0,2,6,39,39,0,6,6,38.0,628.0,39,0,6,6,38.0,82,6.05,85,480,2458,10.1,0.16756776
15210,15210,Kevin Bieksa,2007-08,26.0,3,42,81,81,12,30,42,203.0,1966.0,120,12,36,48,241.0,82,5.76,70,398,2426,9.7,0.5163267
15211,15211,Kevin Bieksa,2008-09,27.0,4,12,34,34,2,10,12,64.0,795.0,154,14,46,60,305.0,82,5.44,62,351,2383,9.4,0.25355363
15212,15212,Kevin Bieksa,2009-10,28.0,5,43,72,72,11,32,43,153.0,1691.0,226,25,78,103,458.0,82,5.7,65,341,2477,9.4,0.49467522
15213,15213,Kevin Bieksa,2010-11,29.0,6,22,55,55,3,19,22,95.0,1200.0,281,28,97,125,553.0,82,5.53,56,304,2486,9.1,0.35989413
15214,15214,Kevin Bieksa,2011-12,30.0,7,22,66,66,6,16,22,105.0,1483.0,347,34,113,147,658.0,82,5.46,52,291,2492,9.0,0.34345886
15215,15215,Kevin Bieksa,2012-13,31.0,8,44,78,78,8,36,44,166.0,1844.0,425,42,149,191,824.0,82,5.32,47,271,2439,8.9,0.4676417
15216,15216,Kevin Bieksa,2013-14,32.0,9,12,36,36,6,6,12,77.0,790.0,461,48,155,203,901.0,48,5.31,29,160,1399,9.1,0.36709517
15217,15217,Kevin Bieksa,2014-15,33.0,10,24,76,76,4,20,24,167.0,1731.0,537,52,175,227,1068.0,82,5.34,48,269,2463,8.9,0.2991102
15218,15218,Kevin Bieksa,2015-16,34.0,11,14,60,60,4,10,14,99.0,1250.0,597,56,185,241,1167.0,82,5.32,47,251,2453,8.9,0.21884182
15219,15219,Kevin Bieksa,2016-17,35.0,12,15,71,71,4,11,15,109.0,1492.0,668,60,196,256,1276.0,82,5.34,48,255,2438,9.0,0.22103012
15220,15220,Kevin Bieksa,2017-18,36.0,13,14,81,81,3,11,14,94.0,1519.0,749,63,207,270,1370.0,82,5.45,47,245,2478,9.0,0.19093907
15221,15221,Kevin Bieksa,2018-19,37.0,14,8,59,59,0,8,8,66.0,1063.0,808,63,215,278,1436.0,82,5.86,50,250,2620,9.2,0.15678203
15222,15222,Kevin Brown,1995-96,21.0,2,5,23,23,2,3,5,25.0,,23,2,3,5,25.0,48,5.97,37,209,1408,10.2,0.3546945
15223,15223,Kevin Brown,1996-97,22.0,3,1,7,7,1,0,1,9.0,,30,3,3,6,34.0,82,6.29,74,413,2481,10.4,0.24031636
15224,15224,Kevin Brown,1997-98,23.0,4,4,11,11,0,4,4,12.0,,41,3,7,10,46.0,82,5.83,55,336,2444,9.8,0.2086123
15225,15225,Kevin Brown,1998-99,24.0,5,0,4,4,0,0,0,0.0,,45,3,7,10,46.0,82,5.28,57,380,2242,9.6,0.15482903
15226,15226,Kevin Brown,1999-00,25.0,6,6,12,12,4,2,6,13.0,110.0,57,7,9,16,59.0,82,5.27,57,359,2285,9.4,0.25605842
15227,15227,Kevin Brown,2000-01,26.0,7,0,7,7,0,0,0,5.0,58.0,64,7,9,16,64.0,82,5.49,53,331,2294,9.8,0.15237668
15228,15228,Kevin Colley,2006-07,28.0,2,0,16,16,0,0,0,4.0,76.0,16,0,0,0,4.0,82,6.05,85,480,2458,10.1,0.13167483
15229,15229,Kevin Connauton,2014-15,24.0,2,8,36,36,1,7,8,56.0,552.0,36,1,7,8,56.0,82,5.34,48,269,2463,8.9,0.20541719
15230,15230,Kevin Connauton,2015-16,25.0,3,21,62,62,9,12,21,96.0,1005.0,98,10,19,29,152.0,82,5.32,47,251,2453,8.9,0.307001
15231,15231,Kevin Connauton,2016-17,26.0,4,17,65,65,5,12,17,109.0,1088.0,163,15,31,46,261.0,82,5.34,48,255,2438,9.0,0.24033076
15232,15232,Kevin Connauton,2017-18,27.0,5,1,24,24,0,1,1,21.0,315.0,187,15,32,47,282.0,82,5.45,47,245,2478,9.0,0.16089648
15233,15233,Kevin Connauton,2018-19,28.0,6,21,73,73,11,10,21,102.0,1108.0,260,26,42,68,384.0,82,5.86,50,250,2620,9.2,0.27143264
15234,15234,Kevin Connauton,2019-20,29.0,7,8,50,50,1,7,8,76.0,918.0,310,27,49,76,460.0,82,5.96,47,239,2579,9.5,0.17503807
15235,15235,Kevin Connauton,2020-21,30.0,8,0,4,4,0,0,0,4.0,62.0,314,27,49,76,464.0,70,5.96,42,208,2192,9.5,0.19585648
15236,15236,Kevin Czuczman,2014-15,24.0,2,2,13,13,0,2,2,24.0,254.0,13,0,2,2,24.0,82,5.34,48,269,2463,8.9,0.23188797
15237,15237,Kevin Dahl,1993-94,25.0,2,11,61,61,2,9,11,40.0,,61,2,9,11,40.0,84,7.25,87,443,2603,11.7,0.1958738
15238,15238,Kevin Dahl,1994-95,26.0,3,3,33,33,0,3,3,20.0,,94,2,12,14,60.0,84,6.48,76,407,2545,10.7,0.15053621
15239,15239,Kevin Dahl,1995-96,27.0,4,12,34,34,4,8,12,30.0,,128,6,20,26,90.0,48,5.97,37,209,1408,10.2,0.24610874
15240,15240,Kevin Dahl,1996-97,28.0,5,2,32,32,1,1,2,17.0,,160,7,21,28,107.0,82,6.29,74,413,2481,10.4,0.12132928
15241,15241,Kevin Dahl,1997-98,29.0,6,0,2,2,0,0,0,2.0,,162,7,21,28,109.0,82,5.83,55,336,2444,9.8,0.12444207
15242,15242,Kevin Dahl,1998-99,30.0,7,1,19,19,0,1,1,17.0,,181,7,22,29,126.0,82,5.28,57,380,2242,9.6,0.106321126
15243,15243,Kevin Dahl,1999-00,31.0,8,0,3,3,0,0,0,0.0,46.0,184,7,22,29,126.0,82,5.27,57,359,2285,9.4,0.13329214
15244,15244,Kevin Dahl,2001-02,33.0,9,0,4,4,0,0,0,3.0,42.0,188,7,22,29,129.0,82,5.51,63,376,2272,9.9,0.12183818
15245,15245,Kevin Dallman,2006-07,25.0,2,14,67,67,4,10,14,131.0,1273.0,67,4,10,14,131.0,82,6.05,85,480,2458,10.1,0.24643394
15246,15246,Kevin Dallman,2007-08,26.0,3,10,53,53,1,9,10,76.0,678.0,120,5,19,24,207.0,82,5.76,70,398,2426,9.7,0.22009915
15247,15247,Kevin Dallman,2008-09,27.0,4,7,34,34,3,4,7,41.0,438.0,154,8,23,31,248.0,82,5.44,62,351,2383,9.4,0.20244381
15248,15248,Kevin Dean,1995-96,26.0,2,1,17,17,0,1,1,11.0,,17,0,1,1,11.0,48,5.97,37,209,1408,10.2,0.19014353
15249,15249,Kevin Dean,1996-97,27.0,3,6,41,41,0,6,6,29.0,,58,0,7,7,40.0,82,6.29,74,413,2481,10.4,0.12792751
15250,15250,Kevin Dean,1997-98,28.0,4,6,28,28,2,4,6,21.0,,86,2,11,13,61.0,82,5.83,55,336,2444,9.8,0.17860043
15251,15251,Kevin Dean,1998-99,29.0,5,9,50,50,1,8,9,28.0,,136,3,19,22,89.0,82,5.28,57,380,2242,9.6,0.10530084
15252,15252,Kevin Dean,1999-00,30.0,6,11,62,62,1,10,11,51.0,973.0,198,4,29,33,140.0,82,5.27,57,359,2285,9.4,0.14328873
15253,15253,Kevin Dean,2000-01,31.0,7,11,64,64,3,8,11,47.0,1049.0,262,7,37,44,187.0,82,5.49,53,331,2294,9.8,0.150729
15254,15254,Kevin Dean,2001-02,32.0,8,11,69,69,0,11,11,75.0,1342.0,331,7,48,55,262.0,82,5.51,63,376,2272,9.9,0.15729111
15255,15255,Kevin Devine,1983-84,29.0,2,1,2,2,0,1,1,3.0,,2,0,1,1,3.0,80,7.73,71,310,2444,12.7,0.21307656
15256,15256,Kevin Dineen,1985-86,22.0,2,41,57,57,25,16,41,141.0,,57,25,16,41,141.0,80,7.77,71,321,2447,12.7,0.95652246
15257,15257,Kevin Dineen,1986-87,23.0,3,68,57,57,33,35,68,167.0,,114,58,51,109,308.0,80,7.94,82,370,2484,12.8,0.9944381
15258,15258,Kevin Dineen,1987-88,24.0,4,79,78,78,40,39,79,234.0,,192,98,90,188,542.0,80,7.34,72,344,2400,12.2,0.97841
15259,15259,Kevin Dineen,1988-89,25.0,5,50,74,74,25,25,50,223.0,,266,123,115,238,765.0,80,7.43,89,437,2435,12.2,0.7750491
15260,15260,Kevin Dineen,1989-90,26.0,6,89,79,79,45,44,89,294.0,,345,168,159,327,1059.0,80,7.48,85,403,2430,12.3,1.0697932
15261,15261,Kevin Dineen,1990-91,27.0,7,66,67,67,25,41,66,214.0,,412,193,200,393,1273.0,80,7.37,76,367,2421,12.2,0.8457986
15262,15262,Kevin Dineen,1991-92,28.0,8,47,61,61,17,30,47,161.0,,473,210,230,440,1434.0,80,6.91,71,366,2385,11.6,0.733178
15263,15263,Kevin Dineen,1992-93,29.0,9,62,80,80,30,32,62,225.0,,553,240,262,502,1659.0,80,6.96,77,402,2440,11.4,0.8339535
15264,15264,Kevin Dineen,1993-94,30.0,10,63,83,83,35,28,63,241.0,,636,275,290,565,1900.0,84,7.25,87,443,2603,11.7,0.71675915
15265,15265,Kevin Dineen,1994-95,31.0,11,42,71,71,19,23,42,156.0,,707,294,313,607,2056.0,84,6.48,76,407,2545,10.7,0.51162523
15266,15266,Kevin Dineen,1995-96,32.0,12,13,40,40,8,5,13,55.0,,747,302,318,620,2111.0,48,5.97,37,209,1408,10.2,0.4642102
15267,15267,Kevin Dineen,1996-97,33.0,13,11,46,46,2,9,11,66.0,,793,304,327,631,2177.0,82,6.29,74,413,2481,10.4,0.3860426
15268,15268,Kevin Dineen,1997-98,34.0,14,48,78,78,19,29,48,185.0,,871,323,356,679,2362.0,82,5.83,55,336,2444,9.8,0.56799614
15269,15269,Kevin Dineen,1998-99,35.0,15,23,54,54,7,16,23,96.0,,925,330,372,702,2458.0,82,5.28,57,380,2242,9.6,0.4077942
15270,15270,Kevin Dineen,1999-00,36.0,16,18,67,67,8,10,18,86.0,668.0,992,338,382,720,2544.0,82,5.27,57,359,2285,9.4,0.2984128
15271,15271,Kevin Dineen,2000-01,37.0,17,12,67,67,4,8,12,71.0,638.0,1059,342,390,732,2615.0,82,5.49,53,331,2294,9.8,0.24540973
15272,15272,Kevin Dineen,2001-02,38.0,18,15,66,66,8,7,15,74.0,701.0,1125,350,397,747,2689.0,82,5.51,63,376,2272,9.9,0.2592711
15273,15273,Kevin Dineen,2002-03,39.0,19,13,59,59,5,8,13,73.0,597.0,1184,355,405,760,2762.0,82,5.24,53,338,2262,9.5,0.25589687
15274,15274,Kevin Dineen,2003-04,40.0,20,0,4,4,0,0,0,7.0,43.0,1188,355,405,760,2769.0,82,5.31,60,363,2326,9.4,0.31186187
15275,15275,Kevin Doell,2008-09,29.0,2,1,8,8,0,1,1,6.0,77.0,8,0,1,1,6.0,82,5.44,62,351,2383,9.4,0.18831
15276,15276,Kevin Evans,1991-92,26.0,2,0,4,4,0,0,0,2.0,,4,0,0,0,2.0,80,6.91,71,366,2385,11.6,0.19778803
15277,15277,Kevin Evans,1992-93,27.0,3,1,5,5,0,1,1,4.0,,9,0,1,1,6.0,80,6.96,77,402,2440,11.4,0.19482386
15278,15278,Kevin Fiala,2015-16,19.0,2,0,1,1,0,0,0,3.0,11.0,1,0,0,0,3.0,82,5.32,47,251,2453,8.9,0.24448085
15279,15279,Kevin Fiala,2016-17,20.0,3,1,5,5,1,0,1,11.0,66.0,6,1,0,1,14.0,82,5.34,48,255,2438,9.0,0.28725183
15280,15280,Kevin Fiala,2017-18,21.0,4,16,54,54,11,5,16,114.0,730.0,60,12,5,17,128.0,82,5.45,47,245,2478,9.0,0.39368254
15281,15281,Kevin Fiala,2018-19,22.0,5,48,80,80,23,25,48,187.0,1212.0,140,35,30,65,315.0,82,5.86,50,250,2620,9.2,0.6421933
15282,15282,Kevin Fiala,2019-20,23.0,6,39,83,83,13,26,39,174.0,1298.0,223,48,56,104,489.0,82,5.96,47,239,2579,9.5,0.54598296
15283,15283,Kevin Fiala,2020-21,24.0,7,54,64,64,23,31,54,175.0,986.0,287,71,87,158,664.0,70,5.96,42,208,2192,9.5,0.7715423
15284,15284,Kevin Gravel,2016-17,24.0,2,0,5,5,0,0,0,2.0,58.0,5,0,0,0,2.0,82,5.34,48,255,2438,9.0,0.16909173
15285,15285,Kevin Gravel,2017-18,25.0,3,7,49,49,1,6,7,52.0,693.0,54,1,6,7,54.0,82,5.45,47,245,2478,9.0,0.17223468
15286,15286,Kevin Gravel,2018-19,26.0,4,3,16,16,0,3,3,20.0,225.0,70,1,9,10,74.0,82,5.86,50,250,2620,9.2,0.19249779
15287,15287,Kevin Gravel,2019-20,27.0,5,3,36,36,0,3,3,44.0,530.0,106,1,12,13,118.0,82,5.96,47,239,2579,9.5,0.14789847
15288,15288,Kevin Gravel,2020-21,28.0,6,0,3,3,0,0,0,2.0,33.0,109,1,12,13,120.0,70,5.96,42,208,2192,9.5,0.1447548
15289,15289,Kevin Haller,1990-91,20.0,2,0,2,2,0,0,0,1.0,,2,0,0,0,1.0,80,7.37,76,367,2421,12.2,0.28816393
15290,15290,Kevin Haller,1991-92,21.0,3,9,21,21,1,8,9,42.0,,23,1,8,9,43.0,80,6.91,71,366,2385,11.6,0.35249543
15291,15291,Kevin Haller,1992-93,22.0,4,25,66,66,8,17,25,85.0,,89,9,25,34,128.0,80,6.96,77,402,2440,11.4,0.38584024
15292,15292,Kevin Haller,1993-94,23.0,5,25,73,73,11,14,25,126.0,,162,20,39,59,254.0,84,7.25,87,443,2603,11.7,0.37336642
15293,15293,Kevin Haller,1994-95,24.0,6,13,68,68,4,9,13,72.0,,230,24,48,72,326.0,84,6.48,76,407,2545,10.7,0.239003
15294,15294,Kevin Haller,1995-96,25.0,7,10,36,36,2,8,10,26.0,,266,26,56,82,352.0,48,5.97,37,209,1408,10.2,0.26605898
15295,15295,Kevin Haller,1996-97,26.0,8,14,69,69,5,9,14,89.0,,335,31,65,96,441.0,82,6.29,74,413,2481,10.4,0.21968916
15296,15296,Kevin Haller,1997-98,27.0,9,13,62,62,2,11,13,77.0,,397,33,76,109,518.0,82,5.83,55,336,2444,9.8,0.2101712
15297,15297,Kevin Haller,1998-99,28.0,10,8,65,65,3,5,8,67.0,,462,36,81,117,585.0,82,5.28,57,380,2242,9.6,0.19013238
15298,15298,Kevin Haller,1999-00,29.0,11,7,82,82,1,6,7,64.0,1693.0,544,37,87,124,649.0,82,5.27,57,359,2285,9.4,0.14866385
15299,15299,Kevin Haller,2000-01,30.0,12,8,67,67,3,5,8,50.0,1217.0,611,40,92,132,699.0,82,5.49,53,331,2294,9.8,0.14354444
15300,15300,Kevin Haller,2001-02,31.0,13,6,30,30,1,5,6,19.0,574.0,641,41,97,138,718.0,82,5.51,63,376,2272,9.9,0.14848858
15301,15301,Kevin Haller,2002-03,32.0,14,0,1,1,0,0,0,2.0,17.0,642,41,97,138,720.0,82,5.24,53,338,2262,9.5,0.16893989
15302,15302,Kevin Hatcher,1985-86,19.0,2,1,2,2,1,0,1,3.0,,2,1,0,1,3.0,80,7.77,71,321,2447,12.7,0.30613458
15303,15303,Kevin Hatcher,1986-87,20.0,3,19,79,79,9,10,19,132.0,,81,10,10,20,135.0,80,7.94,82,370,2484,12.8,0.382939
15304,15304,Kevin Hatcher,1987-88,21.0,4,24,78,78,8,16,24,100.0,,159,18,26,44,235.0,80,7.34,72,344,2400,12.2,0.38559416
15305,15305,Kevin Hatcher,1988-89,22.0,5,41,71,71,14,27,41,181.0,,230,32,53,85,416.0,80,7.43,89,437,2435,12.2,0.6165058
15306,15306,Kevin Hatcher,1989-90,23.0,6,40,62,62,13,27,40,148.0,,292,45,80,125,564.0,80,7.48,85,403,2430,12.3,0.61492944
15307,15307,Kevin Hatcher,1990-91,24.0,7,54,80,80,13,41,54,240.0,,372,58,121,179,804.0,80,7.37,76,367,2421,12.2,0.7122266
15308,15308,Kevin Hatcher,1991-92,25.0,8,74,79,79,24,50,74,267.0,,451,82,171,253,1071.0,80,6.91,71,366,2385,11.6,0.8390681
15309,15309,Kevin Hatcher,1992-93,26.0,9,54,79,79,17,37,54,246.0,,530,99,208,307,1317.0,80,6.96,77,402,2440,11.4,0.8045192
15310,15310,Kevin Hatcher,1993-94,27.0,10,79,83,83,34,45,79,329.0,,613,133,253,386,1646.0,84,7.25,87,443,2603,11.7,0.7730231
15311,15311,Kevin Hatcher,1994-95,28.0,11,40,72,72,16,24,40,217.0,,685,149,277,426,1863.0,84,6.48,76,407,2545,10.7,0.5781369
15312,15312,Kevin Hatcher,1995-96,29.0,12,29,47,47,10,19,29,138.0,,732,159,296,455,2001.0,48,5.97,37,209,1408,10.2,0.6194217
15313,15313,Kevin Hatcher,1996-97,30.0,13,41,74,74,15,26,41,237.0,,806,174,322,496,2238.0,82,6.29,74,413,2481,10.4,0.5752806
15314,15314,Kevin Hatcher,1997-98,31.0,14,54,80,80,15,39,54,199.0,,886,189,361,550,2437.0,82,5.83,55,336,2444,9.8,0.61211914
15315,15315,Kevin Hatcher,1998-99,32.0,15,48,74,74,19,29,48,169.0,,960,208,390,598,2606.0,82,5.28,57,380,2242,9.6,0.527844
15316,15316,Kevin Hatcher,1999-00,33.0,16,38,66,66,11,27,38,131.0,1626.0,1026,219,417,636,2737.0,82,5.27,57,359,2285,9.4,0.46357706
15317,15317,Kevin Hatcher,2000-01,34.0,17,23,74,74,4,19,23,112.0,1568.0,1100,223,436,659,2849.0,82,5.49,53,331,2294,9.8,0.28549084
15318,15318,Kevin Hatcher,2001-02,35.0,18,18,57,57,4,14,18,98.0,1333.0,1157,227,450,677,2947.0,82,5.51,63,376,2272,9.9,0.3059522
15319,15319,Kevin Hayes,2015-16,23.0,2,45,79,79,17,28,45,111.0,1030.0,79,17,28,45,111.0,82,5.32,47,251,2453,8.9,0.53181267
15320,15320,Kevin Hayes,2016-17,24.0,3,36,79,79,14,22,36,133.0,1079.0,158,31,50,81,244.0,82,5.34,48,255,2438,9.0,0.4573967
15321,15321,Kevin Hayes,2017-18,25.0,4,49,76,76,17,32,49,143.0,1258.0,234,48,82,130,387.0,82,5.45,47,245,2478,9.0,0.61145896
15322,15322,Kevin Hayes,2018-19,26.0,5,44,76,76,25,19,44,172.0,1319.0,310,73,101,174,559.0,82,5.86,50,250,2620,9.2,0.638979
15323,15323,Kevin Hayes,2019-20,27.0,6,55,71,71,19,36,55,156.0,1298.0,381,92,137,229,715.0,82,5.96,47,239,2579,9.5,0.6780698
15324,15324,Kevin Hayes,2020-21,28.0,7,41,69,69,23,18,41,175.0,1223.0,450,115,155,270,890.0,70,5.96,42,208,2192,9.5,0.6096745
15325,15325,Kevin Henderson,2013-14,27.0,2,1,4,4,1,0,1,3.0,59.0,4,1,0,1,3.0,48,5.31,29,160,1399,9.1,0.20570469
15326,15326,Kevin Kaminski,1989-90,20.0,2,0,1,1,0,0,0,0.0,,1,0,0,0,0.0,80,7.48,85,403,2430,12.3,0.2499237
15327,15327,Kevin Kaminski,1990-91,21.0,3,0,1,1,0,0,0,0.0,,2,0,0,0,0.0,80,7.37,76,367,2421,12.2,0.20737287
15328,15328,Kevin Kaminski,1992-93,23.0,4,0,5,5,0,0,0,6.0,,7,0,0,0,6.0,80,6.96,77,402,2440,11.4,0.20248064
15329,15329,Kevin Kaminski,1994-95,25.0,5,5,13,13,0,5,5,9.0,,20,0,5,5,15.0,84,6.48,76,407,2545,10.7,0.1813558
15330,15330,Kevin Kaminski,1995-96,26.0,6,2,27,27,1,1,2,12.0,,47,1,6,7,27.0,48,5.97,37,209,1408,10.2,0.12710258
15331,15331,Kevin Kaminski,1996-97,27.0,7,3,54,54,1,2,3,17.0,,101,2,8,10,44.0,82,6.29,74,413,2481,10.4,0.092362404
15332,15332,Kevin Kaminski,1997-98,28.0,8,3,38,38,1,2,3,12.0,,139,3,10,13,56.0,82,5.83,55,336,2444,9.8,0.07468021
15333,15333,Kevin Kemp,1981-82,27.0,2,0,3,3,0,0,0,5.0,,3,0,0,0,5.0,80,7.69,77,340,2441,12.6,0.23748085
15334,15334,Kevin Klein,2006-07,22.0,2,0,2,2,0,0,0,0.0,27.0,2,0,0,0,0.0,82,6.05,85,480,2458,10.1,0.15910202
15335,15335,Kevin Klein,2007-08,23.0,3,1,3,3,1,0,1,2.0,50.0,5,1,0,1,2.0,82,5.76,70,398,2426,9.7,0.21034181
15336,15336,Kevin Klein,2008-09,24.0,4,2,13,13,0,2,2,14.0,187.0,18,1,2,3,16.0,82,5.44,62,351,2383,9.4,0.18392944
15337,15337,Kevin Klein,2009-10,25.0,5,12,63,63,4,8,12,41.0,798.0,81,5,10,15,57.0,82,5.7,65,341,2477,9.4,0.1678622
15338,15338,Kevin Klein,2010-11,26.0,6,11,81,81,1,10,11,67.0,1614.0,162,6,20,26,124.0,82,5.53,56,304,2486,9.1,0.1528486
15339,15339,Kevin Klein,2011-12,27.0,7,18,81,81,2,16,18,99.0,1684.0,243,8,36,44,223.0,82,5.46,52,291,2492,9.0,0.22241509
15340,15340,Kevin Klein,2012-13,28.0,8,21,66,66,4,17,21,91.0,1316.0,309,12,53,65,314.0,82,5.32,47,271,2439,8.9,0.23015022
15341,15341,Kevin Klein,2013-14,29.0,9,14,47,47,3,11,14,54.0,960.0,356,15,64,79,368.0,48,5.31,29,160,1399,9.1,0.24831653
15342,15342,Kevin Klein,2014-15,30.0,10,9,77,77,2,7,9,73.0,1335.0,433,17,71,88,441.0,82,5.34,48,269,2463,8.9,0.16510981
15343,15343,Kevin Klein,2015-16,31.0,11,26,65,65,9,17,26,76.0,1202.0,498,26,88,114,517.0,82,5.32,47,251,2453,8.9,0.27949578
15344,15344,Kevin Klein,2016-17,32.0,12,26,69,69,9,17,26,69.0,1407.0,567,35,105,140,586.0,82,5.34,48,255,2438,9.0,0.26554376
15345,15345,Kevin Klein,2017-18,33.0,13,14,60,60,3,11,14,54.0,1058.0,627,38,116,154,640.0,82,5.45,47,245,2478,9.0,0.17001063
15346,15346,Kevin LaVallee,1981-82,20.0,2,35,77,77,15,20,35,131.0,,77,15,20,35,131.0,80,7.69,77,340,2441,12.6,0.61328334
15347,15347,Kevin LaVallee,1982-83,21.0,3,61,75,75,32,29,61,169.0,,152,47,49,96,300.0,80,8.03,73,320,2489,12.9,0.76026815
15348,15348,Kevin LaVallee,1983-84,22.0,4,35,60,60,19,16,35,138.0,,212,66,65,131,438.0,80,7.73,71,310,2444,12.7,0.61209565
15349,15349,Kevin LaVallee,1984-85,23.0,5,6,19,19,3,3,6,41.0,,231,69,68,137,479.0,80,7.89,74,336,2448,12.9,0.5370077
15350,15350,Kevin LaVallee,1985-86,24.0,6,32,38,38,15,17,32,67.0,,269,84,85,169,546.0,80,7.77,71,321,2447,12.7,0.69370705
15351,15351,Kevin LaVallee,1986-87,25.0,7,38,64,64,18,20,38,129.0,,333,102,105,207,675.0,80,7.94,82,370,2484,12.8,0.6251422
15352,15352,Kevin LaVallee,1987-88,26.0,8,28,33,33,8,20,28,80.0,,366,110,125,235,755.0,80,7.34,72,344,2400,12.2,0.72091776
15353,15353,Kevin Labanc,2017-18,22.0,2,20,55,55,8,12,20,70.0,752.0,55,8,12,20,70.0,82,5.45,47,245,2478,9.0,0.36771864
15354,15354,Kevin Labanc,2018-19,23.0,3,40,77,77,11,29,40,156.0,1105.0,132,19,41,60,226.0,82,5.86,50,250,2620,9.2,0.49354488
15355,15355,Kevin Labanc,2019-20,24.0,4,56,82,82,17,39,56,130.0,1150.0,214,36,80,116,356.0,82,5.96,47,239,2579,9.5,0.6649176
15356,15356,Kevin Labanc,2020-21,25.0,5,33,70,70,14,19,33,176.0,1125.0,284,50,99,149,532.0,70,5.96,42,208,2192,9.5,0.5920069
15357,15357,Kevin Lowe,1980-81,21.0,2,21,64,64,2,19,21,86.0,,64,2,19,21,86.0,80,7.03,61,280,2352,12.0,0.39168707
15358,15358,Kevin Lowe,1981-82,22.0,3,34,79,79,10,24,34,115.0,,143,12,43,55,201.0,80,7.69,77,340,2441,12.6,0.4673693
15359,15359,Kevin Lowe,1982-83,23.0,4,40,80,80,9,31,40,110.0,,223,21,74,95,311.0,80,8.03,73,320,2489,12.9,0.47413772
15360,15360,Kevin Lowe,1983-84,24.0,5,40,80,80,6,34,40,92.0,,303,27,108,135,403.0,80,7.73,71,310,2444,12.7,0.50553447
15361,15361,Kevin Lowe,1984-85,25.0,6,46,80,80,4,42,46,82.0,,383,31,150,181,485.0,80,7.89,74,336,2448,12.9,0.4800877
15362,15362,Kevin Lowe,1985-86,26.0,7,25,80,80,4,21,25,82.0,,463,35,171,206,567.0,80,7.77,71,321,2447,12.7,0.33299536
15363,15363,Kevin Lowe,1986-87,27.0,8,18,74,74,2,16,18,57.0,,537,37,187,224,624.0,80,7.94,82,370,2484,12.8,0.28260005
15364,15364,Kevin Lowe,1987-88,28.0,9,37,77,77,8,29,37,97.0,,614,45,216,261,721.0,80,7.34,72,344,2400,12.2,0.4398708
15365,15365,Kevin Lowe,1988-89,29.0,10,24,70,70,9,15,24,82.0,,684,54,231,285,803.0,80,7.43,89,437,2435,12.2,0.32534662
15366,15366,Kevin Lowe,1989-90,30.0,11,25,76,76,7,18,25,85.0,,760,61,249,310,888.0,80,7.48,85,403,2430,12.3,0.3060077
15367,15367,Kevin Lowe,1990-91,31.0,12,33,78,78,7,26,33,74.0,,838,68,275,343,962.0,80,7.37,76,367,2421,12.2,0.32189867
15368,15368,Kevin Lowe,1991-92,32.0,13,16,73,73,3,13,16,51.0,,911,71,288,359,1013.0,80,6.91,71,366,2385,11.6,0.23937806
15369,15369,Kevin Lowe,1992-93,33.0,14,10,55,55,2,8,10,33.0,,966,73,296,369,1046.0,80,6.96,77,402,2440,11.4,0.2672755
15370,15370,Kevin Lowe,1993-94,34.0,15,15,49,49,3,12,15,52.0,,1015,76,308,384,1098.0,84,7.25,87,443,2603,11.7,0.21696511
15371,15371,Kevin Lowe,1994-95,35.0,16,19,71,71,5,14,19,50.0,,1086,81,322,403,1148.0,84,6.48,76,407,2545,10.7,0.19837555
15372,15372,Kevin Lowe,1995-96,36.0,17,8,44,44,1,7,8,35.0,,1130,82,329,411,1183.0,48,5.97,37,209,1408,10.2,0.1856502
15373,15373,Kevin Lowe,1996-97,37.0,18,6,53,53,1,5,6,30.0,,1183,83,334,417,1213.0,82,6.29,74,413,2481,10.4,0.1326245
15374,15374,Kevin Lowe,1997-98,38.0,19,14,64,64,1,13,14,46.0,,1247,84,347,431,1259.0,82,5.83,55,336,2444,9.8,0.14178914
15375,15375,Kevin Lowe,1998-99,39.0,20,0,7,7,0,0,0,5.0,,1254,84,347,431,1264.0,82,5.28,57,380,2242,9.6,0.17535654
15376,15376,Kevin MacDonald,1994-95,28.0,2,0,1,1,0,0,0,0.0,,1,0,0,0,0.0,84,6.48,76,407,2545,10.7,0.14672285
15377,15377,Kevin Maguire,1987-88,25.0,2,0,17,17,0,0,0,2.0,,17,0,0,0,2.0,80,7.34,72,344,2400,12.2,0.19708669
15378,15378,Kevin Maguire,1988-89,26.0,3,10,46,46,4,6,10,25.0,,63,4,6,10,27.0,80,7.43,89,437,2435,12.2,0.21874109
15379,15379,Kevin Maguire,1989-90,27.0,4,18,60,60,8,10,18,35.0,,123,12,16,28,62.0,80,7.48,85,403,2430,12.3,0.26575148
15380,15380,Kevin Maguire,1990-91,28.0,5,16,66,66,7,9,16,69.0,,189,19,25,44,131.0,80,7.37,76,367,2421,12.2,0.23613879
15381,15381,Kevin Maguire,1991-92,29.0,6,14,63,63,9,5,14,52.0,,252,28,30,58,183.0,80,6.91,71,366,2385,11.6,0.22439536
15382,15382,Kevin Maguire,1992-93,30.0,7,1,8,8,1,0,1,8.0,,260,29,30,59,191.0,80,6.96,77,402,2440,11.4,0.2121464
15383,15383,Kevin Marshall,2012-13,23.0,2,0,10,10,0,0,0,6.0,88.0,10,0,0,0,6.0,82,5.32,47,271,2439,8.9,0.16678938
15384,15384,Kevin Maxwell,1981-82,21.0,2,3,6,6,0,3,3,9.0,,6,0,3,3,9.0,80,7.69,77,340,2441,12.6,0.31187278
15385,15385,Kevin Maxwell,1982-83,22.0,3,15,46,46,6,9,15,72.0,,52,6,12,18,81.0,80,8.03,73,320,2489,12.9,0.3787245
15386,15386,Kevin Maxwell,1984-85,24.0,4,3,14,14,0,3,3,8.0,,66,6,15,21,89.0,80,7.89,74,336,2448,12.9,0.25403273
15387,15387,Kevin McClelland,1982-83,20.0,2,5,10,10,1,4,5,18.0,,10,1,4,5,18.0,80,8.03,73,320,2489,12.9,0.34615684
15388,15388,Kevin McClelland,1983-84,21.0,3,9,38,38,5,4,9,70.0,,48,6,8,14,88.0,80,7.73,71,310,2444,12.7,0.31845015
15389,15389,Kevin McClelland,1984-85,22.0,4,34,76,76,10,24,34,103.0,,124,16,32,48,191.0,80,7.89,74,336,2448,12.9,0.43571383
15390,15390,Kevin McClelland,1985-86,23.0,5,23,62,62,8,15,23,99.0,,186,24,47,71,290.0,80,7.77,71,321,2447,12.7,0.4151602
15391,15391,Kevin McClelland,1986-87,24.0,6,36,79,79,11,25,36,104.0,,265,35,72,107,394.0,80,7.94,82,370,2484,12.8,0.4044267
15392,15392,Kevin McClelland,1987-88,25.0,7,25,72,72,12,13,25,76.0,,337,47,85,132,470.0,80,7.34,72,344,2400,12.2,0.373773
15393,15393,Kevin McClelland,1988-89,26.0,8,16,74,74,10,6,16,61.0,,411,57,91,148,531.0,80,7.43,89,437,2435,12.2,0.25708187
15394,15394,Kevin McClelland,1989-90,27.0,9,20,79,79,6,14,20,43.0,,490,63,105,168,574.0,80,7.48,85,403,2430,12.3,0.26226556
15395,15395,Kevin McClelland,1990-91,28.0,10,11,71,71,5,6,11,31.0,,561,68,111,179,605.0,80,7.37,76,367,2421,12.2,0.23802006
15396,15396,Kevin McClelland,1991-92,29.0,11,0,3,3,0,0,0,1.0,,564,68,111,179,606.0,80,6.91,71,366,2385,11.6,0.22311494
15397,15397,Kevin McClelland,1992-93,30.0,12,1,18,18,0,1,1,5.0,,582,68,112,180,611.0,80,6.96,77,402,2440,11.4,0.1886403
15398,15398,Kevin McClelland,1994-95,32.0,13,0,6,6,0,0,0,1.0,,588,68,112,180,612.0,84,6.48,76,407,2545,10.7,0.16535321
15399,15399,Kevin Miehm,1993-94,24.0,2,4,8,8,1,3,4,5.0,,8,1,3,4,5.0,84,7.25,87,443,2603,11.7,0.24762487
15400,15400,Kevin Miehm,1994-95,25.0,3,1,14,14,0,1,1,5.0,,22,1,4,5,10.0,84,6.48,76,407,2545,10.7,0.16356659
15401,15401,Kevin Miller,1989-90,24.0,2,8,24,24,3,5,8,40.0,,24,3,5,8,40.0,80,7.48,85,403,2430,12.3,0.34165913
15402,15402,Kevin Miller,1990-91,25.0,3,5,16,16,0,5,5,9.0,,40,3,10,13,49.0,80,7.37,76,367,2421,12.2,0.2194772
15403,15403,Kevin Miller,1991-92,26.0,4,51,74,74,22,29,51,136.0,,114,25,39,64,185.0,80,6.91,71,366,2385,11.6,0.6236932
15404,15404,Kevin Miller,1992-93,27.0,5,46,80,80,20,26,46,130.0,,194,45,65,110,315.0,80,6.96,77,402,2440,11.4,0.5144651
15405,15405,Kevin Miller,1993-94,28.0,6,49,82,82,24,25,49,163.0,,276,69,90,159,478.0,84,7.25,87,443,2603,11.7,0.5479563
15406,15406,Kevin Miller,1994-95,29.0,7,48,75,75,23,25,48,154.0,,351,92,115,207,632.0,84,6.48,76,407,2545,10.7,0.5391288
15407,15407,Kevin Miller,1995-96,30.0,8,20,36,36,8,12,20,60.0,,387,100,127,227,692.0,48,5.97,37,209,1408,10.2,0.54110914
15408,15408,Kevin Miller,1996-97,31.0,9,53,81,81,28,25,53,179.0,,468,128,152,280,871.0,82,6.29,74,413,2481,10.4,0.57544017
15409,15409,Kevin Miller,1997-98,32.0,10,31,69,69,14,17,31,139.0,,537,142,169,311,1010.0,82,5.83,55,336,2444,9.8,0.3840813
15410,15410,Kevin Miller,1998-99,33.0,11,11,37,37,4,7,11,37.0,,574,146,176,322,1047.0,82,5.28,57,380,2242,9.6,0.2336188
15411,15411,Kevin Miller,1999-00,34.0,12,6,33,33,1,5,6,37.0,340.0,607,147,181,328,1084.0,82,5.27,57,359,2285,9.4,0.22332656
15412,15412,Kevin Miller,2000-01,35.0,13,5,9,9,3,2,5,11.0,74.0,616,150,183,333,1095.0,82,5.49,53,331,2294,9.8,0.275922
15413,15413,Kevin Miller,2004-05,39.0,14,2,4,4,0,2,2,2.0,29.0,620,150,185,335,1097.0,82,5.14,57,348,2300,9.2,0.263699
15414,15414,Kevin Morrison,1980-81,31.0,2,15,41,41,4,11,15,64.0,,41,4,11,15,64.0,80,7.03,61,280,2352,12.0,0.32991785
15415,15415,Kevin Porter,2009-10,23.0,2,10,34,34,5,5,10,39.0,463.0,34,5,5,10,39.0,82,5.7,65,341,2477,9.4,0.302903
15416,15416,Kevin Porter,2010-11,24.0,3,3,20,20,2,1,3,21.0,241.0,54,7,6,13,60.0,82,5.53,56,304,2486,9.1,0.20617163
15417,15417,Kevin Porter,2011-12,25.0,4,25,74,74,14,11,25,102.0,1023.0,128,21,17,38,162.0,82,5.46,52,291,2492,9.0,0.34432405
15418,15418,Kevin Porter,2012-13,26.0,5,7,35,35,4,3,7,32.0,321.0,163,25,20,45,194.0,82,5.32,47,271,2439,8.9,0.23111111
15419,15419,Kevin Porter,2013-14,27.0,6,9,31,31,4,5,9,37.0,472.0,194,29,25,54,231.0,48,5.31,29,160,1399,9.1,0.2530227
15420,15420,Kevin Porter,2014-15,28.0,7,1,12,12,0,1,1,3.0,140.0,206,29,26,55,234.0,82,5.34,48,269,2463,8.9,0.17332798
15421,15421,Kevin Porter,2016-17,30.0,8,3,41,41,0,3,3,34.0,464.0,247,29,29,58,268.0,82,5.34,48,255,2438,9.0,0.14920527
15422,15422,Kevin Porter,2017-18,31.0,9,0,2,2,0,0,0,0.0,23.0,249,29,29,58,268.0,82,5.45,47,245,2478,9.0,0.1941874
15423,15423,Kevin Primeau,1981-82,26.0,2,0,2,2,0,0,0,0.0,,2,0,0,0,0.0,80,7.69,77,340,2441,12.6,0.18390518
15424,15424,Kevin Quick,2009-10,21.0,2,1,6,6,0,1,1,7.0,80.0,6,0,1,1,7.0,82,5.7,65,341,2477,9.4,0.241801
15425,15425,Kevin Rooney,2017-18,24.0,2,0,4,4,0,0,0,2.0,41.0,4,0,0,0,2.0,82,5.45,47,245,2478,9.0,0.17709363
15426,15426,Kevin Rooney,2018-19,25.0,3,0,1,1,0,0,0,3.0,12.0,5,0,0,0,5.0,82,5.86,50,250,2620,9.2,0.16127622
15427,15427,Kevin Rooney,2019-20,26.0,4,10,41,41,6,4,10,39.0,517.0,46,6,4,10,44.0,82,5.96,47,239,2579,9.5,0.2307615
15428,15428,Kevin Rooney,2020-21,27.0,5,9,49,49,4,5,9,59.0,575.0,95,10,9,19,103.0,70,5.96,42,208,2192,9.5,0.20376268
15429,15429,Kevin Roy,2018-19,25.0,2,7,25,25,6,1,7,26.0,341.0,25,6,1,7,26.0,82,5.86,50,250,2620,9.2,0.25132135
15430,15430,Kevin Roy,2019-20,26.0,3,0,3,3,0,0,0,2.0,39.0,28,6,1,7,28.0,82,5.96,47,239,2579,9.5,0.16872025
15431,15431,Kevin Sawyer,1996-97,22.0,2,0,8,8,0,0,0,1.0,,8,0,0,0,1.0,82,6.29,74,413,2481,10.4,0.15635514
15432,15432,Kevin Sawyer,1997-98,23.0,3,0,2,2,0,0,0,0.0,,10,0,0,0,1.0,82,5.83,55,336,2444,9.8,0.15775183
15433,15433,Kevin Sawyer,2000-01,26.0,4,0,3,3,0,0,0,0.0,7.0,13,0,0,0,1.0,82,5.49,53,331,2294,9.8,0.13729548
15434,15434,Kevin Sawyer,2001-02,27.0,5,1,9,9,0,1,1,6.0,59.0,22,0,1,1,7.0,82,5.51,63,376,2272,9.9,0.14703268
15435,15435,Kevin Sawyer,2002-03,28.0,6,2,57,57,1,1,2,29.0,330.0,79,1,2,3,36.0,82,5.24,53,338,2262,9.5,0.09239316
15436,15436,Kevin Sawyer,2003-04,29.0,7,3,31,31,2,1,3,11.0,189.0,110,3,3,6,47.0,82,5.31,60,363,2326,9.4,0.14521769
15437,15437,Kevin Shattenkirk,2011-12,23.0,2,43,72,72,9,34,43,108.0,1429.0,72,9,34,43,108.0,82,5.46,52,291,2492,9.0,0.5320429
15438,15438,Kevin Shattenkirk,2012-13,24.0,3,43,81,81,9,34,43,178.0,1750.0,153,18,68,86,286.0,82,5.32,47,271,2439,8.9,0.5206653
15439,15439,Kevin Shattenkirk,2013-14,25.0,4,23,48,48,5,18,23,84.0,1022.0,201,23,86,109,370.0,48,5.31,29,160,1399,9.1,0.49438885
15440,15440,Kevin Shattenkirk,2014-15,26.0,5,45,81,81,10,35,45,188.0,1666.0,282,33,121,154,558.0,82,5.34,48,269,2463,8.9,0.60991484
15441,15441,Kevin Shattenkirk,2015-16,27.0,6,44,56,56,8,36,44,135.0,1263.0,338,41,157,198,693.0,82,5.32,47,251,2453,8.9,0.6665852
15442,15442,Kevin Shattenkirk,2016-17,28.0,7,44,72,72,14,30,44,180.0,1614.0,410,55,187,242,873.0,82,5.34,48,255,2438,9.0,0.5735236
15443,15443,Kevin Shattenkirk,2017-18,29.0,8,56,80,80,13,43,56,161.0,1595.0,490,68,230,298,1034.0,82,5.45,47,245,2478,9.0,0.6597221
15444,15444,Kevin Shattenkirk,2018-19,30.0,9,23,46,46,5,18,23,94.0,933.0,536,73,248,321,1128.0,82,5.86,50,250,2620,9.2,0.44684035
15445,15445,Kevin Shattenkirk,2019-20,31.0,10,28,73,73,2,26,28,148.0,1383.0,609,75,274,349,1276.0,82,5.96,47,239,2579,9.5,0.3738274
15446,15446,Kevin Shattenkirk,2020-21,32.0,11,34,70,70,8,26,34,131.0,1323.0,679,83,300,383,1407.0,70,5.96,42,208,2192,9.5,0.43318158
15447,15447,Kevin Smyth,1994-95,21.0,2,5,21,21,3,2,5,8.0,,21,3,2,5,8.0,84,6.48,76,407,2545,10.7,0.30319288
15448,15448,Kevin Smyth,1995-96,22.0,3,6,16,16,1,5,6,20.0,,37,4,7,11,28.0,48,5.97,37,209,1408,10.2,0.28552505
15449,15449,Kevin Smyth,1996-97,23.0,4,3,21,21,2,1,3,27.0,,58,6,8,14,55.0,82,6.29,74,413,2481,10.4,0.25203884
15450,15450,Kevin Stenlund,2019-20,23.0,2,0,4,4,0,0,0,3.0,44.0,4,0,0,0,3.0,82,5.96,47,239,2579,9.5,0.18043473
15451,15451,Kevin Stenlund,2020-21,24.0,3,10,32,32,6,4,10,57.0,447.0,36,6,4,10,60.0,70,5.96,42,208,2192,9.5,0.323663
15452,15452,Kevin Stevens,1988-89,23.0,2,7,16,16,5,2,7,22.0,,16,5,2,7,22.0,80,7.43,89,437,2435,12.2,0.38700527
15453,15453,Kevin Stevens,1989-90,24.0,3,15,24,24,12,3,15,52.0,,40,17,5,22,74.0,80,7.48,85,403,2430,12.3,0.5585263
15454,15454,Kevin Stevens,1990-91,25.0,4,70,76,76,29,41,70,179.0,,116,46,46,92,253.0,80,7.37,76,367,2421,12.2,0.8503846
15455,15455,Kevin Stevens,1991-92,26.0,5,86,80,80,40,46,86,253.0,,196,86,92,178,506.0,80,6.91,71,366,2385,11.6,1.1039329
15456,15456,Kevin Stevens,1992-93,27.0,6,123,80,80,54,69,123,325.0,,276,140,161,301,831.0,80,6.96,77,402,2440,11.4,1.4379437
15457,15457,Kevin Stevens,1993-94,28.0,7,111,72,72,55,56,111,326.0,,348,195,217,412,1157.0,84,7.25,87,443,2603,11.7,1.1207552
15458,15458,Kevin Stevens,1994-95,29.0,8,88,83,83,41,47,88,284.0,,431,236,264,500,1441.0,84,6.48,76,407,2545,10.7,0.9382465
15459,15459,Kevin Stevens,1995-96,30.0,9,27,27,27,15,12,27,80.0,,458,251,276,527,1521.0,48,5.97,37,209,1408,10.2,0.82348406
15460,15460,Kevin Stevens,1996-97,31.0,10,36,61,61,13,23,36,170.0,,519,264,299,563,1691.0,82,6.29,74,413,2481,10.4,0.5904902
15461,15461,Kevin Stevens,1997-98,32.0,11,34,69,69,14,20,34,175.0,,588,278,319,597,1866.0,82,5.83,55,336,2444,9.8,0.5141965
15462,15462,Kevin Stevens,1998-99,33.0,12,41,80,80,14,27,41,144.0,,668,292,346,638,2010.0,82,5.28,57,380,2242,9.6,0.52330756
15463,15463,Kevin Stevens,1999-00,34.0,13,43,81,81,23,20,43,136.0,1231.0,749,315,366,681,2146.0,82,5.27,57,359,2285,9.4,0.5322898
15464,15464,Kevin Stevens,2000-01,35.0,14,8,38,38,3,5,8,44.0,475.0,787,318,371,689,2190.0,82,5.49,53,331,2294,9.8,0.34727195
15465,15465,Kevin Stevens,2001-02,36.0,15,32,55,55,10,22,32,107.0,877.0,842,328,393,721,2297.0,82,5.51,63,376,2272,9.9,0.47807217
15466,15466,Kevin Stevens,2002-03,37.0,16,5,32,32,1,4,5,34.0,347.0,874,329,397,726,2331.0,82,5.24,53,338,2262,9.5,0.3507522
15467,15467,Kevin Todd,1989-90,21.0,2,0,1,1,0,0,0,0.0,,1,0,0,0,0.0,80,7.48,85,403,2430,12.3,0.20433158
15468,15468,Kevin Todd,1991-92,23.0,3,0,1,1,0,0,0,0.0,,2,0,0,0,0.0,80,6.91,71,366,2385,11.6,0.19620845
15469,15469,Kevin Todd,1992-93,24.0,4,63,80,80,21,42,63,131.0,,82,21,42,63,131.0,80,6.96,77,402,2440,11.4,0.6894499
15470,15470,Kevin Todd,1993-94,25.0,5,23,55,55,9,14,23,87.0,,137,30,56,86,218.0,84,7.25,87,443,2603,11.7,0.381682
15471,15471,Kevin Todd,1994-95,26.0,6,22,47,47,8,14,22,65.0,,184,38,70,108,283.0,84,6.48,76,407,2545,10.7,0.38598895
15472,15472,Kevin Todd,1995-96,27.0,7,11,33,33,3,8,11,34.0,,217,41,78,119,317.0,48,5.97,37,209,1408,10.2,0.3555931
15473,15473,Kevin Todd,1996-97,28.0,8,43,74,74,16,27,43,132.0,,291,57,105,162,449.0,82,6.29,74,413,2481,10.4,0.49887672
15474,15474,Kevin Todd,1997-98,29.0,9,30,65,65,9,21,30,95.0,,356,66,126,192,544.0,82,5.83,55,336,2444,9.8,0.43039173
15475,15475,Kevin Todd,1998-99,30.0,10,11,27,27,4,7,11,30.0,,383,70,133,203,574.0,82,5.28,57,380,2242,9.6,0.3531081
15476,15476,Kevin Westgarth,2009-10,25.0,2,0,9,9,0,0,0,1.0,45.0,9,0,0,0,1.0,82,5.7,65,341,2477,9.4,0.16073143
15477,15477,Kevin Westgarth,2011-12,27.0,3,3,56,56,0,3,3,20.0,304.0,65,0,3,3,21.0,82,5.46,52,291,2492,9.0,0.07583928
15478,15478,Kevin Westgarth,2012-13,28.0,4,2,25,25,1,1,2,13.0,132.0,90,1,4,5,34.0,82,5.32,47,271,2439,8.9,0.102490574
15479,15479,Kevin Westgarth,2013-14,29.0,5,4,31,31,2,2,4,16.0,177.0,121,3,6,9,50.0,48,5.31,29,160,1399,9.1,0.177677
15480,15480,Kevin Westgarth,2014-15,30.0,6,7,48,48,4,3,7,31.0,312.0,169,7,9,16,81.0,82,5.34,48,269,2463,8.9,0.105852515
15481,15481,Kevin Wortman,1994-95,25.0,2,0,5,5,0,0,0,2.0,,5,0,0,0,2.0,84,6.48,76,407,2545,10.7,0.16625237
15482,15482,Kevyn Adams,1998-99,24.0,2,0,5,5,0,0,0,3.0,,5,0,0,0,3.0,82,5.28,57,380,2242,9.6,0.17145029
15483,15483,Kevyn Adams,1999-00,25.0,3,0,1,1,0,0,0,1.0,8.0,6,0,0,0,4.0,82,5.27,57,359,2285,9.4,0.15949795
15484,15484,Kevyn Adams,2000-01,26.0,4,13,52,52,5,8,13,70.0,644.0,58,5,8,13,74.0,82,5.49,53,331,2294,9.8,0.23391724
15485,15485,Kevyn Adams,2001-02,27.0,5,29,78,78,11,18,29,105.0,1219.0,136,16,26,42,179.0,82,5.51,63,376,2272,9.9,0.293571
15486,15486,Kevyn Adams,2002-03,28.0,6,17,77,77,6,11,17,108.0,887.0,213,22,37,59,287.0,82,5.24,53,338,2262,9.5,0.2737548
15487,15487,Kevyn Adams,2003-04,29.0,7,18,77,77,9,9,18,169.0,1128.0,290,31,46,77,456.0,82,5.31,60,363,2326,9.4,0.2700702
15488,15488,Kevyn Adams,2004-05,30.0,8,22,73,73,10,12,22,141.0,970.0,363,41,58,99,597.0,82,5.14,57,348,2300,9.2,0.3454226
15489,15489,Kevyn Adams,2006-07,32.0,9,23,82,82,15,8,23,160.0,1057.0,445,56,66,122,757.0,82,6.05,85,480,2458,10.1,0.292853
15490,15490,Kevyn Adams,2007-08,33.0,10,12,68,68,3,9,12,87.0,742.0,513,59,75,134,844.0,82,5.76,70,398,2426,9.7,0.20098352
15491,15491,Kevyn Adams,2008-09,34.0,11,2,27,27,0,2,2,32.0,295.0,540,59,77,136,876.0,82,5.44,62,351,2383,9.4,0.17042574
15492,15492,Kiefer Sherwood,2019-20,24.0,2,12,50,50,6,6,12,60.0,569.0,50,6,6,12,60.0,82,5.96,47,239,2579,9.5,0.246611
15493,15493,Kiefer Sherwood,2020-21,25.0,3,1,10,10,0,1,1,17.0,133.0,60,6,7,13,77.0,70,5.96,42,208,2192,9.5,0.21670023
15494,15494,Kieffer Bellows,2020-21,22.0,2,3,8,8,2,1,3,11.0,85.0,8,2,1,3,11.0,70,5.96,42,208,2192,9.5,0.30630738
15495,15495,Kim Clackson,1980-81,25.0,2,3,45,45,0,3,3,12.0,,45,0,3,3,12.0,80,7.03,61,280,2352,12.0,0.13519675
15496,15496,Kim Clackson,1981-82,26.0,3,5,61,61,0,5,5,20.0,,106,0,8,8,32.0,80,7.69,77,340,2441,12.6,0.13073367
15497,15497,Kim Issel,1989-90,22.0,2,0,4,4,0,0,0,1.0,,4,0,0,0,1.0,80,7.48,85,403,2430,12.3,0.21295735
15498,15498,Kim Johnsson,2000-01,24.0,2,21,76,76,6,15,21,101.0,1376.0,76,6,15,21,101.0,82,5.49,53,331,2294,9.8,0.29765278
15499,15499,Kim Johnsson,2001-02,25.0,3,26,75,75,5,21,26,104.0,1595.0,151,11,36,47,205.0,82,5.51,63,376,2272,9.9,0.33578098
15500,15500,Kim Johnsson,2002-03,26.0,4,41,82,82,11,30,41,150.0,1889.0,233,22,66,88,355.0,82,5.24,53,338,2262,9.5,0.4978781
15501,15501,Kim Johnsson,2003-04,27.0,5,39,82,82,10,29,39,159.0,1975.0,315,32,95,127,514.0,82,5.31,60,363,2326,9.4,0.4872068
15502,15502,Kim Johnsson,2004-05,28.0,6,42,80,80,13,29,42,189.0,1956.0,395,45,124,169,703.0,82,5.14,57,348,2300,9.2,0.6183892
15503,15503,Kim Johnsson,2006-07,30.0,7,25,47,47,6,19,25,97.0,1095.0,442,51,143,194,800.0,82,6.05,85,480,2458,10.1,0.44416484
15504,15504,Kim Johnsson,2007-08,31.0,8,22,76,76,3,19,22,98.0,1790.0,518,54,162,216,898.0,82,5.76,70,398,2426,9.7,0.28982425
15505,15505,Kim Johnsson,2008-09,32.0,9,27,80,80,4,23,27,87.0,1876.0,598,58,185,243,985.0,82,5.44,62,351,2383,9.4,0.29872465
15506,15506,Kim Johnsson,2009-10,33.0,10,24,81,81,2,22,24,93.0,1987.0,679,60,207,267,1078.0,82,5.7,65,341,2477,9.4,0.27087384
15507,15507,Kim Johnsson,2010-11,34.0,11,17,60,60,7,10,17,94.0,1367.0,739,67,217,284,1172.0,82,5.53,56,304,2486,9.1,0.26278353
15508,15508,Kimbi Daniels,1991-92,20.0,2,1,2,2,0,1,1,2.0,,2,0,1,1,2.0,80,6.91,71,366,2385,11.6,0.2882866
15509,15509,Kimbi Daniels,1992-93,21.0,3,2,25,25,1,1,2,16.0,,27,1,2,3,18.0,80,6.96,77,402,2440,11.4,0.24525028
15510,15510,Kimmo Timonen,1999-00,24.0,2,12,50,50,4,8,12,75.0,953.0,50,4,8,12,75.0,82,5.27,57,359,2285,9.4,0.27104115
15511,15511,Kimmo Timonen,2000-01,25.0,3,33,51,51,8,25,33,97.0,1076.0,101,12,33,45,172.0,82,5.49,53,331,2294,9.8,0.4961936
15512,15512,Kimmo Timonen,2001-02,26.0,4,25,82,82,12,13,25,151.0,1901.0,183,24,46,70,323.0,82,5.51,63,376,2272,9.9,0.39404988
15513,15513,Kimmo Timonen,2002-03,27.0,5,42,82,82,13,29,42,154.0,1984.0,265,37,75,112,477.0,82,5.24,53,338,2262,9.5,0.5158135
15514,15514,Kimmo Timonen,2003-04,28.0,6,40,72,72,6,34,40,144.0,1614.0,337,43,109,152,621.0,82,5.31,60,363,2326,9.4,0.5073878
15515,15515,Kimmo Timonen,2004-05,29.0,7,44,77,77,12,32,44,180.0,1838.0,414,55,141,196,801.0,82,5.14,57,348,2300,9.2,0.6149119
15516,15516,Kimmo Timonen,2006-07,31.0,8,50,79,79,11,39,50,156.0,1773.0,493,66,180,246,957.0,82,6.05,85,480,2458,10.1,0.54392827
15517,15517,Kimmo Timonen,2007-08,32.0,9,55,80,80,13,42,55,121.0,1748.0,573,79,222,301,1078.0,82,5.76,70,398,2426,9.7,0.60245335
15518,15518,Kimmo Timonen,2008-09,33.0,10,44,80,80,8,36,44,125.0,1886.0,653,87,258,345,1203.0,82,5.44,62,351,2383,9.4,0.5000873
15519,15519,Kimmo Timonen,2009-10,34.0,11,43,77,77,3,40,43,104.0,1888.0,730,90,298,388,1307.0,82,5.7,65,341,2477,9.4,0.45041472
15520,15520,Kimmo Timonen,2010-11,35.0,12,39,82,82,6,33,39,121.0,1876.0,812,96,331,427,1428.0,82,5.53,56,304,2486,9.1,0.42881328
15521,15521,Kimmo Timonen,2011-12,36.0,13,37,82,82,6,31,37,147.0,1843.0,894,102,362,464,1575.0,82,5.46,52,291,2492,9.0,0.42220777
15522,15522,Kimmo Timonen,2012-13,37.0,14,43,76,76,4,39,43,130.0,1614.0,970,106,401,507,1705.0,82,5.32,47,271,2439,8.9,0.44105214
15523,15523,Kimmo Timonen,2013-14,38.0,15,29,45,45,5,24,29,78.0,979.0,1015,111,425,536,1783.0,48,5.31,29,160,1399,9.1,0.49328467
15524,15524,Kimmo Timonen,2014-15,39.0,16,35,77,77,6,29,35,152.0,1565.0,1092,117,454,571,1935.0,82,5.34,48,269,2463,8.9,0.3509941
15525,15525,Kimmo Timonen,2015-16,40.0,17,0,16,16,0,0,0,10.0,192.0,1108,117,454,571,1945.0,82,5.32,47,251,2453,8.9,0.19376889
15526,15526,Kip Brennan,2002-03,22.0,2,0,4,4,0,0,0,0.0,19.0,4,0,0,0,0.0,82,5.24,53,338,2262,9.5,0.15280509
15527,15527,Kip Brennan,2003-04,23.0,3,0,19,19,0,0,0,6.0,93.0,23,0,0,0,6.0,82,5.31,60,363,2326,9.4,0.116125256
15528,15528,Kip Brennan,2004-05,24.0,4,1,23,23,1,0,1,8.0,108.0,46,1,0,1,14.0,82,5.14,57,348,2300,9.2,0.12629184
15529,15529,Kip Brennan,2006-07,26.0,5,1,12,12,0,1,1,5.0,51.0,58,1,1,2,19.0,82,6.05,85,480,2458,10.1,0.12171763
15530,15530,Kip Brennan,2008-09,28.0,6,0,3,3,0,0,0,0.0,13.0,61,1,1,2,19.0,82,5.44,62,351,2383,9.4,0.121697485
15531,15531,Kip Miller,1991-92,22.0,2,7,13,13,4,3,7,16.0,,13,4,3,7,16.0,80,6.91,71,366,2385,11.6,0.36712182
15532,15532,Kip Miller,1992-93,23.0,3,18,39,39,6,12,18,49.0,,52,10,15,25,65.0,80,6.96,77,402,2440,11.4,0.42597097
15533,15533,Kip Miller,1994-95,25.0,4,4,11,11,2,2,4,21.0,,63,12,17,29,86.0,84,6.48,76,407,2545,10.7,0.2748469
15534,15534,Kip Miller,1995-96,26.0,5,1,8,8,0,1,1,11.0,,71,12,18,30,97.0,48,5.97,37,209,1408,10.2,0.22302866
15535,15535,Kip Miller,1996-97,27.0,6,5,10,10,1,4,5,12.0,,81,13,22,35,109.0,82,6.29,74,413,2481,10.4,0.23824078
15536,15536,Kip Miller,1998-99,29.0,7,4,9,9,1,3,4,11.0,,90,14,25,39,120.0,82,5.28,57,380,2242,9.6,0.23893192
15537,15537,Kip Miller,1999-00,30.0,8,42,77,77,19,23,42,125.0,1303.0,167,33,48,81,245.0,82,5.27,57,359,2285,9.4,0.45969397
15538,15538,Kip Miller,2000-01,31.0,9,42,74,74,10,32,42,82.0,1041.0,241,43,80,123,327.0,82,5.49,53,331,2294,9.8,0.43762398
15539,15539,Kip Miller,2001-02,32.0,10,11,33,33,3,8,11,38.0,323.0,274,46,88,134,365.0,82,5.51,63,376,2272,9.9,0.26702866
15540,15540,Kip Miller,2002-03,33.0,11,24,37,37,7,17,24,52.0,523.0,311,53,105,158,417.0,82,5.24,53,338,2262,9.5,0.45341745
15541,15541,Kip Miller,2003-04,34.0,12,50,72,72,12,38,50,89.0,1077.0,383,65,143,208,506.0,82,5.31,60,363,2326,9.4,0.5153562
15542,15542,Kip Miller,2004-05,35.0,13,31,66,66,9,22,31,74.0,928.0,449,74,165,239,580.0,82,5.14,57,348,2300,9.2,0.405043
15543,15543,Kirby Dach,2020-21,20.0,2,23,64,64,8,15,23,101.0,913.0,64,8,15,23,101.0,70,5.96,42,208,2192,9.5,0.40794364
15544,15544,Kirby Law,2001-02,24.0,2,0,1,1,0,0,0,0.0,3.0,1,0,0,0,0.0,82,5.51,63,376,2272,9.9,0.15658855
15545,15545,Kirby Law,2003-04,26.0,3,0,2,2,0,0,0,0.0,3.0,3,0,0,0,0.0,82,5.31,60,363,2326,9.4,0.164154
15546,15546,Kirby Law,2004-05,27.0,4,1,6,6,0,1,1,1.0,49.0,9,0,1,1,1.0,82,5.14,57,348,2300,9.2,0.1492058
15547,15547,Kirill Safronov,2002-03,21.0,2,0,3,3,0,0,0,2.0,49.0,3,0,0,0,2.0,82,5.24,53,338,2262,9.5,0.18559515
15548,15548,Kirill Safronov,2003-04,22.0,3,4,32,32,2,2,4,21.0,481.0,35,2,2,4,23.0,82,5.31,60,363,2326,9.4,0.2394459
15549,15549,Kirk Maltby,1994-95,22.0,2,19,68,68,11,8,19,89.0,,68,11,8,19,89.0,84,6.48,76,407,2545,10.7,0.3098082
15550,15550,Kirk Maltby,1995-96,23.0,3,11,47,47,8,3,11,73.0,,115,19,11,30,162.0,48,5.97,37,209,1408,10.2,0.3526942
15551,15551,Kirk Maltby,1996-97,24.0,4,9,55,55,3,6,9,55.0,,170,22,17,39,217.0,82,6.29,74,413,2481,10.4,0.2055029
15552,15552,Kirk Maltby,1997-98,25.0,5,8,66,66,3,5,8,62.0,,236,25,22,47,279.0,82,5.83,55,336,2444,9.8,0.18521553
15553,15553,Kirk Maltby,1998-99,26.0,6,23,65,65,14,9,23,106.0,,301,39,31,70,385.0,82,5.28,57,380,2242,9.6,0.3101468
15554,15554,Kirk Maltby,1999-00,27.0,7,14,53,53,8,6,14,76.0,700.0,354,47,37,84,461.0,82,5.27,57,359,2285,9.4,0.28250316
15555,15555,Kirk Maltby,2000-01,28.0,8,14,41,41,6,8,14,71.0,554.0,395,53,45,98,532.0,82,5.49,53,331,2294,9.8,0.2787819
15556,15556,Kirk Maltby,2001-02,29.0,9,19,79,79,12,7,19,119.0,1129.0,474,65,52,117,651.0,82,5.51,63,376,2272,9.9,0.26398814
15557,15557,Kirk Maltby,2002-03,30.0,10,24,82,82,9,15,24,108.0,1097.0,556,74,67,141,759.0,82,5.24,53,338,2262,9.5,0.28327197
15558,15558,Kirk Maltby,2003-04,31.0,11,37,82,82,14,23,37,116.0,1326.0,638,88,90,178,875.0,82,5.31,60,363,2326,9.4,0.3968815
15559,15559,Kirk Maltby,2004-05,32.0,12,33,79,79,14,19,33,123.0,1285.0,717,102,109,211,998.0,82,5.14,57,348,2300,9.2,0.3158782
15560,15560,Kirk Maltby,2006-07,34.0,13,11,82,82,5,6,11,115.0,1126.0,799,107,115,222,1113.0,82,6.05,85,480,2458,10.1,0.18060398
15561,15561,Kirk Maltby,2007-08,35.0,14,11,82,82,6,5,11,113.0,1081.0,881,113,120,233,1226.0,82,5.76,70,398,2426,9.7,0.16816139
15562,15562,Kirk Maltby,2008-09,36.0,15,10,61,61,6,4,10,70.0,736.0,942,119,124,243,1296.0,82,5.44,62,351,2383,9.4,0.17365938
15563,15563,Kirk Maltby,2009-10,37.0,16,11,78,78,5,6,11,58.0,713.0,1020,124,130,254,1354.0,82,5.7,65,341,2477,9.4,0.13090727
15564,15564,Kirk Maltby,2010-11,38.0,17,6,52,52,4,2,6,43.0,526.0,1072,128,132,260,1397.0,82,5.53,56,304,2486,9.1,0.13083926
15565,15565,Kirk Muller,1985-86,19.0,2,54,80,80,17,37,54,158.0,,80,17,37,54,158.0,80,7.77,71,321,2447,12.7,0.7235763
15566,15566,Kirk Muller,1986-87,20.0,3,66,77,77,25,41,66,168.0,,157,42,78,120,326.0,80,7.94,82,370,2484,12.8,0.8486167
15567,15567,Kirk Muller,1987-88,21.0,4,76,79,79,26,50,76,193.0,,236,68,128,196,519.0,80,7.34,72,344,2400,12.2,0.99911755
15568,15568,Kirk Muller,1988-89,22.0,5,94,80,80,37,57,94,215.0,,316,105,185,290,734.0,80,7.43,89,437,2435,12.2,1.1306999
15569,15569,Kirk Muller,1989-90,23.0,6,74,80,80,31,43,74,182.0,,396,136,228,364,916.0,80,7.48,85,403,2430,12.3,0.95671034
15570,15570,Kirk Muller,1990-91,24.0,7,86,80,80,30,56,86,200.0,,476,166,284,450,1116.0,80,7.37,76,367,2421,12.2,1.0320659
15571,15571,Kirk Muller,1991-92,25.0,8,70,80,80,19,51,70,221.0,,556,185,335,520,1337.0,80,6.91,71,366,2385,11.6,0.94927585
15572,15572,Kirk Muller,1992-93,26.0,9,77,78,78,36,41,77,191.0,,634,221,376,597,1528.0,80,6.96,77,402,2440,11.4,0.9898106
15573,15573,Kirk Muller,1993-94,27.0,10,94,80,80,37,57,94,231.0,,714,258,433,691,1759.0,84,7.25,87,443,2603,11.7,0.9842037
15574,15574,Kirk Muller,1994-95,28.0,11,57,76,76,23,34,57,168.0,,790,281,467,748,1927.0,84,6.48,76,407,2545,10.7,0.6976898
15575,15575,Kirk Muller,1995-96,29.0,12,27,45,45,11,16,27,97.0,,835,292,483,775,2024.0,48,5.97,37,209,1408,10.2,0.6918912
15576,15576,Kirk Muller,1996-97,30.0,13,32,51,51,13,19,32,102.0,,886,305,502,807,2126.0,82,6.29,74,413,2481,10.4,0.652261
15577,15577,Kirk Muller,1997-98,31.0,14,40,76,76,21,19,40,174.0,,962,326,521,847,2300.0,82,5.83,55,336,2444,9.8,0.52244127
15578,15578,Kirk Muller,1998-99,32.0,15,29,70,70,8,21,29,115.0,,1032,334,542,876,2415.0,82,5.28,57,380,2242,9.6,0.38222852
15579,15579,Kirk Muller,1999-00,33.0,16,15,82,82,4,11,15,107.0,1186.0,1114,338,553,891,2522.0,82,5.27,57,359,2285,9.4,0.32091224
15580,15580,Kirk Muller,2000-01,34.0,17,22,47,47,7,15,22,57.0,770.0,1161,345,568,913,2579.0,82,5.49,53,331,2294,9.8,0.40851334
15581,15581,Kirk Muller,2001-02,35.0,18,10,55,55,1,9,10,54.0,680.0,1216,346,577,923,2633.0,82,5.51,63,376,2272,9.9,0.27865928
15582,15582,Kirk Muller,2002-03,36.0,19,30,78,78,10,20,30,111.0,1076.0,1294,356,597,953,2744.0,82,5.24,53,338,2262,9.5,0.3701074
15583,15583,Kirk Muller,2003-04,37.0,20,6,55,55,1,5,6,48.0,521.0,1349,357,602,959,2792.0,82,5.31,60,363,2326,9.4,0.26758385
15584,15584,Kirk Nielsen,1998-99,25.0,2,0,6,6,0,0,0,1.0,,6,0,0,0,1.0,82,5.28,57,380,2242,9.6,0.14944527
15585,15585,Kirk Tomlinson,1988-89,20.0,2,0,1,1,0,0,0,0.0,,1,0,0,0,0.0,80,7.43,89,437,2435,12.2,0.2499237
15586,15586,Kjell Dahlin,1986-87,23.0,2,71,77,77,32,39,71,172.0,,77,32,39,71,172.0,80,7.94,82,370,2484,12.8,0.7904229
15587,15587,Kjell Dahlin,1987-88,24.0,3,20,41,41,12,8,20,53.0,,118,44,47,91,225.0,80,7.34,72,344,2400,12.2,0.5242401
15588,15588,Kjell Dahlin,1988-89,25.0,4,25,48,48,13,12,25,51.0,,166,57,59,116,276.0,80,7.43,89,437,2435,12.2,0.5408162
15589,15589,Kjell Samuelsson,1986-87,28.0,2,0,9,9,0,0,0,7.0,,9,0,0,0,7.0,80,7.94,82,370,2484,12.8,0.20818633
15590,15590,Kjell Samuelsson,1987-88,29.0,3,15,76,76,3,12,15,48.0,,85,3,12,15,55.0,80,7.34,72,344,2400,12.2,0.21932018
15591,15591,Kjell Samuelsson,1988-89,30.0,4,30,74,74,6,24,30,118.0,,159,9,36,45,173.0,80,7.43,89,437,2435,12.2,0.37016055
15592,15592,Kjell Samuelsson,1989-90,31.0,5,17,69,69,3,14,17,60.0,,228,12,50,62,233.0,80,7.48,85,403,2430,12.3,0.22649518
15593,15593,Kjell Samuelsson,1990-91,32.0,6,22,66,66,5,17,22,88.0,,294,17,67,84,321.0,80,7.37,76,367,2421,12.2,0.25815177
15594,15594,Kjell Samuelsson,1991-92,33.0,7,28,78,78,9,19,28,101.0,,372,26,86,112,422.0,80,6.91,71,366,2385,11.6,0.33241808
15595,15595,Kjell Samuelsson,1992-93,34.0,8,16,74,74,5,11,16,91.0,,446,31,97,128,513.0,80,6.96,77,402,2440,11.4,0.2499151
15596,15596,Kjell Samuelsson,1993-94,35.0,9,9,63,63,3,6,9,63.0,,509,34,103,137,576.0,84,7.25,87,443,2603,11.7,0.1853742
15597,15597,Kjell Samuelsson,1994-95,36.0,10,13,59,59,5,8,13,57.0,,568,39,111,150,633.0,84,6.48,76,407,2545,10.7,0.19464517
15598,15598,Kjell Samuelsson,1995-96,37.0,11,7,41,41,1,6,7,37.0,,609,40,117,157,670.0,48,5.97,37,209,1408,10.2,0.15824577
15599,15599,Kjell Samuelsson,1996-97,38.0,12,14,75,75,3,11,14,62.0,,684,43,128,171,732.0,82,6.29,74,413,2481,10.4,0.14394733
15600,15600,Kjell Samuelsson,1997-98,39.0,13,7,34,34,4,3,7,36.0,,718,47,131,178,768.0,82,5.83,55,336,2444,9.8,0.17969778
15601,15601,Kjell Samuelsson,1998-99,40.0,14,3,49,49,0,3,3,23.0,,767,47,134,181,791.0,82,5.28,57,380,2242,9.6,0.10607341
15602,15602,Kjell Samuelsson,1999-00,41.0,15,5,46,46,1,4,5,22.0,856.0,813,48,138,186,813.0,82,5.27,57,359,2285,9.4,0.11404511
15603,15603,Klas Dahlbeck,2015-16,24.0,2,4,23,23,1,3,4,20.0,406.0,23,1,3,4,20.0,82,5.32,47,251,2453,8.9,0.17948452
15604,15604,Klas Dahlbeck,2016-17,25.0,3,8,71,71,2,6,8,64.0,1117.0,94,3,9,12,84.0,82,5.34,48,255,2438,9.0,0.16930437
15605,15605,Klas Dahlbeck,2017-18,26.0,4,6,43,43,2,4,6,37.0,597.0,137,5,13,18,121.0,82,5.45,47,245,2478,9.0,0.14871559
15606,15606,Klas Dahlbeck,2018-19,27.0,5,5,33,33,1,4,5,43.0,540.0,170,6,17,23,164.0,82,5.86,50,250,2620,9.2,0.1633366
15607,15607,Klim Kostin,2020-21,21.0,2,1,4,4,1,0,1,5.0,34.0,4,1,0,1,5.0,70,5.96,42,208,2192,9.5,0.25774068
15608,15608,Kole Sherwood,2019-20,23.0,2,0,2,2,0,0,0,2.0,18.0,2,0,0,0,2.0,82,5.96,47,239,2579,9.5,0.18310392
15609,15609,Kole Sherwood,2020-21,24.0,3,0,3,3,0,0,0,6.0,20.0,5,0,0,0,8.0,70,5.96,42,208,2192,9.5,0.18707949
15610,15610,Konstantin Koltsov,2003-04,22.0,2,0,2,2,0,0,0,4.0,26.0,2,0,0,0,4.0,82,5.31,60,363,2326,9.4,0.19251204
15611,15611,Konstantin Koltsov,2004-05,23.0,3,29,82,82,9,20,29,123.0,1259.0,84,9,20,29,127.0,82,5.14,57,348,2300,9.2,0.49070457
15612,15612,Konstantin Koltsov,2006-07,25.0,4,9,60,60,3,6,9,72.0,795.0,144,12,26,38,199.0,82,6.05,85,480,2458,10.1,0.19316468
15613,15613,Konstantin Pushkarev,2006-07,21.0,2,1,1,1,0,1,1,0.0,10.0,1,0,1,1,0.0,82,6.05,85,480,2458,10.1,0.23186013
15614,15614,Konstantin Pushkarev,2007-08,22.0,3,4,16,16,2,2,4,10.0,147.0,17,2,3,5,10.0,82,5.76,70,398,2426,9.7,0.24842599
15615,15615,Konstantin Shafranov,1997-98,29.0,2,3,5,5,2,1,3,8.0,,5,2,1,3,8.0,82,5.83,55,336,2444,9.8,0.24013561
15616,15616,Korbinian Holzer,2011-12,23.0,2,0,2,2,0,0,0,1.0,26.0,2,0,0,0,1.0,82,5.46,52,291,2492,9.0,0.16773644
15617,15617,Korbinian Holzer,2013-14,25.0,3,3,22,22,2,1,3,16.0,407.0,24,2,1,3,17.0,48,5.31,29,160,1399,9.1,0.21876514
15618,15618,Korbinian Holzer,2015-16,27.0,4,6,34,34,0,6,6,32.0,582.0,58,2,7,9,49.0,82,5.32,47,251,2453,8.9,0.1459668
15619,15619,Korbinian Holzer,2016-17,28.0,5,3,29,29,0,3,3,17.0,428.0,87,2,10,12,66.0,82,5.34,48,255,2438,9.0,0.12555361
15620,15620,Korbinian Holzer,2017-18,29.0,6,7,32,32,2,5,7,14.0,432.0,119,4,15,19,80.0,82,5.45,47,245,2478,9.0,0.16148344
15621,15621,Korbinian Holzer,2018-19,30.0,7,0,16,16,0,0,0,10.0,186.0,135,4,15,19,90.0,82,5.86,50,250,2620,9.2,0.124228746
15622,15622,Korbinian Holzer,2019-20,31.0,8,4,22,22,1,3,4,15.0,353.0,157,5,18,23,105.0,82,5.96,47,239,2579,9.5,0.11261633
15623,15623,Korbinian Holzer,2020-21,32.0,9,4,49,49,1,3,4,39.0,786.0,206,6,21,27,144.0,70,5.96,42,208,2192,9.5,0.12860414
15624,15624,Kraig Nienhuis,1986-87,25.0,2,30,70,70,16,14,30,120.0,,70,16,14,30,120.0,80,7.94,82,370,2484,12.8,0.43612793
15625,15625,Kraig Nienhuis,1987-88,26.0,3,6,16,16,4,2,6,24.0,,86,20,16,36,144.0,80,7.34,72,344,2400,12.2,0.36091834
15626,15626,Kraig Nienhuis,1988-89,27.0,4,0,1,1,0,0,0,4.0,,87,20,16,36,148.0,80,7.43,89,437,2435,12.2,0.22973585
15627,15627,Kris Beech,2001-02,20.0,2,0,4,4,0,0,0,0.0,30.0,4,0,0,0,0.0,82,5.51,63,376,2272,9.9,0.20927101
15628,15628,Kris Beech,2002-03,21.0,3,25,79,79,10,15,25,126.0,1071.0,83,10,15,25,126.0,82,5.24,53,338,2262,9.5,0.36872435
15629,15629,Kris Beech,2003-04,22.0,4,1,12,12,0,1,1,6.0,127.0,95,10,16,26,132.0,82,5.31,60,363,2326,9.4,0.2480357
15630,15630,Kris Beech,2004-05,23.0,5,1,4,4,0,1,1,6.0,50.0,99,10,17,27,138.0,82,5.14,57,348,2300,9.2,0.30944788
15631,15631,Kris Beech,2006-07,25.0,6,3,10,10,1,2,3,12.0,120.0,109,11,19,30,150.0,82,6.05,85,480,2458,10.1,0.23161307
15632,15632,Kris Beech,2007-08,26.0,7,26,64,64,8,18,26,77.0,798.0,173,19,37,56,227.0,82,5.76,70,398,2426,9.7,0.32520267
15633,15633,Kris Beech,2008-09,27.0,8,11,25,25,6,5,11,36.0,288.0,198,25,42,67,263.0,82,5.44,62,351,2383,9.4,0.29738906
15634,15634,Kris Chucko,2009-10,23.0,2,0,2,2,0,0,0,0.0,14.0,2,0,0,0,0.0,82,5.7,65,341,2477,9.4,0.16788644
15635,15635,Kris Draper,1991-92,20.0,2,1,3,3,1,0,1,1.0,,3,1,0,1,1.0,80,6.91,71,366,2385,11.6,0.3011052
15636,15636,Kris Draper,1992-93,21.0,3,2,10,10,2,0,2,19.0,,13,3,0,3,20.0,80,6.96,77,402,2440,11.4,0.3154763
15637,15637,Kris Draper,1993-94,22.0,4,0,7,7,0,0,0,5.0,,20,3,0,3,25.0,84,7.25,87,443,2603,11.7,0.225642
15638,15638,Kris Draper,1994-95,23.0,5,13,39,39,5,8,13,55.0,,59,8,8,16,80.0,84,6.48,76,407,2545,10.7,0.3058235
15639,15639,Kris Draper,1995-96,24.0,6,8,36,36,2,6,8,44.0,,95,10,14,24,124.0,48,5.97,37,209,1408,10.2,0.24892205
15640,15640,Kris Draper,1996-97,25.0,7,16,52,52,7,9,16,51.0,,147,17,23,40,175.0,82,6.29,74,413,2481,10.4,0.27906376
15641,15641,Kris Draper,1997-98,26.0,8,13,76,76,8,5,13,85.0,,223,25,28,53,260.0,82,5.83,55,336,2444,9.8,0.20726371
15642,15642,Kris Draper,1998-99,27.0,9,23,64,64,13,10,23,96.0,,287,38,38,76,356.0,82,5.28,57,380,2242,9.6,0.30719686
15643,15643,Kris Draper,1999-00,28.0,10,18,80,80,4,14,18,78.0,1017.0,367,42,52,94,434.0,82,5.27,57,359,2285,9.4,0.22613397
15644,15644,Kris Draper,2000-01,29.0,11,12,51,51,5,7,12,76.0,691.0,418,47,59,106,510.0,82,5.49,53,331,2294,9.8,0.22283545
15645,15645,Kris Draper,2001-02,30.0,12,25,75,75,8,17,25,123.0,1008.0,493,55,76,131,633.0,82,5.51,63,376,2272,9.9,0.2791431
15646,15646,Kris Draper,2002-03,31.0,13,30,82,82,15,15,30,137.0,1278.0,575,70,91,161,770.0,82,5.24,53,338,2262,9.5,0.3666525
15647,15647,Kris Draper,2003-04,32.0,14,35,82,82,14,21,35,142.0,1328.0,657,84,112,196,912.0,82,5.31,60,363,2326,9.4,0.3498171
15648,15648,Kris Draper,2004-05,33.0,15,40,67,67,24,16,40,149.0,1188.0,724,108,128,236,1061.0,82,5.14,57,348,2300,9.2,0.51773447
15649,15649,Kris Draper,2006-07,35.0,16,32,80,80,10,22,32,153.0,1422.0,804,118,150,268,1214.0,82,6.05,85,480,2458,10.1,0.31340396
15650,15650,Kris Draper,2007-08,36.0,17,29,81,81,14,15,29,157.0,1357.0,885,132,165,297,1371.0,82,5.76,70,398,2426,9.7,0.29871488
15651,15651,Kris Draper,2008-09,37.0,18,17,65,65,9,8,17,97.0,1016.0,950,141,173,314,1468.0,82,5.44,62,351,2383,9.4,0.21803218
15652,15652,Kris Draper,2009-10,38.0,19,17,79,79,7,10,17,93.0,947.0,1029,148,183,331,1561.0,82,5.7,65,341,2477,9.4,0.20652726
15653,15653,Kris Draper,2010-11,39.0,20,22,81,81,7,15,22,98.0,935.0,1110,155,198,353,1659.0,82,5.53,56,304,2486,9.1,0.2278395
15654,15654,Kris Draper,2011-12,40.0,21,11,47,47,6,5,11,57.0,491.0,1157,161,203,364,1716.0,82,5.46,52,291,2492,9.0,0.19219941
15655,15655,Kris Foucault,2012-13,22.0,2,0,1,1,0,0,0,0.0,9.0,1,0,0,0,0.0,82,5.32,47,271,2439,8.9,0.14758375
15656,15656,Kris Fredheim,2012-13,25.0,2,0,3,3,0,0,0,0.0,36.0,3,0,0,0,0.0,82,5.32,47,271,2439,8.9,0.12702146
15657,15657,Kris King,1988-89,22.0,2,1,3,3,1,0,1,3.0,,3,1,0,1,3.0,80,7.43,89,437,2435,12.2,0.28381008
15658,15658,Kris King,1989-90,23.0,3,5,55,55,2,3,5,34.0,,58,3,3,6,37.0,80,7.48,85,403,2430,12.3,0.19249034
15659,15659,Kris King,1990-91,24.0,4,13,68,68,6,7,13,49.0,,126,9,10,19,86.0,80,7.37,76,367,2421,12.2,0.21989071
15660,15660,Kris King,1991-92,25.0,5,25,72,72,11,14,25,107.0,,198,20,24,44,193.0,80,6.91,71,366,2385,11.6,0.34684968
15661,15661,Kris King,1992-93,26.0,6,19,79,79,10,9,19,97.0,,277,30,33,63,290.0,80,6.96,77,402,2440,11.4,0.26024735
15662,15662,Kris King,1993-94,27.0,7,19,78,78,8,11,19,74.0,,355,38,44,82,364.0,84,7.25,87,443,2603,11.7,0.23004255
15663,15663,Kris King,1994-95,28.0,8,12,83,83,4,8,12,86.0,,438,42,52,94,450.0,84,6.48,76,407,2545,10.7,0.18704334
15664,15664,Kris King,1995-96,29.0,9,6,48,48,4,2,6,58.0,,486,46,54,100,508.0,48,5.97,37,209,1408,10.2,0.17573223
15665,15665,Kris King,1996-97,30.0,10,20,81,81,9,11,20,89.0,,567,55,65,120,597.0,82,6.29,74,413,2481,10.4,0.23371804
15666,15666,Kris King,1997-98,31.0,11,14,81,81,3,11,14,57.0,,648,58,76,134,654.0,82,5.83,55,336,2444,9.8,0.15089068
15667,15667,Kris King,1998-99,32.0,12,6,82,82,3,3,6,53.0,,730,61,79,140,707.0,82,5.28,57,380,2242,9.6,0.14046752
15668,15668,Kris King,1999-00,33.0,13,4,67,67,2,2,4,34.0,628.0,797,63,81,144,741.0,82,5.27,57,359,2285,9.4,0.13784957
15669,15669,Kris King,2000-01,34.0,14,6,39,39,2,4,6,24.0,332.0,836,65,85,150,765.0,82,5.49,53,331,2294,9.8,0.14853173
15670,15670,Kris King,2001-02,35.0,15,1,13,13,1,0,1,12.0,130.0,849,66,85,151,777.0,82,5.51,63,376,2272,9.9,0.17231476
15671,15671,Kris Letang,2007-08,20.0,2,2,7,7,2,0,2,8.0,81.0,7,2,0,2,8.0,82,5.76,70,398,2426,9.7,0.28130245
15672,15672,Kris Letang,2008-09,21.0,3,17,63,63,6,11,17,68.0,1144.0,70,8,11,19,76.0,82,5.44,62,351,2383,9.4,0.31289762
15673,15673,Kris Letang,2009-10,22.0,4,33,74,74,10,23,33,138.0,1565.0,144,18,34,52,214.0,82,5.7,65,341,2477,9.4,0.4484805
15674,15674,Kris Letang,2010-11,23.0,5,27,73,73,3,24,27,174.0,1574.0,217,21,58,79,388.0,82,5.53,56,304,2486,9.1,0.40064445
15675,15675,Kris Letang,2011-12,24.0,6,50,82,82,8,42,50,236.0,1971.0,299,29,100,129,624.0,82,5.46,52,291,2492,9.0,0.6313096
15676,15676,Kris Letang,2012-13,25.0,7,42,51,51,10,32,42,142.0,1267.0,350,39,132,171,766.0,82,5.32,47,271,2439,8.9,0.7802714
15677,15677,Kris Letang,2013-14,26.0,8,38,35,35,5,33,38,95.0,897.0,385,44,165,209,861.0,48,5.31,29,160,1399,9.1,0.698541
15678,15678,Kris Letang,2014-15,27.0,9,22,37,37,11,11,22,108.0,897.0,422,55,176,231,969.0,82,5.34,48,269,2463,8.9,0.5399035
15679,15679,Kris Letang,2015-16,28.0,10,54,69,69,11,43,54,197.0,1759.0,491,66,219,285,1166.0,82,5.32,47,251,2453,8.9,0.6911615
15680,15680,Kris Letang,2016-17,29.0,11,67,71,71,16,51,67,218.0,1913.0,562,82,270,352,1384.0,82,5.34,48,255,2438,9.0,0.806543
15681,15681,Kris Letang,2017-18,30.0,12,34,41,41,5,29,34,122.0,1046.0,603,87,299,386,1506.0,82,5.45,47,245,2478,9.0,0.6573936
15682,15682,Kris Letang,2018-19,31.0,13,51,79,79,9,42,51,222.0,2001.0,682,96,341,437,1728.0,82,5.86,50,250,2620,9.2,0.61746776
15683,15683,Kris Letang,2019-20,32.0,14,56,65,65,16,40,56,206.0,1687.0,747,112,381,493,1934.0,82,5.96,47,239,2579,9.5,0.7722354
15684,15684,Kris Letang,2020-21,33.0,15,44,61,61,15,29,44,177.0,1569.0,808,127,410,537,2111.0,70,5.96,42,208,2192,9.5,0.6620923
15685,15685,Kris Newbury,2007-08,25.0,2,4,15,15,2,2,4,30.0,115.0,15,2,2,4,30.0,82,5.76,70,398,2426,9.7,0.23496169
15686,15686,Kris Newbury,2008-09,26.0,3,2,28,28,1,1,2,14.0,122.0,43,3,3,6,44.0,82,5.44,62,351,2383,9.4,0.1358298
15687,15687,Kris Newbury,2009-10,27.0,4,0,1,1,0,0,0,0.0,5.0,44,3,3,6,44.0,82,5.7,65,341,2477,9.4,0.14772752
15688,15688,Kris Newbury,2010-11,28.0,5,1,4,4,1,0,1,3.0,35.0,48,4,3,7,47.0,82,5.53,56,304,2486,9.1,0.14996028
15689,15689,Kris Newbury,2011-12,29.0,6,1,11,11,0,1,1,6.0,84.0,59,4,4,8,53.0,82,5.46,52,291,2492,9.0,0.11539686
15690,15690,Kris Newbury,2012-13,30.0,7,0,7,7,0,0,0,2.0,41.0,66,4,4,8,55.0,82,5.32,47,271,2439,8.9,0.106182724
15691,15691,Kris Newbury,2013-14,31.0,8,1,6,6,0,1,1,4.0,47.0,72,4,5,9,59.0,48,5.31,29,160,1399,9.1,0.13650075
15692,15692,Kris Newbury,2014-15,32.0,9,1,4,4,0,1,1,1.0,20.0,76,4,6,10,60.0,82,5.34,48,269,2463,8.9,0.12687784
15693,15693,Kris Russell,2008-09,21.0,2,10,67,67,2,8,10,90.0,991.0,67,2,8,10,90.0,82,5.44,62,351,2383,9.4,0.2539152
15694,15694,Kris Russell,2009-10,22.0,3,21,66,66,2,19,21,86.0,1064.0,133,4,27,31,176.0,82,5.7,65,341,2477,9.4,0.30251327
15695,15695,Kris Russell,2010-11,23.0,4,22,70,70,7,15,22,108.0,1301.0,203,11,42,53,284.0,82,5.53,56,304,2486,9.1,0.34634206
15696,15696,Kris Russell,2011-12,24.0,5,23,73,73,5,18,23,88.0,1279.0,276,16,60,76,372.0,82,5.46,52,291,2492,9.0,0.284685
15697,15697,Kris Russell,2012-13,25.0,6,12,55,55,6,6,12,56.0,936.0,331,22,66,88,428.0,82,5.32,47,271,2439,8.9,0.24465042
15698,15698,Kris Russell,2013-14,26.0,7,7,33,33,1,6,7,41.0,530.0,364,23,72,95,469.0,48,5.31,29,160,1399,9.1,0.22314328
15699,15699,Kris Russell,2014-15,27.0,8,29,68,68,7,22,29,109.0,1573.0,432,30,94,124,578.0,82,5.34,48,269,2463,8.9,0.367518
15700,15700,Kris Russell,2015-16,28.0,9,34,79,79,4,30,34,111.0,1892.0,511,34,124,158,689.0,82,5.32,47,251,2453,8.9,0.34138095
15701,15701,Kris Russell,2016-17,29.0,10,19,62,62,4,15,19,70.0,1431.0,573,38,139,177,759.0,82,5.34,48,255,2438,9.0,0.25733292
15702,15702,Kris Russell,2017-18,30.0,11,13,68,68,1,12,13,68.0,1443.0,641,39,151,190,827.0,82,5.45,47,245,2478,9.0,0.16626275
15703,15703,Kris Russell,2018-19,31.0,12,21,78,78,4,17,21,90.0,1487.0,719,43,168,211,917.0,82,5.86,50,250,2620,9.2,0.22992745
15704,15704,Kris Russell,2019-20,32.0,13,16,72,72,3,13,16,63.0,1471.0,791,46,181,227,980.0,82,5.96,47,239,2579,9.5,0.19397381
15705,15705,Kris Russell,2020-21,33.0,14,9,55,55,0,9,9,45.0,923.0,846,46,190,236,1025.0,70,5.96,42,208,2192,9.5,0.151544
15706,15706,Kris Vernarsky,2003-04,21.0,2,1,14,14,1,0,1,18.0,144.0,14,1,0,1,18.0,82,5.31,60,363,2326,9.4,0.22363803
15707,15707,Kris Vernarsky,2004-05,22.0,3,0,3,3,0,0,0,0.0,20.0,17,1,0,1,18.0,82,5.14,57,348,2300,9.2,0.21895856
15708,15708,Kris Versteeg,2008-09,22.0,2,4,13,13,2,2,4,21.0,206.0,13,2,2,4,21.0,82,5.44,62,351,2383,9.4,0.2840094
15709,15709,Kris Versteeg,2009-10,23.0,3,53,78,78,22,31,53,139.0,1329.0,91,24,33,57,160.0,82,5.7,65,341,2477,9.4,0.613598
15710,15710,Kris Versteeg,2010-11,24.0,4,44,79,79,20,24,44,184.0,1242.0,170,44,57,101,344.0,82,5.53,56,304,2486,9.1,0.5659231
15711,15711,Kris Versteeg,2011-12,25.0,5,46,80,80,21,25,46,180.0,1418.0,250,65,82,147,524.0,82,5.46,52,291,2492,9.0,0.60171366
15712,15712,Kris Versteeg,2012-13,26.0,6,54,71,71,23,31,54,181.0,1414.0,321,88,113,201,705.0,82,5.32,47,271,2439,8.9,0.707809
15713,15713,Kris Versteeg,2013-14,27.0,7,4,10,10,2,2,4,20.0,169.0,331,90,115,205,725.0,48,5.31,29,160,1399,9.1,0.435957
15714,15714,Kris Versteeg,2014-15,28.0,8,36,81,81,12,24,36,157.0,1171.0,412,102,139,241,882.0,82,5.34,48,269,2463,8.9,0.45635676
15715,15715,Kris Versteeg,2015-16,29.0,9,34,61,61,14,20,34,134.0,967.0,473,116,159,275,1016.0,82,5.32,47,251,2453,8.9,0.5250989
15716,15716,Kris Versteeg,2016-17,30.0,10,38,77,77,15,23,38,156.0,1185.0,550,131,182,313,1172.0,82,5.34,48,255,2438,9.0,0.49484873
15717,15717,Kris Versteeg,2017-18,31.0,11,37,69,69,15,22,37,136.0,1016.0,619,146,204,350,1308.0,82,5.45,47,245,2478,9.0,0.46769288
15718,15718,Kris Versteeg,2018-19,32.0,12,8,24,24,3,5,8,49.0,316.0,643,149,209,358,1357.0,82,5.86,50,250,2620,9.2,0.29943702
15719,15719,Kristian Huselius,2002-03,24.0,2,45,79,79,23,22,45,169.0,1336.0,79,23,22,45,169.0,82,5.24,53,338,2262,9.5,0.54093415
15720,15720,Kristian Huselius,2003-04,25.0,3,43,78,78,20,23,43,187.0,1352.0,157,43,45,88,356.0,82,5.31,60,363,2326,9.4,0.54837286
15721,15721,Kristian Huselius,2004-05,26.0,4,31,76,76,10,21,31,168.0,1082.0,233,53,66,119,524.0,82,5.14,57,348,2300,9.2,0.62406325
15722,15722,Kristian Huselius,2006-07,28.0,5,47,78,78,20,27,47,164.0,1159.0,311,73,93,166,688.0,82,6.05,85,480,2458,10.1,0.5610435
15723,15723,Kristian Huselius,2007-08,29.0,6,77,81,81,34,43,77,173.0,1408.0,392,107,136,243,861.0,82,5.76,70,398,2426,9.7,0.76376104
15724,15724,Kristian Huselius,2008-09,30.0,7,66,81,81,25,41,66,202.0,1433.0,473,132,177,309,1063.0,82,5.44,62,351,2383,9.4,0.74762285
15725,15725,Kristian Huselius,2009-10,31.0,8,56,74,74,21,35,56,212.0,1444.0,547,153,212,365,1275.0,82,5.7,65,341,2477,9.4,0.6992414
15726,15726,Kristian Huselius,2010-11,32.0,9,63,74,74,23,40,63,162.0,1361.0,621,176,252,428,1437.0,82,5.53,56,304,2486,9.1,0.6697154
15727,15727,Kristian Huselius,2011-12,33.0,10,23,39,39,14,9,23,94.0,639.0,660,190,261,451,1531.0,82,5.46,52,291,2492,9.0,0.5011238
15728,15728,Kristian Huselius,2012-13,34.0,11,0,2,2,0,0,0,2.0,32.0,662,190,261,451,1533.0,82,5.32,47,271,2439,8.9,0.28084713
15729,15729,Kristian Kudroc,2001-02,20.0,2,4,22,22,2,2,4,12.0,201.0,22,2,2,4,12.0,82,5.51,63,376,2272,9.9,0.21570495
15730,15730,Kristian Kudroc,2002-03,21.0,3,0,2,2,0,0,0,0.0,16.0,24,2,2,4,12.0,82,5.24,53,338,2262,9.5,0.21097574
15731,15731,Kristian Kudroc,2004-05,23.0,4,0,2,2,0,0,0,0.0,15.0,26,2,2,4,12.0,82,5.14,57,348,2300,9.2,0.20856377
15732,15732,Kristian Vesalainen,2019-20,20.0,2,1,5,5,0,1,1,1.0,34.0,5,0,1,1,1.0,82,5.96,47,239,2579,9.5,0.29294723
15733,15733,Krys Barch,2007-08,27.0,2,5,26,26,3,2,5,12.0,147.0,26,3,2,5,12.0,82,5.76,70,398,2426,9.7,0.18468413
15734,15734,Krys Barch,2008-09,28.0,3,3,48,48,1,2,3,23.0,312.0,74,4,4,8,35.0,82,5.44,62,351,2383,9.4,0.11631122
15735,15735,Krys Barch,2009-10,29.0,4,9,72,72,4,5,9,27.0,465.0,146,8,9,17,62.0,82,5.7,65,341,2477,9.4,0.10855383
15736,15736,Krys Barch,2010-11,30.0,5,6,63,63,0,6,6,29.0,444.0,209,8,15,23,91.0,82,5.53,56,304,2486,9.1,0.088220686
15737,15737,Krys Barch,2011-12,31.0,6,3,44,44,2,1,3,16.0,230.0,253,10,16,26,107.0,82,5.46,52,291,2492,9.0,0.092193335
15738,15738,Krys Barch,2012-13,32.0,7,5,51,51,2,3,5,24.0,375.0,304,12,19,31,131.0,82,5.32,47,271,2439,8.9,0.0813261
15739,15739,Krys Barch,2013-14,33.0,8,0,22,22,0,0,0,4.0,129.0,326,12,19,31,135.0,48,5.31,29,160,1399,9.1,0.07052794
15740,15740,Krys Barch,2014-15,34.0,9,4,55,55,0,4,4,19.0,329.0,381,12,23,35,154.0,82,5.34,48,269,2463,8.9,0.06026867
15741,15741,Krys Kolanos,2002-03,21.0,2,22,57,57,11,11,22,81.0,745.0,57,11,11,22,81.0,82,5.24,53,338,2262,9.5,0.37448686
15742,15742,Krys Kolanos,2003-04,22.0,3,0,2,2,0,0,0,8.0,28.0,59,11,11,22,89.0,82,5.31,60,363,2326,9.4,0.28370044
15743,15743,Krys Kolanos,2004-05,23.0,4,10,41,41,4,6,10,61.0,554.0,100,15,17,32,150.0,82,5.14,57,348,2300,9.2,0.3287366
15744,15744,Krys Kolanos,2006-07,25.0,5,3,15,15,2,1,3,22.0,149.0,115,17,18,35,172.0,82,6.05,85,480,2458,10.1,0.23939827
15745,15745,Krys Kolanos,2009-10,28.0,6,6,21,21,3,3,6,30.0,223.0,136,20,21,41,202.0,82,5.7,65,341,2477,9.4,0.23718485
15746,15746,Krys Kolanos,2012-13,31.0,7,1,13,13,0,1,1,29.0,128.0,149,20,22,42,231.0,82,5.32,47,271,2439,8.9,0.20531413
15747,15747,Krzysztof Oliwa,1997-98,24.0,2,0,1,1,0,0,0,0.0,,1,0,0,0,0.0,82,5.83,55,336,2444,9.8,0.14520383
15748,15748,Krzysztof Oliwa,1998-99,25.0,3,5,73,73,2,3,5,53.0,,74,2,3,5,53.0,82,5.28,57,380,2242,9.6,0.14074919
15749,15749,Krzysztof Oliwa,1999-00,26.0,4,12,64,64,5,7,12,59.0,450.0,138,7,10,17,112.0,82,5.27,57,359,2285,9.4,0.18254644
15750,15750,Krzysztof Oliwa,2000-01,27.0,5,16,69,69,6,10,16,61.0,466.0,207,13,20,33,173.0,82,5.49,53,331,2294,9.8,0.20002452
15751,15751,Krzysztof Oliwa,2001-02,28.0,6,5,36,36,1,4,5,22.0,182.0,243,14,24,38,195.0,82,5.51,63,376,2272,9.9,0.12547562
15752,15752,Krzysztof Oliwa,2002-03,29.0,7,2,57,57,0,2,2,31.0,318.0,300,14,26,40,226.0,82,5.24,53,338,2262,9.5,0.09120646
15753,15753,Krzysztof Oliwa,2003-04,30.0,8,0,42,42,0,0,0,14.0,165.0,342,14,26,40,240.0,82,5.31,60,363,2326,9.4,0.06886271
15754,15754,Krzysztof Oliwa,2004-05,31.0,9,5,65,65,3,2,5,32.0,320.0,407,17,28,45,272.0,82,5.14,57,348,2300,9.2,0.12006697
15755,15755,Krzysztof Oliwa,2006-07,33.0,10,0,3,3,0,0,0,1.0,19.0,410,17,28,45,273.0,82,6.05,85,480,2458,10.1,0.111884505
15756,15756,Kurt Sauer,2003-04,23.0,2,3,80,80,1,2,3,50.0,1484.0,80,1,2,3,50.0,82,5.31,60,363,2326,9.4,0.157011
15757,15757,Kurt Sauer,2004-05,24.0,3,6,69,69,1,5,6,44.0,1140.0,149,2,7,9,94.0,82,5.14,57,348,2300,9.2,0.16662717
15758,15758,Kurt Sauer,2006-07,26.0,4,5,37,37,1,4,5,19.0,474.0,186,3,11,14,113.0,82,6.05,85,480,2458,10.1,0.124069154
15759,15759,Kurt Sauer,2007-08,27.0,5,6,48,48,0,6,6,29.0,880.0,234,3,17,20,142.0,82,5.76,70,398,2426,9.7,0.10149786
15760,15760,Kurt Sauer,2008-09,28.0,6,6,54,54,1,5,6,28.0,1009.0,288,4,22,26,170.0,82,5.44,62,351,2383,9.4,0.1037609
15761,15761,Kurt Sauer,2009-10,29.0,7,7,68,68,1,6,7,33.0,1402.0,356,5,28,33,203.0,82,5.7,65,341,2477,9.4,0.11804211
15762,15762,Kurt Sauer,2010-11,30.0,8,0,1,1,0,0,0,2.0,17.0,357,5,28,33,205.0,82,5.53,56,304,2486,9.1,0.13102677
15763,15763,Kurtis Foster,2003-04,22.0,2,0,2,2,0,0,0,1.0,22.0,2,0,0,0,1.0,82,5.31,60,363,2326,9.4,0.18129355
15764,15764,Kurtis Foster,2004-05,23.0,3,1,3,3,0,1,1,1.0,21.0,5,0,1,1,2.0,82,5.14,57,348,2300,9.2,0.22914153
15765,15765,Kurtis Foster,2006-07,25.0,4,28,58,58,10,18,28,124.0,1115.0,63,10,19,29,126.0,82,6.05,85,480,2458,10.1,0.4185866
15766,15766,Kurtis Foster,2007-08,26.0,5,23,57,57,3,20,23,135.0,1025.0,120,13,39,52,261.0,82,5.76,70,398,2426,9.7,0.377113
15767,15767,Kurtis Foster,2008-09,27.0,6,19,56,56,7,12,19,118.0,919.0,176,20,51,71,379.0,82,5.44,62,351,2383,9.4,0.37161398
15768,15768,Kurtis Foster,2009-10,28.0,7,6,10,10,1,5,6,10.0,136.0,186,21,56,77,389.0,82,5.7,65,341,2477,9.4,0.2592172
15769,15769,Kurtis Foster,2010-11,29.0,8,42,71,71,8,34,42,165.0,1220.0,257,29,90,119,554.0,82,5.53,56,304,2486,9.1,0.4864907
15770,15770,Kurtis Foster,2011-12,30.0,9,22,74,74,8,14,22,182.0,1307.0,331,37,104,141,736.0,82,5.46,52,291,2492,9.0,0.34920135
15771,15771,Kurtis Foster,2012-13,31.0,10,14,51,51,4,10,14,85.0,811.0,382,41,114,155,821.0,82,5.32,47,271,2439,8.9,0.24921498
15772,15772,Kurtis Foster,2013-14,32.0,11,5,23,23,1,4,5,21.0,301.0,405,42,118,160,842.0,48,5.31,29,160,1399,9.1,0.18702221
15773,15773,Kurtis Gabriel,2016-17,23.0,2,0,3,3,0,0,0,1.0,13.0,3,0,0,0,1.0,82,5.34,48,255,2438,9.0,0.16478965
15774,15774,Kurtis Gabriel,2017-18,24.0,3,1,13,13,0,1,1,3.0,76.0,16,0,1,1,4.0,82,5.45,47,245,2478,9.0,0.16425428
15775,15775,Kurtis Gabriel,2019-20,26.0,4,4,22,22,2,2,4,7.0,162.0,38,2,3,5,11.0,82,5.96,47,239,2579,9.5,0.15625882
15776,15776,Kurtis MacDermid,2018-19,24.0,2,4,34,34,1,3,4,19.0,395.0,34,1,3,4,19.0,82,5.86,50,250,2620,9.2,0.15904012
15777,15777,Kurtis MacDermid,2019-20,25.0,3,1,11,11,0,1,1,5.0,103.0,45,1,4,5,24.0,82,5.96,47,239,2579,9.5,0.1579001
15778,15778,Kurtis MacDermid,2020-21,26.0,4,8,45,45,3,5,8,51.0,617.0,90,4,9,13,75.0,70,5.96,42,208,2192,9.5,0.19868824
15779,15779,Kurtis McLean,2009-10,29.0,2,1,4,4,1,0,1,5.0,42.0,4,1,0,1,5.0,82,5.7,65,341,2477,9.4,0.21447763
15780,15780,Kyle Baun,2015-16,23.0,2,0,3,3,0,0,0,4.0,38.0,3,0,0,0,4.0,82,5.32,47,251,2453,8.9,0.17318648
15781,15781,Kyle Baun,2016-17,24.0,3,0,2,2,0,0,0,1.0,18.0,5,0,0,0,5.0,82,5.34,48,255,2438,9.0,0.15936142
15782,15782,Kyle Brodziak,2006-07,22.0,2,0,10,10,0,0,0,7.0,110.0,10,0,0,0,7.0,82,6.05,85,480,2458,10.1,0.17290509
15783,15783,Kyle Brodziak,2007-08,23.0,3,1,6,6,1,0,1,11.0,103.0,16,1,0,1,18.0,82,5.76,70,398,2426,9.7,0.216458
15784,15784,Kyle Brodziak,2008-09,24.0,4,31,80,80,14,17,31,125.0,1033.0,96,15,17,32,143.0,82,5.44,62,351,2383,9.4,0.41075623
15785,15785,Kyle Brodziak,2009-10,25.0,5,27,79,79,11,16,27,99.0,1005.0,175,26,33,59,242.0,82,5.7,65,341,2477,9.4,0.32016996
15786,15786,Kyle Brodziak,2010-11,26.0,6,32,82,82,9,23,32,140.0,1257.0,257,35,56,91,382.0,82,5.53,56,304,2486,9.1,0.40843132
15787,15787,Kyle Brodziak,2011-12,27.0,7,37,80,80,16,21,37,126.0,1262.0,337,51,77,128,508.0,82,5.46,52,291,2492,9.0,0.45268768
15788,15788,Kyle Brodziak,2012-13,28.0,8,44,82,82,22,22,44,160.0,1563.0,419,73,99,172,668.0,82,5.32,47,271,2439,8.9,0.46944043
15789,15789,Kyle Brodziak,2013-14,29.0,9,12,48,48,8,4,12,88.0,833.0,467,81,103,184,756.0,48,5.31,29,160,1399,9.1,0.36469513
15790,15790,Kyle Brodziak,2014-15,30.0,10,24,81,81,8,16,24,115.0,1314.0,548,89,119,208,871.0,82,5.34,48,269,2463,8.9,0.2958626
15791,15791,Kyle Brodziak,2015-16,31.0,11,20,73,73,9,11,20,86.0,952.0,621,98,130,228,957.0,82,5.32,47,251,2453,8.9,0.2669471
15792,15792,Kyle Brodziak,2016-17,32.0,12,11,76,76,7,4,11,49.0,821.0,697,105,134,239,1006.0,82,5.34,48,255,2438,9.0,0.16712958
15793,15793,Kyle Brodziak,2017-18,33.0,13,15,69,69,8,7,15,55.0,773.0,766,113,141,254,1061.0,82,5.45,47,245,2478,9.0,0.19365034
15794,15794,Kyle Brodziak,2018-19,34.0,14,33,81,81,10,23,33,113.0,1090.0,847,123,164,287,1174.0,82,5.86,50,250,2620,9.2,0.30260035
15795,15795,Kyle Brodziak,2019-20,35.0,15,9,70,70,6,3,9,74.0,818.0,917,129,167,296,1248.0,82,5.96,47,239,2579,9.5,0.15858579
15796,15796,Kyle Calder,2000-01,22.0,2,2,8,8,1,1,2,5.0,80.0,8,1,1,2,5.0,82,5.49,53,331,2294,9.8,0.2214163
15797,15797,Kyle Calder,2001-02,23.0,3,15,43,43,5,10,15,63.0,547.0,51,6,11,17,68.0,82,5.51,63,376,2272,9.9,0.31239235
15798,15798,Kyle Calder,2002-03,24.0,4,53,81,81,17,36,53,133.0,1341.0,132,23,47,70,201.0,82,5.24,53,338,2262,9.5,0.6728748
15799,15799,Kyle Calder,2003-04,25.0,5,42,82,82,15,27,42,164.0,1371.0,214,38,74,112,365.0,82,5.31,60,363,2326,9.4,0.5399547
15800,15800,Kyle Calder,2004-05,26.0,6,39,66,66,21,18,39,144.0,1131.0,280,59,92,151,509.0,82,5.14,57,348,2300,9.2,0.69052684
15801,15801,Kyle Calder,2006-07,28.0,7,59,79,79,26,33,59,183.0,1452.0,359,85,125,210,692.0,82,6.05,85,480,2458,10.1,0.6488133
15802,15802,Kyle Calder,2007-08,29.0,8,35,78,78,14,21,35,130.0,1212.0,437,99,146,245,822.0,82,5.76,70,398,2426,9.7,0.42646852
15803,15803,Kyle Calder,2008-09,30.0,9,20,65,65,7,13,20,70.0,845.0,502,106,159,265,892.0,82,5.44,62,351,2383,9.4,0.30557245
15804,15804,Kyle Calder,2009-10,31.0,10,27,74,74,8,19,27,93.0,974.0,576,114,178,292,985.0,82,5.7,65,341,2477,9.4,0.31287527
15805,15805,Kyle Calder,2010-11,32.0,11,2,14,14,0,2,2,20.0,198.0,590,114,180,294,1005.0,82,5.53,56,304,2486,9.1,0.2468983
15806,15806,Kyle Capobianco,2018-19,21.0,2,0,1,1,0,0,0,0.0,14.0,1,0,0,0,0.0,82,5.86,50,250,2620,9.2,0.19211695
15807,15807,Kyle Capobianco,2019-20,22.0,3,0,2,2,0,0,0,1.0,32.0,3,0,0,0,1.0,82,5.96,47,239,2579,9.5,0.17836133
15808,15808,Kyle Capobianco,2020-21,23.0,4,1,9,9,1,0,1,10.0,133.0,12,1,0,1,11.0,70,5.96,42,208,2192,9.5,0.23195177
15809,15809,Kyle Chipchura,2008-09,22.0,2,11,36,36,4,7,11,36.0,409.0,36,4,7,11,36.0,82,5.44,62,351,2383,9.4,0.28543496
15810,15810,Kyle Chipchura,2009-10,23.0,3,3,13,13,0,3,3,5.0,134.0,49,4,10,14,41.0,82,5.7,65,341,2477,9.4,0.21700531
15811,15811,Kyle Chipchura,2010-11,24.0,4,12,74,74,6,6,12,54.0,850.0,123,10,16,26,95.0,82,5.53,56,304,2486,9.1,0.18389145
15812,15812,Kyle Chipchura,2011-12,25.0,5,2,40,40,0,2,2,23.0,320.0,163,10,18,28,118.0,82,5.46,52,291,2492,9.0,0.116603136
15813,15813,Kyle Chipchura,2012-13,26.0,6,16,53,53,3,13,16,43.0,558.0,216,13,31,44,161.0,82,5.32,47,271,2439,8.9,0.23860446
15814,15814,Kyle Chipchura,2013-14,27.0,7,14,46,46,5,9,14,37.0,446.0,262,18,40,58,198.0,48,5.31,29,160,1399,9.1,0.2541504
15815,15815,Kyle Chipchura,2014-15,28.0,8,20,80,80,5,15,20,46.0,777.0,342,23,55,78,244.0,82,5.34,48,269,2463,8.9,0.19987541
15816,15816,Kyle Chipchura,2015-16,29.0,9,14,70,70,4,10,14,81.0,938.0,412,27,65,92,325.0,82,5.32,47,251,2453,8.9,0.19119611
15817,15817,Kyle Chipchura,2016-17,30.0,10,12,70,70,4,8,12,47.0,716.0,482,31,73,104,372.0,82,5.34,48,255,2438,9.0,0.16168562
15818,15818,Kyle Clifford,2011-12,21.0,2,14,76,76,7,7,14,69.0,722.0,76,7,7,14,69.0,82,5.46,52,291,2492,9.0,0.2517643
15819,15819,Kyle Clifford,2012-13,22.0,3,12,81,81,5,7,12,88.0,762.0,157,12,14,26,157.0,82,5.32,47,271,2439,8.9,0.23527661
15820,15820,Kyle Clifford,2013-14,23.0,4,14,48,48,7,7,14,56.0,509.0,205,19,21,40,213.0,48,5.31,29,160,1399,9.1,0.35137588
15821,15821,Kyle Clifford,2014-15,24.0,5,8,71,71,3,5,8,74.0,721.0,276,22,26,48,287.0,82,5.34,48,269,2463,8.9,0.23133957
15822,15822,Kyle Clifford,2015-16,25.0,6,15,80,80,6,9,15,117.0,859.0,356,28,35,63,404.0,82,5.32,47,251,2453,8.9,0.22497252
15823,15823,Kyle Clifford,2016-17,26.0,7,9,56,56,3,6,9,68.0,524.0,412,31,41,72,472.0,82,5.34,48,255,2438,9.0,0.17419377
15824,15824,Kyle Clifford,2017-18,27.0,8,12,73,73,6,6,12,122.0,783.0,485,37,47,84,594.0,82,5.45,47,245,2478,9.0,0.20954436
15825,15825,Kyle Clifford,2018-19,28.0,9,10,50,50,6,4,10,81.0,527.0,535,43,51,94,675.0,82,5.86,50,250,2620,9.2,0.24086106
15826,15826,Kyle Clifford,2019-20,29.0,10,21,72,72,11,10,21,115.0,755.0,607,54,61,115,790.0,82,5.96,47,239,2579,9.5,0.26095992
15827,15827,Kyle Clifford,2020-21,30.0,11,17,69,69,7,10,17,110.0,772.0,676,61,71,132,900.0,70,5.96,42,208,2192,9.5,0.26563835
15828,15828,Kyle Connor,2017-18,21.0,2,5,20,20,2,3,5,24.0,244.0,20,2,3,5,24.0,82,5.45,47,245,2478,9.0,0.3090828
15829,15829,Kyle Connor,2018-19,22.0,3,57,76,76,31,26,57,192.0,1285.0,96,33,29,62,216.0,82,5.86,50,250,2620,9.2,0.74317974
15830,15830,Kyle Connor,2019-20,23.0,4,66,82,82,34,32,66,227.0,1579.0,178,67,61,128,443.0,82,5.96,47,239,2579,9.5,0.8128892
15831,15831,Kyle Connor,2020-21,24.0,5,73,71,71,38,35,73,239.0,1497.0,249,105,96,201,682.0,70,5.96,42,208,2192,9.5,0.9950839
15832,15832,Kyle Criscuolo,2018-19,26.0,2,0,9,9,0,0,0,5.0,72.0,9,0,0,0,5.0,82,5.86,50,250,2620,9.2,0.16531053
15833,15833,Kyle Cumiskey,2007-08,21.0,2,2,9,9,1,1,2,8.0,121.0,9,1,1,2,8.0,82,5.76,70,398,2426,9.7,0.2528793
15834,15834,Kyle Cumiskey,2008-09,22.0,3,5,38,38,0,5,5,19.0,461.0,47,1,6,7,27.0,82,5.44,62,351,2383,9.4,0.12829891
15835,15835,Kyle Cumiskey,2009-10,23.0,4,0,6,6,0,0,0,2.0,51.0,53,1,6,7,29.0,82,5.7,65,341,2477,9.4,0.15679622
15836,15836,Kyle Cumiskey,2010-11,24.0,5,20,61,61,7,13,20,74.0,1208.0,114,8,19,27,103.0,82,5.53,56,304,2486,9.1,0.30686668
15837,15837,Kyle Cumiskey,2011-12,25.0,6,8,18,18,1,7,8,21.0,354.0,132,9,26,35,124.0,82,5.46,52,291,2492,9.0,0.21300364
15838,15838,Kyle Cumiskey,2015-16,29.0,7,0,7,7,0,0,0,5.0,93.0,139,9,26,35,129.0,82,5.32,47,251,2453,8.9,0.13230526
15839,15839,Kyle Freadrich,2000-01,22.0,2,0,10,10,0,0,0,0.0,23.0,10,0,0,0,0.0,82,5.49,53,331,2294,9.8,0.13374805
15840,15840,Kyle Freadrich,2001-02,23.0,3,1,13,13,0,1,1,3.0,46.0,23,0,1,1,3.0,82,5.51,63,376,2272,9.9,0.15840498
15841,15841,Kyle Greentree,2008-09,25.0,2,0,2,2,0,0,0,3.0,18.0,2,0,0,0,3.0,82,5.44,62,351,2383,9.4,0.17526406
15842,15842,Kyle Greentree,2009-10,26.0,3,0,2,2,0,0,0,3.0,19.0,4,0,0,0,6.0,82,5.7,65,341,2477,9.4,0.17323917
15843,15843,Kyle McLaren,1996-97,19.0,2,17,74,74,5,12,17,74.0,,74,5,12,17,74.0,82,6.29,74,413,2481,10.4,0.29864222
15844,15844,Kyle McLaren,1997-98,20.0,3,14,58,58,5,9,14,68.0,,132,10,21,31,142.0,82,5.83,55,336,2444,9.8,0.30285746
15845,15845,Kyle McLaren,1998-99,21.0,4,25,66,66,5,20,25,101.0,,198,15,41,56,243.0,82,5.28,57,380,2242,9.6,0.3854581
15846,15846,Kyle McLaren,1999-00,22.0,5,24,52,52,6,18,24,97.0,1218.0,250,21,59,80,340.0,82,5.27,57,359,2285,9.4,0.43883252
15847,15847,Kyle McLaren,2000-01,23.0,6,19,71,71,8,11,19,142.0,1654.0,321,29,70,99,482.0,82,5.49,53,331,2294,9.8,0.38170993
15848,15848,Kyle McLaren,2001-02,24.0,7,17,58,58,5,12,17,91.0,1405.0,379,34,82,116,573.0,82,5.51,63,376,2272,9.9,0.33933467
15849,15849,Kyle McLaren,2002-03,25.0,8,8,38,38,0,8,8,57.0,735.0,417,34,90,124,630.0,82,5.24,53,338,2262,9.5,0.23716304
15850,15850,Kyle McLaren,2003-04,26.0,9,8,33,33,0,8,8,43.0,748.0,450,34,98,132,673.0,82,5.31,60,363,2326,9.4,0.24082515
15851,15851,Kyle McLaren,2004-05,27.0,10,24,64,64,2,22,24,67.0,1345.0,514,36,120,156,740.0,82,5.14,57,348,2300,9.2,0.31806612
15852,15852,Kyle McLaren,2006-07,29.0,11,23,77,77,2,21,23,67.0,1761.0,591,38,141,179,807.0,82,6.05,85,480,2458,10.1,0.23009604
15853,15853,Kyle McLaren,2007-08,30.0,12,17,67,67,5,12,17,43.0,1435.0,658,43,153,196,850.0,82,5.76,70,398,2426,9.7,0.21762973
15854,15854,Kyle McLaren,2008-09,31.0,13,11,61,61,3,8,11,39.0,1120.0,719,46,161,207,889.0,82,5.44,62,351,2383,9.4,0.16274971
15855,15855,Kyle Okposo,2008-09,20.0,2,5,9,9,2,3,5,15.0,148.0,9,2,3,5,15.0,82,5.44,62,351,2383,9.4,0.3097605
15856,15856,Kyle Okposo,2009-10,21.0,3,39,65,65,18,21,39,165.0,1171.0,74,20,24,44,180.0,82,5.7,65,341,2477,9.4,0.6510387
15857,15857,Kyle Okposo,2010-11,22.0,4,52,80,80,19,33,52,249.0,1643.0,154,39,57,96,429.0,82,5.53,56,304,2486,9.1,0.6648049
15858,15858,Kyle Okposo,2011-12,23.0,5,20,38,38,5,15,20,72.0,630.0,192,44,72,116,501.0,82,5.46,52,291,2492,9.0,0.5518127
15859,15859,Kyle Okposo,2012-13,24.0,6,45,79,79,24,21,45,152.0,1348.0,271,68,93,161,653.0,82,5.32,47,271,2439,8.9,0.59048265
15860,15860,Kyle Okposo,2013-14,25.0,7,24,48,48,4,20,24,101.0,814.0,319,72,113,185,754.0,48,5.31,29,160,1399,9.1,0.5830274
15861,15861,Kyle Okposo,2014-15,26.0,8,69,71,71,27,42,69,195.0,1451.0,390,99,155,254,949.0,82,5.34,48,269,2463,8.9,0.83822185
15862,15862,Kyle Okposo,2015-16,27.0,9,51,60,60,18,33,51,195.0,1173.0,450,117,188,305,1144.0,82,5.32,47,251,2453,8.9,0.73336136
15863,15863,Kyle Okposo,2016-17,28.0,10,64,79,79,22,42,64,202.0,1438.0,529,139,230,369,1346.0,82,5.34,48,255,2438,9.0,0.7584639
15864,15864,Kyle Okposo,2017-18,29.0,11,45,65,65,19,26,45,156.0,1233.0,594,158,256,414,1502.0,82,5.45,47,245,2478,9.0,0.6103837
15865,15865,Kyle Okposo,2018-19,30.0,12,44,76,76,15,29,44,161.0,1294.0,670,173,285,458,1663.0,82,5.86,50,250,2620,9.2,0.53209203
15866,15866,Kyle Okposo,2019-20,31.0,13,29,78,78,14,15,29,147.0,1075.0,748,187,300,487,1810.0,82,5.96,47,239,2579,9.5,0.392706
15867,15867,Kyle Okposo,2020-21,32.0,14,19,52,52,9,10,19,82.0,668.0,800,196,310,506,1892.0,70,5.96,42,208,2192,9.5,0.42221287
15868,15868,Kyle Palmieri,2011-12,20.0,2,1,10,10,1,0,1,10.0,87.0,10,1,0,1,10.0,82,5.46,52,291,2492,9.0,0.2832756
15869,15869,Kyle Palmieri,2012-13,21.0,3,7,18,18,4,3,7,34.0,207.0,28,5,3,8,44.0,82,5.32,47,271,2439,8.9,0.36589977
15870,15870,Kyle Palmieri,2013-14,22.0,4,21,42,42,10,11,21,92.0,518.0,70,15,14,29,136.0,48,5.31,29,160,1399,9.1,0.47288442
15871,15871,Kyle Palmieri,2014-15,23.0,5,31,71,71,14,17,31,147.0,848.0,141,29,31,60,283.0,82,5.34,48,269,2463,8.9,0.45132875
15872,15872,Kyle Palmieri,2015-16,24.0,6,29,57,57,14,15,29,112.0,804.0,198,43,46,89,395.0,82,5.32,47,251,2453,8.9,0.4726362
15873,15873,Kyle Palmieri,2016-17,25.0,7,57,82,82,30,27,57,222.0,1460.0,280,73,73,146,617.0,82,5.34,48,255,2438,9.0,0.6637083
15874,15874,Kyle Palmieri,2017-18,26.0,8,53,80,80,26,27,53,192.0,1388.0,360,99,100,199,809.0,82,5.45,47,245,2478,9.0,0.6964513
15875,15875,Kyle Palmieri,2018-19,27.0,9,44,62,62,24,20,44,181.0,1073.0,422,123,120,243,990.0,82,5.86,50,250,2620,9.2,0.65349925
15876,15876,Kyle Palmieri,2019-20,28.0,10,50,74,74,27,23,50,224.0,1343.0,496,150,143,293,1214.0,82,5.96,47,239,2579,9.5,0.65315694
15877,15877,Kyle Palmieri,2020-21,29.0,11,45,65,65,25,20,45,155.0,1112.0,561,175,163,338,1369.0,70,5.96,42,208,2192,9.5,0.6442461
15878,15878,Kyle Quincey,2006-07,21.0,2,0,1,1,0,0,0,1.0,12.0,1,0,0,0,1.0,82,6.05,85,480,2458,10.1,0.195333
15879,15879,Kyle Quincey,2007-08,22.0,3,1,6,6,1,0,1,7.0,69.0,7,1,0,1,8.0,82,5.76,70,398,2426,9.7,0.229292
15880,15880,Kyle Quincey,2008-09,23.0,4,0,6,6,0,0,0,5.0,84.0,13,1,0,1,13.0,82,5.44,62,351,2383,9.4,0.16898668
15881,15881,Kyle Quincey,2009-10,24.0,5,38,72,72,4,34,38,150.0,1511.0,85,5,34,39,163.0,82,5.7,65,341,2477,9.4,0.43896872
15882,15882,Kyle Quincey,2010-11,25.0,6,29,79,79,6,23,29,139.0,1865.0,164,11,57,68,302.0,82,5.53,56,304,2486,9.1,0.36805058
15883,15883,Kyle Quincey,2011-12,26.0,7,1,21,21,0,1,1,39.0,411.0,185,11,58,69,341.0,82,5.46,52,291,2492,9.0,0.21660599
15884,15884,Kyle Quincey,2012-13,27.0,8,26,72,72,7,19,26,168.0,1574.0,257,18,77,95,509.0,82,5.32,47,271,2439,8.9,0.31381127
15885,15885,Kyle Quincey,2013-14,28.0,9,3,36,36,1,2,3,36.0,692.0,293,19,79,98,545.0,48,5.31,29,160,1399,9.1,0.18232188
15886,15886,Kyle Quincey,2014-15,29.0,10,13,82,82,4,9,13,106.0,1706.0,375,23,88,111,651.0,82,5.34,48,269,2463,8.9,0.21886632
15887,15887,Kyle Quincey,2015-16,30.0,11,18,73,73,3,15,18,90.0,1422.0,448,26,103,129,741.0,82,5.32,47,251,2453,8.9,0.22996819
15888,15888,Kyle Quincey,2016-17,31.0,12,11,47,47,4,7,11,62.0,929.0,495,30,110,140,803.0,82,5.34,48,255,2438,9.0,0.17828223
15889,15889,Kyle Quincey,2017-18,32.0,13,15,73,73,6,9,15,79.0,1306.0,568,36,119,155,882.0,82,5.45,47,245,2478,9.0,0.18642077
15890,15890,Kyle Quincey,2018-19,33.0,14,3,18,18,0,3,3,11.0,257.0,586,36,122,158,893.0,82,5.86,50,250,2620,9.2,0.144963
15891,15891,Kyle Rau,2016-17,24.0,2,0,9,9,0,0,0,15.0,113.0,9,0,0,0,15.0,82,5.34,48,255,2438,9.0,0.18053848
15892,15892,Kyle Rau,2017-18,25.0,3,3,24,24,2,1,3,21.0,230.0,33,2,1,3,36.0,82,5.45,47,245,2478,9.0,0.20060787
15893,15893,Kyle Rau,2018-19,26.0,4,1,3,3,0,1,1,4.0,33.0,36,2,2,4,40.0,82,5.86,50,250,2620,9.2,0.15902498
15894,15894,Kyle Rau,2019-20,27.0,5,1,6,6,0,1,1,6.0,42.0,42,2,3,5,46.0,82,5.96,47,239,2579,9.5,0.134518
15895,15895,Kyle Rossiter,2002-03,22.0,2,0,2,2,0,0,0,0.0,31.0,2,0,0,0,0.0,82,5.24,53,338,2262,9.5,0.157395
15896,15896,Kyle Rossiter,2003-04,23.0,3,0,3,3,0,0,0,0.0,30.0,5,0,0,0,0.0,82,5.31,60,363,2326,9.4,0.15707734
15897,15897,Kyle Rossiter,2004-05,24.0,4,1,6,6,0,1,1,1.0,68.0,11,0,1,1,1.0,82,5.14,57,348,2300,9.2,0.18121871
15898,15898,Kyle Turris,2008-09,19.0,2,1,3,3,0,1,1,11.0,59.0,3,0,1,1,11.0,82,5.44,62,351,2383,9.4,0.27982897
15899,15899,Kyle Turris,2009-10,20.0,3,20,63,63,8,12,20,91.0,814.0,66,8,13,21,102.0,82,5.7,65,341,2477,9.4,0.3690374
15900,15900,Kyle Turris,2011-12,22.0,4,25,65,65,11,14,25,116.0,733.0,131,19,27,46,218.0,82,5.46,52,291,2492,9.0,0.3689314
15901,15901,Kyle Turris,2012-13,23.0,5,29,55,55,12,17,29,142.0,927.0,186,31,44,75,360.0,82,5.32,47,271,2439,8.9,0.5386987
15902,15902,Kyle Turris,2013-14,24.0,6,29,48,48,12,17,29,118.0,943.0,234,43,61,104,478.0,48,5.31,29,160,1399,9.1,0.5542172
15903,15903,Kyle Turris,2014-15,25.0,7,58,82,82,26,32,58,215.0,1536.0,316,69,93,162,693.0,82,5.34,48,269,2463,8.9,0.68074095
15904,15904,Kyle Turris,2015-16,26.0,8,64,82,82,24,40,64,215.0,1576.0,398,93,133,226,908.0,82,5.32,47,251,2453,8.9,0.7186165
15905,15905,Kyle Turris,2016-17,27.0,9,30,57,57,13,17,30,122.0,1123.0,455,106,150,256,1030.0,82,5.34,48,255,2438,9.0,0.4754441
15906,15906,Kyle Turris,2017-18,28.0,10,55,78,78,27,28,55,185.0,1521.0,533,133,178,311,1215.0,82,5.45,47,245,2478,9.0,0.6535585
15907,15907,Kyle Turris,2018-19,29.0,11,51,76,76,16,35,51,145.0,1263.0,609,149,213,362,1360.0,82,5.86,50,250,2620,9.2,0.58512825
15908,15908,Kyle Turris,2019-20,30.0,12,23,55,55,7,16,23,78.0,863.0,664,156,229,385,1438.0,82,5.96,47,239,2579,9.5,0.41785645
15909,15909,Kyle Turris,2020-21,31.0,13,31,62,62,9,22,31,88.0,956.0,726,165,251,416,1526.0,70,5.96,42,208,2192,9.5,0.44460732
15910,15910,Kyle Wanvig,2003-04,23.0,2,1,7,7,1,0,1,5.0,65.0,7,1,0,1,5.0,82,5.31,60,363,2326,9.4,0.22790256
15911,15911,Kyle Wanvig,2004-05,24.0,3,1,6,6,0,1,1,16.0,83.0,13,1,1,2,21.0,82,5.14,57,348,2300,9.2,0.19351026
15912,15912,Kyle Wanvig,2006-07,26.0,4,12,51,51,4,8,12,55.0,543.0,64,5,9,14,76.0,82,6.05,85,480,2458,10.1,0.19783929
15913,15913,Kyle Wanvig,2007-08,27.0,5,0,4,4,0,0,0,0.0,21.0,68,5,9,14,76.0,82,5.76,70,398,2426,9.7,0.15606326
15914,15914,Kyle Wanvig,2008-09,28.0,6,1,7,7,1,0,1,10.0,71.0,75,6,9,15,86.0,82,5.44,62,351,2383,9.4,0.20057747
15915,15915,Kyle Wellwood,2004-05,21.0,2,0,1,1,0,0,0,1.0,8.0,1,0,0,0,1.0,82,5.14,57,348,2300,9.2,0.315835
15916,15916,Kyle Wellwood,2006-07,23.0,3,45,81,81,11,34,45,117.0,1035.0,82,11,34,45,118.0,82,6.05,85,480,2458,10.1,0.5252021
15917,15917,Kyle Wellwood,2007-08,24.0,4,42,48,48,12,30,42,99.0,798.0,130,23,64,87,217.0,82,5.76,70,398,2426,9.7,0.633508
15918,15918,Kyle Wellwood,2008-09,25.0,5,21,59,59,8,13,21,57.0,746.0,189,31,77,108,274.0,82,5.44,62,351,2383,9.4,0.34731877
15919,15919,Kyle Wellwood,2009-10,26.0,6,27,74,74,18,9,27,94.0,1021.0,263,49,86,135,368.0,82,5.7,65,341,2477,9.4,0.4138463
15920,15920,Kyle Wellwood,2010-11,27.0,7,25,75,75,14,11,25,98.0,1040.0,338,63,97,160,466.0,82,5.53,56,304,2486,9.1,0.37266865
15921,15921,Kyle Wellwood,2011-12,28.0,8,13,35,35,5,8,13,50.0,479.0,373,68,105,173,516.0,82,5.46,52,291,2492,9.0,0.3816834
15922,15922,Kyle Wellwood,2012-13,29.0,9,47,77,77,18,29,47,93.0,1151.0,450,86,134,220,609.0,82,5.32,47,271,2439,8.9,0.50591373
15923,15923,Kyle Wellwood,2013-14,30.0,10,15,39,39,6,9,15,37.0,506.0,489,92,143,235,646.0,48,5.31,29,160,1399,9.1,0.39108688
15924,15924,Kyle Wilson,2010-11,26.0,2,2,2,2,0,2,2,1.0,19.0,2,0,2,2,1.0,82,5.53,56,304,2486,9.1,0.19476879
15925,15925,Kyle Wilson,2011-12,27.0,3,11,32,32,4,7,11,38.0,340.0,34,4,9,13,39.0,82,5.46,52,291,2492,9.0,0.20995429
15926,15926,Kyle Wilson,2012-13,28.0,4,0,5,5,0,0,0,2.0,41.0,39,4,9,13,41.0,82,5.32,47,271,2439,8.9,0.13458556
15927,15927,Kyosti Karjalainen,1992-93,25.0,2,9,28,28,1,8,9,20.0,,28,1,8,9,20.0,80,6.96,77,402,2440,11.4,0.2401543
15928,15928,Ladislav Benysek,1998-99,23.0,2,0,2,2,0,0,0,0.0,,2,0,0,0,0.0,82,5.28,57,380,2242,9.6,0.15889817
15929,15929,Ladislav Benysek,2001-02,26.0,3,7,71,71,2,5,7,48.0,1307.0,73,2,5,7,48.0,82,5.51,63,376,2272,9.9,0.13579592
15930,15930,Ladislav Benysek,2002-03,27.0,4,8,74,74,1,7,8,44.0,1417.0,147,3,12,15,92.0,82,5.24,53,338,2262,9.5,0.12754703
15931,15931,Ladislav Benysek,2003-04,28.0,5,0,14,14,0,0,0,7.0,160.0,161,3,12,15,99.0,82,5.31,60,363,2326,9.4,0.12603104
15932,15932,Ladislav Karabin,1994-95,24.0,2,0,9,9,0,0,0,3.0,,9,0,0,0,3.0,84,6.48,76,407,2545,10.7,0.17295086
15933,15933,Ladislav Kohn,1996-97,21.0,2,1,5,5,1,0,1,8.0,,5,1,0,1,8.0,82,6.29,74,413,2481,10.4,0.2425819
15934,15934,Ladislav Kohn,1998-99,23.0,3,1,4,4,0,1,1,2.0,,9,1,1,2,10.0,82,5.28,57,380,2242,9.6,0.1999802
15935,15935,Ladislav Kohn,1999-00,24.0,4,4,16,16,1,3,4,23.0,201.0,25,2,4,6,33.0,82,5.27,57,359,2285,9.4,0.23354849
15936,15936,Ladislav Kohn,2000-01,25.0,5,21,77,77,5,16,21,123.0,932.0,102,7,20,27,156.0,82,5.49,53,331,2294,9.8,0.2609358
15937,15937,Ladislav Kohn,2001-02,26.0,6,14,77,77,7,7,14,129.0,914.0,179,14,27,41,285.0,82,5.51,63,376,2272,9.9,0.23603919
15938,15938,Ladislav Kohn,2002-03,27.0,7,0,4,4,0,0,0,2.0,21.0,183,14,27,41,287.0,82,5.24,53,338,2262,9.5,0.1414504
15939,15939,Ladislav Kohn,2003-04,28.0,8,1,3,3,0,1,1,3.0,27.0,186,14,28,42,290.0,82,5.31,60,363,2326,9.4,0.14827845
15940,15940,Ladislav Nagy,2000-01,21.0,2,6,11,11,2,4,6,15.0,136.0,11,2,4,6,15.0,82,5.49,53,331,2294,9.8,0.28338444
15941,15941,Ladislav Nagy,2001-02,22.0,3,17,46,46,8,9,17,64.0,598.0,57,10,13,23,79.0,82,5.51,63,376,2272,9.9,0.34937882
15942,15942,Ladislav Nagy,2002-03,23.0,4,42,74,74,23,19,42,187.0,1115.0,131,33,32,65,266.0,82,5.24,53,338,2262,9.5,0.5841856
15943,15943,Ladislav Nagy,2003-04,24.0,5,57,80,80,22,35,57,209.0,1397.0,211,55,67,122,475.0,82,5.31,60,363,2326,9.4,0.7023531
15944,15944,Ladislav Nagy,2004-05,25.0,6,52,55,55,24,28,52,160.0,999.0,266,79,95,174,635.0,82,5.14,57,348,2300,9.2,0.9401411
15945,15945,Ladislav Nagy,2006-07,27.0,7,56,51,51,15,41,56,132.0,963.0,317,94,136,230,767.0,82,6.05,85,480,2458,10.1,0.82590926
15946,15946,Ladislav Nagy,2007-08,28.0,8,55,80,80,12,43,55,146.0,1386.0,397,106,179,285,913.0,82,5.76,70,398,2426,9.7,0.63092315
15947,15947,Ladislav Nagy,2008-09,29.0,9,26,38,38,9,17,26,78.0,524.0,435,115,196,311,991.0,82,5.44,62,351,2383,9.4,0.59606814
15948,15948,Ladislav Smid,2007-08,21.0,2,10,77,77,3,7,10,53.0,1481.0,77,3,7,10,53.0,82,5.76,70,398,2426,9.7,0.21060517
15949,15949,Ladislav Smid,2008-09,22.0,3,4,65,65,0,4,4,45.0,1161.0,142,3,11,14,98.0,82,5.44,62,351,2383,9.4,0.16078177
15950,15950,Ladislav Smid,2009-10,23.0,4,11,60,60,0,11,11,33.0,897.0,202,3,22,25,131.0,82,5.7,65,341,2477,9.4,0.18149626
15951,15951,Ladislav Smid,2010-11,24.0,5,9,51,51,1,8,9,36.0,978.0,253,4,30,34,167.0,82,5.53,56,304,2486,9.1,0.17427656
15952,15952,Ladislav Smid,2011-12,25.0,6,10,78,78,0,10,10,48.0,1582.0,331,4,40,44,215.0,82,5.46,52,291,2492,9.0,0.1493114
15953,15953,Ladislav Smid,2012-13,26.0,7,15,78,78,5,10,15,47.0,1631.0,409,9,50,59,262.0,82,5.32,47,271,2439,8.9,0.16915858
15954,15954,Ladislav Smid,2013-14,27.0,8,4,48,48,1,3,4,30.0,975.0,457,10,53,63,292.0,48,5.31,29,160,1399,9.1,0.13453344
15955,15955,Ladislav Smid,2014-15,28.0,9,8,73,73,2,6,8,41.0,1323.0,530,12,59,71,333.0,82,5.34,48,269,2463,8.9,0.14593834
15956,15956,Ladislav Smid,2015-16,29.0,10,1,31,31,0,1,1,21.0,433.0,561,12,60,72,354.0,82,5.32,47,251,2453,8.9,0.12654254
15957,15957,Ladislav Smid,2016-17,30.0,11,0,22,22,0,0,0,11.0,255.0,583,12,60,72,365.0,82,5.34,48,255,2438,9.0,0.094677985
15958,15958,Lance Bouma,2011-12,21.0,2,1,16,16,0,1,1,9.0,94.0,16,0,1,1,9.0,82,5.46,52,291,2492,9.0,0.2221227
15959,15959,Lance Bouma,2012-13,22.0,3,3,27,27,1,2,3,26.0,274.0,43,1,3,4,35.0,82,5.32,47,271,2439,8.9,0.19305792
15960,15960,Lance Bouma,2014-15,24.0,4,15,78,78,5,10,15,82.0,983.0,121,6,13,19,117.0,82,5.34,48,269,2463,8.9,0.2246528
15961,15961,Lance Bouma,2015-16,25.0,5,34,78,78,16,18,34,104.0,1093.0,199,22,31,53,221.0,82,5.32,47,251,2453,8.9,0.38504
15962,15962,Lance Bouma,2016-17,26.0,6,7,44,44,2,5,7,49.0,530.0,243,24,36,60,270.0,82,5.34,48,255,2438,9.0,0.19914976
15963,15963,Lance Bouma,2017-18,27.0,7,7,61,61,3,4,7,53.0,692.0,304,27,40,67,323.0,82,5.45,47,245,2478,9.0,0.15474972
15964,15964,Lance Bouma,2018-19,28.0,8,9,53,53,3,6,9,56.0,564.0,357,30,46,76,379.0,82,5.86,50,250,2620,9.2,0.15765777
15965,15965,Lance Nethery,1981-82,24.0,2,23,33,33,11,12,23,47.0,,33,11,12,23,47.0,80,7.69,77,340,2441,12.6,0.510556
15966,15966,Lance Nethery,1982-83,25.0,3,2,8,8,0,2,2,5.0,,41,11,14,25,52.0,80,8.03,73,320,2489,12.9,0.25965232
15967,15967,Lance Pitlick,1995-96,28.0,2,1,15,15,0,1,1,11.0,,15,0,1,1,11.0,48,5.97,37,209,1408,10.2,0.19575003
15968,15968,Lance Pitlick,1996-97,29.0,3,7,28,28,1,6,7,13.0,,43,1,7,8,24.0,82,6.29,74,413,2481,10.4,0.14340273
15969,15969,Lance Pitlick,1997-98,30.0,4,10,66,66,5,5,10,54.0,,109,6,12,18,78.0,82,5.83,55,336,2444,9.8,0.16441277
15970,15970,Lance Pitlick,1998-99,31.0,5,9,69,69,2,7,9,66.0,,178,8,19,27,144.0,82,5.28,57,380,2242,9.6,0.14222416
15971,15971,Lance Pitlick,1999-00,32.0,6,9,50,50,3,6,9,34.0,833.0,228,11,25,36,178.0,82,5.27,57,359,2285,9.4,0.13610065
15972,15972,Lance Pitlick,2000-01,33.0,7,8,62,62,3,5,8,26.0,1027.0,290,14,30,44,204.0,82,5.49,53,331,2294,9.8,0.09800592
15973,15973,Lance Pitlick,2001-02,34.0,8,3,68,68,1,2,3,24.0,924.0,358,15,32,47,228.0,82,5.51,63,376,2272,9.9,0.09735274
15974,15974,Lance Pitlick,2002-03,35.0,9,2,35,35,1,1,2,15.0,328.0,393,16,33,49,243.0,82,5.24,53,338,2262,9.5,0.101177365
15975,15975,Lance Ward,2001-02,23.0,2,2,30,30,0,2,2,17.0,475.0,30,0,2,2,17.0,82,5.51,63,376,2272,9.9,0.1432277
15976,15976,Lance Ward,2002-03,24.0,3,5,68,68,1,4,5,39.0,987.0,98,1,6,7,56.0,82,5.24,53,338,2262,9.5,0.14547673
15977,15977,Lance Ward,2003-04,25.0,4,5,65,65,3,2,5,52.0,535.0,163,4,8,12,108.0,82,5.31,60,363,2326,9.4,0.15168512
15978,15978,Lance Ward,2004-05,26.0,5,4,46,46,0,4,4,26.0,399.0,209,4,12,16,134.0,82,5.14,57,348,2300,9.2,0.13519537
15979,15979,Landon Ferraro,2014-15,23.0,2,0,4,4,0,0,0,2.0,36.0,4,0,0,0,2.0,82,5.34,48,269,2463,8.9,0.17318648
15980,15980,Landon Ferraro,2015-16,24.0,3,1,3,3,1,0,1,4.0,36.0,7,1,0,1,6.0,82,5.32,47,251,2453,8.9,0.20199013
15981,15981,Landon Ferraro,2016-17,25.0,4,10,68,68,5,5,10,77.0,722.0,75,6,5,11,83.0,82,5.34,48,255,2438,9.0,0.21276891
15982,15982,Landon Ferraro,2018-19,27.0,5,1,2,2,1,0,1,3.0,9.0,77,7,5,12,86.0,82,5.86,50,250,2620,9.2,0.16248316
15983,15983,Landon Wilson,1996-97,21.0,2,1,7,7,1,0,1,6.0,,7,1,0,1,6.0,82,6.29,74,413,2481,10.4,0.23457137
15984,15984,Landon Wilson,1997-98,22.0,3,20,49,49,8,12,20,83.0,,56,9,12,21,89.0,82,5.83,55,336,2444,9.8,0.4131724
15985,15985,Landon Wilson,1998-99,23.0,4,6,28,28,1,5,6,26.0,,84,10,17,27,115.0,82,5.28,57,380,2242,9.6,0.2769887
15986,15986,Landon Wilson,1999-00,24.0,5,6,22,22,3,3,6,32.0,221.0,106,13,20,33,147.0,82,5.27,57,359,2285,9.4,0.27460873
15987,15987,Landon Wilson,2000-01,25.0,6,4,40,40,1,3,4,67.0,406.0,146,14,23,37,214.0,82,5.49,53,331,2294,9.8,0.17877579
15988,15988,Landon Wilson,2001-02,26.0,7,31,70,70,18,13,31,123.0,800.0,216,32,36,68,337.0,82,5.51,63,376,2272,9.9,0.4208802
15989,15989,Landon Wilson,2002-03,27.0,8,19,47,47,7,12,19,100.0,604.0,263,39,48,87,437.0,82,5.24,53,338,2262,9.5,0.37005875
15990,15990,Landon Wilson,2003-04,28.0,9,14,31,31,6,8,14,92.0,378.0,294,45,56,101,529.0,82,5.31,60,363,2326,9.4,0.32388163
15991,15991,Landon Wilson,2004-05,29.0,10,10,54,54,6,4,10,76.0,560.0,348,51,60,111,605.0,82,5.14,57,348,2300,9.2,0.28053874
15992,15992,Landon Wilson,2009-10,34.0,11,8,27,27,2,6,8,34.0,249.0,375,53,66,119,639.0,82,5.7,65,341,2477,9.4,0.21968704
15993,15993,Lane Lambert,1984-85,20.0,2,35,73,73,20,15,35,88.0,,73,20,15,35,88.0,80,7.89,74,336,2448,12.9,0.5025387
15994,15994,Lane Lambert,1985-86,21.0,3,25,69,69,14,11,25,67.0,,142,34,26,60,155.0,80,7.77,71,321,2447,12.7,0.41532627
15995,15995,Lane Lambert,1986-87,22.0,4,5,34,34,2,3,5,32.0,,176,36,29,65,187.0,80,7.94,82,370,2484,12.8,0.3695386
15996,15996,Lane Lambert,1987-88,23.0,5,14,33,33,7,7,14,43.0,,209,43,36,79,230.0,80,7.34,72,344,2400,12.2,0.45445615
15997,15997,Lane Lambert,1988-89,24.0,6,41,61,61,13,28,41,98.0,,270,56,64,120,328.0,80,7.43,89,437,2435,12.2,0.52690655
15998,15998,Lane Lambert,1989-90,25.0,7,4,13,13,2,2,4,19.0,,283,58,66,124,347.0,80,7.48,85,403,2430,12.3,0.37372035
15999,15999,Lane MacDermid,2012-13,23.0,2,0,5,5,0,0,0,6.0,45.0,5,0,0,0,6.0,82,5.32,47,271,2439,8.9,0.17154336
16000,16000,Lane MacDermid,2013-14,24.0,3,2,9,9,2,0,2,4.0,41.0,14,2,0,2,10.0,48,5.31,29,160,1399,9.1,0.26325935
16001,16001,Lane MacDermid,2014-15,25.0,4,2,7,7,0,2,2,1.0,39.0,21,2,2,4,11.0,82,5.34,48,269,2463,8.9,0.1676814
16002,16002,Larry Courville,1996-97,21.0,2,1,3,3,1,0,1,2.0,,3,1,0,1,2.0,82,6.29,74,413,2481,10.4,0.22342837
16003,16003,Larry Courville,1997-98,22.0,3,2,19,19,0,2,2,11.0,,22,1,2,3,13.0,82,5.83,55,336,2444,9.8,0.12419742
16004,16004,Larry Courville,1998-99,23.0,4,0,11,11,0,0,0,3.0,,33,1,2,3,16.0,82,5.28,57,380,2242,9.6,0.15559322
16005,16005,Larry DePalma,1986-87,21.0,2,0,1,1,0,0,0,0.0,,1,0,0,0,0.0,80,7.94,82,370,2484,12.8,0.20334706
16006,16006,Larry DePalma,1987-88,22.0,3,15,56,56,9,6,15,56.0,,57,9,6,15,56.0,80,7.34,72,344,2400,12.2,0.32213458
16007,16007,Larry DePalma,1988-89,23.0,4,2,7,7,1,1,2,8.0,,64,10,7,17,64.0,80,7.43,89,437,2435,12.2,0.26953632
16008,16008,Larry DePalma,1989-90,24.0,5,12,43,43,5,7,12,42.0,,107,15,14,29,106.0,80,7.48,85,403,2430,12.3,0.2925654
16009,16009,Larry DePalma,1991-92,26.0,6,3,14,14,3,0,3,18.0,,121,18,14,32,124.0,80,6.91,71,366,2385,11.6,0.3090406
16010,16010,Larry DePalma,1993-94,28.0,7,8,20,20,2,6,8,29.0,,141,20,20,40,153.0,84,7.25,87,443,2603,11.7,0.26043296
16011,16011,Larry DePalma,1994-95,29.0,8,1,7,7,1,0,1,2.0,,148,21,20,41,155.0,84,6.48,76,407,2545,10.7,0.16762146
16012,16012,Larry Floyd,1983-84,22.0,2,1,5,5,1,0,1,9.0,,5,1,0,1,9.0,80,7.73,71,310,2444,12.7,0.29718515
16013,16013,Larry Floyd,1984-85,23.0,3,4,7,7,1,3,4,15.0,,12,2,3,5,24.0,80,7.89,74,336,2448,12.9,0.26891208
16014,16014,Larry Landon,1984-85,26.0,2,0,2,2,0,0,0,5.0,,2,0,0,0,5.0,80,7.89,74,336,2448,12.9,0.22462675
16015,16015,Larry Landon,1985-86,27.0,3,0,7,7,0,0,0,5.0,,9,0,0,0,10.0,80,7.77,71,321,2447,12.7,0.19933069
16016,16016,Larry Melnyk,1981-82,21.0,2,4,26,26,0,4,4,30.0,,26,0,4,4,30.0,80,7.69,77,340,2441,12.6,0.2956361
16017,16017,Larry Melnyk,1982-83,22.0,3,8,48,48,0,8,8,40.0,,74,0,12,12,70.0,80,8.03,73,320,2489,12.9,0.17596582
16018,16018,Larry Melnyk,1983-84,23.0,4,0,1,1,0,0,0,2.0,,75,0,12,12,72.0,80,7.73,71,310,2444,12.7,0.19136393
16019,16019,Larry Melnyk,1985-86,25.0,5,11,28,28,0,11,11,8.0,,103,0,23,23,80.0,80,7.77,71,321,2447,12.7,0.21324977
16020,16020,Larry Melnyk,1986-87,26.0,6,14,52,52,3,11,14,37.0,,155,3,34,37,117.0,80,7.94,82,370,2484,12.8,0.24967685
16021,16021,Larry Melnyk,1987-88,27.0,7,15,73,73,3,12,15,53.0,,228,6,46,52,170.0,80,7.34,72,344,2400,12.2,0.2102974
16022,16022,Larry Melnyk,1988-89,28.0,8,6,63,63,2,4,6,40.0,,291,8,50,58,210.0,80,7.43,89,437,2435,12.2,0.16439143
16023,16023,Larry Melnyk,1989-90,29.0,9,14,74,74,3,11,14,59.0,,365,11,61,72,269.0,80,7.48,85,403,2430,12.3,0.19313991
16024,16024,Larry Melnyk,1990-91,30.0,10,2,67,67,0,2,2,45.0,,432,11,63,74,314.0,80,7.37,76,367,2421,12.2,0.13525736
16025,16025,Larry Murphy,1981-82,20.0,2,76,80,80,16,60,76,153.0,,80,16,60,76,153.0,80,7.69,77,340,2441,12.6,0.9265401
16026,16026,Larry Murphy,1982-83,21.0,3,66,79,79,22,44,66,191.0,,159,38,104,142,344.0,80,8.03,73,320,2489,12.9,0.8585323
16027,16027,Larry Murphy,1983-84,22.0,4,62,77,77,14,48,62,172.0,,236,52,152,204,516.0,80,7.73,71,310,2444,12.7,0.81635857
16028,16028,Larry Murphy,1984-85,23.0,5,49,78,78,13,36,49,149.0,,314,65,188,253,665.0,80,7.89,74,336,2448,12.9,0.6953319
16029,16029,Larry Murphy,1985-86,24.0,6,56,79,79,14,42,56,153.0,,393,79,230,309,818.0,80,7.77,71,321,2447,12.7,0.7537131
16030,16030,Larry Murphy,1986-87,25.0,7,65,78,78,21,44,65,180.0,,471,100,274,374,998.0,80,7.94,82,370,2484,12.8,0.83727
16031,16031,Larry Murphy,1987-88,26.0,8,81,80,80,23,58,81,224.0,,551,123,332,455,1222.0,80,7.34,72,344,2400,12.2,0.9703294
16032,16032,Larry Murphy,1988-89,27.0,9,61,79,79,8,53,61,201.0,,630,131,385,516,1423.0,80,7.43,89,437,2435,12.2,0.7543259
16033,16033,Larry Murphy,1989-90,28.0,10,46,78,78,11,35,46,160.0,,708,142,420,562,1583.0,80,7.48,85,403,2430,12.3,0.6121486
16034,16034,Larry Murphy,1990-91,29.0,11,68,77,77,10,58,68,173.0,,785,152,478,630,1756.0,80,7.37,76,367,2421,12.2,0.7282089
16035,16035,Larry Murphy,1991-92,30.0,12,43,75,75,9,34,43,188.0,,860,161,512,673,1944.0,80,6.91,71,366,2385,11.6,0.69901437
16036,16036,Larry Murphy,1992-93,31.0,13,77,77,77,21,56,77,206.0,,937,182,568,750,2150.0,80,6.96,77,402,2440,11.4,0.8827952
16037,16037,Larry Murphy,1993-94,32.0,14,85,83,83,22,63,85,230.0,,1020,204,631,835,2380.0,84,7.25,87,443,2603,11.7,0.86644864
16038,16038,Larry Murphy,1994-95,33.0,15,73,84,84,17,56,73,236.0,,1104,221,687,908,2616.0,84,6.48,76,407,2545,10.7,0.75567025
16039,16039,Larry Murphy,1995-96,34.0,16,38,48,48,13,25,38,124.0,,1152,234,712,946,2740.0,48,5.97,37,209,1408,10.2,0.7843114
16040,16040,Larry Murphy,1996-97,35.0,17,61,82,82,12,49,61,182.0,,1234,246,761,1007,2922.0,82,6.29,74,413,2481,10.4,0.6321706
16041,16041,Larry Murphy,1997-98,36.0,18,45,81,81,9,36,45,158.0,,1315,255,797,1052,3080.0,82,5.83,55,336,2444,9.8,0.5201859
16042,16042,Larry Murphy,1998-99,37.0,19,52,82,82,11,41,52,129.0,,1397,266,838,1104,3209.0,82,5.28,57,380,2242,9.6,0.57304305
16043,16043,Larry Murphy,1999-00,38.0,20,52,80,80,10,42,52,168.0,1940.0,1477,276,880,1156,3377.0,82,5.27,57,359,2285,9.4,0.5908877
16044,16044,Larry Murphy,2000-01,39.0,21,40,81,81,10,30,40,146.0,1769.0,1558,286,910,1196,3523.0,82,5.49,53,331,2294,9.8,0.45480052
16045,16045,Larry Murphy,2001-02,40.0,22,21,57,57,2,19,21,81.0,1083.0,1615,288,929,1217,3604.0,82,5.51,63,376,2272,9.9,0.3401111
16046,16046,Larry Trader,1983-84,20.0,2,2,15,15,0,2,2,7.0,,15,0,2,2,7.0,80,7.73,71,310,2444,12.7,0.28404683
16047,16047,Larry Trader,1985-86,22.0,3,10,40,40,3,7,10,47.0,,55,3,9,12,54.0,80,7.77,71,321,2447,12.7,0.28840443
16048,16048,Larry Trader,1987-88,24.0,4,0,5,5,0,0,0,3.0,,60,3,9,12,57.0,80,7.34,72,344,2400,12.2,0.19249138
16049,16049,Larry Trader,1988-89,25.0,5,6,31,31,2,4,6,19.0,,91,5,13,18,76.0,80,7.43,89,437,2435,12.2,0.23038256
16050,16050,Lars Eller,2010-11,21.0,2,2,7,7,2,0,2,8.0,76.0,7,2,0,2,8.0,82,5.53,56,304,2486,9.1,0.26007032
16051,16051,Lars Eller,2011-12,22.0,3,17,77,77,7,10,17,79.0,858.0,84,9,10,19,87.0,82,5.46,52,291,2492,9.0,0.28687608
16052,16052,Lars Eller,2012-13,23.0,4,28,79,79,16,12,28,129.0,1210.0,163,25,22,47,216.0,82,5.32,47,271,2439,8.9,0.41570377
16053,16053,Lars Eller,2013-14,24.0,5,30,46,46,8,22,30,84.0,682.0,209,33,44,77,300.0,48,5.31,29,160,1399,9.1,0.5310416
16054,16054,Lars Eller,2014-15,25.0,6,26,77,77,12,14,26,137.0,1229.0,286,45,58,103,437.0,82,5.34,48,269,2463,8.9,0.3682493
16055,16055,Lars Eller,2015-16,26.0,7,27,77,77,15,12,27,150.0,1193.0,363,60,70,130,587.0,82,5.32,47,251,2453,8.9,0.3914892
16056,16056,Lars Eller,2016-17,27.0,8,26,79,79,13,13,26,149.0,1205.0,442,73,83,156,736.0,82,5.34,48,255,2438,9.0,0.34544313
16057,16057,Lars Eller,2017-18,28.0,9,25,81,81,12,13,25,115.0,1126.0,523,85,96,181,851.0,82,5.45,47,245,2478,9.0,0.31983185
16058,16058,Lars Eller,2018-19,29.0,10,38,81,81,18,20,38,161.0,1239.0,604,103,116,219,1012.0,82,5.86,50,250,2620,9.2,0.47077024
16059,16059,Lars Eller,2019-20,30.0,11,36,81,81,13,23,36,163.0,1339.0,685,116,139,255,1175.0,82,5.96,47,239,2579,9.5,0.42964256
16060,16060,Lars Eller,2020-21,31.0,12,39,69,69,16,23,39,151.0,1174.0,754,132,162,294,1326.0,70,5.96,42,208,2192,9.5,0.491666
16061,16061,Lars Jonsson,2007-08,26.0,2,2,8,8,0,2,2,4.0,99.0,8,0,2,2,4.0,82,5.76,70,398,2426,9.7,0.18186307
16062,16062,Lars Molin,1982-83,26.0,2,46,72,72,15,31,46,150.0,,72,15,31,46,150.0,80,8.03,73,320,2489,12.9,0.6112284
16063,16063,Lars Molin,1983-84,27.0,3,39,58,58,12,27,39,127.0,,130,27,58,85,277.0,80,7.73,71,310,2444,12.7,0.553688
16064,16064,Lars Molin,1984-85,28.0,4,13,42,42,6,7,13,47.0,,172,33,65,98,324.0,80,7.89,74,336,2448,12.9,0.37254116
16065,16065,Lars-Erik Sjoberg,1980-81,36.0,2,34,79,79,7,27,34,145.0,,79,7,27,34,145.0,80,7.03,61,280,2352,12.0,0.4265526
16066,16066,Lasse Kukkonen,2004-05,23.0,2,1,10,10,0,1,1,9.0,136.0,10,0,1,1,9.0,82,5.14,57,348,2300,9.2,0.21428028
16067,16067,Lasse Kukkonen,2007-08,26.0,3,14,74,74,5,9,14,54.0,1266.0,84,5,10,15,63.0,82,5.76,70,398,2426,9.7,0.18823266
16068,16068,Lasse Kukkonen,2008-09,27.0,4,5,53,53,1,4,5,31.0,834.0,137,6,14,20,94.0,82,5.44,62,351,2383,9.4,0.116768986
16069,16069,Lasse Kukkonen,2009-10,28.0,5,2,22,22,0,2,2,10.0,236.0,159,6,16,22,104.0,82,5.7,65,341,2477,9.4,0.101811826
16070,16070,Lasse Pirjeta,2003-04,29.0,2,21,51,51,11,10,21,80.0,585.0,51,11,10,21,80.0,82,5.31,60,363,2326,9.4,0.3669415
16071,16071,Lasse Pirjeta,2004-05,30.0,3,22,70,70,8,14,22,111.0,800.0,121,19,24,43,191.0,82,5.14,57,348,2300,9.2,0.3530981
16072,16072,Lasse Pirjeta,2006-07,32.0,4,7,25,25,4,3,7,30.0,231.0,146,23,27,50,221.0,82,6.05,85,480,2458,10.1,0.2294372
16073,16073,Laurent Dauphin,2016-17,21.0,2,1,8,8,1,0,1,7.0,91.0,8,1,0,1,7.0,82,5.34,48,255,2438,9.0,0.22345677
16074,16074,Laurent Dauphin,2017-18,22.0,3,3,24,24,2,1,3,32.0,262.0,32,3,1,4,39.0,82,5.45,47,245,2478,9.0,0.25148278
16075,16075,Laurent Dauphin,2018-19,23.0,4,0,2,2,0,0,0,1.0,14.0,34,3,1,4,40.0,82,5.86,50,250,2620,9.2,0.17392781
16076,16076,Laurent Dauphin,2019-20,24.0,5,0,1,1,0,0,0,2.0,12.0,35,3,1,4,42.0,82,5.96,47,239,2579,9.5,0.2283152
16077,16077,Lauri Korpikoski,2009-10,23.0,2,14,68,68,6,8,14,63.0,742.0,68,6,8,14,63.0,82,5.7,65,341,2477,9.4,0.2267699
16078,16078,Lauri Korpikoski,2010-11,24.0,3,11,71,71,5,6,11,68.0,874.0,139,11,14,25,131.0,82,5.53,56,304,2486,9.1,0.1974873
16079,16079,Lauri Korpikoski,2011-12,25.0,4,40,79,79,19,21,40,103.0,1227.0,218,30,35,65,234.0,82,5.46,52,291,2492,9.0,0.44940835
16080,16080,Lauri Korpikoski,2012-13,26.0,5,37,82,82,17,20,37,146.0,1405.0,300,47,55,102,380.0,82,5.32,47,271,2439,8.9,0.48374638
16081,16081,Lauri Korpikoski,2013-14,27.0,6,11,36,36,6,5,11,83.0,616.0,336,53,60,113,463.0,48,5.31,29,160,1399,9.1,0.3445898
16082,16082,Lauri Korpikoski,2014-15,28.0,7,25,64,64,9,16,25,109.0,1029.0,400,62,76,138,572.0,82,5.34,48,269,2463,8.9,0.342551
16083,16083,Lauri Korpikoski,2015-16,29.0,8,21,69,69,6,15,21,82.0,1052.0,469,68,91,159,654.0,82,5.32,47,251,2453,8.9,0.298877
16084,16084,Lauri Korpikoski,2016-17,30.0,9,22,71,71,10,12,22,88.0,989.0,540,78,103,181,742.0,82,5.34,48,255,2438,9.0,0.30670446
16085,16085,Lauri Korpikoski,2017-18,31.0,10,20,69,69,8,12,20,108.0,856.0,609,86,115,201,850.0,82,5.45,47,245,2478,9.0,0.2822051
16086,16086,Lauri Tukonen,2007-08,21.0,2,0,4,4,0,0,0,1.0,26.0,4,0,0,0,1.0,82,5.76,70,398,2426,9.7,0.18608436
16087,16087,Lauri Tukonen,2008-09,22.0,3,0,1,1,0,0,0,1.0,10.0,5,0,0,0,2.0,82,5.44,62,351,2383,9.4,0.17291385
16088,16088,Laurie Boschman,1980-81,20.0,2,48,80,80,16,32,48,99.0,,80,16,32,48,99.0,80,7.03,61,280,2352,12.0,0.6586001
16089,16089,Laurie Boschman,1981-82,21.0,3,33,53,53,14,19,33,71.0,,133,30,51,81,170.0,80,7.69,77,340,2441,12.6,0.63124454
16090,16090,Laurie Boschman,1982-83,22.0,4,33,65,65,11,22,33,68.0,,198,41,73,114,238.0,80,8.03,73,320,2489,12.9,0.46977982
16091,16091,Laurie Boschman,1983-84,23.0,5,28,74,74,11,17,28,84.0,,272,52,90,142,322.0,80,7.73,71,310,2444,12.7,0.5148051
16092,16092,Laurie Boschman,1984-85,24.0,6,74,61,61,28,46,74,137.0,,333,80,136,216,459.0,80,7.89,74,336,2448,12.9,1.0289333
16093,16093,Laurie Boschman,1985-86,25.0,7,76,80,80,32,44,76,167.0,,413,112,180,292,626.0,80,7.77,71,321,2447,12.7,0.87567747
16094,16094,Laurie Boschman,1986-87,26.0,8,69,77,77,27,42,69,158.0,,490,139,222,361,784.0,80,7.94,82,370,2484,12.8,0.8122196
16095,16095,Laurie Boschman,1987-88,27.0,9,41,80,80,17,24,41,161.0,,570,156,246,402,945.0,80,7.34,72,344,2400,12.2,0.58574563
16096,16096,Laurie Boschman,1988-89,28.0,10,48,80,80,25,23,48,166.0,,650,181,269,450,1111.0,80,7.43,89,437,2435,12.2,0.63286877
16097,16097,Laurie Boschman,1989-90,29.0,11,36,70,70,10,26,36,113.0,,720,191,295,486,1224.0,80,7.48,85,403,2430,12.3,0.4555027
16098,16098,Laurie Boschman,1990-91,30.0,12,27,66,66,10,17,27,87.0,,786,201,312,513,1311.0,80,7.37,76,367,2421,12.2,0.3642782
16099,16099,Laurie Boschman,1991-92,31.0,13,20,78,78,11,9,20,91.0,,864,212,321,533,1402.0,80,6.91,71,366,2385,11.6,0.30999005
16100,16100,Laurie Boschman,1992-93,32.0,14,28,75,75,8,20,28,89.0,,939,220,341,561,1491.0,80,6.96,77,402,2440,11.4,0.31581065
16101,16101,Laurie Boschman,1993-94,33.0,15,16,70,70,9,7,16,84.0,,1009,229,348,577,1575.0,84,7.25,87,443,2603,11.7,0.28094694
16102,16102,Lawrence Nycholat,2004-05,25.0,2,0,9,9,0,0,0,6.0,154.0,9,0,0,0,6.0,82,5.14,57,348,2300,9.2,0.17265499
16103,16103,Lawrence Nycholat,2007-08,28.0,3,8,19,19,2,6,8,25.0,382.0,28,2,6,8,31.0,82,5.76,70,398,2426,9.7,0.22697034
16104,16104,Lawrence Nycholat,2008-09,29.0,4,0,3,3,0,0,0,4.0,36.0,31,2,6,8,35.0,82,5.44,62,351,2383,9.4,0.1487003
16105,16105,Lawrence Nycholat,2009-10,30.0,5,1,19,19,0,1,1,9.0,188.0,50,2,7,9,44.0,82,5.7,65,341,2477,9.4,0.098555654
16106,16106,Lawrence Pilut,2019-20,24.0,2,6,33,33,1,5,6,37.0,575.0,33,1,5,6,37.0,82,5.96,47,239,2579,9.5,0.20513222
16107,16107,Lawrence Pilut,2020-21,25.0,3,0,13,13,0,0,0,6.0,211.0,46,1,5,6,43.0,70,5.96,42,208,2192,9.5,0.16592643
16108,16108,Lawson Crouse,2017-18,20.0,2,12,72,72,5,7,12,84.0,856.0,72,5,7,12,84.0,82,5.45,47,245,2478,9.0,0.2778756
16109,16109,Lawson Crouse,2018-19,21.0,3,1,11,11,1,0,1,13.0,120.0,83,6,7,13,97.0,82,5.86,50,250,2620,9.2,0.27415004
16110,16110,Lawson Crouse,2019-20,22.0,4,25,81,81,11,14,25,131.0,1049.0,164,17,21,38,228.0,82,5.96,47,239,2579,9.5,0.3779352
16111,16111,Lawson Crouse,2020-21,23.0,5,25,66,66,15,10,25,109.0,896.0,230,32,31,63,337.0,70,5.96,42,208,2192,9.5,0.39622623
16112,16112,Layne Ulmer,2004-05,24.0,2,0,1,1,0,0,0,1.0,9.0,1,0,0,0,1.0,82,5.14,57,348,2300,9.2,0.25496042
16113,16113,Lean Bergmann,2020-21,22.0,2,1,12,12,0,1,1,11.0,99.0,12,0,1,1,11.0,70,5.96,42,208,2192,9.5,0.22445014
16114,16114,Lee Giffin,1987-88,20.0,2,2,8,8,1,1,2,8.0,,8,1,1,2,8.0,80,7.34,72,344,2400,12.2,0.33005685
16115,16115,Lee Giffin,1988-89,21.0,3,2,19,19,0,2,2,8.0,,27,1,3,4,16.0,80,7.43,89,437,2435,12.2,0.25188076
16116,16116,Lee Goren,2001-02,24.0,2,2,21,21,2,0,2,9.0,92.0,21,2,0,2,9.0,82,5.51,63,376,2272,9.9,0.15522984
16117,16117,Lee Goren,2003-04,26.0,3,3,14,14,2,1,3,15.0,115.0,35,4,1,5,24.0,82,5.31,60,363,2326,9.4,0.2267285
16118,16118,Lee Goren,2004-05,27.0,4,1,2,2,0,1,1,1.0,27.0,37,4,2,6,25.0,82,5.14,57,348,2300,9.2,0.15949571
16119,16119,Lee Goren,2006-07,29.0,5,3,28,28,1,2,3,37.0,207.0,65,5,4,9,62.0,82,6.05,85,480,2458,10.1,0.15301216
16120,16120,Lee Goren,2007-08,30.0,6,0,2,2,0,0,0,2.0,23.0,67,5,4,9,64.0,82,5.76,70,398,2426,9.7,0.118183374
16121,16121,Lee Norwood,1981-82,21.0,2,2,11,11,1,1,2,8.0,,11,1,1,2,8.0,80,7.69,77,340,2441,12.6,0.3181813
16122,16122,Lee Norwood,1982-83,22.0,3,17,28,28,7,10,17,34.0,,39,8,11,19,42.0,80,8.03,73,320,2489,12.9,0.4541736
16123,16123,Lee Norwood,1983-84,23.0,4,1,8,8,0,1,1,6.0,,47,8,12,20,48.0,80,7.73,71,310,2444,12.7,0.24592501
16124,16124,Lee Norwood,1986-87,26.0,5,29,71,71,5,24,29,112.0,,118,13,36,49,160.0,80,7.94,82,370,2484,12.8,0.38990667
16125,16125,Lee Norwood,1987-88,27.0,6,27,57,57,6,21,27,101.0,,175,19,57,76,261.0,80,7.34,72,344,2400,12.2,0.41535544
16126,16126,Lee Norwood,1988-89,28.0,7,31,51,51,9,22,31,106.0,,226,28,79,107,367.0,80,7.43,89,437,2435,12.2,0.5216015
16127,16127,Lee Norwood,1989-90,29.0,8,42,66,66,10,32,42,97.0,,292,38,111,149,464.0,80,7.48,85,403,2430,12.3,0.47879657
16128,16128,Lee Norwood,1990-91,30.0,9,22,64,64,8,14,22,60.0,,356,46,125,171,524.0,80,7.37,76,367,2421,12.2,0.326204
16129,16129,Lee Norwood,1991-92,31.0,10,15,49,49,6,9,15,63.0,,405,52,134,186,587.0,80,6.91,71,366,2385,11.6,0.30746973
16130,16130,Lee Norwood,1992-93,32.0,11,14,50,50,3,11,14,52.0,,455,55,145,200,639.0,80,6.96,77,402,2440,11.4,0.25139815
16131,16131,Lee Norwood,1993-94,33.0,12,10,32,32,3,7,10,36.0,,487,58,152,210,675.0,84,7.25,87,443,2603,11.7,0.24012181
16132,16132,Lee Norwood,1994-95,34.0,13,1,16,16,0,1,1,10.0,,503,58,153,211,685.0,84,6.48,76,407,2545,10.7,0.17555586
16133,16133,Lee Sorochan,1999-00,24.0,2,0,2,2,0,0,0,5.0,31.0,2,0,0,0,5.0,82,5.27,57,359,2285,9.4,0.17904526
16134,16134,Lee Sorochan,2000-01,25.0,3,0,1,1,0,0,0,0.0,4.0,3,0,0,0,5.0,82,5.49,53,331,2294,9.8,0.14700228
16135,16135,Lee Stempniak,2006-07,23.0,2,27,57,57,14,13,27,100.0,819.0,57,14,13,27,100.0,82,6.05,85,480,2458,10.1,0.45303458
16136,16136,Lee Stempniak,2007-08,24.0,3,52,82,82,27,25,52,166.0,1207.0,139,41,38,79,266.0,82,5.76,70,398,2426,9.7,0.6310209
16137,16137,Lee Stempniak,2008-09,25.0,4,38,80,80,13,25,38,162.0,1271.0,219,54,63,117,428.0,82,5.44,62,351,2383,9.4,0.52780074
16138,16138,Lee Stempniak,2009-10,26.0,5,44,75,75,14,30,44,171.0,1240.0,294,68,93,161,599.0,82,5.7,65,341,2477,9.4,0.58612776
16139,16139,Lee Stempniak,2010-11,27.0,6,48,80,80,28,20,48,212.0,1386.0,374,96,113,209,811.0,82,5.53,56,304,2486,9.1,0.60407984
16140,16140,Lee Stempniak,2011-12,28.0,7,38,82,82,19,19,38,199.0,1251.0,456,115,132,247,1010.0,82,5.46,52,291,2492,9.0,0.5299433
16141,16141,Lee Stempniak,2012-13,29.0,8,28,61,61,14,14,28,130.0,990.0,517,129,146,275,1140.0,82,5.32,47,271,2439,8.9,0.48021317
16142,16142,Lee Stempniak,2013-14,30.0,9,32,47,47,9,23,32,113.0,842.0,564,138,169,307,1253.0,48,5.31,29,160,1399,9.1,0.59965324
16143,16143,Lee Stempniak,2014-15,31.0,10,34,73,73,12,22,34,178.0,1348.0,637,150,191,341,1431.0,82,5.34,48,269,2463,8.9,0.45873448
16144,16144,Lee Stempniak,2015-16,32.0,11,28,71,71,15,13,28,115.0,903.0,708,165,204,369,1546.0,82,5.32,47,251,2453,8.9,0.37498248
16145,16145,Lee Stempniak,2016-17,33.0,12,51,82,82,19,32,51,146.0,1471.0,790,184,236,420,1692.0,82,5.34,48,255,2438,9.0,0.54978675
16146,16146,Lee Stempniak,2017-18,34.0,13,40,82,82,16,24,40,131.0,1299.0,872,200,260,460,1823.0,82,5.45,47,245,2478,9.0,0.430244
16147,16147,Lee Stempniak,2018-19,35.0,14,9,37,37,3,6,9,41.0,461.0,909,203,266,469,1864.0,82,5.86,50,250,2620,9.2,0.1994729
16148,16148,Lee Stempniak,2019-20,36.0,15,0,2,2,0,0,0,0.0,16.0,911,203,266,469,1864.0,82,5.96,47,239,2579,9.5,0.19347581
16149,16149,Lee Sweatt,2011-12,26.0,2,2,3,3,1,1,2,4.0,40.0,3,1,1,2,4.0,82,5.46,52,291,2492,9.0,0.19746163
16150,16150,Leif Rohlin,1996-97,28.0,2,22,56,56,6,16,22,72.0,,56,6,16,22,72.0,82,6.29,74,413,2481,10.4,0.3655594
16151,16151,Leif Rohlin,1997-98,29.0,3,10,40,40,2,8,10,37.0,,96,8,24,32,109.0,82,5.83,55,336,2444,9.8,0.21873724
16152,16152,Leigh Verstraete,1983-84,22.0,2,0,3,3,0,0,0,0.0,,3,0,0,0,0.0,80,7.73,71,310,2444,12.7,0.1900217
16153,16153,Leigh Verstraete,1985-86,24.0,3,0,2,2,0,0,0,2.0,,5,0,0,0,2.0,80,7.77,71,321,2447,12.7,0.20360401
16154,16154,Leigh Verstraete,1988-89,27.0,4,1,3,3,0,1,1,0.0,,8,0,1,1,2.0,80,7.43,89,437,2435,12.2,0.17586505
16155,16155,Len Barrie,1990-91,21.0,2,0,1,1,0,0,0,0.0,,1,0,0,0,0.0,80,7.37,76,367,2421,12.2,0.21253276
16156,16156,Len Barrie,1993-94,24.0,3,4,8,8,2,2,4,14.0,,9,2,2,4,14.0,84,7.25,87,443,2603,11.7,0.27164996
16157,16157,Len Barrie,1994-95,25.0,4,0,2,2,0,0,0,0.0,,11,2,2,4,14.0,84,6.48,76,407,2545,10.7,0.16300607
16158,16158,Len Barrie,1995-96,26.0,5,14,48,48,3,11,14,37.0,,59,5,13,18,51.0,48,5.97,37,209,1408,10.2,0.2580511
16159,16159,Len Barrie,1996-97,27.0,6,0,5,5,0,0,0,5.0,,64,5,13,18,56.0,82,6.29,74,413,2481,10.4,0.14660111
16160,16160,Len Barrie,2000-01,31.0,7,23,60,60,9,14,23,61.0,741.0,124,14,27,41,117.0,82,5.49,53,331,2294,9.8,0.25165296
16161,16161,Len Barrie,2001-02,32.0,8,23,60,60,5,18,23,48.0,754.0,184,19,45,64,165.0,82,5.51,63,376,2272,9.9,0.25530726
16162,16162,Len Esau,1992-93,24.0,2,0,2,2,0,0,0,0.0,,2,0,0,0,0.0,80,6.96,77,402,2440,11.4,0.17426091
16163,16163,Len Esau,1993-94,25.0,3,1,4,4,0,1,1,1.0,,6,0,1,1,1.0,84,7.25,87,443,2603,11.7,0.19231844
16164,16164,Len Esau,1994-95,26.0,4,3,6,6,0,3,3,4.0,,12,0,4,4,5.0,84,6.48,76,407,2545,10.7,0.19237122
16165,16165,Len Esau,1995-96,27.0,5,6,15,15,0,6,6,21.0,,27,0,10,10,26.0,48,5.97,37,209,1408,10.2,0.24589589
16166,16166,Len Hachborn,1984-85,23.0,2,32,38,38,11,21,32,69.0,,38,11,21,32,69.0,80,7.89,74,336,2448,12.9,0.6505994
16167,16167,Len Hachborn,1985-86,24.0,3,22,40,40,5,17,22,57.0,,78,16,38,54,126.0,80,7.77,71,321,2447,12.7,0.46791992
16168,16168,Len Hachborn,1986-87,25.0,4,5,24,24,4,1,5,14.0,,102,20,39,59,140.0,80,7.94,82,370,2484,12.8,0.31804225
16169,16169,Lennart Petrell,2012-13,28.0,2,9,60,60,4,5,9,36.0,578.0,60,4,5,9,36.0,82,5.32,47,271,2439,8.9,0.14839941
16170,16170,Lennart Petrell,2013-14,29.0,3,9,35,35,3,6,9,23.0,404.0,95,7,11,18,59.0,48,5.31,29,160,1399,9.1,0.2177437
16171,16171,Leo Komarov,2013-14,27.0,2,9,42,42,4,5,9,51.0,585.0,42,4,5,9,51.0,48,5.31,29,160,1399,9.1,0.21253169
16172,16172,Leo Komarov,2015-16,29.0,3,26,62,62,8,18,26,84.0,911.0,104,12,23,35,135.0,82,5.32,47,251,2453,8.9,0.32190704
16173,16173,Leo Komarov,2016-17,30.0,4,36,67,67,19,17,36,130.0,1195.0,171,31,40,71,265.0,82,5.34,48,255,2438,9.0,0.43182933
16174,16174,Leo Komarov,2017-18,31.0,5,32,82,82,14,18,32,114.0,1400.0,253,45,58,103,379.0,82,5.45,47,245,2478,9.0,0.381555
16175,16175,Leo Komarov,2018-19,32.0,6,19,74,74,7,12,19,114.0,1168.0,327,52,70,122,493.0,82,5.86,50,250,2620,9.2,0.2822711
16176,16176,Leo Komarov,2019-20,33.0,7,26,82,82,6,20,26,78.0,1139.0,409,58,90,148,571.0,82,5.96,47,239,2579,9.5,0.31568226
16177,16177,Leo Komarov,2020-21,34.0,8,14,48,48,4,10,14,46.0,605.0,457,62,100,162,617.0,70,5.96,42,208,2192,9.5,0.25996125
16178,16178,Leon Draisaitl,2015-16,20.0,2,9,37,37,2,7,9,49.0,470.0,37,2,7,9,49.0,82,5.32,47,251,2453,8.9,0.28437117
16179,16179,Leon Draisaitl,2016-17,21.0,3,51,72,72,19,32,51,133.0,1300.0,109,21,39,60,182.0,82,5.34,48,255,2438,9.0,0.6750583
16180,16180,Leon Draisaitl,2017-18,22.0,4,77,82,82,29,48,77,172.0,1548.0,191,50,87,137,354.0,82,5.45,47,245,2478,9.0,0.9165057
16181,16181,Leon Draisaitl,2018-19,23.0,5,70,78,78,25,45,70,194.0,1507.0,269,75,132,207,548.0,82,5.86,50,250,2620,9.2,0.9674022
16182,16182,Leon Draisaitl,2019-20,24.0,6,105,82,82,50,55,105,231.0,1852.0,351,125,187,312,779.0,82,5.96,47,239,2579,9.5,1.2311628
16183,16183,Leon Draisaitl,2020-21,25.0,7,110,71,71,43,67,110,218.0,1605.0,422,168,254,422,997.0,70,5.96,42,208,2192,9.5,1.2277212
16184,16184,Les Auge,1981-82,28.0,2,3,6,6,0,3,3,3.0,,6,0,3,3,3.0,80,7.69,77,340,2441,12.6,0.20791188
16185,16185,Liam Foudy,2020-21,20.0,2,1,2,2,0,1,1,3.0,28.0,2,0,1,1,3.0,70,5.96,42,208,2192,9.5,0.26746184
16186,16186,Liam O'Brien,2015-16,21.0,2,2,13,13,1,1,2,16.0,98.0,13,1,1,2,16.0,82,5.32,47,251,2453,8.9,0.2594186
16187,16187,Liam O'Brien,2017-18,23.0,3,0,1,1,0,0,0,0.0,6.0,14,1,1,2,16.0,82,5.45,47,245,2478,9.0,0.16559654
16188,16188,Liam O'Brien,2018-19,24.0,4,0,3,3,0,0,0,1.0,21.0,17,1,1,2,17.0,82,5.86,50,250,2620,9.2,0.14547431
16189,16189,Liam Reddox,2008-09,23.0,2,0,1,1,0,0,0,1.0,6.0,1,0,0,0,1.0,82,5.44,62,351,2383,9.4,0.18452415
16190,16190,Liam Reddox,2009-10,24.0,3,12,46,46,5,7,12,39.0,482.0,47,5,7,12,40.0,82,5.7,65,341,2477,9.4,0.22165564
16191,16191,Liam Reddox,2010-11,25.0,4,2,9,9,0,2,2,11.0,113.0,56,5,9,14,51.0,82,5.53,56,304,2486,9.1,0.17347205
16192,16192,Liam Reddox,2011-12,26.0,5,10,44,44,1,9,10,85.0,660.0,100,6,18,24,136.0,82,5.46,52,291,2492,9.0,0.22562289
16193,16193,Lias Andersson,2018-19,20.0,2,2,7,7,1,1,2,5.0,84.0,7,1,1,2,5.0,82,5.86,50,250,2620,9.2,0.258058
16194,16194,Lias Andersson,2019-20,21.0,3,6,42,42,2,4,6,41.0,450.0,49,3,5,8,46.0,82,5.96,47,239,2579,9.5,0.2521003
16195,16195,Lias Andersson,2020-21,22.0,4,1,17,17,0,1,1,13.0,162.0,66,3,6,9,59.0,70,5.96,42,208,2192,9.5,0.21725467
16196,16196,Libor Hajek,2019-20,21.0,2,1,5,5,1,0,1,10.0,83.0,5,1,0,1,10.0,82,5.96,47,239,2579,9.5,0.27075565
16197,16197,Libor Hajek,2020-21,22.0,3,5,28,28,0,5,5,23.0,448.0,33,1,5,6,33.0,70,5.96,42,208,2192,9.5,0.20776072
16198,16198,Libor Pivko,2004-05,24.0,2,0,1,1,0,0,0,2.0,7.0,1,0,0,0,2.0,82,5.14,57,348,2300,9.2,0.27859044
16199,16199,Libor Sulak,2019-20,25.0,2,0,6,6,0,0,0,7.0,116.0,6,0,0,0,7.0,82,5.96,47,239,2579,9.5,0.1706697
16200,16200,Libor Zabransky,1997-98,24.0,2,6,34,34,1,5,6,26.0,,34,1,5,6,26.0,82,5.83,55,336,2444,9.8,0.19052577
16201,16201,Libor Zabransky,1998-99,25.0,3,1,6,6,0,1,1,2.0,,40,1,6,7,28.0,82,5.28,57,380,2242,9.6,0.16709605
16202,16202,Linden Vey,2014-15,23.0,2,5,18,18,0,5,5,8.0,218.0,18,0,5,5,8.0,82,5.34,48,269,2463,8.9,0.18542886
16203,16203,Linden Vey,2015-16,24.0,3,24,75,75,10,14,24,61.0,988.0,93,10,19,29,69.0,82,5.32,47,251,2453,8.9,0.2856493
16204,16204,Linden Vey,2016-17,25.0,4,15,41,41,4,11,15,40.0,646.0,134,14,30,44,109.0,82,5.34,48,255,2438,9.0,0.25167906
16205,16205,Linden Vey,2017-18,26.0,5,0,4,4,0,0,0,1.0,44.0,138,14,30,44,110.0,82,5.45,47,245,2478,9.0,0.17334855
16206,16206,Lindsay Carson,1982-83,22.0,2,1,18,18,0,1,1,24.0,,18,0,1,1,24.0,80,8.03,73,320,2489,12.9,0.27685356
16207,16207,Lindsay Carson,1983-84,23.0,3,37,78,78,18,19,37,150.0,,96,18,20,38,174.0,80,7.73,71,310,2444,12.7,0.50196505
16208,16208,Lindsay Carson,1984-85,24.0,4,4,16,16,1,3,4,16.0,,112,19,23,42,190.0,80,7.89,74,336,2448,12.9,0.3236746
16209,16209,Lindsay Carson,1985-86,25.0,5,39,77,77,20,19,39,118.0,,189,39,42,81,308.0,80,7.77,71,321,2447,12.7,0.47760323
16210,16210,Lindsay Carson,1986-87,26.0,6,21,50,50,9,12,21,59.0,,239,48,54,102,367.0,80,7.94,82,370,2484,12.8,0.37559447
16211,16211,Lindsay Carson,1987-88,27.0,7,26,71,71,11,15,26,100.0,,310,59,69,128,467.0,80,7.34,72,344,2400,12.2,0.33835113
16212,16212,Lindsay Carson,1988-89,28.0,8,18,63,63,7,11,18,73.0,,373,66,80,146,540.0,80,7.43,89,437,2435,12.2,0.3096794
16213,16213,Lindsay Vallis,1994-95,24.0,2,0,1,1,0,0,0,0.0,,1,0,0,0,0.0,84,6.48,76,407,2545,10.7,0.15297985
16214,16214,Lindy Ruff,1980-81,20.0,2,19,63,63,5,14,19,77.0,,63,5,14,19,77.0,80,7.03,61,280,2352,12.0,0.38072366
16215,16215,Lindy Ruff,1981-82,21.0,3,26,65,65,8,18,26,97.0,,128,13,32,45,174.0,80,7.69,77,340,2441,12.6,0.44241032
16216,16216,Lindy Ruff,1982-83,22.0,4,48,79,79,16,32,48,181.0,,207,29,64,93,355.0,80,8.03,73,320,2489,12.9,0.646729
16217,16217,Lindy Ruff,1983-84,23.0,5,29,60,60,12,17,29,110.0,,267,41,81,122,465.0,80,7.73,71,310,2444,12.7,0.5481694
16218,16218,Lindy Ruff,1984-85,24.0,6,45,58,58,14,31,45,126.0,,325,55,112,167,591.0,80,7.89,74,336,2448,12.9,0.6123908
16219,16219,Lindy Ruff,1985-86,25.0,7,24,39,39,13,11,24,71.0,,364,68,123,191,662.0,80,7.77,71,321,2447,12.7,0.6167282
16220,16220,Lindy Ruff,1986-87,26.0,8,32,54,54,20,12,32,131.0,,418,88,135,223,793.0,80,7.94,82,370,2484,12.8,0.58719844
16221,16221,Lindy Ruff,1987-88,27.0,9,20,50,50,6,14,20,95.0,,468,94,149,243,888.0,80,7.34,72,344,2400,12.2,0.41488504
16222,16222,Lindy Ruff,1988-89,28.0,10,25,77,77,2,23,25,106.0,,545,96,172,268,994.0,80,7.43,89,437,2435,12.2,0.32478037
16223,16223,Lindy Ruff,1989-90,29.0,11,22,76,76,6,16,22,88.0,,621,102,188,290,1082.0,80,7.48,85,403,2430,12.3,0.28659835
16224,16224,Lindy Ruff,1990-91,30.0,12,9,56,56,3,6,9,59.0,,677,105,194,299,1141.0,80,7.37,76,367,2421,12.2,0.25244713
16225,16225,Lindy Ruff,1991-92,31.0,13,1,14,14,0,1,1,10.0,,691,105,195,300,1151.0,80,6.91,71,366,2385,11.6,0.24692741
16226,16226,Link Gaetz,1989-90,21.0,2,2,12,12,0,2,2,8.0,,12,0,2,2,8.0,80,7.48,85,403,2430,12.3,0.292997
16227,16227,Link Gaetz,1990-91,22.0,3,0,5,5,0,0,0,4.0,,17,0,2,2,12.0,80,7.37,76,367,2421,12.2,0.20404321
16228,16228,Link Gaetz,1992-93,24.0,4,12,48,48,6,6,12,73.0,,65,6,8,14,85.0,80,6.96,77,402,2440,11.4,0.31555194
16229,16229,Linus Klasen,2011-12,25.0,2,0,4,4,0,0,0,4.0,52.0,4,0,0,0,4.0,82,5.46,52,291,2492,9.0,0.16366741
16230,16230,Linus Omark,2011-12,24.0,2,27,51,51,5,22,27,76.0,783.0,51,5,22,27,76.0,82,5.46,52,291,2492,9.0,0.41630834
16231,16231,Linus Omark,2012-13,25.0,3,3,14,14,3,0,3,24.0,188.0,65,8,22,30,100.0,82,5.32,47,271,2439,8.9,0.2735896
16232,16232,Linus Omark,2014-15,27.0,4,2,14,14,0,2,2,10.0,175.0,79,8,24,32,110.0,82,5.34,48,269,2463,8.9,0.18595645
16233,16233,Logan Brown,2018-19,20.0,2,1,4,4,0,1,1,4.0,33.0,4,0,1,1,4.0,82,5.86,50,250,2620,9.2,0.25736958
16234,16234,Logan Brown,2019-20,21.0,3,0,2,2,0,0,0,2.0,21.0,6,0,1,1,6.0,82,5.96,47,239,2579,9.5,0.261055
16235,16235,Logan Brown,2020-21,22.0,4,8,23,23,1,7,8,23.0,270.0,29,1,8,9,29.0,70,5.96,42,208,2192,9.5,0.2817642
16236,16236,Logan Couture,2010-11,21.0,2,9,25,25,5,4,9,42.0,256.0,25,5,4,9,42.0,82,5.53,56,304,2486,9.1,0.3694597
16237,16237,Logan Couture,2011-12,22.0,3,56,79,79,32,24,56,253.0,1408.0,104,37,28,65,295.0,82,5.46,52,291,2492,9.0,0.73375267
16238,16238,Logan Couture,2012-13,23.0,4,65,80,80,31,34,65,245.0,1485.0,184,68,62,130,540.0,82,5.32,47,271,2439,8.9,0.8190271
16239,16239,Logan Couture,2013-14,24.0,5,37,48,48,21,16,37,151.0,869.0,232,89,78,167,691.0,48,5.31,29,160,1399,9.1,0.8030537
16240,16240,Logan Couture,2014-15,25.0,6,54,65,65,23,31,54,233.0,1231.0,297,112,109,221,924.0,82,5.34,48,269,2463,8.9,0.77476996
16241,16241,Logan Couture,2015-16,26.0,7,67,82,82,27,40,67,263.0,1564.0,379,139,149,288,1187.0,82,5.32,47,251,2453,8.9,0.8422407
16242,16242,Logan Couture,2016-17,27.0,8,36,52,52,15,21,36,137.0,904.0,431,154,170,324,1324.0,82,5.34,48,255,2438,9.0,0.68375033
16243,16243,Logan Couture,2017-18,28.0,9,52,73,73,25,27,52,174.0,1285.0,504,179,197,376,1498.0,82,5.45,47,245,2478,9.0,0.6720947
16244,16244,Logan Couture,2018-19,29.0,10,61,78,78,34,27,61,204.0,1447.0,582,213,224,437,1702.0,82,5.86,50,250,2620,9.2,0.72241575
16245,16245,Logan Couture,2019-20,30.0,11,70,81,81,27,43,70,204.0,1506.0,663,240,267,507,1906.0,82,5.96,47,239,2579,9.5,0.77579665
16246,16246,Logan Couture,2020-21,31.0,12,39,52,52,16,23,39,126.0,963.0,715,256,290,546,2032.0,70,5.96,42,208,2192,9.5,0.69701976
16247,16247,Logan O'Connor,2019-20,23.0,2,0,5,5,0,0,0,1.0,34.0,5,0,0,0,1.0,82,5.96,47,239,2579,9.5,0.17800906
16248,16248,Logan O'Connor,2020-21,24.0,3,2,16,16,2,0,2,15.0,135.0,21,2,0,2,16.0,70,5.96,42,208,2192,9.5,0.25371206
16249,16249,Logan Shaw,2016-17,25.0,2,7,53,53,5,2,7,72.0,649.0,53,5,2,7,72.0,82,5.34,48,255,2438,9.0,0.22177806
16250,16250,Logan Shaw,2017-18,26.0,3,10,55,55,3,7,10,59.0,534.0,108,8,9,17,131.0,82,5.45,47,245,2478,9.0,0.21426216
16251,16251,Logan Shaw,2018-19,27.0,4,14,72,72,4,10,14,105.0,855.0,180,12,19,31,236.0,82,5.86,50,250,2620,9.2,0.19474283
16252,16252,Logan Shaw,2020-21,29.0,5,5,35,35,3,2,5,20.0,239.0,215,15,21,36,256.0,70,5.96,42,208,2192,9.5,0.17560837
16253,16253,Lonnie Loach,1993-94,25.0,2,23,53,53,10,13,23,58.0,,53,10,13,23,58.0,84,7.25,87,443,2603,11.7,0.35480845
16254,16254,Lonnie Loach,1994-95,26.0,3,0,3,3,0,0,0,8.0,,56,10,13,23,66.0,84,6.48,76,407,2545,10.7,0.18132219
16255,16255,Lonny Bohonos,1996-97,23.0,2,1,3,3,0,1,1,3.0,,3,0,1,1,3.0,82,6.29,74,413,2481,10.4,0.20212269
16256,16256,Lonny Bohonos,1997-98,24.0,3,22,36,36,11,11,22,67.0,,39,11,12,23,70.0,82,5.83,55,336,2444,9.8,0.429529
16257,16257,Lonny Bohonos,1998-99,25.0,4,9,37,37,5,4,9,50.0,,76,16,16,32,120.0,82,5.28,57,380,2242,9.6,0.2713941
16258,16258,Lonny Bohonos,1999-00,26.0,5,3,7,7,3,0,3,13.0,96.0,83,19,16,35,133.0,82,5.27,57,359,2285,9.4,0.2686593
16259,16259,Lou Crawford,1990-91,28.0,2,0,7,7,0,0,0,6.0,,7,0,0,0,6.0,80,7.37,76,367,2421,12.2,0.21331918
16260,16260,Lou Crawford,1992-93,30.0,3,3,19,19,2,1,3,14.0,,26,2,1,3,20.0,80,6.96,77,402,2440,11.4,0.22200945
16261,16261,Lou Franceschetti,1982-83,24.0,2,12,30,30,2,10,12,25.0,,30,2,10,12,25.0,80,8.03,73,320,2489,12.9,0.29289562
16262,16262,Lou Franceschetti,1984-85,26.0,3,0,2,2,0,0,0,2.0,,32,2,10,12,27.0,80,7.89,74,336,2448,12.9,0.22522682
16263,16263,Lou Franceschetti,1985-86,27.0,4,11,22,22,4,7,11,19.0,,54,6,17,23,46.0,80,7.77,71,321,2447,12.7,0.3159469
16264,16264,Lou Franceschetti,1986-87,28.0,5,21,76,76,7,14,21,57.0,,130,13,31,44,103.0,80,7.94,82,370,2484,12.8,0.22014907
16265,16265,Lou Franceschetti,1987-88,29.0,6,21,75,75,12,9,21,77.0,,205,25,40,65,180.0,80,7.34,72,344,2400,12.2,0.2851531
16266,16266,Lou Franceschetti,1988-89,30.0,7,12,59,59,4,8,12,53.0,,264,29,48,77,233.0,80,7.43,89,437,2435,12.2,0.2527089
16267,16267,Lou Franceschetti,1989-90,31.0,8,17,63,63,7,10,17,55.0,,327,36,58,94,288.0,80,7.48,85,403,2430,12.3,0.23674014
16268,16268,Lou Franceschetti,1990-91,32.0,9,36,80,80,21,15,36,76.0,,407,57,73,130,364.0,80,7.37,76,367,2421,12.2,0.3484109
16269,16269,Lou Franceschetti,1991-92,33.0,10,10,51,51,2,8,10,27.0,,458,59,81,140,391.0,80,6.91,71,366,2385,11.6,0.1927436
16270,16270,Lou Franceschetti,1992-93,34.0,11,0,1,1,0,0,0,0.0,,459,59,81,140,391.0,80,6.96,77,402,2440,11.4,0.2951974
16271,16271,Loui Eriksson,2007-08,22.0,2,19,59,59,6,13,19,78.0,778.0,59,6,13,19,78.0,82,5.76,70,398,2426,9.7,0.34390622
16272,16272,Loui Eriksson,2008-09,23.0,3,31,69,69,14,17,31,120.0,968.0,128,20,30,50,198.0,82,5.44,62,351,2383,9.4,0.45256513
16273,16273,Loui Eriksson,2009-10,24.0,4,63,82,82,36,27,63,178.0,1626.0,210,56,57,113,376.0,82,5.7,65,341,2477,9.4,0.73860705
16274,16274,Loui Eriksson,2010-11,25.0,5,71,82,82,29,42,71,214.0,1620.0,292,85,99,184,590.0,82,5.53,56,304,2486,9.1,0.81777894
16275,16275,Loui Eriksson,2011-12,26.0,6,73,79,79,27,46,73,179.0,1625.0,371,112,145,257,769.0,82,5.46,52,291,2492,9.0,0.8268139
16276,16276,Loui Eriksson,2012-13,27.0,7,71,82,82,26,45,71,187.0,1620.0,453,138,190,328,956.0,82,5.32,47,271,2439,8.9,0.80937445
16277,16277,Loui Eriksson,2013-14,28.0,8,29,48,48,12,17,29,104.0,966.0,501,150,207,357,1060.0,48,5.31,29,160,1399,9.1,0.6192706
16278,16278,Loui Eriksson,2014-15,29.0,9,37,61,61,10,27,37,115.0,1008.0,562,160,234,394,1175.0,82,5.34,48,269,2463,8.9,0.5472166
16279,16279,Loui Eriksson,2015-16,30.0,10,47,81,81,22,25,47,169.0,1497.0,643,182,259,441,1344.0,82,5.32,47,251,2453,8.9,0.5758149
16280,16280,Loui Eriksson,2016-17,31.0,11,63,82,82,30,33,63,184.0,1598.0,725,212,292,504,1528.0,82,5.34,48,255,2438,9.0,0.6773743
16281,16281,Loui Eriksson,2017-18,32.0,12,24,65,65,11,13,24,132.0,1214.0,790,223,305,528,1660.0,82,5.45,47,245,2478,9.0,0.37310708
16282,16282,Loui Eriksson,2018-19,33.0,13,23,50,50,10,13,23,101.0,813.0,840,233,318,551,1761.0,82,5.86,50,250,2620,9.2,0.44455525
16283,16283,Loui Eriksson,2019-20,34.0,14,29,81,81,11,18,29,107.0,1139.0,921,244,336,580,1868.0,82,5.96,47,239,2579,9.5,0.29951787
16284,16284,Loui Eriksson,2020-21,35.0,15,13,49,49,6,7,13,59.0,606.0,970,250,343,593,1927.0,70,5.96,42,208,2192,9.5,0.29312983
16285,16285,Louie DeBrusk,1992-93,21.0,2,3,25,25,2,1,3,7.0,,25,2,1,3,7.0,80,6.96,77,402,2440,11.4,0.3087031
16286,16286,Louie DeBrusk,1993-94,22.0,3,10,51,51,8,2,10,33.0,,76,10,3,13,40.0,84,7.25,87,443,2603,11.7,0.27420735
16287,16287,Louie DeBrusk,1994-95,23.0,4,10,48,48,4,6,10,27.0,,124,14,9,23,67.0,84,6.48,76,407,2545,10.7,0.21665826
16288,16288,Louie DeBrusk,1995-96,24.0,5,2,34,34,2,0,2,14.0,,158,16,9,25,81.0,48,5.97,37,209,1408,10.2,0.18071267
16289,16289,Louie DeBrusk,1996-97,25.0,6,4,38,38,1,3,4,17.0,,196,17,12,29,98.0,82,6.29,74,413,2481,10.4,0.10777971
16290,16290,Louie DeBrusk,1997-98,26.0,7,2,32,32,2,0,2,10.0,,228,19,12,31,108.0,82,5.83,55,336,2444,9.8,0.15535745
16291,16291,Louie DeBrusk,1998-99,27.0,8,3,54,54,1,2,3,14.0,,282,20,14,34,122.0,82,5.28,57,380,2242,9.6,0.08407882
16292,16292,Louie DeBrusk,1999-00,28.0,9,0,15,15,0,0,0,6.0,89.0,297,20,14,34,128.0,82,5.27,57,359,2285,9.4,0.12361425
16293,16293,Louie DeBrusk,2000-01,29.0,10,7,61,61,4,3,7,24.0,327.0,358,24,17,41,152.0,82,5.49,53,331,2294,9.8,0.104194224
16294,16294,Louie DeBrusk,2001-02,30.0,11,0,39,39,0,0,0,12.0,188.0,397,24,17,41,164.0,82,5.51,63,376,2272,9.9,0.06965354
16295,16295,Louie DeBrusk,2003-04,32.0,12,0,4,4,0,0,0,0.0,25.0,401,24,17,41,164.0,82,5.31,60,363,2326,9.4,0.15033263
16296,16296,Louis Belpedio,2018-19,22.0,2,2,1,1,0,2,2,0.0,16.0,1,0,2,2,0.0,82,5.86,50,250,2620,9.2,0.20052567
16297,16297,Louis Belpedio,2019-20,23.0,3,0,2,2,0,0,0,0.0,26.0,3,0,2,2,0.0,82,5.96,47,239,2579,9.5,0.17036629
16298,16298,Louis Leblanc,2012-13,22.0,2,10,42,42,5,5,10,58.0,470.0,42,5,5,10,58.0,82,5.32,47,271,2439,8.9,0.26873484
16299,16299,Louis Leblanc,2014-15,24.0,3,0,8,8,0,0,0,7.0,79.0,50,5,5,10,65.0,82,5.34,48,269,2463,8.9,0.16226232
16300,16300,Louis Robitaille,2006-07,24.0,2,0,2,2,0,0,0,0.0,9.0,2,0,0,0,0.0,82,6.05,85,480,2458,10.1,0.14691085
16301,16301,Louis Sleigher,1980-81,22.0,2,1,2,2,0,1,1,0.0,,2,0,1,1,0.0,80,7.03,61,280,2352,12.0,0.22101018
16302,16302,Louis Sleigher,1982-83,24.0,3,0,8,8,0,0,0,3.0,,10,0,1,1,3.0,80,8.03,73,320,2489,12.9,0.20360401
16303,16303,Louis Sleigher,1983-84,25.0,4,24,51,51,14,10,24,55.0,,61,14,11,25,58.0,80,7.73,71,310,2444,12.7,0.41665715
16304,16304,Louis Sleigher,1984-85,26.0,5,34,44,44,15,19,34,74.0,,105,29,30,59,132.0,80,7.89,74,336,2448,12.9,0.5433176
16305,16305,Louis Sleigher,1985-86,27.0,6,34,76,76,13,21,34,113.0,,181,42,51,93,245.0,80,7.77,71,321,2447,12.7,0.41456598
16306,16306,Louis Sleigher,1986-87,28.0,7,6,13,13,4,2,6,18.0,,194,46,53,99,263.0,80,7.94,82,370,2484,12.8,0.3391397
16307,16307,Lubomir Sekeras,2001-02,33.0,2,34,80,80,11,23,34,102.0,1697.0,80,11,23,34,102.0,82,5.51,63,376,2272,9.9,0.37333953
16308,16308,Lubomir Sekeras,2002-03,34.0,3,24,69,69,4,20,24,82.0,1561.0,149,15,43,58,184.0,82,5.24,53,338,2262,9.5,0.28771842
16309,16309,Lubomir Sekeras,2003-04,35.0,4,11,60,60,2,9,11,50.0,1132.0,209,17,52,69,234.0,82,5.31,60,363,2326,9.4,0.2046645
16310,16310,Lubomir Sekeras,2004-05,36.0,5,2,4,4,1,1,2,2.0,66.0,213,18,53,71,236.0,82,5.14,57,348,2300,9.2,0.25816917
16311,16311,Lubomir Vaic,1998-99,21.0,2,2,5,5,1,1,2,8.0,,5,1,1,2,8.0,82,5.28,57,380,2242,9.6,0.24957067
16312,16312,Lubomir Vaic,2000-01,23.0,3,0,4,4,0,0,0,2.0,30.0,9,1,1,2,10.0,82,5.49,53,331,2294,9.8,0.16874447
16313,16313,Lubomir Visnovsky,2001-02,25.0,2,39,81,81,7,32,39,105.0,1375.0,81,7,32,39,105.0,82,5.51,63,376,2272,9.9,0.44385344
16314,16314,Lubomir Visnovsky,2002-03,26.0,3,21,72,72,4,17,21,95.0,1170.0,153,11,49,60,200.0,82,5.24,53,338,2262,9.5,0.3090499
16315,16315,Lubomir Visnovsky,2003-04,27.0,4,24,57,57,8,16,24,85.0,1102.0,210,19,65,84,285.0,82,5.31,60,363,2326,9.4,0.36107087
16316,16316,Lubomir Visnovsky,2004-05,28.0,5,29,58,58,8,21,29,114.0,1394.0,268,27,86,113,399.0,82,5.14,57,348,2300,9.2,0.5345359
16317,16317,Lubomir Visnovsky,2006-07,30.0,6,67,80,80,17,50,67,152.0,1862.0,348,44,136,180,551.0,82,6.05,85,480,2458,10.1,0.7518171
16318,16318,Lubomir Visnovsky,2007-08,31.0,7,58,69,69,18,40,58,159.0,1687.0,417,62,176,238,710.0,82,5.76,70,398,2426,9.7,0.6944559
16319,16319,Lubomir Visnovsky,2008-09,32.0,8,41,82,82,8,33,41,153.0,1886.0,499,70,209,279,863.0,82,5.44,62,351,2383,9.4,0.50143397
16320,16320,Lubomir Visnovsky,2009-10,33.0,9,31,50,50,8,23,31,86.0,1151.0,549,78,232,310,949.0,82,5.7,65,341,2477,9.4,0.54493296
16321,16321,Lubomir Visnovsky,2010-11,34.0,10,45,73,73,15,30,45,131.0,1599.0,622,93,262,355,1080.0,82,5.53,56,304,2486,9.1,0.51952803
16322,16322,Lubomir Visnovsky,2011-12,35.0,11,68,81,81,18,50,68,152.0,1968.0,703,111,312,423,1232.0,82,5.46,52,291,2492,9.0,0.66890347
16323,16323,Lubomir Visnovsky,2012-13,36.0,12,27,68,68,6,21,27,112.0,1414.0,771,117,333,450,1344.0,82,5.32,47,271,2439,8.9,0.34940517
16324,16324,Lubomir Visnovsky,2013-14,37.0,13,14,35,35,3,11,14,69.0,798.0,806,120,344,464,1413.0,48,5.31,29,160,1399,9.1,0.35681313
16325,16325,Lubomir Visnovsky,2014-15,38.0,14,11,24,24,3,8,11,34.0,493.0,830,123,352,475,1447.0,82,5.34,48,269,2463,8.9,0.2951349
16326,16326,Lubomir Visnovsky,2015-16,39.0,15,20,53,53,5,15,20,85.0,1035.0,883,128,367,495,1532.0,82,5.32,47,251,2453,8.9,0.36884975
16327,16327,Lubos Bartecko,1999-00,23.0,2,16,32,32,5,11,16,37.0,423.0,32,5,11,16,37.0,82,5.27,57,359,2285,9.4,0.3856231
16328,16328,Lubos Bartecko,2000-01,24.0,3,39,67,67,16,23,39,75.0,908.0,99,21,34,55,112.0,82,5.49,53,331,2294,9.8,0.5102155
16329,16329,Lubos Bartecko,2001-02,25.0,4,13,50,50,5,8,13,51.0,521.0,149,26,42,68,163.0,82,5.51,63,376,2272,9.9,0.2908195
16330,16330,Lubos Bartecko,2002-03,26.0,5,27,71,71,13,14,27,96.0,1028.0,220,39,56,95,259.0,82,5.24,53,338,2262,9.5,0.4301431
16331,16331,Lubos Bartecko,2003-04,27.0,6,16,37,37,7,9,16,54.0,463.0,257,46,65,111,313.0,82,5.31,60,363,2326,9.4,0.3894523
16332,16332,Luc Bourdon,2007-08,20.0,2,0,9,9,0,0,0,3.0,80.0,9,0,0,0,3.0,82,5.76,70,398,2426,9.7,0.22936767
16333,16333,Luc Bourdon,2008-09,21.0,3,2,27,27,2,0,2,26.0,348.0,36,2,0,2,29.0,82,5.44,62,351,2383,9.4,0.23006037
16334,16334,Luc Dufour,1983-84,20.0,2,25,73,73,14,11,25,121.0,,73,14,11,25,121.0,80,7.73,71,310,2444,12.7,0.46383014
16335,16335,Luc Dufour,1984-85,21.0,3,10,41,41,6,4,10,39.0,,114,20,15,35,160.0,80,7.89,74,336,2448,12.9,0.37876704
16336,16336,Luc Dufour,1985-86,22.0,4,9,53,53,3,6,9,56.0,,167,23,21,44,216.0,80,7.77,71,321,2447,12.7,0.29719633
16337,16337,Luc Gauthier,1991-92,27.0,2,0,3,3,0,0,0,0.0,,3,0,0,0,0.0,80,6.91,71,366,2385,11.6,0.18243021
16338,16338,Luc Robitaille,1987-88,21.0,2,84,79,79,45,39,84,199.0,,79,45,39,84,199.0,80,7.34,72,344,2400,12.2,1.2160839
16339,16339,Luc Robitaille,1988-89,22.0,3,111,80,80,53,58,111,220.0,,159,98,97,195,419.0,80,7.43,89,437,2435,12.2,1.225567
16340,16340,Luc Robitaille,1989-90,23.0,4,98,78,78,46,52,98,237.0,,237,144,149,293,656.0,80,7.48,85,403,2430,12.3,1.0971351
16341,16341,Luc Robitaille,1990-91,24.0,5,101,80,80,52,49,101,210.0,,317,196,198,394,866.0,80,7.37,76,367,2421,12.2,1.1428277
16342,16342,Luc Robitaille,1991-92,25.0,6,91,76,76,45,46,91,229.0,,393,241,244,485,1095.0,80,6.91,71,366,2385,11.6,1.1716188
16343,16343,Luc Robitaille,1992-93,26.0,7,107,80,80,44,63,107,240.0,,473,285,307,592,1335.0,80,6.96,77,402,2440,11.4,1.2939755
16344,16344,Luc Robitaille,1993-94,27.0,8,125,84,84,63,62,125,265.0,,557,348,369,717,1600.0,84,7.25,87,443,2603,11.7,1.10025
16345,16345,Luc Robitaille,1994-95,28.0,9,86,83,83,44,42,86,267.0,,640,392,411,803,1867.0,84,6.48,76,407,2545,10.7,0.92042375
16346,16346,Luc Robitaille,1995-96,29.0,10,42,46,46,23,19,42,109.0,,686,415,430,845,1976.0,48,5.97,37,209,1408,10.2,0.8413726
16347,16347,Luc Robitaille,1996-97,30.0,11,69,77,77,23,46,69,223.0,,763,438,476,914,2199.0,82,6.29,74,413,2481,10.4,0.7954891
16348,16348,Luc Robitaille,1997-98,31.0,12,48,69,69,24,24,48,200.0,,832,462,500,962,2399.0,82,5.83,55,336,2444,9.8,0.7654353
16349,16349,Luc Robitaille,1998-99,32.0,13,40,57,57,16,24,40,130.0,,889,478,524,1002,2529.0,82,5.28,57,380,2242,9.6,0.808864
16350,16350,Luc Robitaille,1999-00,33.0,14,74,82,82,39,35,74,292.0,1573.0,971,517,559,1076,2821.0,82,5.27,57,359,2285,9.4,0.9210477
16351,16351,Luc Robitaille,2000-01,34.0,15,74,71,71,36,38,74,221.0,1318.0,1042,553,597,1150,3042.0,82,5.49,53,331,2294,9.8,0.8991958
16352,16352,Luc Robitaille,2001-02,35.0,16,88,82,82,37,51,88,235.0,1534.0,1124,590,648,1238,3277.0,82,5.51,63,376,2272,9.9,0.85209626
16353,16353,Luc Robitaille,2002-03,36.0,17,50,81,81,30,20,50,190.0,1203.0,1205,620,668,1288,3467.0,82,5.24,53,338,2262,9.5,0.59865534
16354,16354,Luc Robitaille,2003-04,37.0,18,31,81,81,11,20,31,148.0,1038.0,1286,631,688,1319,3615.0,82,5.31,60,363,2326,9.4,0.4407723
16355,16355,Luc Robitaille,2004-05,38.0,19,51,80,80,22,29,51,221.0,1334.0,1366,653,717,1370,3836.0,82,5.14,57,348,2300,9.2,0.50133145
16356,16356,Luc Robitaille,2006-07,40.0,20,24,65,65,15,9,24,125.0,914.0,1431,668,726,1394,3961.0,82,6.05,85,480,2458,10.1,0.336838
16357,16357,Luca Caputi,2009-10,21.0,2,1,5,5,1,0,1,7.0,51.0,5,1,0,1,7.0,82,5.7,65,341,2477,9.4,0.24621487
16358,16358,Luca Caputi,2010-11,22.0,3,8,23,23,2,6,8,36.0,325.0,28,3,6,9,43.0,82,5.53,56,304,2486,9.1,0.28934515
16359,16359,Luca Caputi,2011-12,23.0,4,0,7,7,0,0,0,8.0,77.0,35,3,6,9,51.0,82,5.46,52,291,2492,9.0,0.17810175
16360,16360,Luca Sbisa,2009-10,20.0,2,7,39,39,0,7,7,38.0,682.0,39,0,7,7,38.0,82,5.7,65,341,2477,9.4,0.230542
16361,16361,Luca Sbisa,2010-11,21.0,3,0,8,8,0,0,0,3.0,101.0,47,0,7,7,41.0,82,5.53,56,304,2486,9.1,0.19748455
16362,16362,Luca Sbisa,2011-12,22.0,4,11,68,68,2,9,11,76.0,1142.0,115,2,16,18,117.0,82,5.46,52,291,2492,9.0,0.22618636
16363,16363,Luca Sbisa,2012-13,23.0,5,24,80,80,5,19,24,88.0,1434.0,195,7,35,42,205.0,82,5.32,47,271,2439,8.9,0.29834083
16364,16364,Luca Sbisa,2013-14,24.0,6,8,41,41,1,7,8,39.0,813.0,236,8,42,50,244.0,48,5.31,29,160,1399,9.1,0.23123959
16365,16365,Luca Sbisa,2014-15,25.0,7,6,30,30,1,5,6,30.0,512.0,266,9,47,56,274.0,82,5.34,48,269,2463,8.9,0.19269171
16366,16366,Luca Sbisa,2015-16,26.0,8,11,76,76,3,8,11,79.0,1427.0,342,12,55,67,353.0,82,5.32,47,251,2453,8.9,0.18690982
16367,16367,Luca Sbisa,2016-17,27.0,9,8,41,41,2,6,8,29.0,712.0,383,14,61,75,382.0,82,5.34,48,255,2438,9.0,0.14183545
16368,16368,Luca Sbisa,2017-18,28.0,10,13,82,82,2,11,13,75.0,1556.0,465,16,72,88,457.0,82,5.45,47,245,2478,9.0,0.19290695
16369,16369,Luca Sbisa,2018-19,29.0,11,14,30,30,2,12,14,26.0,586.0,495,18,84,102,483.0,82,5.86,50,250,2620,9.2,0.22406536
16370,16370,Luca Sbisa,2019-20,30.0,12,1,9,9,0,1,1,5.0,139.0,504,18,85,103,488.0,82,5.96,47,239,2579,9.5,0.12844768
16371,16371,Luca Sbisa,2020-21,31.0,13,10,44,44,2,8,10,49.0,789.0,548,20,93,113,537.0,70,5.96,42,208,2192,9.5,0.21495208
16372,16372,Lucas Carlsson,2020-21,23.0,2,1,6,6,0,1,1,3.0,85.0,6,0,1,1,3.0,70,5.96,42,208,2192,9.5,0.21753478
16373,16373,Lucas Lessio,2014-15,22.0,2,0,3,3,0,0,0,4.0,35.0,3,0,0,0,4.0,82,5.34,48,269,2463,8.9,0.18369669
16374,16374,Lucas Lessio,2015-16,23.0,3,5,26,26,2,3,5,44.0,332.0,29,2,3,5,48.0,82,5.32,47,251,2453,8.9,0.23844853
16375,16375,Lucas Lessio,2016-17,24.0,4,2,12,12,1,1,2,14.0,126.0,41,3,4,7,62.0,82,5.34,48,255,2438,9.0,0.20003733
16376,16376,Lucas Wallmark,2017-18,22.0,2,2,8,8,0,2,2,11.0,87.0,8,0,2,2,11.0,82,5.45,47,245,2478,9.0,0.21700197
16377,16377,Lucas Wallmark,2018-19,23.0,3,1,11,11,1,0,1,16.0,104.0,19,1,2,3,27.0,82,5.86,50,250,2620,9.2,0.21318877
16378,16378,Lucas Wallmark,2019-20,24.0,4,28,81,81,10,18,28,131.0,1198.0,100,11,20,31,158.0,82,5.96,47,239,2579,9.5,0.37593925
16379,16379,Lucas Wallmark,2020-21,25.0,5,25,67,67,12,13,25,84.0,856.0,167,23,33,56,242.0,70,5.96,42,208,2192,9.5,0.36591515
16380,16380,Luciano Borsato,1991-92,26.0,2,1,1,1,0,1,1,1.0,,1,0,1,1,1.0,80,6.91,71,366,2385,11.6,0.21786681
16381,16381,Luciano Borsato,1992-93,27.0,3,36,56,56,15,21,36,81.0,,57,15,22,37,82.0,80,6.96,77,402,2440,11.4,0.5176004
16382,16382,Luciano Borsato,1993-94,28.0,4,35,67,67,15,20,35,101.0,,124,30,42,72,183.0,84,7.25,87,443,2603,11.7,0.43106985
16383,16383,Luciano Borsato,1994-95,29.0,5,18,75,75,5,13,18,65.0,,199,35,55,90,248.0,84,6.48,76,407,2545,10.7,0.24824491
16384,16384,Luciano Borsato,1995-96,30.0,6,0,4,4,0,0,0,2.0,,203,35,55,90,250.0,48,5.97,37,209,1408,10.2,0.27114064
16385,16385,Lukas Kaspar,2008-09,23.0,2,0,3,3,0,0,0,5.0,37.0,3,0,0,0,5.0,82,5.44,62,351,2383,9.4,0.17979303
16386,16386,Lukas Kaspar,2009-10,24.0,3,4,13,13,2,2,4,14.0,119.0,16,2,2,4,19.0,82,5.7,65,341,2477,9.4,0.2309652
16387,16387,Lukas Krajicek,2002-03,19.0,2,0,5,5,0,0,0,3.0,67.0,5,0,0,0,3.0,82,5.24,53,338,2262,9.5,0.2072236
16388,16388,Lukas Krajicek,2004-05,21.0,3,7,18,18,1,6,7,16.0,244.0,23,1,6,7,19.0,82,5.14,57,348,2300,9.2,0.30432355
16389,16389,Lukas Krajicek,2006-07,23.0,4,16,67,67,2,14,16,89.0,1240.0,90,3,20,23,108.0,82,6.05,85,480,2458,10.1,0.26036185
16390,16390,Lukas Krajicek,2007-08,24.0,5,16,78,78,3,13,16,105.0,1444.0,168,6,33,39,213.0,82,5.76,70,398,2426,9.7,0.23304707
16391,16391,Lukas Krajicek,2008-09,25.0,6,11,39,39,2,9,11,28.0,709.0,207,8,42,50,241.0,82,5.44,62,351,2383,9.4,0.2173867
16392,16392,Lukas Krajicek,2009-10,26.0,7,19,71,71,2,17,19,66.0,1393.0,278,10,59,69,307.0,82,5.7,65,341,2477,9.4,0.23233905
16393,16393,Lukas Krajicek,2010-11,27.0,8,3,50,50,1,2,3,42.0,861.0,328,11,61,72,349.0,82,5.53,56,304,2486,9.1,0.14091018
16394,16394,Lukas Radil,2019-20,29.0,2,11,36,36,7,4,11,40.0,385.0,36,7,4,11,40.0,82,5.96,47,239,2579,9.5,0.24543822
16395,16395,Lukas Radil,2020-21,30.0,3,0,14,14,0,0,0,12.0,132.0,50,7,4,11,52.0,70,5.96,42,208,2192,9.5,0.16456294
16396,16396,Lukas Sedlak,2017-18,24.0,2,13,62,62,7,6,13,57.0,603.0,62,7,6,13,57.0,82,5.45,47,245,2478,9.0,0.2054855
16397,16397,Lukas Sedlak,2018-19,25.0,3,8,53,53,4,4,8,50.0,498.0,115,11,10,21,107.0,82,5.86,50,250,2620,9.2,0.17779317
16398,16398,Lukas Sedlak,2019-20,26.0,4,6,47,47,4,2,6,43.0,423.0,162,15,12,27,150.0,82,5.96,47,239,2579,9.5,0.16030946
16399,16399,Lukas Vejdemo,2020-21,25.0,2,1,7,7,1,0,1,7.0,56.0,7,1,0,1,7.0,70,5.96,42,208,2192,9.5,0.21806669
16400,16400,Luke Adam,2011-12,21.0,2,4,19,19,3,1,4,31.0,213.0,19,3,1,4,31.0,82,5.46,52,291,2492,9.0,0.30534244
16401,16401,Luke Adam,2012-13,22.0,3,20,52,52,10,10,20,89.0,645.0,71,13,11,24,120.0,82,5.32,47,271,2439,8.9,0.40367237
16402,16402,Luke Adam,2013-14,23.0,4,1,4,4,1,0,1,2.0,39.0,75,14,11,25,122.0,48,5.31,29,160,1399,9.1,0.28011483
16403,16403,Luke Adam,2014-15,24.0,5,1,12,12,1,0,1,16.0,154.0,87,15,11,26,138.0,82,5.34,48,269,2463,8.9,0.22518608
16404,16404,Luke Adam,2015-16,25.0,6,0,3,3,0,0,0,0.0,19.0,90,15,11,26,138.0,82,5.32,47,251,2453,8.9,0.16458803
16405,16405,Luke Gazdic,2014-15,25.0,2,4,67,67,2,2,4,30.0,389.0,67,2,2,4,30.0,82,5.34,48,269,2463,8.9,0.10886219
16406,16406,Luke Gazdic,2015-16,26.0,3,3,40,40,2,1,3,26.0,296.0,107,4,3,7,56.0,82,5.32,47,251,2453,8.9,0.13628665
16407,16407,Luke Gazdic,2016-17,27.0,4,1,29,29,1,0,1,18.0,180.0,136,5,3,8,74.0,82,5.34,48,255,2438,9.0,0.11959073
16408,16408,Luke Gazdic,2017-18,28.0,5,0,11,11,0,0,0,3.0,78.0,147,5,3,8,77.0,82,5.45,47,245,2478,9.0,0.11249983
16409,16409,Luke Glendening,2014-15,25.0,2,7,56,56,1,6,7,54.0,779.0,56,1,6,7,54.0,82,5.34,48,269,2463,8.9,0.1578469
16410,16410,Luke Glendening,2015-16,26.0,3,18,82,82,12,6,18,104.0,1207.0,138,13,12,25,158.0,82,5.32,47,251,2453,8.9,0.25758415
16411,16411,Luke Glendening,2016-17,27.0,4,21,81,81,8,13,21,88.0,1181.0,219,21,25,46,246.0,82,5.34,48,255,2438,9.0,0.24963424
16412,16412,Luke Glendening,2017-18,28.0,5,14,74,74,3,11,14,76.0,956.0,293,24,36,60,322.0,82,5.45,47,245,2478,9.0,0.20358104
16413,16413,Luke Glendening,2018-19,29.0,6,19,69,69,11,8,19,88.0,911.0,362,35,44,79,410.0,82,5.86,50,250,2620,9.2,0.24614584
16414,16414,Luke Glendening,2019-20,30.0,7,23,78,78,10,13,23,102.0,1231.0,440,45,57,102,512.0,82,5.96,47,239,2579,9.5,0.25842285
16415,16415,Luke Glendening,2020-21,31.0,8,9,60,60,6,3,9,76.0,921.0,500,51,60,111,588.0,70,5.96,42,208,2192,9.5,0.21129131
16416,16416,Luke Johnson,2019-20,25.0,2,1,15,15,0,1,1,19.0,162.0,15,0,1,1,19.0,82,5.96,47,239,2579,9.5,0.17383757
16417,16417,Luke Johnson,2020-21,26.0,3,0,3,3,0,0,0,1.0,35.0,18,0,1,1,20.0,70,5.96,42,208,2192,9.5,0.16955516
16418,16418,Luke Kunin,2018-19,21.0,2,4,19,19,2,2,4,32.0,247.0,19,2,2,4,32.0,82,5.86,50,250,2620,9.2,0.27884945
16419,16419,Luke Kunin,2019-20,22.0,3,17,49,49,6,11,17,88.0,778.0,68,8,13,21,120.0,82,5.96,47,239,2579,9.5,0.37434113
16420,16420,Luke Kunin,2020-21,23.0,4,31,63,63,15,16,31,128.0,974.0,131,23,29,52,248.0,70,5.96,42,208,2192,9.5,0.49366853
16421,16421,Luke Richardson,1988-89,19.0,2,10,78,78,4,6,10,49.0,,78,4,6,10,49.0,80,7.43,89,437,2435,12.2,0.24669445
16422,16422,Luke Richardson,1989-90,20.0,3,9,55,55,2,7,9,59.0,,133,6,13,19,108.0,80,7.48,85,403,2430,12.3,0.27530837
16423,16423,Luke Richardson,1990-91,21.0,4,18,67,67,4,14,18,80.0,,200,10,27,37,188.0,80,7.37,76,367,2421,12.2,0.33297145
16424,16424,Luke Richardson,1991-92,22.0,5,10,78,78,1,9,10,68.0,,278,11,36,47,256.0,80,6.91,71,366,2385,11.6,0.2193399
16425,16425,Luke Richardson,1992-93,23.0,6,21,75,75,2,19,21,85.0,,353,13,55,68,341.0,80,6.96,77,402,2440,11.4,0.26534528
16426,16426,Luke Richardson,1993-94,24.0,7,13,82,82,3,10,13,78.0,,435,16,65,81,419.0,84,7.25,87,443,2603,11.7,0.20916757
16427,16427,Luke Richardson,1994-95,25.0,8,8,69,69,2,6,8,92.0,,504,18,71,89,511.0,84,6.48,76,407,2545,10.7,0.19910717
16428,16428,Luke Richardson,1995-96,26.0,9,13,46,46,3,10,13,51.0,,550,21,81,102,562.0,48,5.97,37,209,1408,10.2,0.25292772
16429,16429,Luke Richardson,1996-97,27.0,10,11,82,82,2,9,11,61.0,,632,23,90,113,623.0,82,6.29,74,413,2481,10.4,0.17070553
16430,16430,Luke Richardson,1997-98,28.0,11,12,82,82,1,11,12,67.0,,714,24,101,125,690.0,82,5.83,55,336,2444,9.8,0.14650318
16431,16431,Luke Richardson,1998-99,29.0,12,5,81,81,2,3,5,57.0,,795,26,104,130,747.0,82,5.28,57,380,2242,9.6,0.13206285
16432,16432,Luke Richardson,1999-00,30.0,13,6,78,78,0,6,6,49.0,1291.0,873,26,110,136,796.0,82,5.27,57,359,2285,9.4,0.12608314
16433,16433,Luke Richardson,2000-01,31.0,14,7,74,74,2,5,7,50.0,1197.0,947,28,115,143,846.0,82,5.49,53,331,2294,9.8,0.13038853
16434,16434,Luke Richardson,2001-02,32.0,15,8,82,82,2,6,8,75.0,1698.0,1029,30,121,151,921.0,82,5.51,63,376,2272,9.9,0.13823351
16435,16435,Luke Richardson,2002-03,33.0,16,9,72,72,1,8,9,65.0,1316.0,1101,31,129,160,986.0,82,5.24,53,338,2262,9.5,0.11433363
16436,16436,Luke Richardson,2003-04,34.0,17,13,82,82,0,13,13,56.0,1929.0,1183,31,142,173,1042.0,82,5.31,60,363,2326,9.4,0.1103946
16437,16437,Luke Richardson,2004-05,35.0,18,6,64,64,1,5,6,34.0,1288.0,1247,32,147,179,1076.0,82,5.14,57,348,2300,9.2,0.122982204
16438,16438,Luke Richardson,2006-07,37.0,19,10,65,65,1,9,10,40.0,1066.0,1312,33,156,189,1116.0,82,6.05,85,480,2458,10.1,0.10365999
16439,16439,Luke Richardson,2007-08,38.0,20,3,27,27,0,3,3,3.0,192.0,1339,33,159,192,1119.0,82,5.76,70,398,2426,9.7,0.0761762
16440,16440,Luke Richardson,2008-09,39.0,21,9,76,76,2,7,9,41.0,936.0,1415,35,166,201,1160.0,82,5.44,62,351,2383,9.4,0.115162194
16441,16441,Luke Richardson,2009-10,40.0,22,0,2,2,0,0,0,0.0,26.0,1417,35,166,201,1160.0,82,5.7,65,341,2477,9.4,0.190781
16442,16442,Luke Schenn,2009-10,20.0,2,14,70,70,2,12,14,102.0,1507.0,70,2,12,14,102.0,82,5.7,65,341,2477,9.4,0.2661257
16443,16443,Luke Schenn,2010-11,21.0,3,17,79,79,5,12,17,101.0,1333.0,149,7,24,31,203.0,82,5.53,56,304,2486,9.1,0.29860562
16444,16444,Luke Schenn,2011-12,22.0,4,22,82,82,5,17,22,128.0,1834.0,231,12,41,53,331.0,82,5.46,52,291,2492,9.0,0.3021242
16445,16445,Luke Schenn,2012-13,23.0,5,22,79,79,2,20,22,81.0,1267.0,310,14,61,75,412.0,82,5.32,47,271,2439,8.9,0.2674507
16446,16446,Luke Schenn,2013-14,24.0,6,11,47,47,3,8,11,81.0,1028.0,357,17,69,86,493.0,48,5.31,29,160,1399,9.1,0.29576004
16447,16447,Luke Schenn,2014-15,25.0,7,12,79,79,4,8,12,78.0,1307.0,436,21,77,98,571.0,82,5.34,48,269,2463,8.9,0.21381599
16448,16448,Luke Schenn,2015-16,26.0,8,14,58,58,3,11,14,67.0,1048.0,494,24,88,112,638.0,82,5.32,47,251,2453,8.9,0.22596979
16449,16449,Luke Schenn,2016-17,27.0,9,16,72,72,4,12,16,76.0,1265.0,566,28,100,128,714.0,82,5.34,48,255,2438,9.0,0.21600059
16450,16450,Luke Schenn,2017-18,28.0,10,8,78,78,1,7,8,94.0,1408.0,644,29,107,136,808.0,82,5.45,47,245,2478,9.0,0.18971747
16451,16451,Luke Schenn,2018-19,29.0,11,7,64,64,1,6,7,59.0,1049.0,708,30,113,143,867.0,82,5.86,50,250,2620,9.2,0.13715827
16452,16452,Luke Schenn,2019-20,30.0,12,2,26,26,0,2,2,30.0,362.0,734,30,115,145,897.0,82,5.96,47,239,2579,9.5,0.13248435
16453,16453,Luke Schenn,2020-21,31.0,13,3,25,25,1,2,3,31.0,311.0,759,31,117,148,928.0,70,5.96,42,208,2192,9.5,0.14670205
16454,16454,Luke Sellars,2002-03,21.0,2,0,1,1,0,0,0,0.0,3.0,1,0,0,0,0.0,82,5.24,53,338,2262,9.5,0.17350736
16455,16455,Luke Witkowski,2015-16,25.0,2,0,16,16,0,0,0,10.0,243.0,16,0,0,0,10.0,82,5.32,47,251,2453,8.9,0.16054782
16456,16456,Luke Witkowski,2016-17,26.0,3,0,4,4,0,0,0,1.0,29.0,20,0,0,0,11.0,82,5.34,48,255,2438,9.0,0.144142
16457,16457,Luke Witkowski,2017-18,27.0,4,4,34,34,0,4,4,24.0,336.0,54,0,4,4,35.0,82,5.45,47,245,2478,9.0,0.13878992
16458,16458,Luke Witkowski,2018-19,28.0,5,4,31,31,1,3,4,16.0,213.0,85,1,7,8,51.0,82,5.86,50,250,2620,9.2,0.13273752
16459,16459,Luke Witkowski,2019-20,29.0,6,2,34,34,0,2,2,14.0,326.0,119,1,9,10,65.0,82,5.96,47,239,2579,9.5,0.08922997
16460,16460,Luke Witkowski,2020-21,30.0,7,3,12,12,1,2,3,10.0,106.0,131,2,11,13,75.0,70,5.96,42,208,2192,9.5,0.19690132
16461,16461,Lyle Odelein,1990-91,22.0,2,2,8,8,0,2,2,1.0,,8,0,2,2,1.0,80,7.37,76,367,2421,12.2,0.22707778
16462,16462,Lyle Odelein,1991-92,23.0,3,2,52,52,0,2,2,25.0,,60,0,4,4,26.0,80,6.91,71,366,2385,11.6,0.14490202
16463,16463,Lyle Odelein,1992-93,24.0,4,8,71,71,1,7,8,43.0,,131,1,11,12,69.0,80,6.96,77,402,2440,11.4,0.17194855
16464,16464,Lyle Odelein,1993-94,25.0,5,16,83,83,2,14,16,79.0,,214,3,25,28,148.0,84,7.25,87,443,2603,11.7,0.2038227
16465,16465,Lyle Odelein,1994-95,26.0,6,40,79,79,11,29,40,116.0,,293,14,54,68,264.0,84,6.48,76,407,2545,10.7,0.38123122
16466,16466,Lyle Odelein,1995-96,27.0,7,10,48,48,3,7,10,74.0,,341,17,61,78,338.0,48,5.97,37,209,1408,10.2,0.25531203
16467,16467,Lyle Odelein,1996-97,28.0,8,17,79,79,3,14,17,74.0,,420,20,75,95,412.0,82,6.29,74,413,2481,10.4,0.20992115
16468,16468,Lyle Odelein,1997-98,29.0,9,16,79,79,3,13,16,93.0,,499,23,88,111,505.0,82,5.83,55,336,2444,9.8,0.22417119
16469,16469,Lyle Odelein,1998-99,30.0,10,23,79,79,4,19,23,76.0,,578,27,107,134,581.0,82,5.28,57,380,2242,9.6,0.22268406
16470,16470,Lyle Odelein,1999-00,31.0,11,31,70,70,5,26,31,101.0,1392.0,648,32,133,165,682.0,82,5.27,57,359,2285,9.4,0.36649573
16471,16471,Lyle Odelein,2000-01,32.0,12,24,73,73,2,22,24,89.0,1300.0,721,34,155,189,771.0,82,5.49,53,331,2294,9.8,0.24704084
16472,16472,Lyle Odelein,2001-02,33.0,13,17,81,81,3,14,17,104.0,1743.0,802,37,169,206,875.0,82,5.51,63,376,2272,9.9,0.21265873
16473,16473,Lyle Odelein,2002-03,34.0,14,18,77,77,2,16,18,86.0,1735.0,879,39,185,224,961.0,82,5.24,53,338,2262,9.5,0.18822637
16474,16474,Lyle Odelein,2003-04,35.0,15,11,68,68,7,4,11,78.0,1294.0,947,46,189,235,1039.0,82,5.31,60,363,2326,9.4,0.16030425
16475,16475,Lyle Odelein,2004-05,36.0,16,16,82,82,4,12,16,67.0,1549.0,1029,50,201,251,1106.0,82,5.14,57,348,2300,9.2,0.16463134
16476,16476,Lyle Odelein,2006-07,38.0,17,1,27,27,0,1,1,17.0,438.0,1056,50,202,252,1123.0,82,6.05,85,480,2458,10.1,0.12179029
16477,16477,Lyle Phair,1986-87,25.0,2,1,15,15,0,1,1,11.0,,15,0,1,1,11.0,80,7.94,82,370,2484,12.8,0.21335462
16478,16478,Lyle Phair,1987-88,26.0,3,2,5,5,2,0,2,4.0,,20,2,1,3,15.0,80,7.34,72,344,2400,12.2,0.27924994
16479,16479,Lyle Phair,1988-89,27.0,4,10,28,28,4,6,10,35.0,,48,6,7,13,50.0,80,7.43,89,437,2435,12.2,0.2962968
16480,16480,Lyndon Byers,1984-85,20.0,2,6,10,10,2,4,6,11.0,,10,2,4,6,11.0,80,7.89,74,336,2448,12.9,0.37796402
16481,16481,Lyndon Byers,1985-86,21.0,3,11,33,33,3,8,11,25.0,,43,5,12,17,36.0,80,7.77,71,321,2447,12.7,0.34084237
16482,16482,Lyndon Byers,1986-87,22.0,4,2,5,5,0,2,2,1.0,,48,5,14,19,37.0,80,7.94,82,370,2484,12.8,0.25489327
16483,16483,Lyndon Byers,1987-88,23.0,5,5,18,18,2,3,5,14.0,,66,7,17,24,51.0,80,7.34,72,344,2400,12.2,0.3131879
16484,16484,Lyndon Byers,1988-89,24.0,6,24,53,53,10,14,24,69.0,,119,17,31,48,120.0,80,7.43,89,437,2435,12.2,0.3763349
16485,16485,Lyndon Byers,1989-90,25.0,7,4,49,49,0,4,4,25.0,,168,17,35,52,145.0,80,7.48,85,403,2430,12.3,0.15989023
16486,16486,Lyndon Byers,1990-91,26.0,8,8,43,43,4,4,8,43.0,,211,21,39,60,188.0,80,7.37,76,367,2421,12.2,0.21106946
16487,16487,Lyndon Byers,1991-92,27.0,9,4,19,19,2,2,4,20.0,,230,23,41,64,208.0,80,6.91,71,366,2385,11.6,0.23298475
16488,16488,Lyndon Byers,1992-93,28.0,10,2,31,31,1,1,2,12.0,,261,24,42,66,220.0,80,6.96,77,402,2440,11.4,0.16709816
16489,16489,Lyndon Byers,1993-94,29.0,11,5,18,18,4,1,5,18.0,,279,28,43,71,238.0,84,7.25,87,443,2603,11.7,0.23654822
16490,16490,Lynn Loyns,2003-04,22.0,2,3,19,19,3,0,3,12.0,149.0,19,3,0,3,12.0,82,5.31,60,363,2326,9.4,0.2313762
16491,16491,Lynn Loyns,2004-05,23.0,3,2,14,14,0,2,2,6.0,150.0,33,3,2,5,18.0,82,5.14,57,348,2300,9.2,0.22554109
16492,16492,Lynn Loyns,2006-07,25.0,4,0,1,1,0,0,0,0.0,6.0,34,3,2,5,18.0,82,6.05,85,480,2458,10.1,0.14862704
16493,16493,MacGregor Sharp,2010-11,25.0,2,0,8,8,0,0,0,6.0,33.0,8,0,0,0,6.0,82,5.53,56,304,2486,9.1,0.16698298
16494,16494,MacKenzie Weegar,2017-18,24.0,2,0,3,3,0,0,0,3.0,52.0,3,0,0,0,3.0,82,5.45,47,245,2478,9.0,0.17442444
16495,16495,MacKenzie Weegar,2018-19,25.0,3,8,60,60,2,6,8,58.0,874.0,63,2,6,8,61.0,82,5.86,50,250,2620,9.2,0.1578066
16496,16496,MacKenzie Weegar,2019-20,26.0,4,15,64,64,4,11,15,79.0,1086.0,127,6,17,23,140.0,82,5.96,47,239,2579,9.5,0.20495895
16497,16497,MacKenzie Weegar,2020-21,27.0,5,18,45,45,7,11,18,77.0,905.0,172,13,28,41,217.0,70,5.96,42,208,2192,9.5,0.3667298
16498,16498,Mackenzie MacEachern,2019-20,25.0,2,5,29,29,3,2,5,33.0,233.0,29,3,2,5,33.0,82,5.96,47,239,2579,9.5,0.22277093
16499,16499,Mackenzie MacEachern,2020-21,26.0,3,10,51,51,7,3,10,63.0,457.0,80,10,5,15,96.0,70,5.96,42,208,2192,9.5,0.27796972
16500,16500,Madison Bowey,2018-19,23.0,2,12,51,51,0,12,12,47.0,699.0,51,0,12,12,47.0,82,5.86,50,250,2620,9.2,0.18487823
16501,16501,Madison Bowey,2019-20,24.0,3,10,50,50,2,8,10,48.0,763.0,101,2,20,22,95.0,82,5.96,47,239,2579,9.5,0.2284945
16502,16502,Madison Bowey,2020-21,25.0,4,17,53,53,3,14,17,70.0,949.0,154,5,34,39,165.0,70,5.96,42,208,2192,9.5,0.31420287
16503,16503,Magnus Arvedson,1998-99,27.0,2,26,61,61,11,15,26,90.0,,61,11,15,26,90.0,82,5.28,57,380,2242,9.6,0.34246957
16504,16504,Magnus Arvedson,1999-00,28.0,3,47,80,80,21,26,47,136.0,1371.0,141,32,41,73,226.0,82,5.27,57,359,2285,9.4,0.5611426
16505,16505,Magnus Arvedson,2000-01,29.0,4,28,47,47,15,13,28,91.0,849.0,188,47,54,101,317.0,82,5.49,53,331,2294,9.8,0.51475096
16506,16506,Magnus Arvedson,2001-02,30.0,5,33,51,51,17,16,33,79.0,817.0,239,64,70,134,396.0,82,5.51,63,376,2272,9.9,0.5457966
16507,16507,Magnus Arvedson,2002-03,31.0,6,39,74,74,12,27,39,121.0,1312.0,313,76,97,173,517.0,82,5.24,53,338,2262,9.5,0.479568
16508,16508,Magnus Arvedson,2003-04,32.0,7,37,80,80,16,21,37,138.0,1433.0,393,92,118,210,655.0,82,5.31,60,363,2326,9.4,0.46602297
16509,16509,Magnus Arvedson,2004-05,33.0,8,15,41,41,8,7,15,54.0,594.0,434,100,125,225,709.0,82,5.14,57,348,2300,9.2,0.3638358
16510,16510,Magnus Johansson,2008-09,35.0,2,14,45,45,0,14,14,37.0,709.0,45,0,14,14,37.0,82,5.44,62,351,2383,9.4,0.20281652
16511,16511,Magnus Paajarvi,2011-12,20.0,2,34,80,80,15,19,34,180.0,1231.0,80,15,19,34,180.0,82,5.46,52,291,2492,9.0,0.49793127
16512,16512,Magnus Paajarvi,2012-13,21.0,3,8,41,41,2,6,8,79.0,540.0,121,17,25,42,259.0,82,5.32,47,271,2439,8.9,0.34647238
16513,16513,Magnus Paajarvi,2013-14,22.0,4,16,42,42,9,7,16,75.0,593.0,163,26,32,58,334.0,48,5.31,29,160,1399,9.1,0.43264517
16514,16514,Magnus Paajarvi,2014-15,23.0,5,12,55,55,6,6,12,60.0,564.0,218,32,38,70,394.0,82,5.34,48,269,2463,8.9,0.32068896
16515,16515,Magnus Paajarvi,2015-16,24.0,6,1,10,10,0,1,1,9.0,98.0,228,32,39,71,403.0,82,5.32,47,251,2453,8.9,0.26131046
16516,16516,Magnus Paajarvi,2016-17,25.0,7,9,48,48,3,6,9,88.0,617.0,276,35,45,80,491.0,82,5.34,48,255,2438,9.0,0.22942719
16517,16517,Magnus Paajarvi,2017-18,26.0,8,13,32,32,8,5,13,51.0,389.0,308,43,50,93,542.0,82,5.45,47,245,2478,9.0,0.30638677
16518,16518,Magnus Paajarvi,2018-19,27.0,9,12,79,79,8,4,12,126.0,984.0,387,51,54,105,668.0,82,5.86,50,250,2620,9.2,0.23474798
16519,16519,Magnus Paajarvi,2019-20,28.0,10,19,80,80,11,8,19,119.0,1078.0,467,62,62,124,787.0,82,5.96,47,239,2579,9.5,0.25669438
16520,16520,Magnus Roupe,1988-89,25.0,2,6,33,33,2,4,6,37.0,,33,2,4,6,37.0,80,7.43,89,437,2435,12.2,0.26247227
16521,16521,Magnus Roupe,1989-90,26.0,3,2,7,7,1,1,2,15.0,,40,3,5,8,52.0,80,7.48,85,403,2430,12.3,0.23263806
16522,16522,Magnus Svensson,1995-96,32.0,2,7,19,19,2,5,7,41.0,,19,2,5,7,41.0,48,5.97,37,209,1408,10.2,0.33067912
16523,16523,Magnus Svensson,1996-97,33.0,3,11,27,27,2,9,11,58.0,,46,4,14,18,99.0,82,6.29,74,413,2481,10.4,0.25203252
16524,16524,Maksim Mayorov,2009-10,20.0,2,0,3,3,0,0,0,1.0,17.0,3,0,0,0,1.0,82,5.7,65,341,2477,9.4,0.24377522
16525,16525,Maksim Mayorov,2010-11,21.0,3,0,4,4,0,0,0,4.0,31.0,7,0,0,0,5.0,82,5.53,56,304,2486,9.1,0.21040192
16526,16526,Maksim Mayorov,2011-12,22.0,4,1,5,5,1,0,1,3.0,44.0,12,1,0,1,8.0,82,5.46,52,291,2492,9.0,0.21537653
16527,16527,Maksim Mayorov,2012-13,23.0,5,2,10,10,1,1,2,9.0,107.0,22,2,1,3,17.0,82,5.32,47,271,2439,8.9,0.20421779
16528,16528,Manny Malhotra,1999-00,19.0,2,16,73,73,8,8,16,61.0,628.0,73,8,8,16,61.0,82,5.27,57,359,2285,9.4,0.2591484
16529,16529,Manny Malhotra,2000-01,20.0,3,0,27,27,0,0,0,18.0,181.0,100,8,8,16,79.0,82,5.49,53,331,2294,9.8,0.24525553
16530,16530,Manny Malhotra,2001-02,21.0,4,12,50,50,4,8,12,46.0,453.0,150,12,16,28,125.0,82,5.51,63,376,2272,9.9,0.25446206
16531,16531,Manny Malhotra,2002-03,22.0,5,14,72,72,8,6,14,60.0,743.0,222,20,22,42,185.0,82,5.24,53,338,2262,9.5,0.2440975
16532,16532,Manny Malhotra,2003-04,23.0,6,10,59,59,3,7,10,62.0,552.0,281,23,29,52,247.0,82,5.31,60,363,2326,9.4,0.2520669
16533,16533,Manny Malhotra,2004-05,24.0,7,25,65,65,12,13,25,107.0,898.0,346,35,42,77,354.0,82,5.14,57,348,2300,9.2,0.43866125
16534,16534,Manny Malhotra,2006-07,26.0,8,31,58,58,10,21,31,102.0,949.0,404,45,63,108,456.0,82,6.05,85,480,2458,10.1,0.4440212
16535,16535,Manny Malhotra,2007-08,27.0,9,25,82,82,9,16,25,109.0,1214.0,486,54,79,133,565.0,82,5.76,70,398,2426,9.7,0.3054064
16536,16536,Manny Malhotra,2008-09,28.0,10,29,71,71,11,18,29,112.0,1169.0,557,65,97,162,677.0,82,5.44,62,351,2383,9.4,0.365104
16537,16537,Manny Malhotra,2009-10,29.0,11,35,77,77,11,24,35,116.0,1387.0,634,76,121,197,793.0,82,5.7,65,341,2477,9.4,0.37364334
16538,16538,Manny Malhotra,2010-11,30.0,12,33,71,71,14,19,33,111.0,1109.0,705,90,140,230,904.0,82,5.53,56,304,2486,9.1,0.35813725
16539,16539,Manny Malhotra,2011-12,31.0,13,30,72,72,11,19,30,111.0,1164.0,777,101,159,260,1015.0,82,5.46,52,291,2492,9.0,0.3183511
16540,16540,Manny Malhotra,2012-13,32.0,14,18,78,78,7,11,18,60.0,963.0,855,108,170,278,1075.0,82,5.32,47,271,2439,8.9,0.21026164
16541,16541,Manny Malhotra,2013-14,33.0,15,0,9,9,0,0,0,2.0,100.0,864,108,170,278,1077.0,48,5.31,29,160,1399,9.1,0.19975445
16542,16542,Manny Malhotra,2014-15,34.0,16,13,69,69,7,6,13,53.0,800.0,933,115,176,291,1130.0,82,5.34,48,269,2463,8.9,0.1633769
16543,16543,Manny Malhotra,2015-16,35.0,17,4,58,58,1,3,4,46.0,629.0,991,116,179,295,1176.0,82,5.32,47,251,2453,8.9,0.14622998
16544,16544,Marc Bergevin,1985-86,20.0,2,6,60,60,0,6,6,41.0,,60,0,6,6,41.0,80,7.77,71,321,2447,12.7,0.25713015
16545,16545,Marc Bergevin,1986-87,21.0,3,14,71,71,7,7,14,50.0,,131,7,13,20,91.0,80,7.94,82,370,2484,12.8,0.25636438
16546,16546,Marc Bergevin,1987-88,22.0,4,14,66,66,4,10,14,55.0,,197,11,23,34,146.0,80,7.34,72,344,2400,12.2,0.24722388
16547,16547,Marc Bergevin,1988-89,23.0,5,7,58,58,1,6,7,51.0,,255,12,29,41,197.0,80,7.43,89,437,2435,12.2,0.22624657
16548,16548,Marc Bergevin,1989-90,24.0,6,15,69,69,2,13,15,65.0,,324,14,42,56,262.0,80,7.48,85,403,2430,12.3,0.22839147
16549,16549,Marc Bergevin,1990-91,25.0,7,4,18,18,0,4,4,12.0,,342,14,46,60,274.0,80,7.37,76,367,2421,12.2,0.2141467
16550,16550,Marc Bergevin,1991-92,26.0,8,0,4,4,0,0,0,2.0,,346,14,46,60,276.0,80,6.91,71,366,2385,11.6,0.18364027
16551,16551,Marc Bergevin,1992-93,27.0,9,24,75,75,7,17,24,96.0,,421,21,63,84,372.0,80,6.96,77,402,2440,11.4,0.2791252
16552,16552,Marc Bergevin,1993-94,28.0,10,14,78,78,2,12,14,69.0,,499,23,75,98,441.0,84,7.25,87,443,2603,11.7,0.17639387
16553,16553,Marc Bergevin,1994-95,29.0,11,16,83,83,1,15,16,76.0,,582,24,90,114,517.0,84,6.48,76,407,2545,10.7,0.17918262
16554,16554,Marc Bergevin,1995-96,30.0,12,6,44,44,2,4,6,32.0,,626,26,94,120,549.0,48,5.97,37,209,1408,10.2,0.14286539
16555,16555,Marc Bergevin,1996-97,31.0,13,10,70,70,1,9,10,26.0,,696,27,103,130,575.0,82,6.29,74,413,2481,10.4,0.112317234
16556,16556,Marc Bergevin,1997-98,32.0,14,4,82,82,0,4,4,30.0,,778,27,107,134,605.0,82,5.83,55,336,2444,9.8,0.100265205
16557,16557,Marc Bergevin,1998-99,33.0,15,10,81,81,3,7,10,40.0,,859,30,114,144,645.0,82,5.28,57,380,2242,9.6,0.113666505
16558,16558,Marc Bergevin,1999-00,34.0,16,2,52,52,1,1,2,40.0,840.0,911,31,115,146,685.0,82,5.27,57,359,2285,9.4,0.11430445
16559,16559,Marc Bergevin,2000-01,35.0,17,9,81,81,1,8,9,54.0,1723.0,992,32,123,155,739.0,82,5.49,53,331,2294,9.8,0.10766864
16560,16560,Marc Bergevin,2001-02,36.0,18,5,38,38,1,4,5,12.0,640.0,1030,33,127,160,751.0,82,5.51,63,376,2272,9.9,0.079622895
16561,16561,Marc Bergevin,2002-03,37.0,19,3,30,30,0,3,3,13.0,368.0,1060,33,130,163,764.0,82,5.24,53,338,2262,9.5,0.090125024
16562,16562,Marc Bergevin,2003-04,38.0,20,7,70,70,2,5,7,27.0,1313.0,1130,35,135,170,791.0,82,5.31,60,363,2326,9.4,0.1034525
16563,16563,Marc Bergevin,2004-05,39.0,21,11,61,61,1,10,11,30.0,978.0,1191,36,145,181,821.0,82,5.14,57,348,2300,9.2,0.11878383
16564,16564,Marc Bureau,1990-91,24.0,2,0,5,5,0,0,0,3.0,,5,0,0,0,3.0,80,7.37,76,367,2421,12.2,0.2231631
16565,16565,Marc Bureau,1991-92,25.0,3,6,14,14,0,6,6,12.0,,19,0,6,6,15.0,80,6.91,71,366,2385,11.6,0.23155707
16566,16566,Marc Bureau,1992-93,26.0,4,10,46,46,6,4,10,53.0,,65,6,10,16,68.0,80,6.96,77,402,2440,11.4,0.25977844
16567,16567,Marc Bureau,1993-94,27.0,5,31,63,63,10,21,31,132.0,,128,16,31,47,200.0,84,7.25,87,443,2603,11.7,0.43473858
16568,16568,Marc Bureau,1994-95,28.0,6,15,75,75,8,7,15,110.0,,203,24,38,62,310.0,84,6.48,76,407,2545,10.7,0.22758096
16569,16569,Marc Bureau,1995-96,29.0,7,14,48,48,2,12,14,72.0,,251,26,50,76,382.0,48,5.97,37,209,1408,10.2,0.28988057
16570,16570,Marc Bureau,1996-97,30.0,8,10,65,65,3,7,10,43.0,,316,29,57,86,425.0,82,6.29,74,413,2481,10.4,0.16042891
16571,16571,Marc Bureau,1997-98,31.0,9,15,43,43,6,9,15,56.0,,359,35,66,101,481.0,82,5.83,55,336,2444,9.8,0.24980539
16572,16572,Marc Bureau,1998-99,32.0,10,19,74,74,13,6,19,82.0,,433,48,72,120,563.0,82,5.28,57,380,2242,9.6,0.27160007
16573,16573,Marc Bureau,1999-00,33.0,11,10,71,71,4,6,10,52.0,783.0,504,52,78,130,615.0,82,5.27,57,359,2285,9.4,0.15282181
16574,16574,Marc Bureau,2000-01,34.0,12,8,63,63,3,5,8,51.0,724.0,567,55,83,138,666.0,82,5.49,53,331,2294,9.8,0.14010149
16575,16575,Marc Chorney,1981-82,22.0,2,7,8,8,1,6,7,3.0,,8,1,6,7,3.0,80,7.69,77,340,2441,12.6,0.34837085
16576,16576,Marc Chorney,1982-83,23.0,3,7,60,60,1,6,7,37.0,,68,2,12,14,40.0,80,8.03,73,320,2489,12.9,0.18973279
16577,16577,Marc Chorney,1983-84,24.0,4,8,67,67,3,5,8,65.0,,135,5,17,22,105.0,80,7.73,71,310,2444,12.7,0.20502052
16578,16578,Marc Chorney,1984-85,25.0,5,13,75,75,3,10,13,62.0,,210,8,27,35,167.0,80,7.89,74,336,2448,12.9,0.22442141
16579,16579,Marc Chouinard,2001-02,24.0,2,7,44,44,3,4,7,26.0,345.0,44,3,4,7,26.0,82,5.51,63,376,2272,9.9,0.1492753
16580,16580,Marc Chouinard,2002-03,25.0,3,9,45,45,4,5,9,40.0,477.0,89,7,9,16,66.0,82,5.24,53,338,2262,9.5,0.17001548
16581,16581,Marc Chouinard,2003-04,26.0,4,7,70,70,3,4,7,52.0,659.0,159,10,13,23,118.0,82,5.31,60,363,2326,9.4,0.15677187
16582,16582,Marc Chouinard,2004-05,27.0,5,21,45,45,11,10,21,70.0,719.0,204,21,23,44,188.0,82,5.14,57,348,2300,9.2,0.36982954
16583,16583,Marc Chouinard,2006-07,29.0,6,30,74,74,14,16,30,112.0,1220.0,278,35,39,74,300.0,82,6.05,85,480,2458,10.1,0.35469872
16584,16584,Marc Chouinard,2007-08,30.0,7,4,42,42,2,2,4,15.0,396.0,320,37,41,78,315.0,82,5.76,70,398,2426,9.7,0.12394762
16585,16585,Marc Crawford,1982-83,21.0,2,12,40,40,4,8,12,57.0,,40,4,8,12,57.0,80,8.03,73,320,2489,12.9,0.34745905
16586,16586,Marc Crawford,1983-84,22.0,3,9,41,41,4,5,9,34.0,,81,8,13,21,91.0,80,7.73,71,310,2444,12.7,0.2593419
16587,16587,Marc Crawford,1984-85,23.0,4,1,19,19,0,1,1,12.0,,100,8,14,22,103.0,80,7.89,74,336,2448,12.9,0.23781624
16588,16588,Marc Crawford,1985-86,24.0,5,0,1,1,0,0,0,0.0,,101,8,14,22,103.0,80,7.77,71,321,2447,12.7,0.23039529
16589,16589,Marc Crawford,1986-87,25.0,6,25,54,54,11,14,25,80.0,,155,19,28,47,183.0,80,7.94,82,370,2484,12.8,0.397845
16590,16590,Marc Crawford,1987-88,26.0,7,3,21,21,0,3,3,19.0,,176,19,31,50,202.0,80,7.34,72,344,2400,12.2,0.21416464
16591,16591,Marc Fortier,1988-89,22.0,2,14,27,27,4,10,14,40.0,,27,4,10,14,40.0,80,7.43,89,437,2435,12.2,0.40317303
16592,16592,Marc Fortier,1989-90,23.0,3,39,57,57,20,19,39,90.0,,84,24,29,53,130.0,80,7.48,85,403,2430,12.3,0.5819703
16593,16593,Marc Fortier,1990-91,24.0,4,30,59,59,13,17,30,89.0,,143,37,46,83,219.0,80,7.37,76,367,2421,12.2,0.48119137
16594,16594,Marc Fortier,1991-92,25.0,5,4,14,14,0,4,4,13.0,,157,37,50,87,232.0,80,6.91,71,366,2385,11.6,0.348508
16595,16595,Marc Fortier,1992-93,26.0,6,14,39,39,5,9,14,42.0,,196,42,59,101,274.0,80,6.96,77,402,2440,11.4,0.35711324
16596,16596,Marc Fortier,1993-94,27.0,7,1,16,16,0,1,1,14.0,,212,42,60,102,288.0,84,7.25,87,443,2603,11.7,0.28273696
16597,16597,Marc Habscheid,1982-83,19.0,2,4,7,7,1,3,4,7.0,,7,1,3,4,7.0,80,8.03,73,320,2489,12.9,0.34714603
16598,16598,Marc Habscheid,1983-84,20.0,3,13,32,32,3,10,13,19.0,,39,4,13,17,26.0,80,7.73,71,310,2444,12.7,0.34739646
16599,16599,Marc Habscheid,1984-85,21.0,4,1,9,9,1,0,1,6.0,,48,5,13,18,32.0,80,7.89,74,336,2448,12.9,0.33299756
16600,16600,Marc Habscheid,1985-86,22.0,5,8,26,26,5,3,8,30.0,,74,10,16,26,62.0,80,7.77,71,321,2447,12.7,0.3805287
16601,16601,Marc Habscheid,1986-87,23.0,6,5,6,6,2,3,5,8.0,,80,12,19,31,70.0,80,7.94,82,370,2484,12.8,0.3309006
16602,16602,Marc Habscheid,1987-88,24.0,7,2,15,15,2,0,2,14.0,,95,14,19,33,84.0,80,7.34,72,344,2400,12.2,0.34090403
16603,16603,Marc Habscheid,1988-89,25.0,8,15,16,16,4,11,15,44.0,,111,18,30,48,128.0,80,7.43,89,437,2435,12.2,0.47471195
16604,16604,Marc Habscheid,1989-90,26.0,9,54,76,76,23,31,54,182.0,,187,41,61,102,310.0,80,7.48,85,403,2430,12.3,0.6293559
16605,16605,Marc Habscheid,1990-91,27.0,10,26,66,66,15,11,26,114.0,,253,56,72,128,424.0,80,7.37,76,367,2421,12.2,0.3457388
16606,16606,Marc Habscheid,1991-92,28.0,11,17,46,46,9,8,17,54.0,,299,65,80,145,478.0,80,6.91,71,366,2385,11.6,0.33159608
16607,16607,Marc Habscheid,1992-93,29.0,12,18,46,46,7,11,18,60.0,,345,72,91,163,538.0,80,6.96,77,402,2440,11.4,0.39681438
16608,16608,Marc Labelle,1997-98,28.0,2,0,9,9,0,0,0,2.0,,9,0,0,0,2.0,82,5.83,55,336,2444,9.8,0.14468402
16609,16609,Marc Laforge,1990-91,23.0,2,0,9,9,0,0,0,0.0,,9,0,0,0,0.0,80,7.37,76,367,2421,12.2,0.17319295
16610,16610,Marc Laforge,1994-95,27.0,3,0,5,5,0,0,0,0.0,,14,0,0,0,0.0,84,6.48,76,407,2545,10.7,0.1267905
16611,16611,Marc Magnan,1983-84,21.0,2,1,4,4,0,1,1,1.0,,4,0,1,1,1.0,80,7.73,71,310,2444,12.7,0.2937922
16612,16612,Marc Methot,2007-08,22.0,2,4,20,20,0,4,4,11.0,293.0,20,0,4,4,11.0,82,5.76,70,398,2426,9.7,0.13795301
16613,16613,Marc Methot,2008-09,23.0,3,0,9,9,0,0,0,9.0,128.0,29,0,4,4,20.0,82,5.44,62,351,2383,9.4,0.16884995
16614,16614,Marc Methot,2009-10,24.0,4,17,66,66,4,13,17,58.0,1185.0,95,4,17,21,78.0,82,5.7,65,341,2477,9.4,0.20865664
16615,16615,Marc Methot,2010-11,25.0,5,8,60,60,2,6,8,42.0,1171.0,155,6,23,29,120.0,82,5.53,56,304,2486,9.1,0.15725076
16616,16616,Marc Methot,2011-12,26.0,6,15,74,74,0,15,15,58.0,1472.0,229,6,38,44,178.0,82,5.46,52,291,2492,9.0,0.17189899
16617,16617,Marc Methot,2012-13,27.0,7,7,46,46,1,6,7,42.0,922.0,275,7,44,51,220.0,82,5.32,47,271,2439,8.9,0.14352217
16618,16618,Marc Methot,2013-14,28.0,8,11,47,47,2,9,11,53.0,1045.0,322,9,53,62,273.0,48,5.31,29,160,1399,9.1,0.23025274
16619,16619,Marc Methot,2014-15,29.0,9,23,75,75,6,17,23,117.0,1632.0,397,15,70,85,390.0,82,5.34,48,269,2463,8.9,0.25634697
16620,16620,Marc Methot,2015-16,30.0,10,11,45,45,1,10,11,49.0,1020.0,442,16,80,96,439.0,82,5.32,47,251,2453,8.9,0.17018738
16621,16621,Marc Methot,2016-17,31.0,11,12,69,69,5,7,12,74.0,1425.0,511,21,87,108,513.0,82,5.34,48,255,2438,9.0,0.18144995
16622,16622,Marc Methot,2017-18,32.0,12,12,68,68,0,12,12,69.0,1348.0,579,21,99,120,582.0,82,5.45,47,245,2478,9.0,0.13502714
16623,16623,Marc Methot,2018-19,33.0,13,3,36,36,1,2,3,25.0,644.0,615,22,101,123,607.0,82,5.86,50,250,2620,9.2,0.124589056
16624,16624,Marc Methot,2019-20,34.0,14,0,9,9,0,0,0,3.0,152.0,624,22,101,123,610.0,82,5.96,47,239,2579,9.5,0.09620428
16625,16625,Marc Moro,1998-99,21.0,2,0,1,1,0,0,0,0.0,,1,0,0,0,0.0,82,5.28,57,380,2242,9.6,0.16920802
16626,16626,Marc Moro,2000-01,23.0,3,0,8,8,0,0,0,3.0,87.0,9,0,0,0,3.0,82,5.49,53,331,2294,9.8,0.16841361
16627,16627,Marc Moro,2001-02,24.0,4,0,6,6,0,0,0,1.0,21.0,15,0,0,0,4.0,82,5.51,63,376,2272,9.9,0.14069283
16628,16628,Marc Moro,2002-03,25.0,5,0,15,15,0,0,0,7.0,179.0,30,0,0,0,11.0,82,5.24,53,338,2262,9.5,0.13615996
16629,16629,Marc Potvin,1991-92,25.0,2,0,9,9,0,0,0,13.0,,9,0,0,0,13.0,80,6.91,71,366,2385,11.6,0.19698304
16630,16630,Marc Potvin,1992-93,26.0,3,1,5,5,1,0,1,4.0,,14,1,0,1,17.0,80,6.96,77,402,2440,11.4,0.21537742
16631,16631,Marc Potvin,1993-94,27.0,4,1,20,20,0,1,1,7.0,,34,1,1,2,24.0,84,7.25,87,443,2603,11.7,0.14986318
16632,16632,Marc Potvin,1994-95,28.0,5,5,54,54,2,3,5,26.0,,88,3,4,7,50.0,84,6.48,76,407,2545,10.7,0.10358903
16633,16633,Marc Potvin,1995-96,29.0,6,1,6,6,0,1,1,4.0,,94,3,5,8,54.0,48,5.97,37,209,1408,10.2,0.13444972
16634,16634,Marc Potvin,1996-97,30.0,7,0,27,27,0,0,0,14.0,,121,3,5,8,68.0,82,6.29,74,413,2481,10.4,0.085139126
16635,16635,Marc Pouliot,2006-07,21.0,2,1,8,8,1,0,1,5.0,68.0,8,1,0,1,5.0,82,6.05,85,480,2458,10.1,0.22030097
16636,16636,Marc Pouliot,2007-08,22.0,3,11,46,46,4,7,11,73.0,600.0,54,5,7,12,78.0,82,5.76,70,398,2426,9.7,0.2780713
16637,16637,Marc Pouliot,2008-09,23.0,4,7,24,24,1,6,7,32.0,248.0,78,6,13,19,110.0,82,5.44,62,351,2383,9.4,0.26286063
16638,16638,Marc Pouliot,2009-10,24.0,5,20,63,63,8,12,20,94.0,725.0,141,14,25,39,204.0,82,5.7,65,341,2477,9.4,0.29416758
16639,16639,Marc Pouliot,2010-11,25.0,6,14,35,35,7,7,14,60.0,448.0,176,21,32,53,264.0,82,5.53,56,304,2486,9.1,0.3103217
16640,16640,Marc Pouliot,2011-12,26.0,7,0,3,3,0,0,0,2.0,32.0,179,21,32,53,266.0,82,5.46,52,291,2492,9.0,0.19387347
16641,16641,Marc Pouliot,2012-13,27.0,8,4,13,13,0,4,4,19.0,145.0,192,21,36,57,285.0,82,5.32,47,271,2439,8.9,0.21816516
16642,16642,Marc Rodgers,2000-01,28.0,2,2,21,21,1,1,2,17.0,166.0,21,1,1,2,17.0,82,5.49,53,331,2294,9.8,0.15479544
16643,16643,Marc Savard,1998-99,21.0,2,6,28,28,1,5,6,32.0,,28,1,5,6,32.0,82,5.28,57,380,2242,9.6,0.25658318
16644,16644,Marc Savard,1999-00,22.0,3,45,70,70,9,36,45,116.0,1021.0,98,10,41,51,148.0,82,5.27,57,359,2285,9.4,0.58524096
16645,16645,Marc Savard,2000-01,23.0,4,53,78,78,22,31,53,184.0,1294.0,176,32,72,104,332.0,82,5.49,53,331,2294,9.8,0.672868
16646,16646,Marc Savard,2001-02,24.0,5,65,77,77,23,42,65,197.0,1480.0,253,55,114,169,529.0,82,5.51,63,376,2272,9.9,0.8116367
16647,16647,Marc Savard,2002-03,25.0,6,33,56,56,14,19,33,140.0,970.0,309,69,133,202,669.0,82,5.24,53,338,2262,9.5,0.736166
16648,16648,Marc Savard,2003-04,26.0,7,50,67,67,17,33,50,148.0,1277.0,376,86,166,252,817.0,82,5.31,60,363,2326,9.4,0.66265893
16649,16649,Marc Savard,2004-05,27.0,8,52,45,45,19,33,52,133.0,1004.0,421,105,199,304,950.0,82,5.14,57,348,2300,9.2,1.0301853
16650,16650,Marc Savard,2006-07,29.0,9,97,82,82,28,69,97,212.0,1682.0,503,133,268,401,1162.0,82,6.05,85,480,2458,10.1,1.0483264
16651,16651,Marc Savard,2007-08,30.0,10,96,82,82,22,74,96,221.0,1658.0,585,155,342,497,1383.0,82,5.76,70,398,2426,9.7,0.97579074
16652,16652,Marc Savard,2008-09,31.0,11,78,74,74,15,63,78,196.0,1519.0,659,170,405,575,1579.0,82,5.44,62,351,2383,9.4,0.8662099
16653,16653,Marc Savard,2009-10,32.0,12,88,82,82,25,63,88,213.0,1602.0,741,195,468,663,1792.0,82,5.7,65,341,2477,9.4,0.95783985
16654,16654,Marc Savard,2010-11,33.0,13,33,41,41,10,23,33,90.0,762.0,782,205,491,696,1882.0,82,5.53,56,304,2486,9.1,0.6642697
16655,16655,Marc Savard,2011-12,34.0,14,10,25,25,2,8,10,50.0,395.0,807,207,499,706,1932.0,82,5.46,52,291,2492,9.0,0.4101029
16656,16656,Marc Staal,2008-09,22.0,2,10,80,80,2,8,10,78.0,1504.0,80,2,8,10,78.0,82,5.44,62,351,2383,9.4,0.2111179
16657,16657,Marc Staal,2009-10,23.0,3,15,82,82,3,12,15,96.0,1733.0,162,5,20,25,174.0,82,5.7,65,341,2477,9.4,0.24088234
16658,16658,Marc Staal,2010-11,24.0,4,27,82,82,8,19,27,78.0,1897.0,244,13,39,52,252.0,82,5.53,56,304,2486,9.1,0.31912076
16659,16659,Marc Staal,2011-12,25.0,5,29,77,77,7,22,29,116.0,1982.0,321,20,61,81,368.0,82,5.46,52,291,2492,9.0,0.34227416
16660,16660,Marc Staal,2012-13,26.0,6,5,46,46,2,3,5,61.0,915.0,367,22,64,86,429.0,82,5.32,47,271,2439,8.9,0.20148763
16661,16661,Marc Staal,2013-14,27.0,7,11,21,21,2,9,11,20.0,513.0,388,24,73,97,449.0,48,5.31,29,160,1399,9.1,0.2892586
16662,16662,Marc Staal,2014-15,28.0,8,14,72,72,3,11,14,92.0,1477.0,460,27,84,111,541.0,82,5.34,48,269,2463,8.9,0.22421485
16663,16663,Marc Staal,2015-16,29.0,9,20,80,80,5,15,20,97.0,1691.0,540,32,99,131,638.0,82,5.32,47,251,2453,8.9,0.2521417
16664,16664,Marc Staal,2016-17,30.0,10,15,77,77,2,13,15,65.0,1515.0,617,34,112,146,703.0,82,5.34,48,255,2438,9.0,0.16173705
16665,16665,Marc Staal,2017-18,31.0,11,10,72,72,3,7,10,70.0,1381.0,689,37,119,156,773.0,82,5.45,47,245,2478,9.0,0.14028022
16666,16666,Marc Staal,2018-19,32.0,12,8,72,72,1,7,8,68.0,1334.0,761,38,126,164,841.0,82,5.86,50,250,2620,9.2,0.13120428
16667,16667,Marc Staal,2019-20,33.0,13,13,79,79,3,10,13,84.0,1534.0,840,41,136,177,925.0,82,5.96,47,239,2579,9.5,0.16550925
16668,16668,Marc Staal,2020-21,34.0,14,11,52,52,2,9,11,46.0,917.0,892,43,145,188,971.0,70,5.96,42,208,2192,9.5,0.1831114
16669,16669,Marc-Andre Bergeron,2003-04,23.0,2,2,5,5,1,1,2,5.0,83.0,5,1,1,2,5.0,82,5.31,60,363,2326,9.4,0.23293379
16670,16670,Marc-Andre Bergeron,2004-05,24.0,3,26,54,54,9,17,26,105.0,953.0,59,10,18,28,110.0,82,5.14,57,348,2300,9.2,0.51768196
16671,16671,Marc-Andre Bergeron,2006-07,26.0,4,35,75,75,15,20,35,144.0,1592.0,134,25,38,63,254.0,82,6.05,85,480,2458,10.1,0.44115806
16672,16672,Marc-Andre Bergeron,2007-08,27.0,5,46,78,78,14,32,46,166.0,1491.0,212,39,70,109,420.0,82,5.76,70,398,2426,9.7,0.5204085
16673,16673,Marc-Andre Bergeron,2008-09,28.0,6,19,55,55,9,10,19,108.0,957.0,267,48,80,128,528.0,82,5.44,62,351,2383,9.4,0.4005314
16674,16674,Marc-Andre Bergeron,2009-10,29.0,7,32,72,72,14,18,32,140.0,1217.0,339,62,98,160,668.0,82,5.7,65,341,2477,9.4,0.4552933
16675,16675,Marc-Andre Bergeron,2010-11,30.0,8,34,60,60,13,21,34,123.0,904.0,399,75,119,194,791.0,82,5.53,56,304,2486,9.1,0.4813068
16676,16676,Marc-Andre Bergeron,2011-12,31.0,9,8,23,23,2,6,8,37.0,329.0,422,77,125,202,828.0,82,5.46,52,291,2492,9.0,0.3059259
16677,16677,Marc-Andre Bergeron,2012-13,32.0,10,24,43,43,4,20,24,80.0,832.0,465,81,145,226,908.0,82,5.32,47,271,2439,8.9,0.39360708
16678,16678,Marc-Andre Bergeron,2013-14,33.0,11,9,25,25,1,8,9,43.0,344.0,490,82,153,235,951.0,48,5.31,29,160,1399,9.1,0.26365107
16679,16679,Marc-Andre Bourdon,2012-13,23.0,2,7,45,45,4,3,7,45.0,729.0,45,4,3,7,45.0,82,5.32,47,271,2439,8.9,0.21270692
16680,16680,Marc-Andre Cliche,2010-11,23.0,2,0,1,1,0,0,0,0.0,7.0,1,0,0,0,0.0,82,5.53,56,304,2486,9.1,0.1638569
16681,16681,Marc-Andre Cliche,2014-15,27.0,3,7,76,76,1,6,7,69.0,803.0,77,1,6,7,69.0,82,5.34,48,269,2463,8.9,0.13642061
16682,16682,Marc-Andre Cliche,2015-16,28.0,4,7,74,74,2,5,7,68.0,785.0,151,3,11,14,137.0,82,5.32,47,251,2453,8.9,0.13809079
16683,16683,Marc-Andre Gragnani,2008-09,21.0,2,0,2,2,0,0,0,1.0,13.0,2,0,0,0,1.0,82,5.44,62,351,2383,9.4,0.20738643
16684,16684,Marc-Andre Gragnani,2009-10,22.0,3,0,4,4,0,0,0,3.0,62.0,6,0,0,0,4.0,82,5.7,65,341,2477,9.4,0.17882463
16685,16685,Marc-Andre Gragnani,2011-12,24.0,4,3,9,9,1,2,3,11.0,138.0,15,1,2,3,15.0,82,5.46,52,291,2492,9.0,0.20193306
16686,16686,Marc-Andre Gragnani,2012-13,25.0,5,15,58,58,2,13,15,47.0,936.0,73,3,15,18,62.0,82,5.32,47,271,2439,8.9,0.180965
16687,16687,Marc-Andre Gragnani,2013-14,26.0,6,0,1,1,0,0,0,0.0,8.0,74,3,15,18,62.0,48,5.31,29,160,1399,9.1,0.15706131
16688,16688,Marc-Andre Gragnani,2016-17,29.0,7,0,4,4,0,0,0,0.0,57.0,78,3,15,18,62.0,82,5.34,48,255,2438,9.0,0.13736668
16689,16689,Marc-Edouard Vlasic,2007-08,20.0,2,26,81,81,3,23,26,66.0,1798.0,81,3,23,26,66.0,82,5.76,70,398,2426,9.7,0.3495083
16690,16690,Marc-Edouard Vlasic,2008-09,21.0,3,14,82,82,2,12,14,72.0,1772.0,163,5,35,40,138.0,82,5.44,62,351,2383,9.4,0.28077286
16691,16691,Marc-Edouard Vlasic,2009-10,22.0,4,36,82,82,6,30,36,104.0,1960.0,245,11,65,76,242.0,82,5.7,65,341,2477,9.4,0.40221238
16692,16692,Marc-Edouard Vlasic,2010-11,23.0,5,16,64,64,3,13,16,74.0,1414.0,309,14,78,92,316.0,82,5.53,56,304,2486,9.1,0.27329957
16693,16693,Marc-Edouard Vlasic,2011-12,24.0,6,18,80,80,4,14,18,116.0,1669.0,389,18,92,110,432.0,82,5.46,52,291,2492,9.0,0.2885455
16694,16694,Marc-Edouard Vlasic,2012-13,25.0,7,23,82,82,4,19,23,119.0,1899.0,471,22,111,133,551.0,82,5.32,47,271,2439,8.9,0.30169207
16695,16695,Marc-Edouard Vlasic,2013-14,26.0,8,7,48,48,3,4,7,59.0,1000.0,519,25,115,140,610.0,48,5.31,29,160,1399,9.1,0.24087608
16696,16696,Marc-Edouard Vlasic,2014-15,27.0,9,24,81,81,5,19,24,138.0,1678.0,600,30,134,164,748.0,82,5.34,48,269,2463,8.9,0.29915962
16697,16697,Marc-Edouard Vlasic,2015-16,28.0,10,23,70,70,9,14,23,98.0,1548.0,670,39,148,187,846.0,82,5.32,47,251,2453,8.9,0.3233031
16698,16698,Marc-Edouard Vlasic,2016-17,29.0,11,39,67,67,8,31,39,116.0,1550.0,737,47,179,226,962.0,82,5.34,48,255,2438,9.0,0.44514376
16699,16699,Marc-Edouard Vlasic,2017-18,30.0,12,28,75,75,6,22,28,144.0,1593.0,812,53,201,254,1106.0,82,5.45,47,245,2478,9.0,0.34795654
16700,16700,Marc-Edouard Vlasic,2018-19,31.0,13,32,81,81,11,21,32,161.0,1826.0,893,64,222,286,1267.0,82,5.86,50,250,2620,9.2,0.36396462
16701,16701,Marc-Edouard Vlasic,2019-20,32.0,14,25,72,72,3,22,25,100.0,1515.0,965,67,244,311,1367.0,82,5.96,47,239,2579,9.5,0.27578512
16702,16702,Marc-Edouard Vlasic,2020-21,33.0,15,15,70,70,5,10,15,74.0,1421.0,1035,72,254,326,1441.0,70,5.96,42,208,2192,9.5,0.25127536
16703,16703,Marcel Goc,2006-07,23.0,2,22,81,81,8,14,22,96.0,948.0,81,8,14,22,96.0,82,6.05,85,480,2458,10.1,0.33343163
16704,16704,Marcel Goc,2007-08,24.0,3,13,78,78,5,8,13,96.0,937.0,159,13,22,35,192.0,82,5.76,70,398,2426,9.7,0.22689083
16705,16705,Marcel Goc,2008-09,25.0,4,8,51,51,5,3,8,87.0,545.0,210,18,25,43,279.0,82,5.44,62,351,2383,9.4,0.2458551
16706,16706,Marcel Goc,2009-10,26.0,5,11,55,55,2,9,11,104.0,765.0,265,20,34,54,383.0,82,5.7,65,341,2477,9.4,0.25923494
16707,16707,Marcel Goc,2010-11,27.0,6,30,73,73,12,18,30,118.0,1072.0,338,32,52,84,501.0,82,5.53,56,304,2486,9.1,0.34991974
16708,16708,Marcel Goc,2011-12,28.0,7,24,51,51,9,15,24,111.0,818.0,389,41,67,108,612.0,82,5.46,52,291,2492,9.0,0.38981518
16709,16709,Marcel Goc,2012-13,29.0,8,27,57,57,11,16,27,97.0,1004.0,446,52,83,135,709.0,82,5.32,47,271,2439,8.9,0.34456283
16710,16710,Marcel Goc,2013-14,30.0,9,19,42,42,9,10,19,92.0,767.0,488,61,93,154,801.0,48,5.31,29,160,1399,9.1,0.40922588
16711,16711,Marcel Goc,2014-15,31.0,10,25,74,74,11,14,25,117.0,1208.0,562,72,107,179,918.0,82,5.34,48,269,2463,8.9,0.29040134
16712,16712,Marcel Goc,2015-16,32.0,11,9,74,74,3,6,9,77.0,864.0,636,75,113,188,995.0,82,5.32,47,251,2453,8.9,0.1943576
16713,16713,Marcel Hossa,2002-03,21.0,2,4,10,10,3,1,4,20.0,111.0,10,3,1,4,20.0,82,5.24,53,338,2262,9.5,0.32305777
16714,16714,Marcel Hossa,2003-04,22.0,3,13,34,34,6,7,13,51.0,475.0,44,9,8,17,71.0,82,5.31,60,363,2326,9.4,0.3265854
16715,16715,Marcel Hossa,2004-05,23.0,4,2,15,15,1,1,2,19.0,223.0,59,10,9,19,90.0,82,5.14,57,348,2300,9.2,0.2968794
16716,16716,Marcel Hossa,2006-07,25.0,5,16,64,64,10,6,16,105.0,688.0,123,20,15,35,195.0,82,6.05,85,480,2458,10.1,0.26895988
16717,16717,Marcel Hossa,2007-08,26.0,6,18,64,64,10,8,18,83.0,797.0,187,30,23,53,278.0,82,5.76,70,398,2426,9.7,0.2619332
16718,16718,Marcel Hossa,2008-09,27.0,7,8,50,50,1,7,8,66.0,689.0,237,31,30,61,344.0,82,5.44,62,351,2383,9.4,0.17771494
16719,16719,Marcel Mueller,2011-12,23.0,2,0,3,3,0,0,0,5.0,30.0,3,0,0,0,5.0,82,5.46,52,291,2492,9.0,0.17343244
16720,16720,Marco Scandella,2011-12,21.0,2,2,20,20,0,2,2,13.0,299.0,20,0,2,2,13.0,82,5.46,52,291,2492,9.0,0.18281132
16721,16721,Marco Scandella,2012-13,22.0,3,12,63,63,3,9,12,77.0,1372.0,83,3,11,14,90.0,82,5.32,47,271,2439,8.9,0.21785587
16722,16722,Marco Scandella,2013-14,23.0,4,1,6,6,1,0,1,7.0,87.0,89,4,11,15,97.0,48,5.31,29,160,1399,9.1,0.24121246
16723,16723,Marco Scandella,2014-15,24.0,5,17,76,76,3,14,17,80.0,1430.0,165,7,25,32,177.0,82,5.34,48,269,2463,8.9,0.22106656
16724,16724,Marco Scandella,2015-16,25.0,6,23,64,64,11,12,23,112.0,1390.0,229,18,37,55,289.0,82,5.32,47,251,2453,8.9,0.29772508
16725,16725,Marco Scandella,2016-17,26.0,7,21,73,73,5,16,21,126.0,1511.0,302,23,53,76,415.0,82,5.34,48,255,2438,9.0,0.26577944
16726,16726,Marco Scandella,2017-18,27.0,8,13,71,71,4,9,13,88.0,1302.0,373,27,62,89,503.0,82,5.45,47,245,2478,9.0,0.20245385
16727,16727,Marco Scandella,2018-19,28.0,9,22,82,82,5,17,22,138.0,1912.0,455,32,79,111,641.0,82,5.86,50,250,2620,9.2,0.27730817
16728,16728,Marco Scandella,2019-20,29.0,10,13,63,63,6,7,13,83.0,1109.0,518,38,86,124,724.0,82,5.96,47,239,2579,9.5,0.21918762
16729,16729,Marco Scandella,2020-21,30.0,11,13,62,62,4,9,13,77.0,1090.0,580,42,95,137,801.0,70,5.96,42,208,2192,9.5,0.21725696
16730,16730,Marco Sturm,1998-99,20.0,2,30,74,74,10,20,30,118.0,,74,10,20,30,118.0,82,5.28,57,380,2242,9.6,0.4561848
16731,16731,Marco Sturm,1999-00,21.0,3,38,78,78,16,22,38,140.0,1200.0,152,26,42,68,258.0,82,5.27,57,359,2285,9.4,0.5547835
16732,16732,Marco Sturm,2000-01,22.0,4,27,74,74,12,15,27,120.0,1044.0,226,38,57,95,378.0,82,5.49,53,331,2294,9.8,0.45443282
16733,16733,Marco Sturm,2001-02,23.0,5,32,81,81,14,18,32,153.0,1304.0,307,52,75,127,531.0,82,5.51,63,376,2272,9.9,0.48478678
16734,16734,Marco Sturm,2002-03,24.0,6,41,77,77,21,20,41,174.0,1205.0,384,73,95,168,705.0,82,5.24,53,338,2262,9.5,0.58786553
16735,16735,Marco Sturm,2003-04,25.0,7,48,82,82,28,20,48,208.0,1354.0,466,101,115,216,913.0,82,5.31,60,363,2326,9.4,0.64101845
16736,16736,Marco Sturm,2004-05,26.0,8,41,64,64,21,20,41,158.0,1050.0,530,122,135,257,1071.0,82,5.14,57,348,2300,9.2,0.7601305
16737,16737,Marco Sturm,2006-07,28.0,9,59,74,74,29,30,59,180.0,1357.0,604,151,165,316,1251.0,82,6.05,85,480,2458,10.1,0.6783729
16738,16738,Marco Sturm,2007-08,29.0,10,44,76,76,27,17,44,224.0,1413.0,680,178,182,360,1475.0,82,5.76,70,398,2426,9.7,0.5874074
16739,16739,Marco Sturm,2008-09,30.0,11,56,80,80,27,29,56,229.0,1440.0,760,205,211,416,1704.0,82,5.44,62,351,2383,9.4,0.659564
16740,16740,Marco Sturm,2009-10,31.0,12,13,19,19,7,6,13,45.0,304.0,779,212,217,429,1749.0,82,5.7,65,341,2477,9.4,0.47668308
16741,16741,Marco Sturm,2010-11,32.0,13,37,76,76,22,15,37,203.0,1275.0,855,234,232,466,1952.0,82,5.53,56,304,2486,9.1,0.5158598
16742,16742,Marco Sturm,2011-12,33.0,14,16,35,35,5,11,16,57.0,498.0,890,239,243,482,2009.0,82,5.46,52,291,2492,9.0,0.35875106
16743,16743,Marco Sturm,2012-13,34.0,15,5,48,48,3,2,5,65.0,591.0,938,242,245,487,2074.0,82,5.32,47,271,2439,8.9,0.21866536
16744,16744,Marcus Foligno,2012-13,21.0,2,13,14,14,6,7,13,23.0,221.0,14,6,7,13,23.0,82,5.32,47,271,2439,8.9,0.44831392
16745,16745,Marcus Foligno,2013-14,22.0,3,18,47,47,5,13,18,55.0,640.0,61,11,20,31,78.0,48,5.31,29,160,1399,9.1,0.39901796
16746,16746,Marcus Foligno,2014-15,23.0,4,19,74,74,7,12,19,79.0,1115.0,135,18,32,50,157.0,82,5.34,48,269,2463,8.9,0.32015353
16747,16747,Marcus Foligno,2015-16,24.0,5,20,57,57,8,12,20,66.0,925.0,192,26,44,70,223.0,82,5.32,47,251,2453,8.9,0.32317123
16748,16748,Marcus Foligno,2016-17,25.0,6,23,75,75,10,13,23,81.0,989.0,267,36,57,93,304.0,82,5.34,48,255,2438,9.0,0.29123467
16749,16749,Marcus Foligno,2017-18,26.0,7,23,80,80,13,10,23,97.0,1238.0,347,49,67,116,401.0,82,5.45,47,245,2478,9.0,0.31716448
16750,16750,Marcus Foligno,2018-19,27.0,8,23,77,77,8,15,23,79.0,836.0,424,57,82,139,480.0,82,5.86,50,250,2620,9.2,0.29814798
16751,16751,Marcus Foligno,2019-20,28.0,9,19,82,82,7,12,19,91.0,982.0,506,64,94,158,571.0,82,5.96,47,239,2579,9.5,0.2830171
16752,16752,Marcus Foligno,2020-21,29.0,10,25,59,59,11,14,25,86.0,861.0,565,75,108,183,657.0,70,5.96,42,208,2192,9.5,0.35301554
16753,16753,Marcus Johansson,2011-12,21.0,2,27,69,69,13,14,27,102.0,1016.0,69,13,14,27,102.0,82,5.46,52,291,2492,9.0,0.45032364
16754,16754,Marcus Johansson,2012-13,22.0,3,46,80,80,14,32,46,90.0,1344.0,149,27,46,73,192.0,82,5.32,47,271,2439,8.9,0.5563876
16755,16755,Marcus Johansson,2013-14,23.0,4,22,34,34,6,16,22,40.0,564.0,183,33,62,95,232.0,48,5.31,29,160,1399,9.1,0.5582138
16756,16756,Marcus Johansson,2014-15,24.0,5,44,80,80,8,36,44,107.0,1403.0,263,41,98,139,339.0,82,5.34,48,269,2463,8.9,0.57892823
16757,16757,Marcus Johansson,2015-16,25.0,6,47,82,82,20,27,47,138.0,1351.0,345,61,125,186,477.0,82,5.32,47,251,2453,8.9,0.60554737
16758,16758,Marcus Johansson,2016-17,26.0,7,46,74,74,17,29,46,132.0,1231.0,419,78,154,232,609.0,82,5.34,48,255,2438,9.0,0.5693012
16759,16759,Marcus Johansson,2017-18,27.0,8,58,82,82,24,34,58,129.0,1394.0,501,102,188,290,738.0,82,5.45,47,245,2478,9.0,0.65831834
16760,16760,Marcus Johansson,2018-19,28.0,9,14,29,29,5,9,14,42.0,464.0,530,107,197,304,780.0,82,5.86,50,250,2620,9.2,0.4229899
16761,16761,Marcus Johansson,2019-20,29.0,10,30,58,58,13,17,30,115.0,924.0,588,120,214,334,895.0,82,5.96,47,239,2579,9.5,0.476792
16762,16762,Marcus Johansson,2020-21,30.0,11,30,60,60,9,21,30,87.0,1029.0,648,129,235,364,982.0,70,5.96,42,208,2192,9.5,0.44435978
16763,16763,Marcus Kruger,2011-12,21.0,2,0,7,7,0,0,0,7.0,84.0,7,0,0,0,7.0,82,5.46,52,291,2492,9.0,0.20690775
16764,16764,Marcus Kruger,2012-13,22.0,3,26,71,71,9,17,26,89.0,1093.0,78,9,17,26,96.0,82,5.32,47,271,2439,8.9,0.38111484
16765,16765,Marcus Kruger,2013-14,23.0,4,13,47,47,4,9,13,50.0,666.0,125,13,26,39,146.0,48,5.31,29,160,1399,9.1,0.29857546
16766,16766,Marcus Kruger,2014-15,24.0,5,28,81,81,8,20,28,96.0,1124.0,206,21,46,67,242.0,82,5.34,48,269,2463,8.9,0.3596983
16767,16767,Marcus Kruger,2015-16,25.0,6,17,81,81,7,10,17,126.0,1060.0,287,28,56,84,368.0,82,5.32,47,251,2453,8.9,0.24721941
16768,16768,Marcus Kruger,2016-17,26.0,7,4,41,41,0,4,4,50.0,554.0,328,28,60,88,418.0,82,5.34,48,255,2438,9.0,0.19522452
16769,16769,Marcus Kruger,2017-18,27.0,8,17,70,70,5,12,17,83.0,981.0,398,33,72,105,501.0,82,5.45,47,245,2478,9.0,0.24459553
16770,16770,Marcus Kruger,2018-19,28.0,9,6,48,48,1,5,6,30.0,520.0,446,34,77,111,531.0,82,5.86,50,250,2620,9.2,0.15221381
16771,16771,Marcus Kruger,2019-20,29.0,10,12,74,74,4,8,12,74.0,771.0,520,38,85,123,605.0,82,5.96,47,239,2579,9.5,0.20355752
16772,16772,Marcus Nilson,1999-00,21.0,2,2,8,8,1,1,2,7.0,99.0,8,1,1,2,7.0,82,5.27,57,359,2285,9.4,0.2451931
16773,16773,Marcus Nilson,2000-01,22.0,3,2,9,9,0,2,2,6.0,71.0,17,1,3,4,13.0,82,5.49,53,331,2294,9.8,0.17911607
16774,16774,Marcus Nilson,2001-02,23.0,4,36,78,78,12,24,36,141.0,1230.0,95,13,27,40,154.0,82,5.51,63,376,2272,9.9,0.4647537
16775,16775,Marcus Nilson,2002-03,24.0,5,33,81,81,14,19,33,147.0,1338.0,176,27,46,73,301.0,82,5.24,53,338,2262,9.5,0.46481392
16776,16776,Marcus Nilson,2003-04,25.0,6,34,82,82,15,19,34,187.0,1273.0,258,42,65,107,488.0,82,5.31,60,363,2326,9.4,0.4809342
16777,16777,Marcus Nilson,2004-05,26.0,7,24,83,83,11,13,24,133.0,1304.0,341,53,78,131,621.0,82,5.14,57,348,2300,9.2,0.35324806
16778,16778,Marcus Nilson,2006-07,28.0,8,17,70,70,6,11,17,83.0,1038.0,411,59,89,148,704.0,82,6.05,85,480,2458,10.1,0.27595085
16779,16779,Marcus Nilson,2007-08,29.0,9,15,63,63,5,10,15,69.0,826.0,474,64,99,163,773.0,82,5.76,70,398,2426,9.7,0.23913768
16780,16780,Marcus Nilson,2008-09,30.0,10,5,47,47,3,2,5,47.0,461.0,521,67,101,168,820.0,82,5.44,62,351,2383,9.4,0.23798531
16781,16781,Marcus Pettersson,2018-19,22.0,2,4,22,22,1,3,4,16.0,299.0,22,1,3,4,16.0,82,5.86,50,250,2620,9.2,0.18243843
16782,16782,Marcus Pettersson,2019-20,23.0,3,25,84,84,2,23,25,87.0,1401.0,106,3,26,29,103.0,82,5.96,47,239,2579,9.5,0.34217033
16783,16783,Marcus Pettersson,2020-21,24.0,4,22,69,69,2,20,22,79.0,1339.0,175,5,46,51,182.0,70,5.96,42,208,2192,9.5,0.2938552
16784,16784,Marcus Ragnarsson,1996-97,25.0,2,39,71,71,8,31,39,94.0,,71,8,31,39,94.0,82,6.29,74,413,2481,10.4,0.4509745
16785,16785,Marcus Ragnarsson,1997-98,26.0,3,17,69,69,3,14,17,57.0,,140,11,45,56,151.0,82,5.83,55,336,2444,9.8,0.22533357
16786,16786,Marcus Ragnarsson,1998-99,27.0,4,25,79,79,5,20,25,91.0,,219,16,65,81,242.0,82,5.28,57,380,2242,9.6,0.28613275
16787,16787,Marcus Ragnarsson,1999-00,28.0,5,13,74,74,0,13,13,87.0,1622.0,293,16,78,94,329.0,82,5.27,57,359,2285,9.4,0.21089864
16788,16788,Marcus Ragnarsson,2000-01,29.0,6,16,63,63,3,13,16,60.0,1440.0,356,19,91,110,389.0,82,5.49,53,331,2294,9.8,0.26267737
16789,16789,Marcus Ragnarsson,2001-02,30.0,7,15,68,68,3,12,15,74.0,1605.0,424,22,103,125,463.0,82,5.51,63,376,2272,9.9,0.2187717
16790,16790,Marcus Ragnarsson,2002-03,31.0,8,20,70,70,5,15,20,68.0,1583.0,494,27,118,145,531.0,82,5.24,53,338,2262,9.5,0.24951538
16791,16791,Marcus Ragnarsson,2003-04,32.0,9,16,68,68,3,13,16,79.0,1533.0,562,30,131,161,610.0,82,5.31,60,363,2326,9.4,0.2198573
16792,16792,Marcus Ragnarsson,2004-05,33.0,10,16,70,70,7,9,16,82.0,1464.0,632,37,140,177,692.0,82,5.14,57,348,2300,9.2,0.2426736
16793,16793,Marcus Sorensen,2017-18,25.0,2,4,19,19,1,3,4,27.0,205.0,19,1,3,4,27.0,82,5.45,47,245,2478,9.0,0.20203638
16794,16794,Marcus Sorensen,2018-19,26.0,3,7,32,32,5,2,7,25.0,325.0,51,6,5,11,52.0,82,5.86,50,250,2620,9.2,0.21878839
16795,16795,Marcus Sorensen,2019-20,27.0,4,30,80,80,17,13,30,100.0,1037.0,131,23,18,41,152.0,82,5.96,47,239,2579,9.5,0.3869008
16796,16796,Marcus Sorensen,2020-21,28.0,5,18,66,66,7,11,18,78.0,914.0,197,30,29,59,230.0,70,5.96,42,208,2192,9.5,0.28941643
16797,16797,Marek Hrivik,2016-17,25.0,2,1,5,5,0,1,1,3.0,54.0,5,0,1,1,3.0,82,5.34,48,255,2438,9.0,0.17724419
16798,16798,Marek Hrivik,2017-18,26.0,3,2,16,16,0,2,2,15.0,167.0,21,0,3,3,18.0,82,5.45,47,245,2478,9.0,0.17480803
16799,16799,Marek Hrivik,2018-19,27.0,4,0,3,3,0,0,0,2.0,26.0,24,0,3,3,20.0,82,5.86,50,250,2620,9.2,0.14098835
16800,16800,Marek Malik,1995-96,20.0,2,1,1,1,0,1,1,0.0,,1,0,1,1,0.0,48,5.97,37,209,1408,10.2,0.26789245
16801,16801,Marek Malik,1996-97,21.0,3,0,7,7,0,0,0,2.0,,8,0,1,1,2.0,82,6.29,74,413,2481,10.4,0.2048921
16802,16802,Marek Malik,1997-98,22.0,4,6,47,47,1,5,6,33.0,,55,1,6,7,35.0,82,5.83,55,336,2444,9.8,0.17105371
16803,16803,Marek Malik,1999-00,24.0,5,11,52,52,2,9,11,36.0,1104.0,107,3,15,18,71.0,82,5.27,57,359,2285,9.4,0.20403525
16804,16804,Marek Malik,2000-01,25.0,6,14,57,57,4,10,14,57.0,1026.0,164,7,25,32,128.0,82,5.49,53,331,2294,9.8,0.20341668
16805,16805,Marek Malik,2001-02,26.0,7,20,61,61,6,14,20,72.0,1195.0,225,13,39,52,200.0,82,5.51,63,376,2272,9.9,0.27851665
16806,16806,Marek Malik,2002-03,27.0,8,23,82,82,4,19,23,91.0,1679.0,307,17,58,75,291.0,82,5.24,53,338,2262,9.5,0.23365784
16807,16807,Marek Malik,2003-04,28.0,9,20,79,79,7,13,20,77.0,1419.0,386,24,71,95,368.0,82,5.31,60,363,2326,9.4,0.2500002
16808,16808,Marek Malik,2004-05,29.0,10,19,78,78,3,16,19,61.0,1411.0,464,27,87,114,429.0,82,5.14,57,348,2300,9.2,0.23821548
16809,16809,Marek Malik,2006-07,31.0,11,18,74,74,2,16,18,70.0,1512.0,538,29,103,132,499.0,82,6.05,85,480,2458,10.1,0.21598697
16810,16810,Marek Malik,2007-08,32.0,12,21,69,69,2,19,21,57.0,1329.0,607,31,122,153,556.0,82,5.76,70,398,2426,9.7,0.21689767
16811,16811,Marek Malik,2008-09,33.0,13,10,42,42,2,8,10,34.0,808.0,649,33,130,163,590.0,82,5.44,62,351,2383,9.4,0.16401151
16812,16812,Marek Malik,2009-10,34.0,14,5,42,42,0,5,5,22.0,805.0,691,33,135,168,612.0,82,5.7,65,341,2477,9.4,0.10215855
16813,16813,Marek Posmyk,2000-01,22.0,2,3,18,18,1,2,3,22.0,237.0,18,1,2,3,22.0,82,5.49,53,331,2294,9.8,0.23296633
16814,16814,Marek Posmyk,2001-02,23.0,3,0,1,1,0,0,0,0.0,13.0,19,1,2,3,22.0,82,5.51,63,376,2272,9.9,0.15049845
16815,16815,Marek Svatos,2004-05,22.0,2,2,4,4,2,0,2,6.0,41.0,4,2,0,2,6.0,82,5.14,57,348,2300,9.2,0.34240147
16816,16816,Marek Svatos,2006-07,24.0,3,50,61,61,32,18,50,165.0,838.0,65,34,18,52,171.0,82,6.05,85,480,2458,10.1,0.6826665
16817,16817,Marek Svatos,2007-08,25.0,4,30,66,66,15,15,30,179.0,825.0,131,49,33,82,350.0,82,5.76,70,398,2426,9.7,0.52651185
16818,16818,Marek Svatos,2008-09,26.0,5,37,62,62,26,11,37,140.0,847.0,193,75,44,119,490.0,82,5.44,62,351,2383,9.4,0.6339232
16819,16819,Marek Svatos,2009-10,27.0,6,34,69,69,14,20,34,140.0,904.0,262,89,64,153,630.0,82,5.7,65,341,2477,9.4,0.45457634
16820,16820,Marek Svatos,2010-11,28.0,7,11,54,54,7,4,11,84.0,616.0,316,96,68,164,714.0,82,5.53,56,304,2486,9.1,0.3634491
16821,16821,Marek Svatos,2011-12,29.0,8,8,28,28,4,4,8,50.0,328.0,344,100,72,172,764.0,82,5.46,52,291,2492,9.0,0.35149863
16822,16822,Marek Zidlicky,2004-05,27.0,2,53,82,82,14,39,53,143.0,1643.0,82,14,39,53,143.0,82,5.14,57,348,2300,9.2,0.6619148
16823,16823,Marek Zidlicky,2006-07,29.0,3,49,67,67,12,37,49,113.0,1344.0,149,26,76,102,256.0,82,6.05,85,480,2458,10.1,0.5465276
16824,16824,Marek Zidlicky,2007-08,30.0,4,30,79,79,4,26,30,114.0,1558.0,228,30,102,132,370.0,82,5.76,70,398,2426,9.7,0.40428928
16825,16825,Marek Zidlicky,2008-09,31.0,5,43,79,79,5,38,43,122.0,1645.0,307,35,140,175,492.0,82,5.44,62,351,2383,9.4,0.49977177
16826,16826,Marek Zidlicky,2009-10,32.0,6,42,76,76,12,30,42,147.0,1680.0,383,47,170,217,639.0,82,5.7,65,341,2477,9.4,0.46432245
16827,16827,Marek Zidlicky,2010-11,33.0,7,43,78,78,6,37,43,116.0,1885.0,461,53,207,260,755.0,82,5.53,56,304,2486,9.1,0.4830077
16828,16828,Marek Zidlicky,2011-12,34.0,8,24,46,46,7,17,24,53.0,1002.0,507,60,224,284,808.0,82,5.46,52,291,2492,9.0,0.39354604
16829,16829,Marek Zidlicky,2012-13,35.0,9,22,63,63,2,20,22,70.0,1344.0,570,62,244,306,878.0,82,5.32,47,271,2439,8.9,0.27745962
16830,16830,Marek Zidlicky,2013-14,36.0,10,19,48,48,4,15,19,101.0,1008.0,618,66,259,325,979.0,48,5.31,29,160,1399,9.1,0.38504547
16831,16831,Marek Zidlicky,2014-15,37.0,11,42,81,81,12,30,42,128.0,1754.0,699,78,289,367,1107.0,82,5.34,48,269,2463,8.9,0.43022162
16832,16832,Marek Zidlicky,2015-16,38.0,12,34,84,84,7,27,34,130.0,1760.0,783,85,316,401,1237.0,82,5.32,47,251,2453,8.9,0.3828786
16833,16833,Marek Zidlicky,2016-17,39.0,13,16,53,53,4,12,16,48.0,826.0,836,89,328,417,1285.0,82,5.34,48,255,2438,9.0,0.26547462
16834,16834,Marian Cisar,2000-01,22.0,2,0,3,3,0,0,0,2.0,25.0,3,0,0,0,2.0,82,5.49,53,331,2294,9.8,0.1732291
16835,16835,Marian Cisar,2001-02,23.0,3,27,60,60,12,15,27,97.0,790.0,63,12,15,27,99.0,82,5.51,63,376,2272,9.9,0.42218006
16836,16836,Marian Cisar,2002-03,24.0,4,3,10,10,1,2,3,16.0,129.0,73,13,17,30,115.0,82,5.24,53,338,2262,9.5,0.24216655
16837,16837,Marian Gaborik,2001-02,19.0,2,36,71,71,18,18,36,179.0,1096.0,71,18,18,36,179.0,82,5.51,63,376,2272,9.9,0.6019235
16838,16838,Marian Gaborik,2002-03,20.0,3,67,78,78,30,37,67,221.0,1308.0,149,48,55,103,400.0,82,5.24,53,338,2262,9.5,0.88479716
16839,16839,Marian Gaborik,2003-04,21.0,4,65,81,81,30,35,65,280.0,1410.0,230,78,90,168,680.0,82,5.31,60,363,2326,9.4,0.8623481
16840,16840,Marian Gaborik,2004-05,22.0,5,40,65,65,18,22,40,220.0,1188.0,295,96,112,208,900.0,82,5.14,57,348,2300,9.2,0.8935764
16841,16841,Marian Gaborik,2006-07,24.0,6,66,65,65,38,28,66,252.0,1198.0,360,134,140,274,1152.0,82,6.05,85,480,2458,10.1,1.0223701
16842,16842,Marian Gaborik,2007-08,25.0,7,57,48,48,30,27,57,196.0,942.0,408,164,167,331,1348.0,82,5.76,70,398,2426,9.7,0.96696246
16843,16843,Marian Gaborik,2008-09,26.0,8,83,77,77,42,41,83,278.0,1509.0,485,206,208,414,1626.0,82,5.44,62,351,2383,9.4,1.0352967
16844,16844,Marian Gaborik,2009-10,27.0,9,23,17,17,13,10,23,68.0,340.0,502,219,218,437,1694.0,82,5.7,65,341,2477,9.4,1.0670621
16845,16845,Marian Gaborik,2010-11,28.0,10,86,76,76,42,44,86,272.0,1615.0,578,261,262,523,1966.0,82,5.53,56,304,2486,9.1,0.9679313
16846,16846,Marian Gaborik,2011-12,29.0,11,48,62,62,22,26,48,192.0,1121.0,640,283,288,571,2158.0,82,5.46,52,291,2492,9.0,0.735359
16847,16847,Marian Gaborik,2012-13,30.0,12,76,82,82,41,35,76,276.0,1600.0,722,324,323,647,2434.0,82,5.32,47,271,2439,8.9,0.8637004
16848,16848,Marian Gaborik,2013-14,31.0,13,27,47,47,12,15,27,151.0,870.0,769,336,338,674,2585.0,48,5.31,29,160,1399,9.1,0.657784
16849,16849,Marian Gaborik,2014-15,32.0,14,30,41,41,11,19,30,103.0,697.0,810,347,357,704,2688.0,82,5.34,48,269,2463,8.9,0.618487
16850,16850,Marian Gaborik,2015-16,33.0,15,47,69,69,27,20,47,174.0,1167.0,879,374,377,751,2862.0,82,5.32,47,251,2453,8.9,0.5922758
16851,16851,Marian Gaborik,2016-17,34.0,16,22,54,54,12,10,22,142.0,807.0,933,386,387,773,3004.0,82,5.34,48,255,2438,9.0,0.44675475
16852,16852,Marian Gaborik,2017-18,35.0,17,21,56,56,10,11,21,123.0,828.0,989,396,398,794,3127.0,82,5.45,47,245,2478,9.0,0.38307133
16853,16853,Marian Gaborik,2018-19,36.0,18,21,46,46,11,10,21,80.0,643.0,1035,407,408,815,3207.0,82,5.86,50,250,2620,9.2,0.42271447
16854,16854,Marian Hossa,1998-99,20.0,2,1,7,7,0,1,1,10.0,,7,0,1,1,10.0,82,5.28,57,380,2242,9.6,0.24847177
16855,16855,Marian Hossa,1999-00,21.0,3,30,60,60,15,15,30,124.0,839.0,67,15,16,31,134.0,82,5.27,57,359,2285,9.4,0.56869376
16856,16856,Marian Hossa,2000-01,22.0,4,56,78,78,29,27,56,240.0,1341.0,145,44,43,87,374.0,82,5.49,53,331,2294,9.8,0.76044905
16857,16857,Marian Hossa,2001-02,23.0,5,75,81,81,32,43,75,249.0,1460.0,226,76,86,162,623.0,82,5.51,63,376,2272,9.9,0.85013247
16858,16858,Marian Hossa,2002-03,24.0,6,66,80,80,31,35,66,278.0,1479.0,306,107,121,228,901.0,82,5.24,53,338,2262,9.5,0.89823973
16859,16859,Marian Hossa,2003-04,25.0,7,80,80,80,45,35,80,229.0,1481.0,386,152,156,308,1130.0,82,5.31,60,363,2326,9.4,0.89835453
16860,16860,Marian Hossa,2004-05,26.0,8,82,81,81,36,46,82,233.0,1509.0,467,188,202,390,1363.0,82,5.14,57,348,2300,9.2,1.0369916
16861,16861,Marian Hossa,2006-07,28.0,9,92,80,80,39,53,92,341.0,1735.0,547,227,255,482,1704.0,82,6.05,85,480,2458,10.1,1.0891213
16862,16862,Marian Hossa,2007-08,29.0,10,100,82,82,43,57,100,340.0,1778.0,629,270,312,582,2044.0,82,5.76,70,398,2426,9.7,1.0365276
16863,16863,Marian Hossa,2008-09,30.0,11,66,72,72,29,37,66,264.0,1538.0,701,299,349,648,2308.0,82,5.44,62,351,2383,9.4,0.86216813
16864,16864,Marian Hossa,2009-10,31.0,12,71,74,74,40,31,71,307.0,1317.0,775,339,380,719,2615.0,82,5.7,65,341,2477,9.4,0.82498705
16865,16865,Marian Hossa,2010-11,32.0,13,51,57,57,24,27,51,199.0,1067.0,832,363,407,770,2814.0,82,5.53,56,304,2486,9.1,0.8680259
16866,16866,Marian Hossa,2011-12,33.0,14,57,65,65,25,32,57,205.0,1281.0,897,388,439,827,3019.0,82,5.46,52,291,2492,9.0,0.8331696
16867,16867,Marian Hossa,2012-13,34.0,15,77,81,81,29,48,77,248.0,1617.0,978,417,487,904,3267.0,82,5.32,47,271,2439,8.9,0.8068994
16868,16868,Marian Hossa,2013-14,35.0,16,31,40,40,17,14,31,116.0,722.0,1018,434,501,935,3383.0,48,5.31,29,160,1399,9.1,0.70832574
16869,16869,Marian Hossa,2014-15,36.0,17,60,72,72,30,30,60,241.0,1316.0,1090,464,531,995,3624.0,82,5.34,48,269,2463,8.9,0.70056665
16870,16870,Marian Hossa,2015-16,37.0,18,61,82,82,22,39,61,247.0,1521.0,1172,486,570,1056,3871.0,82,5.32,47,251,2453,8.9,0.6408847
16871,16871,Marian Hossa,2016-17,38.0,19,33,64,64,13,20,33,191.0,1105.0,1236,499,590,1089,4062.0,82,5.34,48,255,2438,9.0,0.55228
16872,16872,Marian Hossa,2017-18,39.0,20,45,73,73,26,19,45,167.0,1231.0,1309,525,609,1134,4229.0,82,5.45,47,245,2478,9.0,0.508521
16873,16873,Marian Stastny,1982-83,30.0,2,89,74,74,35,54,89,174.0,,74,35,54,89,174.0,80,8.03,73,320,2489,12.9,1.0604331
16874,16874,Marian Stastny,1983-84,31.0,3,79,60,60,36,43,79,169.0,,134,71,97,168,343.0,80,7.73,71,310,2444,12.7,0.93103874
16875,16875,Marian Stastny,1984-85,32.0,4,52,68,68,20,32,52,113.0,,202,91,129,220,456.0,80,7.89,74,336,2448,12.9,0.62815666
16876,16876,Marian Stastny,1985-86,33.0,5,21,50,50,7,14,21,45.0,,252,98,143,241,501.0,80,7.77,71,321,2447,12.7,0.5403066
16877,16877,Marian Stastny,1986-87,34.0,6,53,70,70,23,30,53,132.0,,322,121,173,294,633.0,80,7.94,82,370,2484,12.8,0.654135
16878,16878,Mario Bliznak,2010-11,23.0,2,0,2,2,0,0,0,1.0,17.0,2,0,0,0,1.0,82,5.53,56,304,2486,9.1,0.17624307
16879,16879,Mario Bliznak,2011-12,24.0,3,1,4,4,1,0,1,1.0,26.0,6,1,0,1,2.0,82,5.46,52,291,2492,9.0,0.2033835
16880,16880,Mario Doyon,1989-90,21.0,2,2,7,7,1,1,2,7.0,,7,1,1,2,7.0,80,7.48,85,403,2430,12.3,0.31594867
16881,16881,Mario Doyon,1990-91,22.0,3,5,9,9,2,3,5,19.0,,16,3,4,7,26.0,80,7.37,76,367,2421,12.2,0.32381463
16882,16882,Mario Doyon,1991-92,23.0,4,0,12,12,0,0,0,12.0,,28,3,4,7,38.0,80,6.91,71,366,2385,11.6,0.21800438
16883,16883,Mario Ferraro,2020-21,22.0,2,11,61,61,2,9,11,63.0,969.0,61,2,9,11,63.0,70,5.96,42,208,2192,9.5,0.2519778
16884,16884,Mario Giallonardo,1980-81,23.0,2,1,8,8,0,1,1,4.0,,8,0,1,1,4.0,80,7.03,61,280,2352,12.0,0.24016955
16885,16885,Mario Giallonardo,1981-82,24.0,3,2,15,15,0,2,2,8.0,,23,0,3,3,12.0,80,7.69,77,340,2441,12.6,0.21424171
16886,16886,Mario Kempe,2018-19,30.0,2,4,18,18,2,2,4,20.0,200.0,18,2,2,4,20.0,82,5.86,50,250,2620,9.2,0.21033469
16887,16887,Mario Kempe,2019-20,31.0,3,9,52,52,4,5,9,57.0,582.0,70,6,7,13,77.0,82,5.96,47,239,2579,9.5,0.16263235
16888,16888,Mario Larocque,1999-00,21.0,2,0,5,5,0,0,0,3.0,63.0,5,0,0,0,3.0,82,5.27,57,359,2285,9.4,0.19303653
16889,16889,Mario Lemieux,1985-86,20.0,2,100,73,73,43,57,100,209.0,,73,43,57,100,209.0,80,7.77,71,321,2447,12.7,1.3454335
16890,16890,Mario Lemieux,1986-87,21.0,3,141,79,79,48,93,141,276.0,,152,91,150,241,485.0,80,7.94,82,370,2484,12.8,1.6094913
16891,16891,Mario Lemieux,1987-88,22.0,4,107,63,63,54,53,107,267.0,,215,145,203,348,752.0,80,7.34,72,344,2400,12.2,1.8980868
16892,16892,Mario Lemieux,1988-89,23.0,5,168,77,77,70,98,168,382.0,,292,215,301,516,1134.0,80,7.43,89,437,2435,12.2,2.4501379
16893,16893,Mario Lemieux,1989-90,24.0,6,199,76,76,85,114,199,313.0,,368,300,415,715,1447.0,80,7.48,85,403,2430,12.3,2.2500777
16894,16894,Mario Lemieux,1990-91,25.0,7,123,59,59,45,78,123,226.0,,427,345,493,838,1673.0,80,7.37,76,367,2421,12.2,1.7867146
16895,16895,Mario Lemieux,1991-92,26.0,8,45,26,26,19,26,45,89.0,,453,364,519,883,1762.0,80,6.91,71,366,2385,11.6,1.9235436
16896,16896,Mario Lemieux,1992-93,27.0,9,131,64,64,44,87,131,249.0,,517,408,606,1014,2011.0,80,6.96,77,402,2440,11.4,2.2743592
16897,16897,Mario Lemieux,1993-94,28.0,10,160,60,60,69,91,160,286.0,,577,477,697,1174,2297.0,84,7.25,87,443,2603,11.7,1.6662923
16898,16898,Mario Lemieux,1994-95,29.0,11,37,22,22,17,20,37,92.0,,599,494,717,1211,2389.0,84,6.48,76,407,2545,10.7,1.8922892
16899,16899,Mario Lemieux,1996-97,31.0,12,161,70,70,69,92,161,338.0,,669,563,809,1372,2727.0,82,6.29,74,413,2481,10.4,1.6163026
16900,16900,Mario Lemieux,1997-98,32.0,13,122,76,76,50,72,122,327.0,,745,613,881,1494,3054.0,82,5.83,55,336,2444,9.8,1.5460753
16901,16901,Mario Lemieux,2001-02,36.0,14,76,43,43,35,41,76,171.0,1047.0,788,648,922,1570,3225.0,82,5.51,63,376,2272,9.9,1.280118
16902,16902,Mario Lemieux,2002-03,37.0,15,31,24,24,6,25,31,75.0,534.0,812,654,947,1601,3300.0,82,5.24,53,338,2262,9.5,1.1482565
16903,16903,Mario Lemieux,2003-04,38.0,16,91,67,67,28,63,91,235.0,1546.0,879,682,1010,1692,3535.0,82,5.31,60,363,2326,9.4,1.0545208
16904,16904,Mario Lemieux,2004-05,39.0,17,9,10,10,1,8,9,21.0,224.0,889,683,1018,1701,3556.0,82,5.14,57,348,2300,9.2,0.6672484
16905,16905,Mario Lemieux,2006-07,41.0,18,22,26,26,7,15,22,77.0,504.0,915,690,1033,1723,3633.0,82,6.05,85,480,2458,10.1,0.8517099
16906,16906,Mario Roberge,1991-92,28.0,2,0,5,5,0,0,0,2.0,,5,0,0,0,2.0,80,6.91,71,366,2385,11.6,0.15793985
16907,16907,Mario Roberge,1992-93,29.0,3,3,20,20,2,1,3,7.0,,25,2,1,3,9.0,80,6.96,77,402,2440,11.4,0.22636163
16908,16908,Mario Roberge,1993-94,30.0,4,8,50,50,4,4,8,23.0,,75,6,5,11,32.0,84,7.25,87,443,2603,11.7,0.12527889
16909,16909,Mario Roberge,1994-95,31.0,5,3,28,28,1,2,3,5.0,,103,7,7,14,37.0,84,6.48,76,407,2545,10.7,0.11360812
16910,16910,Mario Roberge,1995-96,32.0,6,0,9,9,0,0,0,0.0,,112,7,7,14,37.0,48,5.97,37,209,1408,10.2,0.13010782
16911,16911,Mario Thyer,1990-91,24.0,2,0,5,5,0,0,0,4.0,,5,0,0,0,4.0,80,7.37,76,367,2421,12.2,0.2231631
16912,16912,Mariusz Czerkawski,1994-95,22.0,2,3,4,4,2,1,3,11.0,,4,2,1,3,11.0,84,6.48,76,407,2545,10.7,0.3086732
16913,16913,Mariusz Czerkawski,1995-96,23.0,3,26,47,47,12,14,26,126.0,,51,14,15,29,137.0,48,5.97,37,209,1408,10.2,0.5535839
16914,16914,Mariusz Czerkawski,1996-97,24.0,4,40,70,70,17,23,40,142.0,,121,31,38,69,279.0,82,6.29,74,413,2481,10.4,0.52124405
16915,16915,Mariusz Czerkawski,1997-98,25.0,5,47,76,76,26,21,47,182.0,,197,57,59,116,461.0,82,5.83,55,336,2444,9.8,0.6081051
16916,16916,Mariusz Czerkawski,1998-99,26.0,6,25,68,68,12,13,25,136.0,,265,69,72,141,597.0,82,5.28,57,380,2242,9.6,0.39401016
16917,16917,Mariusz Czerkawski,1999-00,27.0,7,38,78,78,21,17,38,205.0,1115.0,343,90,89,179,802.0,82,5.27,57,359,2285,9.4,0.5976961
16918,16918,Mariusz Czerkawski,2000-01,28.0,8,70,79,79,35,35,70,276.0,1402.0,422,125,124,249,1078.0,82,5.49,53,331,2294,9.8,0.803199
16919,16919,Mariusz Czerkawski,2001-02,29.0,9,62,82,82,30,32,62,287.0,1536.0,504,155,156,311,1365.0,82,5.51,63,376,2272,9.9,0.71683663
16920,16920,Mariusz Czerkawski,2002-03,30.0,10,51,82,82,22,29,51,169.0,1309.0,586,177,185,362,1534.0,82,5.24,53,338,2262,9.5,0.57790804
16921,16921,Mariusz Czerkawski,2003-04,31.0,11,14,43,43,5,9,14,77.0,566.0,629,182,194,376,1611.0,82,5.31,60,363,2326,9.4,0.31438386
16922,16922,Mariusz Czerkawski,2004-05,32.0,12,49,81,81,25,24,49,157.0,1056.0,710,207,218,425,1768.0,82,5.14,57,348,2300,9.2,0.62362194
16923,16923,Mariusz Czerkawski,2006-07,34.0,13,10,35,35,8,2,10,72.0,449.0,745,215,220,435,1840.0,82,6.05,85,480,2458,10.1,0.30614468
16924,16924,Mark Alt,2015-16,24.0,2,0,1,1,0,0,0,0.0,9.0,1,0,0,0,0.0,82,5.32,47,251,2453,8.9,0.1370357
16925,16925,Mark Alt,2018-19,27.0,3,0,15,15,0,0,0,11.0,187.0,16,0,0,0,11.0,82,5.86,50,250,2620,9.2,0.16363192
16926,16926,Mark Alt,2019-20,28.0,4,0,2,2,0,0,0,2.0,20.0,18,0,0,0,13.0,82,5.96,47,239,2579,9.5,0.156784
16927,16927,Mark Arcobello,2013-14,25.0,2,0,1,1,0,0,0,0.0,18.0,1,0,0,0,0.0,48,5.31,29,160,1399,9.1,0.18009916
16928,16928,Mark Arcobello,2014-15,26.0,3,18,41,41,4,14,18,70.0,618.0,42,4,14,18,70.0,82,5.34,48,269,2463,8.9,0.32932532
16929,16929,Mark Arcobello,2015-16,27.0,4,31,77,77,17,14,31,129.0,1140.0,119,21,28,49,199.0,82,5.32,47,251,2453,8.9,0.40812367
16930,16930,Mark Arcobello,2016-17,28.0,5,4,20,20,3,1,4,43.0,254.0,139,24,29,53,242.0,82,5.34,48,255,2438,9.0,0.2357113
16931,16931,Mark Astley,1994-95,25.0,2,0,1,1,0,0,0,2.0,,1,0,0,0,2.0,84,6.48,76,407,2545,10.7,0.16625237
16932,16932,Mark Astley,1995-96,26.0,3,3,14,14,2,1,3,21.0,,15,2,1,3,23.0,48,5.97,37,209,1408,10.2,0.28203106
16933,16933,Mark Astley,1996-97,27.0,4,20,60,60,2,18,20,80.0,,75,4,19,23,103.0,82,6.29,74,413,2481,10.4,0.26976323
16934,16934,Mark Barberio,2013-14,23.0,2,0,2,2,0,0,0,1.0,31.0,2,0,0,0,1.0,48,5.31,29,160,1399,9.1,0.20178127
16935,16935,Mark Barberio,2014-15,24.0,3,10,49,49,5,5,10,54.0,714.0,51,5,5,10,55.0,82,5.34,48,269,2463,8.9,0.22152698
16936,16936,Mark Barberio,2015-16,25.0,4,7,52,52,1,6,7,53.0,873.0,103,6,11,17,108.0,82,5.32,47,251,2453,8.9,0.17104873
16937,16937,Mark Barberio,2016-17,26.0,5,10,30,30,2,8,10,32.0,450.0,133,8,19,27,140.0,82,5.34,48,255,2438,9.0,0.19921434
16938,16938,Mark Barberio,2017-18,27.0,6,13,60,60,2,11,13,80.0,1096.0,193,10,30,40,220.0,82,5.45,47,245,2478,9.0,0.19961357
16939,16939,Mark Barberio,2018-19,28.0,7,13,46,46,3,10,13,52.0,795.0,239,13,40,53,272.0,82,5.86,50,250,2620,9.2,0.19940543
16940,16940,Mark Barberio,2019-20,29.0,8,1,12,12,1,0,1,11.0,183.0,251,14,40,54,283.0,82,5.96,47,239,2579,9.5,0.17803743
16941,16941,Mark Barberio,2020-21,30.0,9,2,21,21,0,2,2,29.0,296.0,272,14,42,56,312.0,70,5.96,42,208,2192,9.5,0.18783763
16942,16942,Mark Beaufait,1993-94,23.0,2,1,5,5,1,0,1,3.0,,5,1,0,1,3.0,84,7.25,87,443,2603,11.7,0.25787604
16943,16943,Mark Bell,2001-02,21.0,2,1,13,13,0,1,1,14.0,156.0,13,0,1,1,14.0,82,5.51,63,376,2272,9.9,0.21664149
16944,16944,Mark Bell,2002-03,22.0,3,28,80,80,12,16,28,120.0,1012.0,93,12,17,29,134.0,82,5.24,53,338,2262,9.5,0.39852205
16945,16945,Mark Bell,2003-04,23.0,4,29,82,82,14,15,29,127.0,1154.0,175,26,32,58,261.0,82,5.31,60,363,2326,9.4,0.39616036
16946,16946,Mark Bell,2004-05,24.0,5,45,82,82,21,24,45,202.0,1445.0,257,47,56,103,463.0,82,5.14,57,348,2300,9.2,0.63566834
16947,16947,Mark Bell,2006-07,26.0,6,48,82,82,25,23,48,227.0,1444.0,339,72,79,151,690.0,82,6.05,85,480,2458,10.1,0.5850655
16948,16948,Mark Bell,2007-08,27.0,7,21,71,71,11,10,21,116.0,920.0,410,83,89,172,806.0,82,5.76,70,398,2426,9.7,0.32255507
16949,16949,Mark Bell,2008-09,28.0,8,10,35,35,4,6,10,42.0,341.0,445,87,95,182,848.0,82,5.44,62,351,2383,9.4,0.31312323
16950,16950,Mark Bell,2012-13,32.0,9,0,5,5,0,0,0,0.0,32.0,450,87,95,182,848.0,82,5.32,47,271,2439,8.9,0.4442875
16951,16951,Mark Borowiecki,2012-13,23.0,2,0,2,2,0,0,0,1.0,25.0,2,0,0,0,1.0,82,5.32,47,271,2439,8.9,0.16584736
16952,16952,Mark Borowiecki,2013-14,24.0,3,0,6,6,0,0,0,1.0,78.0,8,0,0,0,2.0,48,5.31,29,160,1399,9.1,0.18462735
16953,16953,Mark Borowiecki,2014-15,25.0,4,1,13,13,1,0,1,6.0,164.0,21,1,0,1,8.0,82,5.34,48,269,2463,8.9,0.16937166
16954,16954,Mark Borowiecki,2015-16,26.0,5,11,63,63,1,10,11,30.0,1002.0,84,2,10,12,38.0,82,5.32,47,251,2453,8.9,0.12835324
16955,16955,Mark Borowiecki,2016-17,27.0,6,2,63,63,1,1,2,27.0,922.0,147,3,11,14,65.0,82,5.34,48,255,2438,9.0,0.08953059
16956,16956,Mark Borowiecki,2017-18,28.0,7,3,70,70,1,2,3,50.0,981.0,217,4,13,17,115.0,82,5.45,47,245,2478,9.0,0.120452404
16957,16957,Mark Borowiecki,2018-19,29.0,8,11,52,52,3,8,11,66.0,761.0,269,7,21,28,181.0,82,5.86,50,250,2620,9.2,0.18794456
16958,16958,Mark Borowiecki,2019-20,30.0,9,5,53,53,1,4,5,59.0,825.0,322,8,25,33,240.0,82,5.96,47,239,2579,9.5,0.118018925
16959,16959,Mark Borowiecki,2020-21,31.0,10,18,53,53,7,11,18,63.0,951.0,375,15,36,51,303.0,70,5.96,42,208,2192,9.5,0.30968207
16960,16960,Mark Botell,1982-83,21.0,2,14,32,32,4,10,14,50.0,,32,4,10,14,50.0,80,8.03,73,320,2489,12.9,0.40687257
16961,16961,Mark Cornforth,1996-97,24.0,2,0,6,6,0,0,0,1.0,,6,0,0,0,1.0,82,6.29,74,413,2481,10.4,0.15421098
16962,16962,Mark Cullen,2006-07,28.0,2,16,29,29,7,9,16,45.0,384.0,29,7,9,16,45.0,82,6.05,85,480,2458,10.1,0.36661464
16963,16963,Mark Cullen,2007-08,29.0,3,0,3,3,0,0,0,4.0,19.0,32,7,9,16,49.0,82,5.76,70,398,2426,9.7,0.16195449
16964,16964,Mark Cullen,2012-13,34.0,4,1,6,6,0,1,1,1.0,48.0,38,7,10,17,50.0,82,5.32,47,271,2439,8.9,0.14290035
16965,16965,Mark Cundari,2013-14,23.0,2,3,4,4,1,2,3,8.0,79.0,4,1,2,3,8.0,48,5.31,29,160,1399,9.1,0.2733314
16966,16966,Mark Cundari,2014-15,24.0,3,0,4,4,0,0,0,6.0,43.0,8,1,2,3,14.0,82,5.34,48,269,2463,8.9,0.16467515
16967,16967,Mark Eaton,2000-01,23.0,2,2,27,27,1,1,2,25.0,494.0,27,1,1,2,25.0,82,5.49,53,331,2294,9.8,0.20766208
16968,16968,Mark Eaton,2001-02,24.0,3,11,34,34,3,8,11,32.0,585.0,61,4,9,13,57.0,82,5.51,63,376,2272,9.9,0.21660197
16969,16969,Mark Eaton,2002-03,25.0,4,8,58,58,3,5,8,52.0,998.0,119,7,14,21,109.0,82,5.24,53,338,2262,9.5,0.16899043
16970,16970,Mark Eaton,2003-04,26.0,5,9,50,50,2,7,9,52.0,788.0,169,9,21,30,161.0,82,5.31,60,363,2326,9.4,0.17417315
16971,16971,Mark Eaton,2004-05,27.0,6,13,75,75,4,9,13,82.0,1570.0,244,13,30,43,243.0,82,5.14,57,348,2300,9.2,0.20655525
16972,16972,Mark Eaton,2006-07,29.0,7,4,69,69,3,1,4,28.0,1361.0,313,16,31,47,271.0,82,6.05,85,480,2458,10.1,0.10531166
16973,16973,Mark Eaton,2007-08,30.0,8,3,35,35,0,3,3,22.0,672.0,348,16,34,50,293.0,82,5.76,70,398,2426,9.7,0.12249854
16974,16974,Mark Eaton,2008-09,31.0,9,3,36,36,0,3,3,28.0,708.0,384,16,37,53,321.0,82,5.44,62,351,2383,9.4,0.12728596
16975,16975,Mark Eaton,2009-10,32.0,10,9,68,68,4,5,9,34.0,1208.0,452,20,42,62,355.0,82,5.7,65,341,2477,9.4,0.13507918
16976,16976,Mark Eaton,2010-11,33.0,11,16,79,79,3,13,16,65.0,1561.0,531,23,55,78,420.0,82,5.53,56,304,2486,9.1,0.16228604
16977,16977,Mark Eaton,2011-12,34.0,12,3,34,34,0,3,3,29.0,692.0,565,23,58,81,449.0,82,5.46,52,291,2492,9.0,0.12410319
16978,16978,Mark Eaton,2012-13,35.0,13,4,62,62,1,3,4,44.0,995.0,627,24,61,85,493.0,82,5.32,47,271,2439,8.9,0.112451315
16979,16979,Mark Eaton,2013-14,36.0,14,0,23,23,0,0,0,8.0,414.0,650,24,61,85,501.0,48,5.31,29,160,1399,9.1,0.09398928
16980,16980,Mark Fayne,2011-12,24.0,2,14,57,57,4,10,14,77.0,1017.0,57,4,10,14,77.0,82,5.46,52,291,2492,9.0,0.2471421
16981,16981,Mark Fayne,2012-13,25.0,3,17,82,82,4,13,17,94.0,1656.0,139,8,23,31,171.0,82,5.32,47,271,2439,8.9,0.23076963
16982,16982,Mark Fayne,2013-14,26.0,4,6,31,31,1,5,6,34.0,561.0,170,9,28,37,205.0,48,5.31,29,160,1399,9.1,0.19979832
16983,16983,Mark Fayne,2014-15,27.0,5,11,72,72,4,7,11,88.0,1318.0,242,13,35,48,293.0,82,5.34,48,269,2463,8.9,0.18852696
16984,16984,Mark Fayne,2015-16,28.0,6,8,74,74,2,6,8,78.0,1327.0,316,15,41,56,371.0,82,5.32,47,251,2453,8.9,0.16011068
16985,16985,Mark Fayne,2016-17,29.0,7,7,69,69,2,5,7,61.0,1153.0,385,17,46,63,432.0,82,5.34,48,255,2438,9.0,0.14856952
16986,16986,Mark Fayne,2017-18,30.0,8,2,4,4,0,2,2,4.0,32.0,389,17,48,65,436.0,82,5.45,47,245,2478,9.0,0.14461097
16987,16987,Mark Ferner,1987-88,22.0,2,3,13,13,0,3,3,5.0,,13,0,3,3,5.0,80,7.34,72,344,2400,12.2,0.22936583
16988,16988,Mark Ferner,1989-90,24.0,3,0,2,2,0,0,0,0.0,,15,0,3,3,5.0,80,7.48,85,403,2430,12.3,0.18642482
16989,16989,Mark Ferner,1990-91,25.0,4,0,2,2,0,0,0,2.0,,17,0,3,3,7.0,80,7.37,76,367,2421,12.2,0.18270257
16990,16990,Mark Ferner,1991-92,26.0,5,1,7,7,0,1,1,3.0,,24,0,4,4,10.0,80,6.91,71,366,2385,11.6,0.17444125
16991,16991,Mark Ferner,1994-95,29.0,6,8,50,50,3,5,8,44.0,,74,3,9,12,54.0,84,6.48,76,407,2545,10.7,0.15205589
16992,16992,Mark Ferner,1995-96,30.0,7,1,17,17,0,1,1,16.0,,91,3,10,13,70.0,48,5.97,37,209,1408,10.2,0.14384481
16993,16993,Mark Fistric,2008-09,22.0,2,2,37,37,0,2,2,17.0,471.0,37,0,2,2,17.0,82,5.44,62,351,2383,9.4,0.14720565
16994,16994,Mark Fistric,2009-10,23.0,3,4,36,36,0,4,4,35.0,574.0,73,0,6,6,52.0,82,5.7,65,341,2477,9.4,0.16986999
16995,16995,Mark Fistric,2010-11,24.0,4,10,67,67,1,9,10,46.0,1000.0,140,1,15,16,98.0,82,5.53,56,304,2486,9.1,0.15044087
16996,16996,Mark Fistric,2011-12,25.0,5,5,57,57,2,3,5,26.0,820.0,197,3,18,21,124.0,82,5.46,52,291,2492,9.0,0.108340025
16997,16997,Mark Fistric,2012-13,26.0,6,2,60,60,0,2,2,30.0,991.0,257,3,20,23,154.0,82,5.32,47,271,2439,8.9,0.09809509
16998,16998,Mark Fistric,2013-14,27.0,7,6,25,25,0,6,6,9.0,383.0,282,3,26,29,163.0,48,5.31,29,160,1399,9.1,0.10687336
16999,16999,Mark Fistric,2014-15,28.0,8,5,34,34,1,4,5,22.0,524.0,316,4,30,34,185.0,82,5.34,48,269,2463,8.9,0.12162331
17000,17000,Mark Fistric,2015-16,29.0,9,0,9,9,0,0,0,1.0,133.0,325,4,30,34,186.0,82,5.32,47,251,2453,8.9,0.10166374
17001,17001,Mark Flood,2010-11,26.0,2,1,6,6,0,1,1,5.0,76.0,6,0,1,1,5.0,82,5.53,56,304,2486,9.1,0.17891663
17002,17002,Mark Flood,2012-13,28.0,3,7,33,33,3,4,7,30.0,507.0,39,3,5,8,35.0,82,5.32,47,271,2439,8.9,0.19888148
17003,17003,Mark Fraser,2007-08,21.0,2,0,7,7,0,0,0,1.0,25.0,7,0,0,0,1.0,82,5.76,70,398,2426,9.7,0.1717813
17004,17004,Mark Fraser,2010-11,24.0,3,6,61,61,3,3,6,24.0,755.0,68,3,3,6,25.0,82,5.53,56,304,2486,9.1,0.12908253
17005,17005,Mark Fraser,2011-12,25.0,4,2,26,26,0,2,2,16.0,363.0,94,3,5,8,41.0,82,5.46,52,291,2492,9.0,0.12721658
17006,17006,Mark Fraser,2012-13,26.0,5,0,4,4,0,0,0,0.0,57.0,98,3,5,8,41.0,82,5.32,47,271,2439,8.9,0.12185547
17007,17007,Mark Fraser,2013-14,27.0,6,8,45,45,0,8,8,33.0,763.0,143,3,13,16,74.0,48,5.31,29,160,1399,9.1,0.13365376
17008,17008,Mark Fraser,2014-15,28.0,7,2,42,42,1,1,2,11.0,646.0,185,4,14,18,85.0,82,5.34,48,269,2463,8.9,0.08346659
17009,17009,Mark Fraser,2015-16,29.0,8,4,34,34,0,4,4,19.0,553.0,219,4,18,22,104.0,82,5.32,47,251,2453,8.9,0.10631189
17010,17010,Mark Freer,1987-88,19.0,2,1,1,1,0,1,1,0.0,,1,0,1,1,0.0,80,7.34,72,344,2400,12.2,0.28640527
17011,17011,Mark Freer,1988-89,20.0,3,0,1,1,0,0,0,0.0,,2,0,1,1,0.0,80,7.43,89,437,2435,12.2,0.30134928
17012,17012,Mark Freer,1989-90,21.0,4,1,5,5,0,1,1,1.0,,7,0,2,2,1.0,80,7.48,85,403,2430,12.3,0.26432878
17013,17013,Mark Freer,1990-91,22.0,5,0,2,2,0,0,0,2.0,,9,0,2,2,3.0,80,7.37,76,367,2421,12.2,0.21150887
17014,17014,Mark Freer,1992-93,24.0,6,13,50,50,6,7,13,41.0,,59,6,9,15,44.0,80,6.96,77,402,2440,11.4,0.2818807
17015,17015,Mark Freer,1993-94,25.0,7,24,63,63,10,14,24,80.0,,122,16,23,39,124.0,84,7.25,87,443,2603,11.7,0.27827317
17016,17016,Mark Freer,1994-95,26.0,8,0,2,2,0,0,0,0.0,,124,16,23,39,124.0,84,6.48,76,407,2545,10.7,0.15000871
17017,17017,Mark Friedman,2019-20,24.0,2,0,1,1,0,0,0,1.0,13.0,1,0,0,0,1.0,82,5.96,47,239,2579,9.5,0.17661515
17018,17018,Mark Friedman,2020-21,25.0,3,1,6,6,0,1,1,2.0,82.0,7,0,1,1,3.0,70,5.96,42,208,2192,9.5,0.19754416
17019,17019,Mark Fusco,1984-85,23.0,2,4,17,17,0,4,4,17.0,,17,0,4,4,17.0,80,7.89,74,336,2448,12.9,0.24928305
17020,17020,Mark Fusco,1985-86,24.0,3,11,63,63,3,8,11,71.0,,80,3,12,15,88.0,80,7.77,71,321,2447,12.7,0.25283757
17021,17021,Mark Giordano,2006-07,23.0,2,1,7,7,0,1,1,5.0,85.0,7,0,1,1,5.0,82,6.05,85,480,2458,10.1,0.19417447
17022,17022,Mark Giordano,2007-08,24.0,3,15,48,48,7,8,15,49.0,645.0,55,7,9,16,54.0,82,5.76,70,398,2426,9.7,0.2786147
17023,17023,Mark Giordano,2009-10,26.0,4,19,58,58,2,17,19,82.0,940.0,113,9,26,35,136.0,82,5.7,65,341,2477,9.4,0.28475112
17024,17024,Mark Giordano,2010-11,27.0,5,30,82,82,11,19,30,111.0,1709.0,195,20,45,65,247.0,82,5.53,56,304,2486,9.1,0.34674108
17025,17025,Mark Giordano,2011-12,28.0,6,43,82,82,8,35,43,165.0,1898.0,277,28,80,108,412.0,82,5.46,52,291,2492,9.0,0.48869923
17026,17026,Mark Giordano,2012-13,29.0,7,27,61,61,9,18,27,125.0,1404.0,338,37,98,135,537.0,82,5.32,47,271,2439,8.9,0.36782032
17027,17027,Mark Giordano,2013-14,30.0,8,15,47,47,4,11,15,58.0,1089.0,385,41,109,150,595.0,48,5.31,29,160,1399,9.1,0.30107626
17028,17028,Mark Giordano,2014-15,31.0,9,47,64,64,14,33,47,180.0,1615.0,449,55,142,197,775.0,82,5.34,48,269,2463,8.9,0.61299056
17029,17029,Mark Giordano,2015-16,32.0,10,48,61,61,11,37,48,157.0,1536.0,510,66,179,245,932.0,82,5.32,47,251,2453,8.9,0.5949179
17030,17030,Mark Giordano,2016-17,33.0,11,56,82,82,21,35,56,212.0,2032.0,592,87,214,301,1144.0,82,5.34,48,255,2438,9.0,0.6365949
17031,17031,Mark Giordano,2017-18,34.0,12,39,81,81,12,27,39,151.0,1910.0,673,99,241,340,1295.0,82,5.45,47,245,2478,9.0,0.445342
17032,17032,Mark Giordano,2018-19,35.0,13,38,82,82,13,25,38,214.0,2033.0,755,112,266,378,1509.0,82,5.86,50,250,2620,9.2,0.5181209
17033,17033,Mark Giordano,2019-20,36.0,14,74,78,78,17,57,74,221.0,1891.0,833,129,323,452,1730.0,82,5.96,47,239,2579,9.5,0.7172694
17034,17034,Mark Giordano,2020-21,37.0,15,31,60,60,5,26,31,157.0,1433.0,893,134,349,483,1887.0,70,5.96,42,208,2192,9.5,0.44988602
17035,17035,Mark Greig,1991-92,22.0,2,0,4,4,0,0,0,1.0,,4,0,0,0,1.0,80,6.91,71,366,2385,11.6,0.19551483
17036,17036,Mark Greig,1992-93,23.0,3,5,17,17,0,5,5,18.0,,21,0,5,5,19.0,80,6.96,77,402,2440,11.4,0.24198925
17037,17037,Mark Greig,1993-94,24.0,4,8,22,22,1,7,8,16.0,,43,1,12,13,35.0,84,7.25,87,443,2603,11.7,0.20382446
17038,17038,Mark Greig,1994-95,25.0,5,13,44,44,6,7,13,55.0,,87,7,19,26,90.0,84,6.48,76,407,2545,10.7,0.2688751
17039,17039,Mark Greig,1995-96,26.0,6,2,8,8,1,1,2,5.0,,95,8,20,28,95.0,48,5.97,37,209,1408,10.2,0.22372076
17040,17040,Mark Greig,1999-00,30.0,7,4,7,7,1,3,4,9.0,69.0,102,9,23,32,104.0,82,5.27,57,359,2285,9.4,0.23346806
17041,17041,Mark Greig,2000-01,31.0,8,5,11,11,3,2,5,14.0,125.0,113,12,25,37,118.0,82,5.49,53,331,2294,9.8,0.26428208
17042,17042,Mark Greig,2001-02,32.0,9,2,7,7,1,1,2,7.0,101.0,120,13,26,39,125.0,82,5.51,63,376,2272,9.9,0.1684112
17043,17043,Mark Greig,2003-04,34.0,10,1,5,5,0,1,1,2.0,25.0,125,13,27,40,127.0,82,5.31,60,363,2326,9.4,0.13440824
17044,17044,Mark Hamway,1985-86,24.0,2,0,2,2,0,0,0,1.0,,2,0,0,0,1.0,80,7.77,71,321,2447,12.7,0.22530669
17045,17045,Mark Hamway,1986-87,25.0,3,17,49,49,5,12,17,50.0,,51,5,12,17,51.0,80,7.94,82,370,2484,12.8,0.31663674
17046,17046,Mark Hamway,1987-88,26.0,4,1,2,2,0,1,1,1.0,,53,5,13,18,52.0,80,7.34,72,344,2400,12.2,0.21373522
17047,17047,Mark Hardy,1980-81,21.0,2,1,15,15,0,1,1,14.0,,15,0,1,1,14.0,80,7.03,61,280,2352,12.0,0.27989614
17048,17048,Mark Hardy,1981-82,22.0,3,25,77,77,5,20,25,90.0,,92,5,21,26,104.0,80,7.69,77,340,2441,12.6,0.37408066
17049,17049,Mark Hardy,1982-83,23.0,4,45,77,77,6,39,45,121.0,,169,11,60,71,225.0,80,8.03,73,320,2489,12.9,0.48901474
17050,17050,Mark Hardy,1983-84,24.0,5,39,74,74,5,34,39,162.0,,243,16,94,110,387.0,80,7.73,71,310,2444,12.7,0.5320984
17051,17051,Mark Hardy,1984-85,25.0,6,49,79,79,8,41,49,175.0,,322,24,135,159,562.0,80,7.89,74,336,2448,12.9,0.60557306
17052,17052,Mark Hardy,1985-86,26.0,7,53,78,78,14,39,53,151.0,,400,38,174,212,713.0,80,7.77,71,321,2447,12.7,0.63954103
17053,17053,Mark Hardy,1986-87,27.0,8,27,55,55,6,21,27,113.0,,455,44,195,239,826.0,80,7.94,82,370,2484,12.8,0.4638536
17054,17054,Mark Hardy,1987-88,28.0,9,30,73,73,3,27,30,97.0,,528,47,222,269,923.0,80,7.34,72,344,2400,12.2,0.39545232
17055,17055,Mark Hardy,1988-89,29.0,10,32,80,80,8,24,32,134.0,,608,55,246,301,1057.0,80,7.43,89,437,2435,12.2,0.41531318
17056,17056,Mark Hardy,1989-90,30.0,11,20,60,60,4,16,20,70.0,,668,59,262,321,1127.0,80,7.48,85,403,2430,12.3,0.30359364
17057,17057,Mark Hardy,1990-91,31.0,12,15,54,54,0,15,15,55.0,,722,59,277,336,1182.0,80,7.37,76,367,2421,12.2,0.23729566
17058,17058,Mark Hardy,1991-92,32.0,13,6,70,70,1,5,6,63.0,,792,60,282,342,1245.0,80,6.91,71,366,2385,11.6,0.16731754
17059,17059,Mark Hardy,1992-93,33.0,14,9,52,52,1,8,9,42.0,,844,61,290,351,1287.0,80,6.96,77,402,2440,11.4,0.1909832
17060,17060,Mark Hardy,1993-94,34.0,15,14,55,55,1,13,14,48.0,,899,62,303,365,1335.0,84,7.25,87,443,2603,11.7,0.15920648
17061,17061,Mark Hardy,1994-95,35.0,16,3,16,16,0,3,3,8.0,,915,62,306,368,1343.0,84,6.48,76,407,2545,10.7,0.12619421
17062,17062,Mark Hartigan,2002-03,25.0,2,0,2,2,0,0,0,3.0,27.0,2,0,0,0,3.0,82,5.24,53,338,2262,9.5,0.16791895
17063,17063,Mark Hartigan,2003-04,26.0,3,7,23,23,5,2,7,25.0,250.0,25,5,2,7,28.0,82,5.31,60,363,2326,9.4,0.26957285
17064,17064,Mark Hartigan,2004-05,27.0,4,4,9,9,1,3,4,15.0,147.0,34,6,5,11,43.0,82,5.14,57,348,2300,9.2,0.22331136
17065,17065,Mark Hartigan,2006-07,29.0,5,12,33,33,9,3,12,54.0,384.0,67,15,8,23,97.0,82,6.05,85,480,2458,10.1,0.25882328
17066,17066,Mark Hartigan,2007-08,30.0,6,3,12,12,1,2,3,15.0,129.0,79,16,10,26,112.0,82,5.76,70,398,2426,9.7,0.22105825
17067,17067,Mark Hartigan,2008-09,31.0,7,4,23,23,3,1,4,19.0,165.0,102,19,11,30,131.0,82,5.44,62,351,2383,9.4,0.19929364
17068,17068,Mark Howe,1980-81,25.0,2,80,74,74,24,56,80,178.0,,74,24,56,80,178.0,80,7.03,61,280,2352,12.0,0.9368155
17069,17069,Mark Howe,1981-82,26.0,3,65,63,63,19,46,65,172.0,,137,43,102,145,350.0,80,7.69,77,340,2441,12.6,0.8877245
17070,17070,Mark Howe,1982-83,27.0,4,53,76,76,8,45,53,225.0,,213,51,147,198,575.0,80,8.03,73,320,2489,12.9,0.7158678
17071,17071,Mark Howe,1983-84,28.0,5,67,76,76,20,47,67,219.0,,289,71,194,265,794.0,80,7.73,71,310,2444,12.7,0.8367206
17072,17072,Mark Howe,1984-85,29.0,6,53,71,71,19,34,53,184.0,,360,90,228,318,978.0,80,7.89,74,336,2448,12.9,0.6955576
17073,17073,Mark Howe,1985-86,30.0,7,57,73,73,18,39,57,215.0,,433,108,267,375,1193.0,80,7.77,71,321,2447,12.7,0.7751744
17074,17074,Mark Howe,1986-87,31.0,8,82,77,77,24,58,82,193.0,,510,132,325,457,1386.0,80,7.94,82,370,2484,12.8,0.82569635
17075,17075,Mark Howe,1987-88,32.0,9,58,69,69,15,43,58,150.0,,579,147,368,515,1536.0,80,7.34,72,344,2400,12.2,0.7970704
17076,17076,Mark Howe,1988-89,33.0,10,62,75,75,19,43,62,177.0,,654,166,411,577,1713.0,80,7.43,89,437,2435,12.2,0.74654126
17077,17077,Mark Howe,1989-90,34.0,11,38,52,52,9,29,38,95.0,,706,175,440,615,1808.0,80,7.48,85,403,2430,12.3,0.65067506
17078,17078,Mark Howe,1990-91,35.0,12,28,40,40,7,21,28,63.0,,746,182,461,643,1871.0,80,7.37,76,367,2421,12.2,0.5908585
17079,17079,Mark Howe,1991-92,36.0,13,10,19,19,0,10,10,40.0,,765,182,471,653,1911.0,80,6.91,71,366,2385,11.6,0.46090856
17080,17080,Mark Howe,1992-93,37.0,14,25,42,42,7,18,25,63.0,,807,189,489,678,1974.0,80,6.96,77,402,2440,11.4,0.523365
17081,17081,Mark Howe,1993-94,38.0,15,34,60,60,3,31,34,72.0,,867,192,520,712,2046.0,84,7.25,87,443,2603,11.7,0.39583164
17082,17082,Mark Howe,1994-95,39.0,16,24,44,44,4,20,24,72.0,,911,196,540,736,2118.0,84,6.48,76,407,2545,10.7,0.38083977
17083,17083,Mark Howe,1995-96,40.0,17,6,18,18,1,5,6,14.0,,929,197,545,742,2132.0,48,5.97,37,209,1408,10.2,0.37572405
17084,17084,Mark Hunter,1982-83,20.0,2,29,71,71,18,11,29,79.0,,71,18,11,29,79.0,80,8.03,73,320,2489,12.9,0.4746069
17085,17085,Mark Hunter,1983-84,21.0,3,16,31,31,8,8,16,39.0,,102,26,19,45,118.0,80,7.73,71,310,2444,12.7,0.4872267
17086,17086,Mark Hunter,1984-85,22.0,4,10,22,22,6,4,10,24.0,,124,32,23,55,142.0,80,7.89,74,336,2448,12.9,0.45503733
17087,17087,Mark Hunter,1985-86,23.0,5,33,72,72,21,12,33,107.0,,196,53,35,88,249.0,80,7.77,71,321,2447,12.7,0.50988406
17088,17088,Mark Hunter,1986-87,24.0,6,74,78,78,44,30,74,204.0,,274,97,65,162,453.0,80,7.94,82,370,2484,12.8,0.8382114
17089,17089,Mark Hunter,1987-88,25.0,7,69,74,74,36,33,69,178.0,,348,133,98,231,631.0,80,7.34,72,344,2400,12.2,0.84937835
17090,17090,Mark Hunter,1988-89,26.0,8,63,66,66,32,31,63,164.0,,414,165,129,294,795.0,80,7.43,89,437,2435,12.2,0.79695666
17091,17091,Mark Hunter,1989-90,27.0,9,30,66,66,22,8,30,116.0,,480,187,137,324,911.0,80,7.48,85,403,2430,12.3,0.4781042
17092,17092,Mark Hunter,1990-91,28.0,10,5,10,10,2,3,5,15.0,,490,189,140,329,926.0,80,7.37,76,367,2421,12.2,0.46256152
17093,17093,Mark Hunter,1991-92,29.0,11,32,68,68,14,18,32,110.0,,558,203,158,361,1036.0,80,6.91,71,366,2385,11.6,0.4275839
17094,17094,Mark Hunter,1992-93,30.0,12,23,63,63,10,13,23,92.0,,621,213,171,384,1128.0,80,6.96,77,402,2440,11.4,0.34303954
17095,17095,Mark Hunter,1993-94,31.0,13,0,7,7,0,0,0,5.0,,628,213,171,384,1133.0,84,7.25,87,443,2603,11.7,0.2558777
17096,17096,Mark Jankowski,2017-18,23.0,2,0,1,1,0,0,0,0.0,10.0,1,0,0,0,0.0,82,5.45,47,245,2478,9.0,0.17018634
17097,17097,Mark Jankowski,2018-19,24.0,3,25,72,72,17,8,25,118.0,962.0,73,17,8,25,118.0,82,5.86,50,250,2620,9.2,0.3777681
17098,17098,Mark Jankowski,2019-20,25.0,4,32,79,79,14,18,32,99.0,1004.0,152,31,26,57,217.0,82,5.96,47,239,2579,9.5,0.37627286
17099,17099,Mark Jankowski,2020-21,26.0,5,7,56,56,5,2,7,38.0,621.0,208,36,28,64,255.0,70,5.96,42,208,2192,9.5,0.22060445
17100,17100,Mark Janssens,1988-89,20.0,2,0,1,1,0,0,0,0.0,,1,0,0,0,0.0,80,7.43,89,437,2435,12.2,0.2499237
17101,17101,Mark Janssens,1989-90,21.0,3,0,5,5,0,0,0,4.0,,6,0,0,0,4.0,80,7.48,85,403,2430,12.3,0.23458329
17102,17102,Mark Janssens,1990-91,22.0,4,13,80,80,5,8,13,61.0,,86,5,8,13,65.0,80,7.37,76,367,2421,12.2,0.22580951
17103,17103,Mark Janssens,1991-92,23.0,5,16,67,67,9,7,16,45.0,,153,14,15,29,110.0,80,6.91,71,366,2385,11.6,0.24099645
17104,17104,Mark Janssens,1992-93,24.0,6,0,7,7,0,0,0,1.0,,160,14,15,29,111.0,80,6.96,77,402,2440,11.4,0.18196657
17105,17105,Mark Janssens,1993-94,25.0,7,29,76,76,12,17,29,63.0,,236,26,32,58,174.0,84,7.25,87,443,2603,11.7,0.2947016
17106,17106,Mark Janssens,1994-95,26.0,8,12,84,84,2,10,12,52.0,,320,28,42,70,226.0,84,6.48,76,407,2545,10.7,0.16969651
17107,17107,Mark Janssens,1995-96,27.0,9,7,46,46,2,5,7,33.0,,366,30,47,77,259.0,48,5.97,37,209,1408,10.2,0.16078866
17108,17108,Mark Janssens,1996-97,28.0,10,9,81,81,2,7,9,63.0,,447,32,54,86,322.0,82,6.29,74,413,2481,10.4,0.16029096
17109,17109,Mark Janssens,1997-98,29.0,11,8,66,66,2,6,8,39.0,,513,34,60,94,361.0,82,5.83,55,336,2444,9.8,0.14566278
17110,17110,Mark Janssens,1998-99,30.0,12,12,74,74,5,7,12,53.0,,587,39,67,106,414.0,82,5.28,57,380,2242,9.6,0.14202166
17111,17111,Mark Janssens,1999-00,31.0,13,1,60,60,1,0,1,27.0,497.0,647,40,67,107,441.0,82,5.27,57,359,2285,9.4,0.1110619
17112,17112,Mark Janssens,2000-01,32.0,14,6,36,36,0,6,6,14.0,259.0,683,40,73,113,455.0,82,5.49,53,331,2294,9.8,0.114596516
17113,17113,Mark Janssens,2001-02,33.0,15,0,28,28,0,0,0,15.0,293.0,711,40,73,113,470.0,82,5.51,63,376,2272,9.9,0.10402572
17114,17114,Mark Johnson,1980-81,23.0,2,8,17,17,3,5,8,32.0,,17,3,5,8,32.0,80,7.03,61,280,2352,12.0,0.39406177
17115,17115,Mark Johnson,1981-82,24.0,3,33,73,73,10,23,33,109.0,,90,13,28,41,141.0,80,7.69,77,340,2441,12.6,0.44594833
17116,17116,Mark Johnson,1982-83,25.0,4,25,56,56,12,13,25,111.0,,146,25,41,66,252.0,80,8.03,73,320,2489,12.9,0.47346914
17117,17117,Mark Johnson,1983-84,26.0,5,69,73,73,31,38,69,167.0,,219,56,79,135,419.0,80,7.73,71,310,2444,12.7,0.83565015
17118,17118,Mark Johnson,1984-85,27.0,6,87,79,79,35,52,87,184.0,,298,91,131,222,603.0,80,7.89,74,336,2448,12.9,0.9704225
17119,17119,Mark Johnson,1985-86,28.0,7,57,66,66,23,34,57,143.0,,364,114,165,279,746.0,80,7.77,71,321,2447,12.7,0.7477527
17120,17120,Mark Johnson,1986-87,29.0,8,62,80,80,21,41,62,167.0,,444,135,206,341,913.0,80,7.94,82,370,2484,12.8,0.69994843
17121,17121,Mark Johnson,1987-88,30.0,9,51,68,68,25,26,51,193.0,,512,160,232,392,1106.0,80,7.34,72,344,2400,12.2,0.69614565
17122,17122,Mark Johnson,1988-89,31.0,10,33,54,54,14,19,33,121.0,,566,174,251,425,1227.0,80,7.43,89,437,2435,12.2,0.646015
17123,17123,Mark Johnson,1989-90,32.0,11,38,40,40,13,25,38,95.0,,606,187,276,463,1322.0,80,7.48,85,403,2430,12.3,0.6478393
17124,17124,Mark Johnson,1990-91,33.0,12,45,63,63,16,29,45,82.0,,669,203,305,508,1404.0,80,7.37,76,367,2421,12.2,0.5142782
17125,17125,Mark Kachowski,1988-89,23.0,2,8,38,38,5,3,8,21.0,,38,5,3,8,21.0,80,7.43,89,437,2435,12.2,0.25209042
17126,17126,Mark Kachowski,1989-90,24.0,3,2,12,12,1,1,2,3.0,,50,6,4,10,24.0,80,7.48,85,403,2430,12.3,0.23267177
17127,17127,Mark Kachowski,1990-91,25.0,4,1,14,14,0,1,1,4.0,,64,6,5,11,28.0,80,7.37,76,367,2421,12.2,0.18325183
17128,17128,Mark Katic,2011-12,22.0,2,1,11,11,0,1,1,8.0,181.0,11,0,1,1,8.0,82,5.46,52,291,2492,9.0,0.18217763
17129,17129,Mark Kirton,1980-81,22.0,2,1,2,2,1,0,1,3.0,,2,1,0,1,3.0,80,7.03,61,280,2352,12.0,0.29302087
17130,17130,Mark Kirton,1981-82,23.0,3,31,61,61,18,13,31,102.0,,63,19,13,32,105.0,80,7.69,77,340,2441,12.6,0.55393535
17131,17131,Mark Kirton,1982-83,24.0,4,42,74,74,14,28,42,121.0,,137,33,41,74,226.0,80,8.03,73,320,2489,12.9,0.49060982
17132,17132,Mark Kirton,1983-84,25.0,5,12,41,41,5,7,12,49.0,,178,38,48,86,275.0,80,7.73,71,310,2444,12.7,0.35696256
17133,17133,Mark Kirton,1984-85,26.0,6,5,26,26,2,3,5,26.0,,204,40,51,91,301.0,80,7.89,74,336,2448,12.9,0.2997142
17134,17134,Mark Kirton,1985-86,27.0,7,22,62,62,17,5,22,94.0,,266,57,56,113,395.0,80,7.77,71,321,2447,12.7,0.3699246
17135,17135,Mark Kolesar,1996-97,24.0,2,4,21,21,2,2,4,10.0,,21,2,2,4,10.0,82,6.29,74,413,2481,10.4,0.19135419
17136,17136,Mark Kolesar,1997-98,25.0,3,0,7,7,0,0,0,3.0,,28,2,2,4,13.0,82,5.83,55,336,2444,9.8,0.15311566
17137,17137,Mark Kumpel,1985-86,24.0,2,15,42,42,8,7,15,48.0,,42,8,7,15,48.0,80,7.77,71,321,2447,12.7,0.38176182
17138,17138,Mark Kumpel,1986-87,25.0,3,22,47,47,10,12,22,76.0,,89,18,19,37,124.0,80,7.94,82,370,2484,12.8,0.4269709
17139,17139,Mark Kumpel,1987-88,26.0,4,10,45,45,1,9,10,48.0,,134,19,28,47,172.0,80,7.34,72,344,2400,12.2,0.27609617
17140,17140,Mark Kumpel,1988-89,27.0,5,10,45,45,4,6,10,42.0,,179,23,34,57,214.0,80,7.43,89,437,2435,12.2,0.2949373
17141,17141,Mark Kumpel,1990-91,29.0,6,17,56,56,8,9,17,74.0,,235,31,43,74,288.0,80,7.37,76,367,2421,12.2,0.3183137
17142,17142,Mark Kumpel,1991-92,30.0,7,10,53,53,7,3,10,65.0,,288,38,46,84,353.0,80,6.91,71,366,2385,11.6,0.26100442
17143,17143,Mark LaVarre,1986-87,21.0,2,0,2,2,0,0,0,2.0,,2,0,0,0,2.0,80,7.94,82,370,2484,12.8,0.23389101
17144,17144,Mark LaVarre,1987-88,22.0,3,23,58,58,8,15,23,46.0,,60,8,15,23,48.0,80,7.34,72,344,2400,12.2,0.37178582
17145,17145,Mark LaVarre,1988-89,23.0,4,2,18,18,1,1,2,17.0,,78,9,16,25,65.0,80,7.43,89,437,2435,12.2,0.29266027
17146,17146,Mark Lamb,1986-87,22.0,2,0,1,1,0,0,0,0.0,,1,0,0,0,0.0,80,7.94,82,370,2484,12.8,0.18277737
17147,17147,Mark Lamb,1987-88,23.0,3,3,22,22,2,1,3,8.0,,23,2,1,3,8.0,80,7.34,72,344,2400,12.2,0.27048746
17148,17148,Mark Lamb,1988-89,24.0,4,0,2,2,0,0,0,0.0,,25,2,1,3,8.0,80,7.43,89,437,2435,12.2,0.18699536
17149,17149,Mark Lamb,1989-90,25.0,5,10,20,20,2,8,10,20.0,,45,4,9,13,28.0,80,7.48,85,403,2430,12.3,0.29347903
17150,17150,Mark Lamb,1990-91,26.0,6,28,58,58,12,16,28,81.0,,103,16,25,41,109.0,80,7.37,76,367,2421,12.2,0.37954506
17151,17151,Mark Lamb,1991-92,27.0,7,12,37,37,4,8,12,41.0,,140,20,33,53,150.0,80,6.91,71,366,2385,11.6,0.28364247
17152,17152,Mark Lamb,1992-93,28.0,8,28,59,59,6,22,28,61.0,,199,26,55,81,211.0,80,6.96,77,402,2440,11.4,0.38045824
17153,17153,Mark Lamb,1993-94,29.0,9,26,71,71,7,19,26,123.0,,270,33,74,107,334.0,84,7.25,87,443,2603,11.7,0.3031961
17154,17154,Mark Lamb,1994-95,30.0,10,36,85,85,12,24,36,124.0,,355,45,98,143,458.0,84,6.48,76,407,2545,10.7,0.33382562
17155,17155,Mark Lamb,1995-96,31.0,11,3,47,47,1,2,3,30.0,,402,46,100,146,488.0,48,5.97,37,209,1408,10.2,0.12154424
17156,17156,Mark Lamb,1996-97,32.0,12,0,1,1,0,0,0,0.0,,403,46,100,146,488.0,82,6.29,74,413,2481,10.4,0.38377115
17157,17157,Mark Lawrence,1995-96,24.0,2,0,2,2,0,0,0,3.0,,2,0,0,0,3.0,48,5.97,37,209,1408,10.2,0.19634986
17158,17158,Mark Lawrence,1996-97,25.0,3,1,13,13,0,1,1,13.0,,15,0,1,1,16.0,82,6.29,74,413,2481,10.4,0.17150384
17159,17159,Mark Lawrence,1998-99,27.0,4,0,2,2,0,0,0,4.0,,17,0,1,1,20.0,82,5.28,57,380,2242,9.6,0.15367845
17160,17160,Mark Lawrence,1999-00,28.0,5,30,60,60,14,16,30,88.0,848.0,77,14,17,31,108.0,82,5.27,57,359,2285,9.4,0.40948182
17161,17161,Mark Lawrence,2000-01,29.0,6,6,29,29,1,5,6,33.0,405.0,106,15,22,37,141.0,82,5.49,53,331,2294,9.8,0.20271423
17162,17162,Mark Lawrence,2001-02,30.0,7,7,36,36,3,4,7,32.0,355.0,142,18,26,44,173.0,82,5.51,63,376,2272,9.9,0.19686976
17163,17163,Mark Letestu,2010-11,25.0,2,1,10,10,1,0,1,9.0,96.0,10,1,0,1,9.0,82,5.53,56,304,2486,9.1,0.19307852
17164,17164,Mark Letestu,2011-12,26.0,3,27,64,64,14,13,27,128.0,912.0,74,15,13,28,137.0,82,5.46,52,291,2492,9.0,0.3912267
17165,17165,Mark Letestu,2012-13,27.0,4,25,62,62,11,14,25,114.0,970.0,136,26,27,53,251.0,82,5.32,47,271,2439,8.9,0.33763582
17166,17166,Mark Letestu,2013-14,28.0,5,27,46,46,13,14,27,92.0,760.0,182,39,41,80,343.0,48,5.31,29,160,1399,9.1,0.5093503
17167,17167,Mark Letestu,2014-15,29.0,6,34,82,82,12,22,34,122.0,1205.0,264,51,63,114,465.0,82,5.34,48,269,2463,8.9,0.39149228
17168,17168,Mark Letestu,2015-16,30.0,7,13,54,54,7,6,13,63.0,720.0,318,58,69,127,528.0,82,5.32,47,251,2453,8.9,0.26409924
17169,17169,Mark Letestu,2016-17,31.0,8,25,82,82,10,15,25,107.0,1294.0,400,68,84,152,635.0,82,5.34,48,255,2438,9.0,0.29363596
17170,17170,Mark Letestu,2017-18,32.0,9,35,78,78,16,19,35,120.0,1111.0,478,84,103,187,755.0,82,5.45,47,245,2478,9.0,0.36613834
17171,17171,Mark Letestu,2018-19,33.0,10,23,80,80,9,14,23,111.0,1028.0,558,93,117,210,866.0,82,5.86,50,250,2620,9.2,0.26856315
17172,17172,Mark Letestu,2019-20,34.0,11,0,2,2,0,0,0,1.0,19.0,560,93,117,210,867.0,82,5.96,47,239,2579,9.5,0.13553506
17173,17173,Mark Letestu,2020-21,35.0,12,0,7,7,0,0,0,5.0,74.0,567,93,117,210,872.0,70,5.96,42,208,2192,9.5,0.17044476
17174,17174,Mark Major,1997-98,27.0,2,0,2,2,0,0,0,0.0,,2,0,0,0,0.0,82,5.83,55,336,2444,9.8,0.13894683
17175,17175,Mark Mancari,2007-08,22.0,2,1,3,3,0,1,1,1.0,19.0,3,0,1,1,1.0,82,5.76,70,398,2426,9.7,0.18879038
17176,17176,Mark Mancari,2009-10,24.0,3,2,7,7,1,1,2,21.0,93.0,10,1,2,3,22.0,82,5.7,65,341,2477,9.4,0.24529347
17177,17177,Mark Mancari,2010-11,25.0,4,2,6,6,1,1,2,19.0,84.0,16,2,3,5,41.0,82,5.53,56,304,2486,9.1,0.19480398
17178,17178,Mark Mancari,2011-12,26.0,5,8,20,20,1,7,8,43.0,246.0,36,3,10,13,84.0,82,5.46,52,291,2492,9.0,0.21752235
17179,17179,Mark Mancari,2012-13,27.0,6,0,6,6,0,0,0,5.0,50.0,42,3,10,13,89.0,82,5.32,47,271,2439,8.9,0.1435726
17180,17180,Mark McNeill,2016-17,23.0,2,0,1,1,0,0,0,0.0,13.0,1,0,0,0,0.0,82,5.34,48,255,2438,9.0,0.15699339
17181,17181,Mark McNeill,2017-18,24.0,3,0,1,1,0,0,0,1.0,14.0,2,0,0,0,1.0,82,5.45,47,245,2478,9.0,0.17255437
17182,17182,Mark Messier,1980-81,20.0,2,33,75,75,12,21,33,113.0,,75,12,21,33,113.0,80,7.03,61,280,2352,12.0,0.54150707
17183,17183,Mark Messier,1981-82,21.0,3,63,72,72,23,40,63,179.0,,147,35,61,96,292.0,80,7.69,77,340,2441,12.6,0.9090054
17184,17184,Mark Messier,1982-83,22.0,4,88,78,78,50,38,88,235.0,,225,85,99,184,527.0,80,8.03,73,320,2489,12.9,1.1252816
17185,17185,Mark Messier,1983-84,23.0,5,106,77,77,48,58,106,237.0,,302,133,157,290,764.0,80,7.73,71,310,2444,12.7,1.2765048
17186,17186,Mark Messier,1984-85,24.0,6,101,73,73,37,64,101,220.0,,375,170,221,391,984.0,80,7.89,74,336,2448,12.9,1.2041669
17187,17187,Mark Messier,1985-86,25.0,7,54,55,55,23,31,54,138.0,,430,193,252,445,1122.0,80,7.77,71,321,2447,12.7,1.0027051
17188,17188,Mark Messier,1986-87,26.0,8,84,63,63,35,49,84,198.0,,493,228,301,529,1320.0,80,7.94,82,370,2484,12.8,1.265354
17189,17189,Mark Messier,1987-88,27.0,9,107,77,77,37,70,107,210.0,,570,265,371,636,1530.0,80,7.34,72,344,2400,12.2,1.2878767
17190,17190,Mark Messier,1988-89,28.0,10,111,77,77,37,74,111,182.0,,647,302,445,747,1712.0,80,7.43,89,437,2435,12.2,1.204129
17191,17191,Mark Messier,1989-90,29.0,11,94,72,72,33,61,94,164.0,,719,335,506,841,1876.0,80,7.48,85,403,2430,12.3,1.1866462
17192,17192,Mark Messier,1990-91,30.0,12,129,79,79,45,84,129,211.0,,798,380,590,970,2087.0,80,7.37,76,367,2421,12.2,1.2901344
17193,17193,Mark Messier,1991-92,31.0,13,64,53,53,12,52,64,109.0,,851,392,642,1034,2196.0,80,6.91,71,366,2385,11.6,1.0912246
17194,17194,Mark Messier,1992-93,32.0,14,107,79,79,35,72,107,212.0,,930,427,714,1141,2408.0,80,6.96,77,402,2440,11.4,1.190656
17195,17195,Mark Messier,1993-94,33.0,15,91,75,75,25,66,91,215.0,,1005,452,780,1232,2623.0,84,7.25,87,443,2603,11.7,1.0510697
17196,17196,Mark Messier,1994-95,34.0,16,84,76,76,26,58,84,216.0,,1081,478,838,1316,2839.0,84,6.48,76,407,2545,10.7,0.9933348
17197,17197,Mark Messier,1995-96,35.0,17,53,46,46,14,39,53,126.0,,1127,492,877,1369,2965.0,48,5.97,37,209,1408,10.2,1.1139355
17198,17198,Mark Messier,1996-97,36.0,18,99,74,74,47,52,99,241.0,,1201,539,929,1468,3206.0,82,6.29,74,413,2481,10.4,1.0765629
17199,17199,Mark Messier,1997-98,37.0,19,84,71,71,36,48,84,227.0,,1272,575,977,1552,3433.0,82,5.83,55,336,2444,9.8,0.90935296
17200,17200,Mark Messier,1998-99,38.0,20,60,82,82,22,38,60,139.0,,1354,597,1015,1612,3572.0,82,5.28,57,380,2242,9.6,0.6681266
17201,17201,Mark Messier,1999-00,39.0,21,48,59,59,13,35,48,97.0,1333.0,1413,610,1050,1660,3669.0,82,5.27,57,359,2285,9.4,0.6702999
17202,17202,Mark Messier,2000-01,40.0,22,54,66,66,17,37,54,131.0,1399.0,1479,627,1087,1714,3800.0,82,5.49,53,331,2294,9.8,0.7088051
17203,17203,Mark Messier,2001-02,41.0,23,67,82,82,24,43,67,131.0,1578.0,1561,651,1130,1781,3931.0,82,5.51,63,376,2272,9.9,0.6609672
17204,17204,Mark Messier,2002-03,42.0,24,23,41,41,7,16,23,69.0,759.0,1602,658,1146,1804,4000.0,82,5.24,53,338,2262,9.5,0.4764651
17205,17205,Mark Messier,2003-04,43.0,25,40,78,78,18,22,40,117.0,1453.0,1680,676,1168,1844,4117.0,82,5.31,60,363,2326,9.4,0.49150944
17206,17206,Mark Messier,2004-05,44.0,26,43,76,76,18,25,43,104.0,1253.0,1756,694,1193,1887,4221.0,82,5.14,57,348,2300,9.2,0.577325
17207,17207,Mark Morrison,1982-83,19.0,2,2,9,9,1,1,2,6.0,,9,1,1,2,6.0,80,8.03,73,320,2489,12.9,0.34500402
17208,17208,Mark Morrison,1984-85,21.0,3,0,1,1,0,0,0,5.0,,10,1,1,2,11.0,80,7.89,74,336,2448,12.9,0.27462822
17209,17209,Mark Mowers,1999-00,25.0,2,6,30,30,0,6,6,24.0,281.0,30,0,6,6,24.0,82,5.27,57,359,2285,9.4,0.19290155
17210,17210,Mark Mowers,2000-01,26.0,3,9,41,41,4,5,9,50.0,449.0,71,4,11,15,74.0,82,5.49,53,331,2294,9.8,0.20091915
17211,17211,Mark Mowers,2002-03,28.0,4,3,14,14,1,2,3,5.0,119.0,85,5,13,18,79.0,82,5.24,53,338,2262,9.5,0.19235799
17212,17212,Mark Mowers,2004-05,30.0,5,11,52,52,3,8,11,48.0,544.0,137,8,21,29,127.0,82,5.14,57,348,2300,9.2,0.19322392
17213,17213,Mark Mowers,2006-07,32.0,6,15,46,46,4,11,15,65.0,382.0,183,12,32,44,192.0,82,6.05,85,480,2458,10.1,0.23596388
17214,17214,Mark Mowers,2007-08,33.0,7,17,78,78,5,12,17,60.0,936.0,261,17,44,61,252.0,82,5.76,70,398,2426,9.7,0.18196723
17215,17215,Mark Mowers,2008-09,34.0,8,1,17,17,1,0,1,6.0,154.0,278,18,44,62,258.0,82,5.44,62,351,2383,9.4,0.15056643
17216,17216,Mark Olver,2011-12,24.0,2,9,18,18,2,7,9,25.0,214.0,18,2,7,9,25.0,82,5.46,52,291,2492,9.0,0.24255663
17217,17217,Mark Olver,2012-13,25.0,3,7,24,24,4,3,7,25.0,311.0,42,6,10,16,50.0,82,5.32,47,271,2439,8.9,0.22326833
17218,17218,Mark Olver,2013-14,26.0,4,6,32,32,4,2,6,33.0,289.0,74,10,12,22,83.0,48,5.31,29,160,1399,9.1,0.27639523
17219,17219,Mark Osborne,1982-83,21.0,2,67,80,80,26,41,67,181.0,,80,26,41,67,181.0,80,8.03,73,320,2489,12.9,0.7857735
17220,17220,Mark Osborne,1983-84,22.0,3,43,80,80,19,24,43,159.0,,160,45,65,110,340.0,80,7.73,71,310,2444,12.7,0.6132473
17221,17221,Mark Osborne,1984-85,23.0,4,51,73,73,23,28,51,139.0,,233,68,93,161,479.0,80,7.89,74,336,2448,12.9,0.6758861
17222,17222,Mark Osborne,1985-86,24.0,5,8,23,23,4,4,8,29.0,,256,72,97,169,508.0,80,7.77,71,321,2447,12.7,0.618548
17223,17223,Mark Osborne,1986-87,25.0,6,40,62,62,16,24,40,134.0,,318,88,121,209,642.0,80,7.94,82,370,2484,12.8,0.6499822
17224,17224,Mark Osborne,1987-88,26.0,7,47,74,74,22,25,47,160.0,,392,110,146,256,802.0,80,7.34,72,344,2400,12.2,0.64867646
17225,17225,Mark Osborne,1988-89,27.0,8,60,79,79,23,37,60,155.0,,471,133,183,316,957.0,80,7.43,89,437,2435,12.2,0.69650733
17226,17226,Mark Osborne,1989-90,28.0,9,46,75,75,16,30,46,118.0,,546,149,213,362,1075.0,80,7.48,85,403,2430,12.3,0.5796869
17227,17227,Mark Osborne,1990-91,29.0,10,73,78,78,23,50,73,137.0,,624,172,263,435,1212.0,80,7.37,76,367,2421,12.2,0.7450501
17228,17228,Mark Osborne,1991-92,30.0,11,22,55,55,11,11,22,87.0,,679,183,274,457,1299.0,80,6.91,71,366,2385,11.6,0.4358037
17229,17229,Mark Osborne,1992-93,31.0,12,20,54,54,7,13,20,66.0,,733,190,287,477,1365.0,80,6.96,77,402,2440,11.4,0.39734763
17230,17230,Mark Osborne,1993-94,32.0,13,26,76,76,12,14,26,110.0,,809,202,301,503,1475.0,84,7.25,87,443,2603,11.7,0.34442297
17231,17231,Mark Osborne,1994-95,33.0,14,24,73,73,9,15,24,103.0,,882,211,316,527,1578.0,84,6.48,76,407,2545,10.7,0.28527364
17232,17232,Mark Osborne,1995-96,34.0,15,4,37,37,1,3,4,32.0,,919,212,319,531,1610.0,48,5.97,37,209,1408,10.2,0.22257254
17233,17233,Mark Osiecki,1992-93,24.0,2,9,50,50,2,7,9,44.0,,50,2,7,9,44.0,80,6.96,77,402,2440,11.4,0.21860325
17234,17234,Mark Osiecki,1993-94,25.0,3,5,43,43,1,4,5,26.0,,93,3,11,14,70.0,84,7.25,87,443,2603,11.7,0.1340127
17235,17235,Mark Parrish,1999-00,22.0,2,37,73,73,24,13,37,129.0,1021.0,73,24,13,37,129.0,82,5.27,57,359,2285,9.4,0.60656554
17236,17236,Mark Parrish,2000-01,23.0,3,44,81,81,26,18,44,152.0,1139.0,154,50,31,81,281.0,82,5.49,53,331,2294,9.8,0.57104045
17237,17237,Mark Parrish,2001-02,24.0,4,30,70,70,17,13,30,123.0,1082.0,224,67,44,111,404.0,82,5.51,63,376,2272,9.9,0.5189929
17238,17238,Mark Parrish,2002-03,25.0,5,60,78,78,30,30,60,162.0,1311.0,302,97,74,171,566.0,82,5.24,53,338,2262,9.5,0.6858319
17239,17239,Mark Parrish,2003-04,26.0,6,48,81,81,23,25,48,147.0,1312.0,383,120,99,219,713.0,82,5.31,60,363,2326,9.4,0.61364454
17240,17240,Mark Parrish,2004-05,27.0,7,35,59,59,24,11,35,105.0,1023.0,442,144,110,254,818.0,82,5.14,57,348,2300,9.2,0.66888964
17241,17241,Mark Parrish,2006-07,29.0,8,49,76,76,29,20,49,137.0,1409.0,518,173,130,303,955.0,82,6.05,85,480,2458,10.1,0.59021676
17242,17242,Mark Parrish,2007-08,30.0,9,39,76,76,19,20,39,141.0,1089.0,594,192,150,342,1096.0,82,5.76,70,398,2426,9.7,0.45387888
17243,17243,Mark Parrish,2008-09,31.0,10,30,66,66,16,14,30,95.0,986.0,660,208,164,372,1191.0,82,5.44,62,351,2383,9.4,0.37648764
17244,17244,Mark Parrish,2009-10,32.0,11,13,44,44,8,5,13,46.0,496.0,704,216,169,385,1237.0,82,5.7,65,341,2477,9.4,0.26310134
17245,17245,Mark Parrish,2010-11,33.0,12,2,16,16,0,2,2,10.0,243.0,720,216,171,387,1247.0,82,5.53,56,304,2486,9.1,0.21573189
17246,17246,Mark Parrish,2011-12,34.0,13,0,2,2,0,0,0,0.0,24.0,722,216,171,387,1247.0,82,5.46,52,291,2492,9.0,0.22328755
17247,17247,Mark Paterson,1983-84,19.0,2,0,2,2,0,0,0,1.0,,2,0,0,0,1.0,80,7.73,71,310,2444,12.7,0.27397004
17248,17248,Mark Paterson,1984-85,20.0,3,2,9,9,2,0,2,10.0,,11,2,0,2,11.0,80,7.89,74,336,2448,12.9,0.34141088
17249,17249,Mark Paterson,1985-86,21.0,4,4,13,13,1,3,4,9.0,,24,3,3,6,20.0,80,7.77,71,321,2447,12.7,0.3220091
17250,17250,Mark Paterson,1986-87,22.0,5,0,5,5,0,0,0,0.0,,29,3,3,6,20.0,80,7.94,82,370,2484,12.8,0.19525462
17251,17251,Mark Pavelich,1982-83,24.0,2,76,79,79,33,43,76,181.0,,79,33,43,76,181.0,80,8.03,73,320,2489,12.9,0.7984632
17252,17252,Mark Pavelich,1983-84,25.0,3,75,78,78,37,38,75,154.0,,157,70,81,151,335.0,80,7.73,71,310,2444,12.7,0.87349534
17253,17253,Mark Pavelich,1984-85,26.0,4,82,77,77,29,53,82,163.0,,234,99,134,233,498.0,80,7.89,74,336,2448,12.9,0.9323008
17254,17254,Mark Pavelich,1985-86,27.0,5,45,48,48,14,31,45,87.0,,282,113,165,278,585.0,80,7.77,71,321,2447,12.7,0.79044783
17255,17255,Mark Pavelich,1986-87,28.0,6,40,59,59,20,20,40,104.0,,341,133,185,318,689.0,80,7.94,82,370,2484,12.8,0.67046213
17256,17256,Mark Pavelich,1987-88,29.0,7,10,12,12,4,6,10,25.0,,353,137,191,328,714.0,80,7.34,72,344,2400,12.2,0.5343982
17257,17257,Mark Pavelich,1992-93,34.0,8,1,2,2,0,1,1,0.0,,355,137,192,329,714.0,80,6.96,77,402,2440,11.4,0.667727
17258,17258,Mark Pederson,1990-91,23.0,2,2,9,9,0,2,2,10.0,,9,0,2,2,10.0,80,7.37,76,367,2421,12.2,0.2500918
17259,17259,Mark Pederson,1991-92,24.0,3,26,59,59,10,16,26,76.0,,68,10,18,28,86.0,80,6.91,71,366,2385,11.6,0.4116494
17260,17260,Mark Pederson,1992-93,25.0,4,40,58,58,15,25,40,94.0,,126,25,43,68,180.0,80,6.96,77,402,2440,11.4,0.52652264
17261,17261,Mark Pederson,1993-94,26.0,5,17,41,41,10,7,17,63.0,,167,35,50,85,243.0,84,7.25,87,443,2603,11.7,0.35604945
17262,17262,Mark Pederson,1994-95,27.0,6,0,2,2,0,0,0,0.0,,169,35,50,85,243.0,84,6.48,76,407,2545,10.7,0.26322293
17263,17263,Mark Plantery,1981-82,22.0,2,6,25,25,1,5,6,18.0,,25,1,5,6,18.0,80,7.69,77,340,2441,12.6,0.22870639
17264,17264,Mark Popovic,2004-05,22.0,2,0,1,1,0,0,0,1.0,14.0,1,0,0,0,1.0,82,5.14,57,348,2300,9.2,0.2913875
17265,17265,Mark Popovic,2006-07,24.0,3,0,7,7,0,0,0,6.0,77.0,8,0,0,0,7.0,82,6.05,85,480,2458,10.1,0.16514125
17266,17266,Mark Popovic,2007-08,25.0,4,1,3,3,0,1,1,1.0,31.0,11,0,1,1,8.0,82,5.76,70,398,2426,9.7,0.17893612
17267,17267,Mark Popovic,2008-09,26.0,5,2,33,33,0,2,2,25.0,478.0,44,0,3,3,33.0,82,5.44,62,351,2383,9.4,0.14574933
17268,17268,Mark Popovic,2010-11,28.0,6,4,37,37,2,2,4,24.0,547.0,81,2,5,7,57.0,82,5.53,56,304,2486,9.1,0.15003985
17269,17269,Mark Pysyk,2013-14,22.0,2,5,19,19,1,4,5,21.0,309.0,19,1,4,5,21.0,48,5.31,29,160,1399,9.1,0.23633346
17270,17270,Mark Pysyk,2014-15,23.0,3,7,44,44,1,6,7,51.0,863.0,63,2,10,12,72.0,82,5.34,48,269,2463,8.9,0.20711121
17271,17271,Mark Pysyk,2015-16,24.0,4,3,7,7,2,1,3,4.0,127.0,70,4,11,15,76.0,82,5.32,47,251,2453,8.9,0.2438859
17272,17272,Mark Pysyk,2016-17,25.0,5,11,55,55,1,10,11,44.0,875.0,125,5,21,26,120.0,82,5.34,48,255,2438,9.0,0.16368589
17273,17273,Mark Pysyk,2017-18,26.0,6,17,82,82,4,13,17,86.0,1522.0,207,9,34,43,206.0,82,5.45,47,245,2478,9.0,0.21314889
17274,17274,Mark Pysyk,2018-19,27.0,7,16,82,82,3,13,16,106.0,1538.0,289,12,47,59,312.0,82,5.86,50,250,2620,9.2,0.20431393
17275,17275,Mark Pysyk,2019-20,28.0,8,11,70,70,1,10,11,64.0,1279.0,359,13,57,70,376.0,82,5.96,47,239,2579,9.5,0.15655062
17276,17276,Mark Pysyk,2020-21,29.0,9,18,58,58,9,9,18,64.0,740.0,417,22,66,88,440.0,70,5.96,42,208,2192,9.5,0.26477748
17277,17277,Mark Recchi,1989-90,21.0,2,2,15,15,1,1,2,11.0,,15,1,1,2,11.0,80,7.48,85,403,2430,12.3,0.3189323
17278,17278,Mark Recchi,1990-91,22.0,3,67,74,74,30,37,67,143.0,,89,31,38,69,154.0,80,7.37,76,367,2421,12.2,0.9182835
17279,17279,Mark Recchi,1991-92,23.0,4,113,78,78,40,73,113,184.0,,167,71,111,182,338.0,80,6.91,71,366,2385,11.6,1.2426113
17280,17280,Mark Recchi,1992-93,24.0,5,97,80,80,43,54,97,210.0,,247,114,165,279,548.0,80,6.96,77,402,2440,11.4,1.1739564
17281,17281,Mark Recchi,1993-94,25.0,6,123,84,84,53,70,123,274.0,,331,167,235,402,822.0,84,7.25,87,443,2603,11.7,1.2856505
17282,17282,Mark Recchi,1994-95,26.0,7,107,84,84,40,67,107,217.0,,415,207,302,509,1039.0,84,6.48,76,407,2545,10.7,1.053487
17283,17283,Mark Recchi,1995-96,27.0,8,48,49,49,16,32,48,121.0,,464,223,334,557,1160.0,48,5.97,37,209,1408,10.2,1.0073925
17284,17284,Mark Recchi,1996-97,28.0,9,78,82,82,28,50,78,191.0,,546,251,384,635,1351.0,82,6.29,74,413,2481,10.4,0.850505
17285,17285,Mark Recchi,1997-98,29.0,10,80,82,82,34,46,80,202.0,,628,285,430,715,1553.0,82,5.83,55,336,2444,9.8,0.9052657
17286,17286,Mark Recchi,1998-99,30.0,11,74,82,82,32,42,74,216.0,,710,317,472,789,1769.0,82,5.28,57,380,2242,9.6,0.87249106
17287,17287,Mark Recchi,1999-00,31.0,12,53,71,71,16,37,53,171.0,1453.0,781,333,509,842,1940.0,82,5.27,57,359,2285,9.4,0.81981516
17288,17288,Mark Recchi,2000-01,32.0,13,91,82,82,28,63,91,223.0,1781.0,863,361,572,933,2163.0,82,5.49,53,331,2294,9.8,1.0638027
17289,17289,Mark Recchi,2001-02,33.0,14,77,69,69,27,50,77,191.0,1495.0,932,388,622,1010,2354.0,82,5.51,63,376,2272,9.9,0.8773786
17290,17290,Mark Recchi,2002-03,34.0,15,64,80,80,22,42,64,205.0,1653.0,1012,410,664,1074,2559.0,82,5.24,53,338,2262,9.5,0.7296408
17291,17291,Mark Recchi,2003-04,35.0,16,52,79,79,20,32,52,171.0,1488.0,1091,430,696,1126,2730.0,82,5.31,60,363,2326,9.4,0.6336452
17292,17292,Mark Recchi,2004-05,36.0,17,75,82,82,26,49,75,167.0,1410.0,1173,456,745,1201,2897.0,82,5.14,57,348,2300,9.2,0.83574015
17293,17293,Mark Recchi,2006-07,38.0,18,64,83,83,28,36,64,199.0,1693.0,1256,484,781,1265,3096.0,82,6.05,85,480,2458,10.1,0.7326682
17294,17294,Mark Recchi,2007-08,39.0,19,68,82,82,24,44,68,190.0,1616.0,1338,508,825,1333,3286.0,82,5.76,70,398,2426,9.7,0.6798903
17295,17295,Mark Recchi,2008-09,40.0,20,48,72,72,14,34,48,121.0,1287.0,1410,522,859,1381,3407.0,82,5.44,62,351,2383,9.4,0.5845226
17296,17296,Mark Recchi,2009-10,41.0,21,61,80,80,23,38,61,129.0,1342.0,1490,545,897,1442,3536.0,82,5.7,65,341,2477,9.4,0.5875506
17297,17297,Mark Recchi,2010-11,42.0,22,43,81,81,18,25,43,152.0,1381.0,1571,563,922,1485,3688.0,82,5.53,56,304,2486,9.1,0.5038782
17298,17298,Mark Recchi,2011-12,43.0,23,48,81,81,14,34,48,132.0,1304.0,1652,577,956,1533,3820.0,82,5.46,52,291,2492,9.0,0.550254
17299,17299,Mark Reeds,1982-83,23.0,2,4,9,9,1,3,4,8.0,,9,1,3,4,8.0,80,8.03,73,320,2489,12.9,0.2977264
17300,17300,Mark Reeds,1983-84,24.0,3,19,20,20,5,14,19,35.0,,29,6,17,23,43.0,80,7.73,71,310,2444,12.7,0.57673055
17301,17301,Mark Reeds,1984-85,25.0,4,25,65,65,11,14,25,72.0,,94,17,31,48,115.0,80,7.89,74,336,2448,12.9,0.36896455
17302,17302,Mark Reeds,1985-86,26.0,5,39,80,80,9,30,39,100.0,,174,26,61,87,215.0,80,7.77,71,321,2447,12.7,0.44521713
17303,17303,Mark Reeds,1986-87,27.0,6,38,78,78,10,28,38,108.0,,252,36,89,125,323.0,80,7.94,82,370,2484,12.8,0.45751268
17304,17304,Mark Reeds,1987-88,28.0,7,25,68,68,9,16,25,106.0,,320,45,105,150,429.0,80,7.34,72,344,2400,12.2,0.3851872
17305,17305,Mark Reeds,1988-89,29.0,8,7,38,38,0,7,7,36.0,,358,45,112,157,465.0,80,7.43,89,437,2435,12.2,0.23256212
17306,17306,Mark Reeds,1989-90,30.0,9,2,7,7,0,2,2,6.0,,365,45,114,159,471.0,80,7.48,85,403,2430,12.3,0.24856234
17307,17307,Mark Renaud,1980-81,21.0,2,2,13,13,0,2,2,9.0,,13,0,2,2,9.0,80,7.03,61,280,2352,12.0,0.28155732
17308,17308,Mark Renaud,1981-82,22.0,3,1,4,4,1,0,1,1.0,,17,1,2,3,10.0,80,7.69,77,340,2441,12.6,0.2571567
17309,17309,Mark Renaud,1982-83,23.0,4,18,48,48,1,17,18,72.0,,65,2,19,21,82.0,80,8.03,73,320,2489,12.9,0.36937606
17310,17310,Mark Renaud,1983-84,24.0,5,31,77,77,3,28,31,86.0,,142,5,47,52,168.0,80,7.73,71,310,2444,12.7,0.37146747
17311,17311,Mark Renaud,1984-85,25.0,6,4,10,10,1,3,4,10.0,,152,6,50,56,178.0,80,7.89,74,336,2448,12.9,0.27173835
17312,17312,Mark Rycroft,2002-03,24.0,2,3,9,9,0,3,3,14.0,88.0,9,0,3,3,14.0,82,5.24,53,338,2262,9.5,0.20554435
17313,17313,Mark Rycroft,2004-05,26.0,3,21,71,71,9,12,21,110.0,1021.0,80,9,15,24,124.0,82,5.14,57,348,2300,9.2,0.3314367
17314,17314,Mark Rycroft,2006-07,28.0,4,10,80,80,6,4,10,77.0,836.0,160,15,19,34,201.0,82,6.05,85,480,2458,10.1,0.19125709
17315,17315,Mark Rycroft,2007-08,29.0,5,12,66,66,6,6,12,74.0,622.0,226,21,25,46,275.0,82,5.76,70,398,2426,9.7,0.2126539
17316,17316,Mark Scheifele,2012-13,19.0,2,1,7,7,1,0,1,5.0,77.0,7,1,0,1,5.0,82,5.32,47,271,2439,8.9,0.25474277
17317,17317,Mark Scheifele,2013-14,20.0,3,0,4,4,0,0,0,6.0,46.0,11,1,0,1,11.0,48,5.31,29,160,1399,9.1,0.2354804
17318,17318,Mark Scheifele,2014-15,21.0,4,34,63,63,13,21,34,100.0,1031.0,74,14,21,35,111.0,82,5.34,48,269,2463,8.9,0.52930623
17319,17319,Mark Scheifele,2015-16,22.0,5,49,82,82,15,34,49,170.0,1524.0,156,29,55,84,281.0,82,5.32,47,251,2453,8.9,0.61259365
17320,17320,Mark Scheifele,2016-17,23.0,6,61,71,71,29,32,61,194.0,1317.0,227,58,87,145,475.0,82,5.34,48,255,2438,9.0,0.79668176
17321,17321,Mark Scheifele,2017-18,24.0,7,82,79,79,32,50,82,160.0,1624.0,306,90,137,227,635.0,82,5.45,47,245,2478,9.0,0.93098706
17322,17322,Mark Scheifele,2018-19,25.0,8,60,60,60,23,37,60,125.0,1241.0,366,113,174,287,760.0,82,5.86,50,250,2620,9.2,0.8301372
17323,17323,Mark Scheifele,2019-20,26.0,9,84,82,82,38,46,84,199.0,1793.0,448,151,220,371,959.0,82,5.96,47,239,2579,9.5,0.95860046
17324,17324,Mark Scheifele,2020-21,27.0,10,73,71,71,29,44,73,170.0,1548.0,519,180,264,444,1129.0,70,5.96,42,208,2192,9.5,0.8998187
17325,17325,Mark Smith,2001-02,24.0,2,4,42,42,2,2,4,39.0,370.0,42,2,2,4,39.0,82,5.51,63,376,2272,9.9,0.15487283
17326,17326,Mark Smith,2002-03,25.0,3,6,49,49,3,3,6,40.0,395.0,91,5,5,10,79.0,82,5.24,53,338,2262,9.5,0.16300774
17327,17327,Mark Smith,2003-04,26.0,4,15,75,75,4,11,15,68.0,701.0,166,9,16,25,147.0,82,5.31,60,363,2326,9.4,0.18030256
17328,17328,Mark Smith,2004-05,27.0,5,4,36,36,1,3,4,31.0,301.0,202,10,19,29,178.0,82,5.14,57,348,2300,9.2,0.16200367
17329,17329,Mark Smith,2006-07,29.0,6,24,80,80,9,15,24,100.0,964.0,282,19,34,53,278.0,82,6.05,85,480,2458,10.1,0.2587453
17330,17330,Mark Smith,2007-08,30.0,7,13,41,41,3,10,13,38.0,427.0,323,22,44,66,316.0,82,5.76,70,398,2426,9.7,0.20505553
17331,17331,Mark Smith,2008-09,31.0,8,4,54,54,1,3,4,27.0,320.0,377,23,47,70,343.0,82,5.44,62,351,2383,9.4,0.11769301
17332,17332,Mark Stone,2013-14,21.0,2,0,4,4,0,0,0,3.0,40.0,4,0,0,0,3.0,48,5.31,29,160,1399,9.1,0.21354589
17333,17333,Mark Stone,2014-15,22.0,3,8,19,19,4,4,8,36.0,275.0,23,4,4,8,39.0,82,5.34,48,269,2463,8.9,0.3079009
17334,17334,Mark Stone,2015-16,23.0,4,64,80,80,26,38,64,157.0,1362.0,103,30,42,72,196.0,82,5.32,47,251,2453,8.9,0.7227596
17335,17335,Mark Stone,2016-17,24.0,5,61,75,75,23,38,61,151.0,1508.0,178,53,80,133,347.0,82,5.34,48,255,2438,9.0,0.7232733
17336,17336,Mark Stone,2017-18,25.0,6,54,71,71,22,32,54,134.0,1318.0,249,75,112,187,481.0,82,5.45,47,245,2478,9.0,0.732762
17337,17337,Mark Stone,2018-19,26.0,7,62,58,58,20,42,62,132.0,1199.0,307,95,154,249,613.0,82,5.86,50,250,2620,9.2,0.89603794
17338,17338,Mark Stone,2019-20,27.0,8,73,77,77,33,40,73,199.0,1531.0,384,128,194,322,812.0,82,5.96,47,239,2579,9.5,0.80503035
17339,17339,Mark Stone,2020-21,28.0,9,63,65,65,21,42,63,168.0,1262.0,449,149,236,385,980.0,70,5.96,42,208,2192,9.5,0.8806639
17340,17340,Mark Streit,2006-07,29.0,2,11,48,48,2,9,11,52.0,700.0,48,2,9,11,52.0,82,6.05,85,480,2458,10.1,0.20220068
17341,17341,Mark Streit,2007-08,30.0,3,36,76,76,10,26,36,102.0,1065.0,124,12,35,47,154.0,82,5.76,70,398,2426,9.7,0.39336604
17342,17342,Mark Streit,2008-09,31.0,4,62,81,81,13,49,62,165.0,1419.0,205,25,84,109,319.0,82,5.44,62,351,2383,9.4,0.6877167
17343,17343,Mark Streit,2009-10,32.0,5,56,74,74,16,40,56,150.0,1866.0,279,41,124,165,469.0,82,5.7,65,341,2477,9.4,0.63174105
17344,17344,Mark Streit,2010-11,33.0,6,49,82,82,11,38,49,187.0,2107.0,361,52,162,214,656.0,82,5.53,56,304,2486,9.1,0.56091696
17345,17345,Mark Streit,2012-13,35.0,7,47,82,82,7,40,47,149.0,1917.0,443,59,202,261,805.0,82,5.32,47,271,2439,8.9,0.5222596
17346,17346,Mark Streit,2013-14,36.0,8,27,48,48,6,21,27,83.0,1121.0,491,65,223,288,888.0,48,5.31,29,160,1399,9.1,0.5082994
17347,17347,Mark Streit,2014-15,37.0,9,44,82,82,10,34,44,121.0,1693.0,573,75,257,332,1009.0,82,5.34,48,269,2463,8.9,0.4862742
17348,17348,Mark Streit,2015-16,38.0,10,52,81,81,9,43,52,144.0,1812.0,654,84,300,384,1153.0,82,5.32,47,251,2453,8.9,0.54612917
17349,17349,Mark Streit,2016-17,39.0,11,23,62,62,6,17,23,110.0,1356.0,716,90,317,407,1263.0,82,5.34,48,255,2438,9.0,0.34510434
17350,17350,Mark Streit,2017-18,40.0,12,27,68,68,6,21,27,114.0,1275.0,784,96,338,434,1377.0,82,5.45,47,245,2478,9.0,0.3407114
17351,17351,Mark Streit,2018-19,41.0,13,0,2,2,0,0,0,3.0,28.0,786,96,338,434,1380.0,82,5.86,50,250,2620,9.2,0.27993757
17352,17352,Mark Stuart,2006-07,22.0,2,2,17,17,1,1,2,9.0,302.0,17,1,1,2,9.0,82,6.05,85,480,2458,10.1,0.20252997
17353,17353,Mark Stuart,2007-08,23.0,3,1,15,15,0,1,1,4.0,156.0,32,1,2,3,13.0,82,5.76,70,398,2426,9.7,0.16887262
17354,17354,Mark Stuart,2008-09,24.0,4,8,82,82,4,4,8,60.0,1261.0,114,5,6,11,73.0,82,5.44,62,351,2383,9.4,0.18003896
17355,17355,Mark Stuart,2009-10,25.0,5,17,82,82,5,12,17,61.0,1264.0,196,10,18,28,134.0,82,5.7,65,341,2477,9.4,0.19630787
17356,17356,Mark Stuart,2010-11,26.0,6,7,56,56,2,5,7,53.0,953.0,252,12,23,35,187.0,82,5.53,56,304,2486,9.1,0.16294196
17357,17357,Mark Stuart,2011-12,27.0,7,6,54,54,2,4,6,41.0,845.0,306,14,27,41,228.0,82,5.46,52,291,2492,9.0,0.12522206
17358,17358,Mark Stuart,2012-13,28.0,8,14,80,80,3,11,14,60.0,1376.0,386,17,38,55,288.0,82,5.32,47,271,2439,8.9,0.1504578
17359,17359,Mark Stuart,2013-14,29.0,9,4,42,42,2,2,4,40.0,702.0,428,19,40,59,328.0,48,5.31,29,160,1399,9.1,0.15531847
17360,17360,Mark Stuart,2014-15,30.0,10,13,69,69,2,11,13,73.0,1286.0,497,21,51,72,401.0,82,5.34,48,269,2463,8.9,0.16444796
17361,17361,Mark Stuart,2015-16,31.0,11,14,70,70,2,12,14,51.0,1345.0,567,23,63,86,452.0,82,5.32,47,251,2453,8.9,0.1324696
17362,17362,Mark Stuart,2016-17,32.0,12,3,64,64,1,2,3,39.0,1046.0,631,24,65,89,491.0,82,5.34,48,255,2438,9.0,0.1220057
17363,17363,Mark Stuart,2017-18,33.0,13,4,42,42,2,2,4,24.0,523.0,673,26,67,93,515.0,82,5.45,47,245,2478,9.0,0.11316961
17364,17364,Mark Taylor,1982-83,25.0,2,0,2,2,0,0,0,1.0,,2,0,0,0,1.0,80,8.03,73,320,2489,12.9,0.21705627
17365,17365,Mark Taylor,1983-84,26.0,3,33,61,61,8,25,33,72.0,,63,8,25,33,73.0,80,7.73,71,310,2444,12.7,0.492871
17366,17366,Mark Taylor,1984-85,27.0,4,55,60,60,24,31,55,107.0,,123,32,56,88,180.0,80,7.89,74,336,2448,12.9,0.6417344
17367,17367,Mark Taylor,1985-86,28.0,5,19,56,56,8,11,19,55.0,,179,40,67,107,235.0,80,7.77,71,321,2447,12.7,0.39817038
17368,17368,Mark Taylor,1986-87,29.0,6,3,30,30,2,1,3,23.0,,209,42,68,110,258.0,80,7.94,82,370,2484,12.8,0.27570558
17369,17369,Mark Tinordi,1988-89,22.0,2,3,24,24,1,2,3,13.0,,24,1,2,3,13.0,80,7.43,89,437,2435,12.2,0.195797
17370,17370,Mark Tinordi,1989-90,23.0,3,5,47,47,2,3,5,39.0,,71,3,5,8,52.0,80,7.48,85,403,2430,12.3,0.19680867
17371,17371,Mark Tinordi,1990-91,24.0,4,10,66,66,3,7,10,50.0,,137,6,12,18,102.0,80,7.37,76,367,2421,12.2,0.20132035
17372,17372,Mark Tinordi,1991-92,25.0,5,32,69,69,5,27,32,92.0,,206,11,39,50,194.0,80,6.91,71,366,2385,11.6,0.40334183
17373,17373,Mark Tinordi,1992-93,26.0,6,28,63,63,4,24,28,93.0,,269,15,63,78,287.0,80,6.96,77,402,2440,11.4,0.37040007
17374,17374,Mark Tinordi,1993-94,27.0,7,42,69,69,15,27,42,122.0,,338,30,90,120,409.0,84,7.25,87,443,2603,11.7,0.487976
17375,17375,Mark Tinordi,1994-95,28.0,8,24,61,61,6,18,24,112.0,,399,36,108,144,521.0,84,6.48,76,407,2545,10.7,0.36521465
17376,17376,Mark Tinordi,1995-96,29.0,9,12,42,42,3,9,12,71.0,,441,39,117,156,592.0,48,5.97,37,209,1408,10.2,0.28886712
17377,17377,Mark Tinordi,1996-97,30.0,10,13,71,71,3,10,13,82.0,,512,42,127,169,674.0,82,6.29,74,413,2481,10.4,0.2102842
17378,17378,Mark Tinordi,1997-98,31.0,11,8,56,56,2,6,8,53.0,,568,44,133,177,727.0,82,5.83,55,336,2444,9.8,0.15929717
17379,17379,Mark Tinordi,1998-99,32.0,12,17,47,47,8,9,17,57.0,,615,52,142,194,784.0,82,5.28,57,380,2242,9.6,0.28304
17380,17380,Mark Tinordi,1999-00,33.0,13,6,48,48,0,6,6,32.0,980.0,663,52,148,200,816.0,82,5.27,57,359,2285,9.4,0.1475788
17381,17381,Mark Van Guilder,2014-15,31.0,2,0,1,1,0,0,0,0.0,8.0,1,0,0,0,0.0,82,5.34,48,269,2463,8.9,0.12137434
17382,17382,Mark Vermette,1989-90,22.0,2,4,12,12,0,4,4,10.0,,12,0,4,4,10.0,80,7.48,85,403,2430,12.3,0.25446424
17383,17383,Mark Vermette,1990-91,23.0,3,6,11,11,1,5,6,16.0,,23,1,9,10,26.0,80,7.37,76,367,2421,12.2,0.25225368
17384,17384,Mark Vermette,1991-92,24.0,4,7,34,34,3,4,7,42.0,,57,4,13,17,68.0,80,6.91,71,366,2385,11.6,0.24580613
17385,17385,Mark Vermette,1992-93,25.0,5,1,10,10,1,0,1,12.0,,67,5,13,18,80.0,80,6.96,77,402,2440,11.4,0.2312251
17386,17386,Mark Visheau,1994-95,21.0,2,0,1,1,0,0,0,1.0,,1,0,0,0,1.0,84,6.48,76,407,2545,10.7,0.20140201
17387,17387,Mark Visheau,1999-00,26.0,3,4,28,28,1,3,4,10.0,267.0,29,1,3,4,11.0,82,5.27,57,359,2285,9.4,0.13573515
17388,17388,Mark Wotton,1995-96,22.0,2,0,1,1,0,0,0,2.0,,1,0,0,0,2.0,48,5.97,37,209,1408,10.2,0.1978578
17389,17389,Mark Wotton,1997-98,24.0,3,9,36,36,3,6,9,41.0,,37,3,6,9,43.0,82,5.83,55,336,2444,9.8,0.21762541
17390,17390,Mark Wotton,1998-99,25.0,4,0,5,5,0,0,0,3.0,,42,3,6,9,46.0,82,5.28,57,380,2242,9.6,0.1558468
17391,17391,Mark Wotton,2001-02,28.0,5,0,1,1,0,0,0,0.0,14.0,43,3,6,9,46.0,82,5.51,63,376,2272,9.9,0.13552475
17392,17392,Markku Kyllonen,1989-90,27.0,2,2,9,9,0,2,2,7.0,,9,0,2,2,7.0,80,7.48,85,403,2430,12.3,0.23898825
17393,17393,Marko Daňo,2015-16,21.0,2,21,35,35,8,13,21,84.0,464.0,35,8,13,21,84.0,82,5.32,47,251,2453,8.9,0.49083626
17394,17394,Marko Daňo,2016-17,22.0,3,10,34,34,5,5,10,54.0,417.0,69,13,18,31,138.0,82,5.34,48,255,2438,9.0,0.33493823
17395,17395,Marko Daňo,2017-18,23.0,4,11,38,38,4,7,11,44.0,406.0,107,17,25,42,182.0,82,5.45,47,245,2478,9.0,0.2851076
17396,17396,Marko Daňo,2018-19,24.0,5,3,23,23,2,1,3,22.0,165.0,130,19,26,45,204.0,82,5.86,50,250,2620,9.2,0.2393868
17397,17397,Marko Daňo,2019-20,25.0,6,0,8,8,0,0,0,3.0,55.0,138,19,26,45,207.0,82,5.96,47,239,2579,9.5,0.18193737
17398,17398,Marko Daňo,2020-21,26.0,7,0,3,3,0,0,0,2.0,22.0,141,19,26,45,209.0,70,5.96,42,208,2192,9.5,0.1855754
17399,17399,Marko Jantunen,1997-98,26.0,2,0,3,3,0,0,0,7.0,,3,0,0,0,7.0,82,5.83,55,336,2444,9.8,0.16366741
17400,17400,Marko Kiprusoff,1996-97,24.0,2,4,24,24,0,4,4,36.0,,24,0,4,4,36.0,82,6.29,74,413,2481,10.4,0.18724468
17401,17401,Marko Kiprusoff,2002-03,30.0,3,6,27,27,0,6,6,17.0,378.0,51,0,10,10,53.0,82,5.24,53,338,2262,9.5,0.13782886
17402,17402,Marko Tuomainen,1995-96,23.0,2,0,4,4,0,0,0,5.0,,4,0,0,0,5.0,48,5.97,37,209,1408,10.2,0.19440743
17403,17403,Marko Tuomainen,2000-01,28.0,3,17,63,63,9,8,17,74.0,725.0,67,9,8,17,79.0,82,5.49,53,331,2294,9.8,0.24934414
17404,17404,Marko Tuomainen,2001-02,29.0,4,1,11,11,0,1,1,12.0,103.0,78,9,9,18,91.0,82,5.51,63,376,2272,9.9,0.17298093
17405,17405,Marko Tuomainen,2002-03,30.0,5,0,1,1,0,0,0,0.0,7.0,79,9,9,18,91.0,82,5.24,53,338,2262,9.5,0.153002
17406,17406,Markus Granlund,2014-15,21.0,2,3,7,7,2,1,3,9.0,85.0,7,2,1,3,9.0,82,5.34,48,269,2463,8.9,0.28928405
17407,17407,Markus Granlund,2015-16,22.0,3,18,48,48,8,10,18,65.0,642.0,55,10,11,21,74.0,82,5.32,47,251,2453,8.9,0.36789227
17408,17408,Markus Granlund,2016-17,23.0,4,10,47,47,6,4,10,56.0,648.0,102,16,15,31,130.0,82,5.34,48,255,2438,9.0,0.28857285
17409,17409,Markus Granlund,2017-18,24.0,5,32,69,69,19,13,32,122.0,1194.0,171,35,28,63,252.0,82,5.45,47,245,2478,9.0,0.42434365
17410,17410,Markus Granlund,2018-19,25.0,6,12,53,53,8,4,12,93.0,862.0,224,43,32,75,345.0,82,5.86,50,250,2620,9.2,0.31305003
17411,17411,Markus Granlund,2019-20,26.0,7,22,77,77,12,10,22,123.0,1158.0,301,55,42,97,468.0,82,5.96,47,239,2579,9.5,0.28702027
17412,17412,Markus Granlund,2020-21,27.0,8,4,34,34,3,1,4,26.0,368.0,335,58,43,101,494.0,70,5.96,42,208,2192,9.5,0.21381435
17413,17413,Markus Hannikainen,2016-17,23.0,2,0,4,4,0,0,0,3.0,29.0,4,0,0,0,3.0,82,5.34,48,255,2438,9.0,0.17507556
17414,17414,Markus Hannikainen,2017-18,24.0,3,2,10,10,1,1,2,8.0,91.0,14,1,1,2,11.0,82,5.45,47,245,2478,9.0,0.1898537
17415,17415,Markus Hannikainen,2018-19,25.0,4,6,33,33,3,3,6,31.0,276.0,47,4,4,8,42.0,82,5.86,50,250,2620,9.2,0.20423803
17416,17416,Markus Hannikainen,2019-20,26.0,5,7,44,44,4,3,7,52.0,417.0,91,8,7,15,94.0,82,5.96,47,239,2579,9.5,0.18871632
17417,17417,Markus Naslund,1994-95,21.0,2,11,71,71,4,7,11,80.0,,71,4,7,11,80.0,84,6.48,76,407,2545,10.7,0.26374456
17418,17418,Markus Naslund,1995-96,22.0,3,4,14,14,2,2,4,13.0,,85,6,9,15,93.0,48,5.97,37,209,1408,10.2,0.32048273
17419,17419,Markus Naslund,1996-97,23.0,4,55,76,76,22,33,55,144.0,,161,28,42,70,237.0,82,6.29,74,413,2481,10.4,0.61067647
17420,17420,Markus Naslund,1997-98,24.0,5,41,78,78,21,20,41,120.0,,239,49,62,111,357.0,82,5.83,55,336,2444,9.8,0.5121324
17421,17421,Markus Naslund,1998-99,25.0,6,34,76,76,14,20,34,106.0,,315,63,82,145,463.0,82,5.28,57,380,2242,9.6,0.4783556
17422,17422,Markus Naslund,1999-00,26.0,7,66,80,80,36,30,66,205.0,1596.0,395,99,112,211,668.0,82,5.27,57,359,2285,9.4,0.7987124
17423,17423,Markus Naslund,2000-01,27.0,8,65,82,82,27,38,65,271.0,1657.0,477,126,150,276,939.0,82,5.49,53,331,2294,9.8,0.8034235
17424,17424,Markus Naslund,2001-02,28.0,9,75,72,72,41,34,75,277.0,1371.0,549,167,184,351,1216.0,82,5.51,63,376,2272,9.9,0.91141933
17425,17425,Markus Naslund,2002-03,29.0,10,90,81,81,40,50,90,302.0,1580.0,630,207,234,441,1518.0,82,5.24,53,338,2262,9.5,1.0215853
17426,17426,Markus Naslund,2003-04,30.0,11,104,82,82,48,56,104,294.0,1632.0,712,255,290,545,1812.0,82,5.31,60,363,2326,9.4,1.0822027
17427,17427,Markus Naslund,2004-05,31.0,12,84,78,78,35,49,84,296.0,1512.0,790,290,339,629,2108.0,82,5.14,57,348,2300,9.2,1.0785255
17428,17428,Markus Naslund,2006-07,33.0,13,79,81,81,32,47,79,264.0,1496.0,871,322,386,708,2372.0,82,6.05,85,480,2458,10.1,0.8683222
17429,17429,Markus Naslund,2007-08,34.0,14,60,82,82,24,36,60,222.0,1455.0,953,346,422,768,2594.0,82,5.76,70,398,2426,9.7,0.6552468
17430,17430,Markus Naslund,2008-09,35.0,15,55,82,82,25,30,55,237.0,1425.0,1035,371,452,823,2831.0,82,5.44,62,351,2383,9.4,0.63465047
17431,17431,Markus Naslund,2009-10,36.0,16,46,82,82,24,22,46,215.0,1409.0,1117,395,474,869,3046.0,82,5.7,65,341,2477,9.4,0.54392225
17432,17432,Markus Nutivaara,2017-18,23.0,2,7,66,66,2,5,7,66.0,872.0,66,2,5,7,66.0,82,5.45,47,245,2478,9.0,0.20248845
17433,17433,Markus Nutivaara,2018-19,24.0,3,23,61,61,7,16,23,79.0,978.0,127,9,21,30,145.0,82,5.86,50,250,2620,9.2,0.3269636
17434,17434,Markus Nutivaara,2019-20,25.0,4,21,80,80,5,16,21,99.0,1414.0,207,14,37,51,244.0,82,5.96,47,239,2579,9.5,0.26457876
17435,17435,Markus Nutivaara,2020-21,26.0,5,9,37,37,3,6,9,47.0,589.0,244,17,43,60,291.0,70,5.96,42,208,2192,9.5,0.26130205
17436,17436,Marquis Mathieu,1999-00,26.0,2,0,9,9,0,0,0,4.0,66.0,9,0,0,0,4.0,82,5.27,57,359,2285,9.4,0.16484177
17437,17437,Marquis Mathieu,2000-01,27.0,3,2,6,6,0,2,2,3.0,36.0,15,0,2,2,7.0,82,5.49,53,331,2294,9.8,0.15399423
17438,17438,Marquis Mathieu,2001-02,28.0,4,0,1,1,0,0,0,0.0,7.0,16,0,2,2,7.0,82,5.51,63,376,2272,9.9,0.14201969
17439,17439,Martin Cibak,2002-03,22.0,2,6,26,26,1,5,6,22.0,290.0,26,1,5,6,22.0,82,5.24,53,338,2262,9.5,0.21397713
17440,17440,Martin Cibak,2004-05,24.0,3,9,63,63,2,7,9,44.0,478.0,89,3,12,15,66.0,82,5.14,57,348,2300,9.2,0.18844202
17441,17441,Martin Cibak,2006-07,26.0,4,8,65,65,2,6,8,50.0,429.0,154,5,18,23,116.0,82,6.05,85,480,2458,10.1,0.15197921
17442,17442,Martin Desjardins,1990-91,24.0,2,2,8,8,0,2,2,7.0,,8,0,2,2,7.0,80,7.37,76,367,2421,12.2,0.23505256
17443,17443,Martin Erat,2002-03,21.0,2,33,80,80,9,24,33,84.0,1053.0,80,9,24,33,84.0,82,5.24,53,338,2262,9.5,0.45176238
17444,17444,Martin Erat,2003-04,22.0,3,8,27,27,1,7,8,39.0,345.0,107,10,31,41,123.0,82,5.31,60,363,2326,9.4,0.3686791
17445,17445,Martin Erat,2004-05,23.0,4,49,76,76,16,33,49,137.0,1140.0,183,26,64,90,260.0,82,5.14,57,348,2300,9.2,0.73257905
17446,17446,Martin Erat,2006-07,25.0,5,49,80,80,20,29,49,143.0,1180.0,263,46,93,139,403.0,82,6.05,85,480,2458,10.1,0.58540565
17447,17447,Martin Erat,2007-08,26.0,6,57,68,68,16,41,57,132.0,1290.0,331,62,134,196,535.0,82,5.76,70,398,2426,9.7,0.7493701
17448,17448,Martin Erat,2008-09,27.0,7,57,76,76,23,34,57,163.0,1418.0,407,85,168,253,698.0,82,5.44,62,351,2383,9.4,0.6522117
17449,17449,Martin Erat,2009-10,28.0,8,50,71,71,17,33,50,149.0,1318.0,478,102,201,303,847.0,82,5.7,65,341,2477,9.4,0.62485206
17450,17450,Martin Erat,2010-11,29.0,9,49,74,74,21,28,49,168.0,1331.0,552,123,229,352,1015.0,82,5.53,56,304,2486,9.1,0.618314
17451,17451,Martin Erat,2011-12,30.0,10,50,64,64,17,33,50,135.0,1158.0,616,140,262,402,1150.0,82,5.46,52,291,2492,9.0,0.65276265
17452,17452,Martin Erat,2012-13,31.0,11,58,71,71,19,39,58,107.0,1312.0,687,159,301,460,1257.0,82,5.32,47,271,2439,8.9,0.6843963
17453,17453,Martin Erat,2013-14,32.0,12,24,45,45,5,19,24,69.0,806.0,732,164,320,484,1326.0,48,5.31,29,160,1399,9.1,0.44408634
17454,17454,Martin Erat,2014-15,33.0,13,29,70,70,3,26,29,53.0,1027.0,802,167,346,513,1379.0,82,5.34,48,269,2463,8.9,0.3751358
17455,17455,Martin Erat,2015-16,34.0,14,32,79,79,9,23,32,91.0,1253.0,881,176,369,545,1470.0,82,5.32,47,251,2453,8.9,0.35702616
17456,17456,Martin Fehervary,2020-21,21.0,2,1,6,6,0,1,1,7.0,96.0,6,0,1,1,7.0,70,5.96,42,208,2192,9.5,0.25137454
17457,17457,Martin Frk,2017-18,24.0,2,0,2,2,0,0,0,1.0,17.0,2,0,0,0,1.0,82,5.45,47,245,2478,9.0,0.17658868
17458,17458,Martin Frk,2018-19,25.0,3,25,68,68,11,14,25,99.0,700.0,70,11,14,25,100.0,82,5.86,50,250,2620,9.2,0.34007218
17459,17459,Martin Frk,2019-20,26.0,4,6,30,30,1,5,6,28.0,276.0,100,12,19,31,128.0,82,5.96,47,239,2579,9.5,0.21036696
17460,17460,Martin Frk,2020-21,27.0,5,8,17,17,6,2,8,26.0,235.0,117,18,21,39,154.0,70,5.96,42,208,2192,9.5,0.3438989
17461,17461,Martin Gelinas,1989-90,19.0,2,3,6,6,1,2,3,14.0,,6,1,2,3,14.0,80,7.48,85,403,2430,12.3,0.34460807
17462,17462,Martin Gelinas,1990-91,20.0,3,25,46,46,17,8,25,71.0,,52,18,10,28,85.0,80,7.37,76,367,2421,12.2,0.5171479
17463,17463,Martin Gelinas,1991-92,21.0,4,40,73,73,20,20,40,124.0,,125,38,30,68,209.0,80,6.91,71,366,2385,11.6,0.58268195
17464,17464,Martin Gelinas,1992-93,22.0,5,29,68,68,11,18,29,94.0,,193,49,48,97,303.0,80,6.96,77,402,2440,11.4,0.44292042
17465,17465,Martin Gelinas,1993-94,23.0,6,23,65,65,11,12,23,93.0,,258,60,60,120,396.0,84,7.25,87,443,2603,11.7,0.40314975
17466,17466,Martin Gelinas,1994-95,24.0,7,28,64,64,14,14,28,107.0,,322,74,74,148,503.0,84,6.48,76,407,2545,10.7,0.4404413
17467,17467,Martin Gelinas,1995-96,25.0,8,23,46,46,13,10,23,75.0,,368,87,84,171,578.0,48,5.97,37,209,1408,10.2,0.54107165
17468,17468,Martin Gelinas,1996-97,26.0,9,56,81,81,30,26,56,181.0,,449,117,110,227,759.0,82,6.29,74,413,2481,10.4,0.642547
17469,17469,Martin Gelinas,1997-98,27.0,10,68,74,74,35,33,68,177.0,,523,152,143,295,936.0,82,5.83,55,336,2444,9.8,0.72791684
17470,17470,Martin Gelinas,1998-99,28.0,11,34,64,64,16,18,34,147.0,,587,168,161,329,1083.0,82,5.28,57,380,2242,9.6,0.54442865
17471,17471,Martin Gelinas,1999-00,29.0,12,28,76,76,13,15,28,111.0,1004.0,663,181,176,357,1194.0,82,5.27,57,359,2285,9.4,0.37505156
17472,17472,Martin Gelinas,2000-01,30.0,13,30,81,81,14,16,30,139.0,1106.0,744,195,192,387,1333.0,82,5.49,53,331,2294,9.8,0.38981968
17473,17473,Martin Gelinas,2001-02,31.0,14,52,79,79,23,29,52,170.0,1414.0,823,218,221,439,1503.0,82,5.51,63,376,2272,9.9,0.5192501
17474,17474,Martin Gelinas,2002-03,32.0,15,29,72,72,13,16,29,121.0,1158.0,895,231,237,468,1624.0,82,5.24,53,338,2262,9.5,0.37119883
17475,17475,Martin Gelinas,2003-04,33.0,16,52,81,81,21,31,52,152.0,1341.0,976,252,268,520,1776.0,82,5.31,60,363,2326,9.4,0.5316592
17476,17476,Martin Gelinas,2004-05,34.0,17,35,76,76,17,18,35,139.0,1127.0,1052,269,286,555,1915.0,82,5.14,57,348,2300,9.2,0.50148666
17477,17477,Martin Gelinas,2006-07,36.0,18,41,82,82,17,24,41,186.0,1311.0,1134,286,310,596,2101.0,82,6.05,85,480,2458,10.1,0.46932286
17478,17478,Martin Gelinas,2007-08,37.0,19,44,82,82,14,30,44,171.0,1101.0,1216,300,340,640,2272.0,82,5.76,70,398,2426,9.7,0.4575232
17479,17479,Martin Gelinas,2008-09,38.0,20,20,57,57,9,11,20,110.0,805.0,1273,309,351,660,2382.0,82,5.44,62,351,2383,9.4,0.34400064
17480,17480,Martin Gendron,1995-96,21.0,2,3,8,8,2,1,3,11.0,,8,2,1,3,11.0,48,5.97,37,209,1408,10.2,0.34223366
17481,17481,Martin Gendron,1996-97,22.0,3,3,20,20,2,1,3,22.0,,28,4,2,6,33.0,82,6.29,74,413,2481,10.4,0.275401
17482,17482,Martin Gendron,1998-99,24.0,4,0,2,2,0,0,0,3.0,,30,4,2,6,36.0,82,5.28,57,380,2242,9.6,0.18234184
17483,17483,Martin Grenier,2002-03,22.0,2,0,5,5,0,0,0,1.0,30.0,5,0,0,0,1.0,82,5.24,53,338,2262,9.5,0.16294318
17484,17484,Martin Grenier,2003-04,23.0,3,0,3,3,0,0,0,0.0,19.0,8,0,0,0,1.0,82,5.31,60,363,2326,9.4,0.15707734
17485,17485,Martin Grenier,2004-05,24.0,4,1,7,7,1,0,1,6.0,48.0,15,1,0,1,7.0,82,5.14,57,348,2300,9.2,0.1916379
17486,17486,Martin Grenier,2007-08,27.0,5,0,3,3,0,0,0,0.0,14.0,18,1,0,1,7.0,82,5.76,70,398,2426,9.7,0.15500543
17487,17487,Martin Hanzal,2008-09,21.0,2,35,72,72,8,27,35,111.0,1206.0,72,8,27,35,111.0,82,5.44,62,351,2383,9.4,0.4873374
17488,17488,Martin Hanzal,2009-10,22.0,3,31,74,74,11,20,31,97.0,1210.0,146,19,47,66,208.0,82,5.7,65,341,2477,9.4,0.4356983
17489,17489,Martin Hanzal,2010-11,23.0,4,33,81,81,11,22,33,147.0,1497.0,227,30,69,99,355.0,82,5.53,56,304,2486,9.1,0.45258504
17490,17490,Martin Hanzal,2011-12,24.0,5,26,61,61,16,10,26,149.0,1190.0,288,46,79,125,504.0,82,5.46,52,291,2492,9.0,0.49044782
17491,17491,Martin Hanzal,2012-13,25.0,6,34,64,64,8,26,34,145.0,1180.0,352,54,105,159,649.0,82,5.32,47,271,2439,8.9,0.53127545
17492,17492,Martin Hanzal,2013-14,26.0,7,23,39,39,11,12,23,93.0,723.0,391,65,117,182,742.0,48,5.31,29,160,1399,9.1,0.6047016
17493,17493,Martin Hanzal,2014-15,27.0,8,40,65,65,15,25,40,169.0,1214.0,456,80,142,222,911.0,82,5.34,48,269,2463,8.9,0.57768506
17494,17494,Martin Hanzal,2015-16,28.0,9,24,37,37,8,16,24,85.0,656.0,493,88,158,246,996.0,82,5.32,47,251,2453,8.9,0.5281538
17495,17495,Martin Hanzal,2016-17,29.0,10,41,64,64,13,28,41,141.0,1139.0,557,101,186,287,1137.0,82,5.34,48,255,2438,9.0,0.5729766
17496,17496,Martin Hanzal,2017-18,30.0,11,39,71,71,20,19,39,169.0,1258.0,628,121,205,326,1306.0,82,5.45,47,245,2478,9.0,0.5022306
17497,17497,Martin Hanzal,2018-19,31.0,12,10,38,38,5,5,10,62.0,536.0,666,126,210,336,1368.0,82,5.86,50,250,2620,9.2,0.26636893
17498,17498,Martin Hanzal,2019-20,32.0,13,2,7,7,1,1,2,14.0,90.0,673,127,211,338,1382.0,82,5.96,47,239,2579,9.5,0.24278161
17499,17499,Martin Havlat,2001-02,20.0,2,42,73,73,19,23,42,133.0,1006.0,73,19,23,42,133.0,82,5.51,63,376,2272,9.9,0.6079536
17500,17500,Martin Havlat,2002-03,21.0,3,50,72,72,22,28,50,145.0,1063.0,145,41,51,92,278.0,82,5.24,53,338,2262,9.5,0.71996677
17501,17501,Martin Havlat,2003-04,22.0,4,59,67,67,24,35,59,179.0,1102.0,212,65,86,151,457.0,82,5.31,60,363,2326,9.4,0.8971142
17502,17502,Martin Havlat,2004-05,23.0,5,68,68,68,31,37,68,175.0,1138.0,280,96,123,219,632.0,82,5.14,57,348,2300,9.2,1.0331712
17503,17503,Martin Havlat,2006-07,25.0,6,16,18,18,9,7,16,57.0,327.0,298,105,130,235,689.0,82,6.05,85,480,2458,10.1,0.7981777
17504,17504,Martin Havlat,2007-08,26.0,7,57,56,56,25,32,57,176.0,1198.0,354,130,162,292,865.0,82,5.76,70,398,2426,9.7,0.87615037
17505,17505,Martin Havlat,2008-09,27.0,8,27,35,35,10,17,27,87.0,650.0,389,140,179,319,952.0,82,5.44,62,351,2383,9.4,0.6467404
17506,17506,Martin Havlat,2009-10,28.0,9,77,81,81,29,48,77,249.0,1410.0,470,169,227,396,1201.0,82,5.7,65,341,2477,9.4,0.88740635
17507,17507,Martin Havlat,2010-11,29.0,10,54,73,73,18,36,54,169.0,1309.0,543,187,263,450,1370.0,82,5.53,56,304,2486,9.1,0.705744
17508,17508,Martin Havlat,2011-12,30.0,11,62,78,78,22,40,62,229.0,1431.0,621,209,303,512,1599.0,82,5.46,52,291,2492,9.0,0.69853884
17509,17509,Martin Havlat,2012-13,31.0,12,27,39,39,7,20,27,96.0,687.0,660,216,323,539,1695.0,82,5.32,47,271,2439,8.9,0.59369904
17510,17510,Martin Havlat,2013-14,32.0,13,18,40,40,8,10,18,89.0,634.0,700,224,333,557,1784.0,48,5.31,29,160,1399,9.1,0.5237613
17511,17511,Martin Havlat,2014-15,33.0,14,22,48,48,12,10,22,72.0,707.0,748,236,343,579,1856.0,82,5.34,48,269,2463,8.9,0.4352283
17512,17512,Martin Havlat,2015-16,34.0,15,14,40,40,5,9,14,49.0,592.0,788,241,352,593,1905.0,82,5.32,47,251,2453,8.9,0.3395353
17513,17513,Martin Havlat,2016-17,35.0,16,1,2,2,1,0,1,3.0,22.0,790,242,352,594,1908.0,82,5.34,48,255,2438,9.0,0.2915538
17514,17514,Martin Hostak,1991-92,24.0,2,13,50,50,3,10,13,64.0,,50,3,10,13,64.0,80,6.91,71,366,2385,11.6,0.27664912
17515,17515,Martin Hostak,1992-93,25.0,3,1,5,5,0,1,1,8.0,,55,3,11,14,72.0,80,6.96,77,402,2440,11.4,0.19874442
17516,17516,Martin Kaut,2020-21,21.0,2,3,9,9,2,1,3,13.0,91.0,9,2,1,3,13.0,70,5.96,42,208,2192,9.5,0.3245402
17517,17517,Martin Lapointe,1992-93,19.0,2,1,4,4,0,1,1,2.0,,4,0,1,1,2.0,80,6.96,77,402,2440,11.4,0.30199313
17518,17518,Martin Lapointe,1993-94,20.0,3,0,3,3,0,0,0,2.0,,7,0,1,1,4.0,84,7.25,87,443,2603,11.7,0.27036017
17519,17519,Martin Lapointe,1994-95,21.0,4,16,50,50,8,8,16,45.0,,57,8,9,17,49.0,84,6.48,76,407,2545,10.7,0.33091512
17520,17520,Martin Lapointe,1995-96,22.0,5,10,39,39,4,6,10,46.0,,96,12,15,27,95.0,48,5.97,37,209,1408,10.2,0.32150927
17521,17521,Martin Lapointe,1996-97,23.0,6,9,58,58,6,3,9,76.0,,154,18,18,36,171.0,82,6.29,74,413,2481,10.4,0.246138
17522,17522,Martin Lapointe,1997-98,24.0,7,33,78,78,16,17,33,149.0,,232,34,35,69,320.0,82,5.83,55,336,2444,9.8,0.43655705
17523,17523,Martin Lapointe,1998-99,25.0,8,34,79,79,15,19,34,154.0,,311,49,54,103,474.0,82,5.28,57,380,2242,9.6,0.43722
17524,17524,Martin Lapointe,1999-00,26.0,9,29,77,77,16,13,29,153.0,1163.0,388,65,67,132,627.0,82,5.27,57,359,2285,9.4,0.41999874
17525,17525,Martin Lapointe,2000-01,27.0,10,41,82,82,16,25,41,127.0,1207.0,470,81,92,173,754.0,82,5.49,53,331,2294,9.8,0.46956223
17526,17526,Martin Lapointe,2001-02,28.0,11,57,82,82,27,30,57,181.0,1320.0,552,108,122,230,935.0,82,5.51,63,376,2272,9.9,0.5984533
17527,17527,Martin Lapointe,2002-03,29.0,12,40,68,68,17,23,40,141.0,1180.0,620,125,145,270,1076.0,82,5.24,53,338,2262,9.5,0.53001815
17528,17528,Martin Lapointe,2003-04,30.0,13,18,59,59,8,10,18,110.0,906.0,679,133,155,288,1186.0,82,5.31,60,363,2326,9.4,0.3418252
17529,17529,Martin Lapointe,2004-05,31.0,14,25,78,78,15,10,25,136.0,1126.0,757,148,165,313,1322.0,82,5.14,57,348,2300,9.2,0.36315185
17530,17530,Martin Lapointe,2006-07,33.0,15,31,82,82,14,17,31,135.0,1211.0,839,162,182,344,1457.0,82,6.05,85,480,2458,10.1,0.31742576
17531,17531,Martin Lapointe,2007-08,34.0,16,24,82,82,13,11,24,102.0,1147.0,921,175,193,368,1559.0,82,5.76,70,398,2426,9.7,0.2494286
17532,17532,Martin Lapointe,2008-09,35.0,17,13,70,70,6,7,13,63.0,658.0,991,181,200,381,1622.0,82,5.44,62,351,2383,9.4,0.1696788
17533,17533,Martin Lojek,2007-08,22.0,2,1,3,3,0,1,1,0.0,25.0,3,0,1,1,0.0,82,5.76,70,398,2426,9.7,0.17865229
17534,17534,Martin Lojek,2008-09,23.0,3,0,2,2,0,0,0,2.0,12.0,5,0,1,1,2.0,82,5.44,62,351,2383,9.4,0.16976792
17535,17535,Martin Marincin,2014-15,22.0,2,6,44,44,0,6,6,28.0,843.0,44,0,6,6,28.0,82,5.34,48,269,2463,8.9,0.1391733
17536,17536,Martin Marincin,2015-16,23.0,3,5,41,41,1,4,5,38.0,765.0,85,1,10,11,66.0,82,5.32,47,251,2453,8.9,0.16895688
17537,17537,Martin Marincin,2016-17,24.0,4,7,65,65,1,6,7,55.0,1090.0,150,2,16,18,121.0,82,5.34,48,255,2438,9.0,0.14948812
17538,17538,Martin Marincin,2017-18,25.0,5,7,25,25,1,6,7,22.0,451.0,175,3,22,25,143.0,82,5.45,47,245,2478,9.0,0.17670065
17539,17539,Martin Marincin,2018-19,26.0,6,0,2,2,0,0,0,0.0,33.0,177,3,22,25,143.0,82,5.86,50,250,2620,9.2,0.13716197
17540,17540,Martin Marincin,2019-20,27.0,7,5,24,24,1,4,5,34.0,365.0,201,4,26,30,177.0,82,5.96,47,239,2579,9.5,0.1594846
17541,17541,Martin Marincin,2020-21,28.0,8,4,26,26,1,3,4,28.0,395.0,227,5,29,34,205.0,70,5.96,42,208,2192,9.5,0.15899786
17542,17542,Martin Necas,2018-19,20.0,2,0,1,1,0,0,0,0.0,7.0,1,0,0,0,0.0,82,5.86,50,250,2620,9.2,0.22576961
17543,17543,Martin Necas,2019-20,21.0,3,2,7,7,1,1,2,6.0,70.0,8,1,1,2,6.0,82,5.96,47,239,2579,9.5,0.2722798
17544,17544,Martin Necas,2020-21,22.0,4,36,64,64,16,20,36,88.0,907.0,72,17,21,38,94.0,70,5.96,42,208,2192,9.5,0.52756554
17545,17545,Martin Prochazka,1998-99,26.0,2,6,29,29,2,4,6,40.0,,29,2,4,6,40.0,82,5.28,57,380,2242,9.6,0.2161445
17546,17546,Martin Prochazka,2000-01,28.0,3,1,3,3,0,1,1,5.0,50.0,32,2,5,7,45.0,82,5.49,53,331,2294,9.8,0.1487112
17547,17547,Martin Rucinsky,1992-93,21.0,2,2,6,6,1,1,2,5.0,,6,1,1,2,5.0,80,6.96,77,402,2440,11.4,0.31352758
17548,17548,Martin Rucinsky,1993-94,22.0,3,48,77,77,18,30,48,133.0,,83,19,31,50,138.0,84,7.25,87,443,2603,11.7,0.62104625
17549,17549,Martin Rucinsky,1994-95,23.0,4,32,60,60,9,23,32,96.0,,143,28,54,82,234.0,84,6.48,76,407,2545,10.7,0.48725936
17550,17550,Martin Rucinsky,1995-96,24.0,5,9,20,20,3,6,9,32.0,,163,31,60,91,266.0,48,5.97,37,209,1408,10.2,0.4156221
17551,17551,Martin Rucinsky,1996-97,25.0,6,75,78,78,29,46,75,181.0,,241,60,106,166,447.0,82,6.29,74,413,2481,10.4,0.79604876
17552,17552,Martin Rucinsky,1997-98,26.0,7,55,70,70,28,27,55,172.0,,311,88,133,221,619.0,82,5.83,55,336,2444,9.8,0.7066591
17553,17553,Martin Rucinsky,1998-99,27.0,8,53,78,78,21,32,53,192.0,,389,109,165,274,811.0,82,5.28,57,380,2242,9.6,0.6429242
17554,17554,Martin Rucinsky,1999-00,28.0,9,34,73,73,17,17,34,180.0,1329.0,462,126,182,308,991.0,82,5.27,57,359,2285,9.4,0.5467895
17555,17555,Martin Rucinsky,2000-01,29.0,10,49,80,80,25,24,49,242.0,1512.0,542,151,206,357,1233.0,82,5.49,53,331,2294,9.8,0.67061025
17556,17556,Martin Rucinsky,2001-02,30.0,11,38,57,57,16,22,38,141.0,1093.0,599,167,228,395,1374.0,82,5.51,63,376,2272,9.9,0.62926435
17557,17557,Martin Rucinsky,2002-03,31.0,12,38,75,75,11,27,38,128.0,1153.0,674,178,255,433,1502.0,82,5.24,53,338,2262,9.5,0.4479781
17558,17558,Martin Rucinsky,2003-04,32.0,13,30,61,61,16,14,30,135.0,1032.0,735,194,269,463,1637.0,82,5.31,60,363,2326,9.4,0.47872669
17559,17559,Martin Rucinsky,2004-05,33.0,14,45,82,82,14,31,45,206.0,1548.0,817,208,300,508,1843.0,82,5.14,57,348,2300,9.2,0.70009315
17560,17560,Martin Rucinsky,2006-07,35.0,15,55,52,52,16,39,55,152.0,958.0,869,224,339,563,1995.0,82,6.05,85,480,2458,10.1,0.7117862
17561,17561,Martin Rucinsky,2007-08,36.0,16,33,52,52,12,21,33,96.0,870.0,921,236,360,596,2091.0,82,5.76,70,398,2426,9.7,0.49244702
17562,17562,Martin Rucinsky,2008-09,37.0,17,16,40,40,5,11,16,67.0,600.0,961,241,371,612,2158.0,82,5.44,62,351,2383,9.4,0.35224572
17563,17563,Martin Samuelsson,2003-04,22.0,2,1,8,8,0,1,1,3.0,94.0,8,0,1,1,3.0,82,5.31,60,363,2326,9.4,0.19302264
17564,17564,Martin Samuelsson,2004-05,23.0,3,0,6,6,0,0,0,7.0,34.0,14,0,1,1,10.0,82,5.14,57,348,2300,9.2,0.17865449
17565,17565,Martin Simard,1991-92,25.0,2,2,16,16,0,2,2,7.0,,16,0,2,2,7.0,80,6.91,71,366,2385,11.6,0.19363573
17566,17566,Martin Simard,1992-93,26.0,3,4,21,21,1,3,4,11.0,,37,1,5,6,18.0,80,6.96,77,402,2440,11.4,0.18276936
17567,17567,Martin Simard,1993-94,27.0,4,0,7,7,0,0,0,1.0,,44,1,5,6,19.0,84,7.25,87,443,2603,11.7,0.15057388
17568,17568,Martin Skoula,2000-01,21.0,2,16,80,80,3,13,16,66.0,1460.0,80,3,13,16,66.0,82,5.49,53,331,2294,9.8,0.23153517
17569,17569,Martin Skoula,2001-02,22.0,3,25,82,82,8,17,25,108.0,1697.0,162,11,30,41,174.0,82,5.51,63,376,2272,9.9,0.3542325
17570,17570,Martin Skoula,2002-03,23.0,4,31,82,82,10,21,31,100.0,1829.0,244,21,51,72,274.0,82,5.24,53,338,2262,9.5,0.43550536
17571,17571,Martin Skoula,2003-04,24.0,5,25,81,81,4,21,25,93.0,1495.0,325,25,72,97,367.0,82,5.31,60,363,2326,9.4,0.325944
17572,17572,Martin Skoula,2004-05,25.0,6,25,79,79,4,21,25,84.0,1452.0,404,29,93,122,451.0,82,5.14,57,348,2300,9.2,0.34927586
17573,17573,Martin Skoula,2006-07,27.0,7,21,78,78,5,16,21,92.0,1493.0,482,34,109,143,543.0,82,6.05,85,480,2458,10.1,0.2782784
17574,17574,Martin Skoula,2007-08,28.0,8,15,81,81,0,15,15,91.0,1639.0,563,34,124,158,634.0,82,5.76,70,398,2426,9.7,0.20177388
17575,17575,Martin Skoula,2008-09,29.0,9,11,80,80,3,8,11,63.0,1639.0,643,37,132,169,697.0,82,5.44,62,351,2383,9.4,0.19716436
17576,17576,Martin Skoula,2009-10,30.0,10,16,81,81,4,12,16,55.0,1617.0,724,41,144,185,752.0,82,5.7,65,341,2477,9.4,0.20106718
17577,17577,Martin Skoula,2010-11,31.0,11,11,52,52,3,8,11,34.0,905.0,776,44,152,196,786.0,82,5.53,56,304,2486,9.1,0.17411521
17578,17578,Martin Sonnenberg,1999-00,22.0,2,2,44,44,1,1,2,12.0,176.0,44,1,1,2,12.0,82,5.27,57,359,2285,9.4,0.12773028
17579,17579,Martin Sonnenberg,2000-01,23.0,3,3,14,14,1,2,3,19.0,104.0,58,2,3,5,31.0,82,5.49,53,331,2294,9.8,0.21687597
17580,17580,Martin Sonnenberg,2004-05,27.0,4,0,5,5,0,0,0,7.0,44.0,63,2,3,5,38.0,82,5.14,57,348,2300,9.2,0.1624015
17581,17581,Martin Spanhel,2001-02,24.0,2,1,6,6,1,0,1,8.0,75.0,6,1,0,1,8.0,82,5.51,63,376,2272,9.9,0.1949524
17582,17582,Martin Spanhel,2002-03,25.0,3,1,4,4,1,0,1,6.0,45.0,10,2,0,2,14.0,82,5.24,53,338,2262,9.5,0.18687162
17583,17583,Martin St. Amour,1993-94,24.0,2,0,1,1,0,0,0,2.0,,1,0,0,0,2.0,84,7.25,87,443,2603,11.7,0.21332315
17584,17584,Martin St. Louis,1999-00,24.0,2,2,13,13,1,1,2,14.0,107.0,13,1,1,2,14.0,82,5.27,57,359,2285,9.4,0.21591309
17585,17585,Martin St. Louis,2000-01,25.0,3,18,56,56,3,15,18,73.0,823.0,69,4,16,20,87.0,82,5.49,53,331,2294,9.8,0.3181868
17586,17586,Martin St. Louis,2001-02,26.0,4,40,78,78,18,22,40,141.0,1189.0,147,22,38,60,228.0,82,5.51,63,376,2272,9.9,0.47483125
17587,17587,Martin St. Louis,2002-03,27.0,5,35,53,53,16,19,35,105.0,990.0,200,38,57,95,333.0,82,5.24,53,338,2262,9.5,0.5933877
17588,17588,Martin St. Louis,2003-04,28.0,6,70,82,82,33,37,70,201.0,1616.0,282,71,94,165,534.0,82,5.31,60,363,2326,9.4,0.7914388
17589,17589,Martin St. Louis,2004-05,29.0,7,94,82,82,38,56,94,212.0,1688.0,364,109,150,259,746.0,82,5.14,57,348,2300,9.2,1.0147905
17590,17590,Martin St. Louis,2006-07,31.0,8,61,80,80,31,30,61,221.0,1679.0,444,140,180,320,967.0,82,6.05,85,480,2458,10.1,0.7174612
17591,17591,Martin St. Louis,2007-08,32.0,9,102,82,82,43,59,102,273.0,1981.0,526,183,239,422,1240.0,82,5.76,70,398,2426,9.7,1.0646634
17592,17592,Martin St. Louis,2008-09,33.0,10,83,82,82,25,58,83,241.0,1991.0,608,208,297,505,1481.0,82,5.44,62,351,2383,9.4,0.8814023
17593,17593,Martin St. Louis,2009-10,34.0,11,80,82,82,30,50,80,262.0,1745.0,690,238,347,585,1743.0,82,5.7,65,341,2477,9.4,0.8465139
17594,17594,Martin St. Louis,2010-11,35.0,12,94,82,82,29,65,94,242.0,1788.0,772,267,412,679,1985.0,82,5.53,56,304,2486,9.1,0.98538244
17595,17595,Martin St. Louis,2011-12,36.0,13,99,82,82,31,68,99,254.0,1720.0,854,298,480,778,2239.0,82,5.46,52,291,2492,9.0,1.0300999
17596,17596,Martin St. Louis,2012-13,37.0,14,74,77,77,25,49,74,185.0,1743.0,931,323,529,852,2424.0,82,5.32,47,271,2439,8.9,0.85228574
17597,17597,Martin St. Louis,2013-14,38.0,15,60,48,48,17,43,60,112.0,1055.0,979,340,572,912,2536.0,48,5.31,29,160,1399,9.1,0.9263908
17598,17598,Martin St. Louis,2014-15,39.0,16,69,81,81,30,39,69,204.0,1696.0,1060,370,611,981,2740.0,82,5.34,48,269,2463,8.9,0.7495024
17599,17599,Martin St. Louis,2015-16,40.0,17,52,74,74,21,31,52,144.0,1300.0,1134,391,642,1033,2884.0,82,5.32,47,251,2453,8.9,0.5948478
17600,17600,Martin St. Pierre,2006-07,23.0,2,0,2,2,0,0,0,1.0,24.0,2,0,0,0,1.0,82,6.05,85,480,2458,10.1,0.16944346
17601,17601,Martin St. Pierre,2007-08,24.0,3,4,14,14,1,3,4,13.0,175.0,16,1,3,4,14.0,82,5.76,70,398,2426,9.7,0.20801511
17602,17602,Martin St. Pierre,2008-09,25.0,4,0,5,5,0,0,0,2.0,76.0,21,1,3,4,16.0,82,5.44,62,351,2383,9.4,0.15820381
17603,17603,Martin St. Pierre,2009-10,26.0,5,4,14,14,2,2,4,15.0,160.0,35,3,5,8,31.0,82,5.7,65,341,2477,9.4,0.2221278
17604,17604,Martin St. Pierre,2010-11,27.0,6,0,3,3,0,0,0,0.0,29.0,38,3,5,8,31.0,82,5.53,56,304,2486,9.1,0.13935652
17605,17605,Martin St. Pierre,2014-15,31.0,7,0,1,1,0,0,0,0.0,10.0,39,3,5,8,31.0,82,5.34,48,269,2463,8.9,0.124166876
17606,17606,Martin Straka,1993-94,21.0,2,16,42,42,3,13,16,28.0,,42,3,13,16,28.0,84,7.25,87,443,2603,11.7,0.33432186
17607,17607,Martin Straka,1994-95,22.0,3,64,84,84,30,34,64,130.0,,126,33,47,80,158.0,84,6.48,76,407,2545,10.7,0.70721394
17608,17608,Martin Straka,1995-96,23.0,4,18,37,37,5,13,18,49.0,,163,38,60,98,207.0,48,5.97,37,209,1408,10.2,0.54386747
17609,17609,Martin Straka,1996-97,24.0,5,43,77,77,13,30,43,98.0,,240,51,90,141,305.0,82,6.29,74,413,2481,10.4,0.540372
17610,17610,Martin Straka,1997-98,25.0,6,29,55,55,7,22,29,94.0,,295,58,112,170,399.0,82,5.83,55,336,2444,9.8,0.5389116
17611,17611,Martin Straka,1998-99,26.0,7,42,75,75,19,23,42,117.0,,370,77,135,212,516.0,82,5.28,57,380,2242,9.6,0.5404199
17612,17612,Martin Straka,1999-00,27.0,8,83,80,80,35,48,83,177.0,1887.0,450,112,183,295,693.0,82,5.27,57,359,2285,9.4,0.8450364
17613,17613,Martin Straka,2000-01,28.0,9,59,71,71,20,39,59,146.0,1701.0,521,132,222,354,839.0,82,5.49,53,331,2294,9.8,0.7929839
17614,17614,Martin Straka,2001-02,29.0,10,95,82,82,27,68,95,185.0,1888.0,603,159,290,449,1024.0,82,5.51,63,376,2272,9.9,0.92970455
17615,17615,Martin Straka,2002-03,30.0,11,9,13,13,5,4,9,33.0,234.0,616,164,294,458,1057.0,82,5.24,53,338,2262,9.5,0.5591114
17616,17616,Martin Straka,2003-04,31.0,12,46,60,60,18,28,46,136.0,1237.0,676,182,322,504,1193.0,82,5.31,60,363,2326,9.4,0.6157841
17617,17617,Martin Straka,2004-05,32.0,13,26,54,54,10,16,26,68.0,1011.0,730,192,338,530,1261.0,82,5.14,57,348,2300,9.2,0.6551199
17618,17618,Martin Straka,2006-07,34.0,14,76,82,82,22,54,76,171.0,1571.0,812,214,392,606,1432.0,82,6.05,85,480,2458,10.1,0.79274416
17619,17619,Martin Straka,2007-08,35.0,15,70,77,77,29,41,70,165.0,1536.0,889,243,433,676,1597.0,82,5.76,70,398,2426,9.7,0.7357988
17620,17620,Martin Straka,2008-09,36.0,16,41,65,65,14,27,41,116.0,1210.0,954,257,460,717,1713.0,82,5.44,62,351,2383,9.4,0.510361
17621,17621,Martin Strbak,2004-05,30.0,2,16,49,49,5,11,16,54.0,955.0,49,5,11,16,54.0,82,5.14,57,348,2300,9.2,0.2894329
17622,17622,Martins Karsums,2009-10,23.0,2,6,24,24,1,5,6,28.0,269.0,24,1,5,6,28.0,82,5.7,65,341,2477,9.4,0.23728454
17623,17623,Martti Jarventie,2002-03,26.0,2,0,1,1,0,0,0,0.0,13.0,1,0,0,0,0.0,82,5.24,53,338,2262,9.5,0.15208486
17624,17624,Marty Dallman,1988-89,25.0,2,1,2,2,0,1,1,1.0,,2,0,1,1,1.0,80,7.43,89,437,2435,12.2,0.22155422
17625,17625,Marty Dallman,1989-90,26.0,3,0,4,4,0,0,0,2.0,,6,0,1,1,3.0,80,7.48,85,403,2430,12.3,0.19570568
17626,17626,Marty Howe,1980-81,26.0,2,1,6,6,0,1,1,6.0,,6,0,1,1,6.0,80,7.03,61,280,2352,12.0,0.2215442
17627,17627,Marty Howe,1981-82,27.0,3,1,12,12,0,1,1,3.0,,18,0,2,2,9.0,80,7.69,77,340,2441,12.6,0.18656716
17628,17628,Marty Howe,1982-83,28.0,4,4,13,13,0,4,4,21.0,,31,0,6,6,30.0,80,8.03,73,320,2489,12.9,0.23299041
17629,17629,Marty Howe,1983-84,29.0,5,12,78,78,1,11,12,67.0,,109,1,17,18,97.0,80,7.73,71,310,2444,12.7,0.19817913
17630,17630,Marty Howe,1984-85,30.0,6,11,69,69,0,11,11,58.0,,178,1,28,29,155.0,80,7.89,74,336,2448,12.9,0.16344774
17631,17631,Marty Howe,1985-86,31.0,7,2,19,19,1,1,2,23.0,,197,2,29,31,178.0,80,7.77,71,321,2447,12.7,0.20102885
17632,17632,Marty McInnis,1992-93,22.0,2,8,15,15,3,5,8,24.0,,15,3,5,8,24.0,80,6.96,77,402,2440,11.4,0.4029341
17633,17633,Marty McInnis,1993-94,23.0,3,30,56,56,10,20,30,60.0,,71,13,25,38,84.0,84,7.25,87,443,2603,11.7,0.50615597
17634,17634,Marty McInnis,1994-95,24.0,4,56,81,81,25,31,56,136.0,,152,38,56,94,220.0,84,6.48,76,407,2545,10.7,0.5871325
17635,17635,Marty McInnis,1995-96,25.0,5,16,41,41,9,7,16,68.0,,193,47,63,110,288.0,48,5.97,37,209,1408,10.2,0.4443444
17636,17636,Marty McInnis,1996-97,26.0,6,46,74,74,12,34,46,167.0,,267,59,97,156,455.0,82,6.29,74,413,2481,10.4,0.5584089
17637,17637,Marty McInnis,1997-98,27.0,7,49,80,80,23,26,49,182.0,,347,82,123,205,637.0,82,5.83,55,336,2444,9.8,0.5845473
17638,17638,Marty McInnis,1998-99,28.0,8,44,75,75,19,25,44,128.0,,422,101,148,249,765.0,82,5.28,57,380,2242,9.6,0.50535697
17639,17639,Marty McInnis,1999-00,29.0,9,54,81,81,19,35,54,146.0,1507.0,503,120,183,303,911.0,82,5.27,57,359,2285,9.4,0.64538956
17640,17640,Marty McInnis,2000-01,30.0,10,28,62,62,10,18,28,129.0,1182.0,565,130,201,331,1040.0,82,5.49,53,331,2294,9.8,0.43051982
17641,17641,Marty McInnis,2001-02,31.0,11,42,75,75,20,22,42,136.0,1387.0,640,150,223,373,1176.0,82,5.51,63,376,2272,9.9,0.45086193
17642,17642,Marty McInnis,2002-03,32.0,12,28,79,79,11,17,28,157.0,1255.0,719,161,240,401,1333.0,82,5.24,53,338,2262,9.5,0.36065137
17643,17643,Marty McInnis,2003-04,33.0,13,19,77,77,9,10,19,121.0,1095.0,796,170,250,420,1454.0,82,5.31,60,363,2326,9.4,0.29434243
17644,17644,Marty McSorley,1984-85,21.0,2,9,72,72,2,7,9,75.0,,72,2,7,9,75.0,80,7.89,74,336,2448,12.9,0.2543785
17645,17645,Marty McSorley,1985-86,22.0,3,0,15,15,0,0,0,11.0,,87,2,7,9,86.0,80,7.77,71,321,2447,12.7,0.23010358
17646,17646,Marty McSorley,1986-87,23.0,4,23,59,59,11,12,23,72.0,,146,13,19,32,158.0,80,7.94,82,370,2484,12.8,0.36888957
17647,17647,Marty McSorley,1987-88,24.0,5,6,41,41,2,4,6,33.0,,187,15,23,38,191.0,80,7.34,72,344,2400,12.2,0.21422079
17648,17648,Marty McSorley,1988-89,25.0,6,26,60,60,9,17,26,66.0,,247,24,40,64,257.0,80,7.43,89,437,2435,12.2,0.35276973
17649,17649,Marty McSorley,1989-90,26.0,7,27,66,66,10,17,27,87.0,,313,34,57,91,344.0,80,7.48,85,403,2430,12.3,0.33517855
17650,17650,Marty McSorley,1990-91,27.0,8,36,75,75,15,21,36,127.0,,388,49,78,127,471.0,80,7.37,76,367,2421,12.2,0.4085451
17651,17651,Marty McSorley,1991-92,28.0,9,39,61,61,7,32,39,100.0,,449,56,110,166,571.0,80,6.91,71,366,2385,11.6,0.50773644
17652,17652,Marty McSorley,1992-93,29.0,10,29,71,71,7,22,29,119.0,,520,63,132,195,690.0,80,6.96,77,402,2440,11.4,0.38315117
17653,17653,Marty McSorley,1993-94,30.0,11,41,81,81,15,26,41,197.0,,601,78,158,236,887.0,84,7.25,87,443,2603,11.7,0.46860752
17654,17654,Marty McSorley,1994-95,31.0,12,31,65,65,7,24,31,160.0,,666,85,182,267,1047.0,84,6.48,76,407,2545,10.7,0.39986554
17655,17655,Marty McSorley,1995-96,32.0,13,21,41,41,3,18,21,75.0,,707,88,200,288,1122.0,48,5.97,37,209,1408,10.2,0.41428128
17656,17656,Marty McSorley,1996-97,33.0,14,33,68,68,10,23,33,130.0,,775,98,223,321,1252.0,82,6.29,74,413,2481,10.4,0.36245114
17657,17657,Marty McSorley,1997-98,34.0,15,16,57,57,4,12,16,74.0,,832,102,235,337,1326.0,82,5.83,55,336,2444,9.8,0.23015317
17658,17658,Marty McSorley,1998-99,35.0,16,12,56,56,2,10,12,46.0,,888,104,245,349,1372.0,82,5.28,57,380,2242,9.6,0.15497798
17659,17659,Marty McSorley,1999-00,36.0,17,5,46,46,2,3,5,29.0,780.0,934,106,248,354,1401.0,82,5.27,57,359,2285,9.4,0.12973467
17660,17660,Marty McSorley,2000-01,37.0,18,5,27,27,2,3,5,24.0,379.0,961,108,251,359,1425.0,82,5.49,53,331,2294,9.8,0.19418827
17661,17661,Marty Murray,1996-97,21.0,2,6,15,15,3,3,6,22.0,,15,3,3,6,22.0,82,6.29,74,413,2481,10.4,0.35539478
17662,17662,Marty Murray,1997-98,22.0,3,0,2,2,0,0,0,2.0,,17,3,3,6,24.0,82,5.83,55,336,2444,9.8,0.18733236
17663,17663,Marty Murray,1998-99,23.0,4,0,2,2,0,0,0,2.0,,19,3,3,6,26.0,82,5.28,57,380,2242,9.6,0.18198237
17664,17664,Marty Murray,2001-02,26.0,5,0,7,7,0,0,0,6.0,101.0,26,3,3,6,32.0,82,5.51,63,376,2272,9.9,0.15168029
17665,17665,Marty Murray,2002-03,27.0,6,27,74,74,12,15,27,109.0,1031.0,100,15,18,33,141.0,82,5.24,53,338,2262,9.5,0.3227307
17666,17666,Marty Murray,2003-04,28.0,7,26,76,76,11,15,26,105.0,940.0,176,26,33,59,246.0,82,5.31,60,363,2326,9.4,0.28350294
17667,17667,Marty Murray,2004-05,29.0,8,12,66,66,5,7,12,56.0,780.0,242,31,40,71,302.0,82,5.14,57,348,2300,9.2,0.21234864
17668,17668,Marty Murray,2007-08,32.0,9,2,19,19,0,2,2,4.0,181.0,261,31,42,73,306.0,82,5.76,70,398,2426,9.7,0.14910877
17669,17669,Marty Reasoner,1999-00,22.0,2,10,22,22,3,7,10,33.0,306.0,22,3,7,10,33.0,82,5.27,57,359,2285,9.4,0.32468733
17670,17670,Marty Reasoner,2000-01,23.0,3,24,32,32,10,14,24,51.0,491.0,54,13,21,34,84.0,82,5.49,53,331,2294,9.8,0.49975747
17671,17671,Marty Reasoner,2001-02,24.0,4,13,41,41,4,9,13,65.0,574.0,95,17,30,47,149.0,82,5.51,63,376,2272,9.9,0.29730654
17672,17672,Marty Reasoner,2002-03,25.0,5,11,52,52,6,5,11,66.0,611.0,147,23,35,58,215.0,82,5.24,53,338,2262,9.5,0.29040277
17673,17673,Marty Reasoner,2003-04,26.0,6,31,70,70,11,20,31,102.0,1038.0,217,34,55,89,317.0,82,5.31,60,363,2326,9.4,0.41589528
17674,17674,Marty Reasoner,2004-05,27.0,7,8,17,17,2,6,8,28.0,281.0,234,36,61,97,345.0,82,5.14,57,348,2300,9.2,0.30105174
17675,17675,Marty Reasoner,2006-07,29.0,8,34,77,77,11,23,34,102.0,1027.0,311,47,84,131,447.0,82,6.05,85,480,2458,10.1,0.38747096
17676,17676,Marty Reasoner,2007-08,30.0,9,20,72,72,6,14,20,84.0,999.0,383,53,98,151,531.0,82,5.76,70,398,2426,9.7,0.29237688
17677,17677,Marty Reasoner,2008-09,31.0,10,25,82,82,11,14,25,113.0,1227.0,465,64,112,176,644.0,82,5.44,62,351,2383,9.4,0.29522574
17678,17678,Marty Reasoner,2009-10,32.0,11,30,79,79,14,16,30,131.0,1209.0,544,78,128,206,775.0,82,5.7,65,341,2477,9.4,0.3333569
17679,17679,Marty Reasoner,2010-11,33.0,12,17,80,80,4,13,17,86.0,1000.0,624,82,141,223,861.0,82,5.53,56,304,2486,9.1,0.22047502
17680,17680,Marty Reasoner,2011-12,34.0,13,32,82,82,14,18,32,124.0,1407.0,706,96,159,255,985.0,82,5.46,52,291,2492,9.0,0.30882955
17681,17681,Marty Reasoner,2012-13,35.0,14,6,61,61,1,5,6,69.0,708.0,767,97,164,261,1054.0,82,5.32,47,271,2439,8.9,0.14955193
17682,17682,Marty Reasoner,2013-14,36.0,15,5,31,31,0,5,5,34.0,348.0,798,97,169,266,1088.0,48,5.31,29,160,1399,9.1,0.18201184
17683,17683,Masi Marjamaki,2006-07,22.0,2,0,1,1,0,0,0,0.0,5.0,1,0,0,0,0.0,82,6.05,85,480,2458,10.1,0.15910202
17684,17684,Mason Appleton,2019-20,24.0,2,10,36,36,3,7,10,29.0,295.0,36,3,7,10,29.0,82,5.96,47,239,2579,9.5,0.23281312
17685,17685,Mason Appleton,2020-21,25.0,3,8,46,46,5,3,8,55.0,513.0,82,8,10,18,84.0,70,5.96,42,208,2192,9.5,0.23051187
17686,17686,Mason Marchment,2020-21,25.0,2,1,4,4,0,1,1,3.0,32.0,4,0,1,1,3.0,70,5.96,42,208,2192,9.5,0.20359826
17687,17687,Mason Raymond,2008-09,23.0,2,21,49,49,9,12,21,80.0,614.0,49,9,12,21,80.0,82,5.44,62,351,2383,9.4,0.41019845
17688,17688,Mason Raymond,2009-10,24.0,3,23,72,72,11,12,23,145.0,987.0,121,20,24,44,225.0,82,5.7,65,341,2477,9.4,0.35851243
17689,17689,Mason Raymond,2010-11,25.0,4,53,82,82,25,28,53,217.0,1421.0,203,45,52,97,442.0,82,5.53,56,304,2486,9.1,0.622083
17690,17690,Mason Raymond,2011-12,26.0,5,39,70,70,15,24,39,197.0,1106.0,273,60,76,136,639.0,82,5.46,52,291,2492,9.0,0.5691919
17691,17691,Mason Raymond,2012-13,27.0,6,20,55,55,10,10,20,125.0,857.0,328,70,86,156,764.0,82,5.32,47,271,2439,8.9,0.40256363
17692,17692,Mason Raymond,2013-14,28.0,7,22,46,46,10,12,22,79.0,728.0,374,80,98,178,843.0,48,5.31,29,160,1399,9.1,0.5013467
17693,17693,Mason Raymond,2014-15,29.0,8,45,82,82,19,26,45,178.0,1421.0,456,99,124,223,1021.0,82,5.34,48,269,2463,8.9,0.51013356
17694,17694,Mason Raymond,2015-16,30.0,9,23,57,57,12,11,23,123.0,844.0,513,111,135,246,1144.0,82,5.32,47,251,2453,8.9,0.3751155
17695,17695,Mason Raymond,2016-17,31.0,10,5,29,29,4,1,5,53.0,358.0,542,115,136,251,1197.0,82,5.34,48,255,2438,9.0,0.2958184
17696,17696,Mason Raymond,2017-18,32.0,11,0,4,4,0,0,0,3.0,36.0,546,115,136,251,1200.0,82,5.45,47,245,2478,9.0,0.20191312
17697,17697,Mat Clark,2012-13,22.0,2,0,2,2,0,0,0,2.0,22.0,2,0,0,0,2.0,82,5.32,47,271,2439,8.9,0.17134002
17698,17698,Mat Clark,2015-16,25.0,3,1,7,7,0,1,1,2.0,89.0,9,0,1,1,4.0,82,5.32,47,251,2453,8.9,0.17249674
17699,17699,Mathew Barzal,2017-18,20.0,2,0,2,2,0,0,0,0.0,20.0,2,0,0,0,0.0,82,5.45,47,245,2478,9.0,0.2782966
17700,17700,Mathew Barzal,2018-19,21.0,3,85,82,82,22,63,85,170.0,1457.0,84,22,63,85,170.0,82,5.86,50,250,2620,9.2,0.9652467
17701,17701,Mathew Barzal,2019-20,22.0,4,62,82,82,18,44,62,179.0,1470.0,166,40,107,147,349.0,82,5.96,47,239,2579,9.5,0.7895347
17702,17702,Mathew Barzal,2020-21,23.0,5,60,68,68,19,41,60,171.0,1363.0,234,59,148,207,520.0,70,5.96,42,208,2192,9.5,0.85567886
17703,17703,Mathew Dumba,2014-15,20.0,2,2,13,13,1,1,2,12.0,162.0,13,1,1,2,12.0,82,5.34,48,269,2463,8.9,0.27081686
17704,17704,Mathew Dumba,2015-16,21.0,3,16,58,58,8,8,16,86.0,871.0,71,9,9,18,98.0,82,5.32,47,251,2453,8.9,0.30877972
17705,17705,Mathew Dumba,2016-17,22.0,4,26,81,81,10,16,26,152.0,1364.0,152,19,25,44,250.0,82,5.34,48,255,2438,9.0,0.39242923
17706,17706,Mathew Dumba,2017-18,23.0,5,34,76,76,11,23,34,131.0,1545.0,228,30,48,78,381.0,82,5.45,47,245,2478,9.0,0.4514019
17707,17707,Mathew Dumba,2018-19,24.0,6,50,82,82,14,36,50,176.0,1953.0,310,44,84,128,557.0,82,5.86,50,250,2620,9.2,0.6206442
17708,17708,Mathew Dumba,2019-20,25.0,7,22,32,32,12,10,22,93.0,748.0,342,56,94,150,650.0,82,5.96,47,239,2579,9.5,0.55054694
17709,17709,Mathew Dumba,2020-21,26.0,8,24,69,69,6,18,24,167.0,1552.0,411,62,112,174,817.0,70,5.96,42,208,2192,9.5,0.40589422
17710,17710,Mathias Johansson,2003-04,29.0,2,15,58,58,5,10,15,70.0,787.0,58,5,10,15,70.0,82,5.31,60,363,2326,9.4,0.24872938
17711,17711,Mathias Tjarnqvist,2004-05,25.0,2,2,18,18,1,1,2,11.0,175.0,18,1,1,2,11.0,82,5.14,57,348,2300,9.2,0.19384077
17712,17712,Mathias Tjarnqvist,2006-07,27.0,3,6,33,33,2,4,6,36.0,269.0,51,3,5,8,47.0,82,6.05,85,480,2458,10.1,0.18970442
17713,17713,Mathias Tjarnqvist,2007-08,28.0,4,13,44,44,6,7,13,44.0,552.0,95,9,12,21,91.0,82,5.76,70,398,2426,9.7,0.22744158
17714,17714,Mathias Tjarnqvist,2008-09,29.0,5,11,78,78,4,7,11,90.0,1064.0,173,13,19,32,181.0,82,5.44,62,351,2383,9.4,0.18147328
17715,17715,Mathieu Biron,2000-01,20.0,2,8,60,60,4,4,8,70.0,902.0,60,4,4,8,70.0,82,5.49,53,331,2294,9.8,0.23558143
17716,17716,Mathieu Biron,2001-02,21.0,3,1,14,14,0,1,1,10.0,173.0,74,4,5,9,80.0,82,5.51,63,376,2272,9.9,0.23573187
17717,17717,Mathieu Biron,2002-03,22.0,4,0,36,36,0,0,0,35.0,532.0,110,4,5,9,115.0,82,5.24,53,338,2262,9.5,0.18791261
17718,17718,Mathieu Biron,2003-04,23.0,5,9,34,34,1,8,9,52.0,719.0,144,5,13,18,167.0,82,5.31,60,363,2326,9.4,0.24767086
17719,17719,Mathieu Biron,2004-05,24.0,6,13,57,57,3,10,13,75.0,1038.0,201,8,23,31,242.0,82,5.14,57,348,2300,9.2,0.25105816
17720,17720,Mathieu Biron,2006-07,26.0,7,13,52,52,4,9,13,61.0,636.0,253,12,32,44,303.0,82,6.05,85,480,2458,10.1,0.20986545
17721,17721,Mathieu Carle,2010-11,23.0,2,0,3,3,0,0,0,2.0,43.0,3,0,0,0,2.0,82,5.53,56,304,2486,9.1,0.17674801
17722,17722,Mathieu Dandenault,1996-97,20.0,2,12,34,34,5,7,12,32.0,,34,5,7,12,32.0,82,6.29,74,413,2481,10.4,0.32786685
17723,17723,Mathieu Dandenault,1997-98,21.0,3,12,65,65,3,9,12,81.0,,99,8,16,24,113.0,82,5.83,55,336,2444,9.8,0.27732846
17724,17724,Mathieu Dandenault,1998-99,22.0,4,17,68,68,5,12,17,75.0,,167,13,28,41,188.0,82,5.28,57,380,2242,9.6,0.26204175
17725,17725,Mathieu Dandenault,1999-00,23.0,5,14,75,75,4,10,14,94.0,1138.0,242,17,38,55,282.0,82,5.27,57,359,2285,9.4,0.2434645
17726,17726,Mathieu Dandenault,2000-01,24.0,6,18,81,81,6,12,18,98.0,986.0,323,23,50,73,380.0,82,5.49,53,331,2294,9.8,0.29341808
17727,17727,Mathieu Dandenault,2001-02,25.0,7,25,73,73,10,15,25,95.0,1175.0,396,33,65,98,475.0,82,5.51,63,376,2272,9.9,0.32060653
17728,17728,Mathieu Dandenault,2002-03,26.0,8,20,81,81,8,12,20,97.0,1354.0,477,41,77,118,572.0,82,5.24,53,338,2262,9.5,0.28973117
17729,17729,Mathieu Dandenault,2003-04,27.0,9,19,74,74,4,15,19,74.0,1415.0,551,45,92,137,646.0,82,5.31,60,363,2326,9.4,0.25777656
17730,17730,Mathieu Dandenault,2004-05,28.0,10,12,65,65,3,9,12,68.0,896.0,616,48,101,149,714.0,82,5.14,57,348,2300,9.2,0.20007208
17731,17731,Mathieu Dandenault,2006-07,30.0,11,20,82,82,5,15,20,101.0,1528.0,698,53,116,169,815.0,82,6.05,85,480,2458,10.1,0.24883237
17732,17732,Mathieu Dandenault,2007-08,31.0,12,8,68,68,2,6,8,54.0,1096.0,766,55,122,177,869.0,82,5.76,70,398,2426,9.7,0.13680547
17733,17733,Mathieu Dandenault,2008-09,32.0,13,14,61,61,9,5,14,69.0,679.0,827,64,127,191,938.0,82,5.44,62,351,2383,9.4,0.20542806
17734,17734,Mathieu Dandenault,2009-10,33.0,14,12,41,41,4,8,12,46.0,482.0,868,68,135,203,984.0,82,5.7,65,341,2477,9.4,0.20514324
17735,17735,Mathieu Darche,2001-02,25.0,2,0,9,9,0,0,0,9.0,91.0,9,0,0,0,9.0,82,5.51,63,376,2272,9.9,0.16200706
17736,17736,Mathieu Darche,2002-03,26.0,3,2,14,14,1,1,2,15.0,138.0,23,1,1,2,24.0,82,5.24,53,338,2262,9.5,0.19413286
17737,17737,Mathieu Darche,2003-04,27.0,4,0,1,1,0,0,0,0.0,7.0,24,1,1,2,24.0,82,5.31,60,363,2326,9.4,0.14526427
17738,17738,Mathieu Darche,2004-05,28.0,5,0,2,2,0,0,0,1.0,13.0,26,1,1,2,25.0,82,5.14,57,348,2300,9.2,0.1378335
17739,17739,Mathieu Darche,2007-08,31.0,6,0,2,2,0,0,0,3.0,18.0,28,1,1,2,28.0,82,5.76,70,398,2426,9.7,0.14225411
17740,17740,Mathieu Darche,2008-09,32.0,7,22,73,73,7,15,22,120.0,1053.0,101,8,16,24,148.0,82,5.44,62,351,2383,9.4,0.26845315
17741,17741,Mathieu Darche,2010-11,34.0,8,10,29,29,5,5,10,43.0,314.0,130,13,21,34,191.0,82,5.53,56,304,2486,9.1,0.21268559
17742,17742,Mathieu Darche,2011-12,35.0,9,26,59,59,12,14,26,90.0,665.0,189,25,35,60,281.0,82,5.46,52,291,2492,9.0,0.3048396
17743,17743,Mathieu Darche,2012-13,36.0,10,12,61,61,5,7,12,77.0,740.0,250,30,42,72,358.0,82,5.32,47,271,2439,8.9,0.21340668
17744,17744,Mathieu Joseph,2019-20,22.0,2,26,70,70,13,13,26,95.0,795.0,70,13,13,26,95.0,82,5.96,47,239,2579,9.5,0.40620628
17745,17745,Mathieu Joseph,2020-21,23.0,3,7,37,37,4,3,7,35.0,426.0,107,17,16,33,130.0,70,5.96,42,208,2192,9.5,0.2776453
17746,17746,Mathieu Olivier,2020-21,23.0,2,1,8,8,0,1,1,6.0,60.0,8,0,1,1,6.0,70,5.96,42,208,2192,9.5,0.21753478
17747,17747,Mathieu Perreault,2010-11,23.0,2,9,21,21,4,5,9,27.0,238.0,21,4,5,9,27.0,82,5.53,56,304,2486,9.1,0.31344983
17748,17748,Mathieu Perreault,2011-12,24.0,3,14,35,35,7,7,14,41.0,416.0,56,11,12,23,68.0,82,5.46,52,291,2492,9.0,0.30515507
17749,17749,Mathieu Perreault,2012-13,25.0,4,30,64,64,16,14,30,60.0,770.0,120,27,26,53,128.0,82,5.32,47,271,2439,8.9,0.4126266
17750,17750,Mathieu Perreault,2013-14,26.0,5,17,39,39,6,11,17,47.0,455.0,159,33,37,70,175.0,48,5.31,29,160,1399,9.1,0.436545
17751,17751,Mathieu Perreault,2014-15,27.0,6,43,69,69,18,25,43,120.0,957.0,228,51,62,113,295.0,82,5.34,48,269,2463,8.9,0.52641153
17752,17752,Mathieu Perreault,2015-16,28.0,7,41,62,62,18,23,41,129.0,1008.0,290,69,85,154,424.0,82,5.32,47,251,2453,8.9,0.58375245
17753,17753,Mathieu Perreault,2016-17,29.0,8,41,71,71,9,32,41,133.0,1175.0,361,78,117,195,557.0,82,5.34,48,255,2438,9.0,0.48808256
17754,17754,Mathieu Perreault,2017-18,30.0,9,45,65,65,13,32,45,134.0,1059.0,426,91,149,240,691.0,82,5.45,47,245,2478,9.0,0.53231764
17755,17755,Mathieu Perreault,2018-19,31.0,10,39,70,70,17,22,39,139.0,1012.0,496,108,171,279,830.0,82,5.86,50,250,2620,9.2,0.4845587
17756,17756,Mathieu Perreault,2019-20,32.0,11,30,82,82,15,15,30,95.0,1003.0,578,123,186,309,925.0,82,5.96,47,239,2579,9.5,0.35931998
17757,17757,Mathieu Perreault,2020-21,33.0,12,15,49,49,7,8,15,71.0,642.0,627,130,194,324,996.0,70,5.96,42,208,2192,9.5,0.33659247
17758,17758,Mathieu Roy,2006-07,23.0,2,0,1,1,0,0,0,0.0,13.0,1,0,0,0,0.0,82,6.05,85,480,2458,10.1,0.15705729
17759,17759,Mathieu Roy,2007-08,24.0,3,2,16,16,2,0,2,18.0,226.0,17,2,0,2,18.0,82,5.76,70,398,2426,9.7,0.21118522
17760,17760,Mathieu Roy,2008-09,25.0,4,1,13,13,0,1,1,8.0,135.0,30,2,1,3,26.0,82,5.44,62,351,2383,9.4,0.16211066
17761,17761,Mathieu Roy,2010-11,27.0,5,10,31,31,0,10,10,32.0,568.0,61,2,11,13,58.0,82,5.53,56,304,2486,9.1,0.16041529
17762,17762,Mathieu Roy,2011-12,28.0,6,0,4,4,0,0,0,1.0,19.0,65,2,11,13,59.0,82,5.46,52,291,2492,9.0,0.12501788
17763,17763,Mathieu Roy,2013-14,30.0,7,0,1,1,0,0,0,0.0,14.0,66,2,11,13,59.0,48,5.31,29,160,1399,9.1,0.13583606
17764,17764,Mathieu Schneider,1988-89,19.0,2,0,4,4,0,0,0,2.0,,4,0,0,0,2.0,80,7.43,89,437,2435,12.2,0.27700788
17765,17765,Mathieu Schneider,1990-91,21.0,3,21,44,44,7,14,21,84.0,,48,7,14,21,86.0,80,7.37,76,367,2421,12.2,0.463074
17766,17766,Mathieu Schneider,1991-92,22.0,4,30,69,69,10,20,30,164.0,,117,17,34,51,250.0,80,6.91,71,366,2385,11.6,0.5200952
17767,17767,Mathieu Schneider,1992-93,23.0,5,32,78,78,8,24,32,194.0,,195,25,58,83,444.0,80,6.96,77,402,2440,11.4,0.53091633
17768,17768,Mathieu Schneider,1993-94,24.0,6,44,60,60,13,31,44,169.0,,255,38,89,127,613.0,84,7.25,87,443,2603,11.7,0.6233242
17769,17769,Mathieu Schneider,1994-95,25.0,7,52,75,75,20,32,52,193.0,,330,58,121,179,806.0,84,6.48,76,407,2545,10.7,0.58256805
17770,17770,Mathieu Schneider,1995-96,26.0,8,29,43,43,8,21,29,118.0,,373,66,142,208,924.0,48,5.97,37,209,1408,10.2,0.6508275
17771,17771,Mathieu Schneider,1996-97,27.0,9,54,78,78,13,41,54,191.0,,451,79,183,262,1115.0,82,6.29,74,413,2481,10.4,0.6017705
17772,17772,Mathieu Schneider,1997-98,28.0,10,12,26,26,5,7,12,63.0,,477,84,190,274,1178.0,82,5.83,55,336,2444,9.8,0.41243595
17773,17773,Mathieu Schneider,1998-99,29.0,11,37,76,76,11,26,37,181.0,,553,95,216,311,1359.0,82,5.28,57,380,2242,9.6,0.529595
17774,17774,Mathieu Schneider,1999-00,30.0,12,34,75,75,10,24,34,159.0,1844.0,628,105,240,345,1518.0,82,5.27,57,359,2285,9.4,0.44757476
17775,17775,Mathieu Schneider,2000-01,31.0,13,30,80,80,10,20,30,228.0,1801.0,708,115,260,375,1746.0,82,5.49,53,331,2294,9.8,0.45268422
17776,17776,Mathieu Schneider,2001-02,32.0,14,51,73,73,16,35,51,183.0,1684.0,781,131,295,426,1929.0,82,5.51,63,376,2272,9.9,0.591204
17777,17777,Mathieu Schneider,2002-03,33.0,15,30,55,55,7,23,30,123.0,1233.0,836,138,318,456,2052.0,82,5.24,53,338,2262,9.5,0.51196426
17778,17778,Mathieu Schneider,2003-04,34.0,16,50,78,78,16,34,50,199.0,1747.0,914,154,352,506,2251.0,82,5.31,60,363,2326,9.4,0.5573977
17779,17779,Mathieu Schneider,2004-05,35.0,17,46,78,78,14,32,46,165.0,1910.0,992,168,384,552,2416.0,82,5.14,57,348,2300,9.2,0.6651075
17780,17780,Mathieu Schneider,2006-07,37.0,18,59,72,72,21,38,59,188.0,1765.0,1064,189,422,611,2604.0,82,6.05,85,480,2458,10.1,0.6854226
17781,17781,Mathieu Schneider,2007-08,38.0,19,52,68,68,11,41,52,184.0,1603.0,1132,200,463,663,2788.0,82,5.76,70,398,2426,9.7,0.6141254
17782,17782,Mathieu Schneider,2008-09,39.0,20,39,65,65,12,27,39,139.0,1449.0,1197,212,490,702,2927.0,82,5.44,62,351,2383,9.4,0.49019012
17783,17783,Mathieu Schneider,2009-10,40.0,21,32,67,67,9,23,32,128.0,1407.0,1264,221,513,734,3055.0,82,5.7,65,341,2477,9.4,0.37270606
17784,17784,Mathieu Schneider,2010-11,41.0,22,9,25,25,2,7,9,37.0,426.0,1289,223,520,743,3092.0,82,5.53,56,304,2486,9.1,0.36667505
17785,17785,Mats Hallin,1983-84,25.0,2,14,30,30,7,7,14,37.0,,30,7,7,14,37.0,80,7.73,71,310,2444,12.7,0.36839467
17786,17786,Mats Hallin,1984-85,26.0,3,7,40,40,2,5,7,32.0,,70,9,12,21,69.0,80,7.89,74,336,2448,12.9,0.19878447
17787,17787,Mats Hallin,1985-86,27.0,4,5,38,38,5,0,5,22.0,,108,14,12,26,91.0,80,7.77,71,321,2447,12.7,0.22620612
17788,17788,Mats Hallin,1986-87,28.0,5,5,38,38,3,2,5,29.0,,146,17,14,31,120.0,80,7.94,82,370,2484,12.8,0.15333858
17789,17789,Mats Hallin,1987-88,29.0,6,0,6,6,0,0,0,5.0,,152,17,14,31,125.0,80,7.34,72,344,2400,12.2,0.16795954
17790,17790,Mats Lindgren,1997-98,23.0,2,25,69,69,11,14,25,71.0,,69,11,14,25,71.0,82,5.83,55,336,2444,9.8,0.34181178
17791,17791,Mats Lindgren,1998-99,24.0,3,26,82,82,13,13,26,131.0,,151,24,27,51,202.0,82,5.28,57,380,2242,9.6,0.38282713
17792,17792,Mats Lindgren,1999-00,25.0,4,25,60,60,10,15,25,83.0,794.0,211,34,42,76,285.0,82,5.27,57,359,2285,9.4,0.38392612
17793,17793,Mats Lindgren,2000-01,26.0,5,16,43,43,9,7,16,68.0,829.0,254,43,49,92,353.0,82,5.49,53,331,2294,9.8,0.37038088
17794,17794,Mats Lindgren,2001-02,27.0,6,7,20,20,3,4,7,34.0,305.0,274,46,53,99,387.0,82,5.51,63,376,2272,9.9,0.3055339
17795,17795,Mats Lindgren,2002-03,28.0,7,15,59,59,3,12,15,35.0,493.0,333,49,65,114,422.0,82,5.24,53,338,2262,9.5,0.22419474
17796,17796,Mats Lindgren,2003-04,29.0,8,14,54,54,5,9,14,51.0,751.0,387,54,74,128,473.0,82,5.31,60,363,2326,9.4,0.24206403
17797,17797,Mats Naslund,1983-84,24.0,2,71,74,74,26,45,71,122.0,,74,26,45,71,122.0,80,7.73,71,310,2444,12.7,0.8338431
17798,17798,Mats Naslund,1984-85,25.0,3,64,77,77,29,35,64,146.0,,151,55,80,135,268.0,80,7.89,74,336,2448,12.9,0.7492482
17799,17799,Mats Naslund,1985-86,26.0,4,79,80,80,42,37,79,179.0,,231,97,117,214,447.0,80,7.77,71,321,2447,12.7,0.97779953
17800,17800,Mats Naslund,1986-87,27.0,5,110,80,80,43,67,110,225.0,,311,140,184,324,672.0,80,7.94,82,370,2484,12.8,1.1253688
17801,17801,Mats Naslund,1987-88,28.0,6,80,79,79,25,55,80,172.0,,390,165,239,404,844.0,80,7.34,72,344,2400,12.2,0.9644791
17802,17802,Mats Naslund,1988-89,29.0,7,83,78,78,24,59,83,167.0,,468,189,298,487,1011.0,80,7.43,89,437,2435,12.2,0.9326436
17803,17803,Mats Naslund,1989-90,30.0,8,84,77,77,33,51,84,165.0,,545,222,349,571,1176.0,80,7.48,85,403,2430,12.3,0.97344065
17804,17804,Mats Naslund,1990-91,31.0,9,41,72,72,21,20,41,136.0,,617,243,369,612,1312.0,80,7.37,76,367,2421,12.2,0.571029
17805,17805,Mats Naslund,1995-96,36.0,10,22,34,34,8,14,22,48.0,,651,251,383,634,1360.0,48,5.97,37,209,1408,10.2,0.5726667
17806,17806,Mats Sundin,1991-92,20.0,2,59,80,80,23,36,59,155.0,,80,23,36,59,155.0,80,6.91,71,366,2385,11.6,0.7682549
17807,17807,Mats Sundin,1992-93,21.0,3,76,80,80,33,43,76,231.0,,160,56,79,135,386.0,80,6.96,77,402,2440,11.4,1.0020894
17808,17808,Mats Sundin,1993-94,22.0,4,114,80,80,47,67,114,215.0,,240,103,146,249,601.0,84,7.25,87,443,2603,11.7,1.2136838
17809,17809,Mats Sundin,1994-95,23.0,5,85,84,84,32,53,85,226.0,,324,135,199,334,827.0,84,6.48,76,407,2545,10.7,1.0132552
17810,17810,Mats Sundin,1995-96,24.0,6,47,47,47,23,24,47,173.0,,371,158,223,381,1000.0,48,5.97,37,209,1408,10.2,1.1087353
17811,17811,Mats Sundin,1996-97,25.0,7,83,76,76,33,50,83,301.0,,447,191,273,464,1301.0,82,6.29,74,413,2481,10.4,0.95926833
17812,17812,Mats Sundin,1997-98,26.0,8,94,82,82,41,53,94,281.0,,529,232,326,558,1582.0,82,5.83,55,336,2444,9.8,1.0555334
17813,17813,Mats Sundin,1998-99,27.0,9,74,82,82,33,41,74,219.0,,611,265,367,632,1801.0,82,5.28,57,380,2242,9.6,0.88908243
17814,17814,Mats Sundin,1999-00,28.0,10,83,82,82,31,52,83,209.0,1696.0,693,296,419,715,2010.0,82,5.27,57,359,2285,9.4,0.93378234
17815,17815,Mats Sundin,2000-01,29.0,11,73,73,73,32,41,73,184.0,1473.0,766,328,460,788,2194.0,82,5.49,53,331,2294,9.8,0.9092233
17816,17816,Mats Sundin,2001-02,30.0,12,74,82,82,28,46,74,226.0,1587.0,848,356,506,862,2420.0,82,5.51,63,376,2272,9.9,0.87016463
17817,17817,Mats Sundin,2002-03,31.0,13,80,82,82,41,39,80,262.0,1585.0,930,397,545,942,2682.0,82,5.24,53,338,2262,9.5,0.9390502
17818,17818,Mats Sundin,2003-04,32.0,14,72,75,75,37,35,72,223.0,1519.0,1005,434,580,1014,2905.0,82,5.31,60,363,2326,9.4,0.8535861
17819,17819,Mats Sundin,2004-05,33.0,15,75,81,81,31,44,75,226.0,1609.0,1086,465,624,1089,3131.0,82,5.14,57,348,2300,9.2,0.9920613
17820,17820,Mats Sundin,2006-07,35.0,16,78,70,70,31,47,78,220.0,1399.0,1156,496,671,1167,3351.0,82,6.05,85,480,2458,10.1,0.87112063
17821,17821,Mats Sundin,2007-08,36.0,17,76,75,75,27,49,76,321.0,1535.0,1231,523,720,1243,3672.0,82,5.76,70,398,2426,9.7,0.85403466
17822,17822,Mats Sundin,2008-09,37.0,18,78,74,74,32,46,78,259.0,1485.0,1305,555,766,1321,3931.0,82,5.44,62,351,2383,9.4,0.7945715
17823,17823,Mats Sundin,2009-10,38.0,19,28,41,41,9,19,28,84.0,691.0,1346,564,785,1349,4015.0,82,5.7,65,341,2477,9.4,0.5898932
17824,17824,Mats Thelin,1985-86,24.0,2,18,73,73,5,13,18,91.0,,73,5,13,18,91.0,80,7.77,71,321,2447,12.7,0.2932587
17825,17825,Mats Thelin,1986-87,25.0,3,5,31,31,2,3,5,29.0,,104,7,16,23,120.0,80,7.94,82,370,2484,12.8,0.25941378
17826,17826,Mats Thelin,1987-88,26.0,4,4,59,59,1,3,4,41.0,,163,8,19,27,161.0,80,7.34,72,344,2400,12.2,0.18484882
17827,17827,Mats Zuccarello,2011-12,24.0,2,23,42,42,6,17,23,74.0,595.0,42,6,17,23,74.0,82,5.46,52,291,2492,9.0,0.41323256
17828,17828,Mats Zuccarello,2012-13,25.0,3,3,10,10,2,1,3,10.0,100.0,52,8,18,26,84.0,82,5.32,47,271,2439,8.9,0.25788662
17829,17829,Mats Zuccarello,2013-14,26.0,4,8,15,15,3,5,8,27.0,246.0,67,11,23,34,111.0,48,5.31,29,160,1399,9.1,0.3741719
17830,17830,Mats Zuccarello,2014-15,27.0,5,59,77,77,19,40,59,170.0,1320.0,144,30,63,93,281.0,82,5.34,48,269,2463,8.9,0.6209081
17831,17831,Mats Zuccarello,2015-16,28.0,6,49,78,78,15,34,49,154.0,1346.0,222,45,97,142,435.0,82,5.32,47,251,2453,8.9,0.56180704
17832,17832,Mats Zuccarello,2016-17,29.0,7,61,81,81,26,35,61,166.0,1497.0,303,71,132,203,601.0,82,5.34,48,255,2438,9.0,0.681804
17833,17833,Mats Zuccarello,2017-18,30.0,8,59,80,80,15,44,59,189.0,1506.0,383,86,176,262,790.0,82,5.45,47,245,2478,9.0,0.6559694
17834,17834,Mats Zuccarello,2018-19,31.0,9,53,80,80,16,37,53,178.0,1514.0,463,102,213,315,968.0,82,5.86,50,250,2620,9.2,0.6663858
17835,17835,Mats Zuccarello,2019-20,32.0,10,40,48,48,12,28,40,104.0,953.0,511,114,241,355,1072.0,82,5.96,47,239,2579,9.5,0.6531847
17836,17836,Mats Zuccarello,2020-21,33.0,11,37,65,65,15,22,37,96.0,1036.0,576,129,263,392,1168.0,70,5.96,42,208,2192,9.5,0.48767385
17837,17837,Matt Anderson,2013-14,31.0,2,1,2,2,0,1,1,0.0,12.0,2,0,1,1,0.0,48,5.31,29,160,1399,9.1,0.1913867
17838,17838,Matt Bartkowski,2011-12,23.0,2,0,6,6,0,0,0,2.0,55.0,6,0,0,0,2.0,82,5.46,52,291,2492,9.0,0.17343244
17839,17839,Matt Bartkowski,2012-13,24.0,3,0,3,3,0,0,0,0.0,18.0,9,0,0,0,2.0,82,5.32,47,271,2439,8.9,0.14646494
17840,17840,Matt Bartkowski,2013-14,25.0,4,2,11,11,0,2,2,9.0,148.0,20,0,2,2,11.0,48,5.31,29,160,1399,9.1,0.19430923
17841,17841,Matt Bartkowski,2014-15,26.0,5,18,64,64,0,18,18,91.0,1250.0,84,0,20,20,102.0,82,5.34,48,269,2463,8.9,0.23034802
17842,17842,Matt Bartkowski,2015-16,27.0,6,4,47,47,0,4,4,67.0,796.0,131,0,24,24,169.0,82,5.32,47,251,2453,8.9,0.14226878
17843,17843,Matt Bartkowski,2016-17,28.0,7,18,80,80,6,12,18,85.0,1490.0,211,6,36,42,254.0,82,5.34,48,255,2438,9.0,0.2224904
17844,17844,Matt Bartkowski,2017-18,29.0,8,2,24,24,1,1,2,16.0,369.0,235,7,37,44,270.0,82,5.45,47,245,2478,9.0,0.13600081
17845,17845,Matt Bartkowski,2018-19,30.0,9,3,18,18,0,3,3,21.0,240.0,253,7,40,47,291.0,82,5.86,50,250,2620,9.2,0.17841646
17846,17846,Matt Bartkowski,2019-20,31.0,10,1,2,2,1,0,1,2.0,21.0,255,8,40,48,293.0,82,5.96,47,239,2579,9.5,0.18842942
17847,17847,Matt Beleskey,2009-10,21.0,2,0,2,2,0,0,0,0.0,22.0,2,0,0,0,0.0,82,5.7,65,341,2477,9.4,0.20099464
17848,17848,Matt Beleskey,2010-11,22.0,3,18,60,60,11,7,18,123.0,839.0,62,11,7,18,123.0,82,5.53,56,304,2486,9.1,0.3423248
17849,17849,Matt Beleskey,2011-12,23.0,4,10,35,35,3,7,10,58.0,454.0,97,14,14,28,181.0,82,5.46,52,291,2492,9.0,0.2919242
17850,17850,Matt Beleskey,2012-13,24.0,5,15,70,70,4,11,15,75.0,719.0,167,18,25,43,256.0,82,5.32,47,271,2439,8.9,0.21766645
17851,17851,Matt Beleskey,2013-14,25.0,6,13,42,42,8,5,13,61.0,505.0,209,26,30,56,317.0,48,5.31,29,160,1399,9.1,0.31735483
17852,17852,Matt Beleskey,2014-15,26.0,7,24,55,55,9,15,24,112.0,684.0,264,35,45,80,429.0,82,5.34,48,269,2463,8.9,0.38504887
17853,17853,Matt Beleskey,2015-16,27.0,8,32,65,65,22,10,32,145.0,941.0,329,57,55,112,574.0,82,5.32,47,251,2453,8.9,0.45074642
17854,17854,Matt Beleskey,2016-17,28.0,9,37,80,80,15,22,37,168.0,1269.0,409,72,77,149,742.0,82,5.34,48,255,2438,9.0,0.41481546
17855,17855,Matt Beleskey,2017-18,29.0,10,8,49,49,3,5,8,79.0,650.0,458,75,82,157,821.0,82,5.45,47,245,2478,9.0,0.25156748
17856,17856,Matt Beleskey,2018-19,30.0,11,0,15,15,0,0,0,17.0,165.0,473,75,82,157,838.0,82,5.86,50,250,2620,9.2,0.22395003
17857,17857,Matt Beleskey,2019-20,31.0,12,1,4,4,1,0,1,3.0,29.0,477,76,82,158,841.0,82,5.96,47,239,2579,9.5,0.18625781
17858,17858,Matt Benning,2017-18,23.0,2,15,62,62,3,12,15,69.0,1030.0,62,3,12,15,69.0,82,5.45,47,245,2478,9.0,0.2310293
17859,17859,Matt Benning,2018-19,24.0,3,21,73,73,6,15,21,111.0,1262.0,135,9,27,36,180.0,82,5.86,50,250,2620,9.2,0.29234374
17860,17860,Matt Benning,2019-20,25.0,4,17,70,70,5,12,17,94.0,1046.0,205,14,39,53,274.0,82,5.96,47,239,2579,9.5,0.254178
17861,17861,Matt Benning,2020-21,26.0,5,8,43,43,1,7,8,38.0,569.0,248,15,46,61,312.0,70,5.96,42,208,2192,9.5,0.20924073
17862,17862,Matt Bradley,2001-02,23.0,2,2,21,21,1,1,2,16.0,146.0,21,1,1,2,16.0,82,5.51,63,376,2272,9.9,0.1700362
17863,17863,Matt Bradley,2002-03,24.0,3,22,54,54,9,13,22,63.0,457.0,75,10,14,24,79.0,82,5.24,53,338,2262,9.5,0.3456987
17864,17864,Matt Bradley,2003-04,25.0,4,5,46,46,2,3,5,21.0,363.0,121,12,17,29,100.0,82,5.31,60,363,2326,9.4,0.14197162
17865,17865,Matt Bradley,2004-05,26.0,5,16,82,82,7,9,16,85.0,1049.0,203,19,26,45,185.0,82,5.14,57,348,2300,9.2,0.255481
17866,17866,Matt Bradley,2006-07,28.0,6,19,74,74,7,12,19,87.0,932.0,277,26,38,64,272.0,82,6.05,85,480,2458,10.1,0.25086668
17867,17867,Matt Bradley,2007-08,29.0,7,13,57,57,4,9,13,77.0,679.0,334,30,47,77,349.0,82,5.76,70,398,2426,9.7,0.21255791
17868,17868,Matt Bradley,2008-09,30.0,8,18,77,77,7,11,18,111.0,770.0,411,37,58,95,460.0,82,5.44,62,351,2383,9.4,0.23413828
17869,17869,Matt Bradley,2009-10,31.0,9,11,81,81,5,6,11,98.0,859.0,492,42,64,106,558.0,82,5.7,65,341,2477,9.4,0.21618605
17870,17870,Matt Bradley,2010-11,32.0,10,24,77,77,10,14,24,98.0,849.0,569,52,78,130,656.0,82,5.53,56,304,2486,9.1,0.26191798
17871,17871,Matt Bradley,2011-12,33.0,11,11,61,61,4,7,11,58.0,640.0,630,56,85,141,714.0,82,5.46,52,291,2492,9.0,0.15162584
17872,17872,Matt Bradley,2012-13,34.0,12,8,45,45,3,5,8,35.0,489.0,675,59,90,149,749.0,82,5.32,47,271,2439,8.9,0.13370809
17873,17873,Matt Calvert,2011-12,22.0,2,20,42,42,11,9,20,50.0,466.0,42,11,9,20,50.0,82,5.46,52,291,2492,9.0,0.38143393
17874,17874,Matt Calvert,2012-13,23.0,3,3,13,13,0,3,3,4.0,119.0,55,11,12,23,54.0,82,5.32,47,271,2439,8.9,0.25574988
17875,17875,Matt Calvert,2013-14,24.0,4,16,42,42,9,7,16,63.0,596.0,97,20,19,39,117.0,48,5.31,29,160,1399,9.1,0.41674927
17876,17876,Matt Calvert,2014-15,25.0,5,24,56,56,9,15,24,90.0,902.0,153,29,34,63,207.0,82,5.34,48,269,2463,8.9,0.36860073
17877,17877,Matt Calvert,2015-16,26.0,6,23,56,56,13,10,23,93.0,896.0,209,42,44,86,300.0,82,5.32,47,251,2453,8.9,0.3696497
17878,17878,Matt Calvert,2016-17,27.0,7,24,73,73,11,13,24,114.0,1104.0,282,53,57,110,414.0,82,5.34,48,255,2438,9.0,0.2948795
17879,17879,Matt Calvert,2017-18,28.0,8,15,65,65,10,5,15,92.0,868.0,347,63,62,125,506.0,82,5.45,47,245,2478,9.0,0.27813536
17880,17880,Matt Calvert,2018-19,29.0,9,24,69,69,9,15,24,108.0,923.0,416,72,77,149,614.0,82,5.86,50,250,2620,9.2,0.29693526
17881,17881,Matt Calvert,2019-20,30.0,10,26,82,82,11,15,26,141.0,1164.0,498,83,92,175,755.0,82,5.96,47,239,2579,9.5,0.33016703
17882,17882,Matt Calvert,2020-21,31.0,11,25,50,50,12,13,25,89.0,705.0,548,95,105,200,844.0,70,5.96,42,208,2192,9.5,0.43557158
17883,17883,Matt Campanale,2011-12,23.0,2,0,1,1,0,0,0,0.0,8.0,1,0,0,0,0.0,82,5.46,52,291,2492,9.0,0.15535027
17884,17884,Matt Carey,2014-15,22.0,2,1,2,2,1,0,1,1.0,19.0,2,1,0,1,1.0,82,5.34,48,269,2463,8.9,0.28137243
17885,17885,Matt Carkner,2006-07,26.0,2,1,1,1,0,1,1,0.0,6.0,1,0,1,1,0.0,82,6.05,85,480,2458,10.1,0.16025722
17886,17886,Matt Carkner,2009-10,29.0,3,0,1,1,0,0,0,0.0,4.0,2,0,1,1,0.0,82,5.7,65,341,2477,9.4,0.15495202
17887,17887,Matt Carkner,2010-11,30.0,4,11,81,81,2,9,11,87.0,1370.0,83,2,10,12,87.0,82,5.53,56,304,2486,9.1,0.17037728
17888,17888,Matt Carkner,2011-12,31.0,5,7,50,50,1,6,7,40.0,744.0,133,3,16,19,127.0,82,5.46,52,291,2492,9.0,0.1087468
17889,17889,Matt Carkner,2012-13,32.0,6,3,29,29,1,2,3,17.0,345.0,162,4,18,22,144.0,82,5.32,47,271,2439,8.9,0.11353049
17890,17890,Matt Carkner,2013-14,33.0,7,2,22,22,0,2,2,19.0,277.0,184,4,20,24,163.0,48,5.31,29,160,1399,9.1,0.12702101
17891,17891,Matt Carkner,2014-15,34.0,8,3,53,53,0,3,3,50.0,635.0,237,4,23,27,213.0,82,5.34,48,269,2463,8.9,0.11141136
17892,17892,Matt Carle,2006-07,22.0,2,6,12,12,3,3,6,11.0,193.0,12,3,3,6,11.0,82,6.05,85,480,2458,10.1,0.2861836
17893,17893,Matt Carle,2007-08,23.0,3,42,77,77,11,31,42,111.0,1397.0,89,14,34,48,122.0,82,5.76,70,398,2426,9.7,0.4743732
17894,17894,Matt Carle,2008-09,24.0,4,15,62,62,2,13,15,63.0,1026.0,151,16,47,63,185.0,82,5.44,62,351,2383,9.4,0.24142602
17895,17895,Matt Carle,2009-10,25.0,5,26,76,76,5,21,26,85.0,1626.0,227,21,68,89,270.0,82,5.7,65,341,2477,9.4,0.32631636
17896,17896,Matt Carle,2010-11,26.0,6,35,80,80,6,29,35,137.0,1871.0,307,27,97,124,407.0,82,5.53,56,304,2486,9.1,0.43960553
17897,17897,Matt Carle,2011-12,27.0,7,40,82,82,1,39,40,117.0,1803.0,389,28,136,164,524.0,82,5.46,52,291,2492,9.0,0.46511057
17898,17898,Matt Carle,2012-13,28.0,8,38,82,82,4,34,38,132.0,1888.0,471,32,170,202,656.0,82,5.32,47,271,2439,8.9,0.42492503
17899,17899,Matt Carle,2013-14,29.0,9,22,48,48,5,17,22,66.0,1140.0,519,37,187,224,722.0,48,5.31,29,160,1399,9.1,0.4185734
17900,17900,Matt Carle,2014-15,30.0,10,31,82,82,2,29,31,115.0,1819.0,601,39,216,255,837.0,82,5.34,48,269,2463,8.9,0.34322506
17901,17901,Matt Carle,2015-16,31.0,11,18,59,59,4,14,18,73.0,1209.0,660,43,230,273,910.0,82,5.32,47,251,2453,8.9,0.27552897
17902,17902,Matt Carle,2016-17,32.0,12,9,64,64,2,7,9,54.0,1074.0,724,45,237,282,964.0,82,5.34,48,255,2438,9.0,0.16227305
17903,17903,Matt Carle,2017-18,33.0,13,1,6,6,0,1,1,2.0,79.0,730,45,238,283,966.0,82,5.45,47,245,2478,9.0,0.19133162
17904,17904,Matt Cooke,1999-00,21.0,2,2,30,30,0,2,2,22.0,244.0,30,0,2,2,22.0,82,5.27,57,359,2285,9.4,0.20243743
17905,17905,Matt Cooke,2000-01,22.0,3,12,51,51,5,7,12,58.0,602.0,81,5,9,14,80.0,82,5.49,53,331,2294,9.8,0.25415385
17906,17906,Matt Cooke,2001-02,23.0,4,27,81,81,14,13,27,121.0,1181.0,162,19,22,41,201.0,82,5.51,63,376,2272,9.9,0.37260607
17907,17907,Matt Cooke,2002-03,24.0,5,33,82,82,13,20,33,103.0,1153.0,244,32,42,74,304.0,82,5.24,53,338,2262,9.5,0.4608939
17908,17908,Matt Cooke,2003-04,25.0,6,42,82,82,15,27,42,118.0,1098.0,326,47,69,116,422.0,82,5.31,60,363,2326,9.4,0.47289497
17909,17909,Matt Cooke,2004-05,26.0,7,23,53,53,11,12,23,79.0,747.0,379,58,81,139,501.0,82,5.14,57,348,2300,9.2,0.456504
17910,17910,Matt Cooke,2006-07,28.0,8,18,45,45,8,10,18,67.0,628.0,424,66,91,157,568.0,82,6.05,85,480,2458,10.1,0.37778252
17911,17911,Matt Cooke,2007-08,29.0,9,30,81,81,10,20,30,133.0,1264.0,505,76,111,187,701.0,82,5.76,70,398,2426,9.7,0.38691175
17912,17912,Matt Cooke,2008-09,30.0,10,23,78,78,10,13,23,86.0,1027.0,583,86,124,210,787.0,82,5.44,62,351,2383,9.4,0.27610525
17913,17913,Matt Cooke,2009-10,31.0,11,31,76,76,13,18,31,86.0,1080.0,659,99,142,241,873.0,82,5.7,65,341,2477,9.4,0.33533984
17914,17914,Matt Cooke,2010-11,32.0,12,30,79,79,15,15,30,105.0,1168.0,738,114,157,271,978.0,82,5.53,56,304,2486,9.1,0.3264233
17915,17915,Matt Cooke,2011-12,33.0,13,30,67,67,12,18,30,95.0,1048.0,805,126,175,301,1073.0,82,5.46,52,291,2492,9.0,0.3247084
17916,17916,Matt Cooke,2012-13,34.0,14,38,82,82,19,19,38,147.0,1286.0,887,145,194,339,1220.0,82,5.32,47,271,2439,8.9,0.399281
17917,17917,Matt Cooke,2013-14,35.0,15,21,48,48,8,13,21,61.0,706.0,935,153,207,360,1281.0,48,5.31,29,160,1399,9.1,0.34134847
17918,17918,Matt Cooke,2014-15,36.0,16,28,82,82,10,18,28,104.0,1263.0,1017,163,225,388,1385.0,82,5.34,48,269,2463,8.9,0.26374856
17919,17919,Matt Cooke,2015-16,37.0,17,10,29,29,4,6,10,24.0,365.0,1046,167,231,398,1409.0,82,5.32,47,251,2453,8.9,0.23653829
17920,17920,Matt Cullen,1998-99,22.0,2,27,61,61,6,21,27,75.0,,61,6,21,27,75.0,82,5.28,57,380,2242,9.6,0.4238213
17921,17921,Matt Cullen,1999-00,23.0,3,25,75,75,11,14,25,112.0,1164.0,136,17,35,52,187.0,82,5.27,57,359,2285,9.4,0.3891496
17922,17922,Matt Cullen,2000-01,24.0,4,39,80,80,13,26,39,137.0,1352.0,216,30,61,91,324.0,82,5.49,53,331,2294,9.8,0.50824404
17923,17923,Matt Cullen,2001-02,25.0,5,40,82,82,10,30,40,159.0,1496.0,298,40,91,131,483.0,82,5.51,63,376,2272,9.9,0.5161794
17924,17924,Matt Cullen,2002-03,26.0,6,48,79,79,18,30,48,164.0,1344.0,377,58,121,179,647.0,82,5.24,53,338,2262,9.5,0.6163072
17925,17925,Matt Cullen,2003-04,27.0,7,33,80,80,13,20,33,131.0,1157.0,457,71,141,212,778.0,82,5.31,60,363,2326,9.4,0.46171317
17926,17926,Matt Cullen,2004-05,28.0,8,19,56,56,6,13,19,75.0,795.0,513,77,154,231,853.0,82,5.14,57,348,2300,9.2,0.4119382
17927,17927,Matt Cullen,2006-07,30.0,9,49,78,78,25,24,49,214.0,1282.0,591,102,178,280,1067.0,82,6.05,85,480,2458,10.1,0.5808668
17928,17928,Matt Cullen,2007-08,31.0,10,41,80,80,16,25,41,217.0,1373.0,671,118,203,321,1284.0,82,5.76,70,398,2426,9.7,0.5253759
17929,17929,Matt Cullen,2008-09,32.0,11,49,59,59,13,36,49,137.0,996.0,730,131,239,370,1421.0,82,5.44,62,351,2383,9.4,0.6636501
17930,17930,Matt Cullen,2009-10,33.0,12,43,69,69,22,21,43,139.0,1159.0,799,153,260,413,1560.0,82,5.7,65,341,2477,9.4,0.5575244
17931,17931,Matt Cullen,2010-11,34.0,13,48,81,81,16,32,48,195.0,1519.0,880,169,292,461,1755.0,82,5.53,56,304,2486,9.1,0.55728436
17932,17932,Matt Cullen,2011-12,35.0,14,39,78,78,12,27,39,150.0,1406.0,958,181,319,500,1905.0,82,5.46,52,291,2492,9.0,0.43058178
17933,17933,Matt Cullen,2012-13,36.0,15,35,73,73,14,21,35,164.0,1382.0,1031,195,340,535,2069.0,82,5.32,47,271,2439,8.9,0.39839393
17934,17934,Matt Cullen,2013-14,37.0,16,27,42,42,7,20,27,79.0,667.0,1073,202,360,562,2148.0,48,5.31,29,160,1399,9.1,0.54960567
17935,17935,Matt Cullen,2014-15,38.0,17,39,77,77,10,29,39,134.0,1193.0,1150,212,389,601,2282.0,82,5.34,48,269,2463,8.9,0.38942322
17936,17936,Matt Cullen,2015-16,39.0,18,25,62,62,7,18,25,90.0,807.0,1212,219,407,626,2372.0,82,5.32,47,251,2453,8.9,0.31642163
17937,17937,Matt Cullen,2016-17,40.0,19,32,82,82,16,16,32,118.0,1138.0,1294,235,423,658,2490.0,82,5.34,48,255,2438,9.0,0.3700384
17938,17938,Matt Cullen,2017-18,41.0,20,31,72,72,13,18,31,93.0,1002.0,1366,248,441,689,2583.0,82,5.45,47,245,2478,9.0,0.36183476
17939,17939,Matt Cullen,2018-19,42.0,21,22,79,79,11,11,22,104.0,939.0,1445,259,452,711,2687.0,82,5.86,50,250,2620,9.2,0.28847432
17940,17940,Matt Cullen,2019-20,43.0,22,20,71,71,7,13,20,87.0,817.0,1516,266,465,731,2774.0,82,5.96,47,239,2579,9.5,0.27745456
17941,17941,Matt D'Agostini,2008-09,22.0,2,0,1,1,0,0,0,0.0,9.0,1,0,0,0,0.0,82,5.44,62,351,2383,9.4,0.17280087
17942,17942,Matt D'Agostini,2009-10,23.0,3,21,53,53,12,9,21,116.0,711.0,54,12,9,21,116.0,82,5.7,65,341,2477,9.4,0.42873618
17943,17943,Matt D'Agostini,2010-11,24.0,4,4,47,47,2,2,4,54.0,460.0,101,14,11,25,170.0,82,5.53,56,304,2486,9.1,0.212167
17944,17944,Matt D'Agostini,2011-12,25.0,5,46,82,82,21,25,46,163.0,1210.0,183,35,36,71,333.0,82,5.46,52,291,2492,9.0,0.5247217
17945,17945,Matt D'Agostini,2012-13,26.0,6,18,55,55,9,9,18,101.0,771.0,238,44,45,89,434.0,82,5.32,47,271,2439,8.9,0.34965035
17946,17946,Matt D'Agostini,2013-14,27.0,7,6,29,29,3,3,6,33.0,357.0,267,47,48,95,467.0,48,5.31,29,160,1399,9.1,0.26468626
17947,17947,Matt D'Agostini,2014-15,28.0,8,12,57,57,5,7,12,110.0,847.0,324,52,55,107,577.0,82,5.34,48,269,2463,8.9,0.251089
17948,17948,Matt Davidson,2001-02,24.0,2,0,5,5,0,0,0,2.0,36.0,5,0,0,0,2.0,82,5.51,63,376,2272,9.9,0.16199553
17949,17949,Matt Davidson,2002-03,25.0,3,3,17,17,1,2,3,18.0,248.0,22,1,2,3,20.0,82,5.24,53,338,2262,9.5,0.19174716
17950,17950,Matt Davidson,2003-04,26.0,4,9,34,34,4,5,9,28.0,402.0,56,5,7,12,48.0,82,5.31,60,363,2326,9.4,0.20762607
17951,17951,Matt Donovan,2012-13,22.0,2,0,3,3,0,0,0,6.0,56.0,3,0,0,0,6.0,82,5.32,47,271,2439,8.9,0.18205357
17952,17952,Matt Donovan,2014-15,24.0,3,16,52,52,2,14,16,86.0,940.0,55,2,14,16,92.0,82,5.34,48,269,2463,8.9,0.32283893
17953,17953,Matt Donovan,2015-16,25.0,4,3,12,12,0,3,3,12.0,211.0,67,2,17,19,104.0,82,5.32,47,251,2453,8.9,0.20333949
17954,17954,Matt Donovan,2019-20,29.0,5,1,2,2,0,1,1,1.0,15.0,69,2,18,20,105.0,82,5.96,47,239,2579,9.5,0.159704
17955,17955,Matt Duchene,2010-11,20.0,2,55,81,81,24,31,55,180.0,1436.0,81,24,31,55,180.0,82,5.53,56,304,2486,9.1,0.7255943
17956,17956,Matt Duchene,2011-12,21.0,3,67,80,80,27,40,67,202.0,1516.0,161,51,71,122,382.0,82,5.46,52,291,2492,9.0,0.8410324
17957,17957,Matt Duchene,2012-13,22.0,4,28,58,58,14,14,28,132.0,945.0,219,65,85,150,514.0,82,5.32,47,271,2439,8.9,0.60011744
17958,17958,Matt Duchene,2013-14,23.0,5,43,47,47,17,26,43,132.0,983.0,266,82,111,193,646.0,48,5.31,29,160,1399,9.1,0.90919673
17959,17959,Matt Duchene,2014-15,24.0,6,70,71,71,23,47,70,217.0,1313.0,337,105,158,263,863.0,82,5.34,48,269,2463,8.9,0.91758966
17960,17960,Matt Duchene,2015-16,25.0,7,55,82,82,21,34,55,207.0,1523.0,419,126,192,318,1070.0,82,5.32,47,251,2453,8.9,0.69883233
17961,17961,Matt Duchene,2016-17,26.0,8,59,76,76,30,29,59,200.0,1413.0,495,156,221,377,1270.0,82,5.34,48,255,2438,9.0,0.7596408
17962,17962,Matt Duchene,2017-18,27.0,9,41,77,77,18,23,41,160.0,1409.0,572,174,244,418,1430.0,82,5.45,47,245,2478,9.0,0.5762843
17963,17963,Matt Duchene,2018-19,28.0,10,59,82,82,27,32,59,190.0,1503.0,654,201,276,477,1620.0,82,5.86,50,250,2620,9.2,0.71631217
17964,17964,Matt Duchene,2019-20,29.0,11,70,73,73,31,39,70,172.0,1375.0,727,232,315,547,1792.0,82,5.96,47,239,2579,9.5,0.79873484
17965,17965,Matt Duchene,2020-21,30.0,12,42,66,66,13,29,42,136.0,1114.0,793,245,344,589,1928.0,70,5.96,42,208,2192,9.5,0.5802107
17966,17966,Matt Elich,2000-01,21.0,2,2,8,8,1,1,2,5.0,49.0,8,1,1,2,5.0,82,5.49,53,331,2294,9.8,0.23537609
17967,17967,Matt Elich,2001-02,22.0,3,0,8,8,0,0,0,7.0,72.0,16,1,1,2,12.0,82,5.51,63,376,2272,9.9,0.15639657
17968,17968,Matt Ellis,2007-08,26.0,2,0,16,16,0,0,0,22.0,89.0,16,0,0,0,22.0,82,5.76,70,398,2426,9.7,0.18673387
17969,17969,Matt Ellis,2008-09,27.0,3,8,54,54,3,5,8,66.0,429.0,70,3,5,8,88.0,82,5.44,62,351,2383,9.4,0.18254828
17970,17970,Matt Ellis,2009-10,28.0,4,12,45,45,7,5,12,73.0,397.0,115,10,10,20,161.0,82,5.7,65,341,2477,9.4,0.26740813
17971,17971,Matt Ellis,2010-11,29.0,5,13,72,72,3,10,13,112.0,652.0,187,13,20,33,273.0,82,5.53,56,304,2486,9.1,0.1918385
17972,17972,Matt Ellis,2011-12,30.0,6,0,14,14,0,0,0,20.0,141.0,201,13,20,33,293.0,82,5.46,52,291,2492,9.0,0.15475076
17973,17973,Matt Ellis,2012-13,31.0,7,8,60,60,3,5,8,85.0,583.0,261,16,25,41,378.0,82,5.32,47,271,2439,8.9,0.1512874
17974,17974,Matt Ellis,2013-14,32.0,8,0,6,6,0,0,0,8.0,37.0,267,16,25,41,386.0,48,5.31,29,160,1399,9.1,0.13395858
17975,17975,Matt Ellis,2014-15,33.0,9,6,50,50,4,2,6,70.0,474.0,317,20,27,47,456.0,82,5.34,48,269,2463,8.9,0.15307474
17976,17976,Matt Ellis,2015-16,34.0,10,2,39,39,1,1,2,29.0,325.0,356,21,28,49,485.0,82,5.32,47,251,2453,8.9,0.100783855
17977,17977,Matt Ellison,2004-05,21.0,2,1,10,10,0,1,1,4.0,127.0,10,0,1,1,4.0,82,5.14,57,348,2300,9.2,0.26042673
17978,17978,Matt Ellison,2006-07,23.0,3,13,31,31,3,10,13,49.0,416.0,41,3,11,14,53.0,82,6.05,85,480,2458,10.1,0.2829859
17979,17979,Matt Ellison,2007-08,24.0,4,0,2,2,0,0,0,1.0,12.0,43,3,11,14,54.0,82,5.76,70,398,2426,9.7,0.16219193
17980,17980,Matt Foy,2006-07,23.0,2,5,19,19,2,3,5,21.0,209.0,19,2,3,5,21.0,82,6.05,85,480,2458,10.1,0.24861488
17981,17981,Matt Foy,2007-08,24.0,3,0,9,9,0,0,0,6.0,65.0,28,2,3,5,27.0,82,5.76,70,398,2426,9.7,0.16027302
17982,17982,Matt Foy,2008-09,25.0,4,8,28,28,4,4,8,38.0,219.0,56,6,7,13,65.0,82,5.44,62,351,2383,9.4,0.22333887
17983,17983,Matt Fraser,2012-13,22.0,2,0,1,1,0,0,0,1.0,4.0,1,0,0,0,1.0,82,5.32,47,271,2439,8.9,0.16564402
17984,17984,Matt Fraser,2013-14,23.0,3,3,12,12,1,2,3,17.0,142.0,13,1,2,3,18.0,48,5.31,29,160,1399,9.1,0.25336373
17985,17985,Matt Fraser,2014-15,24.0,4,2,14,14,2,0,2,13.0,135.0,27,3,2,5,31.0,82,5.34,48,269,2463,8.9,0.22122833
17986,17986,Matt Fraser,2015-16,25.0,5,12,60,60,8,4,12,92.0,673.0,87,11,6,17,123.0,82,5.32,47,251,2453,8.9,0.23287877
17987,17987,Matt Frattin,2011-12,24.0,2,0,1,1,0,0,0,5.0,16.0,1,0,0,0,5.0,82,5.46,52,291,2492,9.0,0.16744861
17988,17988,Matt Frattin,2012-13,25.0,3,15,56,56,8,7,15,92.0,737.0,57,8,7,15,97.0,82,5.32,47,271,2439,8.9,0.27194783
17989,17989,Matt Frattin,2013-14,26.0,4,13,25,25,7,6,13,42.0,331.0,82,15,13,28,139.0,48,5.31,29,160,1399,9.1,0.3696924
17990,17990,Matt Frattin,2014-15,27.0,5,7,44,44,2,5,7,61.0,529.0,126,17,18,35,200.0,82,5.34,48,269,2463,8.9,0.1647206
17991,17991,Matt Frattin,2015-16,28.0,6,0,9,9,0,0,0,6.0,64.0,135,17,18,35,206.0,82,5.32,47,251,2453,8.9,0.13742909
17992,17992,Matt Gilroy,2010-11,26.0,2,15,69,69,4,11,15,82.0,1126.0,69,4,11,15,82.0,82,5.53,56,304,2486,9.1,0.22993177
17993,17993,Matt Gilroy,2011-12,27.0,3,11,58,58,3,8,11,75.0,822.0,127,7,19,26,157.0,82,5.46,52,291,2492,9.0,0.20480254
17994,17994,Matt Gilroy,2012-13,28.0,4,20,67,67,3,17,20,80.0,1173.0,194,10,36,46,237.0,82,5.32,47,271,2439,8.9,0.24539536
17995,17995,Matt Gilroy,2013-14,29.0,5,0,15,15,0,0,0,14.0,143.0,209,10,36,46,251.0,48,5.31,29,160,1399,9.1,0.18492377
17996,17996,Matt Gilroy,2014-15,30.0,6,2,16,16,1,1,2,27.0,260.0,225,11,37,48,278.0,82,5.34,48,269,2463,8.9,0.19351116
17997,17997,Matt Glennon,1992-93,24.0,2,0,3,3,0,0,0,2.0,,3,0,0,0,2.0,80,6.96,77,402,2440,11.4,0.21249864
17998,17998,Matt Greene,2006-07,23.0,2,2,27,27,0,2,2,10.0,303.0,27,0,2,2,10.0,82,6.05,85,480,2458,10.1,0.13947666
17999,17999,Matt Greene,2007-08,24.0,3,10,78,78,1,9,10,52.0,1373.0,105,1,11,12,62.0,82,5.76,70,398,2426,9.7,0.15706009
18000,18000,Matt Greene,2008-09,25.0,4,1,46,46,0,1,1,28.0,768.0,151,1,12,13,90.0,82,5.44,62,351,2383,9.4,0.11471531
18001,18001,Matt Greene,2009-10,26.0,5,14,82,82,2,12,14,76.0,1619.0,233,3,24,27,166.0,82,5.7,65,341,2477,9.4,0.1880807
18002,18002,Matt Greene,2010-11,27.0,6,9,75,75,2,7,9,57.0,1311.0,308,5,31,36,223.0,82,5.53,56,304,2486,9.1,0.13610038
18003,18003,Matt Greene,2011-12,28.0,7,11,71,71,2,9,11,50.0,1205.0,379,7,40,47,273.0,82,5.46,52,291,2492,9.0,0.15182215
18004,18004,Matt Greene,2012-13,29.0,8,15,82,82,4,11,15,76.0,1367.0,461,11,51,62,349.0,82,5.32,47,271,2439,8.9,0.17603251
18005,18005,Matt Greene,2013-14,30.0,9,1,5,5,0,1,1,3.0,76.0,466,11,52,63,352.0,48,5.31,29,160,1399,9.1,0.15003142
18006,18006,Matt Greene,2014-15,31.0,10,6,38,38,2,4,6,38.0,604.0,504,13,56,69,390.0,82,5.34,48,269,2463,8.9,0.15102255
18007,18007,Matt Greene,2015-16,32.0,11,9,82,82,3,6,9,69.0,1296.0,586,16,62,78,459.0,82,5.32,47,251,2453,8.9,0.1240499
18008,18008,Matt Greene,2016-17,33.0,12,0,3,3,0,0,0,3.0,35.0,589,16,62,78,462.0,82,5.34,48,255,2438,9.0,0.1183798
18009,18009,Matt Greene,2017-18,34.0,13,2,26,26,1,1,2,14.0,343.0,615,17,63,80,476.0,82,5.45,47,245,2478,9.0,0.088067114
18010,18010,Matt Grzelcyk,2017-18,24.0,2,0,2,2,0,0,0,4.0,25.0,2,0,0,0,4.0,82,5.45,47,245,2478,9.0,0.17442444
18011,18011,Matt Grzelcyk,2018-19,25.0,3,15,61,61,3,12,15,82.0,1021.0,63,3,12,15,86.0,82,5.86,50,250,2620,9.2,0.24344563
18012,18012,Matt Grzelcyk,2019-20,26.0,4,18,66,66,3,15,18,90.0,1263.0,129,6,27,33,176.0,82,5.96,47,239,2579,9.5,0.24217182
18013,18013,Matt Grzelcyk,2020-21,27.0,5,21,68,68,4,17,21,112.0,1228.0,197,10,44,54,288.0,70,5.96,42,208,2192,9.5,0.29501784
18014,18014,Matt Halischuk,2009-10,21.0,2,1,1,1,0,1,1,0.0,10.0,1,0,1,1,0.0,82,5.7,65,341,2477,9.4,0.23987854
18015,18015,Matt Halischuk,2010-11,22.0,3,2,20,20,1,1,2,22.0,226.0,21,1,2,3,22.0,82,5.53,56,304,2486,9.1,0.1966252
18016,18016,Matt Halischuk,2011-12,23.0,4,12,27,27,4,8,12,29.0,273.0,48,5,10,15,51.0,82,5.46,52,291,2492,9.0,0.27752253
18017,18017,Matt Halischuk,2012-13,24.0,5,28,73,73,15,13,28,96.0,822.0,121,20,23,43,147.0,82,5.32,47,271,2439,8.9,0.37587148
18018,18018,Matt Halischuk,2013-14,25.0,6,11,36,36,5,6,11,51.0,430.0,157,25,29,54,198.0,48,5.31,29,160,1399,9.1,0.3066715
18019,18019,Matt Halischuk,2014-15,26.0,7,10,46,46,5,5,10,56.0,521.0,203,30,34,64,254.0,82,5.34,48,269,2463,8.9,0.2332643
18020,18020,Matt Halischuk,2015-16,27.0,8,8,47,47,3,5,8,59.0,458.0,250,33,39,72,313.0,82,5.32,47,251,2453,8.9,0.18943343
18021,18021,Matt Halischuk,2016-17,28.0,9,3,30,30,0,3,3,39.0,284.0,280,33,42,75,352.0,82,5.34,48,255,2438,9.0,0.20164084
18022,18022,Matt Henderson,1999-00,25.0,2,0,2,2,0,0,0,0.0,13.0,2,0,0,0,0.0,82,5.27,57,359,2285,9.4,0.16462103
18023,18023,Matt Henderson,2002-03,28.0,3,1,4,4,0,1,1,3.0,29.0,6,0,1,1,3.0,82,5.24,53,338,2262,9.5,0.16545674
18024,18024,Matt Hendricks,2009-10,28.0,2,0,4,4,0,0,0,5.0,34.0,4,0,0,0,5.0,82,5.7,65,341,2477,9.4,0.1931917
18025,18025,Matt Hendricks,2010-11,29.0,3,16,56,56,9,7,16,63.0,519.0,60,9,7,16,68.0,82,5.53,56,304,2486,9.1,0.2539306
18026,18026,Matt Hendricks,2011-12,30.0,4,25,77,77,9,16,25,113.0,882.0,137,18,23,41,181.0,82,5.46,52,291,2492,9.0,0.2672547
18027,18027,Matt Hendricks,2012-13,31.0,5,9,78,78,4,5,9,97.0,946.0,215,22,28,50,278.0,82,5.32,47,271,2439,8.9,0.1781438
18028,18028,Matt Hendricks,2013-14,32.0,6,8,48,48,5,3,8,54.0,563.0,263,27,31,58,332.0,48,5.31,29,160,1399,9.1,0.19587791
18029,18029,Matt Hendricks,2014-15,33.0,7,7,77,77,5,2,7,102.0,981.0,340,32,33,65,434.0,82,5.34,48,269,2463,8.9,0.16183108
18030,18030,Matt Hendricks,2015-16,34.0,8,16,71,71,8,8,16,103.0,934.0,411,40,41,81,537.0,82,5.32,47,251,2453,8.9,0.21685216
18031,18031,Matt Hendricks,2016-17,35.0,9,12,68,68,5,7,12,62.0,900.0,479,45,48,93,599.0,82,5.34,48,255,2438,9.0,0.1634697
18032,18032,Matt Hendricks,2017-18,36.0,10,7,42,42,4,3,7,42.0,451.0,521,49,51,100,641.0,82,5.45,47,245,2478,9.0,0.15744007
18033,18033,Matt Hendricks,2018-19,37.0,11,13,60,60,5,8,13,56.0,565.0,581,54,59,113,697.0,82,5.86,50,250,2620,9.2,0.16221005
18034,18034,Matt Hendricks,2019-20,38.0,12,3,26,26,0,3,3,23.0,230.0,607,54,62,116,720.0,82,5.96,47,239,2579,9.5,0.16437191
18035,18035,Matt Herr,1999-00,23.0,2,4,30,30,2,2,4,40.0,333.0,30,2,2,4,40.0,82,5.27,57,359,2285,9.4,0.250759
18036,18036,Matt Herr,2001-02,25.0,3,5,22,22,2,3,5,20.0,179.0,52,4,5,9,60.0,82,5.51,63,376,2272,9.9,0.18811351
18037,18037,Matt Herr,2002-03,26.0,4,0,3,3,0,0,0,1.0,19.0,55,4,5,9,61.0,82,5.24,53,338,2262,9.5,0.14061743
18038,18038,Matt Herr,2003-04,27.0,5,0,3,3,0,0,0,1.0,25.0,58,4,5,9,62.0,82,5.31,60,363,2326,9.4,0.1375835
18039,18039,Matt Hervey,1989-90,21.0,2,0,2,2,0,0,0,1.0,,2,0,0,0,1.0,80,7.48,85,403,2430,12.3,0.23437062
18040,18040,Matt Hervey,1992-93,24.0,3,1,16,16,0,1,1,8.0,,18,0,1,1,9.0,80,6.96,77,402,2440,11.4,0.20072415
18041,18041,Matt Hervey,1993-94,25.0,4,4,17,17,0,4,4,18.0,,35,0,5,5,27.0,84,7.25,87,443,2603,11.7,0.20184246
18042,18042,Matt Higgins,1998-99,21.0,2,0,1,1,0,0,0,1.0,,1,0,0,0,1.0,82,5.28,57,380,2242,9.6,0.17559981
18043,18043,Matt Higgins,1999-00,22.0,3,1,25,25,1,0,1,12.0,142.0,26,1,0,1,13.0,82,5.27,57,359,2285,9.4,0.15014246
18044,18044,Matt Higgins,2000-01,23.0,4,2,25,25,0,2,2,9.0,199.0,51,1,2,3,22.0,82,5.49,53,331,2294,9.8,0.11925784
18045,18045,Matt Higgins,2001-02,24.0,5,0,6,6,0,0,0,3.0,57.0,57,1,2,3,25.0,82,5.51,63,376,2272,9.9,0.12251091
18046,18046,Matt Hunwick,2008-09,23.0,2,1,13,13,0,1,1,6.0,138.0,13,0,1,1,6.0,82,5.44,62,351,2383,9.4,0.18303743
18047,18047,Matt Hunwick,2009-10,24.0,3,27,53,53,6,21,27,58.0,900.0,66,6,22,28,64.0,82,5.7,65,341,2477,9.4,0.39371553
18048,18048,Matt Hunwick,2010-11,25.0,4,14,76,76,6,8,14,60.0,1365.0,142,12,30,42,124.0,82,5.53,56,304,2486,9.1,0.19656497
18049,18049,Matt Hunwick,2011-12,26.0,5,13,73,73,1,12,13,100.0,1351.0,215,13,42,55,224.0,82,5.46,52,291,2492,9.0,0.20034415
18050,18050,Matt Hunwick,2012-13,27.0,6,6,33,33,3,3,6,40.0,596.0,248,16,45,61,264.0,82,5.32,47,271,2439,8.9,0.20759541
18051,18051,Matt Hunwick,2013-14,28.0,7,6,43,43,0,6,6,57.0,925.0,291,16,51,67,321.0,48,5.31,29,160,1399,9.1,0.16329592
18052,18052,Matt Hunwick,2014-15,29.0,8,0,1,1,0,0,0,1.0,17.0,292,16,51,67,322.0,82,5.34,48,269,2463,8.9,0.19850424
18053,18053,Matt Hunwick,2015-16,30.0,9,11,55,55,2,9,11,72.0,870.0,347,18,60,78,394.0,82,5.32,47,251,2453,8.9,0.19421709
18054,18054,Matt Hunwick,2016-17,31.0,10,10,60,60,2,8,10,74.0,1354.0,407,20,68,88,468.0,82,5.34,48,255,2438,9.0,0.19017115
18055,18055,Matt Hunwick,2017-18,32.0,11,19,72,72,1,18,19,73.0,1294.0,479,21,86,107,541.0,82,5.45,47,245,2478,9.0,0.2301192
18056,18056,Matt Hunwick,2018-19,33.0,12,10,42,42,4,6,10,52.0,735.0,521,25,92,117,593.0,82,5.86,50,250,2620,9.2,0.18124163
18057,18057,Matt Hunwick,2019-20,34.0,13,2,14,14,0,2,2,10.0,220.0,535,25,94,119,603.0,82,5.96,47,239,2579,9.5,0.15372276
18058,18058,Matt Hussey,2004-05,25.0,2,3,3,3,2,1,3,8.0,41.0,3,2,1,3,8.0,82,5.14,57,348,2300,9.2,0.21819964
18059,18059,Matt Hussey,2006-07,27.0,3,1,13,13,0,1,1,17.0,134.0,16,2,2,4,25.0,82,6.05,85,480,2458,10.1,0.17221424
18060,18060,Matt Hussey,2007-08,28.0,4,0,5,5,0,0,0,6.0,28.0,21,2,2,4,31.0,82,5.76,70,398,2426,9.7,0.14944899
18061,18061,Matt Irwin,2013-14,26.0,2,12,38,38,6,6,12,79.0,726.0,38,6,6,12,79.0,48,5.31,29,160,1399,9.1,0.3387242
18062,18062,Matt Irwin,2014-15,27.0,3,19,62,62,2,17,19,147.0,1167.0,100,8,23,31,226.0,82,5.34,48,269,2463,8.9,0.29886353
18063,18063,Matt Irwin,2015-16,28.0,4,19,53,53,8,11,19,93.0,902.0,153,16,34,50,319.0,82,5.32,47,251,2453,8.9,0.35940498
18064,18064,Matt Irwin,2016-17,29.0,5,0,2,2,0,0,0,3.0,30.0,155,16,34,50,322.0,82,5.34,48,255,2438,9.0,0.17486355
18065,18065,Matt Irwin,2017-18,30.0,6,14,74,74,3,11,14,98.0,1204.0,229,19,45,64,420.0,82,5.45,47,245,2478,9.0,0.21201414
18066,18066,Matt Irwin,2018-19,31.0,7,8,50,50,2,6,8,62.0,672.0,279,21,51,72,482.0,82,5.86,50,250,2620,9.2,0.15736383
18067,18067,Matt Irwin,2019-20,32.0,8,7,44,44,1,6,7,50.0,497.0,323,22,57,79,532.0,82,5.96,47,239,2579,9.5,0.15269017
18068,18068,Matt Irwin,2020-21,33.0,9,3,36,36,0,3,3,58.0,521.0,359,22,60,82,590.0,70,5.96,42,208,2192,9.5,0.18382627
18069,18069,Matt Johnson,1995-96,20.0,2,1,14,14,1,0,1,4.0,,14,1,0,1,4.0,48,5.97,37,209,1408,10.2,0.24281758
18070,18070,Matt Johnson,1996-97,21.0,3,0,1,1,0,0,0,1.0,,15,1,0,1,5.0,82,6.29,74,413,2481,10.4,0.19526225
18071,18071,Matt Johnson,1997-98,22.0,4,4,52,52,1,3,4,20.0,,67,2,3,5,25.0,82,5.83,55,336,2444,9.8,0.13378137
18072,18072,Matt Johnson,1998-99,23.0,5,6,66,66,2,4,6,18.0,,133,4,7,11,43.0,82,5.28,57,380,2242,9.6,0.14895865
18073,18073,Matt Johnson,1999-00,24.0,6,3,49,49,2,1,3,14.0,290.0,182,6,8,14,57.0,82,5.27,57,359,2285,9.4,0.12987971
18074,18074,Matt Johnson,2000-01,25.0,7,7,64,64,2,5,7,54.0,539.0,246,8,13,21,111.0,82,5.49,53,331,2294,9.8,0.14630249
18075,18075,Matt Johnson,2001-02,26.0,8,2,50,50,1,1,2,21.0,385.0,296,9,14,23,132.0,82,5.51,63,376,2272,9.9,0.09040111
18076,18076,Matt Johnson,2002-03,27.0,9,4,60,60,4,0,4,23.0,443.0,356,13,14,27,155.0,82,5.24,53,338,2262,9.5,0.08576661
18077,18077,Matt Johnson,2003-04,28.0,10,8,60,60,3,5,8,24.0,444.0,416,16,19,35,179.0,82,5.31,60,363,2326,9.4,0.099668205
18078,18078,Matt Johnson,2004-05,29.0,11,8,57,57,7,1,8,21.0,368.0,473,23,20,43,200.0,82,5.14,57,348,2300,9.2,0.1354087
18079,18079,Matt Jones,2006-07,23.0,2,2,16,16,0,2,2,10.0,185.0,16,0,2,2,10.0,82,6.05,85,480,2458,10.1,0.18742052
18080,18080,Matt Jones,2007-08,24.0,3,7,45,45,1,6,7,20.0,737.0,61,1,8,9,30.0,82,5.76,70,398,2426,9.7,0.13294873
18081,18081,Matt Jones,2008-09,25.0,4,2,45,45,0,2,2,25.0,655.0,106,1,10,11,55.0,82,5.44,62,351,2383,9.4,0.115228474
18082,18082,Matt Kassian,2011-12,25.0,2,0,4,4,0,0,0,1.0,22.0,4,0,0,0,1.0,82,5.46,52,291,2492,9.0,0.1533815
18083,18083,Matt Kassian,2012-13,26.0,3,2,24,24,2,0,2,13.0,133.0,28,2,0,2,14.0,82,5.32,47,271,2439,8.9,0.15033215
18084,18084,Matt Kassian,2013-14,27.0,4,1,15,15,1,0,1,6.0,96.0,43,3,0,3,20.0,48,5.31,29,160,1399,9.1,0.16422832
18085,18085,Matt Kassian,2014-15,28.0,5,2,33,33,1,1,2,12.0,146.0,76,4,1,5,32.0,82,5.34,48,269,2463,8.9,0.105137795
18086,18086,Matt Keith,2004-05,21.0,2,5,20,20,2,3,5,21.0,239.0,20,2,3,5,21.0,82,5.14,57,348,2300,9.2,0.2944622
18087,18087,Matt Keith,2006-07,23.0,3,0,2,2,0,0,0,6.0,23.0,22,2,3,5,27.0,82,6.05,85,480,2458,10.1,0.17690969
18088,18088,Matt Keith,2007-08,24.0,4,0,2,2,0,0,0,0.0,19.0,24,2,3,5,27.0,82,5.76,70,398,2426,9.7,0.15526739
18089,18089,Matt Keith,2008-09,25.0,5,0,3,3,0,0,0,3.0,32.0,27,2,3,5,30.0,82,5.44,62,351,2383,9.4,0.1523124
18090,18090,Matt Koalska,2006-07,26.0,2,0,3,3,0,0,0,3.0,17.0,3,0,0,0,3.0,82,6.05,85,480,2458,10.1,0.16539437
18091,18091,Matt Lashoff,2007-08,21.0,2,2,12,12,0,2,2,8.0,179.0,12,0,2,2,8.0,82,5.76,70,398,2426,9.7,0.23169911
18092,18092,Matt Lashoff,2008-09,22.0,3,5,18,18,1,4,5,11.0,244.0,30,1,6,7,19.0,82,5.44,62,351,2383,9.4,0.22955549
18093,18093,Matt Lashoff,2009-10,23.0,4,8,28,28,0,8,8,25.0,495.0,58,1,14,15,44.0,82,5.7,65,341,2477,9.4,0.20402819
18094,18094,Matt Lashoff,2010-11,24.0,5,0,5,5,0,0,0,2.0,44.0,63,1,14,15,46.0,82,5.53,56,304,2486,9.1,0.15049168
18095,18095,Matt Lashoff,2011-12,25.0,6,1,11,11,0,1,1,8.0,152.0,74,1,15,16,54.0,82,5.46,52,291,2492,9.0,0.14760384
18096,18096,Matt Lindblad,2014-15,24.0,2,0,2,2,0,0,0,0.0,24.0,2,0,0,0,0.0,82,5.34,48,269,2463,8.9,0.1370357
18097,18097,Matt Lindblad,2015-16,25.0,3,0,2,2,0,0,0,3.0,16.0,4,0,0,0,3.0,82,5.32,47,251,2453,8.9,0.16056308
18098,18098,Matt Luff,2019-20,22.0,2,11,33,33,8,3,11,45.0,367.0,33,8,3,11,45.0,82,5.96,47,239,2579,9.5,0.32252786
18099,18099,Matt Luff,2020-21,23.0,3,5,18,18,1,4,5,25.0,187.0,51,9,7,16,70.0,70,5.96,42,208,2192,9.5,0.3213489
18100,18100,Matt Martin,1994-95,23.0,2,1,12,12,0,1,1,6.0,,12,0,1,1,6.0,84,6.48,76,407,2545,10.7,0.19017637
18101,18101,Matt Martin,1995-96,24.0,3,0,15,15,0,0,0,14.0,,27,0,1,1,20.0,48,5.97,37,209,1408,10.2,0.18118647
18102,18102,Matt Martin,1996-97,25.0,4,0,13,13,0,0,0,3.0,,40,0,1,1,23.0,82,6.29,74,413,2481,10.4,0.13996342
18103,18103,Matt Martin,1997-98,26.0,5,4,36,36,0,4,4,30.0,,76,0,5,5,53.0,82,5.83,55,336,2444,9.8,0.12269366
18104,18104,Matt Martin0,2010-11,21.0,2,2,5,5,0,2,2,10.0,66.0,5,0,2,2,10.0,82,5.53,56,304,2486,9.1,0.26400983
18105,18105,Matt Martin0,2011-12,22.0,3,14,68,68,5,9,14,60.0,745.0,73,5,11,16,70.0,82,5.46,52,291,2492,9.0,0.22354963
18106,18106,Matt Martin0,2012-13,23.0,4,14,80,80,7,7,14,130.0,973.0,153,12,18,30,200.0,82,5.32,47,271,2439,8.9,0.28082305
18107,18107,Matt Martin0,2013-14,24.0,5,11,48,48,4,7,11,67.0,572.0,201,16,25,41,267.0,48,5.31,29,160,1399,9.1,0.26653647
18108,18108,Matt Martin0,2014-15,25.0,6,14,79,79,8,6,14,120.0,940.0,280,24,31,55,387.0,82,5.34,48,269,2463,8.9,0.21153799
18109,18109,Matt Martin0,2015-16,26.0,7,14,78,78,8,6,14,90.0,879.0,358,32,37,69,477.0,82,5.32,47,251,2453,8.9,0.19877404
18110,18110,Matt Martin0,2016-17,27.0,8,19,80,80,10,9,19,86.0,845.0,438,42,46,88,563.0,82,5.34,48,255,2438,9.0,0.22021008
18111,18111,Matt Martin0,2017-18,28.0,9,9,82,82,5,4,9,66.0,730.0,520,47,50,97,629.0,82,5.45,47,245,2478,9.0,0.18652114
18112,18112,Matt Martin0,2018-19,29.0,10,12,50,50,3,9,12,46.0,399.0,570,50,59,109,675.0,82,5.86,50,250,2620,9.2,0.18903413
18113,18113,Matt Martin0,2019-20,30.0,11,14,67,67,6,8,14,62.0,766.0,637,56,67,123,737.0,82,5.96,47,239,2579,9.5,0.15998968
18114,18114,Matt Martin0,2020-21,31.0,12,8,55,55,5,3,8,49.0,573.0,692,61,70,131,786.0,70,5.96,42,208,2192,9.5,0.14580116
18115,18115,Matt Moulson,2008-09,25.0,2,9,22,22,5,4,9,35.0,266.0,22,5,4,9,35.0,82,5.44,62,351,2383,9.4,0.27717286
18116,18116,Matt Moulson,2009-10,26.0,3,1,7,7,1,0,1,6.0,101.0,29,6,4,10,41.0,82,5.7,65,341,2477,9.4,0.18583778
18117,18117,Matt Moulson,2010-11,27.0,4,48,82,82,30,18,48,208.0,1364.0,111,36,22,58,249.0,82,5.53,56,304,2486,9.1,0.5875265
18118,18118,Matt Moulson,2011-12,28.0,5,53,82,82,31,22,53,237.0,1547.0,193,67,44,111,486.0,82,5.46,52,291,2492,9.0,0.62944233
18119,18119,Matt Moulson,2012-13,29.0,6,69,82,82,36,33,69,219.0,1583.0,275,103,77,180,705.0,82,5.32,47,271,2439,8.9,0.77858126
18120,18120,Matt Moulson,2013-14,30.0,7,44,47,47,15,29,44,154.0,900.0,322,118,106,224,859.0,48,5.31,29,160,1399,9.1,0.77346134
18121,18121,Matt Moulson,2014-15,31.0,8,51,75,75,23,28,51,176.0,1348.0,397,141,134,275,1035.0,82,5.34,48,269,2463,8.9,0.5407847
18122,18122,Matt Moulson,2015-16,32.0,9,41,77,77,13,28,41,156.0,1362.0,474,154,162,316,1191.0,82,5.32,47,251,2453,8.9,0.46734515
18123,18123,Matt Moulson,2016-17,33.0,10,21,81,81,8,13,21,111.0,964.0,555,162,175,337,1302.0,82,5.34,48,255,2438,9.0,0.28564107
18124,18124,Matt Moulson,2017-18,34.0,11,32,81,81,14,18,32,134.0,940.0,636,176,193,369,1436.0,82,5.45,47,245,2478,9.0,0.34988827
18125,18125,Matt Moulson,2018-19,35.0,12,0,14,14,0,0,0,13.0,144.0,650,176,193,369,1449.0,82,5.86,50,250,2620,9.2,0.238325
18126,18126,Matt Murley,2004-05,25.0,2,2,18,18,1,1,2,20.0,213.0,18,1,1,2,20.0,82,5.14,57,348,2300,9.2,0.2034756
18127,18127,Matt Murley,2006-07,27.0,3,6,41,41,1,5,6,48.0,470.0,59,2,6,8,68.0,82,6.05,85,480,2458,10.1,0.16044384
18128,18128,Matt Murley,2008-09,29.0,4,1,3,3,0,1,1,3.0,35.0,62,2,7,9,71.0,82,5.44,62,351,2383,9.4,0.14887226
18129,18129,Matt Niskanen,2008-09,22.0,2,26,78,78,7,19,26,99.0,1598.0,78,7,19,26,99.0,82,5.44,62,351,2383,9.4,0.3904147
18130,18130,Matt Niskanen,2009-10,23.0,3,35,80,80,6,29,35,111.0,1598.0,158,13,48,61,210.0,82,5.7,65,341,2477,9.4,0.40615544
18131,18131,Matt Niskanen,2010-11,24.0,4,15,74,74,3,12,15,110.0,1351.0,232,16,60,76,320.0,82,5.53,56,304,2486,9.1,0.2593107
18132,18132,Matt Niskanen,2011-12,25.0,5,10,63,63,1,9,10,77.0,1041.0,295,17,69,86,397.0,82,5.46,52,291,2492,9.0,0.19537309
18133,18133,Matt Niskanen,2012-13,26.0,6,21,75,75,4,17,21,118.0,1345.0,370,21,86,107,515.0,82,5.32,47,271,2439,8.9,0.30374873
18134,18134,Matt Niskanen,2013-14,27.0,7,14,40,40,4,10,14,67.0,814.0,410,25,96,121,582.0,48,5.31,29,160,1399,9.1,0.32376987
18135,18135,Matt Niskanen,2014-15,28.0,8,46,81,81,10,36,46,162.0,1725.0,491,35,132,167,744.0,82,5.34,48,269,2463,8.9,0.46780092
18136,18136,Matt Niskanen,2015-16,29.0,9,31,82,82,4,27,31,117.0,1833.0,573,39,159,198,861.0,82,5.32,47,251,2453,8.9,0.35753673
18137,18137,Matt Niskanen,2016-17,30.0,10,32,82,82,5,27,32,150.0,2022.0,655,44,186,230,1011.0,82,5.34,48,255,2438,9.0,0.3973527
18138,18138,Matt Niskanen,2017-18,31.0,11,39,78,78,5,34,39,154.0,1730.0,733,49,220,269,1165.0,82,5.45,47,245,2478,9.0,0.43474647
18139,18139,Matt Niskanen,2018-19,32.0,12,29,68,68,7,22,29,120.0,1537.0,801,56,242,298,1285.0,82,5.86,50,250,2620,9.2,0.3536523
18140,18140,Matt Niskanen,2019-20,33.0,13,25,80,80,8,17,25,143.0,1755.0,881,64,259,323,1428.0,82,5.96,47,239,2579,9.5,0.31007308
18141,18141,Matt Niskanen,2020-21,34.0,14,33,68,68,8,25,33,126.0,1490.0,949,72,284,356,1554.0,70,5.96,42,208,2192,9.5,0.34980834
18142,18142,Matt Pelech,2009-10,22.0,2,3,5,5,0,3,3,4.0,66.0,5,0,3,3,4.0,82,5.7,65,341,2477,9.4,0.21401647
18143,18143,Matt Pelech,2013-14,26.0,3,0,2,2,0,0,0,0.0,18.0,7,0,3,3,4.0,48,5.31,29,160,1399,9.1,0.17501658
18144,18144,Matt Pelech,2014-15,27.0,4,1,6,6,1,0,1,3.0,24.0,13,1,3,4,7.0,82,5.34,48,269,2463,8.9,0.16991863
18145,18145,Matt Pettinger,2001-02,21.0,2,0,10,10,0,0,0,6.0,78.0,10,0,0,0,6.0,82,5.51,63,376,2272,9.9,0.1626755
18146,18146,Matt Pettinger,2002-03,22.0,3,10,61,61,7,3,10,73.0,588.0,71,7,3,10,79.0,82,5.24,53,338,2262,9.5,0.25858858
18147,18147,Matt Pettinger,2003-04,23.0,4,0,1,1,0,0,0,0.0,4.0,72,7,3,10,79.0,82,5.31,60,363,2326,9.4,0.19693059
18148,18148,Matt Pettinger,2004-05,24.0,5,12,71,71,7,5,12,92.0,810.0,143,14,8,22,171.0,82,5.14,57,348,2300,9.2,0.23953491
18149,18149,Matt Pettinger,2006-07,26.0,6,38,71,71,20,18,38,134.0,1099.0,214,34,26,60,305.0,82,6.05,85,480,2458,10.1,0.43461478
18150,18150,Matt Pettinger,2007-08,27.0,7,32,64,64,16,16,32,111.0,1081.0,278,50,42,92,416.0,82,5.76,70,398,2426,9.7,0.44783956
18151,18151,Matt Pettinger,2008-09,28.0,8,13,76,76,6,7,13,127.0,1087.0,354,56,49,105,543.0,82,5.44,62,351,2383,9.4,0.23494533
18152,18152,Matt Pettinger,2009-10,29.0,9,15,59,59,8,7,15,82.0,727.0,413,64,56,120,625.0,82,5.7,65,341,2477,9.4,0.2514357
18153,18153,Matt Pettinger,2010-11,30.0,10,3,9,9,1,2,3,8.0,97.0,422,65,58,123,633.0,82,5.53,56,304,2486,9.1,0.22791415
18154,18154,Matt Puempel,2015-16,23.0,2,3,13,13,2,1,3,14.0,104.0,13,2,1,3,14.0,82,5.32,47,251,2453,8.9,0.25018352
18155,18155,Matt Puempel,2016-17,24.0,3,3,26,26,2,1,3,26.0,295.0,39,4,2,6,40.0,82,5.34,48,255,2438,9.0,0.2141073
18156,18156,Matt Puempel,2017-18,25.0,4,9,40,40,6,3,9,44.0,386.0,79,10,5,15,84.0,82,5.45,47,245,2478,9.0,0.23435661
18157,18157,Matt Puempel,2019-20,27.0,5,1,8,8,1,0,1,10.0,83.0,87,11,5,16,94.0,82,5.96,47,239,2579,9.5,0.18869922
18158,18158,Matt Read,2012-13,26.0,2,47,79,79,24,23,47,155.0,1348.0,79,24,23,47,155.0,82,5.32,47,271,2439,8.9,0.5748737
18159,18159,Matt Read,2013-14,27.0,3,24,42,42,11,13,24,72.0,757.0,121,35,36,71,227.0,48,5.31,29,160,1399,9.1,0.5015573
18160,18160,Matt Read,2014-15,28.0,4,40,75,75,22,18,40,151.0,1410.0,196,57,54,111,378.0,82,5.34,48,269,2463,8.9,0.49752015
18161,18161,Matt Read,2015-16,29.0,5,30,80,80,8,22,30,142.0,1405.0,276,65,76,141,520.0,82,5.32,47,251,2453,8.9,0.4038142
18162,18162,Matt Read,2016-17,30.0,6,26,79,79,11,15,26,127.0,1205.0,355,76,91,167,647.0,82,5.34,48,255,2438,9.0,0.35605383
18163,18163,Matt Read,2017-18,31.0,7,19,63,63,10,9,19,92.0,869.0,418,86,100,186,739.0,82,5.45,47,245,2478,9.0,0.29295987
18164,18164,Matt Read,2018-19,32.0,8,1,19,19,1,0,1,16.0,207.0,437,87,100,187,755.0,82,5.86,50,250,2620,9.2,0.21663341
18165,18165,Matt Read,2019-20,33.0,9,1,12,12,1,0,1,13.0,141.0,449,88,100,188,768.0,82,5.96,47,239,2579,9.5,0.2353954
18166,18166,Matt Roy,2019-20,24.0,2,6,25,25,2,4,6,34.0,428.0,25,2,4,6,34.0,82,5.96,47,239,2579,9.5,0.22410819
18167,18167,Matt Roy,2020-21,25.0,3,18,70,70,4,14,18,112.0,1268.0,95,6,18,24,146.0,70,5.96,42,208,2192,9.5,0.31248474
18168,18168,Matt Ryan,2006-07,23.0,2,1,12,12,0,1,1,8.0,73.0,12,0,1,1,8.0,82,6.05,85,480,2458,10.1,0.18640107
18169,18169,Matt Smaby,2008-09,24.0,2,0,14,14,0,0,0,7.0,170.0,14,0,0,0,7.0,82,5.44,62,351,2383,9.4,0.15400127
18170,18170,Matt Smaby,2009-10,25.0,3,4,43,43,0,4,4,28.0,821.0,57,0,4,4,35.0,82,5.7,65,341,2477,9.4,0.115608096
18171,18171,Matt Smaby,2010-11,26.0,4,2,33,33,0,2,2,17.0,445.0,90,0,6,6,52.0,82,5.53,56,304,2486,9.1,0.12840772
18172,18172,Matt Smaby,2011-12,27.0,5,0,32,32,0,0,0,9.0,224.0,122,0,6,6,61.0,82,5.46,52,291,2492,9.0,0.08418462
18173,18173,Matt Stajan,2003-04,20.0,2,1,1,1,1,0,1,1.0,11.0,1,1,0,1,1.0,82,5.31,60,363,2326,9.4,0.3380987
18174,18174,Matt Stajan,2004-05,21.0,3,27,69,69,14,13,27,63.0,759.0,70,15,13,28,64.0,82,5.14,57,348,2300,9.2,0.4855423
18175,18175,Matt Stajan,2006-07,23.0,4,27,80,80,15,12,27,83.0,931.0,150,30,25,55,147.0,82,6.05,85,480,2458,10.1,0.36882415
18176,18176,Matt Stajan,2007-08,24.0,5,39,82,82,10,29,39,132.0,1324.0,232,40,54,94,279.0,82,5.76,70,398,2426,9.7,0.46827278
18177,18177,Matt Stajan,2008-09,25.0,6,33,82,82,16,17,33,127.0,1550.0,314,56,71,127,406.0,82,5.44,62,351,2383,9.4,0.4425598
18178,18178,Matt Stajan,2009-10,26.0,7,55,76,76,15,40,55,114.0,1287.0,390,71,111,182,520.0,82,5.7,65,341,2477,9.4,0.6642776
18179,18179,Matt Stajan,2010-11,27.0,8,57,82,82,19,38,57,132.0,1551.0,472,90,149,239,652.0,82,5.53,56,304,2486,9.1,0.6348868
18180,18180,Matt Stajan,2011-12,28.0,9,31,76,76,6,25,31,81.0,1081.0,548,96,174,270,733.0,82,5.46,52,291,2492,9.0,0.39657956
18181,18181,Matt Stajan,2012-13,29.0,10,18,61,61,8,10,18,77.0,794.0,609,104,184,288,810.0,82,5.32,47,271,2439,8.9,0.32884523
18182,18182,Matt Stajan,2013-14,30.0,11,23,43,43,5,18,23,44.0,738.0,652,109,202,311,854.0,48,5.31,29,160,1399,9.1,0.4655577
18183,18183,Matt Stajan,2014-15,31.0,12,33,63,63,14,19,33,70.0,1158.0,715,123,221,344,924.0,82,5.34,48,269,2463,8.9,0.37973973
18184,18184,Matt Stajan,2015-16,32.0,13,17,59,59,7,10,17,46.0,708.0,774,130,231,361,970.0,82,5.32,47,251,2453,8.9,0.26543987
18185,18185,Matt Stajan,2016-17,33.0,14,17,80,80,6,11,17,58.0,1016.0,854,136,242,378,1028.0,82,5.34,48,255,2438,9.0,0.20487091
18186,18186,Matt Stajan,2017-18,34.0,15,23,81,81,6,17,23,59.0,1027.0,935,142,259,401,1087.0,82,5.45,47,245,2478,9.0,0.21367383
18187,18187,Matt Stajan,2018-19,35.0,16,12,68,68,4,8,12,65.0,744.0,1003,146,267,413,1152.0,82,5.86,50,250,2620,9.2,0.14996803
18188,18188,Matt Taormina,2011-12,25.0,2,5,17,17,3,2,5,38.0,351.0,17,3,2,5,38.0,82,5.46,52,291,2492,9.0,0.24483153
18189,18189,Matt Taormina,2012-13,26.0,3,7,30,30,1,6,7,33.0,496.0,47,4,8,12,71.0,82,5.32,47,271,2439,8.9,0.18301511
18190,18190,Matt Taormina,2013-14,27.0,4,0,2,2,0,0,0,0.0,33.0,49,4,8,12,71.0,48,5.31,29,160,1399,9.1,0.16673028
18191,18191,Matt Taormina,2014-15,28.0,5,0,7,7,0,0,0,6.0,94.0,56,4,8,12,77.0,82,5.34,48,269,2463,8.9,0.14185274
18192,18192,Matt Taormina,2016-17,30.0,6,0,3,3,0,0,0,2.0,42.0,59,4,8,12,79.0,82,5.34,48,255,2438,9.0,0.13250533
18193,18193,Matt Tennyson,2013-14,23.0,2,2,4,4,0,2,2,8.0,63.0,4,0,2,2,8.0,48,5.31,29,160,1399,9.1,0.23975617
18194,18194,Matt Tennyson,2015-16,25.0,3,8,27,27,2,6,8,37.0,474.0,31,2,8,10,45.0,82,5.32,47,251,2453,8.9,0.21489501
18195,18195,Matt Tennyson,2016-17,26.0,4,4,29,29,1,3,4,23.0,305.0,60,3,11,14,68.0,82,5.34,48,255,2438,9.0,0.16920844
18196,18196,Matt Tennyson,2017-18,27.0,5,6,45,45,0,6,6,36.0,598.0,105,3,17,20,104.0,82,5.45,47,245,2478,9.0,0.14562172
18197,18197,Matt Tennyson,2018-19,28.0,6,0,15,15,0,0,0,25.0,270.0,120,3,17,20,129.0,82,5.86,50,250,2620,9.2,0.1754252
18198,18198,Matt Tennyson,2019-20,29.0,7,0,4,4,0,0,0,4.0,43.0,124,3,17,20,133.0,82,5.96,47,239,2579,9.5,0.12260544
18199,18199,Matt Tennyson,2020-21,30.0,8,3,20,20,0,3,3,14.0,243.0,144,3,20,23,147.0,70,5.96,42,208,2192,9.5,0.11220598
18200,18200,Matt Walker,2003-04,23.0,2,1,16,16,0,1,1,13.0,178.0,16,0,1,1,13.0,82,5.31,60,363,2326,9.4,0.18019128
18201,18201,Matt Walker,2004-05,24.0,3,1,14,14,0,1,1,8.0,159.0,30,0,2,2,21.0,82,5.14,57,348,2300,9.2,0.1629014
18202,18202,Matt Walker,2006-07,26.0,4,2,54,54,0,2,2,59.0,770.0,84,0,4,4,80.0,82,6.05,85,480,2458,10.1,0.14179763
18203,18203,Matt Walker,2007-08,27.0,5,5,48,48,0,5,5,34.0,732.0,132,0,9,9,114.0,82,5.76,70,398,2426,9.7,0.10964763
18204,18204,Matt Walker,2008-09,28.0,6,2,43,43,1,1,2,47.0,684.0,175,1,10,11,161.0,82,5.44,62,351,2383,9.4,0.1425722
18205,18205,Matt Walker,2009-10,29.0,7,14,65,65,1,13,14,83.0,1081.0,240,2,23,25,244.0,82,5.7,65,341,2477,9.4,0.15773135
18206,18206,Matt Walker,2010-11,30.0,8,5,66,66,2,3,5,54.0,1066.0,306,4,26,30,298.0,82,5.53,56,304,2486,9.1,0.118501365
18207,18207,Matt Walker,2011-12,31.0,9,0,4,4,0,0,0,3.0,47.0,310,4,26,30,301.0,82,5.46,52,291,2492,9.0,0.10854548
18208,18208,Matt Walker,2012-13,32.0,10,0,4,4,0,0,0,2.0,44.0,314,4,26,30,303.0,82,5.32,47,271,2439,8.9,0.10145807
18209,18209,Matt Watkins,2012-13,26.0,2,0,1,1,0,0,0,0.0,7.0,1,0,0,0,0.0,82,5.32,47,271,2439,8.9,0.13161138
18210,18210,Matthew Barnaby,1993-94,20.0,2,1,2,2,1,0,1,8.0,,2,1,0,1,8.0,84,7.25,87,443,2603,11.7,0.29206353
18211,18211,Matthew Barnaby,1994-95,21.0,3,6,35,35,2,4,6,13.0,,37,3,4,7,21.0,84,6.48,76,407,2545,10.7,0.25698352
18212,18212,Matthew Barnaby,1995-96,22.0,4,2,23,23,1,1,2,27.0,,60,4,5,9,48.0,48,5.97,37,209,1408,10.2,0.25459197
18213,18213,Matthew Barnaby,1996-97,23.0,5,31,73,73,15,16,31,131.0,,133,19,21,40,179.0,82,6.29,74,413,2481,10.4,0.43802732
18214,18214,Matthew Barnaby,1997-98,24.0,6,43,68,68,19,24,43,121.0,,201,38,45,83,300.0,82,5.83,55,336,2444,9.8,0.5264311
18215,18215,Matthew Barnaby,1998-99,25.0,7,25,72,72,5,20,25,96.0,,273,43,65,108,396.0,82,5.28,57,380,2242,9.6,0.34077647
18216,18216,Matthew Barnaby,1999-00,26.0,8,22,62,62,6,16,22,79.0,857.0,335,49,81,130,475.0,82,5.27,57,359,2285,9.4,0.32132152
18217,18217,Matthew Barnaby,2000-01,27.0,9,24,64,64,12,12,24,80.0,809.0,399,61,93,154,555.0,82,5.49,53,331,2294,9.8,0.3306136
18218,18218,Matthew Barnaby,2001-02,28.0,10,13,76,76,5,8,13,67.0,732.0,475,66,101,167,622.0,82,5.51,63,376,2272,9.9,0.25452948
18219,18219,Matthew Barnaby,2002-03,29.0,11,21,77,77,8,13,21,69.0,776.0,552,74,114,188,691.0,82,5.24,53,338,2262,9.5,0.27022713
18220,18220,Matthew Barnaby,2003-04,30.0,12,36,79,79,14,22,36,104.0,1027.0,631,88,136,224,795.0,82,5.31,60,363,2326,9.4,0.37592345
18221,18221,Matthew Barnaby,2004-05,31.0,13,41,82,82,16,25,41,104.0,1016.0,713,104,161,265,899.0,82,5.14,57,348,2300,9.2,0.39740634
18222,18222,Matthew Barnaby,2006-07,33.0,14,28,82,82,8,20,28,85.0,1101.0,795,112,181,293,984.0,82,6.05,85,480,2458,10.1,0.2835402
18223,18223,Matthew Barnaby,2007-08,34.0,15,7,39,39,1,6,7,22.0,317.0,834,113,187,300,1006.0,82,5.76,70,398,2426,9.7,0.14318833
18224,18224,Matthew Corrente,2010-11,22.0,2,0,12,12,0,0,0,6.0,106.0,12,0,0,0,6.0,82,5.53,56,304,2486,9.1,0.17143455
18225,18225,Matthew Corrente,2011-12,23.0,3,6,22,22,0,6,6,21.0,299.0,34,0,6,6,27.0,82,5.46,52,291,2492,9.0,0.1971584
18226,18226,Matthew Highmore,2018-19,22.0,2,2,13,13,2,0,2,27.0,158.0,13,2,0,2,27.0,82,5.86,50,250,2620,9.2,0.28057235
18227,18227,Matthew Highmore,2020-21,24.0,3,6,36,36,2,4,6,35.0,353.0,49,4,4,8,62.0,70,5.96,42,208,2192,9.5,0.21739087
18228,18228,Matthew Konan,2013-14,22.0,2,0,2,2,0,0,0,4.0,32.0,2,0,0,0,4.0,48,5.31,29,160,1399,9.1,0.2058757
18229,18229,Matthew Lombardi,2004-05,22.0,2,29,79,79,16,13,29,130.0,1140.0,79,16,13,29,130.0,82,5.14,57,348,2300,9.2,0.60953146
18230,18230,Matthew Lombardi,2006-07,24.0,3,26,55,55,6,20,26,72.0,778.0,134,22,33,55,202.0,82,6.05,85,480,2458,10.1,0.42758375
18231,18231,Matthew Lombardi,2007-08,25.0,4,46,81,81,20,26,46,176.0,1326.0,215,42,59,101,378.0,82,5.76,70,398,2426,9.7,0.547824
18232,18232,Matthew Lombardi,2008-09,26.0,5,36,82,82,14,22,36,181.0,1420.0,297,56,81,137,559.0,82,5.44,62,351,2383,9.4,0.53631425
18233,18233,Matthew Lombardi,2009-10,27.0,6,46,69,69,14,32,46,177.0,1220.0,366,70,113,183,736.0,82,5.7,65,341,2477,9.4,0.5838298
18234,18234,Matthew Lombardi,2010-11,28.0,7,53,78,78,19,34,53,174.0,1399.0,444,89,147,236,910.0,82,5.53,56,304,2486,9.1,0.5920838
18235,18235,Matthew Lombardi,2011-12,29.0,8,0,2,2,0,0,0,6.0,30.0,446,89,147,236,916.0,82,5.46,52,291,2492,9.0,0.30340898
18236,18236,Matthew Lombardi,2012-13,30.0,9,18,62,62,8,10,18,101.0,841.0,508,97,157,254,1017.0,82,5.32,47,271,2439,8.9,0.32589716
18237,18237,Matthew Lombardi,2013-14,31.0,10,8,28,28,4,4,8,44.0,391.0,536,101,161,262,1061.0,48,5.31,29,160,1399,9.1,0.33922046
18238,18238,Matthew Lorito,2017-18,27.0,2,1,2,2,0,1,1,6.0,29.0,2,0,1,1,6.0,82,5.45,47,245,2478,9.0,0.19357064
18239,18239,Matthew Nieto,2014-15,22.0,2,24,66,66,10,14,24,124.0,929.0,66,10,14,24,124.0,82,5.34,48,269,2463,8.9,0.365839
18240,18240,Matthew Nieto,2015-16,23.0,3,27,72,72,10,17,27,135.0,1098.0,138,20,31,51,259.0,82,5.32,47,251,2453,8.9,0.39668033
18241,18241,Matthew Nieto,2016-17,24.0,4,17,67,67,8,9,17,90.0,882.0,205,28,40,68,349.0,82,5.34,48,255,2438,9.0,0.30103153
18242,18242,Matthew Nieto,2017-18,25.0,5,13,59,59,7,6,13,85.0,881.0,264,35,46,81,434.0,82,5.45,47,245,2478,9.0,0.27237427
18243,18243,Matthew Nieto,2018-19,26.0,6,26,74,74,15,11,26,84.0,1103.0,338,50,57,107,518.0,82,5.86,50,250,2620,9.2,0.3711695
18244,18244,Matthew Nieto,2019-20,27.0,7,23,64,64,4,19,23,86.0,881.0,402,54,76,130,604.0,82,5.96,47,239,2579,9.5,0.2857777
18245,18245,Matthew Nieto,2020-21,28.0,8,21,70,70,8,13,21,85.0,945.0,472,62,89,151,689.0,70,5.96,42,208,2192,9.5,0.3265107
18246,18246,Matthew Peca,2017-18,24.0,2,2,10,10,1,1,2,9.0,114.0,10,1,1,2,9.0,82,5.45,47,245,2478,9.0,0.21188858
18247,18247,Matthew Peca,2018-19,25.0,3,5,10,10,2,3,5,17.0,137.0,20,3,4,7,26.0,82,5.86,50,250,2620,9.2,0.22643363
18248,18248,Matthew Peca,2019-20,26.0,4,10,39,39,3,7,10,35.0,410.0,59,6,11,17,61.0,82,5.96,47,239,2579,9.5,0.21243754
18249,18249,Matthew Peca,2020-21,27.0,5,2,14,14,0,2,2,7.0,146.0,73,6,13,19,68.0,70,5.96,42,208,2192,9.5,0.17924002
18250,18250,Matthew Spiller,2004-05,21.0,2,0,51,51,0,0,0,22.0,546.0,51,0,0,0,22.0,82,5.14,57,348,2300,9.2,0.15030503
18251,18251,Matthew Spiller,2006-07,23.0,3,1,8,8,0,1,1,3.0,84.0,59,0,1,1,25.0,82,6.05,85,480,2458,10.1,0.15647131
18252,18252,Matthew Spiller,2008-09,25.0,4,1,9,9,0,1,1,6.0,178.0,68,0,2,2,31.0,82,5.44,62,351,2383,9.4,0.13649336
18253,18253,Matthew Tkachuk,2017-18,20.0,2,48,76,76,13,35,48,142.0,1114.0,76,13,35,48,142.0,82,5.45,47,245,2478,9.0,0.63921255
18254,18254,Matthew Tkachuk,2018-19,21.0,3,49,68,68,24,25,49,188.0,1173.0,144,37,60,97,330.0,82,5.86,50,250,2620,9.2,0.77049685
18255,18255,Matthew Tkachuk,2019-20,22.0,4,77,80,80,34,43,77,207.0,1408.0,224,71,103,174,537.0,82,5.96,47,239,2579,9.5,0.9211589
18256,18256,Matthew Tkachuk,2020-21,23.0,5,61,69,69,23,38,61,188.0,1263.0,293,94,141,235,725.0,70,5.96,42,208,2192,9.5,0.8933143
18257,18257,Matthieu Descoteaux,2001-02,24.0,2,2,5,5,1,1,2,6.0,76.0,5,1,1,2,6.0,82,5.51,63,376,2272,9.9,0.19998363
18258,18258,Mattias Ekholm,2012-13,22.0,2,0,2,2,0,0,0,1.0,25.0,2,0,0,0,1.0,82,5.32,47,271,2439,8.9,0.16564402
18259,18259,Mattias Ekholm,2013-14,23.0,3,0,1,1,0,0,0,0.0,16.0,3,0,0,0,1.0,48,5.31,29,160,1399,9.1,0.1865606
18260,18260,Mattias Ekholm,2014-15,24.0,4,9,62,62,1,8,9,58.0,1043.0,65,1,8,9,59.0,82,5.34,48,269,2463,8.9,0.1578109
18261,18261,Mattias Ekholm,2015-16,25.0,5,18,80,80,7,11,18,86.0,1521.0,145,8,19,27,145.0,82,5.32,47,251,2453,8.9,0.23616353
18262,18262,Mattias Ekholm,2016-17,26.0,6,35,82,82,8,27,35,114.0,1660.0,227,16,46,62,259.0,82,5.34,48,255,2438,9.0,0.37833858
18263,18263,Mattias Ekholm,2017-18,27.0,7,23,82,82,3,20,23,120.0,1924.0,309,19,66,85,379.0,82,5.45,47,245,2478,9.0,0.26231444
18264,18264,Mattias Ekholm,2018-19,28.0,8,34,81,81,10,24,34,135.0,1910.0,390,29,90,119,514.0,82,5.86,50,250,2620,9.2,0.41569835
18265,18265,Mattias Ekholm,2019-20,29.0,9,44,80,80,8,36,44,146.0,1869.0,470,37,126,163,660.0,82,5.96,47,239,2579,9.5,0.46925768
18266,18266,Mattias Ekholm,2020-21,30.0,10,33,68,68,8,25,33,154.0,1589.0,538,45,151,196,814.0,70,5.96,42,208,2192,9.5,0.44699103
18267,18267,Mattias Janmark,2016-17,24.0,2,29,73,73,15,14,29,108.0,1035.0,73,15,14,29,108.0,82,5.34,48,255,2438,9.0,0.40303147
18268,18268,Mattias Janmark,2018-19,26.0,3,34,81,81,19,15,34,136.0,1371.0,154,34,29,63,244.0,82,5.86,50,250,2620,9.2,0.41137648
18269,18269,Mattias Janmark,2019-20,27.0,4,25,81,81,6,19,25,105.0,1233.0,235,40,48,88,349.0,82,5.96,47,239,2579,9.5,0.32835528
18270,18270,Mattias Janmark,2020-21,28.0,5,21,62,62,6,15,21,86.0,906.0,297,46,63,109,435.0,70,5.96,42,208,2192,9.5,0.3341872
18271,18271,Mattias Norstrom,1994-95,23.0,2,2,9,9,0,2,2,3.0,,9,0,2,2,3.0,84,6.48,76,407,2545,10.7,0.202981
18272,18272,Mattias Norstrom,1995-96,24.0,3,3,9,9,0,3,3,4.0,,18,0,5,5,7.0,48,5.97,37,209,1408,10.2,0.2089425
18273,18273,Mattias Norstrom,1996-97,25.0,4,4,36,36,2,2,4,34.0,,54,2,7,9,41.0,82,6.29,74,413,2481,10.4,0.17892486
18274,18274,Mattias Norstrom,1997-98,26.0,5,22,80,80,1,21,22,106.0,,134,3,28,31,147.0,82,5.83,55,336,2444,9.8,0.22325116
18275,18275,Mattias Norstrom,1998-99,27.0,6,13,73,73,1,12,13,61.0,,207,4,40,44,208.0,82,5.28,57,380,2242,9.6,0.17357919
18276,18276,Mattias Norstrom,1999-00,28.0,7,7,78,78,2,5,7,61.0,1586.0,285,6,45,51,269.0,82,5.27,57,359,2285,9.4,0.15390646
18277,18277,Mattias Norstrom,2000-01,29.0,8,14,82,82,1,13,14,62.0,1789.0,367,7,58,65,331.0,82,5.49,53,331,2294,9.8,0.15138319
18278,18278,Mattias Norstrom,2001-02,30.0,9,18,82,82,0,18,18,59.0,1790.0,449,7,76,83,390.0,82,5.51,63,376,2272,9.9,0.20270321
18279,18279,Mattias Norstrom,2002-03,31.0,10,11,79,79,2,9,11,42.0,1819.0,528,9,85,94,432.0,82,5.24,53,338,2262,9.5,0.15911666
18280,18280,Mattias Norstrom,2003-04,32.0,11,6,82,82,0,6,6,63.0,1763.0,610,9,91,100,495.0,82,5.31,60,363,2326,9.4,0.13053271
18281,18281,Mattias Norstrom,2004-05,33.0,12,14,74,74,1,13,14,65.0,1660.0,684,10,104,114,560.0,82,5.14,57,348,2300,9.2,0.1368464
18282,18282,Mattias Norstrom,2006-07,35.0,13,27,77,77,4,23,27,83.0,1625.0,761,14,127,141,643.0,82,6.05,85,480,2458,10.1,0.24678811
18283,18283,Mattias Norstrom,2007-08,36.0,14,11,76,76,2,9,11,60.0,1562.0,837,16,136,152,703.0,82,5.76,70,398,2426,9.7,0.12258804
18284,18284,Mattias Norstrom,2008-09,37.0,15,13,66,66,2,11,13,54.0,1287.0,903,18,147,165,757.0,82,5.44,62,351,2383,9.4,0.13206223
18285,18285,Mattias Ohlund,1998-99,22.0,2,30,77,77,7,23,30,172.0,,77,7,23,30,172.0,82,5.28,57,380,2242,9.6,0.47320783
18286,18286,Mattias Ohlund,1999-00,23.0,3,35,74,74,9,26,35,129.0,1929.0,151,16,49,65,301.0,82,5.27,57,359,2285,9.4,0.47265798
18287,18287,Mattias Ohlund,2000-01,24.0,4,20,42,42,4,16,20,63.0,1163.0,193,20,65,85,364.0,82,5.49,53,331,2294,9.8,0.4121978
18288,18288,Mattias Ohlund,2001-02,25.0,5,28,65,65,8,20,28,136.0,1625.0,258,28,85,113,500.0,82,5.51,63,376,2272,9.9,0.45373088
18289,18289,Mattias Ohlund,2002-03,26.0,6,36,81,81,10,26,36,193.0,2048.0,339,38,111,149,693.0,82,5.24,53,338,2262,9.5,0.52709085
18290,18290,Mattias Ohlund,2003-04,27.0,7,29,59,59,2,27,29,100.0,1498.0,398,40,138,178,793.0,82,5.31,60,363,2326,9.4,0.43813804
18291,18291,Mattias Ohlund,2004-05,28.0,8,34,82,82,14,20,34,129.0,2115.0,480,54,158,212,922.0,82,5.14,57,348,2300,9.2,0.47722894
18292,18292,Mattias Ohlund,2006-07,30.0,9,33,78,78,13,20,33,183.0,2002.0,558,67,178,245,1105.0,82,6.05,85,480,2458,10.1,0.4324012
18293,18293,Mattias Ohlund,2007-08,31.0,10,31,77,77,11,20,31,170.0,1909.0,635,78,198,276,1275.0,82,5.76,70,398,2426,9.7,0.38887247
18294,18294,Mattias Ohlund,2008-09,32.0,11,24,53,53,9,15,24,128.0,1260.0,688,87,213,300,1403.0,82,5.44,62,351,2383,9.4,0.42365056
18295,18295,Mattias Ohlund,2009-10,33.0,12,25,82,82,6,19,25,131.0,1769.0,770,93,232,325,1534.0,82,5.7,65,341,2477,9.4,0.308787
18296,18296,Mattias Ohlund,2010-11,34.0,13,13,67,67,0,13,13,71.0,1529.0,837,93,245,338,1605.0,82,5.53,56,304,2486,9.1,0.17135799
18297,18297,Mattias Ohlund,2011-12,35.0,14,5,72,72,0,5,5,39.0,1348.0,909,93,250,343,1644.0,82,5.46,52,291,2492,9.0,0.14539433
18298,18298,Mattias Ritola,2008-09,21.0,2,1,2,2,0,1,1,2.0,12.0,2,0,1,1,2.0,82,5.44,62,351,2383,9.4,0.24627036
18299,18299,Mattias Ritola,2010-11,23.0,3,0,5,5,0,0,0,9.0,58.0,7,0,1,1,11.0,82,5.53,56,304,2486,9.1,0.17974317
18300,18300,Mattias Ritola,2011-12,24.0,4,8,31,31,4,4,8,42.0,312.0,38,4,5,9,53.0,82,5.46,52,291,2492,9.0,0.2328546
18301,18301,Mattias Ritola,2012-13,25.0,5,0,5,5,0,0,0,14.0,54.0,43,4,5,9,67.0,82,5.32,47,271,2439,8.9,0.15813905
18302,18302,Mattias Tedenby,2011-12,21.0,2,22,58,58,8,14,22,87.0,728.0,58,8,14,22,87.0,82,5.46,52,291,2492,9.0,0.37967223
18303,18303,Mattias Tedenby,2012-13,22.0,3,6,43,43,1,5,6,46.0,462.0,101,9,19,28,133.0,82,5.32,47,271,2439,8.9,0.27790415
18304,18304,Mattias Tedenby,2013-14,23.0,4,1,4,4,0,1,1,2.0,36.0,105,9,20,29,135.0,48,5.31,29,160,1399,9.1,0.26262426
18305,18305,Mattias Tedenby,2014-15,24.0,5,1,15,15,1,0,1,9.0,150.0,120,10,20,30,144.0,82,5.34,48,269,2463,8.9,0.18750814
18306,18306,Mattias Timander,1997-98,23.0,2,9,41,41,1,8,9,62.0,,41,1,8,9,62.0,82,5.83,55,336,2444,9.8,0.2124938
18307,18307,Mattias Timander,1998-99,24.0,3,2,23,23,1,1,2,17.0,,64,2,9,11,79.0,82,5.28,57,380,2242,9.6,0.16931447
18308,18308,Mattias Timander,1999-00,25.0,4,6,22,22,0,6,6,22.0,284.0,86,2,15,17,101.0,82,5.27,57,359,2285,9.4,0.19230965
18309,18309,Mattias Timander,2000-01,26.0,5,8,60,60,0,8,8,39.0,749.0,146,2,23,25,140.0,82,5.49,53,331,2294,9.8,0.12957138
18310,18310,Mattias Timander,2001-02,27.0,6,11,76,76,2,9,11,68.0,1599.0,222,4,32,36,208.0,82,5.51,63,376,2272,9.9,0.16088966
18311,18311,Mattias Timander,2002-03,28.0,7,11,78,78,4,7,11,68.0,1549.0,300,8,39,47,276.0,82,5.24,53,338,2262,9.5,0.16411221
18312,18312,Mattias Timander,2003-04,29.0,8,16,80,80,3,13,16,83.0,1399.0,380,11,52,63,359.0,82,5.31,60,363,2326,9.4,0.19520792
18313,18313,Mattias Timander,2004-05,30.0,9,7,39,39,2,5,7,46.0,699.0,419,13,57,70,405.0,82,5.14,57,348,2300,9.2,0.1953857
18314,18314,Mattias Weinhandl,2003-04,23.0,2,23,47,47,6,17,23,66.0,652.0,47,6,17,23,66.0,82,5.31,60,363,2326,9.4,0.41141975
18315,18315,Mattias Weinhandl,2004-05,24.0,3,20,55,55,8,12,20,49.0,678.0,102,14,29,43,115.0,82,5.14,57,348,2300,9.2,0.3522169
18316,18316,Mattias Weinhandl,2006-07,26.0,4,11,68,68,4,7,11,57.0,624.0,170,18,36,54,172.0,82,6.05,85,480,2458,10.1,0.19696698
18317,18317,Mattias Weinhandl,2007-08,27.0,5,2,12,12,1,1,2,3.0,78.0,182,19,37,56,175.0,82,5.76,70,398,2426,9.7,0.20269212
18318,18318,Max Comtois,2019-20,21.0,2,7,10,10,2,5,7,9.0,146.0,10,2,5,7,9.0,82,5.96,47,239,2579,9.5,0.32558078
18319,18319,Max Comtois,2020-21,22.0,3,11,29,29,5,6,11,32.0,405.0,39,7,11,18,41.0,70,5.96,42,208,2192,9.5,0.34571427
18320,18320,Max Domi,2016-17,21.0,2,52,81,81,18,34,52,156.0,1326.0,81,18,34,52,156.0,82,5.34,48,255,2438,9.0,0.6609828
18321,18321,Max Domi,2017-18,22.0,3,38,59,59,9,29,38,108.0,1002.0,140,27,63,90,264.0,82,5.45,47,245,2478,9.0,0.5402108
18322,18322,Max Domi,2018-19,23.0,4,45,82,82,9,36,45,150.0,1370.0,222,36,99,135,414.0,82,5.86,50,250,2620,9.2,0.6328342
18323,18323,Max Domi,2019-20,24.0,5,72,82,82,28,44,72,203.0,1425.0,304,64,143,207,617.0,82,5.96,47,239,2579,9.5,0.87293434
18324,18324,Max Domi,2020-21,25.0,6,44,71,71,17,27,44,179.0,1214.0,375,81,170,251,796.0,70,5.96,42,208,2192,9.5,0.65902805
18325,18325,Max Friberg,2015-16,23.0,2,0,1,1,0,0,0,0.0,9.0,1,0,0,0,0.0,82,5.32,47,251,2453,8.9,0.14718214
18326,18326,Max Friberg,2016-17,24.0,3,0,5,5,0,0,0,1.0,44.0,6,0,0,0,1.0,82,5.34,48,255,2438,9.0,0.1547715
18327,18327,Max Jones,2019-20,21.0,2,5,30,30,2,3,5,58.0,395.0,30,2,3,5,58.0,82,5.96,47,239,2579,9.5,0.29966658
18328,18328,Max Jones,2020-21,22.0,3,12,59,59,8,4,12,102.0,842.0,89,10,7,17,160.0,70,5.96,42,208,2192,9.5,0.3008098
18329,18329,Max McCormick,2016-17,24.0,2,4,20,20,2,2,4,37.0,209.0,20,2,2,4,37.0,82,5.34,48,255,2438,9.0,0.21630573
18330,18330,Max McCormick,2017-18,25.0,3,0,7,7,0,0,0,7.0,47.0,27,2,2,4,44.0,82,5.45,47,245,2478,9.0,0.16525629
18331,18331,Max McCormick,2018-19,26.0,4,5,30,30,3,2,5,33.0,251.0,57,5,4,9,77.0,82,5.86,50,250,2620,9.2,0.21637148
18332,18332,Max McCormick,2019-20,27.0,5,1,14,14,1,0,1,12.0,105.0,71,6,4,10,89.0,82,5.96,47,239,2579,9.5,0.17461768
18333,18333,Max Middendorf,1987-88,20.0,2,5,6,6,1,4,5,4.0,,6,1,4,5,4.0,80,7.34,72,344,2400,12.2,0.3457773
18334,18334,Max Middendorf,1988-89,21.0,3,0,1,1,0,0,0,0.0,,7,1,4,5,4.0,80,7.43,89,437,2435,12.2,0.25828445
18335,18335,Max Middendorf,1990-91,23.0,4,0,3,3,0,0,0,5.0,,10,1,4,5,9.0,80,7.37,76,367,2421,12.2,0.20271629
18336,18336,Max Middendorf,1991-92,24.0,5,1,3,3,1,0,1,1.0,,13,2,4,6,10.0,80,6.91,71,366,2385,11.6,0.20885882
18337,18337,Max Pacioretty,2009-10,21.0,2,11,34,34,3,8,11,57.0,429.0,34,3,8,11,57.0,82,5.7,65,341,2477,9.4,0.31903845
18338,18338,Max Pacioretty,2010-11,22.0,3,14,52,52,3,11,14,74.0,661.0,86,6,19,25,131.0,82,5.53,56,304,2486,9.1,0.32201415
18339,18339,Max Pacioretty,2011-12,23.0,4,24,37,37,14,10,24,112.0,588.0,123,20,29,49,243.0,82,5.46,52,291,2492,9.0,0.5421366
18340,18340,Max Pacioretty,2012-13,24.0,5,65,79,79,33,32,65,286.0,1443.0,202,53,61,114,529.0,82,5.32,47,271,2439,8.9,0.8329926
18341,18341,Max Pacioretty,2013-14,25.0,6,39,44,44,15,24,39,163.0,726.0,246,68,85,153,692.0,48,5.31,29,160,1399,9.1,0.8491075
18342,18342,Max Pacioretty,2014-15,26.0,7,60,73,73,39,21,60,270.0,1350.0,319,107,106,213,962.0,82,5.34,48,269,2463,8.9,0.766272
18343,18343,Max Pacioretty,2015-16,27.0,8,67,80,80,37,30,67,302.0,1552.0,399,144,136,280,1264.0,82,5.32,47,251,2453,8.9,0.7609619
18344,18344,Max Pacioretty,2016-17,28.0,9,64,82,82,30,34,64,303.0,1519.0,481,174,170,344,1567.0,82,5.34,48,255,2438,9.0,0.75412315
18345,18345,Max Pacioretty,2017-18,29.0,10,67,81,81,35,32,67,268.0,1553.0,562,209,202,411,1835.0,82,5.45,47,245,2478,9.0,0.8531425
18346,18346,Max Pacioretty,2018-19,30.0,11,37,64,64,17,20,37,212.0,1217.0,626,226,222,448,2047.0,82,5.86,50,250,2620,9.2,0.60386497
18347,18347,Max Pacioretty,2019-20,31.0,12,40,66,66,22,18,40,191.0,1122.0,692,248,240,488,2238.0,82,5.96,47,239,2579,9.5,0.62833565
18348,18348,Max Pacioretty,2020-21,32.0,13,66,71,71,32,34,66,307.0,1272.0,763,280,274,554,2545.0,70,5.96,42,208,2192,9.5,0.74403334
18349,18349,Max Reinhart,2013-14,21.0,2,3,11,11,1,2,3,26.0,159.0,11,1,2,3,26.0,48,5.31,29,160,1399,9.1,0.32965702
18350,18350,Max Reinhart,2014-15,22.0,3,2,8,8,0,2,2,7.0,86.0,19,1,4,5,33.0,82,5.34,48,269,2463,8.9,0.18116173
18351,18351,Max Reinhart,2015-16,23.0,4,0,4,4,0,0,0,3.0,32.0,23,1,4,5,36.0,82,5.32,47,251,2453,8.9,0.16222048
18352,18352,Max Sauve,2012-13,23.0,2,0,1,1,0,0,0,0.0,4.0,1,0,0,0,0.0,82,5.32,47,271,2439,8.9,0.14553902
18353,18353,Max Veronneau,2019-20,24.0,2,4,12,12,2,2,4,15.0,150.0,12,2,2,4,15.0,82,5.96,47,239,2579,9.5,0.2361688
18354,18354,Max Veronneau,2020-21,25.0,3,0,4,4,0,0,0,3.0,34.0,16,2,2,4,18.0,70,5.96,42,208,2192,9.5,0.17485717
18355,18355,Maxim Afinogenov,2000-01,21.0,2,34,65,65,16,18,34,128.0,854.0,65,16,18,34,128.0,82,5.49,53,331,2294,9.8,0.5308142
18356,18356,Maxim Afinogenov,2001-02,22.0,3,36,78,78,14,22,36,190.0,1134.0,143,30,40,70,318.0,82,5.51,63,376,2272,9.9,0.53073853
18357,18357,Maxim Afinogenov,2002-03,23.0,4,40,81,81,21,19,40,234.0,1245.0,224,51,59,110,552.0,82,5.24,53,338,2262,9.5,0.5874095
18358,18358,Maxim Afinogenov,2003-04,24.0,5,11,35,35,5,6,11,77.0,469.0,259,56,65,121,629.0,82,5.31,60,363,2326,9.4,0.4132355
18359,18359,Maxim Afinogenov,2004-05,25.0,6,31,73,73,17,14,31,148.0,1004.0,332,73,79,152,777.0,82,5.14,57,348,2300,9.2,0.57975143
18360,18360,Maxim Afinogenov,2006-07,27.0,7,73,77,77,22,51,73,241.0,1258.0,409,95,130,225,1018.0,82,6.05,85,480,2458,10.1,0.8109696
18361,18361,Maxim Afinogenov,2007-08,28.0,8,61,56,56,23,38,61,151.0,955.0,465,118,168,286,1169.0,82,5.76,70,398,2426,9.7,0.83303297
18362,18362,Maxim Afinogenov,2008-09,29.0,9,28,56,56,10,18,28,114.0,899.0,521,128,186,314,1283.0,82,5.44,62,351,2383,9.4,0.4916288
18363,18363,Maxim Afinogenov,2009-10,30.0,10,20,48,48,6,14,20,93.0,605.0,569,134,200,334,1376.0,82,5.7,65,341,2477,9.4,0.43171632
18364,18364,Maxim Afinogenov,2010-11,31.0,11,61,82,82,24,37,61,181.0,1426.0,651,158,237,395,1557.0,82,5.53,56,304,2486,9.1,0.6668358
18365,18365,Maxim Balmochnykh,2000-01,21.0,2,1,6,6,0,1,1,6.0,40.0,6,0,1,1,6.0,82,5.49,53,331,2294,9.8,0.22999868
18366,18366,Maxim Bets,1994-95,21.0,2,0,3,3,0,0,0,1.0,,3,0,0,0,1.0,84,6.48,76,407,2545,10.7,0.1968121
18367,18367,Maxim Galanov,1998-99,24.0,2,1,6,6,0,1,1,5.0,,6,0,1,1,5.0,82,5.28,57,380,2242,9.6,0.1858283
18368,18368,Maxim Galanov,1999-00,25.0,3,7,51,51,4,3,7,44.0,776.0,57,4,4,8,49.0,82,5.27,57,359,2285,9.4,0.17110652
18369,18369,Maxim Galanov,2000-01,26.0,4,7,40,40,4,3,7,47.0,861.0,97,8,7,15,96.0,82,5.49,53,331,2294,9.8,0.20481041
18370,18370,Maxim Galanov,2001-02,27.0,5,5,25,25,0,5,5,10.0,405.0,122,8,12,20,106.0,82,5.51,63,376,2272,9.9,0.11152589
18371,18371,Maxim Kondratiev,2004-05,22.0,2,0,7,7,0,0,0,6.0,109.0,7,0,0,0,6.0,82,5.14,57,348,2300,9.2,0.20391458
18372,18372,Maxim Kondratiev,2006-07,24.0,3,3,29,29,1,2,3,16.0,472.0,36,1,2,3,22.0,82,6.05,85,480,2458,10.1,0.15378508
18373,18373,Maxim Kondratiev,2008-09,26.0,4,0,4,4,0,0,0,1.0,30.0,40,1,2,3,23.0,82,5.44,62,351,2383,9.4,0.14323586
18374,18374,Maxim Kuznetsov,2001-02,24.0,2,3,25,25,1,2,3,17.0,237.0,25,1,2,3,17.0,82,5.51,63,376,2272,9.9,0.15737903
18375,18375,Maxim Kuznetsov,2002-03,25.0,3,3,39,39,1,2,3,27.0,462.0,64,2,4,6,44.0,82,5.24,53,338,2262,9.5,0.12549868
18376,18376,Maxim Kuznetsov,2003-04,26.0,4,3,56,56,0,3,3,33.0,748.0,120,2,7,9,77.0,82,5.31,60,363,2326,9.4,0.13164485
18377,18377,Maxim Kuznetsov,2004-05,27.0,5,1,16,16,0,1,1,11.0,243.0,136,2,8,10,88.0,82,5.14,57,348,2300,9.2,0.1718826
18378,18378,Maxim Lapierre,2006-07,21.0,2,0,1,1,0,0,0,0.0,3.0,1,0,0,0,0.0,82,6.05,85,480,2458,10.1,0.18894121
18379,18379,Maxim Lapierre,2007-08,22.0,3,12,46,46,6,6,12,82.0,525.0,47,6,6,12,82.0,82,5.76,70,398,2426,9.7,0.30571377
18380,18380,Maxim Lapierre,2008-09,23.0,4,18,53,53,7,11,18,68.0,698.0,100,13,17,30,150.0,82,5.44,62,351,2383,9.4,0.3853141
18381,18381,Maxim Lapierre,2009-10,24.0,5,28,79,79,15,13,28,165.0,1169.0,179,28,30,58,315.0,82,5.7,65,341,2477,9.4,0.4013823
18382,18382,Maxim Lapierre,2010-11,25.0,6,14,76,76,7,7,14,101.0,933.0,255,35,37,72,416.0,82,5.53,56,304,2486,9.1,0.23169026
18383,18383,Maxim Lapierre,2011-12,26.0,7,12,78,78,6,6,12,129.0,907.0,333,41,43,84,545.0,82,5.46,52,291,2492,9.0,0.24735788
18384,18384,Maxim Lapierre,2012-13,27.0,8,19,82,82,9,10,19,103.0,921.0,415,50,53,103,648.0,82,5.32,47,271,2439,8.9,0.25104558
18385,18385,Maxim Lapierre,2013-14,28.0,9,10,48,48,4,6,10,54.0,605.0,463,54,59,113,702.0,48,5.31,29,160,1399,9.1,0.22688419
18386,18386,Maxim Lapierre,2014-15,29.0,10,15,71,71,9,6,15,78.0,793.0,534,63,65,128,780.0,82,5.34,48,269,2463,8.9,0.23323205
18387,18387,Maxim Lapierre,2015-16,30.0,11,11,80,80,2,9,11,86.0,857.0,614,65,74,139,866.0,82,5.32,47,251,2453,8.9,0.17794538
18388,18388,Maxim Letunov,2020-21,24.0,2,1,3,3,1,0,1,3.0,27.0,3,1,0,1,3.0,70,5.96,42,208,2192,9.5,0.23345041
18389,18389,Maxim Mamin,2018-19,24.0,2,4,26,26,3,1,4,28.0,274.0,26,3,1,4,28.0,82,5.86,50,250,2620,9.2,0.22330093
18390,18390,Maxim Mamin,2019-20,25.0,3,0,7,7,0,0,0,8.0,51.0,33,3,1,4,36.0,82,5.96,47,239,2579,9.5,0.16528276
18391,18391,Maxim Noreau,2010-11,23.0,2,0,1,1,0,0,0,0.0,7.0,1,0,0,0,0.0,82,5.53,56,304,2486,9.1,0.1638569
18392,18392,Maxim Noreau,2011-12,24.0,3,0,5,5,0,0,0,8.0,71.0,6,0,0,0,8.0,82,5.46,52,291,2492,9.0,0.1634143
18393,18393,Maxim Sushinsky,2001-02,27.0,2,11,30,30,7,4,11,62.0,420.0,30,7,4,11,62.0,82,5.51,63,376,2272,9.9,0.2860619
18394,18394,Maxime Fortunus,2010-11,27.0,2,0,8,8,0,0,0,5.0,121.0,8,0,0,0,5.0,82,5.53,56,304,2486,9.1,0.18110988
18395,18395,Maxime Fortunus,2014-15,31.0,3,1,1,1,0,1,1,0.0,16.0,9,0,1,1,5.0,82,5.34,48,269,2463,8.9,0.15800989
18396,18396,Maxime Lajoie,2019-20,22.0,2,15,56,56,7,8,15,79.0,1059.0,56,7,8,15,79.0,82,5.96,47,239,2579,9.5,0.31100824
18397,18397,Maxime Lajoie,2020-21,23.0,3,0,6,6,0,0,0,3.0,47.0,62,7,8,15,82.0,70,5.96,42,208,2192,9.5,0.22699875
18398,18398,Maxime Macenauer,2012-13,24.0,2,4,29,29,1,3,4,14.0,314.0,29,1,3,4,14.0,82,5.32,47,271,2439,8.9,0.13758558
18399,18399,Maxime Talbot,2006-07,22.0,2,8,48,48,5,3,8,45.0,526.0,48,5,3,8,45.0,82,6.05,85,480,2458,10.1,0.23679143
18400,18400,Maxime Talbot,2007-08,23.0,3,24,75,75,13,11,24,88.0,1042.0,123,18,14,32,133.0,82,5.76,70,398,2426,9.7,0.34458363
18401,18401,Maxime Talbot,2008-09,24.0,4,26,63,63,12,14,26,80.0,974.0,186,30,28,58,213.0,82,5.44,62,351,2383,9.4,0.38590854
18402,18402,Maxime Talbot,2009-10,25.0,5,22,75,75,12,10,22,102.0,1060.0,261,42,38,80,315.0,82,5.7,65,341,2477,9.4,0.31851435
18403,18403,Maxime Talbot,2010-11,26.0,6,7,45,45,2,5,7,49.0,550.0,306,44,43,87,364.0,82,5.53,56,304,2486,9.1,0.20397297
18404,18404,Maxime Talbot,2011-12,27.0,7,21,82,82,8,13,21,117.0,1236.0,388,52,56,108,481.0,82,5.46,52,291,2492,9.0,0.26931816
18405,18405,Maxime Talbot,2012-13,28.0,8,34,81,81,19,15,34,115.0,1296.0,469,71,71,142,596.0,82,5.32,47,271,2439,8.9,0.39127654
18406,18406,Maxime Talbot,2013-14,29.0,9,10,35,35,5,5,10,41.0,540.0,504,76,76,152,637.0,48,5.31,29,160,1399,9.1,0.2887933
18407,18407,Maxime Talbot,2014-15,30.0,10,27,81,81,8,19,27,124.0,1309.0,585,84,95,179,761.0,82,5.34,48,269,2463,8.9,0.3022825
18408,18408,Maxime Talbot,2015-16,31.0,11,18,81,81,5,13,18,97.0,1102.0,666,89,108,197,858.0,82,5.32,47,251,2453,8.9,0.24863666
18409,18409,Maxime Talbot,2016-17,32.0,12,7,38,38,2,5,7,29.0,426.0,704,91,113,204,887.0,82,5.34,48,255,2438,9.0,0.18882674
18410,18410,Maynard Schurman,1980-81,23.0,2,0,7,7,0,0,0,5.0,,7,0,0,0,5.0,80,7.03,61,280,2352,12.0,0.22293451
18411,18411,Mel Angelstad,2004-05,32.0,2,0,2,2,0,0,0,1.0,26.0,2,0,0,0,1.0,82,5.14,57,348,2300,9.2,0.164558
18412,18412,Melker Karlsson,2015-16,25.0,2,24,53,53,13,11,24,100.0,818.0,53,13,11,24,100.0,82,5.32,47,251,2453,8.9,0.43348637
18413,18413,Melker Karlsson,2016-17,26.0,3,19,65,65,10,9,19,96.0,879.0,118,23,20,43,196.0,82,5.34,48,255,2438,9.0,0.294289
18414,18414,Melker Karlsson,2017-18,27.0,4,22,67,67,11,11,22,73.0,858.0,185,34,31,65,269.0,82,5.45,47,245,2478,9.0,0.29535192
18415,18415,Melker Karlsson,2018-19,28.0,5,19,71,71,8,11,19,76.0,941.0,256,42,42,84,345.0,82,5.86,50,250,2620,9.2,0.29007435
18416,18416,Melker Karlsson,2019-20,29.0,6,16,79,79,12,4,16,79.0,908.0,335,54,46,100,424.0,82,5.96,47,239,2579,9.5,0.24452612
18417,18417,Melker Karlsson,2020-21,30.0,7,12,61,61,6,6,12,56.0,748.0,396,60,52,112,480.0,70,5.96,42,208,2192,9.5,0.2427282
18418,18418,Micah Aivazoff,1994-95,25.0,2,8,59,59,4,4,8,52.0,,59,4,4,8,52.0,84,6.48,76,407,2545,10.7,0.17146665
18419,18419,Micah Aivazoff,1995-96,26.0,3,1,21,21,0,1,1,6.0,,80,4,5,9,58.0,48,5.97,37,209,1408,10.2,0.1349456
18420,18420,Micah Aivazoff,1996-97,27.0,4,1,12,12,0,1,1,8.0,,92,4,6,10,66.0,82,6.29,74,413,2481,10.4,0.13518488
18421,18421,Michael Amadio,2018-19,22.0,2,8,37,37,4,4,8,28.0,345.0,37,4,4,8,28.0,82,5.86,50,250,2620,9.2,0.26487863
18422,18422,Michael Amadio,2019-20,23.0,3,13,43,43,6,7,13,37.0,439.0,80,10,11,21,65.0,82,5.96,47,239,2579,9.5,0.27061373
18423,18423,Michael Amadio,2020-21,24.0,4,16,68,68,6,10,16,99.0,885.0,148,16,21,37,164.0,70,5.96,42,208,2192,9.5,0.28516012
18424,18424,Michael Anderson,2020-21,21.0,2,1,6,6,1,0,1,9.0,109.0,6,1,0,1,9.0,70,5.96,42,208,2192,9.5,0.2608857
18425,18425,Michael Bournival,2014-15,22.0,2,14,60,60,7,7,14,78.0,619.0,60,7,7,14,78.0,82,5.34,48,269,2463,8.9,0.27621338
18426,18426,Michael Bournival,2015-16,23.0,3,5,29,29,3,2,5,27.0,229.0,89,10,9,19,105.0,82,5.32,47,251,2453,8.9,0.2576918
18427,18427,Michael Bournival,2017-18,25.0,4,3,19,19,2,1,3,25.0,193.0,108,12,10,22,130.0,82,5.45,47,245,2478,9.0,0.22941867
18428,18428,Michael Bournival,2018-19,26.0,5,0,5,5,0,0,0,5.0,47.0,113,12,10,22,135.0,82,5.86,50,250,2620,9.2,0.17422512
18429,18429,Michael Bunting,2019-20,24.0,2,1,5,5,1,0,1,5.0,48.0,5,1,0,1,5.0,82,5.96,47,239,2579,9.5,0.20740777
18430,18430,Michael Caruso,2013-14,25.0,2,0,2,2,0,0,0,0.0,16.0,2,0,0,0,0.0,48,5.31,29,160,1399,9.1,0.18009916
18431,18431,Michael Chaput,2014-15,22.0,2,1,17,17,0,1,1,6.0,151.0,17,0,1,1,6.0,82,5.34,48,269,2463,8.9,0.1710138
18432,18432,Michael Chaput,2015-16,23.0,3,5,33,33,1,4,5,23.0,337.0,50,1,5,6,29.0,82,5.32,47,251,2453,8.9,0.20671105
18433,18433,Michael Chaput,2016-17,24.0,4,2,8,8,1,1,2,10.0,72.0,58,2,6,8,39.0,82,5.34,48,255,2438,9.0,0.18533835
18434,18434,Michael Chaput,2017-18,25.0,5,9,68,68,4,5,9,64.0,750.0,126,6,11,17,103.0,82,5.45,47,245,2478,9.0,0.15816978
18435,18435,Michael Chaput,2018-19,26.0,6,0,9,9,0,0,0,2.0,88.0,135,6,11,17,105.0,82,5.86,50,250,2620,9.2,0.14070275
18436,18436,Michael Chaput,2019-20,27.0,7,5,32,32,0,5,5,31.0,359.0,167,6,16,22,136.0,82,5.96,47,239,2579,9.5,0.14121556
18437,18437,Michael Chaput,2020-21,28.0,8,0,2,2,0,0,0,2.0,20.0,169,6,16,22,138.0,70,5.96,42,208,2192,9.5,0.13237426
18438,18438,Michael Colman,1992-93,24.0,2,1,15,15,0,1,1,7.0,,15,0,1,1,7.0,80,6.96,77,402,2440,11.4,0.21694094
18439,18439,Michael Dal Colle,2018-19,22.0,2,0,4,4,0,0,0,1.0,53.0,4,0,0,0,1.0,82,5.86,50,250,2620,9.2,0.1645863
18440,18440,Michael Dal Colle,2019-20,23.0,3,7,28,28,3,4,7,34.0,339.0,32,3,4,7,35.0,82,5.96,47,239,2579,9.5,0.25942063
18441,18441,Michael Dal Colle,2020-21,24.0,4,10,53,53,4,6,10,59.0,625.0,85,7,10,17,94.0,70,5.96,42,208,2192,9.5,0.26861903
18442,18442,Michael Dark,1987-88,24.0,2,2,13,13,2,0,2,4.0,,13,2,0,2,4.0,80,7.34,72,344,2400,12.2,0.31388235
18443,18443,Michael Dark,1988-89,25.0,3,9,30,30,3,6,9,27.0,,43,5,6,11,31.0,80,7.43,89,437,2435,12.2,0.25757924
18444,18444,Michael Del Zotto,2010-11,20.0,2,37,80,80,9,28,37,81.0,1518.0,80,9,28,37,81.0,82,5.53,56,304,2486,9.1,0.48290825
18445,18445,Michael Del Zotto,2011-12,21.0,3,11,47,47,2,9,11,58.0,916.0,127,11,37,48,139.0,82,5.46,52,291,2492,9.0,0.35988605
18446,18446,Michael Del Zotto,2012-13,22.0,4,41,77,77,10,31,41,113.0,1728.0,204,21,68,89,252.0,82,5.32,47,271,2439,8.9,0.48029402
18447,18447,Michael Del Zotto,2013-14,23.0,5,21,46,46,3,18,21,81.0,1066.0,250,24,86,110,333.0,48,5.31,29,160,1399,9.1,0.44613692
18448,18448,Michael Del Zotto,2014-15,24.0,6,16,67,67,3,13,16,90.0,1153.0,317,27,99,126,423.0,82,5.34,48,269,2463,8.9,0.31144187
18449,18449,Michael Del Zotto,2015-16,25.0,7,32,64,64,10,22,32,119.0,1403.0,381,37,121,158,542.0,82,5.32,47,251,2453,8.9,0.47855332
18450,18450,Michael Del Zotto,2016-17,26.0,8,13,52,52,4,9,13,98.0,1217.0,433,41,130,171,640.0,82,5.34,48,255,2438,9.0,0.31382233
18451,18451,Michael Del Zotto,2017-18,27.0,9,18,51,51,6,12,18,92.0,995.0,484,47,142,189,732.0,82,5.45,47,245,2478,9.0,0.40534636
18452,18452,Michael Del Zotto,2018-19,28.0,10,22,82,82,6,16,22,128.0,1706.0,566,53,158,211,860.0,82,5.86,50,250,2620,9.2,0.29645282
18453,18453,Michael Del Zotto,2019-20,29.0,11,10,42,42,1,9,10,45.0,715.0,608,54,167,221,905.0,82,5.96,47,239,2579,9.5,0.2065621
18454,18454,Michael Del Zotto,2020-21,30.0,12,15,49,49,2,13,15,57.0,917.0,657,56,180,236,962.0,70,5.96,42,208,2192,9.5,0.2700318
18455,18455,Michael Frolik,2009-10,21.0,2,45,79,79,21,24,45,158.0,1170.0,79,21,24,45,158.0,82,5.7,65,341,2477,9.4,0.6067262
18456,18456,Michael Frolik,2010-11,22.0,3,43,82,82,21,22,43,219.0,1433.0,161,42,46,88,377.0,82,5.53,56,304,2486,9.1,0.5900667
18457,18457,Michael Frolik,2011-12,23.0,4,38,80,80,11,27,38,251.0,1247.0,241,53,73,126,628.0,82,5.46,52,291,2492,9.0,0.52165747
18458,18458,Michael Frolik,2012-13,24.0,5,15,63,63,5,10,15,117.0,811.0,304,58,83,141,745.0,82,5.32,47,271,2439,8.9,0.3653251
18459,18459,Michael Frolik,2013-14,25.0,6,10,45,45,3,7,10,98.0,563.0,349,61,90,151,843.0,48,5.31,29,160,1399,9.1,0.3598577
18460,18460,Michael Frolik,2014-15,26.0,7,42,81,81,15,27,42,189.0,1351.0,430,76,117,193,1032.0,82,5.34,48,269,2463,8.9,0.55448925
18461,18461,Michael Frolik,2015-16,27.0,8,42,82,82,19,23,42,206.0,1435.0,512,95,140,235,1238.0,82,5.32,47,251,2453,8.9,0.56497294
18462,18462,Michael Frolik,2016-17,28.0,9,32,64,64,15,17,32,155.0,1012.0,576,110,157,267,1393.0,82,5.34,48,255,2438,9.0,0.5076202
18463,18463,Michael Frolik,2017-18,29.0,10,44,82,82,17,27,44,202.0,1401.0,658,127,184,311,1595.0,82,5.45,47,245,2478,9.0,0.5689552
18464,18464,Michael Frolik,2018-19,30.0,11,25,70,70,10,15,25,167.0,1185.0,728,137,199,336,1762.0,82,5.86,50,250,2620,9.2,0.3855118
18465,18465,Michael Frolik,2019-20,31.0,12,34,65,65,16,18,34,132.0,868.0,793,153,217,370,1894.0,82,5.96,47,239,2579,9.5,0.40937507
18466,18466,Michael Frolik,2020-21,32.0,13,14,57,57,6,8,14,70.0,709.0,850,159,225,384,1964.0,70,5.96,42,208,2192,9.5,0.28090695
18467,18467,Michael Funk,2007-08,21.0,2,2,5,5,0,2,2,1.0,17.0,5,0,2,2,1.0,82,5.76,70,398,2426,9.7,0.22850138
18468,18468,Michael Funk,2008-09,22.0,3,0,4,4,0,0,0,1.0,46.0,9,0,2,2,2.0,82,5.44,62,351,2383,9.4,0.16301623
18469,18469,Michael Grabner,2010-11,23.0,2,11,20,20,5,6,11,63.0,278.0,20,5,6,11,63.0,82,5.53,56,304,2486,9.1,0.35020524
18470,18470,Michael Grabner,2011-12,24.0,3,52,76,76,34,18,52,228.0,1146.0,96,39,24,63,291.0,82,5.46,52,291,2492,9.0,0.64448035
18471,18471,Michael Grabner,2012-13,25.0,4,32,78,78,20,12,32,174.0,1212.0,174,59,36,95,465.0,82,5.32,47,271,2439,8.9,0.49138206
18472,18472,Michael Grabner,2013-14,26.0,5,21,45,45,16,5,21,108.0,666.0,219,75,41,116,573.0,48,5.31,29,160,1399,9.1,0.54431665
18473,18473,Michael Grabner,2014-15,27.0,6,26,64,64,12,14,26,137.0,908.0,283,87,55,142,710.0,82,5.34,48,269,2463,8.9,0.3661731
18474,18474,Michael Grabner,2015-16,28.0,7,13,34,34,8,5,13,63.0,440.0,317,95,60,155,773.0,82,5.32,47,251,2453,8.9,0.32730797
18475,18475,Michael Grabner,2016-17,29.0,8,18,80,80,9,9,18,116.0,1158.0,397,104,69,173,889.0,82,5.34,48,255,2438,9.0,0.29124114
18476,18476,Michael Grabner,2017-18,30.0,9,40,76,76,27,13,40,162.0,1071.0,473,131,82,213,1051.0,82,5.45,47,245,2478,9.0,0.4992722
18477,18477,Michael Grabner,2018-19,31.0,10,36,80,80,27,9,36,167.0,1185.0,553,158,91,249,1218.0,82,5.86,50,250,2620,9.2,0.4381886
18478,18478,Michael Grabner,2019-20,32.0,11,16,41,41,9,7,16,65.0,590.0,594,167,98,265,1283.0,82,5.96,47,239,2579,9.5,0.31444377
18479,18479,Michael Grabner,2020-21,33.0,12,11,46,46,8,3,11,61.0,569.0,640,175,101,276,1344.0,70,5.96,42,208,2192,9.5,0.25500137
18480,18480,Michael Holmqvist,2004-05,25.0,2,2,21,21,2,0,2,18.0,176.0,21,2,0,2,18.0,82,5.14,57,348,2300,9.2,0.17723787
18481,18481,Michael Holmqvist,2006-07,27.0,3,20,72,72,10,10,20,106.0,975.0,93,12,10,22,124.0,82,6.05,85,480,2458,10.1,0.28698367
18482,18482,Michael Holmqvist,2007-08,28.0,4,13,63,63,6,7,13,80.0,868.0,156,18,17,35,204.0,82,5.76,70,398,2426,9.7,0.21073434
18483,18483,Michael Kapla,2017-18,23.0,2,0,5,5,0,0,0,4.0,87.0,5,0,0,0,4.0,82,5.45,47,245,2478,9.0,0.18040827
18484,18484,Michael Keränen,2016-17,27.0,2,0,1,1,0,0,0,0.0,6.0,1,0,0,0,0.0,82,5.34,48,255,2438,9.0,0.1396032
18485,18485,Michael Latta,2014-15,23.0,2,4,17,17,1,3,4,6.0,131.0,17,1,3,4,6.0,82,5.34,48,269,2463,8.9,0.20611697
18486,18486,Michael Latta,2015-16,24.0,3,6,53,53,0,6,6,24.0,444.0,70,1,9,10,30.0,82,5.32,47,251,2453,8.9,0.1136432
18487,18487,Michael Latta,2016-17,25.0,4,7,43,43,3,4,7,29.0,348.0,113,4,13,17,59.0,82,5.34,48,255,2438,9.0,0.14273632
18488,18488,Michael Liambas,2017-18,28.0,2,0,1,1,0,0,0,0.0,5.0,1,0,0,0,0.0,82,5.45,47,245,2478,9.0,0.1502319
18489,18489,Michael Liambas,2018-19,29.0,3,1,7,7,0,1,1,3.0,37.0,8,0,1,1,3.0,82,5.86,50,250,2620,9.2,0.14589468
18490,18490,Michael McCarron,2016-17,21.0,2,2,20,20,1,1,2,41.0,234.0,20,1,1,2,41.0,82,5.34,48,255,2438,9.0,0.26384926
18491,18491,Michael McCarron,2017-18,22.0,3,5,31,31,1,4,5,31.0,307.0,51,2,5,7,72.0,82,5.45,47,245,2478,9.0,0.22478598
18492,18492,Michael McCarron,2018-19,23.0,4,1,18,18,0,1,1,15.0,158.0,69,2,6,8,87.0,82,5.86,50,250,2620,9.2,0.19757465
18493,18493,Michael McLeod,2019-20,21.0,2,3,21,21,0,3,3,21.0,256.0,21,0,3,3,21.0,82,5.96,47,239,2579,9.5,0.26177168
18494,18494,Michael McLeod,2020-21,22.0,3,2,12,12,0,2,2,11.0,123.0,33,0,5,5,32.0,70,5.96,42,208,2192,9.5,0.21770328
18495,18495,Michael Mersch,2016-17,24.0,2,3,17,17,1,2,3,23.0,176.0,17,1,2,3,23.0,82,5.34,48,255,2438,9.0,0.22824627
18496,18496,Michael Nylander,1993-94,21.0,2,33,59,59,11,22,33,85.0,,59,11,22,33,85.0,84,7.25,87,443,2603,11.7,0.5699142
18497,18497,Michael Nylander,1994-95,22.0,3,55,73,73,13,42,55,95.0,,132,24,64,88,180.0,84,6.48,76,407,2545,10.7,0.5955668
18498,18498,Michael Nylander,1995-96,23.0,4,1,6,6,0,1,1,2.0,,138,24,65,89,182.0,48,5.97,37,209,1408,10.2,0.3956098
18499,18499,Michael Nylander,1996-97,24.0,5,55,73,73,17,38,55,163.0,,211,41,103,144,345.0,82,6.29,74,413,2481,10.4,0.70688194
18500,18500,Michael Nylander,1998-99,26.0,6,36,65,65,13,23,36,117.0,,276,54,126,180,462.0,82,5.28,57,380,2242,9.6,0.5465068
18501,18501,Michael Nylander,1999-00,27.0,7,14,33,33,4,10,14,33.0,424.0,309,58,136,194,495.0,82,5.27,57,359,2285,9.4,0.43131962
18502,18502,Michael Nylander,2000-01,28.0,8,54,77,77,24,30,54,122.0,1214.0,386,82,166,248,617.0,82,5.49,53,331,2294,9.8,0.608351
18503,18503,Michael Nylander,2001-02,29.0,9,64,82,82,25,39,64,176.0,1547.0,468,107,205,312,793.0,82,5.51,63,376,2272,9.9,0.73364085
18504,18504,Michael Nylander,2002-03,30.0,10,61,82,82,15,46,61,158.0,1275.0,550,122,251,373,951.0,82,5.24,53,338,2262,9.5,0.7435002
18505,18505,Michael Nylander,2003-04,31.0,11,60,80,80,17,43,60,161.0,1465.0,630,139,294,433,1112.0,82,5.31,60,363,2326,9.4,0.65699434
18506,18506,Michael Nylander,2004-05,32.0,12,14,18,18,1,13,14,30.0,281.0,648,140,307,447,1142.0,82,5.14,57,348,2300,9.2,0.5687574
18507,18507,Michael Nylander,2006-07,34.0,13,79,81,81,23,56,79,172.0,1566.0,729,163,363,526,1314.0,82,6.05,85,480,2458,10.1,0.7807362
18508,18508,Michael Nylander,2007-08,35.0,14,83,79,79,26,57,83,193.0,1610.0,808,189,420,609,1507.0,82,5.76,70,398,2426,9.7,0.8562253
18509,18509,Michael Nylander,2008-09,36.0,15,37,40,40,11,26,37,77.0,766.0,848,200,446,646,1584.0,82,5.44,62,351,2383,9.4,0.61369836
18510,18510,Michael Nylander,2009-10,37.0,16,33,72,72,9,24,33,87.0,1011.0,920,209,470,679,1671.0,82,5.7,65,341,2477,9.4,0.36215192
18511,18511,Michael Paliotta,2015-16,22.0,2,1,1,1,0,1,1,2.0,13.0,1,0,1,1,2.0,82,5.32,47,251,2453,8.9,0.19668719
18512,18512,Michael Paliotta,2016-17,23.0,3,0,1,1,0,0,0,2.0,8.0,2,0,1,1,4.0,82,5.34,48,255,2438,9.0,0.17104125
18513,18513,Michael Peca,1994-95,20.0,2,0,4,4,0,0,0,5.0,,4,0,0,0,5.0,84,6.48,76,407,2545,10.7,0.24540511
18514,18514,Michael Peca,1995-96,21.0,3,12,33,33,6,6,12,46.0,,37,6,6,12,51.0,48,5.97,37,209,1408,10.2,0.3688433
18515,18515,Michael Peca,1996-97,22.0,4,31,68,68,11,20,31,109.0,,105,17,26,43,160.0,82,6.29,74,413,2481,10.4,0.44191924
18516,18516,Michael Peca,1997-98,23.0,5,49,79,79,20,29,49,137.0,,184,37,55,92,297.0,82,5.83,55,336,2444,9.8,0.5841965
18517,18517,Michael Peca,1998-99,24.0,6,40,61,61,18,22,40,132.0,,245,55,77,132,429.0,82,5.28,57,380,2242,9.6,0.65377843
18518,18518,Michael Peca,1999-00,25.0,7,56,82,82,27,29,56,199.0,1700.0,327,82,106,188,628.0,82,5.27,57,359,2285,9.4,0.6911849
18519,18519,Michael Peca,2000-01,26.0,8,41,73,73,20,21,41,144.0,1456.0,400,102,127,229,772.0,82,5.49,53,331,2294,9.8,0.5610248
18520,18520,Michael Peca,2002-03,28.0,9,60,80,80,25,35,60,168.0,1618.0,480,127,162,289,940.0,82,5.24,53,338,2262,9.5,0.66796625
18521,18521,Michael Peca,2003-04,29.0,10,42,66,66,13,29,42,117.0,1251.0,546,140,191,331,1057.0,82,5.31,60,363,2326,9.4,0.5310535
18522,18522,Michael Peca,2004-05,30.0,11,40,76,76,11,29,40,117.0,1446.0,622,151,220,371,1174.0,82,5.14,57,348,2300,9.2,0.50784767
18523,18523,Michael Peca,2006-07,32.0,12,23,71,71,9,14,23,108.0,1182.0,693,160,234,394,1282.0,82,6.05,85,480,2458,10.1,0.30676365
18524,18524,Michael Peca,2007-08,33.0,13,15,35,35,4,11,15,42.0,609.0,728,164,245,409,1324.0,82,5.76,70,398,2426,9.7,0.30371836
18525,18525,Michael Peca,2008-09,34.0,14,34,65,65,8,26,34,86.0,1207.0,793,172,271,443,1410.0,82,5.44,62,351,2383,9.4,0.3654555
18526,18526,Michael Peca,2009-10,35.0,15,22,71,71,4,18,22,74.0,1001.0,864,176,289,465,1484.0,82,5.7,65,341,2477,9.4,0.23970944
18527,18527,Michael Raffl,2014-15,26.0,2,22,68,68,9,13,22,101.0,883.0,68,9,13,22,101.0,82,5.34,48,269,2463,8.9,0.30268162
18528,18528,Michael Raffl,2015-16,27.0,3,28,67,67,21,7,28,134.0,951.0,135,30,20,50,235.0,82,5.32,47,251,2453,8.9,0.41608754
18529,18529,Michael Raffl,2016-17,28.0,4,31,82,82,13,18,31,132.0,1173.0,217,43,38,81,367.0,82,5.34,48,255,2438,9.0,0.40962017
18530,18530,Michael Raffl,2017-18,29.0,5,11,52,52,8,3,11,63.0,690.0,269,51,41,92,430.0,82,5.45,47,245,2478,9.0,0.26527706
18531,18531,Michael Raffl,2018-19,30.0,6,22,76,76,13,9,22,96.0,1007.0,345,64,50,114,526.0,82,5.86,50,250,2620,9.2,0.29185414
18532,18532,Michael Raffl,2019-20,31.0,7,18,67,67,6,12,18,65.0,765.0,412,70,62,132,591.0,82,5.96,47,239,2579,9.5,0.25084049
18533,18533,Michael Raffl,2020-21,32.0,8,20,58,58,8,12,20,66.0,717.0,470,78,74,152,657.0,70,5.96,42,208,2192,9.5,0.28548038
18534,18534,Michael Rasmussen,2019-20,20.0,2,18,62,62,8,10,18,74.0,749.0,62,8,10,18,74.0,82,5.96,47,239,2579,9.5,0.3665197
18535,18535,Michael Ryan,2007-08,27.0,2,5,19,19,3,2,5,34.0,260.0,19,3,2,5,34.0,82,5.76,70,398,2426,9.7,0.24640813
18536,18536,Michael Ryan,2008-09,28.0,3,8,46,46,4,4,8,60.0,455.0,65,7,6,13,94.0,82,5.44,62,351,2383,9.4,0.18477282
18537,18537,Michael Ryan,2009-10,29.0,4,2,18,18,0,2,2,24.0,148.0,83,7,8,15,118.0,82,5.7,65,341,2477,9.4,0.1973621
18538,18538,Michael Ryder,2004-05,24.0,2,63,81,81,25,38,63,215.0,1296.0,81,25,38,63,215.0,82,5.14,57,348,2300,9.2,0.80744255
18539,18539,Michael Ryder,2006-07,26.0,3,55,81,81,30,25,55,243.0,1310.0,162,55,63,118,458.0,82,6.05,85,480,2458,10.1,0.66703176
18540,18540,Michael Ryder,2007-08,27.0,4,58,82,82,30,28,58,221.0,1335.0,244,85,91,176,679.0,82,5.76,70,398,2426,9.7,0.6674492
18541,18541,Michael Ryder,2008-09,28.0,5,31,70,70,14,17,31,134.0,927.0,314,99,108,207,813.0,82,5.44,62,351,2383,9.4,0.52308434
18542,18542,Michael Ryder,2009-10,29.0,6,53,74,74,27,26,53,185.0,1104.0,388,126,134,260,998.0,82,5.7,65,341,2477,9.4,0.63105214
18543,18543,Michael Ryder,2010-11,30.0,7,33,82,82,18,15,33,191.0,1254.0,470,144,149,293,1189.0,82,5.53,56,304,2486,9.1,0.47417754
18544,18544,Michael Ryder,2011-12,31.0,8,41,79,79,18,23,41,165.0,1144.0,549,162,172,334,1354.0,82,5.46,52,291,2492,9.0,0.49495178
18545,18545,Michael Ryder,2012-13,32.0,9,62,82,82,35,27,62,211.0,1425.0,631,197,199,396,1565.0,82,5.32,47,271,2439,8.9,0.7036587
18546,18546,Michael Ryder,2013-14,33.0,10,35,46,46,16,19,35,101.0,738.0,677,213,218,431,1666.0,48,5.31,29,160,1399,9.1,0.6021967
18547,18547,Michael Ryder,2014-15,34.0,11,34,82,82,18,16,34,166.0,1294.0,759,231,234,465,1832.0,82,5.34,48,269,2463,8.9,0.41285646
18548,18548,Michael Ryder,2015-16,35.0,12,19,47,47,6,13,19,89.0,681.0,806,237,247,484,1921.0,82,5.32,47,251,2453,8.9,0.3905543
18549,18549,Michael Sauer,2009-10,22.0,2,0,3,3,0,0,0,2.0,28.0,3,0,0,0,2.0,82,5.7,65,341,2477,9.4,0.1834439
18550,18550,Michael Sauer,2011-12,24.0,3,15,76,76,3,12,15,54.0,1331.0,79,3,12,15,56.0,82,5.46,52,291,2492,9.0,0.18295261
18551,18551,Michael Sauer,2012-13,25.0,4,3,19,19,1,2,3,14.0,356.0,98,4,14,18,70.0,82,5.32,47,271,2439,8.9,0.13765028
18552,18552,Michael Sgarbossa,2013-14,21.0,2,0,6,6,0,0,0,6.0,62.0,6,0,0,0,6.0,48,5.31,29,160,1399,9.1,0.21354589
18553,18553,Michael Sgarbossa,2015-16,23.0,3,1,3,3,0,1,1,2.0,21.0,9,0,1,1,8.0,82,5.32,47,251,2453,8.9,0.19403216
18554,18554,Michael Sgarbossa,2016-17,24.0,4,0,1,1,0,0,0,0.0,8.0,10,0,1,1,8.0,82,5.34,48,255,2438,9.0,0.15110531
18555,18555,Michael Sgarbossa,2017-18,25.0,5,9,38,38,2,7,9,33.0,424.0,48,2,8,10,41.0,82,5.45,47,245,2478,9.0,0.17732382
18556,18556,Michael Sgarbossa,2020-21,28.0,6,0,2,2,0,0,0,1.0,16.0,50,2,8,10,42.0,70,5.96,42,208,2192,9.5,0.14000648
18557,18557,Michael Stone,2012-13,22.0,2,3,13,13,1,2,3,13.0,180.0,13,1,2,3,13.0,82,5.32,47,271,2439,8.9,0.22706002
18558,18558,Michael Stone,2013-14,23.0,3,9,40,40,5,4,9,50.0,667.0,53,6,6,12,63.0,48,5.31,29,160,1399,9.1,0.26849633
18559,18559,Michael Stone,2014-15,24.0,4,21,70,70,8,13,21,105.0,1274.0,123,14,19,33,168.0,82,5.34,48,269,2463,8.9,0.29122204
18560,18560,Michael Stone,2015-16,25.0,5,18,81,81,3,15,18,144.0,1690.0,204,17,34,51,312.0,82,5.32,47,251,2453,8.9,0.2684138
18561,18561,Michael Stone,2016-17,26.0,6,36,75,75,6,30,36,161.0,1687.0,279,23,64,87,473.0,82,5.34,48,255,2438,9.0,0.4241125
18562,18562,Michael Stone,2017-18,27.0,7,15,64,64,3,12,15,81.0,1268.0,343,26,76,102,554.0,82,5.45,47,245,2478,9.0,0.22869837
18563,18563,Michael Stone,2018-19,28.0,8,10,82,82,3,7,10,98.0,1373.0,425,29,83,112,652.0,82,5.86,50,250,2620,9.2,0.2232284
18564,18564,Michael Stone,2019-20,29.0,9,5,14,14,0,5,5,12.0,223.0,439,29,88,117,664.0,82,5.96,47,239,2579,9.5,0.22452065
18565,18565,Michael Stone,2020-21,30.0,10,7,33,33,2,5,7,57.0,539.0,472,31,93,124,721.0,70,5.96,42,208,2192,9.5,0.243806
18566,18566,Michael Thelven,1986-87,26.0,2,26,60,60,6,20,26,108.0,,60,6,20,26,108.0,80,7.94,82,370,2484,12.8,0.43456662
18567,18567,Michael Thelven,1987-88,27.0,3,20,34,34,5,15,20,58.0,,94,11,35,46,166.0,80,7.34,72,344,2400,12.2,0.44110444
18568,18568,Michael Thelven,1988-89,28.0,4,31,67,67,6,25,31,106.0,,161,17,60,77,272.0,80,7.43,89,437,2435,12.2,0.41997412
18569,18569,Michael Thelven,1989-90,29.0,5,21,40,40,3,18,21,68.0,,201,20,78,98,340.0,80,7.48,85,403,2430,12.3,0.42916453
18570,18570,Michael Thelven,1990-91,30.0,6,2,6,6,0,2,2,8.0,,207,20,80,100,348.0,80,7.37,76,367,2421,12.2,0.29937062
18571,18571,Michael Ware,1989-90,22.0,2,1,2,2,0,1,1,0.0,,2,0,1,1,0.0,80,7.48,85,403,2430,12.3,0.21016046
18572,18572,Michael Ware,1990-91,23.0,3,0,3,3,0,0,0,1.0,,5,0,1,1,1.0,80,7.37,76,367,2421,12.2,0.20514506
18573,18573,Michael Zalewski,2014-15,22.0,2,1,2,2,0,1,1,2.0,24.0,2,0,1,1,2.0,82,5.34,48,269,2463,8.9,0.19668719
18574,18574,Michael Zalewski,2016-17,24.0,3,1,3,3,0,1,1,2.0,36.0,5,0,2,2,4.0,82,5.34,48,255,2438,9.0,0.18157893
18575,18575,Michael Zalewski,2017-18,25.0,4,0,1,1,0,0,0,0.0,8.0,6,0,2,2,4.0,82,5.45,47,245,2478,9.0,0.16051707
18576,18576,Michal Barinka,2004-05,20.0,2,1,9,9,0,1,1,15.0,124.0,9,0,1,1,15.0,82,5.14,57,348,2300,9.2,0.2679473
18577,18577,Michal Barinka,2006-07,22.0,3,1,25,25,0,1,1,19.0,366.0,34,0,2,2,34.0,82,6.05,85,480,2458,10.1,0.15278187
18578,18578,Michal Grosek,1994-95,19.0,2,1,3,3,1,0,1,4.0,,3,1,0,1,4.0,84,6.48,76,407,2545,10.7,0.26245734
18579,18579,Michal Grosek,1995-96,20.0,3,4,24,24,2,2,4,27.0,,27,3,2,5,31.0,48,5.97,37,209,1408,10.2,0.31559613
18580,18580,Michal Grosek,1996-97,21.0,4,10,23,23,6,4,10,34.0,,50,9,6,15,65.0,82,6.29,74,413,2481,10.4,0.37153646
18581,18581,Michal Grosek,1997-98,22.0,5,36,82,82,15,21,36,117.0,,132,24,27,51,182.0,82,5.83,55,336,2444,9.8,0.4425249
18582,18582,Michal Grosek,1998-99,23.0,6,30,67,67,10,20,30,114.0,,199,34,47,81,296.0,82,5.28,57,380,2242,9.6,0.49042213
18583,18583,Michal Grosek,1999-00,24.0,7,50,76,76,20,30,50,140.0,1310.0,275,54,77,131,436.0,82,5.27,57,359,2285,9.4,0.5938912
18584,18584,Michal Grosek,2000-01,25.0,8,40,75,75,13,27,40,114.0,1177.0,350,67,104,171,550.0,82,5.49,53,331,2294,9.8,0.5144265
18585,18585,Michal Grosek,2001-02,26.0,9,20,65,65,9,11,20,84.0,721.0,415,76,115,191,634.0,82,5.51,63,376,2272,9.9,0.31603706
18586,18586,Michal Grosek,2002-03,27.0,10,5,15,15,3,2,5,23.0,186.0,430,79,117,196,657.0,82,5.24,53,338,2262,9.5,0.36751205
18587,18587,Michal Grosek,2003-04,28.0,11,20,63,63,2,18,20,74.0,675.0,493,81,135,216,731.0,82,5.31,60,363,2326,9.4,0.29018772
18588,18588,Michal Grosek,2004-05,29.0,12,5,33,33,3,2,5,24.0,206.0,526,84,137,221,755.0,82,5.14,57,348,2300,9.2,0.30400878
18589,18589,Michal Handzus,1999-00,22.0,2,16,66,66,4,12,16,78.0,977.0,66,4,12,16,78.0,82,5.27,57,359,2285,9.4,0.2794553
18590,18590,Michal Handzus,2000-01,23.0,3,53,81,81,25,28,53,166.0,1436.0,147,29,40,69,244.0,82,5.49,53,331,2294,9.8,0.6790974
18591,18591,Michal Handzus,2001-02,24.0,4,32,46,46,14,18,32,72.0,802.0,193,43,58,101,316.0,82,5.51,63,376,2272,9.9,0.59462494
18592,18592,Michal Handzus,2002-03,25.0,5,45,79,79,15,30,45,94.0,1276.0,272,58,88,146,410.0,82,5.24,53,338,2262,9.5,0.5718099
18593,18593,Michal Handzus,2003-04,26.0,6,44,82,82,23,21,44,133.0,1439.0,354,81,109,190,543.0,82,5.31,60,363,2326,9.4,0.5788197
18594,18594,Michal Handzus,2004-05,27.0,7,58,82,82,20,38,58,135.0,1535.0,436,101,147,248,678.0,82,5.14,57,348,2300,9.2,0.7616892
18595,18595,Michal Handzus,2006-07,29.0,8,44,73,73,11,33,44,113.0,1348.0,509,112,180,292,791.0,82,6.05,85,480,2458,10.1,0.5321816
18596,18596,Michal Handzus,2007-08,30.0,9,8,8,8,3,5,8,9.0,168.0,517,115,185,300,800.0,82,5.76,70,398,2426,9.7,0.39198995
18597,18597,Michal Handzus,2008-09,31.0,10,21,82,82,7,14,21,89.0,1250.0,599,122,199,321,889.0,82,5.44,62,351,2383,9.4,0.28100383
18598,18598,Michal Handzus,2009-10,32.0,11,42,82,82,18,24,42,143.0,1550.0,681,140,223,363,1032.0,82,5.7,65,341,2477,9.4,0.46297246
18599,18599,Michal Handzus,2010-11,33.0,12,42,81,81,20,22,42,117.0,1483.0,762,160,245,405,1149.0,82,5.53,56,304,2486,9.1,0.46237284
18600,18600,Michal Handzus,2011-12,34.0,13,30,82,82,12,18,30,94.0,1422.0,844,172,263,435,1243.0,82,5.46,52,291,2492,9.0,0.33524063
18601,18601,Michal Handzus,2012-13,35.0,14,24,67,67,7,17,24,81.0,968.0,911,179,280,459,1324.0,82,5.32,47,271,2439,8.9,0.27518484
18602,18602,Michal Handzus,2013-14,36.0,15,8,39,39,2,6,8,41.0,512.0,950,181,286,467,1365.0,48,5.31,29,160,1399,9.1,0.21571064
18603,18603,Michal Handzus,2014-15,37.0,16,16,59,59,4,12,16,50.0,805.0,1009,185,298,483,1415.0,82,5.34,48,269,2463,8.9,0.21204832
18604,18604,Michal Jordan,2013-14,23.0,2,0,5,5,0,0,0,2.0,53.0,5,0,0,0,2.0,48,5.31,29,160,1399,9.1,0.19705015
18605,18605,Michal Jordan,2015-16,25.0,3,6,38,38,2,4,6,44.0,606.0,43,2,4,6,46.0,82,5.32,47,251,2453,8.9,0.17828628
18606,18606,Michal Jordan,2016-17,26.0,4,1,36,36,1,0,1,36.0,546.0,79,3,4,7,82.0,82,5.34,48,255,2438,9.0,0.16117948
18607,18607,Michal Kempny,2017-18,27.0,2,8,50,50,2,6,8,67.0,748.0,50,2,6,8,67.0,82,5.45,47,245,2478,9.0,0.18342724
18608,18608,Michal Kempny,2018-19,28.0,3,10,53,53,3,7,10,82.0,843.0,103,5,13,18,149.0,82,5.86,50,250,2620,9.2,0.23465002
18609,18609,Michal Kempny,2019-20,29.0,4,25,71,71,6,19,25,111.0,1362.0,174,11,32,43,260.0,82,5.96,47,239,2579,9.5,0.29192606
18610,18610,Michal Kempny,2020-21,30.0,5,18,58,58,3,15,18,73.0,1081.0,232,14,47,61,333.0,70,5.96,42,208,2192,9.5,0.2881655
18611,18611,Michal Pivonka,1987-88,22.0,2,43,73,73,18,25,43,117.0,,73,18,25,43,117.0,80,7.34,72,344,2400,12.2,0.60532117
18612,18612,Michal Pivonka,1988-89,23.0,3,34,71,71,11,23,34,96.0,,144,29,48,77,213.0,80,7.43,89,437,2435,12.2,0.48586795
18613,18613,Michal Pivonka,1989-90,24.0,4,27,52,52,8,19,27,73.0,,196,37,67,104,286.0,80,7.48,85,403,2430,12.3,0.4954803
18614,18614,Michal Pivonka,1990-91,25.0,5,64,77,77,25,39,64,149.0,,273,62,106,168,435.0,80,7.37,76,367,2421,12.2,0.7424799
18615,18615,Michal Pivonka,1991-92,26.0,6,70,79,79,20,50,70,172.0,,352,82,156,238,607.0,80,6.91,71,366,2385,11.6,0.8498401
18616,18616,Michal Pivonka,1992-93,27.0,7,80,80,80,23,57,80,177.0,,432,105,213,318,784.0,80,6.96,77,402,2440,11.4,0.88213134
18617,18617,Michal Pivonka,1993-94,28.0,8,74,69,69,21,53,74,147.0,,501,126,266,392,931.0,84,7.25,87,443,2603,11.7,0.8138969
18618,18618,Michal Pivonka,1994-95,29.0,9,50,82,82,14,36,50,138.0,,583,140,302,442,1069.0,84,6.48,76,407,2545,10.7,0.57506585
18619,18619,Michal Pivonka,1995-96,30.0,10,33,46,46,10,23,33,80.0,,629,150,325,475,1149.0,48,5.97,37,209,1408,10.2,0.652036
18620,18620,Michal Pivonka,1996-97,31.0,11,81,73,73,16,65,81,168.0,,702,166,390,556,1317.0,82,6.29,74,413,2481,10.4,0.7668796
18621,18621,Michal Pivonka,1997-98,32.0,12,23,54,54,7,16,23,83.0,,756,173,406,579,1400.0,82,5.83,55,336,2444,9.8,0.46183112
18622,18622,Michal Pivonka,1998-99,33.0,13,9,33,33,3,6,9,38.0,,789,176,412,588,1438.0,82,5.28,57,380,2242,9.6,0.358663
18623,18623,Michal Pivonka,1999-00,34.0,14,11,36,36,5,6,11,30.0,475.0,825,181,418,599,1468.0,82,5.27,57,359,2285,9.4,0.30772635
18624,18624,Michal Repik,2009-10,21.0,2,2,5,5,2,0,2,7.0,38.0,5,2,0,2,7.0,82,5.7,65,341,2477,9.4,0.26967403
18625,18625,Michal Repik,2010-11,22.0,3,5,19,19,3,2,5,23.0,163.0,24,5,2,7,30.0,82,5.53,56,304,2486,9.1,0.30273157
18626,18626,Michal Repik,2011-12,23.0,4,8,31,31,2,6,8,54.0,396.0,55,7,8,15,84.0,82,5.46,52,291,2492,9.0,0.29694378
18627,18627,Michal Repik,2012-13,24.0,5,5,17,17,2,3,5,35.0,176.0,72,9,11,20,119.0,82,5.32,47,271,2439,8.9,0.25099868
18628,18628,Michal Rozsival,2000-01,22.0,2,21,75,75,4,17,21,73.0,1426.0,75,4,17,21,73.0,82,5.49,53,331,2294,9.8,0.29315764
18629,18629,Michal Rozsival,2001-02,23.0,3,5,30,30,1,4,5,17.0,513.0,105,5,21,26,90.0,82,5.51,63,376,2272,9.9,0.24119663
18630,18630,Michal Rozsival,2002-03,24.0,4,29,79,79,9,20,29,89.0,1581.0,184,14,41,55,179.0,82,5.24,53,338,2262,9.5,0.34841412
18631,18631,Michal Rozsival,2003-04,25.0,5,10,53,53,4,6,10,61.0,1082.0,237,18,47,65,240.0,82,5.31,60,363,2326,9.4,0.24010435
18632,18632,Michal Rozsival,2006-07,28.0,6,30,82,82,5,25,30,115.0,1841.0,319,23,72,95,355.0,82,6.05,85,480,2458,10.1,0.3635517
18633,18633,Michal Rozsival,2007-08,29.0,7,40,80,80,10,30,40,104.0,1902.0,399,33,102,135,459.0,82,5.76,70,398,2426,9.7,0.41734266
18634,18634,Michal Rozsival,2008-09,30.0,8,38,80,80,13,25,38,127.0,1964.0,479,46,127,173,586.0,82,5.44,62,351,2383,9.4,0.4327661
18635,18635,Michal Rozsival,2009-10,31.0,9,30,76,76,8,22,30,120.0,1711.0,555,54,149,203,706.0,82,5.7,65,341,2477,9.4,0.33697197
18636,18636,Michal Rozsival,2010-11,32.0,10,23,82,82,3,20,23,80.0,1758.0,637,57,169,226,786.0,82,5.53,56,304,2486,9.1,0.2586249
18637,18637,Michal Rozsival,2011-12,33.0,11,21,65,65,6,15,21,55.0,1365.0,702,63,184,247,841.0,82,5.46,52,291,2492,9.0,0.25853714
18638,18638,Michal Rozsival,2012-13,34.0,12,13,54,54,1,12,13,49.0,1044.0,756,64,196,260,890.0,82,5.32,47,271,2439,8.9,0.1758528
18639,18639,Michal Rozsival,2013-14,35.0,13,12,27,27,0,12,12,13.0,489.0,783,64,208,272,903.0,48,5.31,29,160,1399,9.1,0.1596807
18640,18640,Michal Rozsival,2014-15,36.0,14,8,42,42,1,7,8,39.0,699.0,825,65,215,280,942.0,82,5.34,48,269,2463,8.9,0.14847374
18641,18641,Michal Rozsival,2015-16,37.0,15,13,65,65,1,12,13,56.0,1106.0,890,66,227,293,998.0,82,5.32,47,251,2453,8.9,0.1424205
18642,18642,Michal Rozsival,2016-17,38.0,16,13,51,51,1,12,13,41.0,824.0,941,67,239,306,1039.0,82,5.34,48,255,2438,9.0,0.16191682
18643,18643,Michal Rozsival,2017-18,39.0,17,3,22,22,1,2,3,16.0,341.0,963,68,241,309,1055.0,82,5.45,47,245,2478,9.0,0.15425318
18644,18644,Michal Sivek,2003-04,23.0,2,6,38,38,3,3,6,45.0,497.0,38,3,3,6,45.0,82,5.31,60,363,2326,9.4,0.23973903
18645,18645,Michal Sykora,1994-95,21.0,2,5,22,22,1,4,5,22.0,,22,1,4,5,22.0,84,6.48,76,407,2545,10.7,0.26367006
18646,18646,Michal Sykora,1995-96,22.0,3,4,16,16,0,4,4,6.0,,38,1,8,9,28.0,48,5.97,37,209,1408,10.2,0.2135635
18647,18647,Michal Sykora,1996-97,23.0,4,20,79,79,4,16,20,80.0,,117,5,24,29,108.0,82,6.29,74,413,2481,10.4,0.27200526
18648,18648,Michal Sykora,1997-98,24.0,5,17,63,63,3,14,17,77.0,,180,8,38,46,185.0,82,5.83,55,336,2444,9.8,0.24401954
18649,18649,Michal Sykora,1998-99,25.0,6,4,28,28,1,3,4,35.0,,208,9,41,50,220.0,82,5.28,57,380,2242,9.6,0.20825773
18650,18650,Michal Sykora,1999-00,26.0,7,3,10,10,1,2,3,24.0,163.0,218,10,43,53,244.0,82,5.27,57,359,2285,9.4,0.28853175
18651,18651,Michal Sykora,2001-02,28.0,8,16,49,49,5,11,16,71.0,806.0,267,15,54,69,315.0,82,5.51,63,376,2272,9.9,0.2876946
18652,18652,Micheal Ferland,2015-16,23.0,2,5,26,26,2,3,5,34.0,274.0,26,2,3,5,34.0,82,5.32,47,251,2453,8.9,0.2413069
18653,18653,Micheal Ferland,2016-17,24.0,3,18,71,71,4,14,18,122.0,896.0,97,6,17,23,156.0,82,5.34,48,255,2438,9.0,0.28425223
18654,18654,Micheal Ferland,2017-18,25.0,4,25,76,76,15,10,25,106.0,879.0,173,21,27,48,262.0,82,5.45,47,245,2478,9.0,0.3668338
18655,18655,Micheal Ferland,2018-19,26.0,5,41,77,77,21,20,41,144.0,1156.0,250,42,47,89,406.0,82,5.86,50,250,2620,9.2,0.5040067
18656,18656,Micheal Ferland,2019-20,27.0,6,40,71,71,17,23,40,156.0,1001.0,321,59,70,129,562.0,82,5.96,47,239,2579,9.5,0.49666128
18657,18657,Micheal Ferland,2020-21,28.0,7,5,14,14,1,4,5,15.0,137.0,335,60,74,134,577.0,70,5.96,42,208,2192,9.5,0.2739898
18658,18658,Micheal Haley,2010-11,24.0,2,0,2,2,0,0,0,0.0,15.0,2,0,0,0,0.0,82,5.53,56,304,2486,9.1,0.15371045
18659,18659,Micheal Haley,2011-12,25.0,3,3,27,27,2,1,3,13.0,217.0,29,2,1,3,13.0,82,5.46,52,291,2492,9.0,0.15875101
18660,18660,Micheal Haley,2012-13,26.0,4,0,14,14,0,0,0,13.0,111.0,43,2,1,3,26.0,82,5.32,47,271,2439,8.9,0.15261191
18661,18661,Micheal Haley,2013-14,27.0,5,0,9,9,0,0,0,4.0,60.0,52,2,1,3,30.0,48,5.31,29,160,1399,9.1,0.13506615
18662,18662,Micheal Haley,2015-16,29.0,6,0,4,4,0,0,0,1.0,30.0,56,2,1,3,31.0,82,5.32,47,251,2453,8.9,0.11745927
18663,18663,Micheal Haley,2016-17,30.0,7,1,16,16,1,0,1,10.0,114.0,72,3,1,4,41.0,82,5.34,48,255,2438,9.0,0.13657406
18664,18664,Micheal Haley,2017-18,31.0,8,12,58,58,2,10,12,37.0,532.0,130,5,11,16,78.0,82,5.45,47,245,2478,9.0,0.14637643
18665,18665,Micheal Haley,2018-19,32.0,9,9,75,75,3,6,9,55.0,584.0,205,8,17,25,133.0,82,5.86,50,250,2620,9.2,0.14917094
18666,18666,Micheal Haley,2019-20,33.0,10,6,43,43,2,4,6,34.0,348.0,248,10,21,31,167.0,82,5.96,47,239,2579,9.5,0.12284076
18667,18667,Micheal Haley,2020-21,34.0,11,1,22,22,1,0,1,9.0,122.0,270,11,21,32,176.0,70,5.96,42,208,2192,9.5,0.103494555
18668,18668,Michel Bolduc,1982-83,21.0,2,0,3,3,0,0,0,1.0,,3,0,0,0,1.0,80,8.03,73,320,2489,12.9,0.238985
18669,18669,Michel Bolduc,1983-84,22.0,3,0,7,7,0,0,0,4.0,,10,0,0,0,5.0,80,7.73,71,310,2444,12.7,0.20939732
18670,18670,Michel Galarneau,1981-82,20.0,2,8,30,30,2,6,8,19.0,,30,2,6,8,19.0,80,7.69,77,340,2441,12.6,0.31585032
18671,18671,Michel Galarneau,1982-83,21.0,3,0,10,10,0,0,0,10.0,,40,2,6,8,29.0,80,8.03,73,320,2489,12.9,0.27118254
18672,18672,Michel Galarneau,1983-84,22.0,4,9,38,38,5,4,9,28.0,,78,7,10,17,57.0,80,7.73,71,310,2444,12.7,0.24275464
18673,18673,Michel Goulet,1980-81,20.0,2,54,77,77,22,32,54,167.0,,77,22,32,54,167.0,80,7.03,61,280,2352,12.0,0.7730907
18674,18674,Michel Goulet,1981-82,21.0,3,71,76,76,32,39,71,265.0,,153,54,71,125,432.0,80,7.69,77,340,2441,12.6,0.9871125
18675,18675,Michel Goulet,1982-83,22.0,4,84,80,80,42,42,84,250.0,,233,96,113,209,682.0,80,8.03,73,320,2489,12.9,1.1482632
18676,18676,Michel Goulet,1983-84,23.0,5,105,80,80,57,48,105,256.0,,313,153,161,314,938.0,80,7.73,71,310,2444,12.7,1.2649258
18677,18677,Michel Goulet,1984-85,24.0,6,122,75,75,56,66,122,239.0,,388,209,227,436,1177.0,80,7.89,74,336,2448,12.9,1.3661938
18678,18678,Michel Goulet,1985-86,25.0,7,95,69,69,55,40,95,260.0,,457,264,267,531,1437.0,80,7.77,71,321,2447,12.7,1.2320006
18679,18679,Michel Goulet,1986-87,26.0,8,104,75,75,53,51,104,244.0,,532,317,318,635,1681.0,80,7.94,82,370,2484,12.8,1.1357868
18680,18680,Michel Goulet,1987-88,27.0,9,96,75,75,49,47,96,276.0,,607,366,365,731,1957.0,80,7.34,72,344,2400,12.2,1.1489198
18681,18681,Michel Goulet,1988-89,28.0,10,106,80,80,48,58,106,284.0,,687,414,423,837,2241.0,80,7.43,89,437,2435,12.2,1.1228336
18682,18682,Michel Goulet,1989-90,29.0,11,64,69,69,26,38,64,162.0,,756,440,461,901,2403.0,80,7.48,85,403,2430,12.3,0.9276935
18683,18683,Michel Goulet,1990-91,30.0,12,50,65,65,20,30,50,154.0,,821,460,491,951,2557.0,80,7.37,76,367,2421,12.2,0.7998283
18684,18684,Michel Goulet,1991-92,31.0,13,65,74,74,27,38,65,167.0,,895,487,529,1016,2724.0,80,6.91,71,366,2385,11.6,0.85821044
18685,18685,Michel Goulet,1992-93,32.0,14,63,75,75,22,41,63,176.0,,970,509,570,1079,2900.0,80,6.96,77,402,2440,11.4,0.75266695
18686,18686,Michel Goulet,1993-94,33.0,15,44,63,63,23,21,44,125.0,,1033,532,591,1123,3025.0,84,7.25,87,443,2603,11.7,0.6227269
18687,18687,Michel Goulet,1994-95,34.0,16,30,56,56,16,14,30,120.0,,1089,548,605,1153,3145.0,84,6.48,76,407,2545,10.7,0.56791574
18688,18688,Michel Mongeau,1990-91,25.0,2,6,7,7,1,5,6,2.0,,7,1,5,6,2.0,80,7.37,76,367,2421,12.2,0.2582844
18689,18689,Michel Mongeau,1991-92,26.0,3,2,7,7,1,1,2,13.0,,14,2,6,8,15.0,80,6.91,71,366,2385,11.6,0.23173562
18690,18690,Michel Mongeau,1992-93,27.0,4,15,36,36,3,12,15,23.0,,50,5,18,23,38.0,80,6.96,77,402,2440,11.4,0.28808263
18691,18691,Michel Mongeau,1993-94,28.0,5,2,4,4,1,1,2,2.0,,54,6,19,25,40.0,84,7.25,87,443,2603,11.7,0.19744298
18692,18692,Michel Ouellet,2006-07,24.0,2,32,50,50,16,16,32,87.0,701.0,50,16,16,32,87.0,82,6.05,85,480,2458,10.1,0.5401598
18693,18693,Michel Ouellet,2007-08,25.0,3,48,73,73,19,29,48,148.0,973.0,123,35,45,80,235.0,82,5.76,70,398,2426,9.7,0.58531106
18694,18694,Michel Ouellet,2008-09,26.0,4,36,64,64,17,19,36,132.0,872.0,187,52,64,116,367.0,82,5.44,62,351,2383,9.4,0.52927727
18695,18695,Michel Ouellet,2009-10,27.0,5,0,3,3,0,0,0,3.0,29.0,190,52,64,116,370.0,82,5.7,65,341,2477,9.4,0.3547071
18696,18696,Michel Petit,1983-84,19.0,2,0,2,2,0,0,0,1.0,,2,0,0,0,1.0,80,7.73,71,310,2444,12.7,0.27397004
18697,18697,Michel Petit,1984-85,20.0,3,15,44,44,6,9,15,80.0,,46,6,9,15,81.0,80,7.89,74,336,2448,12.9,0.4299687
18698,18698,Michel Petit,1985-86,21.0,4,31,69,69,5,26,31,96.0,,115,11,35,46,177.0,80,7.77,71,321,2447,12.7,0.46395668
18699,18699,Michel Petit,1986-87,22.0,5,7,32,32,1,6,7,43.0,,147,12,41,53,220.0,80,7.94,82,370,2484,12.8,0.3246243
18700,18700,Michel Petit,1987-88,23.0,6,25,69,69,12,13,25,116.0,,216,24,54,78,336.0,80,7.34,72,344,2400,12.2,0.41064695
18701,18701,Michel Petit,1988-89,24.0,7,36,74,74,9,27,36,109.0,,290,33,81,114,445.0,80,7.43,89,437,2435,12.2,0.43327492
18702,18702,Michel Petit,1989-90,25.0,8,33,69,69,8,25,33,132.0,,359,41,106,147,577.0,80,7.48,85,403,2430,12.3,0.47600254
18703,18703,Michel Petit,1990-91,26.0,9,36,63,63,12,24,36,137.0,,422,53,130,183,714.0,80,7.37,76,367,2421,12.2,0.5248652
18704,18704,Michel Petit,1991-92,27.0,10,39,73,73,13,26,39,134.0,,495,66,156,222,848.0,80,6.91,71,366,2385,11.6,0.4776114
18705,18705,Michel Petit,1992-93,28.0,11,27,70,70,4,23,27,129.0,,565,70,179,249,977.0,80,6.96,77,402,2440,11.4,0.34418172
18706,18706,Michel Petit,1993-94,29.0,12,12,35,35,3,9,12,58.0,,600,73,188,261,1035.0,84,7.25,87,443,2603,11.7,0.27666116
18707,18707,Michel Petit,1994-95,30.0,13,23,63,63,2,21,23,103.0,,663,75,209,284,1138.0,84,6.48,76,407,2545,10.7,0.31544086
18708,18708,Michel Petit,1995-96,31.0,14,17,40,40,5,12,17,70.0,,703,80,221,301,1208.0,48,5.97,37,209,1408,10.2,0.38147026
18709,18709,Michel Petit,1996-97,32.0,15,12,54,54,4,8,12,68.0,,757,84,229,313,1276.0,82,6.29,74,413,2481,10.4,0.22560316
18710,18710,Michel Petit,1997-98,33.0,16,9,38,38,2,7,9,43.0,,795,86,236,322,1319.0,82,5.83,55,336,2444,9.8,0.17937043
18711,18711,Michel Petit,1998-99,34.0,17,6,32,32,4,2,6,34.0,,827,90,238,328,1353.0,82,5.28,57,380,2242,9.6,0.2079815
18712,18712,Michel Picard,1991-92,22.0,2,1,5,5,1,0,1,7.0,,5,1,0,1,7.0,80,6.91,71,366,2385,11.6,0.2642883
18713,18713,Michel Picard,1992-93,23.0,3,8,25,25,3,5,8,41.0,,30,4,5,9,48.0,80,6.96,77,402,2440,11.4,0.3320039
18714,18714,Michel Picard,1993-94,24.0,4,4,25,25,4,0,4,32.0,,55,8,5,13,80.0,84,7.25,87,443,2603,11.7,0.27560452
18715,18715,Michel Picard,1995-96,26.0,5,13,24,24,5,8,13,33.0,,79,13,13,26,113.0,48,5.97,37,209,1408,10.2,0.38452244
18716,18716,Michel Picard,1996-97,27.0,6,8,17,17,2,6,8,21.0,,96,15,19,34,134.0,82,6.29,74,413,2481,10.4,0.25939134
18717,18717,Michel Picard,1998-99,29.0,7,9,16,16,1,8,9,19.0,,112,16,27,43,153.0,82,5.28,57,380,2242,9.6,0.2242755
18718,18718,Michel Picard,1999-00,30.0,8,22,45,45,11,11,22,69.0,645.0,157,27,38,65,222.0,82,5.27,57,359,2285,9.4,0.35940626
18719,18719,Michel Picard,2000-01,31.0,9,0,2,2,0,0,0,2.0,20.0,159,27,38,65,224.0,82,5.49,53,331,2294,9.8,0.22961143
18720,18720,Michel Picard,2001-02,32.0,10,5,7,7,1,4,5,12.0,100.0,166,28,42,70,236.0,82,5.51,63,376,2272,9.9,0.26207262
18721,18721,Michel Riesen,2001-02,22.0,2,1,12,12,0,1,1,16.0,119.0,12,0,1,1,16.0,82,5.51,63,376,2272,9.9,0.18986851
18722,18722,Mick Vukota,1988-89,22.0,2,1,17,17,1,0,1,7.0,,17,1,0,1,7.0,80,7.43,89,437,2435,12.2,0.233329
18723,18723,Mick Vukota,1989-90,23.0,3,4,48,48,2,2,4,19.0,,65,3,2,5,26.0,80,7.48,85,403,2430,12.3,0.17201501
18724,18724,Mick Vukota,1990-91,24.0,4,12,76,76,4,8,12,55.0,,141,7,10,17,81.0,80,7.37,76,367,2421,12.2,0.19551829
18725,18725,Mick Vukota,1991-92,25.0,5,6,60,60,2,4,6,39.0,,201,9,14,23,120.0,80,6.91,71,366,2385,11.6,0.171361
18726,18726,Mick Vukota,1992-93,26.0,6,6,74,74,0,6,6,34.0,,275,9,20,29,154.0,80,6.96,77,402,2440,11.4,0.13845995
18727,18727,Mick Vukota,1993-94,27.0,7,7,74,74,2,5,7,37.0,,349,11,25,36,191.0,84,7.25,87,443,2603,11.7,0.116990834
18728,18728,Mick Vukota,1994-95,28.0,8,4,72,72,3,1,4,26.0,,421,14,26,40,217.0,84,6.48,76,407,2545,10.7,0.085233
18729,18729,Mick Vukota,1995-96,29.0,9,2,39,39,0,2,2,11.0,,460,14,28,42,228.0,48,5.97,37,209,1408,10.2,0.05962199
18730,18730,Mick Vukota,1996-97,30.0,10,2,32,32,1,1,2,11.0,,492,15,29,44,239.0,82,6.29,74,413,2481,10.4,0.09832257
18731,18731,Mick Vukota,1997-98,31.0,11,1,17,17,1,0,1,7.0,,509,16,29,45,246.0,82,5.83,55,336,2444,9.8,0.11637789
18732,18732,Mick Vukota,1998-99,32.0,12,1,64,64,1,0,1,23.0,,573,17,29,46,269.0,82,5.28,57,380,2242,9.6,0.077976435
18733,18733,Mickey Volcan,1981-82,19.0,2,13,49,49,2,11,13,49.0,,49,2,11,13,49.0,80,7.69,77,340,2441,12.6,0.33188763
18734,18734,Mickey Volcan,1982-83,20.0,3,6,26,26,1,5,6,45.0,,75,3,16,19,94.0,80,8.03,73,320,2489,12.9,0.3182146
18735,18735,Mickey Volcan,1983-84,21.0,4,17,68,68,4,13,17,72.0,,143,7,29,36,166.0,80,7.73,71,310,2444,12.7,0.30083472
18736,18736,Mickey Volcan,1984-85,22.0,5,5,19,19,1,4,5,13.0,,162,8,33,41,179.0,80,7.89,74,336,2448,12.9,0.26173812
18737,18737,Micki DuPont,2002-03,22.0,2,0,2,2,0,0,0,2.0,29.0,2,0,0,0,2.0,82,5.24,53,338,2262,9.5,0.1732291
18738,18738,Micki DuPont,2003-04,23.0,3,3,16,16,1,2,3,27.0,268.0,18,1,2,3,29.0,82,5.31,60,363,2326,9.4,0.2528527
18739,18739,Micki DuPont,2007-08,27.0,4,1,3,3,0,1,1,6.0,41.0,21,1,3,4,35.0,82,5.76,70,398,2426,9.7,0.15492159
18740,18740,Micki DuPont,2008-09,28.0,5,0,2,2,0,0,0,3.0,25.0,23,1,3,4,38.0,82,5.44,62,351,2383,9.4,0.14060295
18741,18741,Miika Elomo,2000-01,23.0,2,1,2,2,0,1,1,3.0,22.0,2,0,1,1,3.0,82,5.49,53,331,2294,9.8,0.20138803
18742,18742,Miikka Salomaki,2015-16,22.0,2,1,1,1,1,0,1,4.0,11.0,1,1,0,1,4.0,82,5.32,47,251,2453,8.9,0.23278314
18743,18743,Miikka Salomaki,2016-17,23.0,3,10,61,61,5,5,10,61.0,732.0,62,6,5,11,65.0,82,5.34,48,255,2438,9.0,0.23645446
18744,18744,Miikka Salomaki,2017-18,24.0,4,0,5,5,0,0,0,3.0,61.0,67,6,5,11,68.0,82,5.45,47,245,2478,9.0,0.16470629
18745,18745,Miikka Salomaki,2018-19,25.0,5,8,58,58,2,6,8,51.0,596.0,125,8,11,19,119.0,82,5.86,50,250,2620,9.2,0.15421987
18746,18746,Miikka Salomaki,2019-20,26.0,6,7,37,37,3,4,7,51.0,387.0,162,11,15,26,170.0,82,5.96,47,239,2579,9.5,0.19824117
18747,18747,Miikka Salomaki,2020-21,27.0,7,1,5,5,1,0,1,2.0,61.0,167,12,15,27,172.0,70,5.96,42,208,2192,9.5,0.16339058
18748,18748,Mika Alatalo,2000-01,29.0,2,27,82,82,10,17,27,107.0,1035.0,82,10,17,27,107.0,82,5.49,53,331,2294,9.8,0.30104148
18749,18749,Mika Alatalo,2001-02,30.0,3,19,70,70,7,12,19,64.0,769.0,152,17,29,46,171.0,82,5.51,63,376,2272,9.9,0.25811583
18750,18750,Mika Pyorala,2010-11,29.0,2,4,36,36,2,2,4,41.0,489.0,36,2,2,4,41.0,82,5.53,56,304,2486,9.1,0.17722175
18751,18751,Mika Zibanejad,2012-13,19.0,2,1,9,9,0,1,1,12.0,116.0,9,0,1,1,12.0,82,5.32,47,271,2439,8.9,0.2708416
18752,18752,Mika Zibanejad,2013-14,20.0,3,20,42,42,7,13,20,90.0,570.0,51,7,14,21,102.0,48,5.31,29,160,1399,9.1,0.4928396
18753,18753,Mika Zibanejad,2014-15,21.0,4,33,69,69,16,17,33,153.0,989.0,120,23,31,54,255.0,82,5.34,48,269,2463,8.9,0.53647953
18754,18754,Mika Zibanejad,2015-16,22.0,5,46,80,80,20,26,46,150.0,1315.0,200,43,57,100,405.0,82,5.32,47,251,2453,8.9,0.60034424
18755,18755,Mika Zibanejad,2016-17,23.0,6,51,81,81,21,30,51,184.0,1439.0,281,64,87,151,589.0,82,5.34,48,255,2438,9.0,0.62313825
18756,18756,Mika Zibanejad,2017-18,24.0,7,37,56,56,14,23,37,119.0,956.0,337,78,110,188,708.0,82,5.45,47,245,2478,9.0,0.64469796
18757,18757,Mika Zibanejad,2018-19,25.0,8,47,72,72,27,20,47,212.0,1293.0,409,105,130,235,920.0,82,5.86,50,250,2620,9.2,0.6569307
18758,18758,Mika Zibanejad,2019-20,26.0,9,74,82,82,30,44,74,236.0,1686.0,491,135,174,309,1156.0,82,5.96,47,239,2579,9.5,0.8424821
18759,18759,Mika Zibanejad,2020-21,27.0,10,75,57,57,41,34,75,208.0,1233.0,548,176,208,384,1364.0,70,5.96,42,208,2192,9.5,1.122041
18760,18760,Mikael Andersson,1986-87,20.0,2,10,32,32,1,9,10,13.0,,32,1,9,10,13.0,80,7.94,82,370,2484,12.8,0.26322457
18761,18761,Mikael Andersson,1987-88,21.0,3,3,16,16,0,3,3,6.0,,48,1,12,13,19.0,80,7.34,72,344,2400,12.2,0.25521088
18762,18762,Mikael Andersson,1988-89,22.0,4,23,37,37,3,20,23,34.0,,85,4,32,36,53.0,80,7.43,89,437,2435,12.2,0.39886236
18763,18763,Mikael Andersson,1989-90,23.0,5,1,14,14,0,1,1,12.0,,99,4,33,37,65.0,80,7.48,85,403,2430,12.3,0.2997176
18764,18764,Mikael Andersson,1990-91,24.0,6,37,50,50,13,24,37,86.0,,149,17,57,74,151.0,80,7.37,76,367,2421,12.2,0.57884914
18765,18765,Mikael Andersson,1991-92,25.0,7,11,41,41,4,7,11,57.0,,190,21,64,85,208.0,80,6.91,71,366,2385,11.6,0.31684154
18766,18766,Mikael Andersson,1992-93,26.0,8,47,74,74,18,29,47,149.0,,264,39,93,132,357.0,80,6.96,77,402,2440,11.4,0.5827274
18767,18767,Mikael Andersson,1993-94,27.0,9,27,77,77,16,11,27,169.0,,341,55,104,159,526.0,84,7.25,87,443,2603,11.7,0.3925404
18768,18768,Mikael Andersson,1994-95,28.0,10,25,76,76,13,12,25,136.0,,417,68,116,184,662.0,84,6.48,76,407,2545,10.7,0.33279788
18769,18769,Mikael Andersson,1995-96,29.0,11,11,36,36,4,7,11,36.0,,453,72,123,195,698.0,48,5.97,37,209,1408,10.2,0.32446665
18770,18770,Mikael Andersson,1996-97,30.0,12,19,64,64,8,11,19,104.0,,517,80,134,214,802.0,82,6.29,74,413,2481,10.4,0.2974176
18771,18771,Mikael Andersson,1997-98,31.0,13,19,70,70,5,14,19,102.0,,587,85,148,233,904.0,82,5.83,55,336,2444,9.8,0.26817745
18772,18772,Mikael Andersson,1998-99,32.0,14,17,72,72,6,11,17,105.0,,659,91,159,250,1009.0,82,5.28,57,380,2242,9.6,0.24072033
18773,18773,Mikael Andersson,1999-00,33.0,15,6,47,47,2,4,6,51.0,597.0,706,93,163,256,1060.0,82,5.27,57,359,2285,9.4,0.16347465
18774,18774,Mikael Andersson,2000-01,34.0,16,8,55,55,2,6,8,57.0,559.0,761,95,169,264,1117.0,82,5.49,53,331,2294,9.8,0.13939303
18775,18775,Mikael Backlund,2009-10,20.0,2,0,1,1,0,0,0,1.0,11.0,1,0,0,0,1.0,82,5.7,65,341,2477,9.4,0.24836513
18776,18776,Mikael Backlund,2010-11,21.0,3,10,23,23,1,9,10,47.0,290.0,24,1,9,10,48.0,82,5.53,56,304,2486,9.1,0.32833117
18777,18777,Mikael Backlund,2011-12,22.0,4,25,73,73,10,15,25,144.0,882.0,97,11,24,35,192.0,82,5.46,52,291,2492,9.0,0.39589348
18778,18778,Mikael Backlund,2012-13,23.0,5,11,41,41,4,7,11,85.0,631.0,138,15,31,46,277.0,82,5.32,47,271,2439,8.9,0.2993251
18779,18779,Mikael Backlund,2013-14,24.0,6,16,32,32,8,8,16,88.0,484.0,170,23,39,62,365.0,48,5.31,29,160,1399,9.1,0.43878776
18780,18780,Mikael Backlund,2014-15,25.0,7,39,76,76,18,21,39,178.0,1409.0,246,41,60,101,543.0,82,5.34,48,269,2463,8.9,0.5241621
18781,18781,Mikael Backlund,2015-16,26.0,8,27,52,52,10,17,27,103.0,923.0,298,51,77,128,646.0,82,5.32,47,251,2453,8.9,0.43587735
18782,18782,Mikael Backlund,2016-17,27.0,9,47,82,82,21,26,47,155.0,1347.0,380,72,103,175,801.0,82,5.34,48,255,2438,9.0,0.5628094
18783,18783,Mikael Backlund,2017-18,28.0,10,53,81,81,22,31,53,197.0,1426.0,461,94,134,228,998.0,82,5.45,47,245,2478,9.0,0.6108444
18784,18784,Mikael Backlund,2018-19,29.0,11,45,82,82,14,31,45,214.0,1560.0,543,108,165,273,1212.0,82,5.86,50,250,2620,9.2,0.5333786
18785,18785,Mikael Backlund,2019-20,30.0,12,47,77,77,21,26,47,205.0,1378.0,620,129,191,320,1417.0,82,5.96,47,239,2579,9.5,0.59642774
18786,18786,Mikael Backlund,2020-21,31.0,13,45,70,70,16,29,45,157.0,1256.0,690,145,220,365,1574.0,70,5.96,42,208,2192,9.5,0.56084645
18787,18787,Mikael Granlund,2013-14,21.0,2,8,27,27,2,6,8,36.0,356.0,27,2,6,8,36.0,48,5.31,29,160,1399,9.1,0.3530518
18788,18788,Mikael Granlund,2014-15,22.0,3,41,63,63,8,33,41,104.0,1091.0,90,10,39,49,140.0,82,5.34,48,269,2463,8.9,0.5552131
18789,18789,Mikael Granlund,2015-16,23.0,4,39,68,68,8,31,39,99.0,1217.0,158,18,70,88,239.0,82,5.32,47,251,2453,8.9,0.48908505
18790,18790,Mikael Granlund,2016-17,24.0,5,44,82,82,13,31,44,160.0,1486.0,240,31,101,132,399.0,82,5.34,48,255,2438,9.0,0.63399255
18791,18791,Mikael Granlund,2017-18,25.0,6,69,81,81,26,43,69,177.0,1525.0,321,57,144,201,576.0,82,5.45,47,245,2478,9.0,0.81018233
18792,18792,Mikael Granlund,2018-19,26.0,7,67,77,77,21,46,67,193.0,1446.0,398,78,190,268,769.0,82,5.86,50,250,2620,9.2,0.80753815
18793,18793,Mikael Granlund,2019-20,27.0,8,54,79,79,16,38,54,189.0,1449.0,477,94,228,322,958.0,82,5.96,47,239,2579,9.5,0.71125007
18794,18794,Mikael Granlund,2020-21,28.0,9,30,63,63,17,13,30,130.0,1122.0,540,111,241,352,1088.0,70,5.96,42,208,2192,9.5,0.55231017
18795,18795,Mikael Lindholm,1990-91,26.0,2,4,18,18,2,2,4,10.0,,18,2,2,4,10.0,80,7.37,76,367,2421,12.2,0.27845252
18796,18796,Mikael Renberg,1994-95,22.0,2,82,83,83,38,44,82,195.0,,83,38,44,82,195.0,84,6.48,76,407,2545,10.7,0.9407295
18797,18797,Mikael Renberg,1995-96,23.0,3,57,47,47,26,31,57,143.0,,130,64,75,139,338.0,48,5.97,37,209,1408,10.2,1.0862813
18798,18798,Mikael Renberg,1996-97,24.0,4,43,51,51,23,20,43,198.0,,181,87,95,182,536.0,82,6.29,74,413,2481,10.4,0.80923176
18799,18799,Mikael Renberg,1997-98,25.0,5,59,77,77,22,37,59,249.0,,258,109,132,241,785.0,82,5.83,55,336,2444,9.8,0.7283618
18800,18800,Mikael Renberg,1998-99,26.0,6,38,68,68,16,22,38,175.0,,326,125,154,279,960.0,82,5.28,57,380,2242,9.6,0.67309785
18801,18801,Mikael Renberg,1999-00,27.0,7,38,66,66,15,23,38,154.0,1047.0,392,140,177,317,1114.0,82,5.27,57,359,2285,9.4,0.60809314
18802,18802,Mikael Renberg,2000-01,28.0,8,35,72,72,10,25,35,122.0,989.0,464,150,202,352,1236.0,82,5.49,53,331,2294,9.8,0.5242991
18803,18803,Mikael Renberg,2002-03,30.0,9,52,71,71,14,38,52,130.0,1035.0,535,164,240,404,1366.0,82,5.24,53,338,2262,9.5,0.67284226
18804,18804,Mikael Renberg,2003-04,31.0,10,35,67,67,14,21,35,137.0,907.0,602,178,261,439,1503.0,82,5.31,60,363,2326,9.4,0.44037205
18805,18805,Mikael Renberg,2004-05,32.0,11,25,59,59,12,13,25,88.0,783.0,661,190,274,464,1591.0,82,5.14,57,348,2300,9.2,0.52429
18806,18806,Mikael Samuelsson,2001-02,25.0,2,0,4,4,0,0,0,3.0,19.0,4,0,0,0,3.0,82,5.51,63,376,2272,9.9,0.15821433
18807,18807,Mikael Samuelsson,2002-03,26.0,3,16,67,67,6,10,16,94.0,795.0,71,6,10,16,97.0,82,5.24,53,338,2262,9.5,0.2730527
18808,18808,Mikael Samuelsson,2003-04,27.0,4,24,80,80,10,14,24,154.0,1211.0,151,16,24,40,251.0,82,5.31,60,363,2326,9.4,0.30228245
18809,18809,Mikael Samuelsson,2004-05,28.0,5,9,37,37,3,6,9,50.0,454.0,188,19,30,49,301.0,82,5.14,57,348,2300,9.2,0.25722986
18810,18810,Mikael Samuelsson,2006-07,30.0,6,45,71,71,23,22,45,187.0,960.0,259,42,52,94,488.0,82,6.05,85,480,2458,10.1,0.5138401
18811,18811,Mikael Samuelsson,2007-08,31.0,7,34,53,53,14,20,34,189.0,803.0,312,56,72,128,677.0,82,5.76,70,398,2426,9.7,0.57690036
18812,18812,Mikael Samuelsson,2008-09,32.0,8,40,73,73,11,29,40,249.0,1187.0,385,67,101,168,926.0,82,5.44,62,351,2383,9.4,0.501186
18813,18813,Mikael Samuelsson,2009-10,33.0,9,40,81,81,19,21,40,257.0,1245.0,466,86,122,208,1183.0,82,5.7,65,341,2477,9.4,0.5169251
18814,18814,Mikael Samuelsson,2010-11,34.0,10,53,74,74,30,23,53,219.0,1271.0,540,116,145,261,1402.0,82,5.53,56,304,2486,9.1,0.59965765
18815,18815,Mikael Samuelsson,2011-12,35.0,11,50,75,75,18,32,50,215.0,1247.0,615,134,177,311,1617.0,82,5.46,52,291,2492,9.0,0.536642
18816,18816,Mikael Samuelsson,2012-13,36.0,12,31,54,54,14,17,31,138.0,861.0,669,148,194,342,1755.0,82,5.32,47,271,2439,8.9,0.54956007
18817,18817,Mikael Samuelsson,2013-14,37.0,13,1,4,4,0,1,1,4.0,51.0,673,148,195,343,1759.0,48,5.31,29,160,1399,9.1,0.19234717
18818,18818,Mikael Samuelsson,2014-15,38.0,14,3,26,26,1,2,3,36.0,269.0,699,149,197,346,1795.0,82,5.34,48,269,2463,8.9,0.20085934
18819,18819,Mike Allison,1981-82,20.0,2,64,75,75,26,38,64,122.0,,75,26,38,64,122.0,80,7.69,77,340,2441,12.6,0.8026992
18820,18820,Mike Allison,1982-83,21.0,3,22,48,48,7,15,22,62.0,,123,33,53,86,184.0,80,8.03,73,320,2489,12.9,0.51207215
18821,18821,Mike Allison,1983-84,22.0,4,20,39,39,11,9,20,45.0,,162,44,62,106,229.0,80,7.73,71,310,2444,12.7,0.56139743
18822,18822,Mike Allison,1984-85,23.0,5,20,45,45,8,12,20,52.0,,207,52,74,126,281.0,80,7.89,74,336,2448,12.9,0.53525335
18823,18823,Mike Allison,1985-86,24.0,6,24,31,31,9,15,24,46.0,,238,61,89,150,327.0,80,7.77,71,321,2447,12.7,0.61125255
18824,18824,Mike Allison,1986-87,25.0,7,15,28,28,2,13,15,26.0,,266,63,102,165,353.0,80,7.94,82,370,2484,12.8,0.47017053
18825,18825,Mike Allison,1987-88,26.0,8,23,71,71,7,16,23,48.0,,337,70,118,188,401.0,80,7.34,72,344,2400,12.2,0.37068528
18826,18826,Mike Allison,1988-89,27.0,9,31,52,52,16,15,31,61.0,,389,86,133,219,462.0,80,7.43,89,437,2435,12.2,0.5384926
18827,18827,Mike Allison,1989-90,28.0,10,36,55,55,14,22,36,71.0,,444,100,155,255,533.0,80,7.48,85,403,2430,12.3,0.47812274
18828,18828,Mike Allison,1990-91,29.0,11,13,55,55,2,11,13,25.0,,499,102,166,268,558.0,80,7.37,76,367,2421,12.2,0.2882893
18829,18829,Mike Amodeo,1980-81,28.0,2,0,19,19,0,0,0,14.0,,19,0,0,0,14.0,80,7.03,61,280,2352,12.0,0.16642779
18830,18830,Mike Angelidis,2012-13,27.0,2,1,6,6,1,0,1,8.0,39.0,6,1,0,1,8.0,82,5.32,47,271,2439,8.9,0.20046723
18831,18831,Mike Angelidis,2013-14,28.0,3,0,1,1,0,0,0,0.0,7.0,7,1,0,1,8.0,48,5.31,29,160,1399,9.1,0.16992834
18832,18832,Mike Angelidis,2015-16,30.0,4,0,3,3,0,0,0,0.0,22.0,10,1,0,1,8.0,82,5.32,47,251,2453,8.9,0.14204338
18833,18833,Mike Angelidis,2016-17,31.0,5,1,4,4,1,0,1,1.0,36.0,14,2,0,2,9.0,82,5.34,48,255,2438,9.0,0.15507552
18834,18834,Mike Backman,1982-83,28.0,2,2,3,3,0,2,2,1.0,,3,0,2,2,1.0,80,8.03,73,320,2489,12.9,0.25511688
18835,18835,Mike Backman,1983-84,29.0,3,4,7,7,1,3,4,9.0,,10,1,5,6,10.0,80,7.73,71,310,2444,12.7,0.25373957
18836,18836,Mike Backman,1984-85,30.0,4,1,8,8,0,1,1,6.0,,18,1,6,7,16.0,80,7.89,74,336,2448,12.9,0.18475524
18837,18837,Mike Berger,1988-89,21.0,2,4,29,29,3,1,4,41.0,,29,3,1,4,41.0,80,7.43,89,437,2435,12.2,0.31927663
18838,18838,Mike Berger,1989-90,22.0,3,0,1,1,0,0,0,0.0,,30,3,1,4,41.0,80,7.48,85,403,2430,12.3,0.20475695
18839,18839,Mike Bishai,2004-05,25.0,2,2,14,14,0,2,2,14.0,128.0,14,0,2,2,14.0,82,5.14,57,348,2300,9.2,0.17891756
18840,18840,Mike Blaisdell,1981-82,22.0,2,9,32,32,3,6,9,45.0,,32,3,6,9,45.0,80,7.69,77,340,2441,12.6,0.34140033
18841,18841,Mike Blaisdell,1982-83,23.0,3,55,80,80,23,32,55,165.0,,112,26,38,64,210.0,80,8.03,73,320,2489,12.9,0.6357465
18842,18842,Mike Blaisdell,1983-84,24.0,4,41,80,80,18,23,41,171.0,,192,44,61,105,381.0,80,7.73,71,310,2444,12.7,0.5626882
18843,18843,Mike Blaisdell,1984-85,25.0,5,11,36,36,5,6,11,61.0,,228,49,67,116,442.0,80,7.89,74,336,2448,12.9,0.36160287
18844,18844,Mike Blaisdell,1985-86,26.0,6,1,12,12,1,0,1,20.0,,240,50,67,117,462.0,80,7.77,71,321,2447,12.7,0.32010972
18845,18845,Mike Blaisdell,1986-87,27.0,7,29,66,66,15,14,29,124.0,,306,65,81,146,586.0,80,7.94,82,370,2484,12.8,0.39215225
18846,18846,Mike Blaisdell,1987-88,28.0,8,2,10,10,1,1,2,12.0,,316,66,82,148,598.0,80,7.34,72,344,2400,12.2,0.25782624
18847,18847,Mike Blaisdell,1988-89,29.0,9,5,18,18,3,2,5,32.0,,334,69,84,153,630.0,80,7.43,89,437,2435,12.2,0.34179032
18848,18848,Mike Blaisdell,1989-90,30.0,10,1,9,9,1,0,1,8.0,,343,70,84,154,638.0,80,7.48,85,403,2430,12.3,0.2646922
18849,18849,Mike Blunden,2007-08,21.0,2,0,9,9,0,0,0,10.0,102.0,9,0,0,0,10.0,82,5.76,70,398,2426,9.7,0.2036914
18850,18850,Mike Blunden,2008-09,22.0,3,0,1,1,0,0,0,1.0,8.0,10,0,0,0,11.0,82,5.44,62,351,2383,9.4,0.1836274
18851,18851,Mike Blunden,2010-11,24.0,4,4,40,40,2,2,4,40.0,324.0,50,2,2,4,51.0,82,5.53,56,304,2486,9.1,0.16884324
18852,18852,Mike Blunden,2011-12,25.0,5,0,1,1,0,0,0,2.0,11.0,51,2,2,4,53.0,82,5.46,52,291,2492,9.0,0.13305089
18853,18853,Mike Blunden,2012-13,26.0,6,4,39,39,2,2,4,34.0,365.0,90,4,4,8,87.0,82,5.32,47,271,2439,8.9,0.15006238
18854,18854,Mike Blunden,2013-14,27.0,7,0,5,5,0,0,0,5.0,42.0,95,4,4,8,92.0,48,5.31,29,160,1399,9.1,0.14579833
18855,18855,Mike Blunden,2014-15,28.0,8,0,7,7,0,0,0,2.0,43.0,102,4,4,8,94.0,82,5.34,48,269,2463,8.9,0.12560719
18856,18856,Mike Blunden,2015-16,29.0,9,0,2,2,0,0,0,0.0,20.0,104,4,4,8,94.0,82,5.32,47,251,2453,8.9,0.13038492
18857,18857,Mike Blunden,2016-17,30.0,10,5,20,20,3,2,5,14.0,173.0,124,7,6,13,108.0,82,5.34,48,255,2438,9.0,0.15664712
18858,18858,Mike Blunden,2017-18,31.0,11,0,2,2,0,0,0,1.0,16.0,126,7,6,13,109.0,82,5.45,47,245,2478,9.0,0.105498135
18859,18859,Mike Blunden,2018-19,32.0,12,0,1,1,0,0,0,1.0,7.0,127,7,6,13,110.0,82,5.86,50,250,2620,9.2,0.14268821
18860,18860,Mike Brown,2001-02,22.0,2,0,1,1,0,0,0,1.0,5.0,1,0,0,0,1.0,82,5.51,63,376,2272,9.9,0.1682556
18861,18861,Mike Brown,2002-03,23.0,3,0,15,15,0,0,0,2.0,52.0,16,0,0,0,3.0,82,5.24,53,338,2262,9.5,0.1537221
18862,18862,Mike Brown,2003-04,24.0,4,2,16,16,1,1,2,8.0,80.0,32,1,1,2,11.0,82,5.31,60,363,2326,9.4,0.18064126
18863,18863,Mike Brown,2006-07,27.0,5,1,2,2,0,1,1,1.0,12.0,34,1,2,3,12.0,82,6.05,85,480,2458,10.1,0.15262347
18864,18864,Mike Brown0,2008-09,23.0,2,1,19,19,1,0,1,9.0,120.0,19,1,0,1,9.0,82,5.44,62,351,2383,9.4,0.15893131
18865,18865,Mike Brown0,2009-10,24.0,3,4,48,48,2,2,4,44.0,391.0,67,3,2,5,53.0,82,5.7,65,341,2477,9.4,0.16824925
18866,18866,Mike Brown0,2010-11,25.0,4,7,75,75,6,1,7,82.0,626.0,142,9,3,12,135.0,82,5.53,56,304,2486,9.1,0.1862121
18867,18867,Mike Brown0,2011-12,26.0,5,8,50,50,3,5,8,59.0,505.0,192,12,8,20,194.0,82,5.46,52,291,2492,9.0,0.15592706
18868,18868,Mike Brown0,2012-13,27.0,6,4,50,50,2,2,4,56.0,464.0,242,14,10,24,250.0,82,5.32,47,271,2439,8.9,0.13851994
18869,18869,Mike Brown0,2013-14,28.0,7,2,39,39,1,1,2,18.0,293.0,281,15,11,26,268.0,48,5.31,29,160,1399,9.1,0.09543112
18870,18870,Mike Brown0,2014-15,29.0,8,5,56,56,2,3,5,45.0,400.0,337,17,14,31,313.0,82,5.34,48,269,2463,8.9,0.12574473
18871,18871,Mike Brown0,2015-16,30.0,9,0,12,12,0,0,0,11.0,98.0,349,17,14,31,324.0,82,5.32,47,251,2453,8.9,0.1110363
18872,18872,Mike Brown0,2016-17,31.0,10,5,58,58,2,3,5,51.0,453.0,407,19,17,36,375.0,82,5.34,48,255,2438,9.0,0.12792993
18873,18873,Mike Bullard,1981-82,20.0,2,3,15,15,1,2,3,18.0,,15,1,2,3,18.0,80,7.69,77,340,2441,12.6,0.3359835
18874,18874,Mike Bullard,1982-83,21.0,3,63,75,75,36,27,63,145.0,,90,37,29,66,163.0,80,8.03,73,320,2489,12.9,0.8088267
18875,18875,Mike Bullard,1983-84,22.0,4,44,57,57,22,22,44,149.0,,147,59,51,110,312.0,80,7.73,71,310,2444,12.7,0.86412114
18876,18876,Mike Bullard,1984-85,23.0,5,92,76,76,51,41,92,213.0,,223,110,92,202,525.0,80,7.89,74,336,2448,12.9,1.085959
18877,18877,Mike Bullard,1985-86,24.0,6,63,68,68,32,31,63,186.0,,291,142,123,265,711.0,80,7.77,71,321,2447,12.7,0.8974105
18878,18878,Mike Bullard,1986-87,25.0,7,83,77,77,41,42,83,216.0,,368,183,165,348,927.0,80,7.94,82,370,2484,12.8,0.89225966
18879,18879,Mike Bullard,1987-88,26.0,8,66,71,71,30,36,66,180.0,,439,213,201,414,1107.0,80,7.34,72,344,2400,12.2,0.9772102
18880,18880,Mike Bullard,1988-89,27.0,9,103,79,79,48,55,103,230.0,,518,261,256,517,1337.0,80,7.43,89,437,2435,12.2,1.1100669
18881,18881,Mike Bullard,1989-90,28.0,10,65,74,74,27,38,65,189.0,,592,288,294,582,1526.0,80,7.48,85,403,2430,12.3,0.83552396
18882,18882,Mike Bullard,1990-91,29.0,11,64,70,70,27,37,64,181.0,,662,315,331,646,1707.0,80,7.37,76,367,2421,12.2,0.8121302
18883,18883,Mike Bullard,1992-93,31.0,12,28,65,65,14,14,28,140.0,,727,329,345,674,1847.0,80,6.96,77,402,2440,11.4,0.4784298
18884,18884,Mike Busniuk,1980-81,29.0,2,20,71,71,2,18,20,56.0,,71,2,18,20,56.0,80,7.03,61,280,2352,12.0,0.24435124
18885,18885,Mike Busniuk,1981-82,30.0,3,6,72,72,1,5,6,33.0,,143,3,23,26,89.0,80,7.69,77,340,2441,12.6,0.1480327
18886,18886,Mike Cammalleri,2003-04,21.0,2,8,28,28,5,3,8,40.0,394.0,28,5,3,8,40.0,82,5.31,60,363,2326,9.4,0.3609792
18887,18887,Mike Cammalleri,2004-05,22.0,3,15,31,31,9,6,15,53.0,412.0,59,14,9,23,93.0,82,5.14,57,348,2300,9.2,0.5113149
18888,18888,Mike Cammalleri,2006-07,24.0,4,55,80,80,26,29,55,206.0,1340.0,139,40,38,78,299.0,82,6.05,85,480,2458,10.1,0.6718213
18889,18889,Mike Cammalleri,2007-08,25.0,5,80,81,81,34,46,80,299.0,1462.0,220,74,84,158,598.0,82,5.76,70,398,2426,9.7,0.88569516
18890,18890,Mike Cammalleri,2008-09,26.0,6,47,63,63,19,28,47,210.0,1170.0,283,93,112,205,808.0,82,5.44,62,351,2383,9.4,0.7701265
18891,18891,Mike Cammalleri,2009-10,27.0,7,82,81,81,39,43,82,255.0,1422.0,364,132,155,287,1063.0,82,5.7,65,341,2477,9.4,0.9108982
18892,18892,Mike Cammalleri,2010-11,28.0,8,50,65,65,26,24,50,218.0,1269.0,429,158,179,337,1281.0,82,5.53,56,304,2486,9.1,0.73849344
18893,18893,Mike Cammalleri,2011-12,29.0,9,47,67,67,19,28,47,193.0,1238.0,496,177,207,384,1474.0,82,5.46,52,291,2492,9.0,0.66645443
18894,18894,Mike Cammalleri,2012-13,30.0,10,41,66,66,20,21,41,175.0,1195.0,562,197,228,425,1649.0,82,5.32,47,271,2439,8.9,0.63506913
18895,18895,Mike Cammalleri,2013-14,31.0,11,32,44,44,13,19,32,102.0,794.0,606,210,247,457,1751.0,48,5.31,29,160,1399,9.1,0.63277173
18896,18896,Mike Cammalleri,2014-15,32.0,12,45,63,63,26,19,45,191.0,1250.0,669,236,266,502,1942.0,82,5.34,48,269,2463,8.9,0.6688521
18897,18897,Mike Cammalleri,2015-16,33.0,13,42,68,68,27,15,42,156.0,1247.0,737,263,281,544,2098.0,82,5.32,47,251,2453,8.9,0.60057354
18898,18898,Mike Cammalleri,2016-17,34.0,14,38,42,42,14,24,38,101.0,810.0,779,277,305,582,2199.0,82,5.34,48,255,2438,9.0,0.6405591
18899,18899,Mike Cammalleri,2017-18,35.0,15,31,61,61,10,21,31,142.0,1059.0,840,287,326,613,2341.0,82,5.45,47,245,2478,9.0,0.44615299
18900,18900,Mike Cammalleri,2018-19,36.0,16,29,66,66,7,22,29,128.0,909.0,906,294,348,642,2469.0,82,5.86,50,250,2620,9.2,0.34658918
18901,18901,Mike Card,2007-08,21.0,2,0,4,4,0,0,0,0.0,18.0,4,0,0,0,0.0,82,5.76,70,398,2426,9.7,0.17969257
18902,18902,Mike Casselman,1996-97,28.0,2,0,3,3,0,0,0,2.0,,3,0,0,0,2.0,82,6.29,74,413,2481,10.4,0.1487976
18903,18903,Mike Commodore,2001-02,22.0,2,5,20,20,1,4,5,11.0,255.0,20,1,4,5,11.0,82,5.51,63,376,2272,9.9,0.1690441
18904,18904,Mike Commodore,2002-03,23.0,3,1,37,37,0,1,1,22.0,467.0,57,1,5,6,33.0,82,5.24,53,338,2262,9.5,0.14057907
18905,18905,Mike Commodore,2003-04,24.0,4,1,6,6,0,1,1,5.0,69.0,63,1,6,7,38.0,82,5.31,60,363,2326,9.4,0.15527391
18906,18906,Mike Commodore,2004-05,25.0,5,0,12,12,0,0,0,10.0,183.0,75,1,6,7,48.0,82,5.14,57,348,2300,9.2,0.18766168
18907,18907,Mike Commodore,2006-07,27.0,6,13,72,72,3,10,13,72.0,1116.0,147,4,16,20,120.0,82,6.05,85,480,2458,10.1,0.16730717
18908,18908,Mike Commodore,2007-08,28.0,7,29,82,82,7,22,29,136.0,1631.0,229,11,38,49,256.0,82,5.76,70,398,2426,9.7,0.32484812
18909,18909,Mike Commodore,2008-09,29.0,8,14,67,67,3,11,14,97.0,1220.0,296,14,49,63,353.0,82,5.44,62,351,2383,9.4,0.2006208
18910,18910,Mike Commodore,2009-10,30.0,9,24,81,81,5,19,24,103.0,1854.0,377,19,68,87,456.0,82,5.7,65,341,2477,9.4,0.25998828
18911,18911,Mike Commodore,2010-11,31.0,10,11,57,57,2,9,11,54.0,1083.0,434,21,77,98,510.0,82,5.53,56,304,2486,9.1,0.18068334
18912,18912,Mike Commodore,2011-12,32.0,11,6,20,20,2,4,6,32.0,371.0,454,23,81,104,542.0,82,5.46,52,291,2492,9.0,0.19417828
18913,18913,Mike Commodore,2012-13,33.0,12,2,30,30,0,2,2,23.0,378.0,484,23,83,106,565.0,82,5.32,47,271,2439,8.9,0.12745506
18914,18914,Mike Comrie,2001-02,21.0,2,22,41,41,8,14,22,62.0,467.0,41,8,14,22,62.0,82,5.51,63,376,2272,9.9,0.45428565
18915,18915,Mike Comrie,2002-03,22.0,3,60,82,82,33,27,60,170.0,1437.0,123,41,41,82,232.0,82,5.24,53,338,2262,9.5,0.7485182
18916,18916,Mike Comrie,2003-04,23.0,4,51,69,69,20,31,51,170.0,1232.0,192,61,72,133,402.0,82,5.31,60,363,2326,9.4,0.7123622
18917,18917,Mike Comrie,2004-05,24.0,5,24,49,49,12,12,24,101.0,769.0,241,73,84,157,503.0,82,5.14,57,348,2300,9.2,0.64335173
18918,18918,Mike Comrie,2006-07,26.0,6,60,80,80,30,30,60,190.0,1282.0,321,103,114,217,693.0,82,6.05,85,480,2458,10.1,0.679258
18919,18919,Mike Comrie,2007-08,27.0,7,45,65,65,20,25,45,125.0,991.0,386,123,139,262,818.0,82,5.76,70,398,2426,9.7,0.59079736
18920,18920,Mike Comrie,2008-09,28.0,8,49,76,76,21,28,49,194.0,1458.0,462,144,167,311,1012.0,82,5.44,62,351,2383,9.4,0.6127293
18921,18921,Mike Comrie,2009-10,29.0,9,27,63,63,10,17,27,121.0,989.0,525,154,184,338,1133.0,82,5.7,65,341,2477,9.4,0.44074133
18922,18922,Mike Comrie,2010-11,30.0,10,21,43,43,13,8,21,97.0,612.0,568,167,192,359,1230.0,82,5.53,56,304,2486,9.1,0.48053682
18923,18923,Mike Comrie,2011-12,31.0,11,6,21,21,1,5,6,25.0,248.0,589,168,197,365,1255.0,82,5.46,52,291,2492,9.0,0.29785615
18924,18924,Mike Connolly,2012-13,23.0,2,0,2,2,0,0,0,1.0,25.0,2,0,0,0,1.0,82,5.32,47,271,2439,8.9,0.16584736
18925,18925,Mike Craig,1991-92,20.0,2,12,39,39,8,4,12,59.0,,39,8,4,12,59.0,80,6.91,71,366,2385,11.6,0.37554452
18926,18926,Mike Craig,1992-93,21.0,3,31,67,67,15,16,31,136.0,,106,23,20,43,195.0,80,6.96,77,402,2440,11.4,0.59166324
18927,18927,Mike Craig,1993-94,22.0,4,38,70,70,15,23,38,131.0,,176,38,43,81,326.0,84,7.25,87,443,2603,11.7,0.5386945
18928,18928,Mike Craig,1994-95,23.0,5,37,72,72,13,24,37,150.0,,248,51,67,118,476.0,84,6.48,76,407,2545,10.7,0.5180008
18929,18929,Mike Craig,1995-96,24.0,6,10,37,37,5,5,10,61.0,,285,56,72,128,537.0,48,5.97,37,209,1408,10.2,0.3838345
18930,18930,Mike Craig,1996-97,25.0,7,20,70,70,8,12,20,108.0,,355,64,84,148,645.0,82,6.29,74,413,2481,10.4,0.3278823
18931,18931,Mike Craig,1997-98,26.0,8,20,65,65,7,13,20,128.0,,420,71,97,168,773.0,82,5.83,55,336,2444,9.8,0.33193523
18932,18932,Mike Craig,1999-00,28.0,9,0,1,1,0,0,0,1.0,11.0,421,71,97,168,774.0,82,5.27,57,359,2285,9.4,0.26662987
18933,18933,Mike Craig,2002-03,31.0,10,0,2,2,0,0,0,2.0,16.0,423,71,97,168,776.0,82,5.24,53,338,2262,9.5,0.2337023
18934,18934,Mike Crowley,1998-99,23.0,2,4,8,8,2,2,4,17.0,,8,2,2,4,17.0,82,5.28,57,380,2242,9.6,0.25984463
18935,18935,Mike Crowley,1999-00,24.0,3,5,20,20,2,3,5,41.0,332.0,28,4,5,9,58.0,82,5.27,57,359,2285,9.4,0.25640154
18936,18936,Mike Crowley,2001-02,26.0,4,11,39,39,1,10,11,45.0,677.0,67,5,15,20,103.0,82,5.51,63,376,2272,9.9,0.19222349
18937,18937,Mike Danton,2001-02,21.0,2,0,2,2,0,0,0,3.0,16.0,2,0,0,0,3.0,82,5.51,63,376,2272,9.9,0.19049251
18938,18938,Mike Danton,2003-04,23.0,3,2,17,17,2,0,2,18.0,153.0,19,2,0,2,21.0,82,5.31,60,363,2326,9.4,0.23930097
18939,18939,Mike Danton,2004-05,24.0,4,12,68,68,7,5,12,72.0,812.0,87,9,5,14,93.0,82,5.14,57,348,2300,9.2,0.23972711
18940,18940,Mike Donnelly,1987-88,24.0,2,2,5,5,1,1,2,5.0,,5,1,1,2,5.0,80,7.34,72,344,2400,12.2,0.28664863
18941,18941,Mike Donnelly,1988-89,25.0,3,18,57,57,8,10,18,99.0,,62,9,11,20,104.0,80,7.43,89,437,2435,12.2,0.3366614
18942,18942,Mike Donnelly,1989-90,26.0,4,10,22,22,4,6,10,25.0,,84,13,17,30,129.0,80,7.48,85,403,2430,12.3,0.37330386
18943,18943,Mike Donnelly,1990-91,27.0,5,3,12,12,1,2,3,20.0,,96,14,19,33,149.0,80,7.37,76,367,2421,12.2,0.25794488
18944,18944,Mike Donnelly,1991-92,28.0,6,12,53,53,7,5,12,76.0,,149,21,24,45,225.0,80,6.91,71,366,2385,11.6,0.3119258
18945,18945,Mike Donnelly,1992-93,29.0,7,45,80,80,29,16,45,197.0,,229,50,40,90,422.0,80,6.96,77,402,2440,11.4,0.6008053
18946,18946,Mike Donnelly,1993-94,30.0,8,69,84,84,29,40,69,244.0,,313,79,80,159,666.0,84,7.25,87,443,2603,11.7,0.6395752
18947,18947,Mike Donnelly,1994-95,31.0,9,42,81,81,21,21,42,177.0,,394,100,101,201,843.0,84,6.48,76,407,2545,10.7,0.4757331
18948,18948,Mike Donnelly,1995-96,32.0,10,27,44,44,12,15,27,116.0,,438,112,116,228,959.0,48,5.97,37,209,1408,10.2,0.53411216
18949,18949,Mike Donnelly,1996-97,33.0,11,7,24,24,2,5,7,21.0,,462,114,121,235,980.0,82,6.29,74,413,2481,10.4,0.22580096
18950,18950,Mike Donnelly,1997-98,34.0,12,0,3,3,0,0,0,5.0,,465,114,121,235,985.0,82,5.83,55,336,2444,9.8,0.1673347
18951,18951,Mike Duco,2010-11,23.0,2,0,10,10,0,0,0,6.0,77.0,10,0,0,0,6.0,82,5.53,56,304,2486,9.1,0.17199403
18952,18952,Mike Duco,2011-12,24.0,3,0,2,2,0,0,0,0.0,17.0,12,0,0,0,6.0,82,5.46,52,291,2492,9.0,0.14874858
18953,18953,Mike Duco,2012-13,25.0,4,2,6,6,0,2,2,4.0,48.0,18,0,2,2,10.0,82,5.32,47,271,2439,8.9,0.1582931
18954,18954,Mike Eagles,1983-84,20.0,2,0,2,2,0,0,0,1.0,,2,0,0,0,1.0,80,7.73,71,310,2444,12.7,0.28916705
18955,18955,Mike Eagles,1986-87,23.0,3,23,73,73,11,12,23,69.0,,75,11,12,23,70.0,80,7.94,82,370,2484,12.8,0.32314956
18956,18956,Mike Eagles,1987-88,24.0,4,32,73,73,13,19,32,95.0,,148,24,31,55,165.0,80,7.34,72,344,2400,12.2,0.4132728
18957,18957,Mike Eagles,1988-89,25.0,5,20,76,76,10,10,20,89.0,,224,34,41,75,254.0,80,7.43,89,437,2435,12.2,0.31094396
18958,18958,Mike Eagles,1989-90,26.0,6,16,47,47,5,11,16,39.0,,271,39,52,91,293.0,80,7.48,85,403,2430,12.3,0.32027012
18959,18959,Mike Eagles,1990-91,27.0,7,3,23,23,1,2,3,23.0,,294,40,54,94,316.0,80,7.37,76,367,2421,12.2,0.23745677
18960,18960,Mike Eagles,1991-92,28.0,8,9,44,44,0,9,9,51.0,,338,40,63,103,367.0,80,6.91,71,366,2385,11.6,0.2141881
18961,18961,Mike Eagles,1992-93,29.0,9,17,65,65,7,10,17,60.0,,403,47,73,120,427.0,80,6.96,77,402,2440,11.4,0.22520596
18962,18962,Mike Eagles,1993-94,30.0,10,26,84,84,8,18,26,67.0,,487,55,91,146,494.0,84,7.25,87,443,2603,11.7,0.2619546
18963,18963,Mike Eagles,1994-95,31.0,11,12,73,73,4,8,12,53.0,,560,59,99,158,547.0,84,6.48,76,407,2545,10.7,0.13880545
18964,18964,Mike Eagles,1995-96,32.0,12,7,40,40,3,4,7,28.0,,600,62,103,165,575.0,48,5.97,37,209,1408,10.2,0.18006569
18965,18965,Mike Eagles,1996-97,33.0,13,11,70,70,4,7,11,70.0,,670,66,110,176,645.0,82,6.29,74,413,2481,10.4,0.16290498
18966,18966,Mike Eagles,1997-98,34.0,14,8,70,70,1,7,8,38.0,,740,67,117,184,683.0,82,5.83,55,336,2444,9.8,0.1384351
18967,18967,Mike Eagles,1998-99,35.0,15,4,36,36,1,3,4,25.0,,776,68,120,188,708.0,82,5.28,57,380,2242,9.6,0.1397056
18968,18968,Mike Eagles,1999-00,36.0,16,6,52,52,4,2,6,41.0,497.0,828,72,122,194,749.0,82,5.27,57,359,2285,9.4,0.13604578
18969,18969,Mike Eagles,2000-01,37.0,17,2,25,25,2,0,2,13.0,190.0,853,74,122,196,762.0,82,5.49,53,331,2294,9.8,0.14543483
18970,18970,Mike Eastwood,1992-93,25.0,2,2,9,9,0,2,2,6.0,,9,0,2,2,6.0,80,6.96,77,402,2440,11.4,0.23103988
18971,18971,Mike Eastwood,1993-94,26.0,3,7,12,12,1,6,7,11.0,,21,1,8,9,17.0,84,7.25,87,443,2603,11.7,0.22923532
18972,18972,Mike Eastwood,1994-95,27.0,4,18,54,54,8,10,18,41.0,,75,9,18,27,58.0,84,6.48,76,407,2545,10.7,0.29900187
18973,18973,Mike Eastwood,1995-96,28.0,5,19,49,49,8,11,19,55.0,,124,17,29,46,113.0,48,5.97,37,209,1408,10.2,0.35803434
18974,18974,Mike Eastwood,1996-97,29.0,6,28,80,80,14,14,28,94.0,,204,31,43,74,207.0,82,6.29,74,413,2481,10.4,0.33337507
18975,18975,Mike Eastwood,1997-98,30.0,7,12,60,60,2,10,12,44.0,,264,33,53,86,251.0,82,5.83,55,336,2444,9.8,0.18777299
18976,18976,Mike Eastwood,1998-99,31.0,8,11,58,58,6,5,11,38.0,,322,39,58,97,289.0,82,5.28,57,380,2242,9.6,0.184616
18977,18977,Mike Eastwood,1999-00,32.0,9,30,82,82,9,21,30,76.0,1229.0,404,48,79,127,365.0,82,5.27,57,359,2285,9.4,0.3314298
18978,18978,Mike Eastwood,2000-01,33.0,10,34,79,79,19,15,34,83.0,1196.0,483,67,94,161,448.0,82,5.49,53,331,2294,9.8,0.35206485
18979,18979,Mike Eastwood,2001-02,34.0,11,23,77,77,6,17,23,51.0,1089.0,560,73,111,184,499.0,82,5.51,63,376,2272,9.9,0.2073209
18980,18980,Mike Eastwood,2002-03,35.0,12,17,71,71,7,10,17,60.0,917.0,631,80,121,201,559.0,82,5.24,53,338,2262,9.5,0.20076612
18981,18981,Mike Eastwood,2003-04,36.0,13,16,70,70,3,13,16,39.0,867.0,701,83,134,217,598.0,82,5.31,60,363,2326,9.4,0.17921433
18982,18982,Mike Eastwood,2004-05,37.0,14,19,82,82,4,15,19,55.0,1160.0,783,87,149,236,653.0,82,5.14,57,348,2300,9.2,0.18921128
18983,18983,Mike Farrell,2002-03,24.0,2,0,8,8,0,0,0,1.0,45.0,8,0,0,0,1.0,82,5.24,53,338,2262,9.5,0.15924224
18984,18984,Mike Farrell,2003-04,25.0,3,0,4,4,0,0,0,2.0,11.0,12,0,0,0,3.0,82,5.31,60,363,2326,9.4,0.15835747
18985,18985,Mike Farrell,2004-05,26.0,4,0,1,1,0,0,0,0.0,5.0,13,0,0,0,3.0,82,5.14,57,348,2300,9.2,0.15446895
18986,18986,Mike Fisher,2000-01,20.0,2,9,32,32,4,5,9,49.0,414.0,32,4,5,9,49.0,82,5.49,53,331,2294,9.8,0.31464118
18987,18987,Mike Fisher,2001-02,21.0,3,19,60,60,7,12,19,83.0,698.0,92,11,17,28,132.0,82,5.51,63,376,2272,9.9,0.36095017
18988,18988,Mike Fisher,2002-03,22.0,4,24,58,58,15,9,24,123.0,817.0,150,26,26,52,255.0,82,5.24,53,338,2262,9.5,0.45743662
18989,18989,Mike Fisher,2003-04,23.0,5,38,74,74,18,20,38,142.0,1183.0,224,44,46,90,397.0,82,5.31,60,363,2326,9.4,0.5270637
18990,18990,Mike Fisher,2004-05,24.0,6,10,24,24,4,6,10,47.0,418.0,248,48,52,100,444.0,82,5.14,57,348,2300,9.2,0.40392914
18991,18991,Mike Fisher,2006-07,26.0,7,44,68,68,22,22,44,150.0,1166.0,316,70,74,144,594.0,82,6.05,85,480,2458,10.1,0.58328885
18992,18992,Mike Fisher,2007-08,27.0,8,48,68,68,22,26,48,193.0,1253.0,384,92,100,192,787.0,82,5.76,70,398,2426,9.7,0.6171738
18993,18993,Mike Fisher,2008-09,28.0,9,47,79,79,23,24,47,215.0,1561.0,463,115,124,239,1002.0,82,5.44,62,351,2383,9.4,0.57638335
18994,18994,Mike Fisher,2009-10,29.0,10,32,78,78,13,19,32,182.0,1443.0,541,128,143,271,1184.0,82,5.7,65,341,2477,9.4,0.43727985
18995,18995,Mike Fisher,2010-11,30.0,11,53,79,79,25,28,53,212.0,1498.0,620,153,171,324,1396.0,82,5.53,56,304,2486,9.1,0.5872797
18996,18996,Mike Fisher,2011-12,31.0,12,36,82,82,19,17,36,192.0,1506.0,702,172,188,360,1588.0,82,5.46,52,291,2492,9.0,0.45765933
18997,18997,Mike Fisher,2012-13,32.0,13,51,72,72,24,27,51,157.0,1389.0,774,196,215,411,1745.0,82,5.32,47,271,2439,8.9,0.57618284
18998,18998,Mike Fisher,2013-14,33.0,14,21,38,38,10,11,21,68.0,740.0,812,206,226,432,1813.0,48,5.31,29,160,1399,9.1,0.47259548
18999,18999,Mike Fisher,2014-15,34.0,15,49,75,75,20,29,49,177.0,1482.0,887,226,255,481,1990.0,82,5.34,48,269,2463,8.9,0.5083112
19000,19000,Mike Fisher,2015-16,35.0,16,39,59,59,19,20,39,111.0,1088.0,946,245,275,520,2101.0,82,5.32,47,251,2453,8.9,0.50408125
19001,19001,Mike Fisher,2016-17,36.0,17,23,70,70,13,10,23,98.0,1201.0,1016,258,285,543,2199.0,82,5.34,48,255,2438,9.0,0.3311458
19002,19002,Mike Fisher,2017-18,37.0,18,42,72,72,18,24,42,120.0,1196.0,1088,276,309,585,2319.0,82,5.45,47,245,2478,9.0,0.40811238
19003,19003,Mike Fisher,2018-19,38.0,19,4,16,16,2,2,4,14.0,198.0,1104,278,311,589,2333.0,82,5.86,50,250,2620,9.2,0.32310796
19004,19004,Mike Foligno,1980-81,22.0,2,71,80,80,36,35,71,196.0,,80,36,35,71,196.0,80,7.03,61,280,2352,12.0,0.92435545
19005,19005,Mike Foligno,1981-82,23.0,3,63,80,80,28,35,63,181.0,,160,64,70,134,377.0,80,7.69,77,340,2441,12.6,0.83586913
19006,19006,Mike Foligno,1982-83,24.0,4,77,82,82,33,44,77,194.0,,242,97,114,211,571.0,80,8.03,73,320,2489,12.9,0.85965675
19007,19007,Mike Foligno,1983-84,25.0,5,47,66,66,22,25,47,132.0,,308,119,139,258,703.0,80,7.73,71,310,2444,12.7,0.8219079
19008,19008,Mike Foligno,1984-85,26.0,6,63,70,70,32,31,63,183.0,,378,151,170,321,886.0,80,7.89,74,336,2448,12.9,0.8068442
19009,19009,Mike Foligno,1985-86,27.0,7,56,77,77,27,29,56,167.0,,455,178,199,377,1053.0,80,7.77,71,321,2447,12.7,0.7487692
19010,19010,Mike Foligno,1986-87,28.0,8,80,79,79,41,39,80,222.0,,534,219,238,457,1275.0,80,7.94,82,370,2484,12.8,0.8229891
19011,19011,Mike Foligno,1987-88,29.0,9,59,75,75,30,29,59,185.0,,609,249,267,516,1460.0,80,7.34,72,344,2400,12.2,0.7576157
19012,19012,Mike Foligno,1988-89,30.0,10,57,74,74,29,28,57,159.0,,683,278,295,573,1619.0,80,7.43,89,437,2435,12.2,0.70375204
19013,19013,Mike Foligno,1989-90,31.0,11,49,75,75,27,22,49,144.0,,758,305,317,622,1763.0,80,7.48,85,403,2430,12.3,0.6071924
19014,19014,Mike Foligno,1990-91,32.0,12,40,61,61,15,25,40,107.0,,819,320,342,662,1870.0,80,7.37,76,367,2421,12.2,0.5605083
19015,19015,Mike Foligno,1991-92,33.0,13,24,68,68,12,12,24,83.0,,887,332,354,686,1953.0,80,6.91,71,366,2385,11.6,0.39027312
19016,19016,Mike Foligno,1992-93,34.0,14,14,33,33,6,8,14,41.0,,920,338,362,700,1994.0,80,6.96,77,402,2440,11.4,0.4484808
19017,19017,Mike Foligno,1993-94,35.0,15,18,55,55,13,5,18,95.0,,975,351,367,718,2089.0,84,7.25,87,443,2603,11.7,0.36374456
19018,19018,Mike Foligno,1994-95,36.0,16,9,43,43,4,5,9,35.0,,1018,355,372,727,2124.0,84,6.48,76,407,2545,10.7,0.25246117
19019,19019,Mike Gartner,1980-81,21.0,2,68,77,77,36,32,68,226.0,,77,36,32,68,226.0,80,7.03,61,280,2352,12.0,0.9415968
19020,19020,Mike Gartner,1981-82,22.0,3,94,80,80,48,46,94,326.0,,157,84,78,162,552.0,80,7.69,77,340,2441,12.6,1.1604514
19021,19021,Mike Gartner,1982-83,23.0,4,80,80,80,35,45,80,301.0,,237,119,123,242,853.0,80,8.03,73,320,2489,12.9,0.95022607
19022,19022,Mike Gartner,1983-84,24.0,5,76,73,73,38,38,76,269.0,,310,157,161,318,1122.0,80,7.73,71,310,2444,12.7,1.0105304
19023,19023,Mike Gartner,1984-85,25.0,6,85,80,80,40,45,85,286.0,,390,197,206,403,1408.0,80,7.89,74,336,2448,12.9,1.1509037
19024,19024,Mike Gartner,1985-86,26.0,7,102,80,80,50,52,102,331.0,,470,247,258,505,1739.0,80,7.77,71,321,2447,12.7,1.1771225
19025,19025,Mike Gartner,1986-87,27.0,8,75,74,74,35,40,75,279.0,,544,282,298,580,2018.0,80,7.94,82,370,2484,12.8,0.9560323
19026,19026,Mike Gartner,1987-88,28.0,9,73,78,78,41,32,73,317.0,,622,323,330,653,2335.0,80,7.34,72,344,2400,12.2,0.88220125
19027,19027,Mike Gartner,1988-89,29.0,10,81,80,80,48,33,81,316.0,,702,371,363,734,2651.0,80,7.43,89,437,2435,12.2,0.95030326
19028,19028,Mike Gartner,1989-90,30.0,11,69,69,69,33,36,69,223.0,,771,404,399,803,2874.0,80,7.48,85,403,2430,12.3,0.9149772
19029,19029,Mike Gartner,1990-91,31.0,12,86,79,79,45,41,86,288.0,,850,449,440,889,3162.0,80,7.37,76,367,2421,12.2,0.9776478
19030,19030,Mike Gartner,1991-92,32.0,13,69,79,79,49,20,69,262.0,,929,498,460,958,3424.0,80,6.91,71,366,2385,11.6,0.81739223
19031,19031,Mike Gartner,1992-93,33.0,14,81,76,76,40,41,81,286.0,,1005,538,501,1039,3710.0,80,6.96,77,402,2440,11.4,0.9235811
19032,19032,Mike Gartner,1993-94,34.0,15,68,84,84,45,23,68,323.0,,1089,583,524,1107,4033.0,84,7.25,87,443,2603,11.7,0.7570782
19033,19033,Mike Gartner,1994-95,35.0,16,64,81,81,34,30,64,275.0,,1170,617,554,1171,4308.0,84,6.48,76,407,2545,10.7,0.66042024
19034,19034,Mike Gartner,1995-96,36.0,17,20,38,38,12,8,20,91.0,,1208,629,562,1191,4399.0,48,5.97,37,209,1408,10.2,0.5713385
19035,19035,Mike Gartner,1996-97,37.0,18,54,82,82,35,19,54,275.0,,1290,664,581,1245,4674.0,82,6.29,74,413,2481,10.4,0.674829
19036,19036,Mike Gartner,1997-98,38.0,19,63,82,82,32,31,63,271.0,,1372,696,612,1308,4945.0,82,5.83,55,336,2444,9.8,0.5839248
19037,19037,Mike Gartner,1998-99,39.0,20,27,60,60,12,15,27,145.0,,1432,708,627,1335,5090.0,82,5.28,57,380,2242,9.6,0.44164968
19038,19038,Mike Gaul,1999-00,26.0,2,0,1,1,0,0,0,1.0,11.0,1,0,0,0,1.0,82,5.27,57,359,2285,9.4,0.18182465
19039,19039,Mike Gaul,2001-02,28.0,3,0,2,2,0,0,0,3.0,27.0,3,0,0,0,4.0,82,5.51,63,376,2272,9.9,0.1464718
19040,19040,Mike Glumac,2006-07,26.0,2,12,33,33,7,5,12,55.0,410.0,33,7,5,12,55.0,82,6.05,85,480,2458,10.1,0.2753125
19041,19041,Mike Glumac,2007-08,27.0,3,1,3,3,0,1,1,4.0,25.0,36,7,6,13,59.0,82,5.76,70,398,2426,9.7,0.16064832
19042,19042,Mike Glumac,2008-09,28.0,4,0,4,4,0,0,0,3.0,41.0,40,7,6,13,62.0,82,5.44,62,351,2383,9.4,0.15374467
19043,19043,Mike Green,2004-05,25.0,2,4,24,24,1,3,4,20.0,219.0,24,1,3,4,20.0,82,5.14,57,348,2300,9.2,0.19902056
19044,19044,Mike Green0,2006-07,21.0,2,3,22,22,1,2,3,13.0,328.0,22,1,2,3,13.0,82,6.05,85,480,2458,10.1,0.21051654
19045,19045,Mike Green0,2007-08,22.0,3,12,70,70,2,10,12,68.0,1084.0,92,3,12,15,81.0,82,5.76,70,398,2426,9.7,0.21521008
19046,19046,Mike Green0,2008-09,23.0,4,56,82,82,18,38,56,234.0,1938.0,174,21,50,71,315.0,82,5.44,62,351,2383,9.4,0.6907196
19047,19047,Mike Green0,2009-10,24.0,5,73,68,68,31,42,73,243.0,1752.0,242,52,92,144,558.0,82,5.7,65,341,2477,9.4,0.9165443
19048,19048,Mike Green0,2010-11,25.0,6,76,75,75,19,57,76,205.0,1911.0,317,71,149,220,763.0,82,5.53,56,304,2486,9.1,0.827199
19049,19049,Mike Green0,2011-12,26.0,7,24,49,49,8,16,24,115.0,1234.0,366,79,165,244,878.0,82,5.46,52,291,2492,9.0,0.49605712
19050,19050,Mike Green0,2012-13,27.0,8,7,32,32,3,4,7,64.0,673.0,398,82,169,251,942.0,82,5.32,47,271,2439,8.9,0.38378352
19051,19051,Mike Green0,2013-14,28.0,9,26,35,35,12,14,26,96.0,870.0,433,94,183,277,1038.0,48,5.31,29,160,1399,9.1,0.6192298
19052,19052,Mike Green0,2014-15,29.0,10,38,70,70,9,29,38,172.0,1591.0,503,103,212,315,1210.0,82,5.34,48,269,2463,8.9,0.51463526
19053,19053,Mike Green0,2015-16,30.0,11,45,72,72,10,35,45,159.0,1376.0,575,113,247,360,1369.0,82,5.32,47,251,2453,8.9,0.54105896
19054,19054,Mike Green0,2016-17,31.0,12,35,74,74,7,28,35,124.0,1463.0,649,120,275,395,1493.0,82,5.34,48,255,2438,9.0,0.40075275
19055,19055,Mike Green0,2017-18,32.0,13,36,72,72,14,22,36,125.0,1696.0,721,134,297,431,1618.0,82,5.45,47,245,2478,9.0,0.43137616
19056,19056,Mike Green0,2018-19,33.0,14,33,66,66,8,25,33,132.0,1457.0,787,142,322,464,1750.0,82,5.86,50,250,2620,9.2,0.4082562
19057,19057,Mike Green0,2019-20,34.0,15,26,43,43,5,21,26,92.0,932.0,830,147,343,490,1842.0,82,5.96,47,239,2579,9.5,0.44070348
19058,19058,Mike Green0,2020-21,35.0,16,11,50,50,3,8,11,76.0,1044.0,880,150,351,501,1918.0,70,5.96,42,208,2192,9.5,0.26914924
19059,19059,Mike Grier,1997-98,23.0,2,32,79,79,15,17,32,89.0,,79,15,17,32,89.0,82,5.83,55,336,2444,9.8,0.43934304
19060,19060,Mike Grier,1998-99,24.0,3,15,66,66,9,6,15,90.0,,145,24,23,47,179.0,82,5.28,57,380,2242,9.6,0.28679433
19061,19061,Mike Grier,1999-00,25.0,4,44,82,82,20,24,44,143.0,1308.0,227,44,47,91,322.0,82,5.27,57,359,2285,9.4,0.5247543
19062,19062,Mike Grier,2000-01,26.0,5,31,65,65,9,22,31,115.0,1024.0,292,53,69,122,437.0,82,5.49,53,331,2294,9.8,0.45331383
19063,19063,Mike Grier,2001-02,27.0,6,36,74,74,20,16,36,124.0,1239.0,366,73,85,158,561.0,82,5.51,63,376,2272,9.9,0.4398695
19064,19064,Mike Grier,2002-03,28.0,7,25,82,82,8,17,25,112.0,1232.0,448,81,102,183,673.0,82,5.24,53,338,2262,9.5,0.36416838
19065,19065,Mike Grier,2003-04,29.0,8,32,82,82,15,17,32,133.0,1459.0,530,96,119,215,806.0,82,5.31,60,363,2326,9.4,0.4170823
19066,19066,Mike Grier,2004-05,30.0,9,29,82,82,9,20,29,133.0,1430.0,612,105,139,244,939.0,82,5.14,57,348,2300,9.2,0.3663206
19067,19067,Mike Grier,2006-07,32.0,10,23,81,81,7,16,23,109.0,1164.0,693,112,155,267,1048.0,82,6.05,85,480,2458,10.1,0.26457432
19068,19068,Mike Grier,2007-08,33.0,11,33,81,81,16,17,33,125.0,1332.0,774,128,172,300,1173.0,82,5.76,70,398,2426,9.7,0.34350863
19069,19069,Mike Grier,2008-09,34.0,12,22,78,78,9,13,22,132.0,1264.0,852,137,185,322,1305.0,82,5.44,62,351,2383,9.4,0.26387843
19070,19070,Mike Grier,2009-10,35.0,13,23,62,62,10,13,23,108.0,930.0,914,147,198,345,1413.0,82,5.7,65,341,2477,9.4,0.30600685
19071,19071,Mike Grier,2010-11,36.0,14,22,73,73,10,12,22,123.0,1153.0,987,157,210,367,1536.0,82,5.53,56,304,2486,9.1,0.24894539
19072,19072,Mike Grier,2011-12,37.0,15,16,73,73,5,11,16,107.0,1051.0,1060,162,221,383,1643.0,82,5.46,52,291,2492,9.0,0.21101853
19073,19073,Mike Halmo,2014-15,23.0,2,1,20,20,1,0,1,25.0,190.0,20,1,0,1,25.0,82,5.34,48,269,2463,8.9,0.21550697
19074,19074,Mike Hartman,1987-88,20.0,2,6,17,17,3,3,6,19.0,,17,3,3,6,19.0,80,7.34,72,344,2400,12.2,0.4071948
19075,19075,Mike Hartman,1988-89,21.0,3,4,18,18,3,1,4,24.0,,35,6,4,10,43.0,80,7.43,89,437,2435,12.2,0.38559747
19076,19076,Mike Hartman,1989-90,22.0,4,17,70,70,8,9,17,91.0,,105,14,13,27,134.0,80,7.48,85,403,2430,12.3,0.3143432
19077,19077,Mike Hartman,1990-91,23.0,5,21,60,60,11,10,21,97.0,,165,25,23,48,231.0,80,7.37,76,367,2421,12.2,0.36753047
19078,19078,Mike Hartman,1991-92,24.0,6,12,60,60,9,3,12,65.0,,225,34,26,60,296.0,80,6.91,71,366,2385,11.6,0.25435036
19079,19079,Mike Hartman,1992-93,25.0,7,8,75,75,4,4,8,89.0,,300,38,30,68,385.0,80,6.96,77,402,2440,11.4,0.19768232
19080,19080,Mike Hartman,1993-94,26.0,8,8,61,61,4,4,8,77.0,,361,42,34,76,462.0,84,7.25,87,443,2603,11.7,0.19216794
19081,19081,Mike Hartman,1994-95,27.0,9,2,35,35,1,1,2,19.0,,396,43,35,78,481.0,84,6.48,76,407,2545,10.7,0.13962045
19082,19082,Mike Hartman,1995-96,28.0,10,0,1,1,0,0,0,0.0,,397,43,35,78,481.0,48,5.97,37,209,1408,10.2,0.21164545
19083,19083,Mike Heidt,1984-85,21.0,2,1,6,6,0,1,1,1.0,,6,0,1,1,1.0,80,7.89,74,336,2448,12.9,0.28391695
19084,19084,Mike Hoffman,1983-84,20.0,2,1,2,2,0,1,1,2.0,,2,0,1,1,2.0,80,7.73,71,310,2444,12.7,0.32005727
19085,19085,Mike Hoffman,1985-86,22.0,3,0,1,1,0,0,0,0.0,,3,0,1,1,2.0,80,7.77,71,321,2447,12.7,0.20296201
19086,19086,Mike Hoffman,1986-87,23.0,4,3,6,6,1,2,3,7.0,,9,1,3,4,9.0,80,7.94,82,370,2484,12.8,0.25172782
19087,19087,Mike Hoffman0,2012-13,23.0,2,0,1,1,0,0,0,0.0,9.0,1,0,0,0,0.0,82,5.32,47,271,2439,8.9,0.14553902
19088,19088,Mike Hoffman0,2013-14,24.0,3,0,3,3,0,0,0,6.0,37.0,4,0,0,0,6.0,48,5.31,29,160,1399,9.1,0.18705302
19089,19089,Mike Hoffman0,2014-15,25.0,4,6,25,25,3,3,6,61.0,330.0,29,3,3,6,67.0,82,5.34,48,269,2463,8.9,0.23101908
19090,19090,Mike Hoffman0,2015-16,26.0,5,48,79,79,27,21,48,199.0,1150.0,108,30,24,54,266.0,82,5.32,47,251,2453,8.9,0.5900324
19091,19091,Mike Hoffman0,2016-17,27.0,6,59,78,78,29,30,59,242.0,1368.0,186,59,54,113,508.0,82,5.34,48,255,2438,9.0,0.6690141
19092,19092,Mike Hoffman0,2017-18,28.0,7,61,74,74,26,35,61,224.0,1302.0,260,85,89,174,732.0,82,5.45,47,245,2478,9.0,0.7238058
19093,19093,Mike Hoffman0,2018-19,29.0,8,56,82,82,22,34,56,257.0,1509.0,342,107,123,230,989.0,82,5.86,50,250,2620,9.2,0.68341666
19094,19094,Mike Hoffman0,2019-20,30.0,9,70,82,82,36,34,70,253.0,1463.0,424,143,157,300,1242.0,82,5.96,47,239,2579,9.5,0.77776945
19095,19095,Mike Hoffman0,2020-21,31.0,10,59,69,69,29,30,59,214.0,1162.0,493,172,187,359,1456.0,70,5.96,42,208,2192,9.5,0.761999
19096,19096,Mike Hough,1987-88,24.0,2,14,56,56,6,8,14,60.0,,56,6,8,14,60.0,80,7.34,72,344,2400,12.2,0.30624044
19097,19097,Mike Hough,1988-89,25.0,3,5,17,17,3,2,5,23.0,,73,9,10,19,83.0,80,7.43,89,437,2435,12.2,0.33312938
19098,19098,Mike Hough,1989-90,26.0,4,19,46,46,9,10,19,51.0,,119,18,20,38,134.0,80,7.48,85,403,2430,12.3,0.3707232
19099,19099,Mike Hough,1990-91,27.0,5,26,43,43,13,13,26,93.0,,162,31,33,64,227.0,80,7.37,76,367,2421,12.2,0.47806582
19100,19100,Mike Hough,1991-92,28.0,6,33,63,63,13,20,33,106.0,,225,44,53,97,333.0,80,6.91,71,366,2385,11.6,0.4855995
19101,19101,Mike Hough,1992-93,29.0,7,38,61,61,16,22,38,92.0,,286,60,75,135,425.0,80,6.96,77,402,2440,11.4,0.46462405
19102,19102,Mike Hough,1993-94,30.0,8,30,77,77,8,22,30,98.0,,363,68,97,165,523.0,84,7.25,87,443,2603,11.7,0.3596757
19103,19103,Mike Hough,1994-95,31.0,9,29,78,78,6,23,29,106.0,,441,74,120,194,629.0,84,6.48,76,407,2545,10.7,0.32119906
19104,19104,Mike Hough,1995-96,32.0,10,13,48,48,6,7,13,58.0,,489,80,127,207,687.0,48,5.97,37,209,1408,10.2,0.2871518
19105,19105,Mike Hough,1996-97,33.0,11,23,64,64,7,16,23,66.0,,553,87,143,230,753.0,82,6.29,74,413,2481,10.4,0.2709029
19106,19106,Mike Hough,1997-98,34.0,12,14,69,69,8,6,14,85.0,,622,95,149,244,838.0,82,5.83,55,336,2444,9.8,0.1989938
19107,19107,Mike Hough,1998-99,35.0,13,12,74,74,5,7,12,44.0,,696,100,156,256,882.0,82,5.28,57,380,2242,9.6,0.14637011
19108,19108,Mike Hough,1999-00,36.0,14,0,11,11,0,0,0,4.0,92.0,707,100,156,256,886.0,82,5.27,57,359,2285,9.4,0.14806983
19109,19109,Mike Hudson,1989-90,22.0,2,23,41,41,7,16,23,45.0,,41,7,16,23,45.0,80,7.48,85,403,2430,12.3,0.46842575
19110,19110,Mike Hudson,1990-91,23.0,3,21,49,49,9,12,21,51.0,,90,16,28,44,96.0,80,7.37,76,367,2421,12.2,0.41682157
19111,19111,Mike Hudson,1991-92,24.0,4,16,55,55,7,9,16,53.0,,145,23,37,60,149.0,80,6.91,71,366,2385,11.6,0.34315094
19112,19112,Mike Hudson,1992-93,25.0,5,29,76,76,14,15,29,97.0,,221,37,52,89,246.0,80,6.96,77,402,2440,11.4,0.412116
19113,19113,Mike Hudson,1993-94,26.0,6,8,41,41,1,7,8,35.0,,262,38,59,97,281.0,84,7.25,87,443,2603,11.7,0.20073897
19114,19114,Mike Hudson,1994-95,27.0,7,11,48,48,4,7,11,48.0,,310,42,66,108,329.0,84,6.48,76,407,2545,10.7,0.22719502
19115,19115,Mike Hudson,1995-96,28.0,8,11,40,40,2,9,11,33.0,,350,44,75,119,362.0,48,5.97,37,209,1408,10.2,0.2602636
19116,19116,Mike Hudson,1996-97,29.0,9,17,59,59,5,12,17,59.0,,409,49,87,136,421.0,82,6.29,74,413,2481,10.4,0.26184303
19117,19117,Mike Hudson,1997-98,30.0,10,0,7,7,0,0,0,9.0,,416,49,87,136,430.0,82,5.83,55,336,2444,9.8,0.23375547
19118,19118,Mike Hurlbut,1993-94,27.0,2,9,23,23,1,8,9,26.0,,23,1,8,9,26.0,84,7.25,87,443,2603,11.7,0.25838113
19119,19119,Mike Hurlbut,1994-95,28.0,3,0,1,1,0,0,0,1.0,,24,1,8,9,27.0,84,6.48,76,407,2545,10.7,0.15737954
19120,19120,Mike Hurlbut,1998-99,32.0,4,0,3,3,0,0,0,3.0,,27,1,8,9,30.0,82,5.28,57,380,2242,9.6,0.14140016
19121,19121,Mike Hurlbut,1999-00,33.0,5,0,1,1,0,0,0,2.0,18.0,28,1,8,9,32.0,82,5.27,57,359,2285,9.4,0.13907945
19122,19122,Mike Hurlbut,2000-01,34.0,6,0,1,1,0,0,0,1.0,12.0,29,1,8,9,33.0,82,5.49,53,331,2294,9.8,0.12831697
19123,19123,Mike Iggulden,2008-09,26.0,2,0,1,1,0,0,0,1.0,7.0,1,0,0,0,1.0,82,5.44,62,351,2383,9.4,0.18182465
19124,19124,Mike Iggulden,2009-10,27.0,3,5,11,11,1,4,5,16.0,133.0,12,1,4,5,17.0,82,5.7,65,341,2477,9.4,0.23358747
19125,19125,Mike Johnson,1997-98,23.0,2,4,13,13,2,2,4,27.0,,13,2,2,4,27.0,82,5.83,55,336,2444,9.8,0.28352758
19126,19126,Mike Johnson,1998-99,24.0,3,47,82,82,15,32,47,143.0,,95,17,34,51,170.0,82,5.28,57,380,2242,9.6,0.5584347
19127,19127,Mike Johnson,1999-00,25.0,4,44,79,79,20,24,44,149.0,1285.0,174,37,58,95,319.0,82,5.27,57,359,2285,9.4,0.5321873
19128,19128,Mike Johnson,2000-01,26.0,5,47,80,80,21,26,47,132.0,1375.0,254,58,84,142,451.0,82,5.49,53,331,2294,9.8,0.6148026
19129,19129,Mike Johnson,2001-02,27.0,6,43,76,76,13,30,43,124.0,1313.0,330,71,114,185,575.0,82,5.51,63,376,2272,9.9,0.5011538
19130,19130,Mike Johnson,2002-03,28.0,7,27,57,57,5,22,27,73.0,901.0,387,76,136,212,648.0,82,5.24,53,338,2262,9.5,0.40783408
19131,19131,Mike Johnson,2003-04,29.0,8,63,82,82,23,40,63,178.0,1611.0,469,99,176,275,826.0,82,5.31,60,363,2326,9.4,0.67957526
19132,19132,Mike Johnson,2004-05,30.0,9,10,11,11,1,9,10,17.0,218.0,480,100,185,285,843.0,82,5.14,57,348,2300,9.2,0.44142017
19133,19133,Mike Johnson,2006-07,32.0,10,54,80,80,16,38,54,145.0,1326.0,560,116,223,339,988.0,82,6.05,85,480,2458,10.1,0.6205779
19134,19134,Mike Johnson,2007-08,33.0,11,31,80,80,11,20,31,131.0,1231.0,640,127,243,370,1119.0,82,5.76,70,398,2426,9.7,0.36528152
19135,19135,Mike Johnson,2008-09,34.0,12,5,21,21,2,3,5,21.0,273.0,661,129,246,375,1140.0,82,5.44,62,351,2383,9.4,0.22981012
19136,19136,Mike Keane,1989-90,22.0,2,35,69,69,16,19,35,90.0,,69,16,19,35,90.0,80,7.48,85,403,2430,12.3,0.4975561
19137,19137,Mike Keane,1990-91,23.0,3,24,74,74,9,15,24,92.0,,143,25,34,59,182.0,80,7.37,76,367,2421,12.2,0.38242078
19138,19138,Mike Keane,1991-92,24.0,4,36,73,73,13,23,36,109.0,,216,38,57,95,291.0,80,6.91,71,366,2385,11.6,0.49433288
19139,19139,Mike Keane,1992-93,25.0,5,41,67,67,11,30,41,116.0,,283,49,87,136,407.0,80,6.96,77,402,2440,11.4,0.5354836
19140,19140,Mike Keane,1993-94,26.0,6,60,77,77,15,45,60,120.0,,360,64,132,196,527.0,84,7.25,87,443,2603,11.7,0.6414044
19141,19141,Mike Keane,1994-95,27.0,7,46,80,80,16,30,46,129.0,,440,80,162,242,656.0,84,6.48,76,407,2545,10.7,0.48985982
19142,19142,Mike Keane,1995-96,28.0,8,20,48,48,10,10,20,75.0,,488,90,172,262,731.0,48,5.97,37,209,1408,10.2,0.46059722
19143,19143,Mike Keane,1996-97,29.0,9,27,73,73,10,17,27,84.0,,561,100,189,289,815.0,82,6.29,74,413,2481,10.4,0.32791293
19144,19144,Mike Keane,1997-98,30.0,10,27,81,81,10,17,27,91.0,,642,110,206,316,906.0,82,5.83,55,336,2444,9.8,0.32775536
19145,19145,Mike Keane,1998-99,31.0,11,23,83,83,10,13,23,128.0,,725,120,219,339,1034.0,82,5.28,57,380,2242,9.6,0.2670246
19146,19146,Mike Keane,1999-00,32.0,12,29,81,81,6,23,29,106.0,1130.0,806,126,242,368,1140.0,82,5.27,57,359,2285,9.4,0.33460918
19147,19147,Mike Keane,2000-01,33.0,13,34,81,81,13,21,34,85.0,1310.0,887,139,263,402,1225.0,82,5.49,53,331,2294,9.8,0.38447684
19148,19148,Mike Keane,2001-02,34.0,14,24,67,67,10,14,24,64.0,1036.0,954,149,277,426,1289.0,82,5.51,63,376,2272,9.9,0.2429328
19149,19149,Mike Keane,2002-03,35.0,15,17,78,78,6,11,17,73.0,1174.0,1032,155,288,443,1362.0,82,5.24,53,338,2262,9.5,0.20052102
19150,19150,Mike Keane,2003-04,36.0,16,10,65,65,5,5,10,35.0,796.0,1097,160,293,453,1397.0,82,5.31,60,363,2326,9.4,0.16321146
19151,19151,Mike Keane,2004-05,37.0,17,17,64,64,8,9,17,41.0,716.0,1161,168,302,470,1438.0,82,5.14,57,348,2300,9.2,0.28921545
19152,19152,Mike Kennedy,1995-96,23.0,2,18,44,44,6,12,18,76.0,,44,6,12,18,76.0,48,5.97,37,209,1408,10.2,0.43855128
19153,19153,Mike Kennedy,1996-97,24.0,3,26,61,61,9,17,26,111.0,,105,15,29,44,187.0,82,6.29,74,413,2481,10.4,0.4070753
19154,19154,Mike Kennedy,1997-98,25.0,4,7,24,24,1,6,7,26.0,,129,16,35,51,213.0,82,5.83,55,336,2444,9.8,0.21754408
19155,19155,Mike Kennedy,1998-99,26.0,5,1,15,15,0,1,1,12.0,,144,16,36,52,225.0,82,5.28,57,380,2242,9.6,0.20144555
19156,19156,Mike Kennedy,1999-00,27.0,6,0,1,1,0,0,0,0.0,11.0,145,16,36,52,225.0,82,5.27,57,359,2285,9.4,0.20768875
19157,19157,Mike Knuble,1997-98,25.0,2,1,9,9,1,0,1,10.0,,9,1,0,1,10.0,82,5.83,55,336,2444,9.8,0.20173368
19158,19158,Mike Knuble,1998-99,26.0,3,13,53,53,7,6,13,54.0,,62,8,6,14,64.0,82,5.28,57,380,2242,9.6,0.2426227
19159,19159,Mike Knuble,1999-00,27.0,4,35,82,82,15,20,35,113.0,1219.0,144,23,26,49,177.0,82,5.27,57,359,2285,9.4,0.40034997
19160,19160,Mike Knuble,2000-01,28.0,5,20,73,73,12,8,20,78.0,901.0,217,35,34,69,255.0,82,5.49,53,331,2294,9.8,0.29093856
19161,19161,Mike Knuble,2001-02,29.0,6,20,82,82,7,13,20,92.0,867.0,299,42,47,89,347.0,82,5.51,63,376,2272,9.9,0.2480405
19162,19162,Mike Knuble,2002-03,30.0,7,14,54,54,8,6,14,77.0,527.0,353,50,53,103,424.0,82,5.24,53,338,2262,9.5,0.29227045
19163,19163,Mike Knuble,2003-04,31.0,8,59,75,75,30,29,59,185.0,1305.0,428,80,82,162,609.0,82,5.31,60,363,2326,9.4,0.6172357
19164,19164,Mike Knuble,2004-05,32.0,9,46,82,82,21,25,46,192.0,1540.0,510,101,107,208,801.0,82,5.14,57,348,2300,9.2,0.5964135
19165,19165,Mike Knuble,2006-07,34.0,10,65,82,82,34,31,65,217.0,1668.0,592,135,138,273,1018.0,82,6.05,85,480,2458,10.1,0.6842313
19166,19166,Mike Knuble,2007-08,35.0,11,54,64,64,24,30,54,160.0,1256.0,656,159,168,327,1178.0,82,5.76,70,398,2426,9.7,0.6596211
19167,19167,Mike Knuble,2008-09,36.0,12,55,82,82,29,26,55,177.0,1551.0,738,188,194,382,1355.0,82,5.44,62,351,2383,9.4,0.57189035
19168,19168,Mike Knuble,2009-10,37.0,13,47,82,82,27,20,47,173.0,1490.0,820,215,214,429,1528.0,82,5.7,65,341,2477,9.4,0.53384453
19169,19169,Mike Knuble,2010-11,38.0,14,53,69,69,29,24,53,151.0,1164.0,889,244,238,482,1679.0,82,5.53,56,304,2486,9.1,0.5800483
19170,19170,Mike Knuble,2011-12,39.0,15,40,79,79,24,16,40,203.0,1413.0,968,268,254,522,1882.0,82,5.46,52,291,2492,9.0,0.43040735
19171,19171,Mike Knuble,2012-13,40.0,16,18,72,72,6,12,18,91.0,1004.0,1040,274,266,540,1973.0,82,5.32,47,271,2439,8.9,0.27176553
19172,19172,Mike Knuble,2013-14,41.0,17,8,28,28,4,4,8,31.0,362.0,1068,278,270,548,2004.0,48,5.31,29,160,1399,9.1,0.38018915
19173,19173,Mike Komisarek,2003-04,22.0,2,1,21,21,0,1,1,26.0,351.0,21,0,1,1,26.0,82,5.31,60,363,2326,9.4,0.19759676
19174,19174,Mike Komisarek,2004-05,23.0,3,4,46,46,0,4,4,40.0,552.0,67,0,5,5,66.0,82,5.14,57,348,2300,9.2,0.17883936
19175,19175,Mike Komisarek,2006-07,25.0,4,6,71,71,2,4,6,66.0,1042.0,138,2,9,11,132.0,82,6.05,85,480,2458,10.1,0.15746659
19176,19176,Mike Komisarek,2007-08,26.0,5,19,82,82,4,15,19,78.0,1580.0,220,6,24,30,210.0,82,5.76,70,398,2426,9.7,0.22273698
19177,19177,Mike Komisarek,2008-09,27.0,6,17,75,75,4,13,17,75.0,1587.0,295,10,37,47,285.0,82,5.44,62,351,2383,9.4,0.19979423
19178,19178,Mike Komisarek,2009-10,28.0,7,11,66,66,2,9,11,56.0,1361.0,361,12,46,58,341.0,82,5.7,65,341,2477,9.4,0.1615397
19179,19179,Mike Komisarek,2010-11,29.0,8,4,34,34,0,4,4,35.0,678.0,395,12,50,62,376.0,82,5.53,56,304,2486,9.1,0.152623
19180,19180,Mike Komisarek,2011-12,30.0,9,10,75,75,1,9,10,48.0,1022.0,470,13,59,72,424.0,82,5.46,52,291,2492,9.0,0.1392209
19181,19181,Mike Komisarek,2012-13,31.0,10,5,45,45,1,4,5,34.0,750.0,515,14,63,77,458.0,82,5.32,47,271,2439,8.9,0.11799121
19182,19182,Mike Komisarek,2013-14,32.0,11,0,4,4,0,0,0,1.0,61.0,519,14,63,77,459.0,48,5.31,29,160,1399,9.1,0.14849699
19183,19183,Mike Komisarek,2014-15,33.0,12,4,32,32,0,4,4,20.0,374.0,551,14,67,81,479.0,82,5.34,48,269,2463,8.9,0.1208646
19184,19184,Mike Kostka,2013-14,28.0,2,8,35,35,0,8,8,49.0,773.0,35,0,8,8,49.0,48,5.31,29,160,1399,9.1,0.20759821
19185,19185,Mike Kostka,2014-15,29.0,3,11,28,28,4,7,11,49.0,432.0,63,4,15,19,98.0,82,5.34,48,269,2463,8.9,0.24984238
19186,19186,Mike Kostka,2015-16,30.0,4,1,7,7,0,1,1,7.0,108.0,70,4,16,20,105.0,82,5.32,47,251,2453,8.9,0.15612787
19187,19187,Mike Kostka,2016-17,31.0,5,1,15,15,0,1,1,9.0,223.0,85,4,17,21,114.0,82,5.34,48,255,2438,9.0,0.14005989
19188,19188,Mike Krushelnyski,1982-83,22.0,2,6,17,17,3,3,6,19.0,,17,3,3,6,19.0,80,8.03,73,320,2489,12.9,0.35951883
19189,19189,Mike Krushelnyski,1983-84,23.0,3,65,79,79,23,42,65,153.0,,96,26,45,71,172.0,80,7.73,71,310,2444,12.7,0.75759965
19190,19190,Mike Krushelnyski,1984-85,24.0,4,45,66,66,25,20,45,152.0,,162,51,65,116,324.0,80,7.89,74,336,2448,12.9,0.6802868
19191,19191,Mike Krushelnyski,1985-86,25.0,5,88,80,80,43,45,88,191.0,,242,94,110,204,515.0,80,7.77,71,321,2447,12.7,1.0421047
19192,19192,Mike Krushelnyski,1986-87,26.0,6,40,54,54,16,24,40,98.0,,296,110,134,244,613.0,80,7.94,82,370,2484,12.8,0.71712637
19193,19193,Mike Krushelnyski,1987-88,27.0,7,51,80,80,16,35,51,88.0,,376,126,169,295,701.0,80,7.34,72,344,2400,12.2,0.5914818
19194,19194,Mike Krushelnyski,1988-89,28.0,8,47,76,76,20,27,47,124.0,,452,146,196,342,825.0,80,7.43,89,437,2435,12.2,0.6058899
19195,19195,Mike Krushelnyski,1989-90,29.0,9,62,78,78,26,36,62,143.0,,530,172,232,404,968.0,80,7.48,85,403,2430,12.3,0.78312385
19196,19196,Mike Krushelnyski,1990-91,30.0,10,41,63,63,16,25,41,101.0,,593,188,257,445,1069.0,80,7.37,76,367,2421,12.2,0.56226444
19197,19197,Mike Krushelnyski,1991-92,31.0,11,45,74,74,18,27,45,109.0,,667,206,284,490,1178.0,80,6.91,71,366,2385,11.6,0.5029155
19198,19198,Mike Krushelnyski,1992-93,32.0,12,24,72,72,9,15,24,100.0,,739,215,299,514,1278.0,80,6.96,77,402,2440,11.4,0.3570264
19199,19199,Mike Krushelnyski,1993-94,33.0,13,39,84,84,19,20,39,130.0,,823,234,319,553,1408.0,84,7.25,87,443,2603,11.7,0.41616556
19200,19200,Mike Krushelnyski,1994-95,34.0,14,11,54,54,5,6,11,71.0,,877,239,325,564,1479.0,84,6.48,76,407,2545,10.7,0.29233432
19201,19201,Mike Krushelnyski,1995-96,35.0,15,5,20,20,2,3,5,20.0,,897,241,328,569,1499.0,48,5.97,37,209,1408,10.2,0.3924075
19202,19202,Mike Lalor,1986-87,23.0,2,8,62,62,3,5,8,44.0,,62,3,5,8,44.0,80,7.94,82,370,2484,12.8,0.19540179
19203,19203,Mike Lalor,1987-88,24.0,3,10,57,57,0,10,10,58.0,,119,3,15,18,102.0,80,7.34,72,344,2400,12.2,0.22588453
19204,19204,Mike Lalor,1988-89,25.0,4,11,66,66,1,10,11,41.0,,185,4,25,29,143.0,80,7.43,89,437,2435,12.2,0.21988228
19205,19205,Mike Lalor,1989-90,26.0,5,20,48,48,2,18,20,52.0,,233,6,43,49,195.0,80,7.48,85,403,2430,12.3,0.32636338
19206,19206,Mike Lalor,1990-91,27.0,6,16,78,78,0,16,16,79.0,,311,6,59,65,274.0,80,7.37,76,367,2421,12.2,0.20895636
19207,19207,Mike Lalor,1991-92,28.0,7,6,68,68,1,5,6,49.0,,379,7,64,71,323.0,80,6.91,71,366,2385,11.6,0.17132798
19208,19208,Mike Lalor,1992-93,29.0,8,17,79,79,7,10,17,74.0,,458,14,74,88,397.0,80,6.96,77,402,2440,11.4,0.22102085
19209,19209,Mike Lalor,1993-94,30.0,9,9,64,64,1,8,9,75.0,,522,15,82,97,472.0,84,7.25,87,443,2603,11.7,0.16398185
19210,19210,Mike Lalor,1994-95,31.0,10,3,35,35,0,3,3,22.0,,557,15,85,100,494.0,84,6.48,76,407,2545,10.7,0.12855801
19211,19211,Mike Lalor,1995-96,32.0,11,0,12,12,0,0,0,6.0,,569,15,85,100,500.0,48,5.97,37,209,1408,10.2,0.11577973
19212,19212,Mike Lalor,1996-97,33.0,12,3,63,63,1,2,3,46.0,,632,16,87,103,546.0,82,6.29,74,413,2481,10.4,0.11381692
19213,19213,Mike Lalor,1997-98,34.0,13,2,55,55,1,1,2,32.0,,687,17,88,105,578.0,82,5.83,55,336,2444,9.8,0.09931588
19214,19214,Mike Lauen,1984-85,23.0,2,1,4,4,0,1,1,3.0,,4,0,1,1,3.0,80,7.89,74,336,2448,12.9,0.2510293
19215,19215,Mike Leclerc,1997-98,21.0,2,2,5,5,1,1,2,3.0,,5,1,1,2,3.0,82,5.83,55,336,2444,9.8,0.2584612
19216,19216,Mike Leclerc,1998-99,22.0,3,0,7,7,0,0,0,11.0,,12,1,1,2,14.0,82,5.28,57,380,2242,9.6,0.18818769
19217,19217,Mike Leclerc,1999-00,23.0,4,0,7,7,0,0,0,1.0,41.0,19,1,1,2,15.0,82,5.27,57,359,2285,9.4,0.15985459
19218,19218,Mike Leclerc,2000-01,24.0,5,19,69,69,8,11,19,105.0,837.0,88,9,12,21,120.0,82,5.49,53,331,2294,9.8,0.2955499
19219,19219,Mike Leclerc,2001-02,25.0,6,35,54,54,15,20,35,130.0,950.0,142,24,32,56,250.0,82,5.51,63,376,2272,9.9,0.55922794
19220,19220,Mike Leclerc,2002-03,26.0,7,44,82,82,20,24,44,178.0,1425.0,224,44,56,100,428.0,82,5.24,53,338,2262,9.5,0.54028946
19221,19221,Mike Leclerc,2003-04,27.0,8,28,57,57,9,19,28,122.0,966.0,281,53,75,128,550.0,82,5.31,60,363,2326,9.4,0.40210766
19222,19222,Mike Leclerc,2004-05,28.0,9,4,10,10,1,3,4,19.0,156.0,291,54,78,132,569.0,82,5.14,57,348,2300,9.2,0.30185223
19223,19223,Mike Leclerc,2006-07,30.0,10,26,50,50,10,16,26,65.0,668.0,341,64,94,158,634.0,82,6.05,85,480,2458,10.1,0.42474085
19224,19224,Mike Lundin,2008-09,24.0,2,6,81,81,0,6,6,33.0,1117.0,81,0,6,6,33.0,82,5.44,62,351,2383,9.4,0.13573757
19225,19225,Mike Lundin,2009-10,25.0,3,2,25,25,0,2,2,8.0,416.0,106,0,8,8,41.0,82,5.7,65,341,2477,9.4,0.112695664
19226,19226,Mike Lundin,2010-11,26.0,4,13,49,49,3,10,13,42.0,1075.0,155,3,18,21,83.0,82,5.53,56,304,2486,9.1,0.19627565
19227,19227,Mike Lundin,2011-12,27.0,5,12,69,69,1,11,12,55.0,1408.0,224,4,29,33,138.0,82,5.46,52,291,2492,9.0,0.13616747
19228,19228,Mike Lundin,2012-13,28.0,6,2,17,17,0,2,2,9.0,344.0,241,4,31,35,147.0,82,5.32,47,271,2439,8.9,0.12742278
19229,19229,Mike Lundin,2013-14,29.0,7,1,11,11,0,1,1,13.0,171.0,252,4,32,36,160.0,48,5.31,29,160,1399,9.1,0.15468642
19230,19230,Mike MacWilliam,1996-97,29.0,2,0,6,6,0,0,0,4.0,,6,0,0,0,4.0,82,6.29,74,413,2481,10.4,0.16535577
19231,19231,Mike Maneluk,1999-00,26.0,2,15,45,45,6,9,15,55.0,533.0,45,6,9,15,55.0,82,5.27,57,359,2285,9.4,0.27674064
19232,19232,Mike Maneluk,2000-01,27.0,3,0,1,1,0,0,0,2.0,8.0,46,6,9,15,57.0,82,5.49,53,331,2294,9.8,0.15300396
19233,19233,Mike Maneluk,2001-02,28.0,4,6,39,39,5,1,6,31.0,458.0,85,11,10,21,88.0,82,5.51,63,376,2272,9.9,0.18313041
19234,19234,Mike Matheson,2016-17,22.0,2,0,3,3,0,0,0,4.0,53.0,3,0,0,0,4.0,82,5.34,48,255,2438,9.0,0.18558577
19235,19235,Mike Matheson,2017-18,23.0,3,17,81,81,7,10,17,179.0,1705.0,84,7,10,17,183.0,82,5.45,47,245,2478,9.0,0.34236014
19236,19236,Mike Matheson,2018-19,24.0,4,27,81,81,10,17,27,167.0,1728.0,165,17,27,44,350.0,82,5.86,50,250,2620,9.2,0.35857964
19237,19237,Mike Matheson,2019-20,25.0,5,27,75,75,8,19,27,129.0,1674.0,240,25,46,71,479.0,82,5.96,47,239,2579,9.5,0.35533798
19238,19238,Mike Matheson,2020-21,26.0,6,20,59,59,8,12,20,104.0,1064.0,299,33,58,91,583.0,70,5.96,42,208,2192,9.5,0.32706255
19239,19239,Mike Matteucci,2001-02,30.0,2,0,3,3,0,0,0,3.0,34.0,3,0,0,0,3.0,82,5.51,63,376,2272,9.9,0.14306968
19240,19240,Mike Matteucci,2002-03,31.0,3,0,3,3,0,0,0,0.0,30.0,6,0,0,0,3.0,82,5.24,53,338,2262,9.5,0.13827932
19241,19241,Mike McBain,1998-99,22.0,2,1,27,27,0,1,1,17.0,,27,0,1,1,17.0,82,5.28,57,380,2242,9.6,0.15398493
19242,19242,Mike McBain,1999-00,23.0,3,6,37,37,0,6,6,22.0,548.0,64,0,7,7,39.0,82,5.27,57,359,2285,9.4,0.16298577
19243,19243,Mike McHugh,1989-90,24.0,2,0,3,3,0,0,0,1.0,,3,0,0,0,1.0,80,7.48,85,403,2430,12.3,0.20986706
19244,19244,Mike McHugh,1990-91,25.0,3,0,3,3,0,0,0,2.0,,6,0,0,0,3.0,80,7.37,76,367,2421,12.2,0.19869587
19245,19245,Mike McHugh,1991-92,26.0,4,0,6,6,0,0,0,4.0,,12,0,0,0,7.0,80,6.91,71,366,2385,11.6,0.17839158
19246,19246,Mike McHugh,1992-93,27.0,5,1,8,8,1,0,1,5.0,,20,1,0,1,12.0,80,6.96,77,402,2440,11.4,0.21614993
19247,19247,Mike McKee,1994-95,25.0,2,15,48,48,3,12,15,60.0,,48,3,12,15,60.0,84,6.48,76,407,2545,10.7,0.2566375
19248,19248,Mike McNeill,1991-92,25.0,2,11,37,37,4,7,11,31.0,,37,4,7,11,31.0,80,6.91,71,366,2385,11.6,0.26478547
19249,19249,Mike McNeill,1992-93,26.0,3,5,26,26,1,4,5,15.0,,63,5,11,16,46.0,80,6.96,77,402,2440,11.4,0.18517739
19250,19250,Mike McPhee,1984-85,24.0,2,7,14,14,5,2,7,22.0,,14,5,2,7,22.0,80,7.89,74,336,2448,12.9,0.40790468
19251,19251,Mike McPhee,1985-86,25.0,3,39,70,70,17,22,39,135.0,,84,22,24,46,157.0,80,7.77,71,321,2447,12.7,0.5504871
19252,19252,Mike McPhee,1986-87,26.0,4,40,70,70,19,21,40,103.0,,154,41,45,86,260.0,80,7.94,82,370,2484,12.8,0.5306833
19253,19253,Mike McPhee,1987-88,27.0,5,39,79,79,18,21,39,150.0,,233,59,66,125,410.0,80,7.34,72,344,2400,12.2,0.5182483
19254,19254,Mike McPhee,1988-89,28.0,6,43,77,77,23,20,43,151.0,,310,82,86,168,561.0,80,7.43,89,437,2435,12.2,0.50286156
19255,19255,Mike McPhee,1989-90,29.0,7,41,73,73,19,22,41,154.0,,383,101,108,209,715.0,80,7.48,85,403,2430,12.3,0.5204284
19256,19256,Mike McPhee,1990-91,30.0,8,41,56,56,23,18,41,118.0,,439,124,126,250,833.0,80,7.37,76,367,2421,12.2,0.6141913
19257,19257,Mike McPhee,1991-92,31.0,9,43,64,64,22,21,43,123.0,,503,146,147,293,956.0,80,6.91,71,366,2385,11.6,0.5563742
19258,19258,Mike McPhee,1992-93,32.0,10,31,78,78,16,15,31,146.0,,581,162,162,324,1102.0,80,6.96,77,402,2440,11.4,0.39969045
19259,19259,Mike McPhee,1993-94,33.0,11,40,84,84,18,22,40,161.0,,665,180,184,364,1263.0,84,7.25,87,443,2603,11.7,0.45282966
19260,19260,Mike McPhee,1994-95,34.0,12,35,79,79,20,15,35,115.0,,744,200,199,399,1378.0,84,6.48,76,407,2545,10.7,0.35726613
19261,19261,Mike Millar,1987-88,22.0,2,4,10,10,2,2,4,13.0,,10,2,2,4,13.0,80,7.34,72,344,2400,12.2,0.3369257
19262,19262,Mike Millar,1988-89,23.0,3,14,28,28,7,7,14,58.0,,38,9,9,18,71.0,80,7.43,89,437,2435,12.2,0.4138719
19263,19263,Mike Millar,1989-90,24.0,4,9,18,18,6,3,9,37.0,,56,15,12,27,108.0,80,7.48,85,403,2430,12.3,0.4094179
19264,19264,Mike Millar,1990-91,25.0,5,5,15,15,1,4,5,18.0,,71,16,16,32,126.0,80,7.37,76,367,2421,12.2,0.3000658
19265,19265,Mike Millar,1991-92,26.0,6,4,7,7,2,2,4,11.0,,78,18,18,36,137.0,80,6.91,71,366,2385,11.6,0.32172453
19266,19266,Mike Modano,1990-91,20.0,2,75,80,80,29,46,75,172.0,,80,29,46,75,172.0,80,7.37,76,367,2421,12.2,0.94271207
19267,19267,Mike Modano,1991-92,21.0,3,64,79,79,28,36,64,232.0,,159,57,82,139,404.0,80,6.91,71,366,2385,11.6,0.89472914
19268,19268,Mike Modano,1992-93,22.0,4,77,76,76,33,44,77,256.0,,235,90,126,216,660.0,80,6.96,77,402,2440,11.4,1.0101068
19269,19269,Mike Modano,1993-94,23.0,5,93,82,82,33,60,93,307.0,,317,123,186,309,967.0,84,7.25,87,443,2603,11.7,1.0583758
19270,19270,Mike Modano,1994-95,24.0,6,93,76,76,50,43,93,281.0,,393,173,229,402,1248.0,84,6.48,76,407,2545,10.7,1.0674865
19271,19271,Mike Modano,1995-96,25.0,7,29,30,30,12,17,29,100.0,,423,185,246,431,1348.0,48,5.97,37,209,1408,10.2,0.9607059
19272,19272,Mike Modano,1996-97,26.0,8,81,78,78,36,45,81,320.0,,501,221,291,512,1668.0,82,6.29,74,413,2481,10.4,0.9419539
19273,19273,Mike Modano,1997-98,27.0,9,83,80,80,35,48,83,291.0,,581,256,339,595,1959.0,82,5.83,55,336,2444,9.8,0.9695863
19274,19274,Mike Modano,1998-99,28.0,10,59,52,52,21,38,59,191.0,,633,277,377,654,2150.0,82,5.28,57,380,2242,9.6,0.9536463
19275,19275,Mike Modano,1999-00,29.0,11,81,77,77,34,47,81,224.0,1604.0,710,311,424,735,2374.0,82,5.27,57,359,2285,9.4,0.9461138
19276,19276,Mike Modano,2000-01,30.0,12,81,77,77,38,43,81,188.0,1764.0,787,349,467,816,2562.0,82,5.49,53,331,2294,9.8,0.9536108
19277,19277,Mike Modano,2001-02,31.0,13,84,81,81,33,51,84,208.0,1815.0,868,382,518,900,2770.0,82,5.51,63,376,2272,9.9,0.93785024
19278,19278,Mike Modano,2002-03,32.0,14,77,78,78,34,43,77,219.0,1752.0,946,416,561,977,2989.0,82,5.24,53,338,2262,9.5,0.89599824
19279,19279,Mike Modano,2003-04,33.0,15,85,79,79,28,57,85,193.0,1649.0,1025,444,618,1062,3182.0,82,5.31,60,363,2326,9.4,0.94726706
19280,19280,Mike Modano,2004-05,34.0,16,44,76,76,14,30,44,152.0,1554.0,1101,458,648,1106,3334.0,82,5.14,57,348,2300,9.2,0.7844298
19281,19281,Mike Modano,2006-07,36.0,17,77,78,78,27,50,77,207.0,1526.0,1179,485,698,1183,3541.0,82,6.05,85,480,2458,10.1,0.8275606
19282,19282,Mike Modano,2007-08,37.0,18,43,59,59,22,21,43,141.0,1086.0,1238,507,719,1226,3682.0,82,5.76,70,398,2426,9.7,0.68306226
19283,19283,Mike Modano,2008-09,38.0,19,57,82,82,21,36,57,200.0,1578.0,1320,528,755,1283,3882.0,82,5.44,62,351,2383,9.4,0.61405855
19284,19284,Mike Modano,2009-10,39.0,20,46,80,80,15,31,46,197.0,1464.0,1400,543,786,1329,4079.0,82,5.7,65,341,2477,9.4,0.55231684
19285,19285,Mike Modano,2010-11,40.0,21,30,59,59,14,16,30,115.0,844.0,1459,557,802,1359,4194.0,82,5.53,56,304,2486,9.1,0.46504778
19286,19286,Mike Modano,2011-12,41.0,22,15,40,40,4,11,15,79.0,498.0,1499,561,813,1374,4273.0,82,5.46,52,291,2492,9.0,0.3687677
19287,19287,Mike Moher,1983-84,21.0,2,1,9,9,0,1,1,8.0,,9,0,1,1,8.0,80,7.73,71,310,2444,12.7,0.28662
19288,19288,Mike Moller,1981-82,19.0,2,4,5,5,2,2,4,7.0,,5,2,2,4,7.0,80,7.69,77,340,2441,12.6,0.3711686
19289,19289,Mike Moller,1982-83,20.0,3,0,9,9,0,0,0,2.0,,14,2,2,4,9.0,80,8.03,73,320,2489,12.9,0.27008206
19290,19290,Mike Moller,1983-84,21.0,4,18,49,49,6,12,18,44.0,,63,8,14,22,53.0,80,7.73,71,310,2444,12.7,0.3949965
19291,19291,Mike Moller,1984-85,22.0,5,16,59,59,5,11,16,42.0,,122,13,25,38,95.0,80,7.89,74,336,2448,12.9,0.30165184
19292,19292,Mike Moller,1985-86,23.0,6,2,5,5,0,2,2,5.0,,127,13,27,40,100.0,80,7.77,71,321,2447,12.7,0.26642346
19293,19293,Mike Moller,1986-87,24.0,7,0,1,1,0,0,0,2.0,,128,13,27,40,102.0,80,7.94,82,370,2484,12.8,0.20344183
19294,19294,Mike Moller,1987-88,25.0,8,3,6,6,2,1,3,10.0,,134,15,28,43,112.0,80,7.34,72,344,2400,12.2,0.29259443
19295,19295,Mike Moore,2011-12,27.0,2,1,6,6,1,0,1,5.0,61.0,6,1,0,1,5.0,82,5.46,52,291,2492,9.0,0.20235631
19296,19296,Mike Mottau,2001-02,23.0,2,3,18,18,0,3,3,17.0,275.0,18,0,3,3,17.0,82,5.51,63,376,2272,9.9,0.18390486
19297,19297,Mike Mottau,2002-03,24.0,3,0,1,1,0,0,0,0.0,6.0,19,0,3,3,17.0,82,5.24,53,338,2262,9.5,0.14397982
19298,19298,Mike Mottau,2003-04,25.0,4,0,4,4,0,0,0,0.0,39.0,23,0,3,3,17.0,82,5.31,60,363,2326,9.4,0.1381582
19299,19299,Mike Mottau,2008-09,30.0,5,17,76,76,4,13,17,68.0,1570.0,99,4,16,20,85.0,82,5.44,62,351,2383,9.4,0.19012138
19300,19300,Mike Mottau,2009-10,31.0,6,15,80,80,1,14,15,71.0,1423.0,179,5,30,35,156.0,82,5.7,65,341,2477,9.4,0.1480192
19301,19301,Mike Mottau,2010-11,32.0,7,18,79,79,2,16,18,74.0,1759.0,258,7,46,53,230.0,82,5.53,56,304,2486,9.1,0.20176312
19302,19302,Mike Mottau,2011-12,33.0,8,3,20,20,0,3,3,21.0,407.0,278,7,49,56,251.0,82,5.46,52,291,2492,9.0,0.12705731
19303,19303,Mike Mottau,2012-13,34.0,9,2,35,35,0,2,2,22.0,493.0,313,7,51,58,273.0,82,5.32,47,271,2439,8.9,0.09848657
19304,19304,Mike Mottau,2014-15,36.0,10,0,8,8,0,0,0,1.0,101.0,321,7,51,58,274.0,82,5.34,48,269,2463,8.9,0.13496953
19305,19305,Mike Murray,1988-89,22.0,2,0,1,1,0,0,0,1.0,,1,0,0,0,1.0,80,7.43,89,437,2435,12.2,0.21754727
19306,19306,Mike Natyshak,1988-89,25.0,2,0,4,4,0,0,0,0.0,,4,0,0,0,0.0,80,7.43,89,437,2435,12.2,0.16142058
19307,19307,Mike Needham,1993-94,23.0,2,13,56,56,8,5,13,49.0,,56,8,5,13,49.0,84,7.25,87,443,2603,11.7,0.29088557
19308,19308,Mike Needham,1994-95,24.0,3,1,30,30,1,0,1,9.0,,86,9,5,14,58.0,84,6.48,76,407,2545,10.7,0.1386778
19309,19309,Mike Pandolfo,2004-05,25.0,2,0,3,3,0,0,0,3.0,25.0,3,0,0,0,3.0,82,5.14,57,348,2300,9.2,0.1792824
19310,19310,Mike Peluso,1990-91,25.0,2,0,2,2,0,0,0,0.0,,2,0,0,0,0.0,80,7.37,76,367,2421,12.2,0.17421168
19311,19311,Mike Peluso,1991-92,26.0,3,7,53,53,6,1,7,29.0,,55,6,1,7,29.0,80,6.91,71,366,2385,11.6,0.17783216
19312,19312,Mike Peluso,1992-93,27.0,4,9,63,63,6,3,9,32.0,,118,12,4,16,61.0,80,6.96,77,402,2440,11.4,0.18665913
19313,19313,Mike Peluso,1993-94,28.0,5,25,81,81,15,10,25,93.0,,199,27,14,41,154.0,84,7.25,87,443,2603,11.7,0.31255376
19314,19314,Mike Peluso,1994-95,29.0,6,20,69,69,4,16,20,44.0,,268,31,30,61,198.0,84,6.48,76,407,2545,10.7,0.22690731
19315,19315,Mike Peluso,1995-96,30.0,7,11,46,46,2,9,11,27.0,,314,33,39,72,225.0,48,5.97,37,209,1408,10.2,0.21900645
19316,19316,Mike Peluso,1996-97,31.0,8,11,57,57,3,8,11,41.0,,371,36,47,83,266.0,82,6.29,74,413,2481,10.4,0.16893235
19317,19317,Mike Peluso,1997-98,32.0,9,7,64,64,2,5,7,37.0,,435,38,52,90,303.0,82,5.83,55,336,2444,9.8,0.14390355
19318,19318,Mike Peluso,1998-99,33.0,10,0,23,23,0,0,0,8.0,,458,38,52,90,311.0,82,5.28,57,380,2242,9.6,0.10151377
19319,19319,Mike Peluso0,2002-03,28.0,2,6,37,37,4,2,6,45.0,343.0,37,4,2,6,45.0,82,5.24,53,338,2262,9.5,0.19777936
19320,19320,Mike Peluso0,2004-05,30.0,3,0,1,1,0,0,0,2.0,10.0,38,4,2,6,47.0,82,5.14,57,348,2300,9.2,0.14559078
19321,19321,Mike Posavad,1986-87,23.0,2,0,6,6,0,0,0,2.0,,6,0,0,0,2.0,80,7.94,82,370,2484,12.8,0.21727103
19322,19322,Mike Posavad,1987-88,24.0,3,0,2,2,0,0,0,0.0,,8,0,0,0,2.0,80,7.34,72,344,2400,12.2,0.1936804
19323,19323,Mike Prokopec,1996-97,22.0,2,0,9,9,0,0,0,5.0,,9,0,0,0,5.0,82,6.29,74,413,2481,10.4,0.17716289
19324,19324,Mike Prokopec,1997-98,23.0,3,0,6,6,0,0,0,2.0,,15,0,0,0,7.0,82,5.83,55,336,2444,9.8,0.15953043
19325,19325,Mike Ramsey,1980-81,20.0,2,7,13,13,1,6,7,17.0,,13,1,6,7,17.0,80,7.03,61,280,2352,12.0,0.34785104
19326,19326,Mike Ramsey,1981-82,21.0,3,17,72,72,3,14,17,72.0,,85,4,20,24,89.0,80,7.69,77,340,2441,12.6,0.34876868
19327,19327,Mike Ramsey,1982-83,22.0,4,30,80,80,7,23,30,94.0,,165,11,43,54,183.0,80,8.03,73,320,2489,12.9,0.4117212
19328,19328,Mike Ramsey,1983-84,23.0,5,38,77,77,8,30,38,117.0,,242,19,73,92,300.0,80,7.73,71,310,2444,12.7,0.47355527
19329,19329,Mike Ramsey,1984-85,24.0,6,31,72,72,9,22,31,135.0,,314,28,95,123,435.0,80,7.89,74,336,2448,12.9,0.46708018
19330,19330,Mike Ramsey,1985-86,25.0,7,30,79,79,8,22,30,161.0,,393,36,117,153,596.0,80,7.77,71,321,2447,12.7,0.46312907
19331,19331,Mike Ramsey,1986-87,26.0,8,28,76,76,7,21,28,154.0,,469,43,138,181,750.0,80,7.94,82,370,2484,12.8,0.42455363
19332,19332,Mike Ramsey,1987-88,27.0,9,39,80,80,8,31,39,156.0,,549,51,169,220,906.0,80,7.34,72,344,2400,12.2,0.47836497
19333,19333,Mike Ramsey,1988-89,28.0,10,21,63,63,5,16,21,94.0,,612,56,185,241,1000.0,80,7.43,89,437,2435,12.2,0.29722667
19334,19334,Mike Ramsey,1989-90,29.0,11,16,56,56,2,14,16,63.0,,668,58,199,257,1063.0,80,7.48,85,403,2430,12.3,0.2852966
19335,19335,Mike Ramsey,1990-91,30.0,12,25,73,73,4,21,25,91.0,,741,62,220,282,1154.0,80,7.37,76,367,2421,12.2,0.26454663
19336,19336,Mike Ramsey,1991-92,31.0,13,20,71,71,6,14,20,87.0,,812,68,234,302,1241.0,80,6.91,71,366,2385,11.6,0.2823462
19337,19337,Mike Ramsey,1992-93,32.0,14,17,66,66,3,14,17,55.0,,878,71,248,319,1296.0,80,6.96,77,402,2440,11.4,0.21403831
19338,19338,Mike Ramsey,1993-94,33.0,15,13,45,45,3,10,13,35.0,,923,74,258,332,1331.0,84,7.25,87,443,2603,11.7,0.18959597
19339,19339,Mike Ramsey,1994-95,34.0,16,4,65,65,2,2,4,31.0,,988,76,260,336,1362.0,84,6.48,76,407,2545,10.7,0.116624326
19340,19340,Mike Ramsey,1995-96,35.0,17,3,33,33,1,2,3,29.0,,1021,77,262,339,1391.0,48,5.97,37,209,1408,10.2,0.18777594
19341,19341,Mike Ramsey,1996-97,36.0,18,6,47,47,2,4,6,35.0,,1068,79,266,345,1426.0,82,6.29,74,413,2481,10.4,0.13657755
19342,19342,Mike Ramsey,1997-98,37.0,19,0,2,2,0,0,0,3.0,,1070,79,266,345,1429.0,82,5.83,55,336,2444,9.8,0.16356438
19343,19343,Mike Rathje,1994-95,20.0,2,10,47,47,1,9,10,30.0,,47,1,9,10,30.0,84,6.48,76,407,2545,10.7,0.23258325
19344,19344,Mike Rathje,1995-96,21.0,3,9,42,42,2,7,9,38.0,,89,3,16,19,68.0,48,5.97,37,209,1408,10.2,0.2580818
19345,19345,Mike Rathje,1996-97,22.0,4,7,27,27,0,7,7,26.0,,116,3,23,26,94.0,82,6.29,74,413,2481,10.4,0.24175626
19346,19346,Mike Rathje,1997-98,23.0,5,8,31,31,0,8,8,22.0,,147,3,31,34,116.0,82,5.83,55,336,2444,9.8,0.23427987
19347,19347,Mike Rathje,1998-99,24.0,6,15,81,81,3,12,15,61.0,,228,6,43,49,177.0,82,5.28,57,380,2242,9.6,0.20120767
19348,19348,Mike Rathje,1999-00,25.0,7,14,82,82,5,9,14,67.0,1650.0,310,11,52,63,244.0,82,5.27,57,359,2285,9.4,0.19262412
19349,19349,Mike Rathje,2000-01,26.0,8,16,66,66,2,14,16,46.0,1464.0,376,13,66,79,290.0,82,5.49,53,331,2294,9.8,0.2021656
19350,19350,Mike Rathje,2001-02,27.0,9,11,81,81,0,11,11,89.0,1809.0,457,13,77,90,379.0,82,5.51,63,376,2272,9.9,0.18541324
19351,19351,Mike Rathje,2002-03,28.0,10,17,52,52,5,12,17,56.0,1119.0,509,18,89,107,435.0,82,5.24,53,338,2262,9.5,0.2734596
19352,19352,Mike Rathje,2003-04,29.0,11,29,82,82,7,22,29,147.0,1977.0,591,25,111,136,582.0,82,5.31,60,363,2326,9.4,0.34549594
19353,19353,Mike Rathje,2004-05,30.0,12,19,80,80,2,17,19,105.0,1876.0,671,27,128,155,687.0,82,5.14,57,348,2300,9.2,0.25129533
19354,19354,Mike Rathje,2006-07,32.0,13,24,79,79,3,21,24,55.0,1590.0,750,30,149,179,742.0,82,6.05,85,480,2458,10.1,0.20034069
19355,19355,Mike Rathje,2007-08,33.0,14,1,18,18,0,1,1,13.0,375.0,768,30,150,180,755.0,82,5.76,70,398,2426,9.7,0.13799396
19356,19356,Mike Reilly,2016-17,23.0,2,7,29,29,1,6,7,27.0,350.0,29,1,6,7,27.0,82,5.34,48,255,2438,9.0,0.22514519
19357,19357,Mike Reilly,2017-18,24.0,3,1,17,17,1,0,1,19.0,210.0,46,2,6,8,46.0,82,5.45,47,245,2478,9.0,0.19092524
19358,19358,Mike Reilly,2018-19,25.0,4,18,57,57,2,16,18,65.0,853.0,103,4,22,26,111.0,82,5.86,50,250,2620,9.2,0.2752663
19359,19359,Mike Reilly,2019-20,26.0,5,11,57,57,3,8,11,101.0,1065.0,160,7,30,37,212.0,82,5.96,47,239,2579,9.5,0.23449197
19360,19360,Mike Reilly,2020-21,27.0,6,16,44,44,1,15,16,85.0,793.0,204,8,45,53,297.0,70,5.96,42,208,2192,9.5,0.30404454
19361,19361,Mike Ribeiro,2000-01,20.0,2,2,19,19,1,1,2,18.0,203.0,19,1,1,2,18.0,82,5.49,53,331,2294,9.8,0.21340987
19362,19362,Mike Ribeiro,2001-02,21.0,3,0,2,2,0,0,0,3.0,21.0,21,1,1,2,21.0,82,5.51,63,376,2272,9.9,0.19862014
19363,19363,Mike Ribeiro,2002-03,22.0,4,18,43,43,8,10,18,48.0,599.0,64,9,11,20,69.0,82,5.24,53,338,2262,9.5,0.35830426
19364,19364,Mike Ribeiro,2003-04,23.0,5,17,52,52,5,12,17,57.0,578.0,116,14,23,37,126.0,82,5.31,60,363,2326,9.4,0.33199254
19365,19365,Mike Ribeiro,2004-05,24.0,6,65,81,81,20,45,65,103.0,1384.0,197,34,68,102,229.0,82,5.14,57,348,2300,9.2,0.7811823
19366,19366,Mike Ribeiro,2006-07,26.0,7,51,79,79,16,35,51,130.0,1310.0,276,50,103,153,359.0,82,6.05,85,480,2458,10.1,0.602822
19367,19367,Mike Ribeiro,2007-08,27.0,8,59,81,81,18,41,59,111.0,1210.0,357,68,144,212,470.0,82,5.76,70,398,2426,9.7,0.67027605
19368,19368,Mike Ribeiro,2008-09,28.0,9,83,76,76,27,56,83,107.0,1400.0,433,95,200,295,577.0,82,5.44,62,351,2383,9.4,0.8791199
19369,19369,Mike Ribeiro,2009-10,29.0,10,78,82,82,22,56,78,163.0,1718.0,515,117,256,373,740.0,82,5.7,65,341,2477,9.4,0.826361
19370,19370,Mike Ribeiro,2010-11,30.0,11,53,66,66,19,34,53,155.0,1289.0,581,136,290,426,895.0,82,5.53,56,304,2486,9.1,0.6976258
19371,19371,Mike Ribeiro,2011-12,31.0,12,71,82,82,19,52,71,161.0,1637.0,663,155,342,497,1056.0,82,5.46,52,291,2492,9.0,0.7586371
19372,19372,Mike Ribeiro,2012-13,32.0,13,63,74,74,18,45,63,142.0,1484.0,737,173,387,560,1198.0,82,5.32,47,271,2439,8.9,0.7785777
19373,19373,Mike Ribeiro,2013-14,33.0,14,49,48,48,13,36,49,63.0,856.0,785,186,423,609,1261.0,48,5.31,29,160,1399,9.1,0.7404094
19374,19374,Mike Ribeiro,2014-15,34.0,15,47,80,80,16,31,47,110.0,1440.0,865,202,454,656,1371.0,82,5.34,48,269,2463,8.9,0.5605604
19375,19375,Mike Ribeiro,2015-16,35.0,16,62,82,82,15,47,62,96.0,1537.0,947,217,501,718,1467.0,82,5.32,47,251,2453,8.9,0.6379777
19376,19376,Mike Ribeiro,2016-17,36.0,17,50,81,81,7,43,50,76.0,1413.0,1028,224,544,768,1543.0,82,5.34,48,255,2438,9.0,0.50839216
19377,19377,Mike Ribeiro,2017-18,37.0,18,25,46,46,4,21,25,38.0,735.0,1074,228,565,793,1581.0,82,5.45,47,245,2478,9.0,0.3721509
19378,19378,Mike Ricci,1991-92,20.0,2,41,68,68,21,20,41,121.0,,68,21,20,41,121.0,80,6.91,71,366,2385,11.6,0.6229161
19379,19379,Mike Ricci,1992-93,21.0,3,56,78,78,20,36,56,149.0,,146,41,56,97,270.0,80,6.96,77,402,2440,11.4,0.78253067
19380,19380,Mike Ricci,1993-94,22.0,4,78,77,77,27,51,78,142.0,,223,68,107,175,412.0,84,7.25,87,443,2603,11.7,0.85278106
19381,19381,Mike Ricci,1994-95,23.0,5,51,83,83,30,21,51,138.0,,306,98,128,226,550.0,84,6.48,76,407,2545,10.7,0.68687713
19382,19382,Mike Ricci,1995-96,24.0,6,36,48,48,15,21,36,73.0,,354,113,149,262,623.0,48,5.97,37,209,1408,10.2,0.7018953
19383,19383,Mike Ricci,1996-97,25.0,7,27,62,62,6,21,27,73.0,,416,119,170,289,696.0,82,6.29,74,413,2481,10.4,0.4265141
19384,19384,Mike Ricci,1997-98,26.0,8,32,63,63,13,19,32,74.0,,479,132,189,321,770.0,82,5.83,55,336,2444,9.8,0.5053945
19385,19385,Mike Ricci,1998-99,27.0,9,27,65,65,9,18,27,91.0,,544,141,207,348,861.0,82,5.28,57,380,2242,9.6,0.4025033
19386,19386,Mike Ricci,1999-00,28.0,10,39,82,82,13,26,39,98.0,1261.0,626,154,233,387,959.0,82,5.27,57,359,2285,9.4,0.4841148
19387,19387,Mike Ricci,2000-01,29.0,11,44,82,82,20,24,44,134.0,1384.0,708,174,257,431,1093.0,82,5.49,53,331,2294,9.8,0.5267247
19388,19388,Mike Ricci,2001-02,30.0,12,44,81,81,22,22,44,141.0,1457.0,789,196,279,475,1234.0,82,5.51,63,376,2272,9.9,0.50036883
19389,19389,Mike Ricci,2002-03,31.0,13,53,79,79,19,34,53,115.0,1348.0,868,215,313,528,1349.0,82,5.24,53,338,2262,9.5,0.56284195
19390,19390,Mike Ricci,2003-04,32.0,14,34,75,75,11,23,34,101.0,1238.0,943,226,336,562,1450.0,82,5.31,60,363,2326,9.4,0.36283177
19391,19391,Mike Ricci,2004-05,33.0,15,26,71,71,7,19,26,48.0,1019.0,1014,233,355,588,1498.0,82,5.14,57,348,2300,9.2,0.3845481
19392,19392,Mike Ricci,2006-07,35.0,16,16,78,78,10,6,16,50.0,998.0,1092,243,361,604,1548.0,82,6.05,85,480,2458,10.1,0.21598548
19393,19393,Mike Ricci,2007-08,36.0,17,1,7,7,0,1,1,4.0,69.0,1099,243,362,605,1552.0,82,5.76,70,398,2426,9.7,0.20163766
19394,19394,Mike Richard,1988-89,22.0,2,0,4,4,0,0,0,5.0,,4,0,0,0,5.0,80,7.43,89,437,2435,12.2,0.24571395
19395,19395,Mike Richard,1990-91,24.0,3,2,3,3,0,2,2,5.0,,7,0,2,2,10.0,80,7.37,76,367,2421,12.2,0.23369804
19396,19396,Mike Richards,2006-07,21.0,2,34,79,79,11,23,34,168.0,1215.0,79,11,23,34,168.0,82,6.05,85,480,2458,10.1,0.48598173
19397,19397,Mike Richards,2007-08,22.0,3,32,59,59,10,22,32,130.0,1052.0,138,21,45,66,298.0,82,5.76,70,398,2426,9.7,0.5667337
19398,19398,Mike Richards,2008-09,23.0,4,75,73,73,28,47,75,212.0,1570.0,211,49,92,141,510.0,82,5.44,62,351,2383,9.4,0.9309609
19399,19399,Mike Richards,2009-10,24.0,5,80,79,79,30,50,80,238.0,1717.0,290,79,142,221,748.0,82,5.7,65,341,2477,9.4,0.9211137
19400,19400,Mike Richards,2010-11,25.0,6,62,82,82,31,31,62,237.0,1673.0,372,110,173,283,985.0,82,5.53,56,304,2486,9.1,0.71018445
19401,19401,Mike Richards,2011-12,26.0,7,66,81,81,23,43,66,184.0,1529.0,453,133,216,349,1169.0,82,5.46,52,291,2492,9.0,0.8117722
19402,19402,Mike Richards,2012-13,27.0,8,44,74,74,18,26,44,171.0,1398.0,527,151,242,393,1340.0,82,5.32,47,271,2439,8.9,0.62590307
19403,19403,Mike Richards,2013-14,28.0,9,32,48,48,12,20,32,82.0,785.0,575,163,262,425,1422.0,48,5.31,29,160,1399,9.1,0.60685754
19404,19404,Mike Richards,2014-15,29.0,10,41,82,82,11,30,41,157.0,1392.0,657,174,292,466,1579.0,82,5.34,48,269,2463,8.9,0.5004281
19405,19405,Mike Richards,2015-16,30.0,11,16,53,53,5,11,16,63.0,708.0,710,179,303,482,1642.0,82,5.32,47,251,2453,8.9,0.41181457
19406,19406,Mike Richards,2016-17,31.0,12,5,39,39,2,3,5,46.0,475.0,749,181,306,487,1688.0,82,5.34,48,255,2438,9.0,0.30415726
19407,19407,Mike Ridley,1986-87,23.0,2,65,80,80,22,43,65,150.0,,80,22,43,65,150.0,80,7.94,82,370,2484,12.8,0.73692894
19408,19408,Mike Ridley,1987-88,24.0,3,70,78,78,31,39,70,149.0,,158,53,82,135,299.0,80,7.34,72,344,2400,12.2,0.8801868
19409,19409,Mike Ridley,1988-89,25.0,4,59,70,70,28,31,59,134.0,,228,81,113,194,433.0,80,7.43,89,437,2435,12.2,0.83096963
19410,19410,Mike Ridley,1989-90,26.0,5,89,80,80,41,48,89,187.0,,308,122,161,283,620.0,80,7.48,85,403,2430,12.3,1.0278525
19411,19411,Mike Ridley,1990-91,27.0,6,73,74,74,30,43,73,124.0,,382,152,204,356,744.0,80,7.37,76,367,2421,12.2,0.8108295
19412,19412,Mike Ridley,1991-92,28.0,7,71,79,79,23,48,71,155.0,,461,175,252,427,899.0,80,6.91,71,366,2385,11.6,0.85538274
19413,19413,Mike Ridley,1992-93,29.0,8,69,80,80,29,40,69,123.0,,541,204,292,496,1022.0,80,6.96,77,402,2440,11.4,0.8246418
19414,19414,Mike Ridley,1993-94,30.0,9,82,84,84,26,56,82,148.0,,625,230,348,578,1170.0,84,7.25,87,443,2603,11.7,0.7922789
19415,19415,Mike Ridley,1994-95,31.0,10,70,81,81,26,44,70,144.0,,706,256,392,648,1314.0,84,6.48,76,407,2545,10.7,0.7659544
19416,19416,Mike Ridley,1995-96,32.0,11,37,48,48,10,27,37,88.0,,754,266,419,685,1402.0,48,5.97,37,209,1408,10.2,0.69025433
19417,19417,Mike Ridley,1996-97,33.0,12,21,37,37,6,15,21,32.0,,791,272,434,706,1434.0,82,6.29,74,413,2481,10.4,0.49836758
19418,19418,Mike Ridley,1997-98,34.0,13,52,75,75,20,32,52,79.0,,866,292,466,758,1513.0,82,5.83,55,336,2444,9.8,0.56883013
19419,19419,Mike Rogers,1980-81,26.0,2,105,80,80,44,61,105,229.0,,80,44,61,105,229.0,80,7.03,61,280,2352,12.0,1.2644948
19420,19420,Mike Rogers,1981-82,27.0,3,105,80,80,40,65,105,242.0,,160,84,126,210,471.0,80,7.69,77,340,2441,12.6,1.2381294
19421,19421,Mike Rogers,1982-83,28.0,4,103,80,80,38,65,103,213.0,,240,122,191,313,684.0,80,8.03,73,320,2489,12.9,1.174253
19422,19422,Mike Rogers,1983-84,29.0,5,76,71,71,29,47,76,200.0,,311,151,238,389,884.0,80,7.73,71,310,2444,12.7,0.9480495
19423,19423,Mike Rogers,1984-85,30.0,6,61,78,78,23,38,61,186.0,,389,174,276,450,1070.0,80,7.89,74,336,2448,12.9,0.81039107
19424,19424,Mike Rogers,1985-86,31.0,7,64,78,78,26,38,64,145.0,,467,200,314,514,1215.0,80,7.77,71,321,2447,12.7,0.7603921
19425,19425,Mike Rogers,1986-87,32.0,8,5,17,17,2,3,5,25.0,,484,202,317,519,1240.0,80,7.94,82,370,2484,12.8,0.60412407
19426,19426,Mike Rowe,1985-86,20.0,2,0,6,6,0,0,0,6.0,,6,0,0,0,6.0,80,7.77,71,321,2447,12.7,0.2803325
19427,19427,Mike Rowe,1986-87,21.0,3,0,3,3,0,0,0,5.0,,9,0,0,0,11.0,80,7.94,82,370,2484,12.8,0.21737662
19428,19428,Mike Rowe,1987-88,22.0,4,0,2,2,0,0,0,1.0,,11,0,0,0,12.0,80,7.34,72,344,2400,12.2,0.21442682
19429,19429,Mike Rucinski,1989-90,26.0,2,0,1,1,0,0,0,0.0,,1,0,0,0,0.0,80,7.48,85,403,2430,12.3,0.1660105
19430,19430,Mike Rucinski0,1998-99,23.0,2,1,9,9,0,1,1,3.0,,9,0,1,1,3.0,82,5.28,57,380,2242,9.6,0.19269377
19431,19431,Mike Rucinski0,1999-00,24.0,3,1,15,15,0,1,1,8.0,157.0,24,0,2,2,11.0,82,5.27,57,359,2285,9.4,0.15451437
19432,19432,Mike Rucinski0,2001-02,26.0,4,0,2,2,0,0,0,2.0,27.0,26,0,2,2,13.0,82,5.51,63,376,2272,9.9,0.14502591
19433,19433,Mike Rupp,2003-04,24.0,2,8,26,26,5,3,8,34.0,303.0,26,5,3,8,34.0,82,5.31,60,363,2326,9.4,0.27233678
19434,19434,Mike Rupp,2004-05,25.0,3,12,57,57,6,6,12,76.0,645.0,83,11,9,20,110.0,82,5.14,57,348,2300,9.2,0.25828832
19435,19435,Mike Rupp,2006-07,27.0,4,6,40,40,4,2,6,39.0,360.0,123,15,11,26,149.0,82,6.05,85,480,2458,10.1,0.15632257
19436,19436,Mike Rupp,2007-08,28.0,5,9,76,76,6,3,9,60.0,490.0,199,21,14,35,209.0,82,5.76,70,398,2426,9.7,0.1760355
19437,19437,Mike Rupp,2008-09,29.0,6,9,64,64,3,6,9,69.0,516.0,263,24,20,44,278.0,82,5.44,62,351,2383,9.4,0.18246302
19438,19438,Mike Rupp,2009-10,30.0,7,9,72,72,3,6,9,76.0,628.0,335,27,26,53,354.0,82,5.7,65,341,2477,9.4,0.16137531
19439,19439,Mike Rupp,2010-11,31.0,8,19,81,81,13,6,19,87.0,732.0,416,40,32,72,441.0,82,5.53,56,304,2486,9.1,0.22562242
19440,19440,Mike Rupp,2011-12,32.0,9,17,81,81,9,8,17,81.0,814.0,497,49,40,89,522.0,82,5.46,52,291,2492,9.0,0.21018076
19441,19441,Mike Rupp,2012-13,33.0,10,5,60,60,4,1,5,31.0,399.0,557,53,41,94,553.0,82,5.32,47,271,2439,8.9,0.111242056
19442,19442,Mike Rupp,2013-14,34.0,11,4,40,40,1,3,4,29.0,334.0,597,54,44,98,582.0,48,5.31,29,160,1399,9.1,0.11946455
19443,19443,Mike Rupp,2014-15,35.0,12,1,13,13,0,1,1,6.0,81.0,610,54,45,99,588.0,82,5.34,48,269,2463,8.9,0.14514574
19444,19444,Mike Santorelli,2009-10,24.0,2,0,7,7,0,0,0,11.0,86.0,7,0,0,0,11.0,82,5.7,65,341,2477,9.4,0.18105423
19445,19445,Mike Santorelli,2010-11,25.0,3,3,25,25,2,1,3,36.0,274.0,32,2,1,3,47.0,82,5.53,56,304,2486,9.1,0.20740154
19446,19446,Mike Santorelli,2011-12,26.0,4,41,82,82,20,21,41,193.0,1368.0,114,22,22,44,240.0,82,5.46,52,291,2492,9.0,0.5215279
19447,19447,Mike Santorelli,2012-13,27.0,5,11,60,60,9,2,11,117.0,744.0,174,31,24,55,357.0,82,5.32,47,271,2439,8.9,0.23910534
19448,19448,Mike Santorelli,2013-14,28.0,6,4,34,34,2,2,4,35.0,403.0,208,33,26,59,392.0,48,5.31,29,160,1399,9.1,0.20849279
19449,19449,Mike Santorelli,2014-15,29.0,7,28,49,49,10,18,28,91.0,910.0,257,43,44,87,483.0,82,5.34,48,269,2463,8.9,0.38985342
19450,19450,Mike Santorelli,2015-16,30.0,8,33,79,79,12,21,33,145.0,1137.0,336,55,65,120,628.0,82,5.32,47,251,2453,8.9,0.37223473
19451,19451,Mike Santorelli,2016-17,31.0,9,18,70,70,9,9,18,81.0,706.0,406,64,74,138,709.0,82,5.34,48,255,2438,9.0,0.262698
19452,19452,Mike Siklenka,2003-04,24.0,2,0,1,1,0,0,0,1.0,4.0,1,0,0,0,1.0,82,5.31,60,363,2326,9.4,0.1768949
19453,19453,Mike Siklenka,2004-05,25.0,3,0,1,1,0,0,0,0.0,2.0,2,0,0,0,1.0,82,5.14,57,348,2300,9.2,0.15516764
19454,19454,Mike Sillinger,1991-92,20.0,2,1,3,3,0,1,1,6.0,,3,0,1,1,6.0,80,6.91,71,366,2385,11.6,0.28413337
19455,19455,Mike Sillinger,1993-94,22.0,3,21,51,51,4,17,21,47.0,,54,4,18,22,53.0,84,7.25,87,443,2603,11.7,0.35405946
19456,19456,Mike Sillinger,1994-95,23.0,4,29,62,62,8,21,29,91.0,,116,12,39,51,144.0,84,6.48,76,407,2545,10.7,0.42575267
19457,19457,Mike Sillinger,1995-96,24.0,5,15,28,28,4,11,15,39.0,,144,16,50,66,183.0,48,5.97,37,209,1408,10.2,0.40133032
19458,19458,Mike Sillinger,1996-97,25.0,6,38,74,74,14,24,38,159.0,,218,30,74,104,342.0,82,6.29,74,413,2481,10.4,0.49875802
19459,19459,Mike Sillinger,1997-98,26.0,7,37,78,78,17,20,37,112.0,,296,47,94,141,454.0,82,5.83,55,336,2444,9.8,0.46323618
19460,19460,Mike Sillinger,1998-99,27.0,8,41,75,75,21,20,41,96.0,,371,68,114,182,550.0,82,5.28,57,380,2242,9.6,0.5115736
19461,19461,Mike Sillinger,1999-00,28.0,9,13,79,79,8,5,13,92.0,1021.0,450,76,119,195,642.0,82,5.27,57,359,2285,9.4,0.2942703
19462,19462,Mike Sillinger,2000-01,29.0,10,52,80,80,23,29,52,146.0,1574.0,530,99,148,247,788.0,82,5.49,53,331,2294,9.8,0.55889785
19463,19463,Mike Sillinger,2001-02,30.0,11,41,68,68,16,25,41,119.0,1227.0,598,115,173,288,907.0,82,5.51,63,376,2272,9.9,0.48673144
19464,19464,Mike Sillinger,2002-03,31.0,12,43,80,80,20,23,43,150.0,1668.0,678,135,196,331,1057.0,82,5.24,53,338,2262,9.5,0.5044496
19465,19465,Mike Sillinger,2003-04,32.0,13,43,75,75,18,25,43,128.0,1435.0,753,153,221,374,1185.0,82,5.31,60,363,2326,9.4,0.47765464
19466,19466,Mike Sillinger,2004-05,33.0,14,24,76,76,13,11,24,106.0,1244.0,829,166,232,398,1291.0,82,5.14,57,348,2300,9.2,0.45576
19467,19467,Mike Sillinger,2006-07,35.0,15,63,79,79,32,31,63,211.0,1520.0,908,198,263,461,1502.0,82,6.05,85,480,2458,10.1,0.637862
19468,19468,Mike Sillinger,2007-08,36.0,16,59,82,82,26,33,59,152.0,1584.0,990,224,296,520,1654.0,82,5.76,70,398,2426,9.7,0.55078614
19469,19469,Mike Sillinger,2008-09,37.0,17,26,52,52,14,12,26,94.0,968.0,1042,238,308,546,1748.0,82,5.44,62,351,2383,9.4,0.46525326
19470,19470,Mike Sillinger,2009-10,38.0,18,2,7,7,2,0,2,14.0,99.0,1049,240,308,548,1762.0,82,5.7,65,341,2477,9.4,0.2705505
19471,19471,Mike Siltala,1982-83,19.0,2,1,3,3,1,0,1,2.0,,3,1,0,1,2.0,80,8.03,73,320,2489,12.9,0.31028783
19472,19472,Mike Siltala,1987-88,24.0,3,0,1,1,0,0,0,0.0,,4,1,0,1,2.0,80,7.34,72,344,2400,12.2,0.20174298
19473,19473,Mike Siltala,1988-89,25.0,4,0,3,3,0,0,0,3.0,,7,1,0,1,5.0,80,7.43,89,437,2435,12.2,0.20801342
19474,19474,Mike Sislo,2014-15,27.0,2,0,14,14,0,0,0,20.0,124.0,14,0,0,0,20.0,82,5.34,48,269,2463,8.9,0.190638
19475,19475,Mike Sislo,2015-16,28.0,3,1,10,10,0,1,1,13.0,122.0,24,0,1,1,33.0,82,5.32,47,251,2453,8.9,0.16906416
19476,19476,Mike Sislo,2016-17,29.0,4,4,18,18,3,1,4,29.0,224.0,42,3,2,5,62.0,82,5.34,48,255,2438,9.0,0.20436257
19477,19477,Mike Stapleton,1987-88,21.0,2,9,39,39,3,6,9,56.0,,39,3,6,9,56.0,80,7.34,72,344,2400,12.2,0.3133426
19478,19478,Mike Stapleton,1988-89,22.0,3,11,53,53,2,9,11,50.0,,92,5,15,20,106.0,80,7.43,89,437,2435,12.2,0.28877068
19479,19479,Mike Stapleton,1989-90,23.0,4,1,7,7,0,1,1,6.0,,99,5,16,21,112.0,80,7.48,85,403,2430,12.3,0.24343184
19480,19480,Mike Stapleton,1991-92,25.0,5,1,7,7,0,1,1,6.0,,106,5,17,22,118.0,80,6.91,71,366,2385,11.6,0.21256816
19481,19481,Mike Stapleton,1992-93,26.0,6,8,19,19,4,4,8,32.0,,125,9,21,30,150.0,80,6.96,77,402,2440,11.4,0.30416906
19482,19482,Mike Stapleton,1993-94,27.0,7,13,78,78,4,9,13,78.0,,203,13,30,43,228.0,84,7.25,87,443,2603,11.7,0.18257076
19483,19483,Mike Stapleton,1994-95,28.0,8,25,81,81,12,13,25,102.0,,284,25,43,68,330.0,84,6.48,76,407,2545,10.7,0.27436095
19484,19484,Mike Stapleton,1995-96,29.0,9,17,46,46,6,11,17,59.0,,330,31,54,85,389.0,48,5.97,37,209,1408,10.2,0.3109479
19485,19485,Mike Stapleton,1996-97,30.0,10,24,58,58,10,14,24,91.0,,388,41,68,109,480.0,82,6.29,74,413,2481,10.4,0.30042621
19486,19486,Mike Stapleton,1997-98,31.0,11,15,55,55,4,11,15,74.0,,443,45,79,124,554.0,82,5.83,55,336,2444,9.8,0.2160007
19487,19487,Mike Stapleton,1998-99,32.0,12,10,64,64,5,5,10,69.0,,507,50,84,134,623.0,82,5.28,57,380,2242,9.6,0.17632821
19488,19488,Mike Stapleton,1999-00,33.0,13,18,76,76,9,9,18,106.0,1039.0,583,59,93,152,729.0,82,5.27,57,359,2285,9.4,0.24339056
19489,19489,Mike Stapleton,2000-01,34.0,14,22,62,62,10,12,22,146.0,1073.0,645,69,105,174,875.0,82,5.49,53,331,2294,9.8,0.31003982
19490,19490,Mike Stapleton,2001-02,35.0,15,8,52,52,2,6,8,31.0,491.0,697,71,111,182,906.0,82,5.51,63,376,2272,9.9,0.118510306
19491,19491,Mike Stevens,1985-86,20.0,2,3,6,6,0,3,3,10.0,,6,0,3,3,10.0,80,7.77,71,321,2447,12.7,0.3253073
19492,19492,Mike Stevens,1988-89,23.0,3,1,7,7,0,1,1,5.0,,13,0,4,4,15.0,80,7.43,89,437,2435,12.2,0.21865442
19493,19493,Mike Stevens,1989-90,24.0,4,1,9,9,1,0,1,9.0,,22,1,4,5,24.0,80,7.48,85,403,2430,12.3,0.22686204
19494,19494,Mike Stevens,1990-91,25.0,5,0,1,1,0,0,0,2.0,,23,1,4,5,26.0,80,7.37,76,367,2421,12.2,0.18935695
19495,19495,Mike Stothers,1985-86,23.0,2,0,1,1,0,0,0,0.0,,1,0,0,0,0.0,80,7.77,71,321,2447,12.7,0.19256687
19496,19496,Mike Stothers,1986-87,24.0,3,1,6,6,0,1,1,1.0,,7,0,1,1,1.0,80,7.94,82,370,2484,12.8,0.21035871
19497,19497,Mike Stothers,1987-88,25.0,4,0,2,2,0,0,0,2.0,,9,0,1,1,3.0,80,7.34,72,344,2400,12.2,0.19204271
19498,19498,Mike Stothers,1988-89,26.0,5,1,21,21,0,1,1,0.0,,30,0,2,2,3.0,80,7.43,89,437,2435,12.2,0.15547407
19499,19499,Mike Stuart,2004-05,24.0,2,0,2,2,0,0,0,0.0,19.0,2,0,0,0,0.0,82,5.14,57,348,2300,9.2,0.19176829
19500,19500,Mike Stuart,2006-07,26.0,3,0,1,1,0,0,0,1.0,13.0,3,0,0,0,1.0,82,6.05,85,480,2458,10.1,0.15564412
19501,19501,Mike Stutzel,2004-05,25.0,2,0,9,9,0,0,0,3.0,52.0,9,0,0,0,3.0,82,5.14,57,348,2300,9.2,0.1864537
19502,19502,Mike Sullivan,1992-93,24.0,2,19,64,64,8,11,19,72.0,,64,8,11,19,72.0,80,6.96,77,402,2440,11.4,0.3156342
19503,19503,Mike Sullivan,1993-94,25.0,3,14,81,81,6,8,14,95.0,,145,14,19,33,167.0,84,7.25,87,443,2603,11.7,0.22055751
19504,19504,Mike Sullivan,1994-95,26.0,4,9,45,45,4,5,9,48.0,,190,18,24,42,215.0,84,6.48,76,407,2545,10.7,0.19073522
19505,19505,Mike Sullivan,1995-96,27.0,5,11,38,38,4,7,11,31.0,,228,22,31,53,246.0,48,5.97,37,209,1408,10.2,0.2701323
19506,19506,Mike Sullivan,1996-97,28.0,6,21,81,81,9,12,21,106.0,,309,31,43,74,352.0,82,6.29,74,413,2481,10.4,0.24277303
19507,19507,Mike Sullivan,1997-98,29.0,7,11,67,67,5,6,11,64.0,,376,36,49,85,416.0,82,5.83,55,336,2444,9.8,0.18086505
19508,19508,Mike Sullivan,1998-99,30.0,8,18,77,77,5,13,18,83.0,,453,41,62,103,499.0,82,5.28,57,380,2242,9.6,0.23175177
19509,19509,Mike Sullivan,1999-00,31.0,9,6,63,63,2,4,6,66.0,765.0,516,43,66,109,565.0,82,5.27,57,359,2285,9.4,0.18160099
19510,19510,Mike Sullivan,2000-01,32.0,10,15,79,79,5,10,15,59.0,916.0,595,48,76,124,624.0,82,5.49,53,331,2294,9.8,0.18559316
19511,19511,Mike Sullivan,2001-02,33.0,11,9,72,72,5,4,9,59.0,922.0,667,53,80,133,683.0,82,5.51,63,376,2272,9.9,0.1544486
19512,19512,Mike Sullivan,2002-03,34.0,12,3,42,42,1,2,3,28.0,459.0,709,54,82,136,711.0,82,5.24,53,338,2262,9.5,0.121118486
19513,19513,Mike Toal,1980-81,21.0,2,0,3,3,0,0,0,1.0,,3,0,0,0,1.0,80,7.03,61,280,2352,12.0,0.2405884
19514,19514,Mike Tomlak,1990-91,26.0,2,21,70,70,7,14,21,64.0,,70,7,14,21,64.0,80,7.37,76,367,2421,12.2,0.26787958
19515,19515,Mike Tomlak,1991-92,27.0,3,16,64,64,8,8,16,69.0,,134,15,22,37,133.0,80,6.91,71,366,2385,11.6,0.23881039
19516,19516,Mike Tomlak,1992-93,28.0,4,0,6,6,0,0,0,10.0,,140,15,22,37,143.0,80,6.96,77,402,2440,11.4,0.19233626
19517,19517,Mike Tomlak,1994-95,30.0,5,0,1,1,0,0,0,2.0,,141,15,22,37,145.0,84,6.48,76,407,2545,10.7,0.13386992
19518,19518,Mike Van Ryn,2001-02,22.0,2,0,1,1,0,0,0,1.0,14.0,1,0,0,0,1.0,82,5.51,63,376,2272,9.9,0.1682556
19519,19519,Mike Van Ryn,2002-03,23.0,3,10,48,48,2,8,10,52.0,786.0,49,2,8,10,53.0,82,5.24,53,338,2262,9.5,0.23733702
19520,19520,Mike Van Ryn,2003-04,24.0,4,3,20,20,0,3,3,21.0,301.0,69,2,11,13,74.0,82,5.31,60,363,2326,9.4,0.17638934
19521,19521,Mike Van Ryn,2004-05,25.0,5,37,79,79,13,24,37,136.0,1931.0,148,15,35,50,210.0,82,5.14,57,348,2300,9.2,0.53853285
19522,19522,Mike Van Ryn,2006-07,27.0,6,37,80,80,8,29,37,154.0,1808.0,228,23,64,87,364.0,82,6.05,85,480,2458,10.1,0.44978288
19523,19523,Mike Van Ryn,2007-08,28.0,7,29,78,78,4,25,29,121.0,1649.0,306,27,89,116,485.0,82,5.76,70,398,2426,9.7,0.348858
19524,19524,Mike Van Ryn,2008-09,29.0,8,2,20,20,0,2,2,16.0,356.0,326,27,91,118,501.0,82,5.44,62,351,2383,9.4,0.20748115
19525,19525,Mike Van Ryn,2009-10,30.0,9,11,27,27,3,8,11,53.0,530.0,353,30,99,129,554.0,82,5.7,65,341,2477,9.4,0.28420824
19526,19526,Mike Vecchione,2017-18,24.0,2,0,2,2,0,0,0,1.0,17.0,2,0,0,0,1.0,82,5.45,47,245,2478,9.0,0.17658868
19527,19527,Mike Vellucci,1988-89,22.0,2,0,2,2,0,0,0,2.0,,2,0,0,0,2.0,80,7.43,89,437,2435,12.2,0.2297894
19528,19528,Mike Vernace,2009-10,23.0,2,0,12,12,0,0,0,9.0,236.0,12,0,0,0,9.0,82,5.7,65,341,2477,9.4,0.17565197
19529,19529,Mike Vernace,2011-12,25.0,3,1,10,10,0,1,1,6.0,87.0,22,0,1,1,15.0,82,5.46,52,291,2492,9.0,0.15407231
19530,19530,Mike Walsh,1988-89,26.0,2,0,1,1,0,0,0,2.0,,1,0,0,0,2.0,80,7.43,89,437,2435,12.2,0.2184487
19531,19531,Mike Walsh,1989-90,27.0,3,2,13,13,2,0,2,11.0,,14,2,0,2,13.0,80,7.48,85,403,2430,12.3,0.28119525
19532,19532,Mike Watt,1998-99,22.0,2,3,14,14,1,2,3,14.0,,14,1,2,3,14.0,82,5.28,57,380,2242,9.6,0.22557828
19533,19533,Mike Watt,1999-00,23.0,3,25,75,75,8,17,25,75.0,844.0,89,9,19,28,89.0,82,5.27,57,359,2285,9.4,0.36944246
19534,19534,Mike Watt,2000-01,24.0,4,11,45,45,5,6,11,49.0,541.0,134,14,25,39,138.0,82,5.49,53,331,2294,9.8,0.2368682
19535,19535,Mike Watt,2001-02,25.0,5,2,18,18,1,1,2,18.0,199.0,152,15,26,41,156.0,82,5.51,63,376,2272,9.9,0.1803017
19536,19536,Mike Watt,2003-04,27.0,6,0,5,5,0,0,0,2.0,38.0,157,15,26,41,158.0,82,5.31,60,363,2326,9.4,0.13958919
19537,19537,Mike Weaver,2002-03,24.0,2,1,16,16,0,1,1,9.0,222.0,16,0,1,1,9.0,82,5.24,53,338,2262,9.5,0.16375425
19538,19538,Mike Weaver,2003-04,25.0,3,5,40,40,0,5,5,21.0,745.0,56,0,6,6,30.0,82,5.31,60,363,2326,9.4,0.11019269
19539,19539,Mike Weaver,2004-05,26.0,4,0,1,1,0,0,0,0.0,8.0,57,0,6,6,30.0,82,5.14,57,348,2300,9.2,0.1636324
19540,19540,Mike Weaver,2006-07,28.0,5,9,53,53,0,9,9,21.0,798.0,110,0,15,15,51.0,82,6.05,85,480,2458,10.1,0.110926956
19541,19541,Mike Weaver,2007-08,29.0,6,9,39,39,3,6,9,22.0,598.0,149,3,21,24,73.0,82,5.76,70,398,2426,9.7,0.13793859
19542,19542,Mike Weaver,2008-09,30.0,7,1,55,55,0,1,1,33.0,771.0,204,3,22,25,106.0,82,5.44,62,351,2383,9.4,0.102383286
19543,19543,Mike Weaver,2009-10,31.0,8,7,58,58,0,7,7,36.0,1001.0,262,3,29,32,142.0,82,5.7,65,341,2477,9.4,0.1109305
19544,19544,Mike Weaver,2010-11,32.0,9,10,77,77,1,9,10,33.0,1306.0,339,4,38,42,175.0,82,5.53,56,304,2486,9.1,0.11845043
19545,19545,Mike Weaver,2011-12,33.0,10,13,82,82,2,11,13,53.0,1706.0,421,6,49,55,228.0,82,5.46,52,291,2492,9.0,0.13830414
19546,19546,Mike Weaver,2012-13,34.0,11,16,82,82,0,16,16,51.0,1667.0,503,6,65,71,279.0,82,5.32,47,271,2439,8.9,0.15141967
19547,19547,Mike Weaver,2013-14,35.0,12,9,27,27,1,8,9,21.0,544.0,530,7,73,80,300.0,48,5.31,29,160,1399,9.1,0.16744995
19548,19548,Mike Weaver,2014-15,36.0,13,13,72,72,1,12,13,53.0,1331.0,602,8,85,93,353.0,82,5.34,48,269,2463,8.9,0.12717628
19549,19549,Mike Weaver,2015-16,37.0,14,4,31,31,0,4,4,8.0,439.0,633,8,89,97,361.0,82,5.32,47,251,2453,8.9,0.093585074
19550,19550,Mike Weber,2008-09,21.0,2,3,16,16,0,3,3,12.0,267.0,16,0,3,3,12.0,82,5.44,62,351,2383,9.4,0.23501998
19551,19551,Mike Weber,2009-10,22.0,3,0,7,7,0,0,0,2.0,99.0,23,0,3,3,14.0,82,5.7,65,341,2477,9.4,0.14804745
19552,19552,Mike Weber,2011-12,24.0,4,17,58,58,4,13,17,53.0,980.0,81,4,16,20,67.0,82,5.46,52,291,2492,9.0,0.22172844
19553,19553,Mike Weber,2012-13,25.0,5,5,51,51,1,4,5,51.0,947.0,132,5,20,25,118.0,82,5.32,47,271,2439,8.9,0.14864513
19554,19554,Mike Weber,2013-14,26.0,6,7,42,42,1,6,7,25.0,771.0,174,6,26,32,143.0,48,5.31,29,160,1399,9.1,0.14555824
19555,19555,Mike Weber,2014-15,27.0,7,9,68,68,1,8,9,47.0,1212.0,242,7,34,41,190.0,82,5.34,48,269,2463,8.9,0.13035962
19556,19556,Mike Weber,2015-16,28.0,8,7,64,64,1,6,7,41.0,1200.0,306,8,40,48,231.0,82,5.32,47,251,2453,8.9,0.12932524
19557,19557,Mike Weber,2016-17,29.0,9,5,45,45,1,4,5,40.0,697.0,351,9,44,53,271.0,82,5.34,48,255,2438,9.0,0.13227388
19558,19558,Mike Wilson,1996-97,21.0,2,12,58,58,4,8,12,52.0,,58,4,8,12,52.0,82,6.29,74,413,2481,10.4,0.2532729
19559,19559,Mike Wilson,1997-98,22.0,3,11,77,77,2,9,11,57.0,,135,6,17,23,109.0,82,5.83,55,336,2444,9.8,0.19479409
19560,19560,Mike Wilson,1998-99,23.0,4,8,66,66,4,4,8,52.0,,201,10,21,31,161.0,82,5.28,57,380,2242,9.6,0.19946158
19561,19561,Mike Wilson,1999-00,24.0,5,3,34,34,1,2,3,48.0,578.0,235,11,23,34,209.0,82,5.27,57,359,2285,9.4,0.20952913
19562,19562,Mike Wilson,2000-01,25.0,6,20,60,60,4,16,20,65.0,1087.0,295,15,39,54,274.0,82,5.49,53,331,2294,9.8,0.2516704
19563,19563,Mike Wilson,2001-02,26.0,7,1,19,19,0,1,1,26.0,253.0,314,15,40,55,300.0,82,5.51,63,376,2272,9.9,0.17667934
19564,19564,Mike Wilson,2002-03,27.0,8,2,21,21,1,1,2,14.0,312.0,335,16,41,57,314.0,82,5.24,53,338,2262,9.5,0.1230658
19565,19565,Mike Wilson,2003-04,28.0,9,0,1,1,0,0,0,0.0,13.0,336,16,41,57,314.0,82,5.31,60,363,2326,9.4,0.18749446
19566,19566,Mike York,2000-01,23.0,2,50,82,82,26,24,50,177.0,1299.0,82,26,24,50,177.0,82,5.49,53,331,2294,9.8,0.6350564
19567,19567,Mike York,2001-02,24.0,3,31,79,79,14,17,31,171.0,1403.0,161,40,41,81,348.0,82,5.51,63,376,2272,9.9,0.5020812
19568,19568,Mike York,2002-03,25.0,4,61,81,81,20,41,61,218.0,1607.0,242,60,82,142,566.0,82,5.24,53,338,2262,9.5,0.7211698
19569,19569,Mike York,2003-04,26.0,5,51,71,71,22,29,51,177.0,1354.0,313,82,111,193,743.0,82,5.31,60,363,2326,9.4,0.68118644
19570,19570,Mike York,2004-05,27.0,6,42,61,61,16,26,42,144.0,1176.0,374,98,137,235,887.0,82,5.14,57,348,2300,9.2,0.7407085
19571,19571,Mike York,2006-07,29.0,7,52,75,75,13,39,52,146.0,1493.0,449,111,176,287,1033.0,82,6.05,85,480,2458,10.1,0.57877153
19572,19572,Mike York,2007-08,30.0,8,21,66,66,10,11,21,87.0,825.0,515,121,187,308,1120.0,82,5.76,70,398,2426,9.7,0.3441538
19573,19573,Mike York,2008-09,31.0,9,14,63,63,6,8,14,85.0,755.0,578,127,195,322,1205.0,82,5.44,62,351,2383,9.4,0.26318672
19574,19574,Mike York,2009-10,32.0,10,0,1,1,0,0,0,1.0,13.0,579,127,195,322,1206.0,82,5.7,65,341,2477,9.4,0.3231038
19575,19575,Mike Zigomanis,2003-04,23.0,2,3,19,19,2,1,3,19.0,185.0,19,2,1,3,19.0,82,5.31,60,363,2326,9.4,0.2198332
19576,19576,Mike Zigomanis,2004-05,24.0,3,3,17,17,0,3,3,13.0,146.0,36,2,4,6,32.0,82,5.14,57,348,2300,9.2,0.20112815
19577,19577,Mike Zigomanis,2006-07,26.0,4,1,23,23,1,0,1,17.0,213.0,59,3,4,7,49.0,82,6.05,85,480,2458,10.1,0.14188597
19578,19578,Mike Zigomanis,2007-08,27.0,5,23,75,75,14,9,23,142.0,1116.0,134,17,13,30,191.0,82,5.76,70,398,2426,9.7,0.2922206
19579,19579,Mike Zigomanis,2008-09,28.0,6,3,33,33,2,1,3,35.0,409.0,167,19,14,33,226.0,82,5.44,62,351,2383,9.4,0.19781974
19580,19580,Mike Zigomanis,2009-10,29.0,7,6,22,22,2,4,6,23.0,251.0,189,21,18,39,249.0,82,5.7,65,341,2477,9.4,0.21133634
19581,19581,Mike Zigomanis,2011-12,31.0,8,1,8,8,0,1,1,7.0,56.0,197,21,19,40,256.0,82,5.46,52,291,2492,9.0,0.14985448
19582,19582,Mikhail Grabovski,2007-08,24.0,2,0,3,3,0,0,0,5.0,40.0,3,0,0,0,5.0,82,5.76,70,398,2426,9.7,0.1724348
19583,19583,Mikhail Grabovski,2008-09,25.0,3,9,24,24,3,6,9,23.0,269.0,27,3,6,9,28.0,82,5.44,62,351,2383,9.4,0.24192727
19584,19584,Mikhail Grabovski,2009-10,26.0,4,48,78,78,20,28,48,120.0,1265.0,105,23,34,57,148.0,82,5.7,65,341,2477,9.4,0.5246511
19585,19585,Mikhail Grabovski,2010-11,27.0,5,35,59,59,10,25,35,126.0,991.0,164,33,59,92,274.0,82,5.53,56,304,2486,9.1,0.49019384
19586,19586,Mikhail Grabovski,2011-12,28.0,6,58,81,81,29,29,58,239.0,1568.0,245,62,88,150,513.0,82,5.46,52,291,2492,9.0,0.6599736
19587,19587,Mikhail Grabovski,2012-13,29.0,7,51,74,74,23,28,51,163.0,1303.0,319,85,116,201,676.0,82,5.32,47,271,2439,8.9,0.5664613
19588,19588,Mikhail Grabovski,2013-14,30.0,8,16,48,48,9,7,16,80.0,747.0,367,94,123,217,756.0,48,5.31,29,160,1399,9.1,0.40844434
19589,19589,Mikhail Grabovski,2014-15,31.0,9,35,58,58,13,22,35,81.0,914.0,425,107,145,252,837.0,82,5.34,48,269,2463,8.9,0.42207038
19590,19590,Mikhail Grabovski,2015-16,32.0,10,19,51,51,9,10,19,81.0,728.0,476,116,155,271,918.0,82,5.32,47,251,2453,8.9,0.37345845
19591,19591,Mikhail Grabovski,2016-17,33.0,11,25,58,58,9,16,25,83.0,818.0,534,125,171,296,1001.0,82,5.34,48,255,2438,9.0,0.3380016
19592,19592,Mikhail Grigorenko,2013-14,19.0,2,5,25,25,1,4,5,31.0,256.0,25,1,4,5,31.0,48,5.31,29,160,1399,9.1,0.26545691
19593,19593,Mikhail Grigorenko,2014-15,20.0,3,3,18,18,2,1,3,20.0,206.0,43,3,5,8,51.0,82,5.34,48,269,2463,8.9,0.27659866
19594,19594,Mikhail Grigorenko,2015-16,21.0,4,6,25,25,3,3,6,35.0,379.0,68,6,8,14,86.0,82,5.32,47,251,2453,8.9,0.30895224
19595,19595,Mikhail Grigorenko,2016-17,22.0,5,27,74,74,6,21,27,84.0,982.0,142,12,29,41,170.0,82,5.34,48,255,2438,9.0,0.3295563
19596,19596,Mikhail Grigorenko,2017-18,23.0,6,23,75,75,10,13,23,85.0,1057.0,217,22,42,64,255.0,82,5.45,47,245,2478,9.0,0.33237445
19597,19597,Mikhail Kravets,1992-93,29.0,2,0,1,1,0,0,0,2.0,,1,0,0,0,2.0,80,6.96,77,402,2440,11.4,0.18694395
19598,19598,Mikhail Kravets,1993-94,30.0,3,0,1,1,0,0,0,0.0,,2,0,0,0,2.0,84,7.25,87,443,2603,11.7,0.17620566
19599,19599,Mikhail Kuleshov,2004-05,24.0,2,0,3,3,0,0,0,4.0,34.0,3,0,0,0,4.0,82,5.14,57,348,2300,9.2,0.2180599
19600,19600,Mikhail Sergachev,2017-18,19.0,2,0,4,4,0,0,0,2.0,49.0,4,0,0,0,2.0,82,5.45,47,245,2478,9.0,0.26999635
19601,19601,Mikhail Sergachev,2018-19,20.0,3,40,79,79,9,31,40,141.0,1213.0,83,9,31,40,143.0,82,5.86,50,250,2620,9.2,0.495545
19602,19602,Mikhail Sergachev,2019-20,21.0,4,32,75,75,6,26,32,128.0,1344.0,158,15,57,72,271.0,82,5.96,47,239,2579,9.5,0.43922558
19603,19603,Mikhail Sergachev,2020-21,22.0,5,34,70,70,10,24,34,118.0,1426.0,228,25,81,106,389.0,70,5.96,42,208,2192,9.5,0.49061072
19604,19604,Mikhail Tatarinov,1991-92,25.0,2,23,65,65,8,15,23,145.0,,65,8,15,23,145.0,80,6.91,71,366,2385,11.6,0.39110568
19605,19605,Mikhail Tatarinov,1992-93,26.0,3,38,66,66,11,27,38,191.0,,131,19,42,61,336.0,80,6.96,77,402,2440,11.4,0.53510666
19606,19606,Mikhail Tatarinov,1993-94,27.0,4,8,28,28,2,6,8,46.0,,159,21,48,69,382.0,84,7.25,87,443,2603,11.7,0.31219018
19607,19607,Mikhail Tatarinov,1994-95,28.0,5,0,2,2,0,0,0,4.0,,161,21,48,69,386.0,84,6.48,76,407,2545,10.7,0.25513965
19608,19608,Mikhail Vorobyev,2019-20,23.0,2,2,15,15,1,1,2,10.0,140.0,15,1,1,2,10.0,82,5.96,47,239,2579,9.5,0.22006753
19609,19609,Mikhail Vorobyev,2020-21,24.0,3,3,20,20,1,2,3,15.0,209.0,35,2,3,5,25.0,70,5.96,42,208,2192,9.5,0.1897397
19610,19610,Mikhail Yakubov,2004-05,22.0,2,8,30,30,1,7,8,32.0,412.0,30,1,7,8,32.0,82,5.14,57,348,2300,9.2,0.25642037
19611,19611,Mikhail Yakubov,2006-07,24.0,3,4,23,23,1,3,4,27.0,222.0,53,2,10,12,59.0,82,6.05,85,480,2458,10.1,0.19162205
19612,19612,Mikkel Boedker,2009-10,20.0,2,28,78,78,11,17,28,116.0,1212.0,78,11,17,28,116.0,82,5.7,65,341,2477,9.4,0.41329408
19613,19613,Mikkel Boedker,2010-11,21.0,3,3,14,14,1,2,3,7.0,122.0,92,12,19,31,123.0,82,5.53,56,304,2486,9.1,0.34250677
19614,19614,Mikkel Boedker,2011-12,22.0,4,14,34,34,4,10,14,39.0,371.0,126,16,29,45,162.0,82,5.46,52,291,2492,9.0,0.30396718
19615,19615,Mikkel Boedker,2012-13,23.0,5,24,82,82,11,13,24,86.0,1118.0,208,27,42,69,248.0,82,5.32,47,271,2439,8.9,0.35384938
19616,19616,Mikkel Boedker,2013-14,24.0,6,26,48,48,7,19,26,83.0,887.0,256,34,61,95,331.0,48,5.31,29,160,1399,9.1,0.48944557
19617,19617,Mikkel Boedker,2014-15,25.0,7,51,82,82,19,32,51,166.0,1428.0,338,53,93,146,497.0,82,5.34,48,269,2463,8.9,0.57647914
19618,19618,Mikkel Boedker,2015-16,26.0,8,28,45,45,14,14,28,79.0,787.0,383,67,107,174,576.0,82,5.32,47,251,2453,8.9,0.54671097
19619,19619,Mikkel Boedker,2016-17,27.0,9,51,80,80,17,34,51,166.0,1481.0,463,84,141,225,742.0,82,5.34,48,255,2438,9.0,0.5789923
19620,19620,Mikkel Boedker,2017-18,28.0,10,26,81,81,10,16,26,122.0,1162.0,544,94,157,251,864.0,82,5.45,47,245,2478,9.0,0.3377707
19621,19621,Mikkel Boedker,2018-19,29.0,11,37,74,74,15,22,37,119.0,988.0,618,109,179,288,983.0,82,5.86,50,250,2620,9.2,0.4381492
19622,19622,Mikkel Boedker,2019-20,30.0,12,35,71,71,7,28,35,88.0,996.0,689,116,207,323,1071.0,82,5.96,47,239,2579,9.5,0.37915912
19623,19623,Mikkel Boedker,2020-21,31.0,13,4,20,20,2,2,4,29.0,194.0,709,118,209,327,1100.0,70,5.96,42,208,2192,9.5,0.2924982
19624,19624,Mikko Eloranta,2000-01,28.0,2,18,50,50,6,12,18,59.0,615.0,50,6,12,18,59.0,82,5.49,53,331,2294,9.8,0.32376754
19625,19625,Mikko Eloranta,2001-02,29.0,3,23,62,62,12,11,23,89.0,647.0,112,18,23,41,148.0,82,5.51,63,376,2272,9.9,0.31945464
19626,19626,Mikko Eloranta,2002-03,30.0,4,18,77,77,9,9,18,136.0,911.0,189,27,32,59,284.0,82,5.24,53,338,2262,9.5,0.30835617
19627,19627,Mikko Eloranta,2003-04,31.0,5,17,75,75,5,12,17,96.0,962.0,264,32,44,76,380.0,82,5.31,60,363,2326,9.4,0.25900412
19628,19628,Mikko Jokela,2003-04,23.0,2,0,1,1,0,0,0,3.0,5.0,1,0,0,0,3.0,82,5.31,60,363,2326,9.4,0.18338367
19629,19629,Mikko Koivu,2006-07,23.0,2,21,64,64,6,15,21,96.0,850.0,64,6,15,21,96.0,82,6.05,85,480,2458,10.1,0.34887078
19630,19630,Mikko Koivu,2007-08,24.0,3,54,82,82,20,34,54,162.0,1433.0,146,26,49,75,258.0,82,5.76,70,398,2426,9.7,0.63988364
19631,19631,Mikko Koivu,2008-09,25.0,4,42,57,57,11,31,42,144.0,1191.0,203,37,80,117,402.0,82,5.44,62,351,2383,9.4,0.6731716
19632,19632,Mikko Koivu,2009-10,26.0,5,67,79,79,20,47,67,236.0,1697.0,282,57,127,184,638.0,82,5.7,65,341,2477,9.4,0.8084513
19633,19633,Mikko Koivu,2010-11,27.0,6,71,80,80,22,49,71,246.0,1660.0,362,79,176,255,884.0,82,5.53,56,304,2486,9.1,0.7905185
19634,19634,Mikko Koivu,2011-12,28.0,7,62,71,71,17,45,62,191.0,1384.0,433,96,221,317,1075.0,82,5.46,52,291,2492,9.0,0.7881279
19635,19635,Mikko Koivu,2012-13,29.0,8,44,55,55,12,32,44,129.0,1174.0,488,108,253,361,1204.0,82,5.32,47,271,2439,8.9,0.72472805
19636,19636,Mikko Koivu,2013-14,30.0,9,37,48,48,11,26,37,127.0,1013.0,536,119,279,398,1331.0,48,5.31,29,160,1399,9.1,0.7298134
19637,19637,Mikko Koivu,2014-15,31.0,10,54,65,65,11,43,54,147.0,1361.0,601,130,322,452,1478.0,82,5.34,48,269,2463,8.9,0.64741254
19638,19638,Mikko Koivu,2015-16,32.0,11,48,80,80,14,34,48,179.0,1542.0,681,144,356,500,1657.0,82,5.32,47,251,2453,8.9,0.618888
19639,19639,Mikko Koivu,2016-17,33.0,12,56,82,82,17,39,56,141.0,1634.0,763,161,395,556,1798.0,82,5.34,48,255,2438,9.0,0.6800888
19640,19640,Mikko Koivu,2017-18,34.0,13,58,80,80,18,40,58,139.0,1529.0,843,179,435,614,1937.0,82,5.45,47,245,2478,9.0,0.6332366
19641,19641,Mikko Koivu,2018-19,35.0,14,45,82,82,14,31,45,170.0,1516.0,925,193,466,659,2107.0,82,5.86,50,250,2620,9.2,0.50329727
19642,19642,Mikko Koivu,2019-20,36.0,15,29,48,48,8,21,29,89.0,878.0,973,201,487,688,2196.0,82,5.96,47,239,2579,9.5,0.47829893
19643,19643,Mikko Koivu,2020-21,37.0,16,21,55,55,4,17,21,74.0,856.0,1028,205,504,709,2270.0,70,5.96,42,208,2192,9.5,0.35169888
19644,19644,Mikko Lehtonen,2007-08,29.0,2,3,15,15,1,2,3,14.0,219.0,15,1,2,3,14.0,82,5.76,70,398,2426,9.7,0.21550116
19645,19645,Mikko Lehtonen0,2009-10,22.0,2,0,1,1,0,0,0,1.0,16.0,1,0,0,0,1.0,82,5.7,65,341,2477,9.4,0.18293896
19646,19646,Mikko Lehtonen0,2010-11,23.0,3,0,1,1,0,0,0,1.0,7.0,2,0,0,0,2.0,82,5.53,56,304,2486,9.1,0.17140418
19647,19647,Mikko Leinonen,1982-83,27.0,2,31,53,53,11,20,31,68.0,,53,11,20,31,68.0,80,8.03,73,320,2489,12.9,0.49206263
19648,19648,Mikko Leinonen,1983-84,28.0,3,51,78,78,17,34,51,134.0,,131,28,54,82,202.0,80,7.73,71,310,2444,12.7,0.58490384
19649,19649,Mikko Leinonen,1984-85,29.0,4,26,28,28,3,23,26,39.0,,159,31,77,108,241.0,80,7.89,74,336,2448,12.9,0.5070475
19650,19650,Mikko Leinonen,1985-86,30.0,5,1,3,3,0,1,1,5.0,,162,31,78,109,246.0,80,7.77,71,321,2447,12.7,0.28781855
19651,19651,Mikko Luoma,2004-05,28.0,2,1,3,3,0,1,1,4.0,53.0,3,0,1,1,4.0,82,5.14,57,348,2300,9.2,0.18058568
19652,19652,Mikko Makela,1986-87,21.0,2,36,58,58,16,20,36,68.0,,58,16,20,36,68.0,80,7.94,82,370,2484,12.8,0.567818
19653,19653,Mikko Makela,1987-88,22.0,3,57,80,80,24,33,57,142.0,,138,40,53,93,210.0,80,7.34,72,344,2400,12.2,0.8020344
19654,19654,Mikko Makela,1988-89,23.0,4,76,73,73,36,40,76,142.0,,211,76,93,169,352.0,80,7.43,89,437,2435,12.2,0.8818011
19655,19655,Mikko Makela,1989-90,24.0,5,45,76,76,17,28,45,123.0,,287,93,121,214,475.0,80,7.48,85,403,2430,12.3,0.61562634
19656,19656,Mikko Makela,1990-91,25.0,6,26,65,65,9,17,26,82.0,,352,102,138,240,557.0,80,7.37,76,367,2421,12.2,0.45528212
19657,19657,Mikko Makela,1991-92,26.0,7,22,60,60,15,7,22,62.0,,412,117,145,262,619.0,80,6.91,71,366,2385,11.6,0.41062617
19658,19658,Mikko Makela,1995-96,30.0,8,3,11,11,1,2,3,10.0,,423,118,147,265,629.0,48,5.97,37,209,1408,10.2,0.37070236
19659,19659,Mikko Rantanen,2016-17,20.0,2,0,9,9,0,0,0,9.0,81.0,9,0,0,0,9.0,82,5.34,48,255,2438,9.0,0.25210273
19660,19660,Mikko Rantanen,2017-18,21.0,3,38,75,75,20,18,38,133.0,1354.0,84,20,18,38,142.0,82,5.45,47,245,2478,9.0,0.5913915
19661,19661,Mikko Rantanen,2018-19,22.0,4,84,81,81,29,55,84,178.0,1536.0,165,49,73,122,320.0,82,5.86,50,250,2620,9.2,1.0410143
19662,19662,Mikko Rantanen,2019-20,23.0,5,87,74,74,31,56,87,193.0,1542.0,239,80,129,209,513.0,82,5.96,47,239,2579,9.5,1.085744
19663,19663,Mikko Rantanen,2020-21,24.0,6,41,42,42,19,22,41,107.0,796.0,281,99,151,250,620.0,70,5.96,42,208,2192,9.5,0.8319775
19664,19664,Milan Bartovic,2003-04,22.0,2,1,3,3,1,0,1,5.0,30.0,3,1,0,1,5.0,82,5.31,60,363,2326,9.4,0.24159849
19665,19665,Milan Bartovic,2004-05,23.0,3,9,23,23,1,8,9,30.0,296.0,26,2,8,10,35.0,82,5.14,57,348,2300,9.2,0.29041052
19666,19666,Milan Bartovic,2006-07,25.0,4,7,24,24,1,6,7,35.0,212.0,50,3,14,17,70.0,82,6.05,85,480,2458,10.1,0.19999117
19667,19667,Milan Chalupa,1985-86,32.0,2,5,14,14,0,5,5,10.0,,14,0,5,5,10.0,80,7.77,71,321,2447,12.7,0.27209586
19668,19668,Milan Hejduk,1999-00,23.0,2,48,82,82,14,34,48,178.0,1292.0,82,14,34,48,178.0,82,5.27,57,359,2285,9.4,0.6164782
19669,19669,Milan Hejduk,2000-01,24.0,3,72,82,82,36,36,72,228.0,1638.0,164,50,70,120,406.0,82,5.49,53,331,2294,9.8,0.88505936
19670,19670,Milan Hejduk,2001-02,25.0,4,79,80,80,41,38,79,213.0,1589.0,244,91,108,199,619.0,82,5.51,63,376,2272,9.9,0.9092512
19671,19671,Milan Hejduk,2002-03,26.0,5,44,62,62,21,23,44,139.0,1252.0,306,112,131,243,758.0,82,5.24,53,338,2262,9.5,0.81310225
19672,19672,Milan Hejduk,2003-04,27.0,6,98,82,82,50,48,98,244.0,1627.0,388,162,179,341,1002.0,82,5.31,60,363,2326,9.4,0.98814785
19673,19673,Milan Hejduk,2004-05,28.0,7,75,82,82,35,40,75,237.0,1539.0,470,197,219,416,1239.0,82,5.14,57,348,2300,9.2,0.93741035
19674,19674,Milan Hejduk,2006-07,30.0,8,58,74,74,24,34,58,221.0,1373.0,544,221,253,474,1460.0,82,6.05,85,480,2458,10.1,0.79018927
19675,19675,Milan Hejduk,2007-08,31.0,9,70,80,80,35,35,70,257.0,1430.0,624,256,288,544,1717.0,82,5.76,70,398,2426,9.7,0.78285456
19676,19676,Milan Hejduk,2008-09,32.0,10,54,77,77,29,25,54,205.0,1490.0,701,285,313,598,1922.0,82,5.44,62,351,2383,9.4,0.7162996
19677,19677,Milan Hejduk,2009-10,33.0,11,59,82,82,27,32,59,211.0,1634.0,783,312,345,657,2133.0,82,5.7,65,341,2477,9.4,0.66247046
19678,19678,Milan Hejduk,2010-11,34.0,12,44,56,56,23,21,44,153.0,1065.0,839,335,366,701,2286.0,82,5.53,56,304,2486,9.1,0.73911774
19679,19679,Milan Hejduk,2011-12,35.0,13,56,71,71,22,34,56,170.0,1273.0,910,357,400,757,2456.0,82,5.46,52,291,2492,9.0,0.6488308
19680,19680,Milan Hejduk,2012-13,36.0,14,37,81,81,14,23,37,170.0,1378.0,991,371,423,794,2626.0,82,5.32,47,271,2439,8.9,0.4742234
19681,19681,Milan Hejduk,2013-14,37.0,15,11,29,29,4,7,11,41.0,381.0,1020,375,430,805,2667.0,48,5.31,29,160,1399,9.1,0.41789055
19682,19682,Milan Jurcina,2006-07,23.0,2,11,51,51,6,5,11,64.0,840.0,51,6,5,11,64.0,82,6.05,85,480,2458,10.1,0.26927105
19683,19683,Milan Jurcina,2007-08,24.0,3,12,70,70,4,8,12,71.0,1122.0,121,10,13,23,135.0,82,5.76,70,398,2426,9.7,0.19645295
19684,19684,Milan Jurcina,2008-09,25.0,4,9,75,75,1,8,9,58.0,1248.0,196,11,21,32,193.0,82,5.44,62,351,2383,9.4,0.16711098
19685,19685,Milan Jurcina,2009-10,26.0,5,14,79,79,3,11,14,95.0,1276.0,275,14,32,46,288.0,82,5.7,65,341,2477,9.4,0.20619875
19686,19686,Milan Jurcina,2010-11,27.0,6,7,44,44,1,6,7,49.0,777.0,319,15,38,53,337.0,82,5.53,56,304,2486,9.1,0.15367031
19687,19687,Milan Jurcina,2011-12,28.0,7,17,46,46,4,13,17,76.0,831.0,365,19,51,70,413.0,82,5.46,52,291,2492,9.0,0.26710737
19688,19688,Milan Jurcina,2012-13,29.0,8,11,65,65,3,8,11,127.0,1221.0,430,22,59,81,540.0,82,5.32,47,271,2439,8.9,0.1928907
19689,19689,Milan Kraft,2001-02,22.0,2,14,42,42,7,7,14,63.0,491.0,42,7,7,14,63.0,82,5.51,63,376,2272,9.9,0.32015705
19690,19690,Milan Kraft,2002-03,23.0,3,16,68,68,8,8,16,103.0,849.0,110,15,15,30,166.0,82,5.24,53,338,2262,9.5,0.29605642
19691,19691,Milan Kraft,2003-04,24.0,4,12,31,31,7,5,12,50.0,432.0,141,22,20,42,216.0,82,5.31,60,363,2326,9.4,0.32598078
19692,19692,Milan Kraft,2004-05,25.0,5,40,66,66,19,21,40,134.0,1008.0,207,41,41,82,350.0,82,5.14,57,348,2300,9.2,0.7014049
19693,19693,Milan Kytnar,2012-13,23.0,2,0,1,1,0,0,0,1.0,6.0,1,0,0,0,1.0,82,5.32,47,271,2439,8.9,0.16584736
19694,19694,Milan Lucic,2008-09,20.0,2,27,77,77,8,19,27,88.0,933.0,77,8,19,27,88.0,82,5.44,62,351,2383,9.4,0.39494196
19695,19695,Milan Lucic,2009-10,21.0,3,42,72,72,17,25,42,97.0,1076.0,149,25,44,69,185.0,82,5.7,65,341,2477,9.4,0.54517597
19696,19696,Milan Lucic,2010-11,22.0,4,20,50,50,9,11,20,72.0,718.0,199,34,55,89,257.0,82,5.53,56,304,2486,9.1,0.48484465
19697,19697,Milan Lucic,2011-12,23.0,5,62,79,79,30,32,62,173.0,1310.0,278,64,87,151,430.0,82,5.46,52,291,2492,9.0,0.7381325
19698,19698,Milan Lucic,2012-13,24.0,6,61,81,81,26,35,61,149.0,1379.0,359,90,122,212,579.0,82,5.32,47,271,2439,8.9,0.73563915
19699,19699,Milan Lucic,2013-14,25.0,7,27,46,46,7,20,27,79.0,778.0,405,97,142,239,658.0,48,5.31,29,160,1399,9.1,0.618098
19700,19700,Milan Lucic,2014-15,26.0,8,59,80,80,24,35,59,153.0,1390.0,485,121,177,298,811.0,82,5.34,48,269,2463,8.9,0.6635315
19701,19701,Milan Lucic,2015-16,27.0,9,44,81,81,18,26,44,141.0,1325.0,566,139,203,342,952.0,82,5.32,47,251,2453,8.9,0.57064754
19702,19702,Milan Lucic,2016-17,28.0,10,55,81,81,20,35,55,124.0,1396.0,647,159,238,397,1076.0,82,5.34,48,255,2438,9.0,0.6520047
19703,19703,Milan Lucic,2017-18,29.0,11,50,82,82,23,27,50,175.0,1407.0,729,182,265,447,1251.0,82,5.45,47,245,2478,9.0,0.5817309
19704,19704,Milan Lucic,2018-19,30.0,12,34,82,82,10,24,34,147.0,1309.0,811,192,289,481,1398.0,82,5.86,50,250,2620,9.2,0.43320507
19705,19705,Milan Lucic,2019-20,31.0,13,20,79,79,6,14,20,74.0,1046.0,890,198,303,501,1472.0,82,5.96,47,239,2579,9.5,0.29653025
19706,19706,Milan Lucic,2020-21,32.0,14,20,68,68,8,12,20,83.0,907.0,958,206,315,521,1555.0,70,5.96,42,208,2192,9.5,0.3037073
19707,19707,Milan Michalek,2004-05,20.0,2,1,2,2,1,0,1,1.0,18.0,2,1,0,1,1.0,82,5.14,57,348,2300,9.2,0.3926534
19708,19708,Milan Michalek,2006-07,22.0,3,35,81,81,17,18,35,159.0,1277.0,83,18,18,36,160.0,82,6.05,85,480,2458,10.1,0.49508104
19709,19709,Milan Michalek,2007-08,23.0,4,66,78,78,26,40,66,191.0,1307.0,161,44,58,102,351.0,82,5.76,70,398,2426,9.7,0.80925286
19710,19710,Milan Michalek,2008-09,24.0,5,55,79,79,24,31,55,233.0,1428.0,240,68,89,157,584.0,82,5.44,62,351,2383,9.4,0.71801454
19711,19711,Milan Michalek,2009-10,25.0,6,57,77,77,23,34,57,179.0,1421.0,317,91,123,214,763.0,82,5.7,65,341,2477,9.4,0.6721406
19712,19712,Milan Michalek,2010-11,26.0,7,34,66,66,22,12,34,163.0,1205.0,383,113,135,248,926.0,82,5.53,56,304,2486,9.1,0.5597694
19713,19713,Milan Michalek,2011-12,27.0,8,33,66,66,18,15,33,167.0,1192.0,449,131,150,281,1093.0,82,5.46,52,291,2492,9.0,0.5272244
19714,19714,Milan Michalek,2012-13,28.0,9,60,77,77,35,25,60,212.0,1506.0,526,166,175,341,1305.0,82,5.32,47,271,2439,8.9,0.69282746
19715,19715,Milan Michalek,2013-14,29.0,10,14,23,23,4,10,14,58.0,418.0,549,170,185,355,1363.0,48,5.31,29,160,1399,9.1,0.5042368
19716,19716,Milan Michalek,2014-15,30.0,11,39,82,82,17,22,39,169.0,1442.0,631,187,207,394,1532.0,82,5.34,48,269,2463,8.9,0.49802813
19717,19717,Milan Michalek,2015-16,31.0,12,34,66,66,13,21,34,130.0,1080.0,697,200,228,428,1662.0,82,5.32,47,251,2453,8.9,0.41850218
19718,19718,Milan Michalek,2016-17,32.0,13,16,45,45,7,9,16,64.0,725.0,742,207,237,444,1726.0,82,5.34,48,255,2438,9.0,0.34480792
19719,19719,Milan Michalek,2017-18,33.0,14,2,5,5,1,1,2,6.0,71.0,747,208,238,446,1732.0,82,5.45,47,245,2478,9.0,0.28953195
19720,19720,Milan Novy,1983-84,32.0,2,48,73,73,18,30,48,132.0,,73,18,30,48,132.0,80,7.73,71,310,2444,12.7,0.6391288
19721,19721,Milan Tichy,1993-94,24.0,2,1,13,13,0,1,1,12.0,,13,0,1,1,12.0,84,7.25,87,443,2603,11.7,0.21656087
19722,19722,Milan Tichy,1995-96,26.0,3,0,2,2,0,0,0,1.0,,15,0,1,1,13.0,48,5.97,37,209,1408,10.2,0.17414507
19723,19723,Milan Tichy,1996-97,27.0,4,4,8,8,0,4,4,6.0,,23,0,5,5,19.0,82,6.29,74,413,2481,10.4,0.16409442
19724,19724,Miles Wood,2016-17,21.0,2,0,1,1,0,0,0,2.0,13.0,1,0,0,0,2.0,82,5.34,48,255,2438,9.0,0.20420474
19725,19725,Miles Wood,2017-18,22.0,3,17,60,60,8,9,17,105.0,771.0,61,8,9,17,107.0,82,5.45,47,245,2478,9.0,0.31711754
19726,19726,Miles Wood,2018-19,23.0,4,32,76,76,19,13,32,170.0,947.0,137,27,22,49,277.0,82,5.86,50,250,2620,9.2,0.46995056
19727,19727,Miles Wood,2019-20,24.0,5,24,63,63,10,14,24,159.0,863.0,200,37,36,73,436.0,82,5.96,47,239,2579,9.5,0.40810332
19728,19728,Miles Wood,2020-21,25.0,6,23,68,68,11,12,23,141.0,900.0,268,48,48,96,577.0,70,5.96,42,208,2192,9.5,0.3775036
19729,19729,Milos Holan,1994-95,23.0,2,2,8,8,1,1,2,26.0,,8,1,1,2,26.0,84,6.48,76,407,2545,10.7,0.29817963
19730,19730,Milos Holan,1995-96,24.0,3,10,25,25,2,8,10,93.0,,33,3,9,12,119.0,48,5.97,37,209,1408,10.2,0.34723163
19731,19731,Milos Holan,1996-97,25.0,4,4,16,16,2,2,4,47.0,,49,5,11,16,166.0,82,6.29,74,413,2481,10.4,0.263462
19732,19732,Miloslav Guren,1999-00,23.0,2,1,12,12,0,1,1,11.0,144.0,12,0,1,1,11.0,82,5.27,57,359,2285,9.4,0.20204923
19733,19733,Miloslav Guren,2000-01,24.0,3,3,24,24,1,2,3,20.0,366.0,36,1,3,4,31.0,82,5.49,53,331,2294,9.8,0.1727367
19734,19734,Miloslav Horava,1989-90,28.0,2,1,6,6,0,1,1,7.0,,6,0,1,1,7.0,80,7.48,85,403,2430,12.3,0.22800797
19735,19735,Miloslav Horava,1990-91,29.0,3,14,45,45,4,10,14,50.0,,51,4,11,15,57.0,80,7.37,76,367,2421,12.2,0.26746464
19736,19736,Miloslav Horava,1991-92,30.0,4,7,29,29,1,6,7,27.0,,80,5,17,22,84.0,80,6.91,71,366,2385,11.6,0.22493094
19737,19737,Mirco Mueller,2015-16,20.0,2,4,39,39,1,3,4,31.0,661.0,39,1,3,4,31.0,82,5.32,47,251,2453,8.9,0.20945758
19738,19738,Mirco Mueller,2016-17,21.0,3,0,11,11,0,0,0,8.0,117.0,50,1,3,4,39.0,82,5.34,48,255,2438,9.0,0.19766286
19739,19739,Mirco Mueller,2017-18,22.0,4,2,4,4,1,1,2,3.0,38.0,54,2,4,6,42.0,82,5.45,47,245,2478,9.0,0.22083783
19740,19740,Mirco Mueller,2018-19,23.0,5,4,28,28,0,4,4,19.0,467.0,82,2,8,10,61.0,82,5.86,50,250,2620,9.2,0.16517484
19741,19741,Mirco Mueller,2019-20,24.0,6,11,53,53,1,10,11,39.0,958.0,135,3,18,21,100.0,82,5.96,47,239,2579,9.5,0.16995254
19742,19742,Mirco Mueller,2020-21,25.0,7,7,50,50,2,5,7,29.0,882.0,185,5,23,28,129.0,70,5.96,42,208,2192,9.5,0.14086574
19743,19743,Miro Heiskanen,2019-20,20.0,2,33,82,82,12,21,33,182.0,1895.0,82,12,21,33,182.0,82,5.96,47,239,2579,9.5,0.5083626
19744,19744,Miro Heiskanen,2020-21,21.0,3,35,68,68,8,27,35,163.0,1616.0,150,20,48,68,345.0,70,5.96,42,208,2192,9.5,0.53982407
19745,19745,Miroslav Dvorak,1983-84,32.0,2,37,80,80,4,33,37,112.0,,80,4,33,37,112.0,80,7.73,71,310,2444,12.7,0.41953066
19746,19746,Miroslav Dvorak,1984-85,33.0,3,31,66,66,4,27,31,85.0,,146,8,60,68,197.0,80,7.89,74,336,2448,12.9,0.35329324
19747,19747,Miroslav Dvorak,1985-86,34.0,4,17,47,47,3,14,17,52.0,,193,11,74,85,249.0,80,7.77,71,321,2447,12.7,0.36373463
19748,19748,Miroslav Frycer,1982-83,23.0,2,47,59,59,24,23,47,112.0,,59,24,23,47,112.0,80,8.03,73,320,2489,12.9,0.7044166
19749,19749,Miroslav Frycer,1983-84,24.0,3,55,67,67,25,30,55,133.0,,126,49,53,102,245.0,80,7.73,71,310,2444,12.7,0.70326364
19750,19750,Miroslav Frycer,1984-85,25.0,4,26,47,47,10,16,26,83.0,,173,59,69,128,328.0,80,7.89,74,336,2448,12.9,0.57767665
19751,19751,Miroslav Frycer,1985-86,26.0,5,55,65,65,25,30,55,183.0,,238,84,99,183,511.0,80,7.77,71,321,2447,12.7,0.88457596
19752,19752,Miroslav Frycer,1986-87,27.0,6,75,73,73,32,43,75,201.0,,311,116,142,258,712.0,80,7.94,82,370,2484,12.8,0.7690239
19753,19753,Miroslav Frycer,1987-88,28.0,7,15,29,29,7,8,15,52.0,,340,123,150,273,764.0,80,7.34,72,344,2400,12.2,0.62520295
19754,19754,Miroslav Frycer,1988-89,29.0,8,32,38,38,12,20,32,76.0,,378,135,170,305,840.0,80,7.43,89,437,2435,12.2,0.65234995
19755,19755,Miroslav Frycer,1989-90,30.0,9,25,37,37,12,13,25,73.0,,415,147,183,330,913.0,80,7.48,85,403,2430,12.3,0.5712949
19756,19756,Miroslav Ihnacak,1986-87,24.0,2,6,21,21,2,4,6,25.0,,21,2,4,6,25.0,80,7.94,82,370,2484,12.8,0.3116647
19757,19757,Miroslav Ihnacak,1987-88,25.0,3,11,34,34,6,5,11,65.0,,55,8,9,17,90.0,80,7.34,72,344,2400,12.2,0.3285786
19758,19758,Miroslav Ihnacak,1989-90,27.0,4,0,1,1,0,0,0,1.0,,56,8,9,17,91.0,80,7.48,85,403,2430,12.3,0.21419647
19759,19759,Miroslav Satan,1996-97,22.0,2,35,62,62,18,17,35,113.0,,62,18,17,35,113.0,82,6.29,74,413,2481,10.4,0.51938456
19760,19760,Miroslav Satan,1997-98,23.0,3,38,76,76,25,13,38,119.0,,138,43,30,73,232.0,82,5.83,55,336,2444,9.8,0.5198771
19761,19761,Miroslav Satan,1998-99,24.0,4,46,79,79,22,24,46,139.0,,217,65,54,119,371.0,82,5.28,57,380,2242,9.6,0.5735445
19762,19762,Miroslav Satan,1999-00,25.0,5,66,81,81,40,26,66,208.0,1686.0,298,105,80,185,579.0,82,5.27,57,359,2285,9.4,0.8316243
19763,19763,Miroslav Satan,2000-01,26.0,6,67,81,81,33,34,67,265.0,1667.0,379,138,114,252,844.0,82,5.49,53,331,2294,9.8,0.8479812
19764,19764,Miroslav Satan,2001-02,27.0,7,62,82,82,29,33,62,206.0,1635.0,461,167,147,314,1050.0,82,5.51,63,376,2272,9.9,0.7105962
19765,19765,Miroslav Satan,2002-03,28.0,8,73,82,82,37,36,73,267.0,1735.0,543,204,183,387,1317.0,82,5.24,53,338,2262,9.5,0.8795278
19766,19766,Miroslav Satan,2003-04,29.0,9,75,79,79,26,49,75,240.0,1690.0,622,230,232,462,1557.0,82,5.31,60,363,2326,9.4,0.82791364
19767,19767,Miroslav Satan,2004-05,30.0,10,57,82,82,29,28,57,206.0,1643.0,704,259,260,519,1763.0,82,5.14,57,348,2300,9.2,0.7564819
19768,19768,Miroslav Satan,2006-07,32.0,11,66,82,82,35,31,66,253.0,1572.0,786,294,291,585,2016.0,82,6.05,85,480,2458,10.1,0.76475096
19769,19769,Miroslav Satan,2007-08,33.0,12,59,81,81,27,32,59,216.0,1505.0,867,321,323,644,2232.0,82,5.76,70,398,2426,9.7,0.64838326
19770,19770,Miroslav Satan,2008-09,34.0,13,41,80,80,16,25,41,171.0,1466.0,947,337,348,685,2403.0,82,5.44,62,351,2383,9.4,0.5162255
19771,19771,Miroslav Satan,2009-10,35.0,14,36,65,65,17,19,36,120.0,1024.0,1012,354,367,721,2523.0,82,5.7,65,341,2477,9.4,0.40316924
19772,19772,Miroslav Satan,2010-11,36.0,15,14,38,38,9,5,14,59.0,599.0,1050,363,372,735,2582.0,82,5.53,56,304,2486,9.1,0.34236938
19773,19773,Miroslav Zalesak,2003-04,24.0,2,3,10,10,1,2,3,8.0,95.0,10,1,2,3,8.0,82,5.31,60,363,2326,9.4,0.208792
19774,19774,Miroslav Zalesak,2004-05,25.0,3,0,2,2,0,0,0,3.0,24.0,12,1,2,3,11.0,82,5.14,57,348,2300,9.2,0.16406211
19775,19775,Mitch Callahan,2014-15,23.0,2,0,1,1,0,0,0,0.0,9.0,1,0,0,0,0.0,82,5.34,48,269,2463,8.9,0.14718214
19776,19776,Mitch Callahan,2017-18,26.0,3,0,4,4,0,0,0,2.0,27.0,5,0,0,0,2.0,82,5.45,47,245,2478,9.0,0.16927812
19777,19777,Mitch Fritz,2009-10,29.0,2,0,20,20,0,0,0,2.0,54.0,20,0,0,0,2.0,82,5.7,65,341,2477,9.4,0.092962354
19778,19778,Mitch Lamoureux,1984-85,22.0,2,2,8,8,1,1,2,13.0,,8,1,1,2,13.0,80,7.89,74,336,2448,12.9,0.30828208
19779,19779,Mitch Lamoureux,1985-86,23.0,3,18,62,62,10,8,18,81.0,,70,11,9,20,94.0,80,7.77,71,321,2447,12.7,0.33639938
19780,19780,Mitch Lamoureux,1988-89,26.0,4,0,3,3,0,0,0,1.0,,73,11,9,20,95.0,80,7.43,89,437,2435,12.2,0.22575879
19781,19781,Mitch Marner,2017-18,20.0,2,61,77,77,19,42,61,176.0,1294.0,77,19,42,61,176.0,82,5.45,47,245,2478,9.0,0.74988514
19782,19782,Mitch Marner,2018-19,21.0,3,69,82,82,22,47,69,194.0,1344.0,159,41,89,130,370.0,82,5.86,50,250,2620,9.2,0.92606455
19783,19783,Mitch Marner,2019-20,22.0,4,94,82,82,26,68,94,233.0,1625.0,241,67,157,224,603.0,82,5.96,47,239,2579,9.5,1.1641123
19784,19784,Mitch Marner,2020-21,23.0,5,67,59,59,16,51,67,154.0,1272.0,300,83,208,291,757.0,70,5.96,42,208,2192,9.5,1.1703992
19785,19785,Mitch Messier,1988-89,23.0,2,1,13,13,0,1,1,5.0,,13,0,1,1,5.0,80,7.43,89,437,2435,12.2,0.2301172
19786,19786,Mitch Messier,1989-90,24.0,3,1,3,3,0,1,1,3.0,,16,0,2,2,8.0,80,7.48,85,403,2430,12.3,0.21263042
19787,19787,Mitch Messier,1990-91,25.0,4,0,2,2,0,0,0,1.0,,18,0,2,2,9.0,80,7.37,76,367,2421,12.2,0.18219763
19788,19788,Mitch Messier,1991-92,26.0,5,0,2,2,0,0,0,0.0,,20,0,2,2,9.0,80,6.91,71,366,2385,11.6,0.15783226
19789,19789,Mitch Molloy,1990-91,24.0,2,0,2,2,0,0,0,0.0,,2,0,0,0,0.0,80,7.37,76,367,2421,12.2,0.1824621
19790,19790,Mitch Reinke,2018-19,22.0,2,0,1,1,0,0,0,1.0,13.0,1,0,0,0,1.0,82,5.86,50,250,2620,9.2,0.16917622
19791,19791,Mitch Wilson,1985-86,23.0,2,2,9,9,0,2,2,7.0,,9,0,2,2,7.0,80,7.77,71,321,2447,12.7,0.25258106
19792,19792,Mitch Wilson,1987-88,25.0,3,3,17,17,2,1,3,7.0,,26,2,3,5,14.0,80,7.34,72,344,2400,12.2,0.26997298
19793,19793,Mitchell Stephens,2020-21,23.0,2,6,38,38,3,3,6,43.0,410.0,38,3,3,6,43.0,70,5.96,42,208,2192,9.5,0.2442745
19794,19794,Moe Lemay,1982-83,20.0,2,3,5,5,1,2,3,14.0,,5,1,2,3,14.0,80,8.03,73,320,2489,12.9,0.3589627
19795,19795,Moe Lemay,1983-84,21.0,3,20,44,44,11,9,20,74.0,,49,12,11,23,88.0,80,7.73,71,310,2444,12.7,0.47897586
19796,19796,Moe Lemay,1984-85,22.0,4,30,56,56,12,18,30,109.0,,105,24,29,53,197.0,80,7.89,74,336,2448,12.9,0.52337205
19797,19797,Moe Lemay,1985-86,23.0,5,52,74,74,21,31,52,162.0,,179,45,60,105,359.0,80,7.77,71,321,2447,12.7,0.6535669
19798,19798,Moe Lemay,1986-87,24.0,6,31,48,48,16,15,31,112.0,,227,61,75,136,471.0,80,7.94,82,370,2484,12.8,0.5493371
19799,19799,Moe Lemay,1987-88,25.0,7,29,62,62,10,19,29,94.0,,289,71,94,165,565.0,80,7.34,72,344,2400,12.2,0.43677607
19800,19800,Moe Lemay,1988-89,26.0,8,0,6,6,0,0,0,7.0,,295,71,94,165,572.0,80,7.43,89,437,2435,12.2,0.32826674
19801,19801,Moe Lemay,1989-90,27.0,9,1,22,22,1,0,1,21.0,,317,72,94,166,593.0,80,7.48,85,403,2430,12.3,0.30347428
19802,19802,Moe Mantha,1981-82,21.0,2,25,58,58,2,23,25,94.0,,58,2,23,25,94.0,80,7.69,77,340,2441,12.6,0.44853696
19803,19803,Moe Mantha,1982-83,22.0,3,12,25,25,0,12,12,39.0,,83,2,35,37,133.0,80,8.03,73,320,2489,12.9,0.32683337
19804,19804,Moe Mantha,1983-84,23.0,4,9,21,21,2,7,9,27.0,,104,4,42,46,160.0,80,7.73,71,310,2444,12.7,0.40701047
19805,19805,Moe Mantha,1984-85,24.0,5,54,72,72,16,38,54,230.0,,176,20,80,100,390.0,80,7.89,74,336,2448,12.9,0.7038089
19806,19806,Moe Mantha,1985-86,25.0,6,51,71,71,11,40,51,205.0,,247,31,120,151,595.0,80,7.77,71,321,2447,12.7,0.65705264
19807,19807,Moe Mantha,1986-87,26.0,7,67,78,78,15,52,67,224.0,,325,46,172,218,819.0,80,7.94,82,370,2484,12.8,0.78641975
19808,19808,Moe Mantha,1987-88,27.0,8,40,62,62,9,31,40,167.0,,387,55,203,258,986.0,80,7.34,72,344,2400,12.2,0.59100574
19809,19809,Moe Mantha,1988-89,28.0,9,38,76,76,11,27,38,223.0,,463,66,230,296,1209.0,80,7.43,89,437,2435,12.2,0.53216106
19810,19810,Moe Mantha,1989-90,29.0,10,18,46,46,4,14,18,103.0,,509,70,244,314,1312.0,80,7.48,85,403,2430,12.3,0.39411476
19811,19811,Moe Mantha,1990-91,30.0,11,28,73,73,2,26,28,114.0,,582,72,270,342,1426.0,80,7.37,76,367,2421,12.2,0.36646706
19812,19812,Moe Mantha,1991-92,31.0,12,24,57,57,9,15,24,102.0,,639,81,285,366,1528.0,80,6.91,71,366,2385,11.6,0.39160708
19813,19813,Moe Mantha,1992-93,32.0,13,4,17,17,0,4,4,17.0,,656,81,289,370,1545.0,80,6.96,77,402,2440,11.4,0.30788907
19814,19814,Moe Robinson,1980-81,23.0,2,0,1,1,0,0,0,0.0,,1,0,0,0,0.0,80,7.03,61,280,2352,12.0,0.19906649
19815,19815,Morgan Ellis,2016-17,24.0,2,0,3,3,0,0,0,3.0,27.0,3,0,0,0,3.0,82,5.34,48,255,2438,9.0,0.16909173
19816,19816,Morgan Frost,2020-21,21.0,2,7,20,20,2,5,7,31.0,274.0,20,2,5,7,31.0,70,5.96,42,208,2192,9.5,0.36455798
19817,19817,Morgan Geekie,2020-21,22.0,2,4,2,2,3,1,4,4.0,24.0,2,3,1,4,4.0,70,5.96,42,208,2192,9.5,0.3268354
19818,19818,Morgan Klimchuk,2018-19,23.0,2,0,1,1,0,0,0,0.0,7.0,1,0,0,0,0.0,82,5.86,50,250,2620,9.2,0.15699339
19819,19819,Morgan Rielly,2014-15,20.0,2,27,73,73,2,25,27,96.0,1287.0,73,2,25,27,96.0,82,5.34,48,269,2463,8.9,0.38742083
19820,19820,Morgan Rielly,2015-16,21.0,3,29,81,81,8,21,29,148.0,1647.0,154,10,46,56,244.0,82,5.32,47,251,2453,8.9,0.4223086
19821,19821,Morgan Rielly,2016-17,22.0,4,36,82,82,9,27,36,167.0,1905.0,236,19,73,92,411.0,82,5.34,48,255,2438,9.0,0.46511146
19822,19822,Morgan Rielly,2017-18,23.0,5,27,76,76,6,21,27,171.0,1685.0,312,25,94,119,582.0,82,5.45,47,245,2478,9.0,0.4549141
19823,19823,Morgan Rielly,2018-19,24.0,6,52,76,76,6,46,52,182.0,1642.0,388,31,140,171,764.0,82,5.86,50,250,2620,9.2,0.6732002
19824,19824,Morgan Rielly,2019-20,25.0,7,72,82,82,20,52,72,223.0,1896.0,470,51,192,243,987.0,82,5.96,47,239,2579,9.5,0.8100277
19825,19825,Morgan Rielly,2020-21,26.0,8,27,47,47,3,24,27,123.0,1137.0,517,54,216,270,1110.0,70,5.96,42,208,2192,9.5,0.52608943
19826,19826,Morris Lukowich,1980-81,24.0,2,74,78,78,35,39,74,201.0,,78,35,39,74,201.0,80,7.03,61,280,2352,12.0,0.88461936
19827,19827,Morris Lukowich,1981-82,25.0,3,67,80,80,33,34,67,175.0,,158,68,73,141,376.0,80,7.69,77,340,2441,12.6,0.84504676
19828,19828,Morris Lukowich,1982-83,26.0,4,92,77,77,43,49,92,229.0,,235,111,122,233,605.0,80,8.03,73,320,2489,12.9,1.0568149
19829,19829,Morris Lukowich,1983-84,27.0,5,43,69,69,22,21,43,162.0,,304,133,143,276,767.0,80,7.73,71,310,2444,12.7,0.7209079
19830,19830,Morris Lukowich,1984-85,28.0,6,55,80,80,30,25,55,155.0,,384,163,168,331,922.0,80,7.89,74,336,2448,12.9,0.64298
19831,19831,Morris Lukowich,1985-86,29.0,7,27,69,69,10,17,27,66.0,,453,173,185,358,988.0,80,7.77,71,321,2447,12.7,0.42595816
19832,19832,Morris Lukowich,1986-87,30.0,8,25,69,69,12,13,25,110.0,,522,185,198,383,1098.0,80,7.94,82,370,2484,12.8,0.42407948
19833,19833,Morris Lukowich,1987-88,31.0,9,35,60,60,14,21,35,105.0,,582,199,219,418,1203.0,80,7.34,72,344,2400,12.2,0.48842633
19834,19834,Murray Baron,1990-91,23.0,2,4,16,16,2,2,4,18.0,,16,2,2,4,18.0,80,7.37,76,367,2421,12.2,0.30887836
19835,19835,Murray Baron,1991-92,24.0,3,16,67,67,8,8,16,86.0,,83,10,10,20,104.0,80,6.91,71,366,2385,11.6,0.28025663
19836,19836,Murray Baron,1992-93,25.0,4,11,67,67,3,8,11,55.0,,150,13,18,31,159.0,80,6.96,77,402,2440,11.4,0.21376538
19837,19837,Murray Baron,1993-94,26.0,5,4,53,53,2,2,4,42.0,,203,15,20,35,201.0,84,7.25,87,443,2603,11.7,0.17351466
19838,19838,Murray Baron,1994-95,27.0,6,14,77,77,5,9,14,73.0,,280,20,29,49,274.0,84,6.48,76,407,2545,10.7,0.19303927
19839,19839,Murray Baron,1995-96,28.0,7,5,39,39,0,5,5,28.0,,319,20,34,54,302.0,48,5.97,37,209,1408,10.2,0.12502646
19840,19840,Murray Baron,1996-97,29.0,8,11,82,82,2,9,11,86.0,,401,22,43,65,388.0,82,6.29,74,413,2481,10.4,0.18710148
19841,19841,Murray Baron,1997-98,30.0,9,8,79,79,1,7,8,64.0,,480,23,50,73,452.0,82,5.83,55,336,2444,9.8,0.14121869
19842,19842,Murray Baron,1998-99,31.0,10,6,45,45,1,5,6,23.0,,525,24,55,79,475.0,82,5.28,57,380,2242,9.6,0.11713636
19843,19843,Murray Baron,1999-00,32.0,11,8,81,81,2,6,8,53.0,1477.0,606,26,61,87,528.0,82,5.27,57,359,2285,9.4,0.13046864
19844,19844,Murray Baron,2000-01,33.0,12,12,81,81,2,10,12,48.0,1750.0,687,28,71,99,576.0,82,5.49,53,331,2294,9.8,0.13284382
19845,19845,Murray Baron,2001-02,34.0,13,11,82,82,3,8,11,56.0,1591.0,769,31,79,110,632.0,82,5.51,63,376,2272,9.9,0.13019297
19846,19846,Murray Baron,2002-03,35.0,14,7,61,61,1,6,7,38.0,1034.0,830,32,85,117,670.0,82,5.24,53,338,2262,9.5,0.1242851
19847,19847,Murray Baron,2003-04,36.0,15,6,78,78,2,4,6,34.0,1327.0,908,34,89,123,704.0,82,5.31,60,363,2326,9.4,0.122976124
19848,19848,Murray Baron,2004-05,37.0,16,6,80,80,1,5,6,57.0,1538.0,988,35,94,129,761.0,82,5.14,57,348,2300,9.2,0.12000865
19849,19849,Murray Brumwell,1981-82,21.0,2,0,1,1,0,0,0,0.0,,1,0,0,0,0.0,80,7.69,77,340,2441,12.6,0.216385
19850,19850,Murray Brumwell,1982-83,22.0,3,3,21,21,0,3,3,12.0,,22,0,3,3,12.0,80,8.03,73,320,2489,12.9,0.1717715
19851,19851,Murray Brumwell,1983-84,23.0,4,19,59,59,5,14,19,61.0,,81,5,17,22,73.0,80,7.73,71,310,2444,12.7,0.33669403
19852,19852,Murray Brumwell,1984-85,24.0,5,20,42,42,7,13,20,55.0,,123,12,30,42,128.0,80,7.89,74,336,2448,12.9,0.393876
19853,19853,Murray Brumwell,1986-87,26.0,6,0,1,1,0,0,0,3.0,,124,12,30,42,131.0,80,7.94,82,370,2484,12.8,0.19440776
19854,19854,Murray Brumwell,1987-88,27.0,7,0,1,1,0,0,0,2.0,,125,12,30,42,133.0,80,7.34,72,344,2400,12.2,0.19731289
19855,19855,Murray Brumwell,1988-89,28.0,8,1,3,3,0,1,1,4.0,,128,12,31,43,137.0,80,7.43,89,437,2435,12.2,0.2079691
19856,19856,Murray Craven,1983-84,19.0,2,11,31,31,4,7,11,21.0,,31,4,7,11,21.0,80,7.73,71,310,2444,12.7,0.36057737
19857,19857,Murray Craven,1984-85,20.0,3,4,15,15,0,4,4,8.0,,46,4,11,15,29.0,80,7.89,74,336,2448,12.9,0.34092844
19858,19858,Murray Craven,1985-86,21.0,4,61,80,80,26,35,61,145.0,,126,30,46,76,174.0,80,7.77,71,321,2447,12.7,0.7870805
19859,19859,Murray Craven,1986-87,22.0,5,54,78,78,21,33,54,182.0,,204,51,79,130,356.0,80,7.94,82,370,2484,12.8,0.72090673
19860,19860,Murray Craven,1987-88,23.0,6,49,77,77,19,30,49,100.0,,281,70,109,179,456.0,80,7.34,72,344,2400,12.2,0.65611744
19861,19861,Murray Craven,1988-89,24.0,7,76,72,72,30,46,76,184.0,,353,100,155,255,640.0,80,7.43,89,437,2435,12.2,0.8966758
19862,19862,Murray Craven,1989-90,25.0,8,37,51,51,9,28,37,89.0,,404,109,183,292,729.0,80,7.48,85,403,2430,12.3,0.66123617
19863,19863,Murray Craven,1990-91,26.0,9,75,76,76,25,50,75,175.0,,480,134,233,367,904.0,80,7.37,76,367,2421,12.2,0.8826344
19864,19864,Murray Craven,1991-92,27.0,10,66,77,77,19,47,66,170.0,,557,153,280,433,1074.0,80,6.91,71,366,2385,11.6,0.8331097
19865,19865,Murray Craven,1992-93,28.0,11,60,73,73,27,33,60,152.0,,630,180,313,493,1226.0,80,6.96,77,402,2440,11.4,0.7698909
19866,19866,Murray Craven,1993-94,29.0,12,77,77,77,25,52,77,151.0,,707,205,365,570,1377.0,84,7.25,87,443,2603,11.7,0.7767248
19867,19867,Murray Craven,1994-95,30.0,13,55,78,78,15,40,55,115.0,,785,220,405,625,1492.0,84,6.48,76,407,2545,10.7,0.6140625
19868,19868,Murray Craven,1995-96,31.0,14,7,16,16,4,3,7,29.0,,801,224,408,632,1521.0,48,5.97,37,209,1408,10.2,0.60877955
19869,19869,Murray Craven,1996-97,32.0,15,47,66,66,18,29,47,86.0,,867,242,437,679,1607.0,82,6.29,74,413,2481,10.4,0.54565537
19870,19870,Murray Craven,1997-98,33.0,16,35,75,75,8,27,35,122.0,,942,250,464,714,1729.0,82,5.83,55,336,2444,9.8,0.36361423
19871,19871,Murray Craven,1998-99,34.0,17,29,67,67,12,17,29,107.0,,1009,262,481,743,1836.0,82,5.28,57,380,2242,9.6,0.3687106
19872,19872,Murray Craven,1999-00,35.0,18,14,43,43,4,10,14,55.0,621.0,1052,266,491,757,1891.0,82,5.27,57,359,2285,9.4,0.29498327
19873,19873,Murray Craven,2000-01,36.0,19,2,19,19,0,2,2,18.0,249.0,1071,266,493,759,1909.0,82,5.49,53,331,2294,9.8,0.29184046
19874,19874,Murray Eaves,1981-82,21.0,2,3,12,12,1,2,3,12.0,,12,1,2,3,12.0,80,7.69,77,340,2441,12.6,0.32225013
19875,19875,Murray Eaves,1982-83,22.0,3,0,2,2,0,0,0,0.0,,14,1,2,3,12.0,80,8.03,73,320,2489,12.9,0.215922
19876,19876,Murray Eaves,1983-84,23.0,4,9,26,26,2,7,9,17.0,,40,3,9,12,29.0,80,7.73,71,310,2444,12.7,0.2904199
19877,19877,Murray Eaves,1984-85,24.0,5,0,2,2,0,0,0,1.0,,42,3,9,12,30.0,80,7.89,74,336,2448,12.9,0.19954589
19878,19878,Murray Eaves,1985-86,25.0,6,3,3,3,0,3,3,2.0,,45,3,12,15,32.0,80,7.77,71,321,2447,12.7,0.23276588
19879,19879,Murray Eaves,1986-87,26.0,7,1,4,4,1,0,1,6.0,,49,4,12,16,38.0,80,7.94,82,370,2484,12.8,0.21614817
19880,19880,Murray Eaves,1988-89,28.0,8,1,7,7,0,1,1,4.0,,56,4,13,17,42.0,80,7.43,89,437,2435,12.2,0.17552593
19881,19881,Murray Eaves,1990-91,30.0,9,0,1,1,0,0,0,2.0,,57,4,13,17,44.0,80,7.37,76,367,2421,12.2,0.16937026
19882,19882,Myles O'Connor,1991-92,24.0,2,4,22,22,3,1,4,14.0,,22,3,1,4,14.0,80,6.91,71,366,2385,11.6,0.2546575
19883,19883,Myles O'Connor,1992-93,25.0,3,2,9,9,0,2,2,13.0,,31,3,3,6,27.0,80,6.96,77,402,2440,11.4,0.22183397
19884,19884,Myles O'Connor,1993-94,26.0,4,0,7,7,0,0,0,4.0,,38,3,3,6,31.0,84,7.25,87,443,2603,11.7,0.18983826
19885,19885,Myles O'Connor,1994-95,27.0,5,1,5,5,0,1,1,7.0,,43,3,4,7,38.0,84,6.48,76,407,2545,10.7,0.13565081
19886,19886,Nail Yakupov,2013-14,20.0,2,31,48,48,17,14,31,81.0,699.0,48,17,14,31,81.0,48,5.31,29,160,1399,9.1,0.58799946
19887,19887,Nail Yakupov,2014-15,21.0,3,24,63,63,11,13,24,122.0,902.0,111,28,27,55,203.0,82,5.34,48,269,2463,8.9,0.42811805
19888,19888,Nail Yakupov,2015-16,22.0,4,33,81,81,14,19,33,191.0,1251.0,192,42,46,88,394.0,82,5.32,47,251,2453,8.9,0.482714
19889,19889,Nail Yakupov,2016-17,23.0,5,23,60,60,8,15,23,127.0,853.0,252,50,61,111,521.0,82,5.34,48,255,2438,9.0,0.46336496
19890,19890,Nail Yakupov,2017-18,24.0,6,9,40,40,3,6,9,35.0,426.0,292,53,67,120,556.0,82,5.45,47,245,2478,9.0,0.2917783
19891,19891,Nail Yakupov,2018-19,25.0,7,16,58,58,9,7,16,94.0,629.0,350,62,74,136,650.0,82,5.86,50,250,2620,9.2,0.32602316
19892,19892,Nate Guenin,2007-08,25.0,2,2,9,9,0,2,2,0.0,78.0,9,0,2,2,0.0,82,5.76,70,398,2426,9.7,0.15594074
19893,19893,Nate Guenin,2008-09,26.0,3,0,2,2,0,0,0,0.0,20.0,11,0,2,2,0.0,82,5.44,62,351,2383,9.4,0.15354764
19894,19894,Nate Guenin,2009-10,27.0,4,0,1,1,0,0,0,0.0,13.0,12,0,2,2,0.0,82,5.7,65,341,2477,9.4,0.13506451
19895,19895,Nate Guenin,2010-11,28.0,5,0,2,2,0,0,0,1.0,27.0,14,0,2,2,1.0,82,5.53,56,304,2486,9.1,0.12849009
19896,19896,Nate Guenin,2011-12,29.0,6,0,3,3,0,0,0,2.0,44.0,17,0,2,2,3.0,82,5.46,52,291,2492,9.0,0.13938075
19897,19897,Nate Guenin,2012-13,30.0,7,2,15,15,2,0,2,5.0,167.0,32,2,2,4,8.0,82,5.32,47,271,2439,8.9,0.16536826
19898,19898,Nate Guenin,2014-15,32.0,8,9,68,68,1,8,9,52.0,1175.0,100,3,10,13,60.0,82,5.34,48,269,2463,8.9,0.12296349
19899,19899,Nate Guenin,2015-16,33.0,9,15,76,76,2,13,15,38.0,1280.0,176,5,23,28,98.0,82,5.32,47,251,2453,8.9,0.12000987
19900,19900,Nate Guenin,2016-17,34.0,10,0,29,29,0,0,0,10.0,379.0,205,5,23,28,108.0,82,5.34,48,255,2438,9.0,0.081623286
19901,19901,Nate Prosser,2010-11,24.0,2,1,3,3,0,1,1,4.0,59.0,3,0,1,1,4.0,82,5.53,56,304,2486,9.1,0.18983117
19902,19902,Nate Prosser,2011-12,25.0,3,0,2,2,0,0,0,1.0,30.0,5,0,1,1,5.0,82,5.46,52,291,2492,9.0,0.1539371
19903,19903,Nate Prosser,2012-13,26.0,4,12,51,51,1,11,12,32.0,982.0,56,1,12,13,37.0,82,5.32,47,271,2439,8.9,0.1479019
19904,19904,Nate Prosser,2013-14,27.0,5,0,17,17,0,0,0,5.0,191.0,73,1,12,13,42.0,48,5.31,29,160,1399,9.1,0.1388624
19905,19905,Nate Prosser,2014-15,28.0,6,8,53,53,2,6,8,30.0,770.0,126,3,18,21,72.0,82,5.34,48,269,2463,8.9,0.101451546
19906,19906,Nate Prosser,2015-16,29.0,7,7,63,63,2,5,7,38.0,806.0,189,5,23,28,110.0,82,5.32,47,251,2453,8.9,0.1242159
19907,19907,Nate Prosser,2016-17,30.0,8,3,54,54,0,3,3,20.0,615.0,243,5,26,31,130.0,82,5.34,48,255,2438,9.0,0.07211536
19908,19908,Nate Prosser,2017-18,31.0,9,7,39,39,2,5,7,20.0,496.0,282,7,31,38,150.0,82,5.45,47,245,2478,9.0,0.1099655
19909,19909,Nate Prosser,2018-19,32.0,10,9,57,57,3,6,9,27.0,767.0,339,10,37,47,177.0,82,5.86,50,250,2620,9.2,0.10002872
19910,19910,Nate Prosser,2019-20,33.0,11,0,15,15,0,0,0,10.0,153.0,354,10,37,47,187.0,82,5.96,47,239,2579,9.5,0.12899795
19911,19911,Nate Raduns,2009-10,25.0,2,0,1,1,0,0,0,0.0,6.0,1,0,0,0,0.0,82,5.7,65,341,2477,9.4,0.1539588
19912,19912,Nate Schmidt,2014-15,23.0,2,6,29,29,2,4,6,41.0,542.0,29,2,4,6,41.0,82,5.34,48,269,2463,8.9,0.24451208
19913,19913,Nate Schmidt,2015-16,24.0,3,4,39,39,1,3,4,40.0,542.0,68,3,7,10,81.0,82,5.32,47,251,2453,8.9,0.17005154
19914,19914,Nate Schmidt,2016-17,25.0,4,16,72,72,2,14,16,80.0,1301.0,140,5,21,26,161.0,82,5.34,48,255,2438,9.0,0.21355474
19915,19915,Nate Schmidt,2017-18,26.0,5,17,60,60,3,14,17,60.0,929.0,200,8,35,43,221.0,82,5.45,47,245,2478,9.0,0.240168
19916,19916,Nate Schmidt,2018-19,27.0,6,36,76,76,5,31,36,103.0,1690.0,276,13,66,79,324.0,82,5.86,50,250,2620,9.2,0.38244358
19917,19917,Nate Schmidt,2019-20,28.0,7,30,61,61,9,21,30,112.0,1339.0,337,22,87,109,436.0,82,5.96,47,239,2579,9.5,0.4527078
19918,19918,Nate Schmidt,2020-21,29.0,8,31,59,59,7,24,31,112.0,1279.0,396,29,111,140,548.0,70,5.96,42,208,2192,9.5,0.49163634
19919,19919,Nate Thompson,2007-08,23.0,2,0,4,4,0,0,0,5.0,19.0,4,0,0,0,5.0,82,5.76,70,398,2426,9.7,0.17841864
19920,19920,Nate Thompson,2009-10,25.0,3,4,43,43,2,2,4,56.0,520.0,47,2,2,4,61.0,82,5.7,65,341,2477,9.4,0.16913795
19921,19921,Nate Thompson,2010-11,26.0,4,10,71,71,2,8,10,92.0,951.0,118,4,10,14,153.0,82,5.53,56,304,2486,9.1,0.20157987
19922,19922,Nate Thompson,2011-12,27.0,5,25,79,79,10,15,25,123.0,1192.0,197,14,25,39,276.0,82,5.46,52,291,2492,9.0,0.2665833
19923,19923,Nate Thompson,2012-13,28.0,6,15,68,68,9,6,15,85.0,1008.0,265,23,31,54,361.0,82,5.32,47,271,2439,8.9,0.2165235
19924,19924,Nate Thompson,2013-14,29.0,7,15,45,45,7,8,15,58.0,645.0,310,30,39,69,419.0,48,5.31,29,160,1399,9.1,0.28937835
19925,19925,Nate Thompson,2014-15,30.0,8,16,81,81,9,7,16,105.0,1042.0,391,39,46,85,524.0,82,5.34,48,269,2463,8.9,0.22783479
19926,19926,Nate Thompson,2015-16,31.0,9,18,80,80,5,13,18,87.0,1066.0,471,44,59,103,611.0,82,5.32,47,251,2453,8.9,0.2124418
19927,19927,Nate Thompson,2016-17,32.0,10,6,49,49,3,3,6,42.0,568.0,520,47,62,109,653.0,82,5.34,48,255,2438,9.0,0.1555224
19928,19928,Nate Thompson,2017-18,33.0,11,2,30,30,1,1,2,19.0,312.0,550,48,63,111,672.0,82,5.45,47,245,2478,9.0,0.13188604
19929,19929,Nate Thompson,2018-19,34.0,12,17,69,69,5,12,17,53.0,881.0,619,53,75,128,725.0,82,5.86,50,250,2620,9.2,0.17565799
19930,19930,Nate Thompson,2019-20,35.0,13,13,78,78,5,8,13,71.0,1014.0,697,58,83,141,796.0,82,5.96,47,239,2579,9.5,0.15156019
19931,19931,Nate Thompson,2020-21,36.0,14,15,70,70,4,11,15,67.0,895.0,767,62,94,156,863.0,70,5.96,42,208,2192,9.5,0.19766188
19932,19932,Nathan Bastian,2019-20,22.0,2,3,7,7,3,0,3,13.0,89.0,7,3,0,3,13.0,82,5.96,47,239,2579,9.5,0.2834099
19933,19933,Nathan Beaulieu,2013-14,21.0,2,2,6,6,0,2,2,8.0,92.0,6,0,2,2,8.0,48,5.31,29,160,1399,9.1,0.261376
19934,19934,Nathan Beaulieu,2014-15,22.0,3,2,17,17,0,2,2,15.0,225.0,23,0,4,4,23.0,82,5.34,48,269,2463,8.9,0.17726392
19935,19935,Nathan Beaulieu,2015-16,23.0,4,9,64,64,1,8,9,62.0,1005.0,87,1,12,13,85.0,82,5.32,47,251,2453,8.9,0.18533796
19936,19936,Nathan Beaulieu,2016-17,24.0,5,19,64,64,2,17,19,74.0,1117.0,151,3,29,32,159.0,82,5.34,48,255,2438,9.0,0.2444531
19937,19937,Nathan Beaulieu,2017-18,25.0,6,28,74,74,4,24,28,118.0,1442.0,225,7,53,60,277.0,82,5.45,47,245,2478,9.0,0.34575737
19938,19938,Nathan Beaulieu,2018-19,26.0,7,9,59,59,1,8,9,67.0,941.0,284,8,61,69,344.0,82,5.86,50,250,2620,9.2,0.16047505
19939,19939,Nathan Beaulieu,2019-20,27.0,8,12,48,48,3,9,12,60.0,744.0,332,11,70,81,404.0,82,5.96,47,239,2579,9.5,0.20860443
19940,19940,Nathan Beaulieu,2020-21,28.0,9,8,38,38,1,7,8,38.0,646.0,370,12,77,89,442.0,70,5.96,42,208,2192,9.5,0.19060531
19941,19941,Nathan Dempsey,1997-98,23.0,2,2,14,14,1,1,2,11.0,,14,1,1,2,11.0,82,5.83,55,336,2444,9.8,0.21799186
19942,19942,Nathan Dempsey,2000-01,26.0,3,2,6,6,0,2,2,3.0,82.0,20,1,3,4,14.0,82,5.49,53,331,2294,9.8,0.16320387
19943,19943,Nathan Dempsey,2001-02,27.0,4,10,25,25,1,9,10,31.0,397.0,45,2,12,14,45.0,82,5.51,63,376,2272,9.9,0.18495405
19944,19944,Nathan Dempsey,2002-03,28.0,5,0,3,3,0,0,0,3.0,42.0,48,2,12,14,48.0,82,5.24,53,338,2262,9.5,0.14346826
19945,19945,Nathan Dempsey,2003-04,29.0,6,28,67,67,5,23,28,124.0,1401.0,115,7,35,42,172.0,82,5.31,60,363,2326,9.4,0.37764686
19946,19946,Nathan Dempsey,2004-05,30.0,7,32,75,75,12,20,32,183.0,1726.0,190,19,55,74,355.0,82,5.14,57,348,2300,9.2,0.5095286
19947,19947,Nathan Dempsey,2006-07,32.0,8,13,53,53,2,11,13,58.0,1015.0,243,21,66,87,413.0,82,6.05,85,480,2458,10.1,0.19970018
19948,19948,Nathan Dempsey,2007-08,33.0,9,1,17,17,0,1,1,4.0,169.0,260,21,67,88,417.0,82,5.76,70,398,2426,9.7,0.17899665
19949,19949,Nathan Gerbe,2009-10,22.0,2,1,10,10,0,1,1,24.0,136.0,10,0,1,1,24.0,82,5.7,65,341,2477,9.4,0.26343322
19950,19950,Nathan Gerbe,2010-11,23.0,3,5,10,10,2,3,5,29.0,146.0,20,2,4,6,53.0,82,5.53,56,304,2486,9.1,0.29600918
19951,19951,Nathan Gerbe,2011-12,24.0,4,31,64,64,16,15,31,171.0,853.0,84,18,19,37,224.0,82,5.46,52,291,2492,9.0,0.50739735
19952,19952,Nathan Gerbe,2012-13,25.0,5,25,62,62,6,19,25,137.0,881.0,146,24,38,62,361.0,82,5.32,47,271,2439,8.9,0.39033818
19953,19953,Nathan Gerbe,2013-14,26.0,6,10,42,42,5,5,10,64.0,525.0,188,29,43,72,425.0,48,5.31,29,160,1399,9.1,0.31331834
19954,19954,Nathan Gerbe,2014-15,27.0,7,31,81,81,16,15,31,221.0,1329.0,269,45,58,103,646.0,82,5.34,48,269,2463,8.9,0.47174653
19955,19955,Nathan Gerbe,2015-16,28.0,8,28,78,78,10,18,28,235.0,1283.0,347,55,76,131,881.0,82,5.32,47,251,2453,8.9,0.33001345
19956,19956,Nathan Gerbe,2016-17,29.0,9,7,47,47,3,4,7,73.0,633.0,394,58,80,138,954.0,82,5.34,48,255,2438,9.0,0.224778
19957,19957,Nathan Gerbe,2018-19,31.0,10,0,2,2,0,0,0,1.0,17.0,396,58,80,138,955.0,82,5.86,50,250,2620,9.2,0.22112742
19958,19958,Nathan Gerbe,2020-21,33.0,11,10,30,30,4,6,10,55.0,413.0,426,62,86,148,1010.0,70,5.96,42,208,2192,9.5,0.25990853
19959,19959,Nathan Horton,2004-05,19.0,2,22,55,55,14,8,22,81.0,733.0,55,14,8,22,81.0,82,5.14,57,348,2300,9.2,0.57881546
19960,19960,Nathan Horton,2006-07,21.0,3,47,71,71,28,19,47,162.0,1199.0,126,42,27,69,243.0,82,6.05,85,480,2458,10.1,0.74629897
19961,19961,Nathan Horton,2007-08,22.0,4,62,82,82,31,31,62,217.0,1481.0,208,73,58,131,460.0,82,5.76,70,398,2426,9.7,0.77554387
19962,19962,Nathan Horton,2008-09,23.0,5,62,82,82,27,35,62,212.0,1537.0,290,100,93,193,672.0,82,5.44,62,351,2383,9.4,0.8165585
19963,19963,Nathan Horton,2009-10,24.0,6,45,67,67,22,23,45,131.0,1196.0,357,122,116,238,803.0,82,5.7,65,341,2477,9.4,0.6981392
19964,19964,Nathan Horton,2010-11,25.0,7,57,65,65,20,37,57,159.0,1358.0,422,142,153,295,962.0,82,5.53,56,304,2486,9.1,0.7439122
19965,19965,Nathan Horton,2011-12,26.0,8,53,80,80,26,27,53,188.0,1303.0,502,168,180,348,1150.0,82,5.46,52,291,2492,9.0,0.70865405
19966,19966,Nathan Horton,2012-13,27.0,9,32,46,46,17,15,32,90.0,733.0,548,185,195,380,1240.0,82,5.32,47,271,2439,8.9,0.6141872
19967,19967,Nathan Horton,2013-14,28.0,10,22,43,43,13,9,22,114.0,725.0,591,198,204,402,1354.0,48,5.31,29,160,1399,9.1,0.55153817
19968,19968,Nathan Horton,2014-15,29.0,11,19,36,36,5,14,19,48.0,556.0,627,203,218,421,1402.0,82,5.34,48,269,2463,8.9,0.5272083
19969,19969,Nathan LaFayette,1994-95,21.0,2,7,49,49,3,4,7,34.0,,49,3,4,7,34.0,84,6.48,76,407,2545,10.7,0.23662016
19970,19970,Nathan LaFayette,1995-96,22.0,3,8,39,39,4,4,8,35.0,,88,7,8,15,69.0,48,5.97,37,209,1408,10.2,0.2596746
19971,19971,Nathan LaFayette,1996-97,23.0,4,6,17,17,2,4,6,28.0,,105,9,12,21,97.0,82,6.29,74,413,2481,10.4,0.3129257
19972,19972,Nathan LaFayette,1997-98,24.0,5,4,15,15,1,3,4,26.0,,120,10,15,25,123.0,82,5.83,55,336,2444,9.8,0.23016739
19973,19973,Nathan LaFayette,1998-99,25.0,6,8,34,34,5,3,8,60.0,,154,15,18,33,183.0,82,5.28,57,380,2242,9.6,0.24641046
19974,19974,Nathan LaFayette,1999-00,26.0,7,4,33,33,2,2,4,42.0,391.0,187,17,20,37,225.0,82,5.27,57,359,2285,9.4,0.20317304
19975,19975,Nathan MacKinnon,2014-15,19.0,2,63,82,82,24,39,63,241.0,1422.0,82,24,39,63,241.0,82,5.34,48,269,2463,8.9,0.7755029
19976,19976,Nathan MacKinnon,2015-16,20.0,3,38,64,64,14,24,38,192.0,1091.0,146,38,63,101,433.0,82,5.32,47,251,2453,8.9,0.6208911
19977,19977,Nathan MacKinnon,2016-17,21.0,4,52,72,72,21,31,52,245.0,1358.0,218,59,94,153,678.0,82,5.34,48,255,2438,9.0,0.72795445
19978,19978,Nathan MacKinnon,2017-18,22.0,5,53,82,82,16,37,53,251.0,1635.0,300,75,131,206,929.0,82,5.45,47,245,2478,9.0,0.78851193
19979,19979,Nathan MacKinnon,2018-19,23.0,6,97,74,74,39,58,97,284.0,1473.0,374,114,189,303,1213.0,82,5.86,50,250,2620,9.2,1.1807711
19980,19980,Nathan MacKinnon,2019-20,24.0,7,99,82,82,41,58,99,365.0,1812.0,456,155,247,402,1578.0,82,5.96,47,239,2579,9.5,1.1050104
19981,19981,Nathan MacKinnon,2020-21,25.0,8,93,69,69,35,58,93,318.0,1464.0,525,190,305,495,1896.0,70,5.96,42,208,2192,9.5,1.1969533
19982,19982,Nathan McIver,2007-08,23.0,2,0,1,1,0,0,0,0.0,11.0,1,0,0,0,0.0,82,5.76,70,398,2426,9.7,0.15239856
19983,19983,Nathan McIver,2008-09,24.0,3,0,17,17,0,0,0,9.0,178.0,18,0,0,0,9.0,82,5.44,62,351,2383,9.4,0.14952433
19984,19984,Nathan McIver,2009-10,25.0,4,1,18,18,0,1,1,5.0,169.0,36,0,1,1,14.0,82,5.7,65,341,2477,9.4,0.14224643
19985,19985,Nathan Oystrick,2009-10,27.0,2,12,53,53,4,8,12,43.0,834.0,53,4,8,12,43.0,82,5.7,65,341,2477,9.4,0.19129539
19986,19986,Nathan Oystrick,2010-11,28.0,3,0,3,3,0,0,0,1.0,32.0,56,4,8,12,44.0,82,5.53,56,304,2486,9.1,0.14285004
19987,19987,Nathan Oystrick,2011-12,29.0,4,3,9,9,1,2,3,11.0,110.0,65,5,10,15,55.0,82,5.46,52,291,2492,9.0,0.18200877
19988,19988,Nathan Paetsch,2006-07,23.0,2,1,1,1,0,1,1,0.0,16.0,1,0,1,1,0.0,82,6.05,85,480,2458,10.1,0.20011985
19989,19989,Nathan Paetsch,2007-08,24.0,3,24,63,63,2,22,24,62.0,961.0,64,2,23,25,62.0,82,5.76,70,398,2426,9.7,0.29048514
19990,19990,Nathan Paetsch,2008-09,25.0,4,9,59,59,2,7,9,49.0,804.0,123,4,30,34,111.0,82,5.44,62,351,2383,9.4,0.17999962
19991,19991,Nathan Paetsch,2009-10,26.0,5,6,23,23,2,4,6,21.0,280.0,146,6,34,40,132.0,82,5.7,65,341,2477,9.4,0.21505758
19992,19992,Nathan Paetsch,2010-11,27.0,6,2,21,21,1,1,2,17.0,219.0,167,7,35,42,149.0,82,5.53,56,304,2486,9.1,0.13583693
19993,19993,Nathan Perrott,2002-03,26.0,2,3,22,22,1,2,3,7.0,108.0,22,1,2,3,7.0,82,5.24,53,338,2262,9.5,0.13445505
19994,19994,Nathan Perrott,2003-04,27.0,3,0,1,1,0,0,0,0.0,4.0,23,1,2,3,7.0,82,5.31,60,363,2326,9.4,0.14757007
19995,19995,Nathan Perrott,2004-05,28.0,4,3,40,40,1,2,3,47.0,307.0,63,2,4,6,54.0,82,5.14,57,348,2300,9.2,0.16472471
19996,19996,Nathan Perrott,2006-07,30.0,5,3,26,26,2,1,3,19.0,143.0,89,4,5,9,73.0,82,6.05,85,480,2458,10.1,0.15952972
19997,19997,Nathan Robinson,2004-05,23.0,2,0,5,5,0,0,0,5.0,30.0,5,0,0,0,5.0,82,5.14,57,348,2300,9.2,0.20593247
19998,19998,Nathan Robinson,2006-07,25.0,3,0,2,2,0,0,0,1.0,7.0,7,0,0,0,6.0,82,6.05,85,480,2458,10.1,0.16085511
19999,19999,Nathan Smith,2004-05,22.0,2,0,2,2,0,0,0,1.0,11.0,2,0,0,0,1.0,82,5.14,57,348,2300,9.2,0.22404626
20000,20000,Nathan Smith,2006-07,24.0,3,0,1,1,0,0,0,2.0,11.0,3,0,0,0,3.0,82,6.05,85,480,2458,10.1,0.16514125
20001,20001,Nathan Smith,2007-08,25.0,4,0,1,1,0,0,0,0.0,9.0,4,0,0,0,3.0,82,5.76,70,398,2426,9.7,0.15585825
20002,20002,Nathan Smith,2008-09,26.0,5,0,13,13,0,0,0,3.0,100.0,17,0,0,0,6.0,82,5.44,62,351,2383,9.4,0.13758406
20003,20003,Nathan Smith,2010-11,28.0,6,0,9,9,0,0,0,4.0,71.0,26,0,0,0,10.0,82,5.53,56,304,2486,9.1,0.13119036
20004,20004,Nathan Walker,2018-19,24.0,2,1,9,9,1,0,1,6.0,85.0,9,1,0,1,6.0,82,5.86,50,250,2620,9.2,0.2020486
20005,20005,Nathan Walker,2019-20,25.0,3,1,3,3,0,1,1,2.0,24.0,12,1,1,2,8.0,82,5.96,47,239,2579,9.5,0.18880355
20006,20006,Nathan Walker,2020-21,26.0,4,2,5,5,1,1,2,6.0,56.0,17,2,2,4,14.0,70,5.96,42,208,2192,9.5,0.20917886
20007,20007,Nazem Kadri,2010-11,20.0,2,0,1,1,0,0,0,0.0,17.0,1,0,0,0,0.0,82,5.53,56,304,2486,9.1,0.23860925
20008,20008,Nazem Kadri,2011-12,21.0,3,12,29,29,3,9,12,51.0,457.0,30,3,9,12,51.0,82,5.46,52,291,2492,9.0,0.31770435
20009,20009,Nazem Kadri,2012-13,22.0,4,7,21,21,5,2,7,28.0,297.0,51,8,11,19,79.0,82,5.32,47,271,2439,8.9,0.3438542
20010,20010,Nazem Kadri,2013-14,23.0,5,44,48,48,18,26,44,107.0,771.0,99,26,37,63,186.0,48,5.31,29,160,1399,9.1,0.700551
20011,20011,Nazem Kadri,2014-15,24.0,6,50,78,78,20,30,50,148.0,1356.0,177,46,67,113,334.0,82,5.34,48,269,2463,8.9,0.5819214
20012,20012,Nazem Kadri,2015-16,25.0,7,39,73,73,18,21,39,176.0,1285.0,250,64,88,152,510.0,82,5.32,47,251,2453,8.9,0.55330783
20013,20013,Nazem Kadri,2016-17,26.0,8,45,76,76,17,28,45,260.0,1389.0,326,81,116,197,770.0,82,5.34,48,255,2438,9.0,0.6180787
20014,20014,Nazem Kadri,2017-18,27.0,9,61,82,82,32,29,61,236.0,1360.0,408,113,145,258,1006.0,82,5.45,47,245,2478,9.0,0.68872005
20015,20015,Nazem Kadri,2018-19,28.0,10,55,80,80,32,23,55,211.0,1341.0,488,145,168,313,1217.0,82,5.86,50,250,2620,9.2,0.669513
20016,20016,Nazem Kadri,2019-20,29.0,11,44,73,73,16,28,44,184.0,1182.0,561,161,196,357,1401.0,82,5.96,47,239,2579,9.5,0.60781336
20017,20017,Nazem Kadri,2020-21,30.0,12,36,51,51,19,17,36,133.0,889.0,612,180,213,393,1534.0,70,5.96,42,208,2192,9.5,0.6327145
20018,20018,Neal Broten,1981-82,22.0,2,2,3,3,2,0,2,6.0,,3,2,0,2,6.0,80,7.69,77,340,2441,12.6,0.5120872
20019,20019,Neal Broten,1982-83,23.0,3,98,73,73,38,60,98,188.0,,76,40,60,100,194.0,80,8.03,73,320,2489,12.9,1.1298892
20020,20020,Neal Broten,1983-84,24.0,4,77,79,79,32,45,77,163.0,,155,72,105,177,357.0,80,7.73,71,310,2444,12.7,0.92600346
20021,20021,Neal Broten,1984-85,25.0,5,89,76,76,28,61,89,185.0,,231,100,166,266,542.0,80,7.89,74,336,2448,12.9,1.0223567
20022,20022,Neal Broten,1985-86,26.0,6,56,80,80,19,37,56,187.0,,311,119,203,322,729.0,80,7.77,71,321,2447,12.7,0.7998773
20023,20023,Neal Broten,1986-87,27.0,7,105,80,80,29,76,105,193.0,,391,148,279,427,922.0,80,7.94,82,370,2484,12.8,1.176296
20024,20024,Neal Broten,1987-88,28.0,8,53,46,46,18,35,53,112.0,,437,166,314,480,1034.0,80,7.34,72,344,2400,12.2,0.93311
20025,20025,Neal Broten,1988-89,29.0,9,39,54,54,9,30,39,121.0,,491,175,344,519,1155.0,80,7.43,89,437,2435,12.2,0.765327
20026,20026,Neal Broten,1989-90,30.0,10,56,68,68,18,38,56,160.0,,559,193,382,575,1315.0,80,7.48,85,403,2430,12.3,0.82574743
20027,20027,Neal Broten,1990-91,31.0,11,85,80,80,23,62,85,212.0,,639,216,444,660,1527.0,80,7.37,76,367,2421,12.2,0.9918474
20028,20028,Neal Broten,1991-92,32.0,12,69,79,79,13,56,69,191.0,,718,229,500,729,1718.0,80,6.91,71,366,2385,11.6,0.7882746
20029,20029,Neal Broten,1992-93,33.0,13,34,76,76,8,26,34,119.0,,794,237,526,763,1837.0,80,6.96,77,402,2440,11.4,0.46792334
20030,20030,Neal Broten,1993-94,34.0,14,33,82,82,12,21,33,123.0,,876,249,547,796,1960.0,84,7.25,87,443,2603,11.7,0.4372175
20031,20031,Neal Broten,1994-95,35.0,15,52,79,79,17,35,52,153.0,,955,266,582,848,2113.0,84,6.48,76,407,2545,10.7,0.5753825
20032,20032,Neal Broten,1995-96,36.0,16,32,47,47,8,24,32,72.0,,1002,274,606,880,2185.0,48,5.97,37,209,1408,10.2,0.56595606
20033,20033,Neal Broten,1996-97,37.0,17,23,55,55,7,16,23,73.0,,1057,281,622,903,2258.0,82,6.29,74,413,2481,10.4,0.3818785
20034,20034,Neal Broten,1997-98,38.0,18,20,42,42,8,12,20,55.0,,1099,289,634,923,2313.0,82,5.83,55,336,2444,9.8,0.43177956
20035,20035,Neal Coulter,1986-87,24.0,2,7,16,16,3,4,7,17.0,,16,3,4,7,17.0,80,7.94,82,370,2484,12.8,0.3305545
20036,20036,Neal Coulter,1987-88,25.0,3,3,9,9,2,1,3,5.0,,25,5,5,10,22.0,80,7.34,72,344,2400,12.2,0.284265
20037,20037,Neal Coulter,1988-89,26.0,4,0,1,1,0,0,0,0.0,,26,5,5,10,22.0,80,7.43,89,437,2435,12.2,0.18176436
20038,20038,Neal Pionk,2018-19,23.0,2,14,28,28,1,13,14,54.0,627.0,28,1,13,14,54.0,82,5.86,50,250,2620,9.2,0.26443464
20039,20039,Neal Pionk,2019-20,24.0,3,26,73,73,6,20,26,132.0,1545.0,101,7,33,40,186.0,82,5.96,47,239,2579,9.5,0.3729195
20040,20040,Neal Pionk,2020-21,25.0,4,45,71,71,6,39,45,177.0,1660.0,172,13,72,85,363.0,70,5.96,42,208,2192,9.5,0.5737176
20041,20041,Neil Belland,1982-83,21.0,2,9,28,28,3,6,9,33.0,,28,3,6,9,33.0,80,8.03,73,320,2489,12.9,0.38364023
20042,20042,Neil Belland,1983-84,22.0,3,6,14,14,2,4,6,13.0,,42,5,10,15,46.0,80,7.73,71,310,2444,12.7,0.32960194
20043,20043,Neil Belland,1984-85,23.0,4,20,44,44,7,13,20,84.0,,86,12,23,35,130.0,80,7.89,74,336,2448,12.9,0.48085082
20044,20044,Neil Belland,1985-86,24.0,5,6,13,13,0,6,6,22.0,,99,12,29,41,152.0,80,7.77,71,321,2447,12.7,0.333831
20045,20045,Neil Belland,1986-87,25.0,6,3,7,7,1,2,3,10.0,,106,13,31,44,162.0,80,7.94,82,370,2484,12.8,0.29408172
20046,20046,Neil Belland,1987-88,26.0,7,1,3,3,0,1,1,4.0,,109,13,32,45,166.0,80,7.34,72,344,2400,12.2,0.27514845
20047,20047,Neil Brady,1990-91,22.0,2,5,19,19,1,4,5,10.0,,19,1,4,5,10.0,80,7.37,76,367,2421,12.2,0.21619782
20048,20048,Neil Brady,1991-92,23.0,3,0,3,3,0,0,0,6.0,,22,1,4,5,16.0,80,6.91,71,366,2385,11.6,0.19098368
20049,20049,Neil Brady,1992-93,24.0,4,1,7,7,1,0,1,3.0,,29,2,4,6,19.0,80,6.96,77,402,2440,11.4,0.22074693
20050,20050,Neil Brady,1993-94,25.0,5,24,55,55,7,17,24,68.0,,84,9,21,30,87.0,84,7.25,87,443,2603,11.7,0.34919333
20051,20051,Neil Brady,1994-95,26.0,6,1,5,5,0,1,1,1.0,,89,9,22,31,88.0,84,6.48,76,407,2545,10.7,0.18600202
20052,20052,Neil Eisenhut,1994-95,27.0,2,4,13,13,1,3,4,13.0,,13,1,3,4,13.0,84,6.48,76,407,2545,10.7,0.22260427
20053,20053,Neil Eisenhut,1995-96,28.0,3,0,3,3,0,0,0,2.0,,16,1,3,4,15.0,48,5.97,37,209,1408,10.2,0.16629729
20054,20054,Neil Hawryliw,1982-83,27.0,2,0,1,1,0,0,0,0.0,,1,0,0,0,0.0,80,8.03,73,320,2489,12.9,0.23809254
20055,20055,Neil Sheehy,1984-85,24.0,2,1,1,1,1,0,1,1.0,,1,1,0,1,1.0,80,7.89,74,336,2448,12.9,0.26884606
20056,20056,Neil Sheehy,1985-86,25.0,3,7,31,31,3,4,7,42.0,,32,4,4,8,43.0,80,7.77,71,321,2447,12.7,0.27234292
20057,20057,Neil Sheehy,1986-87,26.0,4,18,65,65,2,16,18,59.0,,97,6,20,26,102.0,80,7.94,82,370,2484,12.8,0.2668308
20058,20058,Neil Sheehy,1987-88,27.0,5,10,54,54,4,6,10,45.0,,151,10,26,36,147.0,80,7.34,72,344,2400,12.2,0.24265131
20059,20059,Neil Sheehy,1988-89,28.0,6,13,62,62,3,10,13,40.0,,213,13,36,49,187.0,80,7.43,89,437,2435,12.2,0.22555807
20060,20060,Neil Sheehy,1989-90,29.0,7,7,72,72,3,4,7,22.0,,285,16,40,56,209.0,80,7.48,85,403,2430,12.3,0.1314843
20061,20061,Neil Sheehy,1990-91,30.0,8,6,59,59,1,5,6,32.0,,344,17,45,62,241.0,80,7.37,76,367,2421,12.2,0.1531941
20062,20062,Neil Sheehy,1992-93,32.0,9,3,35,35,1,2,3,19.0,,379,18,47,65,260.0,80,6.96,77,402,2440,11.4,0.14293799
20063,20063,Neil Wilkinson,1990-91,23.0,2,5,36,36,0,5,5,36.0,,36,0,5,5,36.0,80,7.37,76,367,2421,12.2,0.20554864
20064,20064,Neil Wilkinson,1991-92,24.0,3,11,50,50,2,9,11,55.0,,86,2,14,16,91.0,80,6.91,71,366,2385,11.6,0.2574227
20065,20065,Neil Wilkinson,1992-93,25.0,4,19,60,60,4,15,19,95.0,,146,6,29,35,186.0,80,6.96,77,402,2440,11.4,0.2767542
20066,20066,Neil Wilkinson,1993-94,26.0,5,8,59,59,1,7,8,51.0,,205,7,36,43,237.0,84,7.25,87,443,2603,11.7,0.17147446
20067,20067,Neil Wilkinson,1994-95,27.0,6,12,72,72,3,9,12,72.0,,277,10,45,55,309.0,84,6.48,76,407,2545,10.7,0.17973149
20068,20068,Neil Wilkinson,1995-96,28.0,7,5,40,40,1,4,5,25.0,,317,11,49,60,334.0,48,5.97,37,209,1408,10.2,0.14850292
20069,20069,Neil Wilkinson,1996-97,29.0,8,17,62,62,3,14,17,59.0,,379,14,63,77,393.0,82,6.29,74,413,2481,10.4,0.20312336
20070,20070,Neil Wilkinson,1997-98,30.0,9,0,23,23,0,0,0,16.0,,402,14,63,77,409.0,82,5.83,55,336,2444,9.8,0.14168444
20071,20071,Neil Wilkinson,1998-99,31.0,10,6,34,34,2,4,6,19.0,,436,16,67,83,428.0,82,5.28,57,380,2242,9.6,0.1646263
20072,20072,Neil Wilkinson,1999-00,32.0,11,0,24,24,0,0,0,11.0,239.0,460,16,67,83,439.0,82,5.27,57,359,2285,9.4,0.103051186
20073,20073,Nelson Emerson,1991-92,24.0,2,3,4,4,0,3,3,3.0,,4,0,3,3,3.0,80,6.91,71,366,2385,11.6,0.24152455
20074,20074,Nelson Emerson,1992-93,25.0,3,59,79,79,23,36,59,143.0,,83,23,39,62,146.0,80,6.96,77,402,2440,11.4,0.6687577
20075,20075,Nelson Emerson,1993-94,26.0,4,73,82,82,22,51,73,196.0,,165,45,90,135,342.0,84,7.25,87,443,2603,11.7,0.79485214
20076,20076,Nelson Emerson,1994-95,27.0,5,74,83,83,33,41,74,282.0,,248,78,131,209,624.0,84,6.48,76,407,2545,10.7,0.76588774
20077,20077,Nelson Emerson,1995-96,28.0,6,37,48,48,14,23,37,122.0,,296,92,154,246,746.0,48,5.97,37,209,1408,10.2,0.82846475
20078,20078,Nelson Emerson,1996-97,29.0,7,58,81,81,29,29,58,247.0,,377,121,183,304,993.0,82,6.29,74,413,2481,10.4,0.6700063
20079,20079,Nelson Emerson,1997-98,30.0,8,38,66,66,9,29,38,194.0,,443,130,212,342,1187.0,82,5.83,55,336,2444,9.8,0.56915057
20080,20080,Nelson Emerson,1998-99,31.0,9,45,81,81,21,24,45,203.0,,524,151,236,387,1390.0,82,5.28,57,380,2242,9.6,0.61168504
20081,20081,Nelson Emerson,1999-00,32.0,10,37,65,65,13,24,37,188.0,1088.0,589,164,260,424,1578.0,82,5.27,57,359,2285,9.4,0.5840257
20082,20082,Nelson Emerson,2000-01,33.0,11,35,63,63,15,20,35,196.0,1185.0,652,179,280,459,1774.0,82,5.49,53,331,2294,9.8,0.5513785
20083,20083,Nelson Emerson,2001-02,34.0,12,22,78,78,11,11,22,157.0,1080.0,730,190,291,481,1931.0,82,5.51,63,376,2272,9.9,0.30094212
20084,20084,Nelson Emerson,2002-03,35.0,13,7,41,41,5,2,7,40.0,377.0,771,195,293,488,1971.0,82,5.24,53,338,2262,9.5,0.26026702
20085,20085,Nelson Nogier,2017-18,21.0,2,0,10,10,0,0,0,8.0,117.0,10,0,0,0,8.0,82,5.45,47,245,2478,9.0,0.21723431
20086,20086,Nelson Nogier,2019-20,23.0,3,0,1,1,0,0,0,1.0,10.0,11,0,0,0,9.0,82,5.96,47,239,2579,9.5,0.17554525
20087,20087,Nevin Markwart,1984-85,20.0,2,30,70,70,14,16,30,66.0,,70,14,16,30,66.0,80,7.89,74,336,2448,12.9,0.4312464
20088,20088,Nevin Markwart,1985-86,21.0,3,4,26,26,0,4,4,5.0,,96,14,20,34,71.0,80,7.77,71,321,2447,12.7,0.37745747
20089,20089,Nevin Markwart,1986-87,22.0,4,22,65,65,7,15,22,44.0,,161,21,35,56,115.0,80,7.94,82,370,2484,12.8,0.366978
20090,20090,Nevin Markwart,1987-88,23.0,5,19,64,64,10,9,19,65.0,,225,31,44,75,180.0,80,7.34,72,344,2400,12.2,0.37315828
20091,20091,Nevin Markwart,1988-89,24.0,6,13,25,25,1,12,13,24.0,,250,32,56,88,204.0,80,7.43,89,437,2435,12.2,0.29866266
20092,20092,Nevin Markwart,1990-91,26.0,7,3,8,8,1,2,3,6.0,,258,33,58,91,210.0,80,7.37,76,367,2421,12.2,0.26754624
20093,20093,Nevin Markwart,1991-92,27.0,8,6,23,23,3,3,6,13.0,,281,36,61,97,223.0,80,6.91,71,366,2385,11.6,0.24885818
20094,20094,Nevin Markwart,1992-93,28.0,9,12,28,28,5,7,12,16.0,,309,41,68,109,239.0,80,6.96,77,402,2440,11.4,0.2997256
20095,20095,Nic Dowd,2016-17,26.0,2,0,5,5,0,0,0,3.0,53.0,5,0,0,0,3.0,82,5.34,48,255,2438,9.0,0.16531053
20096,20096,Nic Dowd,2017-18,27.0,3,22,70,70,6,16,22,78.0,872.0,75,6,16,22,81.0,82,5.45,47,245,2478,9.0,0.29626733
20097,20097,Nic Dowd,2018-19,28.0,4,4,56,56,3,1,4,51.0,590.0,131,9,17,26,132.0,82,5.86,50,250,2620,9.2,0.14117259
20098,20098,Nic Dowd,2019-20,29.0,5,22,64,64,8,14,22,47.0,659.0,195,17,31,48,179.0,82,5.96,47,239,2579,9.5,0.236749
20099,20099,Nic Dowd,2020-21,30.0,6,15,56,56,7,8,15,52.0,607.0,251,24,39,63,231.0,70,5.96,42,208,2192,9.5,0.28204122
20100,20100,Nic Petan,2016-17,21.0,2,6,26,26,2,4,6,25.0,305.0,26,2,4,6,25.0,82,5.34,48,255,2438,9.0,0.2849479
20101,20101,Nic Petan,2017-18,22.0,3,13,54,54,1,12,13,57.0,589.0,80,3,16,19,82.0,82,5.45,47,245,2478,9.0,0.2413033
20102,20102,Nic Petan,2018-19,23.0,4,2,15,15,2,0,2,16.0,126.0,95,5,16,21,98.0,82,5.86,50,250,2620,9.2,0.25587285
20103,20103,Nic Petan,2019-20,24.0,5,3,18,18,1,2,3,15.0,137.0,113,6,18,24,113.0,82,5.96,47,239,2579,9.5,0.22986767
20104,20104,Nic Petan,2020-21,25.0,6,3,16,16,0,3,3,19.0,178.0,129,6,21,27,132.0,70,5.96,42,208,2192,9.5,0.1867125
20105,20105,Nicholas Baptiste,2017-18,22.0,2,4,14,14,3,1,4,16.0,129.0,14,3,1,4,16.0,82,5.45,47,245,2478,9.0,0.2797794
20106,20106,Nicholas Baptiste,2018-19,23.0,3,6,33,33,4,2,6,45.0,329.0,47,7,3,10,61.0,82,5.86,50,250,2620,9.2,0.25064522
20107,20107,Nicholas Caamano,2020-21,22.0,2,2,12,12,1,1,2,13.0,120.0,12,1,1,2,13.0,70,5.96,42,208,2192,9.5,0.2525417
20108,20108,Nicholas Merkley,2018-19,21.0,2,0,1,1,0,0,0,0.0,14.0,1,0,0,0,0.0,82,5.86,50,250,2620,9.2,0.19211695
20109,20109,Nicholas Merkley,2020-21,23.0,3,2,4,4,1,1,2,8.0,45.0,5,1,1,2,8.0,70,5.96,42,208,2192,9.5,0.25548595
20110,20110,Nicholas Petrecki,2013-14,24.0,2,0,1,1,0,0,0,0.0,12.0,1,0,0,0,0.0,48,5.31,29,160,1399,9.1,0.18834955
20111,20111,Nick Bjugstad,2013-14,21.0,2,1,11,11,1,0,1,17.0,167.0,11,1,0,1,17.0,48,5.31,29,160,1399,9.1,0.23810181
20112,20112,Nick Bjugstad,2014-15,22.0,3,38,76,76,16,22,38,185.0,1233.0,87,17,22,39,202.0,82,5.34,48,269,2463,8.9,0.5635606
20113,20113,Nick Bjugstad,2015-16,23.0,4,43,72,72,24,19,43,207.0,1194.0,159,41,41,82,409.0,82,5.32,47,251,2453,8.9,0.61431676
20114,20114,Nick Bjugstad,2016-17,24.0,5,34,67,67,15,19,34,171.0,1039.0,226,56,60,116,580.0,82,5.34,48,255,2438,9.0,0.5148004
20115,20115,Nick Bjugstad,2017-18,25.0,6,14,54,54,7,7,14,91.0,710.0,280,63,67,130,671.0,82,5.45,47,245,2478,9.0,0.3848716
20116,20116,Nick Bjugstad,2018-19,26.0,7,49,82,82,19,30,49,230.0,1240.0,362,82,97,179,901.0,82,5.86,50,250,2620,9.2,0.58887655
20117,20117,Nick Bjugstad,2019-20,27.0,8,26,64,64,14,12,26,154.0,968.0,426,96,109,205,1055.0,82,5.96,47,239,2579,9.5,0.40647537
20118,20118,Nick Bjugstad,2020-21,28.0,9,2,13,13,1,1,2,18.0,159.0,439,97,110,207,1073.0,70,5.96,42,208,2192,9.5,0.34348637
20119,20119,Nick Bonino,2010-11,22.0,2,2,9,9,1,1,2,14.0,128.0,9,1,1,2,14.0,82,5.53,56,304,2486,9.1,0.23872405
20120,20120,Nick Bonino,2011-12,23.0,3,0,26,26,0,0,0,23.0,255.0,35,1,1,2,37.0,82,5.46,52,291,2492,9.0,0.17424649
20121,20121,Nick Bonino,2012-13,24.0,4,18,50,50,5,13,18,63.0,624.0,85,6,14,20,100.0,82,5.32,47,271,2439,8.9,0.29829
20122,20122,Nick Bonino,2013-14,25.0,5,13,27,27,5,8,13,37.0,429.0,112,11,22,33,137.0,48,5.31,29,160,1399,9.1,0.36929628
20123,20123,Nick Bonino,2014-15,26.0,6,49,77,77,22,27,49,159.0,1250.0,189,33,49,82,296.0,82,5.34,48,269,2463,8.9,0.5465354
20124,20124,Nick Bonino,2015-16,27.0,7,39,75,75,15,24,39,149.0,1269.0,264,48,73,121,445.0,82,5.32,47,251,2453,8.9,0.4785713
20125,20125,Nick Bonino,2016-17,28.0,8,29,63,63,9,20,29,97.0,998.0,327,57,93,150,542.0,82,5.34,48,255,2438,9.0,0.41549376
20126,20126,Nick Bonino,2017-18,29.0,9,37,80,80,18,19,37,142.0,1332.0,407,75,112,187,684.0,82,5.45,47,245,2478,9.0,0.45444542
20127,20127,Nick Bonino,2018-19,30.0,10,25,71,71,12,13,25,83.0,1110.0,478,87,125,212,767.0,82,5.86,50,250,2620,9.2,0.31907707
20128,20128,Nick Bonino,2019-20,31.0,11,35,81,81,17,18,35,118.0,1321.0,559,104,143,247,885.0,82,5.96,47,239,2579,9.5,0.35292625
20129,20129,Nick Bonino,2020-21,32.0,12,35,67,67,18,17,35,104.0,1107.0,626,122,160,282,989.0,70,5.96,42,208,2192,9.5,0.3760134
20130,20130,Nick Boynton,2000-01,22.0,2,0,5,5,0,0,0,6.0,107.0,5,0,0,0,6.0,82,5.49,53,331,2294,9.8,0.18394265
20131,20131,Nick Boynton,2001-02,23.0,3,0,1,1,0,0,0,1.0,14.0,6,0,0,0,7.0,82,5.51,63,376,2272,9.9,0.16344011
20132,20132,Nick Boynton,2002-03,24.0,4,18,80,80,4,14,18,136.0,1481.0,86,4,14,18,143.0,82,5.24,53,338,2262,9.5,0.28508583
20133,20133,Nick Boynton,2003-04,25.0,5,24,78,78,7,17,24,160.0,1769.0,164,11,31,42,303.0,82,5.31,60,363,2326,9.4,0.32115543
20134,20134,Nick Boynton,2004-05,26.0,6,30,81,81,6,24,30,178.0,1826.0,245,17,55,72,481.0,82,5.14,57,348,2300,9.2,0.4551535
20135,20135,Nick Boynton,2006-07,28.0,7,12,54,54,5,7,12,89.0,1115.0,299,22,62,84,570.0,82,6.05,85,480,2458,10.1,0.24623558
20136,20136,Nick Boynton,2007-08,29.0,8,11,59,59,2,9,11,53.0,991.0,358,24,71,95,623.0,82,5.76,70,398,2426,9.7,0.19993114
20137,20137,Nick Boynton,2008-09,30.0,9,12,79,79,3,9,12,94.0,1344.0,437,27,80,107,717.0,82,5.44,62,351,2383,9.4,0.20755902
20138,20138,Nick Boynton,2009-10,31.0,10,21,68,68,5,16,21,104.0,1129.0,505,32,96,128,821.0,82,5.7,65,341,2477,9.4,0.25171715
20139,20139,Nick Boynton,2010-11,32.0,11,8,49,49,1,7,8,50.0,815.0,554,33,103,136,871.0,82,5.53,56,304,2486,9.1,0.14142403
20140,20140,Nick Boynton,2011-12,33.0,12,8,51,51,1,7,8,43.0,747.0,605,34,110,144,914.0,82,5.46,52,291,2492,9.0,0.12480098
20141,20141,Nick Cousins,2015-16,22.0,2,0,11,11,0,0,0,6.0,97.0,11,0,0,0,6.0,82,5.32,47,251,2453,8.9,0.16787302
20142,20142,Nick Cousins,2016-17,23.0,3,11,36,36,6,5,11,41.0,386.0,47,6,5,11,47.0,82,5.34,48,255,2438,9.0,0.27389616
20143,20143,Nick Cousins,2017-18,24.0,4,16,60,60,6,10,16,99.0,720.0,107,12,15,27,146.0,82,5.45,47,245,2478,9.0,0.30573222
20144,20144,Nick Cousins,2018-19,25.0,5,19,71,71,12,7,19,119.0,913.0,178,24,22,46,265.0,82,5.86,50,250,2620,9.2,0.29143313
20145,20145,Nick Cousins,2019-20,26.0,6,27,81,81,7,20,27,144.0,1097.0,259,31,42,73,409.0,82,5.96,47,239,2579,9.5,0.35583398
20146,20146,Nick Cousins,2020-21,27.0,7,25,65,65,10,15,25,115.0,878.0,324,41,57,98,524.0,70,5.96,42,208,2192,9.5,0.34061795
20147,20147,Nick Drazenovic,2011-12,25.0,2,0,3,3,0,0,0,2.0,27.0,3,0,0,0,2.0,82,5.46,52,291,2492,9.0,0.16366741
20148,20148,Nick Drazenovic,2013-14,27.0,3,0,8,8,0,0,0,5.0,79.0,11,0,0,0,7.0,48,5.31,29,160,1399,9.1,0.18146771
20149,20149,Nick Drazenovic,2014-15,28.0,4,0,1,1,0,0,0,3.0,10.0,12,0,0,0,10.0,82,5.34,48,269,2463,8.9,0.1564683
20150,20150,Nick Foligno,2008-09,21.0,2,9,45,45,6,3,9,44.0,412.0,45,6,3,9,44.0,82,5.44,62,351,2383,9.4,0.27419117
20151,20151,Nick Foligno,2009-10,22.0,3,32,81,81,17,15,32,145.0,1108.0,126,23,18,41,189.0,82,5.7,65,341,2477,9.4,0.4712871
20152,20152,Nick Foligno,2010-11,23.0,4,26,61,61,9,17,26,83.0,873.0,187,32,35,67,272.0,82,5.53,56,304,2486,9.1,0.43952826
20153,20153,Nick Foligno,2011-12,24.0,5,34,82,82,14,20,34,149.0,1277.0,269,46,55,101,421.0,82,5.46,52,291,2492,9.0,0.47238868
20154,20154,Nick Foligno,2012-13,25.0,6,47,82,82,15,32,47,153.0,1201.0,351,61,87,148,574.0,82,5.32,47,271,2439,8.9,0.57663476
20155,20155,Nick Foligno,2013-14,26.0,7,19,45,45,6,13,19,69.0,744.0,396,67,100,167,643.0,48,5.31,29,160,1399,9.1,0.47402313
20156,20156,Nick Foligno,2014-15,27.0,8,39,70,70,18,21,39,111.0,1124.0,466,85,121,206,754.0,82,5.34,48,269,2463,8.9,0.550311
20157,20157,Nick Foligno,2015-16,28.0,9,73,79,79,31,42,73,182.0,1488.0,545,116,163,279,936.0,82,5.32,47,251,2453,8.9,0.7684195
20158,20158,Nick Foligno,2016-17,29.0,10,37,72,72,12,25,37,149.0,1216.0,617,128,188,316,1085.0,82,5.34,48,255,2438,9.0,0.47349513
20159,20159,Nick Foligno,2017-18,30.0,11,51,79,79,26,25,51,185.0,1456.0,696,154,213,367,1270.0,82,5.45,47,245,2478,9.0,0.6121433
20160,20160,Nick Foligno,2018-19,31.0,12,33,72,72,15,18,33,137.0,1321.0,768,169,231,400,1407.0,82,5.86,50,250,2620,9.2,0.4166094
20161,20161,Nick Foligno,2019-20,32.0,13,35,73,73,17,18,35,141.0,1292.0,841,186,249,435,1548.0,82,5.96,47,239,2579,9.5,0.39372775
20162,20162,Nick Foligno,2020-21,33.0,14,31,67,67,10,21,31,131.0,1251.0,908,196,270,466,1679.0,70,5.96,42,208,2192,9.5,0.40395814
20163,20163,Nick Holden,2011-12,24.0,2,0,5,5,0,0,0,6.0,86.0,5,0,0,0,6.0,82,5.46,52,291,2492,9.0,0.16744861
20164,20164,Nick Holden,2013-14,26.0,3,0,2,2,0,0,0,2.0,17.0,7,0,0,0,8.0,48,5.31,29,160,1399,9.1,0.18147182
20165,20165,Nick Holden,2014-15,27.0,4,25,54,54,10,15,25,66.0,1009.0,61,10,15,25,74.0,82,5.34,48,269,2463,8.9,0.36157608
20166,20166,Nick Holden,2015-16,28.0,5,14,78,78,5,9,14,94.0,1545.0,139,15,24,39,168.0,82,5.32,47,251,2453,8.9,0.18718779
20167,20167,Nick Holden,2016-17,29.0,6,22,82,82,6,16,22,98.0,1794.0,221,21,40,61,266.0,82,5.34,48,255,2438,9.0,0.26703137
20168,20168,Nick Holden,2017-18,30.0,7,34,80,80,11,23,34,84.0,1649.0,301,32,63,95,350.0,82,5.45,47,245,2478,9.0,0.34238112
20169,20169,Nick Holden,2018-19,31.0,8,17,73,73,4,13,17,80.0,1387.0,374,36,76,112,430.0,82,5.86,50,250,2620,9.2,0.22357076
20170,20170,Nick Holden,2019-20,32.0,9,15,61,61,3,12,15,77.0,1116.0,435,39,88,127,507.0,82,5.96,47,239,2579,9.5,0.22771099
20171,20171,Nick Holden,2020-21,33.0,10,14,61,61,6,8,14,101.0,1150.0,496,45,96,141,608.0,70,5.96,42,208,2192,9.5,0.27022406
20172,20172,Nick Jensen,2017-18,27.0,2,13,49,49,4,9,13,59.0,870.0,49,4,9,13,59.0,82,5.45,47,245,2478,9.0,0.22273967
20173,20173,Nick Jensen,2018-19,28.0,3,15,81,81,0,15,15,107.0,1317.0,130,4,24,28,166.0,82,5.86,50,250,2620,9.2,0.18300986
20174,20174,Nick Jensen,2019-20,29.0,4,20,80,80,2,18,20,94.0,1588.0,210,6,42,48,260.0,82,5.96,47,239,2579,9.5,0.24066636
20175,20175,Nick Jensen,2020-21,30.0,5,8,68,68,0,8,8,61.0,1212.0,278,6,50,56,321.0,70,5.96,42,208,2192,9.5,0.17325112
20176,20176,Nick Johnson,2010-11,25.0,2,2,6,6,1,1,2,7.0,61.0,6,1,1,2,7.0,82,5.53,56,304,2486,9.1,0.1986337
20177,20177,Nick Johnson,2011-12,26.0,3,3,4,4,1,2,3,10.0,67.0,10,2,3,5,17.0,82,5.46,52,291,2492,9.0,0.21510771
20178,20178,Nick Johnson,2012-13,27.0,4,26,77,77,8,18,26,146.0,1113.0,87,10,21,31,163.0,82,5.32,47,271,2439,8.9,0.32339686
20179,20179,Nick Johnson,2013-14,28.0,5,6,17,17,4,2,6,23.0,169.0,104,14,23,37,186.0,48,5.31,29,160,1399,9.1,0.29187304
20180,20180,Nick Johnson,2014-15,29.0,6,0,9,9,0,0,0,10.0,87.0,113,14,23,37,196.0,82,5.34,48,269,2463,8.9,0.17594096
20181,20181,Nick Kypreos,1990-91,24.0,2,9,31,31,5,4,9,27.0,,31,5,4,9,27.0,80,7.37,76,367,2421,12.2,0.30657613
20182,20182,Nick Kypreos,1991-92,25.0,3,18,79,79,9,9,18,60.0,,110,14,13,27,87.0,80,6.91,71,366,2385,11.6,0.2631997
20183,20183,Nick Kypreos,1992-93,26.0,4,10,65,65,4,6,10,28.0,,175,18,19,37,115.0,80,6.96,77,402,2440,11.4,0.19511175
20184,20184,Nick Kypreos,1993-94,27.0,5,27,75,75,17,10,27,81.0,,250,35,29,64,196.0,84,7.25,87,443,2603,11.7,0.32019055
20185,20185,Nick Kypreos,1994-95,28.0,6,8,56,56,3,5,8,34.0,,306,38,34,72,230.0,84,6.48,76,407,2545,10.7,0.15601009
20186,20186,Nick Kypreos,1995-96,29.0,7,4,40,40,1,3,4,16.0,,346,39,37,76,246.0,48,5.97,37,209,1408,10.2,0.1378851
20187,20187,Nick Kypreos,1996-97,30.0,8,9,61,61,4,5,9,49.0,,407,43,42,85,295.0,82,6.29,74,413,2481,10.4,0.15499315
20188,20188,Nick Kypreos,1997-98,31.0,9,5,35,35,3,2,5,18.0,,442,46,44,90,313.0,82,5.83,55,336,2444,9.8,0.17101943
20189,20189,Nick Lappin,2017-18,25.0,2,7,43,43,4,3,7,57.0,504.0,43,4,3,7,57.0,82,5.45,47,245,2478,9.0,0.18710577
20190,20190,Nick Lappin,2018-19,26.0,3,1,6,6,1,0,1,7.0,59.0,49,5,3,8,64.0,82,5.86,50,250,2620,9.2,0.17042238
20191,20191,Nick Lappin,2019-20,27.0,4,0,11,11,0,0,0,11.0,151.0,60,5,3,8,75.0,82,5.96,47,239,2579,9.5,0.1735723
20192,20192,Nick Leddy,2011-12,20.0,2,7,46,46,4,3,7,37.0,658.0,46,4,3,7,37.0,82,5.46,52,291,2492,9.0,0.24079946
20193,20193,Nick Leddy,2012-13,21.0,3,37,82,82,3,34,37,94.0,1811.0,128,7,37,44,131.0,82,5.32,47,271,2439,8.9,0.4593479
20194,20194,Nick Leddy,2013-14,22.0,4,18,48,48,6,12,18,65.0,836.0,176,13,49,62,196.0,48,5.31,29,160,1399,9.1,0.40813145
20195,20195,Nick Leddy,2014-15,23.0,5,31,82,82,7,24,31,123.0,1342.0,258,20,73,93,319.0,82,5.34,48,269,2463,8.9,0.43457174
20196,20196,Nick Leddy,2015-16,24.0,6,37,78,78,10,27,37,120.0,1588.0,336,30,100,130,439.0,82,5.32,47,251,2453,8.9,0.4777118
20197,20197,Nick Leddy,2016-17,25.0,7,40,81,81,5,35,40,121.0,1832.0,417,35,135,170,560.0,82,5.34,48,255,2438,9.0,0.49882492
20198,20198,Nick Leddy,2017-18,26.0,8,46,81,81,11,35,46,137.0,1840.0,498,46,170,216,697.0,82,5.45,47,245,2478,9.0,0.5407903
20199,20199,Nick Leddy,2018-19,27.0,9,42,80,80,10,32,42,153.0,1794.0,578,56,202,258,850.0,82,5.86,50,250,2620,9.2,0.4999831
20200,20200,Nick Leddy,2019-20,28.0,10,26,82,82,4,22,26,116.0,1767.0,660,60,224,284,966.0,82,5.96,47,239,2579,9.5,0.32932454
20201,20201,Nick Leddy,2020-21,29.0,11,21,60,60,3,18,21,72.0,1267.0,720,63,242,305,1038.0,70,5.96,42,208,2192,9.5,0.31369877
20202,20202,Nick Palmieri,2010-11,21.0,2,1,6,6,0,1,1,10.0,71.0,6,0,1,1,10.0,82,5.53,56,304,2486,9.1,0.26037765
20203,20203,Nick Palmieri,2011-12,22.0,3,17,43,43,9,8,17,66.0,616.0,49,9,9,18,76.0,82,5.46,52,291,2492,9.0,0.35687393
20204,20204,Nick Palmieri,2012-13,23.0,4,7,38,38,4,3,7,55.0,402.0,87,13,12,25,131.0,82,5.32,47,271,2439,8.9,0.2662058
20205,20205,Nick Paul,2016-17,21.0,2,5,24,24,2,3,5,28.0,293.0,24,2,3,5,28.0,82,5.34,48,255,2438,9.0,0.27665782
20206,20206,Nick Paul,2017-18,22.0,3,0,1,1,0,0,0,4.0,16.0,25,2,3,5,32.0,82,5.45,47,245,2478,9.0,0.1893197
20207,20207,Nick Paul,2018-19,23.0,4,1,11,11,1,0,1,11.0,87.0,36,3,3,6,43.0,82,5.86,50,250,2620,9.2,0.22412041
20208,20208,Nick Paul,2019-20,24.0,5,2,20,20,1,1,2,30.0,169.0,56,4,4,8,73.0,82,5.96,47,239,2579,9.5,0.1941357
20209,20209,Nick Paul,2020-21,25.0,6,20,56,56,9,11,20,103.0,809.0,112,13,15,28,176.0,70,5.96,42,208,2192,9.5,0.3637452
20210,20210,Nick Ritchie,2016-17,21.0,2,4,33,33,2,2,4,55.0,388.0,33,2,2,4,55.0,82,5.34,48,255,2438,9.0,0.2765225
20211,20211,Nick Ritchie,2017-18,22.0,3,28,77,77,14,14,28,149.0,1000.0,110,16,16,32,204.0,82,5.45,47,245,2478,9.0,0.43717596
20212,20212,Nick Ritchie,2018-19,23.0,4,27,76,76,10,17,27,122.0,1002.0,186,26,33,59,326.0,82,5.86,50,250,2620,9.2,0.3657825
20213,20213,Nick Ritchie,2019-20,24.0,5,31,60,60,9,22,31,96.0,900.0,246,35,55,90,422.0,82,5.96,47,239,2579,9.5,0.46616662
20214,20214,Nick Ritchie,2020-21,25.0,6,21,48,48,9,12,21,78.0,680.0,294,44,67,111,500.0,70,5.96,42,208,2192,9.5,0.40626144
20215,20215,Nick Schmaltz,2017-18,21.0,2,28,61,61,6,22,28,66.0,809.0,61,6,22,28,66.0,82,5.45,47,245,2478,9.0,0.44704282
20216,20216,Nick Schmaltz,2018-19,22.0,3,52,78,78,21,31,52,118.0,1422.0,139,27,53,80,184.0,82,5.86,50,250,2620,9.2,0.62137866
20217,20217,Nick Schmaltz,2019-20,23.0,4,25,40,40,7,18,25,62.0,713.0,179,34,71,105,246.0,82,5.96,47,239,2579,9.5,0.58269477
20218,20218,Nick Schmaltz,2020-21,24.0,5,45,70,70,11,34,45,95.0,1087.0,249,45,105,150,341.0,70,5.96,42,208,2192,9.5,0.6379955
20219,20219,Nick Schultz,2002-03,20.0,2,10,52,52,4,6,10,47.0,839.0,52,4,6,10,47.0,82,5.24,53,338,2262,9.5,0.25613037
20220,20220,Nick Schultz,2003-04,21.0,3,10,75,75,3,7,10,70.0,1385.0,127,7,13,20,117.0,82,5.31,60,363,2326,9.4,0.24903962
20221,20221,Nick Schultz,2004-05,22.0,4,16,79,79,6,10,16,72.0,1604.0,206,13,23,36,189.0,82,5.14,57,348,2300,9.2,0.34001765
20222,20222,Nick Schultz,2006-07,24.0,5,14,79,79,2,12,14,45.0,1419.0,285,15,35,50,234.0,82,6.05,85,480,2458,10.1,0.18048522
20223,20223,Nick Schultz,2007-08,25.0,6,12,82,82,2,10,12,69.0,1657.0,367,17,45,62,303.0,82,5.76,70,398,2426,9.7,0.17310381
20224,20224,Nick Schultz,2008-09,26.0,7,15,81,81,2,13,15,52.0,1634.0,448,19,58,77,355.0,82,5.44,62,351,2383,9.4,0.17163748
20225,20225,Nick Schultz,2009-10,27.0,8,11,79,79,2,9,11,48.0,1624.0,527,21,67,88,403.0,82,5.7,65,341,2477,9.4,0.17157483
20226,20226,Nick Schultz,2010-11,28.0,9,20,80,80,1,19,20,83.0,1677.0,607,22,86,108,486.0,82,5.53,56,304,2486,9.1,0.23536637
20227,20227,Nick Schultz,2011-12,29.0,10,17,74,74,3,14,17,46.0,1496.0,681,25,100,125,532.0,82,5.46,52,291,2492,9.0,0.17940551
20228,20228,Nick Schultz,2012-13,30.0,11,7,82,82,1,6,7,51.0,1616.0,763,26,106,132,583.0,82,5.32,47,271,2439,8.9,0.12662229
20229,20229,Nick Schultz,2013-14,31.0,12,9,48,48,1,8,9,33.0,894.0,811,27,114,141,616.0,48,5.31,29,160,1399,9.1,0.14999282
20230,20230,Nick Schultz,2014-15,32.0,13,5,69,69,0,5,5,35.0,1126.0,880,27,119,146,651.0,82,5.34,48,269,2463,8.9,0.11271286
20231,20231,Nick Schultz,2015-16,33.0,14,15,80,80,2,13,15,69.0,1524.0,960,29,132,161,720.0,82,5.32,47,251,2453,8.9,0.14345378
20232,20232,Nick Schultz,2016-17,34.0,15,10,81,81,1,9,10,70.0,1454.0,1041,30,141,171,790.0,82,5.34,48,255,2438,9.0,0.110679984
20233,20233,Nick Schultz,2017-18,35.0,16,4,28,28,0,4,4,25.0,427.0,1069,30,145,175,815.0,82,5.45,47,245,2478,9.0,0.12655416
20234,20234,Nick Seeler,2018-19,25.0,2,4,22,22,0,4,4,17.0,320.0,22,0,4,4,17.0,82,5.86,50,250,2620,9.2,0.14780322
20235,20235,Nick Seeler,2019-20,26.0,3,7,71,71,2,5,7,67.0,876.0,93,2,9,11,84.0,82,5.96,47,239,2579,9.5,0.17593956
20236,20236,Nick Seeler,2020-21,27.0,4,1,12,12,0,1,1,5.0,143.0,105,2,10,12,89.0,70,5.96,42,208,2192,9.5,0.17035133
20237,20237,Nick Shore,2015-16,23.0,2,7,34,34,1,6,7,33.0,377.0,34,1,6,7,33.0,82,5.32,47,251,2453,8.9,0.21708176
20238,20238,Nick Shore,2016-17,24.0,3,10,68,68,3,7,10,90.0,844.0,102,4,13,17,123.0,82,5.34,48,255,2438,9.0,0.2255288
20239,20239,Nick Shore,2017-18,25.0,4,17,70,70,6,11,17,79.0,895.0,172,10,24,34,202.0,82,5.45,47,245,2478,9.0,0.24449289
20240,20240,Nick Shore,2018-19,26.0,5,19,64,64,5,14,19,74.0,907.0,236,15,38,53,276.0,82,5.86,50,250,2620,9.2,0.25048244
20241,20241,Nick Shore,2020-21,28.0,6,6,63,63,3,3,6,45.0,578.0,299,18,41,59,321.0,70,5.96,42,208,2192,9.5,0.17357183
20242,20242,Nick Smith,2002-03,23.0,2,0,15,15,0,0,0,2.0,62.0,15,0,0,0,2.0,82,5.24,53,338,2262,9.5,0.15775642
20243,20243,Nick Sorensen,2017-18,23.0,2,1,5,5,0,1,1,7.0,54.0,5,0,1,1,7.0,82,5.45,47,245,2478,9.0,0.19942334
20244,20244,Nick Spaling,2010-11,22.0,2,3,28,28,0,3,3,26.0,310.0,28,0,3,3,26.0,82,5.53,56,304,2486,9.1,0.19759336
20245,20245,Nick Spaling,2011-12,23.0,3,14,74,74,8,6,14,75.0,1031.0,102,8,9,17,101.0,82,5.46,52,291,2492,9.0,0.250908
20246,20246,Nick Spaling,2012-13,24.0,4,22,77,77,10,12,22,107.0,1210.0,179,18,21,39,208.0,82,5.32,47,271,2439,8.9,0.27907202
20247,20247,Nick Spaling,2013-14,25.0,5,13,47,47,9,4,13,57.0,745.0,226,27,25,52,265.0,48,5.31,29,160,1399,9.1,0.31634605
20248,20248,Nick Spaling,2014-15,26.0,6,32,71,71,13,19,32,85.0,1137.0,297,40,44,84,350.0,82,5.34,48,269,2463,8.9,0.38750622
20249,20249,Nick Spaling,2015-16,27.0,7,27,82,82,9,18,27,90.0,1250.0,379,49,62,111,440.0,82,5.32,47,251,2453,8.9,0.29515192
20250,20250,Nick Spaling,2016-17,28.0,8,13,58,58,3,10,13,53.0,828.0,437,52,72,124,493.0,82,5.34,48,255,2438,9.0,0.2161097
20251,20251,Nick Stajduhar,1996-97,22.0,2,0,2,2,0,0,0,1.0,,2,0,0,0,1.0,82,6.29,74,413,2481,10.4,0.16458139
20252,20252,Nick Suzuki,2020-21,21.0,2,41,71,71,13,28,41,138.0,1135.0,71,13,28,41,138.0,70,5.96,42,208,2192,9.5,0.6286179
20253,20253,Nick Tarnasky,2006-07,22.0,2,1,12,12,0,1,1,9.0,56.0,12,0,1,1,9.0,82,6.05,85,480,2458,10.1,0.19173864
20254,20254,Nick Tarnasky,2007-08,23.0,3,9,77,77,5,4,9,41.0,500.0,89,5,5,10,50.0,82,5.76,70,398,2426,9.7,0.19866458
20255,20255,Nick Tarnasky,2008-09,24.0,4,10,80,80,6,4,10,91.0,660.0,169,11,9,20,141.0,82,5.44,62,351,2383,9.4,0.21402353
20256,20256,Nick Tarnasky,2009-10,25.0,5,7,45,45,1,6,7,38.0,330.0,214,12,15,27,179.0,82,5.7,65,341,2477,9.4,0.15418315
20257,20257,Nick Tarnasky,2010-11,26.0,6,3,31,31,1,2,3,19.0,211.0,245,13,17,30,198.0,82,5.53,56,304,2486,9.1,0.14309111
20258,20258,Nick Vachon,1997-98,25.0,2,0,1,1,0,0,0,0.0,,1,0,0,0,0.0,82,5.83,55,336,2444,9.8,0.14142263
20259,20259,Nicklas Backstrom,2008-09,21.0,2,69,82,82,14,55,69,153.0,1557.0,82,14,55,69,153.0,82,5.44,62,351,2383,9.4,0.8735527
20260,20260,Nicklas Backstrom,2009-10,22.0,3,88,82,82,22,66,88,174.0,1635.0,164,36,121,157,327.0,82,5.7,65,341,2477,9.4,1.0555892
20261,20261,Nicklas Backstrom,2010-11,23.0,4,101,82,82,33,68,101,222.0,1677.0,246,69,189,258,549.0,82,5.53,56,304,2486,9.1,1.0993941
20262,20262,Nicklas Backstrom,2011-12,24.0,5,65,77,77,18,47,65,202.0,1586.0,323,87,236,323,751.0,82,5.46,52,291,2492,9.0,0.8882402
20263,20263,Nicklas Backstrom,2012-13,25.0,6,44,42,42,14,30,44,95.0,805.0,365,101,266,367,846.0,82,5.32,47,271,2439,8.9,0.9135065
20264,20264,Nicklas Backstrom,2013-14,26.0,7,48,48,48,8,40,48,82.0,955.0,413,109,306,415,928.0,48,5.31,29,160,1399,9.1,0.9829994
20265,20265,Nicklas Backstrom,2014-15,27.0,8,79,82,82,18,61,79,196.0,1624.0,495,127,367,494,1124.0,82,5.34,48,269,2463,8.9,0.920243
20266,20266,Nicklas Backstrom,2015-16,28.0,9,78,82,82,18,60,78,153.0,1683.0,577,145,427,572,1277.0,82,5.32,47,251,2453,8.9,0.90475345
20267,20267,Nicklas Backstrom,2016-17,29.0,10,70,75,75,20,50,70,129.0,1439.0,652,165,477,642,1406.0,82,5.34,48,255,2438,9.0,0.8613148
20268,20268,Nicklas Backstrom,2017-18,30.0,11,86,82,82,23,63,86,162.0,1497.0,734,188,540,728,1568.0,82,5.45,47,245,2478,9.0,0.9699721
20269,20269,Nicklas Backstrom,2018-19,31.0,12,71,81,81,21,50,71,165.0,1593.0,815,209,590,799,1733.0,82,5.86,50,250,2620,9.2,0.86131793
20270,20270,Nicklas Backstrom,2019-20,32.0,13,74,80,80,22,52,74,169.0,1596.0,895,231,642,873,1902.0,82,5.96,47,239,2579,9.5,0.835767
20271,20271,Nicklas Backstrom,2020-21,33.0,14,54,61,61,12,42,54,132.0,1160.0,956,243,684,927,2034.0,70,5.96,42,208,2192,9.5,0.80866975
20272,20272,Nicklas Grossmann,2007-08,23.0,2,0,8,8,0,0,0,8.0,103.0,8,0,0,0,8.0,82,5.76,70,398,2426,9.7,0.17466322
20273,20273,Nicklas Grossmann,2008-09,24.0,3,7,62,62,0,7,7,34.0,964.0,70,0,7,7,42.0,82,5.44,62,351,2383,9.4,0.14746124
20274,20274,Nicklas Grossmann,2009-10,25.0,4,12,81,81,2,10,12,60.0,1429.0,151,2,17,19,102.0,82,5.7,65,341,2477,9.4,0.15585876
20275,20275,Nicklas Grossmann,2010-11,26.0,5,7,71,71,0,7,7,58.0,1362.0,222,2,24,26,160.0,82,5.53,56,304,2486,9.1,0.14204368
20276,20276,Nicklas Grossmann,2011-12,27.0,6,10,59,59,1,9,10,38.0,1074.0,281,3,33,36,198.0,82,5.46,52,291,2492,9.0,0.14013264
20277,20277,Nicklas Grossmann,2012-13,28.0,7,11,74,74,0,11,11,56.0,1392.0,355,3,44,47,254.0,82,5.32,47,271,2439,8.9,0.13331106
20278,20278,Nicklas Grossmann,2013-14,29.0,8,4,30,30,1,3,4,21.0,550.0,385,4,47,51,275.0,48,5.31,29,160,1399,9.1,0.14729837
20279,20279,Nicklas Grossmann,2014-15,30.0,9,14,78,78,1,13,14,71.0,1491.0,463,5,60,65,346.0,82,5.34,48,269,2463,8.9,0.1411637
20280,20280,Nicklas Grossmann,2015-16,31.0,10,14,68,68,5,9,14,43.0,1201.0,531,10,69,79,389.0,82,5.32,47,251,2453,8.9,0.14764476
20281,20281,Nicklas Grossmann,2016-17,32.0,11,7,58,58,3,4,7,42.0,1031.0,589,13,73,86,431.0,82,5.34,48,255,2438,9.0,0.12244925
20282,20282,Nicklas Grossmann,2017-18,33.0,12,0,3,3,0,0,0,3.0,39.0,592,13,73,86,434.0,82,5.45,47,245,2478,9.0,0.12625432
20283,20283,Nicklas Jensen,2013-14,20.0,2,0,2,2,0,0,0,0.0,28.0,2,0,0,0,0.0,48,5.31,29,160,1399,9.1,0.23958349
20284,20284,Nicklas Jensen,2014-15,21.0,3,6,17,17,3,3,6,30.0,266.0,19,3,3,6,30.0,82,5.34,48,269,2463,8.9,0.3321974
20285,20285,Nicklas Jensen,2015-16,22.0,4,0,5,5,0,0,0,7.0,48.0,24,3,3,6,37.0,82,5.32,47,251,2453,8.9,0.18595654
20286,20286,Nicklas Jensen,2017-18,24.0,5,0,7,7,0,0,0,8.0,65.0,31,3,3,6,45.0,82,5.45,47,245,2478,9.0,0.16030529
20287,20287,Nicklas Lidstrom,1992-93,22.0,2,60,80,80,11,49,60,168.0,,80,11,49,60,168.0,80,6.96,77,402,2440,11.4,0.6963606
20288,20288,Nicklas Lidstrom,1993-94,23.0,3,41,84,84,7,34,41,156.0,,164,18,83,101,324.0,84,7.25,87,443,2603,11.7,0.55399007
20289,20289,Nicklas Lidstrom,1994-95,24.0,4,56,84,84,10,46,56,200.0,,248,28,129,157,524.0,84,6.48,76,407,2545,10.7,0.6471435
20290,20290,Nicklas Lidstrom,1995-96,25.0,5,26,43,43,10,16,26,90.0,,291,38,145,183,614.0,48,5.97,37,209,1408,10.2,0.68993
20291,20291,Nicklas Lidstrom,1996-97,26.0,6,67,81,81,17,50,67,211.0,,372,55,195,250,825.0,82,6.29,74,413,2481,10.4,0.7525491
20292,20292,Nicklas Lidstrom,1997-98,27.0,7,57,79,79,15,42,57,214.0,,451,70,237,307,1039.0,82,5.83,55,336,2444,9.8,0.6897489
20293,20293,Nicklas Lidstrom,1998-99,28.0,8,59,80,80,17,42,59,205.0,,531,87,279,366,1244.0,82,5.28,57,380,2242,9.6,0.72116256
20294,20294,Nicklas Lidstrom,1999-00,29.0,9,57,81,81,14,43,57,205.0,2148.0,612,101,322,423,1449.0,82,5.27,57,359,2285,9.4,0.6892
20295,20295,Nicklas Lidstrom,2000-01,30.0,10,73,81,81,20,53,73,218.0,2328.0,693,121,375,496,1667.0,82,5.49,53,331,2294,9.8,0.85842216
20296,20296,Nicklas Lidstrom,2001-02,31.0,11,71,82,82,15,56,71,272.0,2333.0,775,136,431,567,1939.0,82,5.51,63,376,2272,9.9,0.80765224
20297,20297,Nicklas Lidstrom,2002-03,32.0,12,59,78,78,9,50,59,215.0,2247.0,853,145,481,626,2154.0,82,5.24,53,338,2262,9.5,0.696387
20298,20298,Nicklas Lidstrom,2003-04,33.0,13,62,82,82,18,44,62,175.0,2406.0,935,163,525,688,2329.0,82,5.31,60,363,2326,9.4,0.69300085
20299,20299,Nicklas Lidstrom,2004-05,34.0,14,38,81,81,10,28,38,194.0,2240.0,1016,173,553,726,2523.0,82,5.14,57,348,2300,9.2,0.6933616
20300,20300,Nicklas Lidstrom,2006-07,36.0,15,80,80,80,16,64,80,243.0,2249.0,1096,189,617,806,2766.0,82,6.05,85,480,2458,10.1,0.8065159
20301,20301,Nicklas Lidstrom,2007-08,37.0,16,62,80,80,13,49,62,224.0,2199.0,1176,202,666,868,2990.0,82,5.76,70,398,2426,9.7,0.70781434
20302,20302,Nicklas Lidstrom,2008-09,38.0,17,70,76,76,10,60,70,188.0,2031.0,1252,212,726,938,3178.0,82,5.44,62,351,2383,9.4,0.7403284
20303,20303,Nicklas Lidstrom,2009-10,39.0,18,59,78,78,16,43,59,180.0,1936.0,1330,228,769,997,3358.0,82,5.7,65,341,2477,9.4,0.62579155
20304,20304,Nicklas Lidstrom,2010-11,40.0,19,49,82,82,9,40,49,194.0,2085.0,1412,237,809,1046,3552.0,82,5.53,56,304,2486,9.1,0.59894454
20305,20305,Nicklas Lidstrom,2011-12,41.0,20,62,82,82,16,46,62,175.0,1924.0,1494,253,855,1108,3727.0,82,5.46,52,291,2492,9.0,0.6165768
20306,20306,Nicklas Lidstrom,2012-13,42.0,21,34,70,70,11,23,34,148.0,1664.0,1564,264,878,1142,3875.0,82,5.32,47,271,2439,8.9,0.44667074
20307,20307,Niclas Bergfors,2008-09,21.0,2,0,1,1,0,0,0,3.0,11.0,1,0,0,0,3.0,82,5.44,62,351,2383,9.4,0.21860492
20308,20308,Niclas Bergfors,2009-10,22.0,3,1,8,8,1,0,1,6.0,46.0,9,1,0,1,9.0,82,5.7,65,341,2477,9.4,0.22575527
20309,20309,Niclas Bergfors,2010-11,23.0,4,44,81,81,21,23,44,217.0,1249.0,90,22,23,45,226.0,82,5.53,56,304,2486,9.1,0.5823872
20310,20310,Niclas Bergfors,2011-12,24.0,5,36,72,72,12,24,36,152.0,1062.0,162,34,47,81,378.0,82,5.46,52,291,2492,9.0,0.46918362
20311,20311,Niclas Bergfors,2012-13,25.0,6,2,11,11,1,1,2,11.0,89.0,173,35,48,83,389.0,82,5.32,47,271,2439,8.9,0.24397233
20312,20312,Niclas Havelid,2000-01,27.0,2,9,50,50,2,7,9,70.0,958.0,50,2,7,9,70.0,82,5.49,53,331,2294,9.8,0.17805147
20313,20313,Niclas Havelid,2001-02,28.0,3,14,47,47,4,10,14,69.0,1027.0,97,6,17,23,139.0,82,5.51,63,376,2272,9.9,0.24688518
20314,20314,Niclas Havelid,2002-03,29.0,4,3,52,52,1,2,3,45.0,885.0,149,7,19,26,184.0,82,5.24,53,338,2262,9.5,0.14481574
20315,20315,Niclas Havelid,2003-04,30.0,5,33,82,82,11,22,33,169.0,1844.0,231,18,41,59,353.0,82,5.31,60,363,2326,9.4,0.40341783
20316,20316,Niclas Havelid,2004-05,31.0,6,26,79,79,6,20,26,122.0,1789.0,310,24,61,85,475.0,82,5.14,57,348,2300,9.2,0.3387245
20317,20317,Niclas Havelid,2006-07,33.0,7,32,82,82,4,28,32,84.0,2002.0,392,28,89,117,559.0,82,6.05,85,480,2458,10.1,0.33741337
20318,20318,Niclas Havelid,2007-08,34.0,8,21,77,77,3,18,21,82.0,1946.0,469,31,107,138,641.0,82,5.76,70,398,2426,9.7,0.24222764
20319,20319,Niclas Havelid,2008-09,35.0,9,14,81,81,1,13,14,54.0,1661.0,550,32,120,152,695.0,82,5.44,62,351,2383,9.4,0.14622808
20320,20320,Niclas Havelid,2009-10,36.0,10,19,78,78,2,17,19,56.0,1613.0,628,34,137,171,751.0,82,5.7,65,341,2477,9.4,0.20152882
20321,20321,Niclas Wallin,2001-02,26.0,2,5,37,37,2,3,5,19.0,553.0,37,2,3,5,19.0,82,5.51,63,376,2272,9.9,0.15453216
20322,20322,Niclas Wallin,2002-03,27.0,3,3,52,52,1,2,3,33.0,634.0,89,3,5,8,52.0,82,5.24,53,338,2262,9.5,0.11973545
20323,20323,Niclas Wallin,2003-04,28.0,4,10,77,77,2,8,10,69.0,1248.0,166,5,13,18,121.0,82,5.31,60,363,2326,9.4,0.15246975
20324,20324,Niclas Wallin,2004-05,29.0,5,10,57,57,3,7,10,74.0,1064.0,223,8,20,28,195.0,82,5.14,57,348,2300,9.2,0.21711326
20325,20325,Niclas Wallin,2006-07,31.0,6,8,50,50,4,4,8,44.0,841.0,273,12,24,36,239.0,82,6.05,85,480,2458,10.1,0.14067397
20326,20326,Niclas Wallin,2007-08,32.0,7,10,67,67,2,8,10,76.0,1242.0,340,14,32,46,315.0,82,5.76,70,398,2426,9.7,0.16272604
20327,20327,Niclas Wallin,2008-09,33.0,8,8,66,66,2,6,8,60.0,1197.0,406,16,38,54,375.0,82,5.44,62,351,2383,9.4,0.14850688
20328,20328,Niclas Wallin,2009-10,34.0,9,10,64,64,2,8,10,53.0,1041.0,470,18,46,64,428.0,82,5.7,65,341,2477,9.4,0.1506302
20329,20329,Niclas Wallin,2010-11,35.0,10,7,70,70,0,7,7,72.0,1213.0,540,18,53,71,500.0,82,5.53,56,304,2486,9.1,0.14116558
20330,20330,Niclas Wallin,2011-12,36.0,11,8,74,74,3,5,8,86.0,1172.0,614,21,58,79,586.0,82,5.46,52,291,2492,9.0,0.13691148
20331,20331,Nico Hischier,2018-19,20.0,2,52,82,82,20,32,52,180.0,1337.0,82,20,32,52,180.0,82,5.86,50,250,2620,9.2,0.6532756
20332,20332,Nico Hischier,2019-20,21.0,3,47,69,69,17,30,47,160.0,1249.0,151,37,62,99,340.0,82,5.96,47,239,2579,9.5,0.68221754
20333,20333,Nico Hischier,2020-21,22.0,4,36,58,58,14,22,36,123.0,1048.0,209,51,84,135,463.0,70,5.96,42,208,2192,9.5,0.6311365
20334,20334,Nico Sturm,2019-20,24.0,2,0,2,2,0,0,0,7.0,26.0,2,0,0,0,7.0,82,5.96,47,239,2579,9.5,0.1744509
20335,20335,Nico Sturm,2020-21,25.0,3,2,6,6,0,2,2,2.0,71.0,8,0,2,2,9.0,70,5.96,42,208,2192,9.5,0.20897111
20336,20336,Nicolas Aube-Kubel,2019-20,23.0,2,0,9,9,0,0,0,2.0,50.0,9,0,0,0,2.0,82,5.96,47,239,2579,9.5,0.18310392
20337,20337,Nicolas Aube-Kubel,2020-21,24.0,3,15,36,36,7,8,15,48.0,406.0,45,7,8,15,50.0,70,5.96,42,208,2192,9.5,0.38331658
20338,20338,Nicolas Beaudin,2020-21,21.0,2,0,1,1,0,0,0,2.0,17.0,1,0,0,0,2.0,70,5.96,42,208,2192,9.5,0.20552799
20339,20339,Nicolas Blanchard,2013-14,26.0,2,0,9,9,0,0,0,6.0,78.0,9,0,0,0,6.0,48,5.31,29,160,1399,9.1,0.18283695
20340,20340,Nicolas Deschamps,2014-15,25.0,2,0,3,3,0,0,0,2.0,20.0,3,0,0,0,2.0,82,5.34,48,269,2463,8.9,0.16342145
20341,20341,Nicolas Deslauriers,2014-15,23.0,2,1,17,17,1,0,1,30.0,223.0,17,1,0,1,30.0,82,5.34,48,269,2463,8.9,0.23955736
20342,20342,Nicolas Deslauriers,2015-16,24.0,3,15,82,82,5,10,15,76.0,973.0,99,6,10,16,106.0,82,5.32,47,251,2453,8.9,0.24583977
20343,20343,Nicolas Deslauriers,2016-17,25.0,4,12,70,70,6,6,12,72.0,723.0,169,12,16,28,178.0,82,5.34,48,255,2438,9.0,0.2001315
20344,20344,Nicolas Deslauriers,2017-18,26.0,5,2,42,42,0,2,2,26.0,311.0,211,12,18,30,204.0,82,5.45,47,245,2478,9.0,0.123671114
20345,20345,Nicolas Deslauriers,2018-19,27.0,6,14,58,58,10,4,14,77.0,673.0,269,22,22,44,281.0,82,5.86,50,250,2620,9.2,0.23766288
20346,20346,Nicolas Deslauriers,2019-20,28.0,7,5,48,48,2,3,5,48.0,482.0,317,24,25,49,329.0,82,5.96,47,239,2579,9.5,0.15584728
20347,20347,Nicolas Deslauriers,2020-21,29.0,8,13,59,59,7,6,13,64.0,577.0,376,31,31,62,393.0,70,5.96,42,208,2192,9.5,0.23768437
20348,20348,Nicolas Hague,2020-21,22.0,2,11,38,38,1,10,11,54.0,611.0,38,1,10,11,54.0,70,5.96,42,208,2192,9.5,0.25525272
20349,20349,Nicolas Kerdiles,2017-18,24.0,2,0,1,1,0,0,0,0.0,11.0,1,0,0,0,0.0,82,5.45,47,245,2478,9.0,0.1600399
20350,20350,Nicolas Kerdiles,2018-19,25.0,3,0,2,2,0,0,0,0.0,8.0,3,0,0,0,0.0,82,5.86,50,250,2620,9.2,0.14321923
20351,20351,Nicolas Roy,2018-19,21.0,2,0,1,1,0,0,0,1.0,11.0,1,0,0,0,1.0,82,5.86,50,250,2620,9.2,0.19850874
20352,20352,Nicolas Roy,2019-20,22.0,3,0,6,6,0,0,0,1.0,42.0,7,0,0,0,2.0,82,5.96,47,239,2579,9.5,0.17377141
20353,20353,Nicolas Roy,2020-21,23.0,4,10,28,28,5,5,10,42.0,320.0,35,5,5,10,44.0,70,5.96,42,208,2192,9.5,0.33955127
20354,20354,Nigel Dawes,2007-08,22.0,2,1,8,8,1,0,1,7.0,54.0,8,1,0,1,7.0,82,5.76,70,398,2426,9.7,0.22156036
20355,20355,Nigel Dawes,2008-09,23.0,3,29,61,61,14,15,29,121.0,792.0,69,15,15,30,128.0,82,5.44,62,351,2383,9.4,0.463919
20356,20356,Nigel Dawes,2009-10,24.0,4,21,64,64,10,11,21,115.0,848.0,133,25,26,51,243.0,82,5.7,65,341,2477,9.4,0.335944
20357,20357,Nigel Dawes,2010-11,25.0,5,32,66,66,14,18,32,96.0,960.0,199,39,44,83,339.0,82,5.53,56,304,2486,9.1,0.4415646
20358,20358,Nigel Dawes,2011-12,26.0,6,1,13,13,0,1,1,12.0,128.0,212,39,45,84,351.0,82,5.46,52,291,2492,9.0,0.2774284
20359,20359,Nik Antropov,2000-01,20.0,2,30,66,66,12,18,30,89.0,845.0,66,12,18,30,89.0,82,5.49,53,331,2294,9.8,0.47110823
20360,20360,Nik Antropov,2001-02,21.0,3,17,52,52,6,11,17,71.0,522.0,118,18,29,47,160.0,82,5.51,63,376,2272,9.9,0.3691265
20361,20361,Nik Antropov,2002-03,22.0,4,2,11,11,1,1,2,12.0,98.0,129,19,30,49,172.0,82,5.24,53,338,2262,9.5,0.31656766
20362,20362,Nik Antropov,2003-04,23.0,5,45,72,72,16,29,45,102.0,1080.0,201,35,59,94,274.0,82,5.31,60,363,2326,9.4,0.55192786
20363,20363,Nik Antropov,2004-05,24.0,6,31,62,62,13,18,31,89.0,948.0,263,48,77,125,363.0,82,5.14,57,348,2300,9.2,0.5426723
20364,20364,Nik Antropov,2006-07,26.0,7,31,57,57,12,19,31,113.0,887.0,320,60,96,156,476.0,82,6.05,85,480,2458,10.1,0.4813854
20365,20365,Nik Antropov,2007-08,27.0,8,33,54,54,18,15,33,125.0,896.0,374,78,111,189,601.0,82,5.76,70,398,2426,9.7,0.6070491
20366,20366,Nik Antropov,2008-09,28.0,9,56,72,72,26,30,56,165.0,1448.0,446,104,141,245,766.0,82,5.44,62,351,2383,9.4,0.6755247
20367,20367,Nik Antropov,2009-10,29.0,10,59,81,81,28,31,59,224.0,1392.0,527,132,172,304,990.0,82,5.7,65,341,2477,9.4,0.65423596
20368,20368,Nik Antropov,2010-11,30.0,11,67,76,76,24,43,67,126.0,1385.0,603,156,215,371,1116.0,82,5.53,56,304,2486,9.1,0.6846413
20369,20369,Nik Antropov,2011-12,31.0,12,41,76,76,16,25,41,105.0,1189.0,679,172,240,412,1221.0,82,5.46,52,291,2492,9.0,0.4704595
20370,20370,Nik Antropov,2012-13,32.0,13,35,69,69,15,20,35,95.0,1140.0,748,187,260,447,1316.0,82,5.32,47,271,2439,8.9,0.40920025
20371,20371,Nik Antropov,2013-14,33.0,14,18,40,40,6,12,18,56.0,638.0,788,193,272,465,1372.0,48,5.31,29,160,1399,9.1,0.45027596
20372,20372,Nikita Alexeev,2002-03,21.0,2,8,44,44,4,4,8,47.0,503.0,44,4,4,8,47.0,82,5.24,53,338,2262,9.5,0.23979947
20373,20373,Nikita Alexeev,2003-04,22.0,3,6,37,37,4,2,6,52.0,426.0,81,8,6,14,99.0,82,5.31,60,363,2326,9.4,0.2726373
20374,20374,Nikita Alexeev,2007-08,26.0,4,23,78,78,12,11,23,117.0,1075.0,159,20,17,37,216.0,82,5.76,70,398,2426,9.7,0.2941457
20375,20375,Nikita Filatov,2009-10,19.0,2,4,8,8,4,0,4,10.0,65.0,8,4,0,4,10.0,82,5.7,65,341,2477,9.4,0.3353621
20376,20376,Nikita Filatov,2010-11,20.0,3,2,13,13,2,0,2,11.0,105.0,21,6,0,6,21.0,82,5.53,56,304,2486,9.1,0.30494472
20377,20377,Nikita Filatov,2011-12,21.0,4,7,23,23,0,7,7,31.0,283.0,44,6,7,13,52.0,82,5.46,52,291,2492,9.0,0.2786978
20378,20378,Nikita Filatov,2012-13,22.0,5,1,9,9,0,1,1,6.0,88.0,53,6,8,14,58.0,82,5.32,47,271,2439,8.9,0.19700974
20379,20379,Nikita Gusev,2020-21,28.0,2,44,66,66,13,31,44,158.0,970.0,66,13,31,44,158.0,70,5.96,42,208,2192,9.5,0.6451767
20380,20380,Nikita Kucherov,2014-15,21.0,2,18,52,52,9,9,18,102.0,682.0,52,9,9,18,102.0,82,5.34,48,269,2463,8.9,0.404676
20381,20381,Nikita Kucherov,2015-16,22.0,3,65,82,82,29,36,65,191.0,1226.0,134,38,45,83,293.0,82,5.32,47,251,2453,8.9,0.8497914
20382,20382,Nikita Kucherov,2016-17,23.0,4,66,77,77,30,36,66,209.0,1402.0,211,68,81,149,502.0,82,5.34,48,255,2438,9.0,0.86761844
20383,20383,Nikita Kucherov,2017-18,24.0,5,85,74,74,40,45,85,246.0,1438.0,285,108,126,234,748.0,82,5.45,47,245,2478,9.0,1.158962
20384,20384,Nikita Kucherov,2018-19,25.0,6,100,80,80,39,61,100,279.0,1586.0,365,147,187,334,1027.0,82,5.86,50,250,2620,9.2,1.1868968
20385,20385,Nikita Kucherov,2019-20,26.0,7,128,82,82,41,87,128,246.0,1637.0,447,188,274,462,1273.0,82,5.96,47,239,2579,9.5,1.2483513
20386,20386,Nikita Kucherov,2020-21,27.0,8,85,68,68,33,52,85,210.0,1283.0,515,221,326,547,1483.0,70,5.96,42,208,2192,9.5,1.1326914
20387,20387,Nikita Nesterov,2015-16,22.0,2,7,27,27,2,5,7,44.0,433.0,27,2,5,7,44.0,82,5.32,47,251,2453,8.9,0.2568084
20388,20388,Nikita Nesterov,2016-17,23.0,3,9,57,57,3,6,9,57.0,849.0,84,5,11,16,101.0,82,5.34,48,255,2438,9.0,0.20767564
20389,20389,Nikita Nesterov,2017-18,24.0,4,17,48,48,4,13,17,63.0,782.0,132,9,24,33,164.0,82,5.45,47,245,2478,9.0,0.28549528
20390,20390,Nikita Nikitin,2011-12,25.0,2,9,41,41,1,8,9,46.0,672.0,41,1,8,9,46.0,82,5.46,52,291,2492,9.0,0.17871737
20391,20391,Nikita Nikitin,2012-13,26.0,3,32,61,61,7,25,32,103.0,1415.0,102,8,33,41,149.0,82,5.32,47,271,2439,8.9,0.45920962
20392,20392,Nikita Nikitin,2013-14,27.0,4,9,38,38,3,6,9,60.0,806.0,140,11,39,50,209.0,48,5.31,29,160,1399,9.1,0.24479502
20393,20393,Nikita Nikitin,2014-15,28.0,5,15,66,66,2,13,15,95.0,1130.0,206,13,52,65,304.0,82,5.34,48,269,2463,8.9,0.21246964
20394,20394,Nikita Nikitin,2015-16,29.0,6,10,42,42,4,6,10,80.0,825.0,248,17,58,75,384.0,82,5.32,47,251,2453,8.9,0.23723483
20395,20395,Nikita Nikitin,2016-17,30.0,7,1,11,11,0,1,1,12.0,163.0,259,17,59,76,396.0,82,5.34,48,255,2438,9.0,0.18123177
20396,20396,Nikita Scherbak,2017-18,22.0,2,1,3,3,1,0,1,3.0,34.0,3,1,0,1,3.0,82,5.45,47,245,2478,9.0,0.24000493
20397,20397,Nikita Scherbak,2018-19,23.0,3,6,26,26,4,2,6,39.0,348.0,29,5,2,7,42.0,82,5.86,50,250,2620,9.2,0.2674228
20398,20398,Nikita Scherbak,2019-20,24.0,4,1,8,8,1,0,1,12.0,81.0,37,6,2,8,54.0,82,5.96,47,239,2579,9.5,0.21062449
20399,20399,Nikita Soshnikov,2016-17,23.0,2,5,11,11,2,3,5,33.0,172.0,11,2,3,5,33.0,82,5.34,48,255,2438,9.0,0.29073858
20400,20400,Nikita Soshnikov,2017-18,24.0,3,9,56,56,5,4,9,70.0,608.0,67,7,7,14,103.0,82,5.45,47,245,2478,9.0,0.22096774
20401,20401,Nikita Soshnikov,2018-19,25.0,4,2,15,15,1,1,2,17.0,165.0,82,8,8,16,120.0,82,5.86,50,250,2620,9.2,0.19972268
20402,20402,Nikita Soshnikov,2019-20,26.0,5,0,5,5,0,0,0,1.0,36.0,87,8,8,16,121.0,82,5.96,47,239,2579,9.5,0.16997352
20403,20403,Nikita Tryamkin,2016-17,22.0,2,2,13,13,1,1,2,11.0,228.0,13,1,1,2,11.0,82,5.34,48,255,2438,9.0,0.22288656
20404,20404,Nikita Tryamkin,2017-18,23.0,3,9,66,66,2,7,9,65.0,1105.0,79,3,8,11,76.0,82,5.45,47,245,2478,9.0,0.20631865
20405,20405,Nikita Zadorov,2014-15,19.0,2,1,7,7,1,0,1,4.0,120.0,7,1,0,1,4.0,82,5.34,48,269,2463,8.9,0.25474277
20406,20406,Nikita Zadorov,2015-16,20.0,3,15,60,60,3,12,15,52.0,1062.0,67,4,12,16,56.0,82,5.32,47,251,2453,8.9,0.26231927
20407,20407,Nikita Zadorov,2016-17,21.0,4,2,22,22,0,2,2,18.0,373.0,89,4,14,18,74.0,82,5.34,48,255,2438,9.0,0.24860913
20408,20408,Nikita Zadorov,2017-18,22.0,5,10,56,56,0,10,10,61.0,1066.0,145,4,24,28,135.0,82,5.45,47,245,2478,9.0,0.20801726
20409,20409,Nikita Zadorov,2018-19,23.0,6,20,77,77,7,13,20,94.0,1499.0,222,11,37,48,229.0,82,5.86,50,250,2620,9.2,0.30913845
20410,20410,Nikita Zadorov,2019-20,24.0,7,14,70,70,7,7,14,100.0,1204.0,292,18,44,62,329.0,82,5.96,47,239,2579,9.5,0.2268078
20411,20411,Nikita Zadorov,2020-21,25.0,8,13,64,64,4,9,13,65.0,1137.0,356,22,53,75,394.0,70,5.96,42,208,2192,9.5,0.2294533
20412,20412,Nikita Zaitsev,2017-18,26.0,2,36,82,82,4,32,36,106.0,1806.0,82,4,32,36,106.0,82,5.45,47,245,2478,9.0,0.40973967
20413,20413,Nikita Zaitsev,2018-19,27.0,3,13,60,60,5,8,13,54.0,1333.0,142,9,40,49,160.0,82,5.86,50,250,2620,9.2,0.2258173
20414,20414,Nikita Zaitsev,2019-20,28.0,4,14,81,81,3,11,14,71.0,1658.0,223,12,51,63,231.0,82,5.96,47,239,2579,9.5,0.18834919
20415,20415,Nikita Zaitsev,2020-21,29.0,5,12,58,58,1,11,12,64.0,1285.0,281,13,62,75,295.0,70,5.96,42,208,2192,9.5,0.22186717
20416,20416,Niklas Andersson,1993-94,22.0,2,1,3,3,0,1,1,4.0,,3,0,1,1,4.0,84,7.25,87,443,2603,11.7,0.2411029
20417,20417,Niklas Andersson,1996-97,25.0,3,26,47,47,14,12,26,89.0,,50,14,13,27,93.0,82,6.29,74,413,2481,10.4,0.4678873
20418,20418,Niklas Andersson,1997-98,26.0,4,43,74,74,12,31,43,122.0,,124,26,44,70,215.0,82,5.83,55,336,2444,9.8,0.4736935
20419,20419,Niklas Andersson,1998-99,27.0,5,0,5,5,0,0,0,6.0,,129,26,44,70,221.0,82,5.28,57,380,2242,9.6,0.3028928
20420,20420,Niklas Andersson,2000-01,29.0,6,11,24,24,3,8,11,31.0,316.0,153,29,52,81,252.0,82,5.49,53,331,2294,9.8,0.28287634
20421,20421,Niklas Andersson,2001-02,30.0,7,1,11,11,0,1,1,8.0,123.0,164,29,53,82,260.0,82,5.51,63,376,2272,9.9,0.21420825
20422,20422,Niklas Hagman,2002-03,23.0,2,28,78,78,10,18,28,134.0,1079.0,78,10,18,28,134.0,82,5.24,53,338,2262,9.5,0.42173526
20423,20423,Niklas Hagman,2003-04,24.0,3,23,80,80,8,15,23,132.0,1081.0,158,18,33,51,266.0,82,5.31,60,363,2326,9.4,0.32527515
20424,20424,Niklas Hagman,2004-05,25.0,4,23,75,75,10,13,23,122.0,1109.0,233,28,46,74,388.0,82,5.14,57,348,2300,9.2,0.364981
20425,20425,Niklas Hagman,2006-07,27.0,5,21,84,84,8,13,21,126.0,1029.0,317,36,59,95,514.0,82,6.05,85,480,2458,10.1,0.2694432
20426,20426,Niklas Hagman,2007-08,28.0,6,29,82,82,17,12,29,152.0,1183.0,399,53,71,124,666.0,82,5.76,70,398,2426,9.7,0.4059023
20427,20427,Niklas Hagman,2008-09,29.0,7,41,82,82,27,14,41,178.0,1279.0,481,80,85,165,844.0,82,5.44,62,351,2383,9.4,0.5556987
20428,20428,Niklas Hagman,2009-10,30.0,8,42,65,65,22,20,42,168.0,1110.0,546,102,105,207,1012.0,82,5.7,65,341,2477,9.4,0.57131016
20429,20429,Niklas Hagman,2010-11,31.0,9,44,82,82,25,19,44,216.0,1322.0,628,127,124,251,1228.0,82,5.53,56,304,2486,9.1,0.5170513
20430,20430,Niklas Hagman,2011-12,32.0,10,27,71,71,11,16,27,140.0,968.0,699,138,140,278,1368.0,82,5.46,52,291,2492,9.0,0.32019728
20431,20431,Niklas Hagman,2012-13,33.0,11,23,71,71,9,14,23,125.0,1035.0,770,147,154,301,1493.0,82,5.32,47,271,2439,8.9,0.28972897
20432,20432,Niklas Hjalmarsson,2008-09,21.0,2,1,13,13,0,1,1,5.0,177.0,13,0,1,1,5.0,82,5.44,62,351,2383,9.4,0.20979112
20433,20433,Niklas Hjalmarsson,2009-10,22.0,3,3,21,21,1,2,3,15.0,315.0,34,1,3,4,20.0,82,5.7,65,341,2477,9.4,0.17545462
20434,20434,Niklas Hjalmarsson,2010-11,23.0,4,17,77,77,2,15,17,62.0,1514.0,111,3,18,21,82.0,82,5.53,56,304,2486,9.1,0.21525371
20435,20435,Niklas Hjalmarsson,2011-12,24.0,5,10,80,80,3,7,10,64.0,1478.0,191,6,25,31,146.0,82,5.46,52,291,2492,9.0,0.17802107
20436,20436,Niklas Hjalmarsson,2012-13,25.0,6,15,69,69,1,14,15,65.0,1392.0,260,7,39,46,211.0,82,5.32,47,271,2439,8.9,0.18364632
20437,20437,Niklas Hjalmarsson,2013-14,26.0,7,10,46,46,2,8,10,43.0,962.0,306,9,47,56,254.0,48,5.31,29,160,1399,9.1,0.22240508
20438,20438,Niklas Hjalmarsson,2014-15,27.0,8,26,81,81,4,22,26,98.0,1724.0,387,13,69,82,352.0,82,5.34,48,269,2463,8.9,0.26993227
20439,20439,Niklas Hjalmarsson,2015-16,28.0,9,19,82,82,3,16,19,97.0,1795.0,469,16,85,101,449.0,82,5.32,47,251,2453,8.9,0.2434453
20440,20440,Niklas Hjalmarsson,2016-17,29.0,10,24,81,81,2,22,24,77.0,1813.0,550,18,107,125,526.0,82,5.34,48,255,2438,9.0,0.23916307
20441,20441,Niklas Hjalmarsson,2017-18,30.0,11,18,73,73,5,13,18,61.0,1569.0,623,23,120,143,587.0,82,5.45,47,245,2478,9.0,0.21919838
20442,20442,Niklas Hjalmarsson,2018-19,31.0,12,9,48,48,1,8,9,32.0,994.0,671,24,128,152,619.0,82,5.86,50,250,2620,9.2,0.11878765
20443,20443,Niklas Hjalmarsson,2019-20,32.0,13,10,82,82,0,10,10,57.0,1615.0,753,24,138,162,676.0,82,5.96,47,239,2579,9.5,0.12839013
20444,20444,Niklas Hjalmarsson,2020-21,33.0,14,5,27,27,1,4,5,18.0,507.0,780,25,142,167,694.0,70,5.96,42,208,2192,9.5,0.14211202
20445,20445,Niklas Kronwall,2004-05,24.0,2,5,20,20,1,4,5,18.0,277.0,20,1,4,5,18.0,82,5.14,57,348,2300,9.2,0.19422239
20446,20446,Niklas Kronwall,2006-07,26.0,3,9,27,27,1,8,9,28.0,554.0,47,2,12,14,46.0,82,6.05,85,480,2458,10.1,0.19780934
20447,20447,Niklas Kronwall,2007-08,27.0,4,22,68,68,1,21,22,104.0,1404.0,115,3,33,36,150.0,82,5.76,70,398,2426,9.7,0.27108026
20448,20448,Niklas Kronwall,2008-09,28.0,5,35,65,65,7,28,35,108.0,1372.0,180,10,61,71,258.0,82,5.44,62,351,2383,9.4,0.4320502
20449,20449,Niklas Kronwall,2009-10,29.0,6,51,80,80,6,45,51,121.0,1832.0,260,16,106,122,379.0,82,5.7,65,341,2477,9.4,0.520069
20450,20450,Niklas Kronwall,2010-11,30.0,7,22,48,48,7,15,22,68.0,1052.0,308,23,121,144,447.0,82,5.53,56,304,2486,9.1,0.41012406
20451,20451,Niklas Kronwall,2011-12,31.0,8,37,77,77,11,26,37,131.0,1761.0,385,34,147,181,578.0,82,5.46,52,291,2492,9.0,0.44392365
20452,20452,Niklas Kronwall,2012-13,32.0,9,36,82,82,15,21,36,141.0,1875.0,467,49,168,217,719.0,82,5.32,47,271,2439,8.9,0.39830238
20453,20453,Niklas Kronwall,2013-14,33.0,10,29,48,48,5,24,29,67.0,1169.0,515,54,192,246,786.0,48,5.31,29,160,1399,9.1,0.48037705
20454,20454,Niklas Kronwall,2014-15,34.0,11,49,79,79,8,41,49,110.0,1921.0,594,62,233,295,896.0,82,5.34,48,269,2463,8.9,0.51842165
20455,20455,Niklas Kronwall,2015-16,35.0,12,44,80,80,9,35,44,101.0,1907.0,674,71,268,339,997.0,82,5.32,47,251,2453,8.9,0.46568686
20456,20456,Niklas Kronwall,2016-17,36.0,13,26,64,64,3,23,26,61.0,1409.0,738,74,291,365,1058.0,82,5.34,48,255,2438,9.0,0.30793297
20457,20457,Niklas Kronwall,2017-18,37.0,14,13,57,57,2,11,13,67.0,1109.0,795,76,302,378,1125.0,82,5.45,47,245,2478,9.0,0.19483882
20458,20458,Niklas Kronwall,2018-19,38.0,15,27,79,79,4,23,27,76.0,1463.0,874,80,325,405,1201.0,82,5.86,50,250,2620,9.2,0.26136154
20459,20459,Niklas Kronwall,2019-20,39.0,16,27,79,79,3,24,27,71.0,1576.0,953,83,349,432,1272.0,82,5.96,47,239,2579,9.5,0.24346799
20460,20460,Niklas Nordgren,2006-07,27.0,2,6,58,58,4,2,6,38.0,411.0,58,4,2,6,38.0,82,6.05,85,480,2458,10.1,0.15557843
20461,20461,Niklas Sundblad,1996-97,24.0,2,0,2,2,0,0,0,3.0,,2,0,0,0,3.0,82,6.29,74,413,2481,10.4,0.1724348
20462,20462,Niklas Sundstrom,1996-97,21.0,2,21,82,82,9,12,21,90.0,,82,9,12,21,90.0,82,6.29,74,413,2481,10.4,0.33467746
20463,20463,Niklas Sundstrom,1997-98,22.0,3,52,82,82,24,28,52,132.0,,164,33,40,73,222.0,82,5.83,55,336,2444,9.8,0.6711004
20464,20464,Niklas Sundstrom,1998-99,23.0,4,47,70,70,19,28,47,115.0,,234,52,68,120,337.0,82,5.28,57,380,2242,9.6,0.64432293
20465,20465,Niklas Sundstrom,1999-00,24.0,5,43,81,81,13,30,43,89.0,1554.0,315,65,98,163,426.0,82,5.27,57,359,2285,9.4,0.5455571
20466,20466,Niklas Sundstrom,2000-01,25.0,6,37,79,79,12,25,37,90.0,1198.0,394,77,123,200,516.0,82,5.49,53,331,2294,9.8,0.51690656
20467,20467,Niklas Sundstrom,2001-02,26.0,7,49,82,82,10,39,49,100.0,1372.0,476,87,162,249,616.0,82,5.51,63,376,2272,9.9,0.5730421
20468,20468,Niklas Sundstrom,2002-03,27.0,8,39,73,73,9,30,39,74.0,1164.0,549,96,192,288,690.0,82,5.24,53,338,2262,9.5,0.4967349
20469,20469,Niklas Sundstrom,2003-04,28.0,9,26,80,80,7,19,26,71.0,1141.0,629,103,211,314,761.0,82,5.31,60,363,2326,9.4,0.3198385
20470,20470,Niklas Sundstrom,2004-05,29.0,10,20,66,66,8,12,20,67.0,943.0,695,111,223,334,828.0,82,5.14,57,348,2300,9.2,0.34698832
20471,20471,Niklas Sundstrom,2006-07,31.0,11,15,55,55,6,9,15,54.0,772.0,750,117,232,349,882.0,82,6.05,85,480,2458,10.1,0.2516966
20472,20472,Niko Dimitrakos,2003-04,24.0,2,13,21,21,6,7,13,34.0,299.0,21,6,7,13,34.0,82,5.31,60,363,2326,9.4,0.364511
20473,20473,Niko Dimitrakos,2004-05,25.0,3,24,68,68,9,15,24,116.0,906.0,89,15,22,37,150.0,82,5.14,57,348,2300,9.2,0.38555133
20474,20474,Niko Dimitrakos,2006-07,27.0,4,25,64,64,9,16,25,93.0,742.0,153,24,38,62,243.0,82,6.05,85,480,2458,10.1,0.32597122
20475,20475,Niko Dimitrakos,2007-08,28.0,5,0,5,5,0,0,0,4.0,43.0,158,24,38,62,247.0,82,5.76,70,398,2426,9.7,0.22607854
20476,20476,Niko Kapanen,2002-03,24.0,2,1,9,9,0,1,1,3.0,88.0,9,0,1,1,3.0,82,5.24,53,338,2262,9.5,0.18390617
20477,20477,Niko Kapanen,2003-04,25.0,3,34,82,82,5,29,34,80.0,1201.0,91,5,30,35,83.0,82,5.31,60,363,2326,9.4,0.3934499
20478,20478,Niko Kapanen,2004-05,26.0,4,6,67,67,1,5,6,57.0,771.0,158,6,35,41,140.0,82,5.14,57,348,2300,9.2,0.18687773
20479,20479,Niko Kapanen,2006-07,28.0,5,35,81,81,14,21,35,97.0,1152.0,239,20,56,76,237.0,82,6.05,85,480,2458,10.1,0.39456
20480,20480,Niko Kapanen,2007-08,29.0,6,22,79,79,6,16,22,79.0,979.0,318,26,72,98,316.0,82,5.76,70,398,2426,9.7,0.26377583
20481,20481,Niko Kapanen,2008-09,30.0,7,28,79,79,10,18,28,85.0,1091.0,397,36,90,126,401.0,82,5.44,62,351,2383,9.4,0.31759092
20482,20482,Niko Mikkola,2020-21,24.0,2,1,5,5,0,1,1,10.0,72.0,5,0,1,1,10.0,70,5.96,42,208,2192,9.5,0.2210508
20483,20483,Nikolai Borschevsky,1993-94,29.0,2,74,78,78,34,40,74,204.0,,78,34,40,74,204.0,84,7.25,87,443,2603,11.7,0.7237173
20484,20484,Nikolai Borschevsky,1994-95,30.0,3,34,45,45,14,20,34,105.0,,123,48,60,108,309.0,84,6.48,76,407,2545,10.7,0.5453064
20485,20485,Nikolai Borschevsky,1995-96,31.0,4,10,27,27,0,10,10,40.0,,150,48,70,118,349.0,48,5.97,37,209,1408,10.2,0.34656495
20486,20486,Nikolai Borschevsky,1996-97,32.0,5,4,12,12,1,3,4,22.0,,162,49,73,122,371.0,82,6.29,74,413,2481,10.4,0.30226514
20487,20487,Nikolai Knyzhov,2020-21,22.0,2,0,3,3,0,0,0,0.0,32.0,3,0,0,0,0.0,70,5.96,42,208,2192,9.5,0.18262485
20488,20488,Nikolai Kulemin,2009-10,23.0,2,31,73,73,15,16,31,129.0,1008.0,73,15,16,31,129.0,82,5.7,65,341,2477,9.4,0.47412676
20489,20489,Nikolai Kulemin,2010-11,24.0,3,36,78,78,16,20,36,145.0,1277.0,151,31,36,67,274.0,82,5.53,56,304,2486,9.1,0.4572792
20490,20490,Nikolai Kulemin,2011-12,25.0,4,57,82,82,30,27,57,173.0,1421.0,233,61,63,124,447.0,82,5.46,52,291,2492,9.0,0.6354205
20491,20491,Nikolai Kulemin,2012-13,26.0,5,28,70,70,7,21,28,107.0,1066.0,303,68,84,152,554.0,82,5.32,47,271,2439,8.9,0.44767582
20492,20492,Nikolai Kulemin,2013-14,27.0,6,23,48,48,7,16,23,72.0,803.0,351,75,100,175,626.0,48,5.31,29,160,1399,9.1,0.51484543
20493,20493,Nikolai Kulemin,2014-15,28.0,7,20,70,70,9,11,20,81.0,1136.0,421,84,111,195,707.0,82,5.34,48,269,2463,8.9,0.3295299
20494,20494,Nikolai Kulemin,2015-16,29.0,8,31,82,82,15,16,31,115.0,1219.0,503,99,127,226,822.0,82,5.32,47,251,2453,8.9,0.40057114
20495,20495,Nikolai Kulemin,2016-17,30.0,9,22,81,81,9,13,22,92.0,1139.0,584,108,140,248,914.0,82,5.34,48,255,2438,9.0,0.29403555
20496,20496,Nikolai Kulemin,2017-18,31.0,10,23,72,72,12,11,23,74.0,995.0,656,120,151,271,988.0,82,5.45,47,245,2478,9.0,0.30176693
20497,20497,Nikolai Kulemin,2018-19,32.0,11,3,13,13,1,2,3,7.0,155.0,669,121,153,274,995.0,82,5.86,50,250,2620,9.2,0.22641036
20498,20498,Nikolai Prokhorkin,2020-21,27.0,2,14,43,43,4,10,14,63.0,520.0,43,4,10,14,63.0,70,5.96,42,208,2192,9.5,0.2861251
20499,20499,Nikolai Tsulygin,1997-98,22.0,2,1,22,22,0,1,1,10.0,,22,0,1,1,10.0,82,5.83,55,336,2444,9.8,0.12790087
20500,20500,Nikolai Zherdev,2004-05,20.0,2,34,57,57,13,21,34,137.0,922.0,57,13,21,34,137.0,82,5.14,57,348,2300,9.2,0.8060522
20501,20501,Nikolai Zherdev,2006-07,22.0,3,54,73,73,27,27,54,194.0,1284.0,130,40,48,88,331.0,82,6.05,85,480,2458,10.1,0.7526108
20502,20502,Nikolai Zherdev,2007-08,23.0,4,32,71,71,10,22,32,164.0,1152.0,201,50,70,120,495.0,82,5.76,70,398,2426,9.7,0.5405588
20503,20503,Nikolai Zherdev,2008-09,24.0,5,61,82,82,26,35,61,254.0,1589.0,283,76,105,181,749.0,82,5.44,62,351,2383,9.4,0.80931604
20504,20504,Nikolai Zherdev,2009-10,25.0,6,58,82,82,23,35,58,219.0,1380.0,365,99,140,239,968.0,82,5.7,65,341,2477,9.4,0.690114
20505,20505,Nikolai Zherdev,2011-12,27.0,7,22,56,56,16,6,22,135.0,720.0,421,115,146,261,1103.0,82,5.46,52,291,2492,9.0,0.5134313
20506,20506,Nikolaj Ehlers,2016-17,20.0,2,38,72,72,15,23,38,167.0,1159.0,72,15,23,38,167.0,82,5.34,48,255,2438,9.0,0.58339894
20507,20507,Nikolaj Ehlers,2017-18,21.0,3,64,82,82,25,39,64,204.0,1434.0,154,40,62,102,371.0,82,5.45,47,245,2478,9.0,0.792511
20508,20508,Nikolaj Ehlers,2018-19,22.0,4,60,82,82,29,31,60,231.0,1319.0,236,69,93,162,602.0,82,5.86,50,250,2620,9.2,0.7508396
20509,20509,Nikolaj Ehlers,2019-20,23.0,5,37,62,62,21,16,37,158.0,977.0,298,90,109,199,760.0,82,5.96,47,239,2579,9.5,0.68711406
20510,20510,Nikolaj Ehlers,2020-21,24.0,6,58,71,71,25,33,58,203.0,1173.0,369,115,142,257,963.0,70,5.96,42,208,2192,9.5,0.82874036
20511,20511,Nikolay Goldobin,2016-17,21.0,2,2,9,9,1,1,2,7.0,101.0,9,1,1,2,7.0,82,5.34,48,255,2438,9.0,0.25398582
20512,20512,Nikolay Goldobin,2017-18,22.0,3,3,14,14,3,0,3,14.0,159.0,23,4,1,5,21.0,82,5.45,47,245,2478,9.0,0.29575586
20513,20513,Nikolay Goldobin,2018-19,23.0,4,14,38,38,8,6,14,50.0,469.0,61,12,7,19,71.0,82,5.86,50,250,2620,9.2,0.32744867
20514,20514,Nikolay Goldobin,2019-20,24.0,5,27,63,63,7,20,27,105.0,944.0,124,19,27,46,176.0,82,5.96,47,239,2579,9.5,0.3708797
20515,20515,Nikolay Goldobin,2020-21,25.0,6,0,1,1,0,0,0,0.0,9.0,125,19,27,46,176.0,70,5.96,42,208,2192,9.5,0.19771987
20516,20516,Nikos Tselios,2002-03,24.0,2,0,2,2,0,0,0,3.0,26.0,2,0,0,0,3.0,82,5.24,53,338,2262,9.5,0.17170015
20517,20517,Nils Ekman,2000-01,24.0,2,4,28,28,2,2,4,42.0,313.0,28,2,2,4,42.0,82,5.49,53,331,2294,9.8,0.2077182
20518,20518,Nils Ekman,2001-02,25.0,3,20,43,43,9,11,20,72.0,678.0,71,11,13,24,114.0,82,5.51,63,376,2272,9.9,0.37086415
20519,20519,Nils Ekman,2004-05,28.0,4,55,82,82,22,33,55,147.0,1222.0,153,33,46,79,261.0,82,5.14,57,348,2300,9.2,0.6896476
20520,20520,Nils Ekman,2006-07,30.0,5,57,77,77,21,36,57,176.0,1171.0,230,54,82,136,437.0,82,6.05,85,480,2458,10.1,0.6192941
20521,20521,Nils Ekman,2007-08,31.0,6,15,34,34,6,9,15,69.0,469.0,264,60,91,151,506.0,82,5.76,70,398,2426,9.7,0.38606718
20522,20522,Nino Niederreiter,2011-12,19.0,2,2,9,9,1,1,2,12.0,122.0,9,1,1,2,12.0,82,5.46,52,291,2492,9.0,0.27683085
20523,20523,Nino Niederreiter,2012-13,20.0,3,1,55,55,1,0,1,74.0,556.0,64,2,1,3,86.0,82,5.32,47,271,2439,8.9,0.2532615
20524,20524,Nino Niederreiter,2014-15,22.0,4,36,81,81,14,22,36,143.0,1142.0,145,16,23,39,229.0,82,5.34,48,269,2463,8.9,0.46353537
20525,20525,Nino Niederreiter,2015-16,23.0,5,37,80,80,24,13,37,149.0,1164.0,225,40,36,76,378.0,82,5.32,47,251,2453,8.9,0.5604786
20526,20526,Nino Niederreiter,2016-17,24.0,6,43,82,82,20,23,43,159.0,1275.0,307,60,59,119,537.0,82,5.34,48,255,2438,9.0,0.5157958
20527,20527,Nino Niederreiter,2017-18,25.0,7,57,82,82,25,32,57,186.0,1236.0,389,85,91,176,723.0,82,5.45,47,245,2478,9.0,0.6911576
20528,20528,Nino Niederreiter,2018-19,26.0,8,32,63,63,18,14,32,133.0,945.0,452,103,105,208,856.0,82,5.86,50,250,2620,9.2,0.53649044
20529,20529,Nino Niederreiter,2019-20,27.0,9,53,82,82,23,30,53,184.0,1330.0,534,126,135,261,1040.0,82,5.96,47,239,2579,9.5,0.6096369
20530,20530,Nino Niederreiter,2020-21,28.0,10,29,67,67,11,18,29,115.0,993.0,601,137,153,290,1155.0,70,5.96,42,208,2192,9.5,0.42476603
20531,20531,Noah Clarke,2004-05,25.0,2,1,2,2,0,1,1,3.0,19.0,2,0,1,1,3.0,82,5.14,57,348,2300,9.2,0.17799836
20532,20532,Noah Clarke,2006-07,27.0,3,0,5,5,0,0,0,3.0,37.0,7,0,1,1,6.0,82,6.05,85,480,2458,10.1,0.15559566
20533,20533,Noah Clarke,2007-08,28.0,4,2,13,13,2,0,2,11.0,112.0,20,2,1,3,17.0,82,5.76,70,398,2426,9.7,0.21341094
20534,20534,Noah Clarke,2008-09,29.0,5,1,1,1,1,0,1,3.0,11.0,21,3,1,4,20.0,82,5.44,62,351,2383,9.4,0.1565983
20535,20535,Noah Dobson,2020-21,21.0,2,7,34,34,1,6,7,37.0,451.0,34,1,6,7,37.0,70,5.96,42,208,2192,9.5,0.2573276
20536,20536,Noah Gregor,2020-21,22.0,2,5,28,28,3,2,5,33.0,282.0,28,3,2,5,33.0,70,5.96,42,208,2192,9.5,0.28938955
20537,20537,Noah Hanifin,2016-17,20.0,2,22,79,79,4,18,22,122.0,1414.0,79,4,18,22,122.0,82,5.34,48,255,2438,9.0,0.32786006
20538,20538,Noah Hanifin,2017-18,21.0,3,29,81,81,4,25,29,108.0,1452.0,160,8,43,51,230.0,82,5.45,47,245,2478,9.0,0.3898127
20539,20539,Noah Hanifin,2018-19,22.0,4,32,79,79,10,22,32,165.0,1490.0,239,18,65,83,395.0,82,5.86,50,250,2620,9.2,0.44262528
20540,20540,Noah Hanifin,2019-20,23.0,5,33,80,80,5,28,33,116.0,1662.0,319,23,93,116,511.0,82,5.96,47,239,2579,9.5,0.4400302
20541,20541,Noah Hanifin,2020-21,24.0,6,22,70,70,5,17,22,132.0,1482.0,389,28,110,138,643.0,70,5.96,42,208,2192,9.5,0.4103653
20542,20542,Noah Juulsen,2018-19,21.0,2,3,23,23,1,2,3,33.0,447.0,23,1,2,3,33.0,82,5.86,50,250,2620,9.2,0.25617212
20543,20543,Noah Juulsen,2019-20,22.0,3,5,21,21,1,4,5,22.0,359.0,44,2,6,8,55.0,82,5.96,47,239,2579,9.5,0.22610211
20544,20544,Noah Welch,2006-07,24.0,2,4,5,5,1,3,4,5.0,87.0,5,1,3,4,5.0,82,6.05,85,480,2458,10.1,0.22392264
20545,20545,Noah Welch,2007-08,25.0,3,3,24,24,2,1,3,18.0,335.0,29,3,4,7,23.0,82,5.76,70,398,2426,9.7,0.18057594
20546,20546,Noah Welch,2008-09,26.0,4,0,4,4,0,0,0,0.0,32.0,33,3,4,7,23.0,82,5.44,62,351,2383,9.4,0.15089366
20547,20547,Noah Welch,2009-10,27.0,5,2,40,40,1,1,2,22.0,438.0,73,4,5,9,45.0,82,5.7,65,341,2477,9.4,0.10592687
20548,20548,Noah Welch,2011-12,29.0,6,0,2,2,0,0,0,1.0,35.0,75,4,5,9,46.0,82,5.46,52,291,2492,9.0,0.12497911
20549,20549,Noel Acciari,2016-17,25.0,2,1,19,19,0,1,1,18.0,188.0,19,0,1,1,18.0,82,5.34,48,255,2438,9.0,0.14012825
20550,20550,Noel Acciari,2017-18,26.0,3,5,29,29,2,3,5,24.0,301.0,48,2,4,6,42.0,82,5.45,47,245,2478,9.0,0.20336556
20551,20551,Noel Acciari,2018-19,27.0,4,11,60,60,10,1,11,66.0,775.0,108,12,5,17,108.0,82,5.86,50,250,2620,9.2,0.21218336
20552,20552,Noel Acciari,2019-20,28.0,5,14,72,72,6,8,14,99.0,935.0,180,18,13,31,207.0,82,5.96,47,239,2579,9.5,0.20997876
20553,20553,Noel Acciari,2020-21,29.0,6,27,66,66,20,7,27,108.0,1054.0,246,38,20,58,315.0,70,5.96,42,208,2192,9.5,0.36431292
20554,20554,Nolan Baumgartner,1996-97,20.0,2,0,1,1,0,0,0,0.0,,1,0,0,0,0.0,82,6.29,74,413,2481,10.4,0.22526118
20555,20555,Nolan Baumgartner,1998-99,22.0,3,1,4,4,0,1,1,4.0,,5,0,1,1,4.0,82,5.28,57,380,2242,9.6,0.20859858
20556,20556,Nolan Baumgartner,1999-00,23.0,4,0,5,5,0,0,0,1.0,43.0,10,0,1,1,5.0,82,5.27,57,359,2285,9.4,0.16236725
20557,20557,Nolan Baumgartner,2000-01,24.0,5,1,8,8,0,1,1,6.0,84.0,18,0,2,2,11.0,82,5.49,53,331,2294,9.8,0.14768589
20558,20558,Nolan Baumgartner,2001-02,25.0,6,0,8,8,0,0,0,7.0,101.0,26,0,2,2,18.0,82,5.51,63,376,2272,9.9,0.14240488
20559,20559,Nolan Baumgartner,2003-04,27.0,7,3,8,8,1,2,3,7.0,93.0,34,1,4,5,25.0,82,5.31,60,363,2326,9.4,0.17142507
20560,20560,Nolan Baumgartner,2004-05,28.0,8,3,14,14,0,3,3,15.0,203.0,48,1,7,8,40.0,82,5.14,57,348,2300,9.2,0.21707878
20561,20561,Nolan Baumgartner,2006-07,30.0,9,34,70,70,5,29,34,73.0,1154.0,118,6,36,42,113.0,82,6.05,85,480,2458,10.1,0.34356034
20562,20562,Nolan Baumgartner,2007-08,31.0,10,3,13,13,0,3,3,8.0,176.0,131,6,39,45,121.0,82,5.76,70,398,2426,9.7,0.18311158
20563,20563,Nolan Baumgartner,2010-11,34.0,11,2,12,12,1,1,2,12.0,170.0,143,7,40,47,133.0,82,5.53,56,304,2486,9.1,0.17048669
20564,20564,Nolan Patrick,2018-19,20.0,2,30,73,73,13,17,30,127.0,1002.0,73,13,17,30,127.0,82,5.86,50,250,2620,9.2,0.47313544
20565,20565,Nolan Patrick,2019-20,21.0,3,31,72,72,13,18,31,115.0,1086.0,145,26,35,61,242.0,82,5.96,47,239,2579,9.5,0.47943667
20566,20566,Nolan Pratt,1997-98,22.0,2,2,9,9,0,2,2,4.0,,9,0,2,2,4.0,82,5.83,55,336,2444,9.8,0.1960339
20567,20567,Nolan Pratt,1998-99,23.0,3,2,23,23,0,2,2,11.0,,32,0,4,4,15.0,82,5.28,57,380,2242,9.6,0.12912402
20568,20568,Nolan Pratt,1999-00,24.0,4,15,61,61,1,14,15,46.0,1022.0,93,1,18,19,61.0,82,5.27,57,359,2285,9.4,0.18801036
20569,20569,Nolan Pratt,2000-01,25.0,5,4,64,64,3,1,4,47.0,1227.0,157,4,19,23,108.0,82,5.49,53,331,2294,9.8,0.15244916
20570,20570,Nolan Pratt,2001-02,26.0,6,3,46,46,1,2,3,26.0,452.0,203,5,21,26,134.0,82,5.51,63,376,2272,9.9,0.123304844
20571,20571,Nolan Pratt,2002-03,27.0,7,3,46,46,0,3,3,38.0,847.0,249,5,24,29,172.0,82,5.24,53,338,2262,9.5,0.11957455
20572,20572,Nolan Pratt,2003-04,28.0,8,8,67,67,1,7,8,38.0,1177.0,316,6,31,37,210.0,82,5.31,60,363,2326,9.4,0.124742895
20573,20573,Nolan Pratt,2004-05,29.0,9,4,58,58,1,3,4,35.0,952.0,374,7,34,41,245.0,82,5.14,57,348,2300,9.2,0.13862455
20574,20574,Nolan Pratt,2006-07,31.0,10,9,82,82,0,9,9,26.0,1475.0,456,7,43,50,271.0,82,6.05,85,480,2458,10.1,0.09772399
20575,20575,Nolan Pratt,2007-08,32.0,11,8,81,81,1,7,8,30.0,1279.0,537,8,50,58,301.0,82,5.76,70,398,2426,9.7,0.09822351
20576,20576,Nolan Pratt,2008-09,33.0,12,7,55,55,1,6,7,21.0,744.0,592,9,56,65,322.0,82,5.44,62,351,2383,9.4,0.09557
20577,20577,Nolan Yonkman,2002-03,21.0,2,1,11,11,1,0,1,7.0,140.0,11,1,0,1,7.0,82,5.24,53,338,2262,9.5,0.18365887
20578,20578,Nolan Yonkman,2004-05,23.0,3,0,1,1,0,0,0,0.0,5.0,12,1,0,1,7.0,82,5.14,57,348,2300,9.2,0.20768464
20579,20579,Nolan Yonkman,2006-07,25.0,4,7,38,38,0,7,7,14.0,313.0,50,1,7,8,21.0,82,6.05,85,480,2458,10.1,0.122023374
20580,20580,Nolan Yonkman,2011-12,30.0,5,1,16,16,0,1,1,8.0,194.0,66,1,8,9,29.0,82,5.46,52,291,2492,9.0,0.11293593
20581,20581,Nolan Yonkman,2012-13,31.0,6,0,1,1,0,0,0,0.0,6.0,67,1,8,9,29.0,82,5.32,47,271,2439,8.9,0.113683164
20582,20582,Nolan Yonkman,2013-14,32.0,7,0,7,7,0,0,0,4.0,68.0,74,1,8,9,33.0,48,5.31,29,160,1399,9.1,0.12644851
20583,20583,Nolan Yonkman,2014-15,33.0,8,1,2,2,0,1,1,3.0,30.0,76,1,9,10,36.0,82,5.34,48,269,2463,8.9,0.12200901
20584,20584,Norm Aubin,1982-83,22.0,2,26,43,43,14,12,26,62.0,,43,14,12,26,62.0,80,8.03,73,320,2489,12.9,0.5362673
20585,20585,Norm Aubin,1983-84,23.0,3,5,26,26,4,1,5,18.0,,69,18,13,31,80.0,80,7.73,71,310,2444,12.7,0.34754607
20586,20586,Norm Dupont,1980-81,23.0,2,4,35,35,1,3,4,18.0,,35,1,3,4,18.0,80,7.03,61,280,2352,12.0,0.2111682
20587,20587,Norm Dupont,1981-82,24.0,3,53,80,80,27,26,53,215.0,,115,28,29,57,233.0,80,7.69,77,340,2441,12.6,0.70442295
20588,20588,Norm Dupont,1982-83,25.0,4,38,62,62,13,25,38,148.0,,177,41,54,95,381.0,80,8.03,73,320,2489,12.9,0.5697895
20589,20589,Norm Dupont,1983-84,26.0,5,23,39,39,7,16,23,71.0,,216,48,70,118,452.0,80,7.73,71,310,2444,12.7,0.49495694
20590,20590,Norm Dupont,1984-85,27.0,6,22,40,40,7,15,22,85.0,,256,55,85,140,537.0,80,7.89,74,336,2448,12.9,0.54254085
20591,20591,Norm Maciver,1987-88,23.0,2,1,4,4,0,1,1,2.0,,4,0,1,1,2.0,80,7.34,72,344,2400,12.2,0.25002423
20592,20592,Norm Maciver,1988-89,24.0,3,24,37,37,9,15,24,65.0,,41,9,16,25,67.0,80,7.43,89,437,2435,12.2,0.4431358
20593,20593,Norm Maciver,1989-90,25.0,4,33,63,63,1,32,33,87.0,,104,10,48,58,154.0,80,7.48,85,403,2430,12.3,0.42363563
20594,20594,Norm Maciver,1990-91,26.0,5,0,1,1,0,0,0,0.0,,105,10,48,58,154.0,80,7.37,76,367,2421,12.2,0.26595646
20595,20595,Norm Maciver,1991-92,27.0,6,7,21,21,2,5,7,25.0,,126,12,53,65,179.0,80,6.91,71,366,2385,11.6,0.32683742
20596,20596,Norm Maciver,1992-93,28.0,7,40,57,57,6,34,40,69.0,,183,18,87,105,248.0,80,6.96,77,402,2440,11.4,0.5423744
20597,20597,Norm Maciver,1993-94,29.0,8,63,80,80,17,46,63,184.0,,263,35,133,168,432.0,84,7.25,87,443,2603,11.7,0.6445633
20598,20598,Norm Maciver,1994-95,30.0,9,23,53,53,3,20,23,88.0,,316,38,153,191,520.0,84,6.48,76,407,2545,10.7,0.41784173
20599,20599,Norm Maciver,1995-96,31.0,10,20,41,41,4,16,20,50.0,,357,42,169,211,570.0,48,5.97,37,209,1408,10.2,0.47255567
20600,20600,Norm Maciver,1996-97,32.0,11,53,71,71,7,46,53,79.0,,428,49,215,264,649.0,82,6.29,74,413,2481,10.4,0.5538053
20601,20601,Norm Maciver,1997-98,33.0,12,13,32,32,4,9,13,40.0,,460,53,224,277,689.0,82,5.83,55,336,2444,9.8,0.2714435
20602,20602,Norm Maciver,1998-99,34.0,13,8,41,41,2,6,8,37.0,,501,55,230,285,726.0,82,5.28,57,380,2242,9.6,0.18271977
20603,20603,Norm Milley,2002-03,22.0,2,1,5,5,0,1,1,10.0,66.0,5,0,1,1,10.0,82,5.24,53,338,2262,9.5,0.2144045
20604,20604,Norm Milley,2003-04,23.0,3,2,8,8,0,2,2,8.0,85.0,13,0,3,3,18.0,82,5.31,60,363,2326,9.4,0.18633834
20605,20605,Norm Milley,2004-05,24.0,4,0,2,2,0,0,0,2.0,17.0,15,0,3,3,20.0,82,5.14,57,348,2300,9.2,0.1801213
20606,20606,Norm Milley,2006-07,26.0,5,3,14,14,2,1,3,12.0,100.0,29,2,4,6,32.0,82,6.05,85,480,2458,10.1,0.22234797
20607,20607,Norm Schmidt,1984-85,22.0,2,18,34,34,6,12,18,56.0,,34,6,12,18,56.0,80,7.89,74,336,2448,12.9,0.4903332
20608,20608,Norm Schmidt,1986-87,24.0,3,29,66,66,15,14,29,141.0,,100,21,26,47,197.0,80,7.94,82,370,2484,12.8,0.45717567
20609,20609,Norm Schmidt,1987-88,25.0,4,6,20,20,1,5,6,32.0,,120,22,31,53,229.0,80,7.34,72,344,2400,12.2,0.33998162
20610,20610,Norm Schmidt,1988-89,26.0,5,3,5,5,1,2,3,13.0,,125,23,33,56,242.0,80,7.43,89,437,2435,12.2,0.3246205
20611,20611,Normand Baron,1984-85,27.0,2,0,4,4,0,0,0,2.0,,4,0,0,0,2.0,80,7.89,74,336,2448,12.9,0.21566072
20612,20612,Normand Baron,1986-87,29.0,3,2,23,23,2,0,2,13.0,,27,2,0,2,15.0,80,7.94,82,370,2484,12.8,0.21316049
20613,20613,Normand Lacombe,1985-86,21.0,2,6,30,30,2,4,6,30.0,,30,2,4,6,30.0,80,7.77,71,321,2447,12.7,0.32132998
20614,20614,Normand Lacombe,1986-87,22.0,3,13,25,25,6,7,13,38.0,,55,8,11,19,68.0,80,7.94,82,370,2484,12.8,0.3891081
20615,20615,Normand Lacombe,1987-88,23.0,4,11,40,40,4,7,11,48.0,,95,12,18,30,116.0,80,7.34,72,344,2400,12.2,0.3349207
20616,20616,Normand Lacombe,1988-89,24.0,5,17,53,53,8,9,17,44.0,,148,20,27,47,160.0,80,7.43,89,437,2435,12.2,0.3745966
20617,20617,Normand Lacombe,1989-90,25.0,6,28,64,64,17,11,28,71.0,,212,37,38,75,231.0,80,7.48,85,403,2430,12.3,0.4062852
20618,20618,Normand Lacombe,1990-91,26.0,7,9,33,33,5,4,9,36.0,,245,42,42,84,267.0,80,7.37,76,367,2421,12.2,0.3142993
20619,20619,Normand Lacombe,1991-92,27.0,8,31,74,74,11,20,31,91.0,,319,53,62,115,358.0,80,6.91,71,366,2385,11.6,0.3868738
20620,20620,Normand Leveille,1982-83,20.0,2,33,66,66,14,19,33,148.0,,66,14,19,33,148.0,80,8.03,73,320,2489,12.9,0.67025805
20621,20621,Normand Leveille,1983-84,21.0,3,9,9,9,3,6,9,32.0,,75,17,25,42,180.0,80,7.73,71,310,2444,12.7,0.53986883
20622,20622,Normand Rochefort,1981-82,21.0,2,10,56,56,3,7,10,77.0,,56,3,7,10,77.0,80,7.69,77,340,2441,12.6,0.34521872
20623,20623,Normand Rochefort,1982-83,22.0,3,18,72,72,4,14,18,105.0,,128,7,21,28,182.0,80,8.03,73,320,2489,12.9,0.3270419
20624,20624,Normand Rochefort,1983-84,23.0,4,23,62,62,6,17,23,104.0,,190,13,38,51,286.0,80,7.73,71,310,2444,12.7,0.38560086
20625,20625,Normand Rochefort,1984-85,24.0,5,24,75,75,2,22,24,83.0,,265,15,60,75,369.0,80,7.89,74,336,2448,12.9,0.29374838
20626,20626,Normand Rochefort,1985-86,25.0,6,24,73,73,3,21,24,111.0,,338,18,81,99,480.0,80,7.77,71,321,2447,12.7,0.33059508
20627,20627,Normand Rochefort,1986-87,26.0,7,9,26,26,5,4,9,51.0,,364,23,85,108,531.0,80,7.94,82,370,2484,12.8,0.35266176
20628,20628,Normand Rochefort,1987-88,27.0,8,15,70,70,6,9,15,92.0,,434,29,94,123,623.0,80,7.34,72,344,2400,12.2,0.28608993
20629,20629,Normand Rochefort,1988-89,28.0,9,13,46,46,3,10,13,70.0,,480,32,104,136,693.0,80,7.43,89,437,2435,12.2,0.27595013
20630,20630,Normand Rochefort,1989-90,29.0,10,6,11,11,1,5,6,14.0,,491,33,109,142,707.0,80,7.48,85,403,2430,12.3,0.25579548
20631,20631,Normand Rochefort,1990-91,30.0,11,4,31,31,3,1,4,30.0,,522,36,110,146,737.0,80,7.37,76,367,2421,12.2,0.23604023
20632,20632,Normand Rochefort,1991-92,31.0,12,10,44,44,3,7,10,34.0,,566,39,117,156,771.0,80,6.91,71,366,2385,11.6,0.1983498
20633,20633,Normand Rochefort,1992-93,32.0,13,2,26,26,0,2,2,18.0,,592,39,119,158,789.0,80,6.96,77,402,2440,11.4,0.1298508
20634,20634,Normand Rochefort,1994-95,34.0,14,0,6,6,0,0,0,4.0,,598,39,119,158,793.0,84,6.48,76,407,2545,10.7,0.09609285
20635,20635,Ole-Kristian Tollefsen,2006-07,22.0,2,0,5,5,0,0,0,3.0,82.0,5,0,0,0,3.0,82,6.05,85,480,2458,10.1,0.1856696
20636,20636,Ole-Kristian Tollefsen,2007-08,23.0,3,5,70,70,2,3,5,39.0,996.0,75,2,3,5,42.0,82,5.76,70,398,2426,9.7,0.16419843
20637,20637,Ole-Kristian Tollefsen,2008-09,24.0,4,4,51,51,2,2,4,21.0,628.0,126,4,5,9,63.0,82,5.44,62,351,2383,9.4,0.12511304
20638,20638,Ole-Kristian Tollefsen,2009-10,25.0,5,1,19,19,0,1,1,12.0,196.0,145,4,6,10,75.0,82,5.7,65,341,2477,9.4,0.1082463
20639,20639,Ole-Kristian Tollefsen,2010-11,26.0,6,2,18,18,0,2,2,12.0,177.0,163,4,8,12,87.0,82,5.53,56,304,2486,9.1,0.14679542
20640,20640,Oleg Kvasha,1999-00,21.0,2,25,68,68,12,13,25,138.0,870.0,68,12,13,25,138.0,82,5.27,57,359,2285,9.4,0.45543864
20641,20641,Oleg Kvasha,2000-01,22.0,3,25,78,78,5,20,25,110.0,890.0,146,17,33,50,248.0,82,5.49,53,331,2294,9.8,0.34259453
20642,20642,Oleg Kvasha,2001-02,23.0,4,20,62,62,11,9,20,118.0,926.0,208,28,42,70,366.0,82,5.51,63,376,2272,9.9,0.38809466
20643,20643,Oleg Kvasha,2002-03,24.0,5,38,71,71,13,25,38,119.0,1008.0,279,41,67,108,485.0,82,5.24,53,338,2262,9.5,0.5107829
20644,20644,Oleg Kvasha,2003-04,25.0,6,26,69,69,12,14,26,121.0,901.0,348,53,81,134,606.0,82,5.31,60,363,2326,9.4,0.4369101
20645,20645,Oleg Kvasha,2004-05,26.0,7,51,81,81,15,36,51,147.0,1447.0,429,68,117,185,753.0,82,5.14,57,348,2300,9.2,0.6964344
20646,20646,Oleg Kvasha,2006-07,28.0,8,32,64,64,13,19,32,136.0,910.0,493,81,136,217,889.0,82,6.05,85,480,2458,10.1,0.46796596
20647,20647,Oleg Mikulchik,1994-95,30.0,2,1,4,4,0,1,1,3.0,,4,0,1,1,3.0,84,6.48,76,407,2545,10.7,0.16531447
20648,20648,Oleg Mikulchik,1995-96,31.0,3,2,25,25,0,2,2,5.0,,29,0,3,3,8.0,48,5.97,37,209,1408,10.2,0.103230536
20649,20649,Oleg Mikulchik,1996-97,32.0,4,0,8,8,0,0,0,0.0,,37,0,3,3,8.0,82,6.29,74,413,2481,10.4,0.121379554
20650,20650,Oleg Petrov,1993-94,22.0,2,3,9,9,2,1,3,20.0,,9,2,1,3,20.0,84,7.25,87,443,2603,11.7,0.34150696
20651,20651,Oleg Petrov,1994-95,23.0,3,27,55,55,12,15,27,107.0,,64,14,16,30,127.0,84,6.48,76,407,2545,10.7,0.47886178
20652,20652,Oleg Petrov,1995-96,24.0,4,5,12,12,2,3,5,26.0,,76,16,19,35,153.0,48,5.97,37,209,1408,10.2,0.35250068
20653,20653,Oleg Petrov,1996-97,25.0,5,11,36,36,4,7,11,44.0,,112,20,26,46,197.0,82,6.29,74,413,2481,10.4,0.27530342
20654,20654,Oleg Petrov,2000-01,29.0,6,26,44,44,2,24,26,96.0,697.0,156,22,50,72,293.0,82,5.49,53,331,2294,9.8,0.4807207
20655,20655,Oleg Petrov,2001-02,30.0,7,47,81,81,17,30,47,158.0,1503.0,237,39,80,119,451.0,82,5.51,63,376,2272,9.9,0.5309097
20656,20656,Oleg Petrov,2002-03,31.0,8,41,75,75,24,17,41,152.0,1421.0,312,63,97,160,603.0,82,5.24,53,338,2262,9.5,0.5012439
20657,20657,Oleg Petrov,2003-04,32.0,9,27,70,70,9,18,27,124.0,1006.0,382,72,115,187,727.0,82,5.31,60,363,2326,9.4,0.33379644
20658,20658,Oleg Saprykin,2000-01,19.0,2,1,4,4,0,1,1,2.0,50.0,4,0,1,1,2.0,82,5.49,53,331,2294,9.8,0.25023925
20659,20659,Oleg Saprykin,2001-02,20.0,3,23,59,59,9,14,23,95.0,718.0,63,9,15,24,97.0,82,5.51,63,376,2272,9.9,0.37033725
20660,20660,Oleg Saprykin,2002-03,21.0,4,0,3,3,0,0,0,9.0,40.0,66,9,15,24,106.0,82,5.24,53,338,2262,9.5,0.31702697
20661,20661,Oleg Saprykin,2003-04,22.0,5,23,52,52,8,15,23,116.0,618.0,118,17,30,47,222.0,82,5.31,60,363,2326,9.4,0.4418448
20662,20662,Oleg Saprykin,2004-05,23.0,6,29,69,69,12,17,29,151.0,952.0,187,29,47,76,373.0,82,5.14,57,348,2300,9.2,0.58077306
20663,20663,Oleg Saprykin,2006-07,25.0,7,25,67,67,11,14,25,126.0,918.0,254,40,61,101,499.0,82,6.05,85,480,2458,10.1,0.35177648
20664,20664,Oleg Saprykin,2007-08,26.0,8,36,71,71,15,21,36,150.0,885.0,325,55,82,137,649.0,82,5.76,70,398,2426,9.7,0.48253128
20665,20665,Oleg Tverdovsky,1995-96,19.0,2,12,36,36,3,9,12,26.0,,36,3,9,12,26.0,48,5.97,37,209,1408,10.2,0.31596574
20666,20666,Oleg Tverdovsky,1996-97,20.0,3,30,82,82,7,23,30,119.0,,118,10,32,42,145.0,82,6.29,74,413,2481,10.4,0.4374451
20667,20667,Oleg Tverdovsky,1997-98,21.0,4,55,82,82,10,45,55,144.0,,200,20,77,97,289.0,82,5.83,55,336,2444,9.8,0.6277564
20668,20668,Oleg Tverdovsky,1998-99,22.0,5,19,46,46,7,12,19,83.0,,246,27,89,116,372.0,82,5.28,57,380,2242,9.6,0.45566657
20669,20669,Oleg Tverdovsky,1999-00,23.0,6,25,82,82,7,18,25,117.0,1706.0,328,34,107,141,489.0,82,5.27,57,359,2285,9.4,0.46131805
20670,20670,Oleg Tverdovsky,2000-01,24.0,7,51,82,82,15,36,51,153.0,1867.0,410,49,143,192,642.0,82,5.49,53,331,2294,9.8,0.65023196
20671,20671,Oleg Tverdovsky,2001-02,25.0,8,53,82,82,14,39,53,188.0,2002.0,492,63,182,245,830.0,82,5.51,63,376,2272,9.9,0.65552515
20672,20672,Oleg Tverdovsky,2002-03,26.0,9,32,73,73,6,26,32,147.0,1667.0,565,69,208,277,977.0,82,5.24,53,338,2262,9.5,0.4789517
20673,20673,Oleg Tverdovsky,2003-04,27.0,10,13,50,50,5,8,13,76.0,840.0,615,74,216,290,1053.0,82,5.31,60,363,2326,9.4,0.35421187
20674,20674,Oleg Tverdovsky,2006-07,30.0,11,23,72,72,3,20,23,91.0,1195.0,687,77,236,313,1144.0,82,6.05,85,480,2458,10.1,0.27377722
20675,20675,Oleg Tverdovsky,2007-08,31.0,12,4,26,26,0,4,4,26.0,308.0,713,77,240,317,1170.0,82,5.76,70,398,2426,9.7,0.22749683
20676,20676,Oliver Bjorkstrand,2016-17,21.0,2,8,12,12,4,4,8,25.0,192.0,12,4,4,8,25.0,82,5.34,48,255,2438,9.0,0.37931755
20677,20677,Oliver Bjorkstrand,2017-18,22.0,3,13,26,26,6,7,13,55.0,366.0,38,10,11,21,80.0,82,5.45,47,245,2478,9.0,0.35849297
20678,20678,Oliver Bjorkstrand,2018-19,23.0,4,40,82,82,11,29,40,163.0,1172.0,120,21,40,61,243.0,82,5.86,50,250,2620,9.2,0.4912497
20679,20679,Oliver Bjorkstrand,2019-20,24.0,5,36,77,77,23,13,36,161.0,950.0,197,44,53,97,404.0,82,5.96,47,239,2579,9.5,0.517315
20680,20680,Oliver Bjorkstrand,2020-21,25.0,6,36,49,49,21,15,36,162.0,879.0,246,65,68,133,566.0,70,5.96,42,208,2192,9.5,0.67609525
20681,20681,Oliver Ekman-Larsson,2011-12,20.0,2,11,48,48,1,10,11,50.0,722.0,48,1,10,11,50.0,82,5.46,52,291,2492,9.0,0.25562704
20682,20682,Oliver Ekman-Larsson,2012-13,21.0,3,32,82,82,13,19,32,147.0,1813.0,130,14,29,43,197.0,82,5.32,47,271,2439,8.9,0.48151717
20683,20683,Oliver Ekman-Larsson,2013-14,22.0,4,24,48,48,3,21,24,101.0,1205.0,178,17,50,67,298.0,48,5.31,29,160,1399,9.1,0.47101346
20684,20684,Oliver Ekman-Larsson,2014-15,23.0,5,44,80,80,15,29,44,199.0,2072.0,258,32,79,111,497.0,82,5.34,48,269,2463,8.9,0.59402287
20685,20685,Oliver Ekman-Larsson,2015-16,24.0,6,43,82,82,23,20,43,264.0,2067.0,340,55,99,154,761.0,82,5.32,47,251,2453,8.9,0.5797161
20686,20686,Oliver Ekman-Larsson,2016-17,25.0,7,55,75,75,21,34,55,228.0,1858.0,415,76,133,209,989.0,82,5.34,48,255,2438,9.0,0.68282294
20687,20687,Oliver Ekman-Larsson,2017-18,26.0,8,39,79,79,12,27,39,145.0,1945.0,494,88,160,248,1134.0,82,5.45,47,245,2478,9.0,0.50652915
20688,20688,Oliver Ekman-Larsson,2018-19,27.0,9,42,82,82,14,28,42,202.0,1942.0,576,102,188,290,1336.0,82,5.86,50,250,2620,9.2,0.5619278
20689,20689,Oliver Ekman-Larsson,2019-20,28.0,10,44,81,81,14,30,44,176.0,1915.0,657,116,218,334,1512.0,82,5.96,47,239,2579,9.5,0.54820675
20690,20690,Oliver Ekman-Larsson,2020-21,29.0,11,30,66,66,9,21,30,135.0,1519.0,723,125,239,364,1647.0,70,5.96,42,208,2192,9.5,0.4639826
20691,20691,Oliver Kylington,2016-17,19.0,2,0,1,1,0,0,0,1.0,17.0,1,0,0,0,1.0,82,5.34,48,255,2438,9.0,0.2355394
20692,20692,Oliver Kylington,2019-20,22.0,3,8,38,38,3,5,8,21.0,472.0,39,3,5,8,22.0,82,5.96,47,239,2579,9.5,0.21819454
20693,20693,Oliver Kylington,2020-21,23.0,4,7,48,48,2,5,7,37.0,658.0,87,5,10,15,59.0,70,5.96,42,208,2192,9.5,0.21641499
20694,20694,Oliver Lauridsen,2013-14,24.0,2,3,15,15,2,1,3,14.0,227.0,15,2,1,3,14.0,48,5.31,29,160,1399,9.1,0.2654256
20695,20695,Oliver Lauridsen,2015-16,26.0,3,0,1,1,0,0,0,2.0,10.0,16,2,1,3,16.0,82,5.32,47,251,2453,8.9,0.15404564
20696,20696,Oliver Wahlstrom,2020-21,20.0,2,0,9,9,0,0,0,9.0,93.0,9,0,0,0,9.0,70,5.96,42,208,2192,9.5,0.23950773
20697,20697,Olivier Magnan,2011-12,25.0,2,0,18,18,0,0,0,8.0,283.0,18,0,0,0,8.0,82,5.46,52,291,2492,9.0,0.14893126
20698,20698,Olli Jokinen,1998-99,20.0,2,0,8,8,0,0,0,12.0,,8,0,0,0,12.0,82,5.28,57,380,2242,9.6,0.22573999
20699,20699,Olli Jokinen,1999-00,21.0,3,21,66,66,9,12,21,87.0,970.0,74,9,12,21,99.0,82,5.27,57,359,2285,9.4,0.35162294
20700,20700,Olli Jokinen,2000-01,22.0,4,21,82,82,11,10,21,138.0,1332.0,156,20,22,42,237.0,82,5.49,53,331,2294,9.8,0.35976136
20701,20701,Olli Jokinen,2001-02,23.0,5,16,78,78,6,10,16,121.0,1044.0,234,26,32,58,358.0,82,5.51,63,376,2272,9.9,0.30721292
20702,20702,Olli Jokinen,2002-03,24.0,6,29,80,80,9,20,29,153.0,1447.0,314,35,52,87,511.0,82,5.24,53,338,2262,9.5,0.40856153
20703,20703,Olli Jokinen,2003-04,25.0,7,65,81,81,36,29,65,240.0,1784.0,395,71,81,152,751.0,82,5.31,60,363,2326,9.4,0.76094556
20704,20704,Olli Jokinen,2004-05,26.0,8,58,82,82,26,32,58,280.0,1852.0,477,97,113,210,1031.0,82,5.14,57,348,2300,9.2,0.82999146
20705,20705,Olli Jokinen,2006-07,28.0,9,89,82,82,38,51,89,351.0,1680.0,559,135,164,299,1382.0,82,6.05,85,480,2458,10.1,0.94813406
20706,20706,Olli Jokinen,2007-08,29.0,10,91,82,82,39,52,91,351.0,1684.0,641,174,216,390,1733.0,82,5.76,70,398,2426,9.7,0.97984254
20707,20707,Olli Jokinen,2008-09,30.0,11,71,82,82,34,37,71,341.0,1632.0,723,208,253,461,2074.0,82,5.44,62,351,2383,9.4,0.8107555
20708,20708,Olli Jokinen,2009-10,31.0,12,57,76,76,29,28,57,236.0,1435.0,799,237,281,518,2310.0,82,5.7,65,341,2477,9.4,0.66288704
20709,20709,Olli Jokinen,2010-11,32.0,13,50,82,82,15,35,50,236.0,1465.0,881,252,316,568,2546.0,82,5.53,56,304,2486,9.1,0.6044783
20710,20710,Olli Jokinen,2011-12,33.0,14,54,79,79,17,37,54,208.0,1404.0,960,269,353,622,2754.0,82,5.46,52,291,2492,9.0,0.6348181
20711,20711,Olli Jokinen,2012-13,34.0,15,61,82,82,23,38,61,223.0,1555.0,1042,292,391,683,2977.0,82,5.32,47,271,2439,8.9,0.61835974
20712,20712,Olli Jokinen,2013-14,35.0,16,14,45,45,7,7,14,85.0,771.0,1087,299,398,697,3062.0,48,5.31,29,160,1399,9.1,0.39437515
20713,20713,Olli Jokinen,2014-15,36.0,17,43,82,82,18,25,43,171.0,1396.0,1169,317,423,740,3233.0,82,5.34,48,269,2463,8.9,0.4568201
20714,20714,Olli Jokinen,2015-16,37.0,18,10,62,62,4,6,10,110.0,822.0,1231,321,429,750,3343.0,82,5.32,47,251,2453,8.9,0.29994613
20715,20715,Olli Maatta,2014-15,20.0,2,29,78,78,9,20,29,119.0,1443.0,78,9,20,29,119.0,82,5.34,48,269,2463,8.9,0.4086532
20716,20716,Olli Maatta,2015-16,21.0,3,9,20,20,1,8,9,27.0,414.0,98,10,28,38,146.0,82,5.32,47,251,2453,8.9,0.36973917
20717,20717,Olli Maatta,2016-17,22.0,4,19,67,67,6,13,19,95.0,1337.0,165,16,41,57,241.0,82,5.34,48,255,2438,9.0,0.32217985
20718,20718,Olli Maatta,2017-18,23.0,5,7,55,55,1,6,7,66.0,994.0,220,17,47,64,307.0,82,5.45,47,245,2478,9.0,0.26300162
20719,20719,Olli Maatta,2018-19,24.0,6,29,82,82,7,22,29,164.0,1538.0,302,24,69,93,471.0,82,5.86,50,250,2620,9.2,0.37935805
20720,20720,Olli Maatta,2019-20,25.0,7,14,60,60,1,13,14,74.0,1115.0,362,25,82,107,545.0,82,5.96,47,239,2579,9.5,0.23315066
20721,20721,Olli Maatta,2020-21,26.0,8,17,65,65,4,13,17,80.0,1197.0,427,29,95,124,625.0,70,5.96,42,208,2192,9.5,0.27696735
20722,20722,Olli Malmivaara,2008-09,26.0,2,0,2,2,0,0,0,0.0,18.0,2,0,0,0,0.0,82,5.44,62,351,2383,9.4,0.17168656
20723,20723,Ondrej Kase,2017-18,22.0,2,15,53,53,5,10,15,77.0,625.0,53,5,10,15,77.0,82,5.45,47,245,2478,9.0,0.3467021
20724,20724,Ondrej Kase,2018-19,23.0,3,38,66,66,20,18,38,146.0,919.0,119,25,28,53,223.0,82,5.86,50,250,2620,9.2,0.52089554
20725,20725,Ondrej Kase,2019-20,24.0,4,20,30,30,11,9,20,94.0,470.0,149,36,37,73,317.0,82,5.96,47,239,2579,9.5,0.51664555
20726,20726,Ondrej Kase,2020-21,25.0,5,24,55,55,7,17,24,144.0,910.0,204,43,54,97,461.0,70,5.96,42,208,2192,9.5,0.50611407
20727,20727,Ondrej Palat,2013-14,22.0,2,4,14,14,2,2,4,16.0,164.0,14,2,2,4,16.0,48,5.31,29,160,1399,9.1,0.2996574
20728,20728,Ondrej Palat,2014-15,23.0,3,59,81,81,23,36,59,165.0,1461.0,95,25,38,63,181.0,82,5.34,48,269,2463,8.9,0.6513209
20729,20729,Ondrej Palat,2015-16,24.0,4,63,75,75,16,47,63,139.0,1307.0,170,41,85,126,320.0,82,5.32,47,251,2453,8.9,0.7528722
20730,20730,Ondrej Palat,2016-17,25.0,5,40,62,62,16,24,40,117.0,1111.0,232,57,109,166,437.0,82,5.34,48,255,2438,9.0,0.68011606
20731,20731,Ondrej Palat,2017-18,26.0,6,52,75,75,17,35,52,162.0,1434.0,307,74,144,218,599.0,82,5.45,47,245,2478,9.0,0.64662814
20732,20732,Ondrej Palat,2018-19,27.0,7,35,56,56,11,24,35,109.0,952.0,363,85,168,253,708.0,82,5.86,50,250,2620,9.2,0.5679424
20733,20733,Ondrej Palat,2019-20,28.0,8,34,64,64,8,26,34,100.0,953.0,427,93,194,287,808.0,82,5.96,47,239,2579,9.5,0.51412344
20734,20734,Ondrej Palat,2020-21,29.0,9,41,69,69,17,24,41,128.0,1117.0,496,110,218,328,936.0,70,5.96,42,208,2192,9.5,0.5399337
20735,20735,Oscar Fantenberg,2018-19,27.0,2,9,27,27,2,7,9,33.0,385.0,27,2,7,9,33.0,82,5.86,50,250,2620,9.2,0.21280599
20736,20736,Oscar Fantenberg,2019-20,28.0,3,4,61,61,2,2,4,70.0,976.0,88,4,9,13,103.0,82,5.96,47,239,2579,9.5,0.16738003
20737,20737,Oscar Fantenberg,2020-21,29.0,4,6,36,36,1,5,6,45.0,573.0,124,5,14,19,148.0,70,5.96,42,208,2192,9.5,0.16597065
20738,20738,Oscar Klefbom,2014-15,21.0,2,3,17,17,1,2,3,14.0,269.0,17,1,2,3,14.0,82,5.34,48,269,2463,8.9,0.25250512
20739,20739,Oscar Klefbom,2015-16,22.0,3,20,60,60,2,18,20,98.0,1320.0,77,3,20,23,112.0,82,5.32,47,251,2453,8.9,0.32936767
20740,20740,Oscar Klefbom,2016-17,23.0,4,12,30,30,4,8,12,48.0,657.0,107,7,28,35,160.0,82,5.34,48,255,2438,9.0,0.30523092
20741,20741,Oscar Klefbom,2017-18,24.0,5,38,82,82,12,26,38,201.0,1834.0,189,19,54,73,361.0,82,5.45,47,245,2478,9.0,0.5255265
20742,20742,Oscar Klefbom,2018-19,25.0,6,21,66,66,5,16,21,203.0,1508.0,255,24,70,94,564.0,82,5.86,50,250,2620,9.2,0.35240048
20743,20743,Oscar Klefbom,2019-20,26.0,7,28,61,61,5,23,28,167.0,1463.0,316,29,93,122,731.0,82,5.96,47,239,2579,9.5,0.4888371
20744,20744,Oscar Klefbom,2020-21,27.0,8,34,62,62,5,29,34,159.0,1576.0,378,34,122,156,890.0,70,5.96,42,208,2192,9.5,0.47769627
20745,20745,Oscar Lindberg,2015-16,24.0,2,0,1,1,0,0,0,2.0,8.0,1,0,0,0,2.0,82,5.32,47,251,2453,8.9,0.16720265
20746,20746,Oscar Lindberg,2016-17,25.0,3,28,68,68,13,15,28,114.0,828.0,69,13,15,28,116.0,82,5.34,48,255,2438,9.0,0.3993969
20747,20747,Oscar Lindberg,2017-18,26.0,4,20,65,65,8,12,20,86.0,704.0,134,21,27,48,202.0,82,5.45,47,245,2478,9.0,0.28834054
20748,20748,Oscar Lindberg,2018-19,27.0,5,11,63,63,9,2,11,81.0,742.0,197,30,29,59,283.0,82,5.86,50,250,2620,9.2,0.22455391
20749,20749,Oscar Lindberg,2019-20,28.0,6,20,55,55,9,11,20,91.0,686.0,252,39,40,79,374.0,82,5.96,47,239,2579,9.5,0.34245837
20750,20750,Oscar Moller,2009-10,21.0,2,15,40,40,7,8,15,81.0,535.0,40,7,8,15,81.0,82,5.7,65,341,2477,9.4,0.4017015
20751,20751,Oscar Moller,2010-11,22.0,3,7,34,34,4,3,7,42.0,292.0,74,11,11,22,123.0,82,5.53,56,304,2486,9.1,0.27791268
20752,20752,Oscar Moller,2011-12,23.0,4,4,13,13,1,3,4,27.0,190.0,87,12,14,26,150.0,82,5.46,52,291,2492,9.0,0.3269747
20753,20753,Oskar Lindblom,2018-19,22.0,2,6,23,23,2,4,6,36.0,335.0,23,2,4,6,36.0,82,5.86,50,250,2620,9.2,0.26766914
20754,20754,Oskar Lindblom,2019-20,23.0,3,33,81,81,17,16,33,162.0,1113.0,104,19,20,39,198.0,82,5.96,47,239,2579,9.5,0.4680821
20755,20755,Oskar Lindblom,2020-21,24.0,4,18,30,30,11,7,18,72.0,528.0,134,30,27,57,270.0,70,5.96,42,208,2192,9.5,0.46403784
20756,20756,Oskar Osala,2009-10,22.0,2,0,2,2,0,0,0,1.0,17.0,2,0,0,0,1.0,82,5.7,65,341,2477,9.4,0.18293896
20757,20757,Oskar Osala,2010-11,23.0,3,0,1,1,0,0,0,1.0,7.0,3,0,0,0,2.0,82,5.53,56,304,2486,9.1,0.17140418
20758,20758,Oskar Sundqvist,2016-17,22.0,2,4,18,18,1,3,4,13.0,186.0,18,1,3,4,13.0,82,5.34,48,255,2438,9.0,0.21597311
20759,20759,Oskar Sundqvist,2017-18,23.0,3,0,10,10,0,0,0,9.0,92.0,28,1,3,4,22.0,82,5.45,47,245,2478,9.0,0.17246264
20760,20760,Oskar Sundqvist,2018-19,24.0,4,5,42,42,1,4,5,41.0,440.0,70,2,7,9,63.0,82,5.86,50,250,2620,9.2,0.14603707
20761,20761,Oskar Sundqvist,2019-20,25.0,5,31,74,74,14,17,31,113.0,1023.0,144,16,24,40,176.0,82,5.96,47,239,2579,9.5,0.3797328
20762,20762,Oskar Sundqvist,2020-21,26.0,6,23,57,57,12,11,23,97.0,820.0,201,28,35,63,273.0,70,5.96,42,208,2192,9.5,0.36130056
20763,20763,Oskars Bartulis,2010-11,24.0,2,9,53,53,1,8,9,26.0,741.0,53,1,8,9,26.0,82,5.53,56,304,2486,9.1,0.13730234
20764,20764,Oskars Bartulis,2011-12,25.0,3,0,13,13,0,0,0,7.0,169.0,66,1,8,9,33.0,82,5.46,52,291,2492,9.0,0.1336056
20765,20765,Ossi Vaananen,2001-02,21.0,2,16,81,81,4,12,16,69.0,1552.0,81,4,12,16,69.0,82,5.51,63,376,2272,9.9,0.23390505
20766,20766,Ossi Vaananen,2002-03,22.0,3,14,76,76,2,12,14,41.0,1536.0,157,6,24,30,110.0,82,5.24,53,338,2262,9.5,0.21128935
20767,20767,Ossi Vaananen,2003-04,23.0,4,9,67,67,2,7,9,49.0,1290.0,224,8,31,39,159.0,82,5.31,60,363,2326,9.4,0.21352032
20768,20768,Ossi Vaananen,2004-05,24.0,5,6,79,79,2,4,6,45.0,1520.0,303,10,35,45,204.0,82,5.14,57,348,2300,9.2,0.19190255
20769,20769,Ossi Vaananen,2006-07,26.0,6,4,53,53,0,4,4,34.0,719.0,356,10,39,49,238.0,82,6.05,85,480,2458,10.1,0.14262873
20770,20770,Ossi Vaananen,2007-08,27.0,7,8,74,74,2,6,8,32.0,1060.0,430,12,45,57,270.0,82,5.76,70,398,2426,9.7,0.12356293
20771,20771,Ossi Vaananen,2009-10,29.0,8,11,49,49,1,10,11,20.0,878.0,479,13,55,68,290.0,82,5.7,65,341,2477,9.4,0.14493382
20772,20772,Otto Koivula,2020-21,22.0,2,0,12,12,0,0,0,4.0,95.0,12,0,0,0,4.0,70,5.96,42,208,2192,9.5,0.17670336
20773,20773,Otto Leskinen,2020-21,23.0,2,0,5,5,0,0,0,2.0,51.0,5,0,0,0,2.0,70,5.96,42,208,2192,9.5,0.19707662
20774,20774,Owen Fussey,2004-05,21.0,2,1,4,4,0,1,1,6.0,33.0,4,0,1,1,6.0,82,5.14,57,348,2300,9.2,0.30835685
20775,20775,Owen Nolan,1991-92,19.0,2,13,59,59,3,10,13,54.0,,59,3,10,13,54.0,80,6.91,71,366,2385,11.6,0.31382042
20776,20776,Owen Nolan,1992-93,20.0,3,73,75,75,42,31,73,190.0,,134,45,41,86,244.0,80,6.96,77,402,2440,11.4,1.0038263
20777,20777,Owen Nolan,1993-94,21.0,4,77,73,73,36,41,77,241.0,,207,81,82,163,485.0,84,7.25,87,443,2603,11.7,0.8593368
20778,20778,Owen Nolan,1994-95,22.0,5,4,6,6,2,2,4,15.0,,213,83,84,167,500.0,84,6.48,76,407,2545,10.7,0.66314745
20779,20779,Owen Nolan,1995-96,23.0,6,49,46,46,30,19,49,137.0,,259,113,103,216,637.0,48,5.97,37,209,1408,10.2,1.0426357
20780,20780,Owen Nolan,1996-97,24.0,7,69,81,81,33,36,69,207.0,,340,146,139,285,844.0,82,6.29,74,413,2481,10.4,0.85825884
20781,20781,Owen Nolan,1997-98,25.0,8,63,72,72,31,32,63,225.0,,412,177,171,348,1069.0,82,5.83,55,336,2444,9.8,0.78003895
20782,20782,Owen Nolan,1998-99,26.0,9,41,75,75,14,27,41,192.0,,487,191,198,389,1261.0,82,5.28,57,380,2242,9.6,0.62555695
20783,20783,Owen Nolan,1999-00,27.0,10,45,78,78,19,26,45,207.0,1494.0,565,210,224,434,1468.0,82,5.27,57,359,2285,9.4,0.6417271
20784,20784,Owen Nolan,2000-01,28.0,11,84,78,78,44,40,84,261.0,1647.0,643,254,264,518,1729.0,82,5.49,53,331,2294,9.8,0.9830814
20785,20785,Owen Nolan,2001-02,29.0,12,49,57,57,24,25,49,191.0,1244.0,700,278,289,567,1920.0,82,5.51,63,376,2272,9.9,0.80696106
20786,20786,Owen Nolan,2002-03,30.0,13,66,75,75,23,43,66,217.0,1454.0,775,301,332,633,2137.0,82,5.24,53,338,2262,9.5,0.767854
20787,20787,Owen Nolan,2003-04,31.0,14,54,75,75,29,25,54,221.0,1345.0,850,330,357,687,2358.0,82,5.31,60,363,2326,9.4,0.64958334
20788,20788,Owen Nolan,2004-05,32.0,15,48,65,65,19,29,48,154.0,1166.0,915,349,386,735,2512.0,82,5.14,57,348,2300,9.2,0.7166071
20789,20789,Owen Nolan,2007-08,35.0,16,40,76,76,16,24,40,154.0,1172.0,991,365,410,775,2666.0,82,5.76,70,398,2426,9.7,0.4801205
20790,20790,Owen Nolan,2008-09,36.0,17,32,77,77,16,16,32,163.0,1275.0,1068,381,426,807,2829.0,82,5.44,62,351,2383,9.4,0.4547925
20791,20791,Owen Nolan,2009-10,37.0,18,45,59,59,25,20,45,148.0,967.0,1127,406,446,852,2977.0,82,5.7,65,341,2477,9.4,0.592801
20792,20792,Owen Nolan,2010-11,38.0,19,33,73,73,16,17,33,151.0,1212.0,1200,422,463,885,3128.0,82,5.53,56,304,2486,9.1,0.395866
20793,20793,Owen Tippett,2018-19,19.0,2,1,7,7,1,0,1,17.0,78.0,7,1,0,1,17.0,82,5.86,50,250,2620,9.2,0.24950358
20794,20794,P.A. Parenteau,2007-08,24.0,2,1,5,5,0,1,1,7.0,55.0,5,0,1,1,7.0,82,5.76,70,398,2426,9.7,0.18681282
20795,20795,P.A. Parenteau,2010-11,27.0,3,8,22,22,3,5,8,38.0,301.0,27,3,6,9,45.0,82,5.53,56,304,2486,9.1,0.24147722
20796,20796,P.A. Parenteau,2011-12,28.0,4,53,81,81,20,33,53,161.0,1476.0,108,23,39,62,206.0,82,5.46,52,291,2492,9.0,0.5537464
20797,20797,P.A. Parenteau,2012-13,29.0,5,67,80,80,18,49,67,167.0,1492.0,188,41,88,129,373.0,82,5.32,47,271,2439,8.9,0.76951295
20798,20798,P.A. Parenteau,2013-14,30.0,6,43,48,48,18,25,43,105.0,919.0,236,59,113,172,478.0,48,5.31,29,160,1399,9.1,0.7306627
20799,20799,P.A. Parenteau,2014-15,31.0,7,33,55,55,14,19,33,110.0,932.0,291,73,132,205,588.0,82,5.34,48,269,2463,8.9,0.51012576
20800,20800,P.A. Parenteau,2015-16,32.0,8,22,56,56,8,14,22,97.0,839.0,347,81,146,227,685.0,82,5.32,47,251,2453,8.9,0.4601977
20801,20801,P.A. Parenteau,2016-17,33.0,9,41,77,77,20,21,41,168.0,1252.0,424,101,167,268,853.0,82,5.34,48,255,2438,9.0,0.46828657
20802,20802,P.A. Parenteau,2017-18,34.0,10,28,67,67,13,15,28,123.0,985.0,491,114,182,296,976.0,82,5.45,47,245,2478,9.0,0.3617292
20803,20803,P.C. Drouin,1997-98,23.0,2,0,3,3,0,0,0,1.0,,3,0,0,0,1.0,82,5.83,55,336,2444,9.8,0.16314653
20804,20804,P.J. Axelsson,1998-99,23.0,2,27,82,82,8,19,27,144.0,,82,8,19,27,144.0,82,5.28,57,380,2242,9.6,0.3942722
20805,20805,P.J. Axelsson,1999-00,24.0,3,17,77,77,7,10,17,146.0,1281.0,159,15,29,44,290.0,82,5.27,57,359,2285,9.4,0.3076504
20806,20806,P.J. Axelsson,2000-01,25.0,4,26,81,81,10,16,26,186.0,1354.0,240,25,45,70,476.0,82,5.49,53,331,2294,9.8,0.42469537
20807,20807,P.J. Axelsson,2001-02,26.0,5,23,81,81,8,15,23,146.0,1013.0,321,33,60,93,622.0,82,5.51,63,376,2272,9.9,0.31293643
20808,20808,P.J. Axelsson,2002-03,27.0,6,24,78,78,7,17,24,127.0,1146.0,399,40,77,117,749.0,82,5.24,53,338,2262,9.5,0.31974304
20809,20809,P.J. Axelsson,2003-04,28.0,7,36,66,66,17,19,36,122.0,1097.0,465,57,96,153,871.0,82,5.31,60,363,2326,9.4,0.42595813
20810,20810,P.J. Axelsson,2004-05,29.0,8,20,68,68,6,14,20,107.0,1109.0,533,63,110,173,978.0,82,5.14,57,348,2300,9.2,0.34838265
20811,20811,P.J. Axelsson,2006-07,31.0,9,28,59,59,10,18,28,113.0,1039.0,592,73,128,201,1091.0,82,6.05,85,480,2458,10.1,0.37108618
20812,20812,P.J. Axelsson,2007-08,32.0,10,27,55,55,11,16,27,81.0,1076.0,647,84,144,228,1172.0,82,5.76,70,398,2426,9.7,0.3857458
20813,20813,P.J. Axelsson,2008-09,33.0,11,29,75,75,13,16,29,100.0,1320.0,722,97,160,257,1272.0,82,5.44,62,351,2383,9.4,0.30531496
20814,20814,P.J. Axelsson,2009-10,34.0,12,30,75,75,6,24,30,87.0,1217.0,797,103,184,287,1359.0,82,5.7,65,341,2477,9.4,0.31620622
20815,20815,P.J. Stock,1998-99,23.0,2,5,38,38,2,3,5,9.0,,38,2,3,5,9.0,82,5.28,57,380,2242,9.6,0.16717878
20816,20816,P.J. Stock,1999-00,24.0,3,0,5,5,0,0,0,0.0,14.0,43,2,3,5,9.0,82,5.27,57,359,2285,9.4,0.1377126
20817,20817,P.J. Stock,2000-01,25.0,4,1,11,11,0,1,1,2.0,68.0,54,2,4,6,11.0,82,5.49,53,331,2294,9.8,0.1365808
20818,20818,P.J. Stock,2001-02,26.0,5,7,51,51,2,5,7,27.0,352.0,105,4,9,13,38.0,82,5.51,63,376,2272,9.9,0.12132466
20819,20819,P.J. Stock,2002-03,27.0,6,3,58,58,0,3,3,12.0,299.0,163,4,12,16,50.0,82,5.24,53,338,2262,9.5,0.063951135
20820,20820,P.J. Stock,2003-04,28.0,7,10,71,71,1,9,10,38.0,443.0,234,5,21,26,88.0,82,5.31,60,363,2326,9.4,0.13597897
20821,20821,P.J. Stock,2004-05,29.0,8,0,1,1,0,0,0,1.0,6.0,235,5,21,26,89.0,82,5.14,57,348,2300,9.2,0.1742821
20822,20822,P.K. Subban,2010-11,21.0,2,2,2,2,0,2,2,4.0,40.0,2,0,2,2,4.0,82,5.53,56,304,2486,9.1,0.263384
20823,20823,P.K. Subban,2011-12,22.0,3,38,77,77,14,24,38,197.0,1715.0,79,14,26,40,201.0,82,5.46,52,291,2492,9.0,0.5458652
20824,20824,P.K. Subban,2012-13,23.0,4,36,81,81,7,29,36,205.0,1968.0,160,21,55,76,406.0,82,5.32,47,271,2439,8.9,0.4920651
20825,20825,P.K. Subban,2013-14,24.0,5,38,42,42,11,27,38,126.0,976.0,202,32,82,114,532.0,48,5.31,29,160,1399,9.1,0.74454176
20826,20826,P.K. Subban,2014-15,25.0,6,53,82,82,10,43,53,204.0,2019.0,284,42,125,167,736.0,82,5.34,48,269,2463,8.9,0.65013367
20827,20827,P.K. Subban,2015-16,26.0,7,60,82,82,15,45,60,170.0,2149.0,366,57,170,227,906.0,82,5.32,47,251,2453,8.9,0.6956885
20828,20828,P.K. Subban,2016-17,27.0,8,51,68,68,6,45,51,176.0,1793.0,434,63,215,278,1082.0,82,5.34,48,255,2438,9.0,0.6314013
20829,20829,P.K. Subban,2017-18,28.0,9,40,66,66,10,30,40,142.0,1611.0,500,73,245,318,1224.0,82,5.45,47,245,2478,9.0,0.54353297
20830,20830,P.K. Subban,2018-19,29.0,10,59,82,82,16,43,59,207.0,1977.0,582,89,288,377,1431.0,82,5.86,50,250,2620,9.2,0.6757097
20831,20831,P.K. Subban,2019-20,30.0,11,31,63,63,9,22,31,168.0,1428.0,645,98,310,408,1599.0,82,5.96,47,239,2579,9.5,0.50906175
20832,20832,P.K. Subban,2020-21,31.0,12,18,68,68,7,11,18,151.0,1504.0,713,105,321,426,1750.0,70,5.96,42,208,2192,9.5,0.3687925
20833,20833,Par Lindholm,2019-20,28.0,2,13,65,65,1,12,13,65.0,738.0,65,1,12,13,65.0,82,5.96,47,239,2579,9.5,0.16999441
20834,20834,Par Lindholm,2020-21,29.0,3,6,40,40,3,3,6,35.0,450.0,105,4,15,19,100.0,70,5.96,42,208,2192,9.5,0.20461729
20835,20835,Pascal Dupuis,2001-02,22.0,2,1,4,4,1,0,1,8.0,62.0,4,1,0,1,8.0,82,5.51,63,376,2272,9.9,0.22856054
20836,20836,Pascal Dupuis,2002-03,23.0,3,27,76,76,15,12,27,154.0,1150.0,80,16,12,28,162.0,82,5.24,53,338,2262,9.5,0.42988554
20837,20837,Pascal Dupuis,2003-04,24.0,4,48,80,80,20,28,48,183.0,1400.0,160,36,40,76,345.0,82,5.31,60,363,2326,9.4,0.5828592
20838,20838,Pascal Dupuis,2004-05,25.0,5,26,59,59,11,15,26,127.0,932.0,219,47,55,102,472.0,82,5.14,57,348,2300,9.2,0.4961191
20839,20839,Pascal Dupuis,2006-07,27.0,6,26,67,67,10,16,26,151.0,1105.0,286,57,71,128,623.0,82,6.05,85,480,2458,10.1,0.3604666
20840,20840,Pascal Dupuis,2007-08,28.0,7,19,71,71,14,5,19,156.0,1103.0,357,71,76,147,779.0,82,5.76,70,398,2426,9.7,0.32189417
20841,20841,Pascal Dupuis,2008-09,29.0,8,27,78,78,12,15,27,143.0,1185.0,435,83,91,174,922.0,82,5.44,62,351,2383,9.4,0.34053367
20842,20842,Pascal Dupuis,2009-10,30.0,9,28,71,71,12,16,28,145.0,1010.0,506,95,107,202,1067.0,82,5.7,65,341,2477,9.4,0.36705595
20843,20843,Pascal Dupuis,2010-11,31.0,10,38,81,81,18,20,38,157.0,1149.0,587,113,127,240,1224.0,82,5.53,56,304,2486,9.1,0.44654536
20844,20844,Pascal Dupuis,2011-12,32.0,11,37,81,81,17,20,37,171.0,1366.0,668,130,147,277,1395.0,82,5.46,52,291,2492,9.0,0.45133695
20845,20845,Pascal Dupuis,2012-13,33.0,12,59,82,82,25,34,59,214.0,1388.0,750,155,181,336,1609.0,82,5.32,47,271,2439,8.9,0.6551105
20846,20846,Pascal Dupuis,2013-14,34.0,13,38,48,48,20,18,38,140.0,840.0,798,175,199,374,1749.0,48,5.31,29,160,1399,9.1,0.6688587
20847,20847,Pascal Dupuis,2014-15,35.0,14,20,39,39,7,13,20,97.0,690.0,837,182,212,394,1846.0,82,5.34,48,269,2463,8.9,0.4231353
20848,20848,Pascal Dupuis,2015-16,36.0,15,11,16,16,6,5,11,44.0,266.0,853,188,217,405,1890.0,82,5.32,47,251,2453,8.9,0.27907726
20849,20849,Pascal Dupuis,2016-17,37.0,16,4,18,18,2,2,4,28.0,272.0,871,190,219,409,1918.0,82,5.34,48,255,2438,9.0,0.27184695
20850,20850,Pascal Pelletier,2008-09,25.0,2,0,6,6,0,0,0,8.0,66.0,6,0,0,0,8.0,82,5.44,62,351,2383,9.4,0.16484177
20851,20851,Pascal Pelletier,2009-10,26.0,3,0,7,7,0,0,0,7.0,64.0,13,0,0,0,15.0,82,5.7,65,341,2477,9.4,0.15817633
20852,20852,Pascal Pelletier,2014-15,31.0,4,0,3,3,0,0,0,1.0,27.0,16,0,0,0,16.0,82,5.34,48,269,2463,8.9,0.13601136
20853,20853,Pascal Rheaume,1997-98,24.0,2,1,2,2,1,0,1,5.0,,2,1,0,1,5.0,82,5.83,55,336,2444,9.8,0.20509446
20854,20854,Pascal Rheaume,1998-99,25.0,3,15,48,48,6,9,15,45.0,,50,7,9,16,50.0,82,5.28,57,380,2242,9.6,0.258864
20855,20855,Pascal Rheaume,1999-00,26.0,4,27,60,60,9,18,27,85.0,799.0,110,16,27,43,135.0,82,5.27,57,359,2285,9.4,0.35362297
20856,20856,Pascal Rheaume,2000-01,27.0,5,2,7,7,1,1,2,5.0,71.0,117,17,28,45,140.0,82,5.49,53,331,2294,9.8,0.18974516
20857,20857,Pascal Rheaume,2001-02,28.0,6,2,8,8,2,0,2,16.0,95.0,125,19,28,47,156.0,82,5.51,63,376,2272,9.9,0.23686644
20858,20858,Pascal Rheaume,2002-03,29.0,7,22,61,61,11,11,22,80.0,785.0,186,30,39,69,236.0,82,5.24,53,338,2262,9.5,0.2962939
20859,20859,Pascal Rheaume,2003-04,30.0,8,18,77,77,8,10,18,93.0,936.0,263,38,49,87,329.0,82,5.31,60,363,2326,9.4,0.25999236
20860,20860,Pascal Rheaume,2004-05,31.0,9,4,42,42,1,3,4,38.0,429.0,305,39,52,91,367.0,82,5.14,57,348,2300,9.2,0.15330157
20861,20861,Pascal Rheaume,2006-07,33.0,10,0,13,13,0,0,0,11.0,117.0,318,39,52,91,378.0,82,6.05,85,480,2458,10.1,0.20991305
20862,20862,Pascal Trepanier,1998-99,25.0,2,1,15,15,0,1,1,9.0,,15,0,1,1,9.0,82,5.28,57,380,2242,9.6,0.15871483
20863,20863,Pascal Trepanier,1999-00,26.0,3,6,45,45,2,4,6,49.0,572.0,60,2,5,7,58.0,82,5.27,57,359,2285,9.4,0.17008558
20864,20864,Pascal Trepanier,2000-01,27.0,4,4,37,37,0,4,4,33.0,418.0,97,2,9,11,91.0,82,5.49,53,331,2294,9.8,0.13506958
20865,20865,Pascal Trepanier,2001-02,28.0,5,10,57,57,6,4,10,86.0,957.0,154,8,13,21,177.0,82,5.51,63,376,2272,9.9,0.21116331
20866,20866,Pascal Trepanier,2002-03,29.0,6,13,74,74,4,9,13,87.0,1082.0,228,12,22,34,264.0,82,5.24,53,338,2262,9.5,0.1751689
20867,20867,Pascal Trepanier,2003-04,30.0,7,0,1,1,0,0,0,1.0,10.0,229,12,22,34,265.0,82,5.31,60,363,2326,9.4,0.14107442
20868,20868,Pat Conacher,1980-81,21.0,2,5,17,17,0,5,5,15.0,,17,0,5,5,15.0,80,7.03,61,280,2352,12.0,0.29369813
20869,20869,Pat Conacher,1983-84,24.0,3,1,5,5,0,1,1,5.0,,22,0,6,6,20.0,80,7.73,71,310,2444,12.7,0.20914021
20870,20870,Pat Conacher,1984-85,25.0,4,10,45,45,2,8,10,17.0,,67,2,14,16,37.0,80,7.89,74,336,2448,12.9,0.27365148
20871,20871,Pat Conacher,1986-87,27.0,5,2,2,2,0,2,2,3.0,,69,2,16,18,40.0,80,7.94,82,370,2484,12.8,0.18556517
20872,20872,Pat Conacher,1988-89,29.0,6,7,24,24,2,5,7,22.0,,93,4,21,25,62.0,80,7.43,89,437,2435,12.2,0.25245437
20873,20873,Pat Conacher,1989-90,30.0,7,12,55,55,7,5,12,59.0,,148,11,26,37,121.0,80,7.48,85,403,2430,12.3,0.24231097
20874,20874,Pat Conacher,1990-91,31.0,8,6,19,19,3,3,6,18.0,,167,14,29,43,139.0,80,7.37,76,367,2421,12.2,0.24415377
20875,20875,Pat Conacher,1991-92,32.0,9,16,49,49,5,11,16,45.0,,216,19,40,59,184.0,80,6.91,71,366,2385,11.6,0.2707882
20876,20876,Pat Conacher,1992-93,33.0,10,10,44,44,7,3,10,38.0,,260,26,43,69,222.0,80,6.96,77,402,2440,11.4,0.246335
20877,20877,Pat Conacher,1993-94,34.0,11,17,81,81,9,8,17,65.0,,341,35,51,86,287.0,84,7.25,87,443,2603,11.7,0.1885837
20878,20878,Pat Conacher,1994-95,35.0,12,28,77,77,15,13,28,98.0,,418,50,64,114,385.0,84,6.48,76,407,2545,10.7,0.297342
20879,20879,Pat Conacher,1995-96,36.0,13,16,48,48,7,9,16,64.0,,466,57,73,130,449.0,48,5.97,37,209,1408,10.2,0.28568637
20880,20880,Pat Conacher,1996-97,37.0,14,9,55,55,6,3,9,45.0,,521,63,76,139,494.0,82,6.29,74,413,2481,10.4,0.14947394
20881,20881,Pat Daley,1980-81,21.0,2,1,5,5,1,0,1,6.0,,5,1,0,1,6.0,80,7.03,61,280,2352,12.0,0.29287815
20882,20882,Pat Daley,1981-82,22.0,3,0,7,7,0,0,0,4.0,,12,1,0,1,10.0,80,7.69,77,340,2441,12.6,0.21127436
20883,20883,Pat Elynuik,1988-89,21.0,2,4,13,13,1,3,4,12.0,,13,1,3,4,12.0,80,7.43,89,437,2435,12.2,0.32107437
20884,20884,Pat Elynuik,1989-90,22.0,3,51,56,56,26,25,51,100.0,,69,27,28,55,112.0,80,7.48,85,403,2430,12.3,0.84757185
20885,20885,Pat Elynuik,1990-91,23.0,4,74,80,80,32,42,74,132.0,,149,59,70,129,244.0,80,7.37,76,367,2421,12.2,0.8385427
20886,20886,Pat Elynuik,1991-92,24.0,5,65,80,80,31,34,65,150.0,,229,90,104,194,394.0,80,6.91,71,366,2385,11.6,0.8673253
20887,20887,Pat Elynuik,1992-93,25.0,6,50,60,60,25,25,50,127.0,,289,115,129,244,521.0,80,6.96,77,402,2440,11.4,0.76028466
20888,20888,Pat Elynuik,1993-94,26.0,7,57,80,80,22,35,57,121.0,,369,137,164,301,642.0,84,7.25,87,443,2603,11.7,0.6082816
20889,20889,Pat Elynuik,1994-95,27.0,8,28,67,67,13,15,28,111.0,,436,150,179,329,753.0,84,6.48,76,407,2545,10.7,0.43133834
20890,20890,Pat Elynuik,1995-96,28.0,9,10,41,41,3,7,10,58.0,,477,153,186,339,811.0,48,5.97,37,209,1408,10.2,0.41167885
20891,20891,Pat Elynuik,1996-97,29.0,10,3,29,29,1,2,3,27.0,,506,154,188,342,838.0,82,6.29,74,413,2481,10.4,0.3345964
20892,20892,Pat Falloon,1992-93,20.0,2,59,79,79,25,34,59,181.0,,79,25,34,59,181.0,80,6.96,77,402,2440,11.4,0.79496944
20893,20893,Pat Falloon,1993-94,21.0,3,28,41,41,14,14,28,131.0,,120,39,48,87,312.0,84,7.25,87,443,2603,11.7,0.70986813
20894,20894,Pat Falloon,1994-95,22.0,4,53,83,83,22,31,53,193.0,,203,61,79,140,505.0,84,6.48,76,407,2545,10.7,0.6476258
20895,20895,Pat Falloon,1995-96,23.0,5,19,46,46,12,7,19,91.0,,249,73,86,159,596.0,48,5.97,37,209,1408,10.2,0.6389569
20896,20896,Pat Falloon,1996-97,24.0,6,51,71,71,25,26,51,170.0,,320,98,112,210,766.0,82,6.29,74,413,2481,10.4,0.6552174
20897,20897,Pat Falloon,1997-98,25.0,7,23,52,52,11,12,23,124.0,,372,109,124,233,890.0,82,5.83,55,336,2444,9.8,0.51465654
20898,20898,Pat Falloon,1998-99,26.0,8,18,58,58,8,10,18,136.0,,430,117,134,251,1026.0,82,5.28,57,380,2242,9.6,0.41664755
20899,20899,Pat Falloon,1999-00,27.0,9,40,82,82,17,23,40,152.0,1205.0,512,134,157,291,1178.0,82,5.27,57,359,2285,9.4,0.5535514
20900,20900,Pat Falloon,2000-01,28.0,10,31,63,63,9,22,31,92.0,776.0,575,143,179,322,1270.0,82,5.49,53,331,2294,9.8,0.48814914
20901,20901,Pat Flatley,1984-85,21.0,2,9,16,16,2,7,9,17.0,,16,2,7,9,17.0,80,7.89,74,336,2448,12.9,0.38934493
20902,20902,Pat Flatley,1985-86,22.0,3,51,78,78,20,31,51,134.0,,94,22,38,60,151.0,80,7.77,71,321,2447,12.7,0.6504252
20903,20903,Pat Flatley,1986-87,23.0,4,52,73,73,18,34,52,120.0,,167,40,72,112,271.0,80,7.94,82,370,2484,12.8,0.6467788
20904,20904,Pat Flatley,1987-88,24.0,5,51,63,63,16,35,51,113.0,,230,56,107,163,384.0,80,7.34,72,344,2400,12.2,0.758444
20905,20905,Pat Flatley,1988-89,25.0,6,24,40,40,9,15,24,83.0,,270,65,122,187,467.0,80,7.43,89,437,2435,12.2,0.62839484
20906,20906,Pat Flatley,1989-90,26.0,7,25,41,41,10,15,25,72.0,,311,75,137,212,539.0,80,7.48,85,403,2430,12.3,0.65086967
20907,20907,Pat Flatley,1990-91,27.0,8,49,62,62,17,32,49,136.0,,373,92,169,261,675.0,80,7.37,76,367,2421,12.2,0.6569848
20908,20908,Pat Flatley,1991-92,28.0,9,45,56,56,20,25,45,137.0,,429,112,194,306,812.0,80,6.91,71,366,2385,11.6,0.7216313
20909,20909,Pat Flatley,1992-93,29.0,10,36,38,38,8,28,36,76.0,,467,120,222,342,888.0,80,6.96,77,402,2440,11.4,0.65779996
20910,20910,Pat Flatley,1993-94,30.0,11,60,80,80,13,47,60,139.0,,547,133,269,402,1027.0,84,7.25,87,443,2603,11.7,0.6737008
20911,20911,Pat Flatley,1994-95,31.0,12,42,64,64,12,30,42,112.0,,611,145,299,444,1139.0,84,6.48,76,407,2545,10.7,0.5387978
20912,20912,Pat Flatley,1995-96,32.0,13,27,45,45,7,20,27,81.0,,656,152,319,471,1220.0,48,5.97,37,209,1408,10.2,0.550459
20913,20913,Pat Flatley,1996-97,33.0,14,17,56,56,8,9,17,89.0,,712,160,328,488,1309.0,82,6.29,74,413,2481,10.4,0.30369943
20914,20914,Pat Flatley,1997-98,34.0,15,22,68,68,10,12,22,96.0,,780,170,340,510,1405.0,82,5.83,55,336,2444,9.8,0.30245322
20915,20915,Pat Graham,1982-83,21.0,2,14,42,42,6,8,14,51.0,,42,6,8,14,51.0,80,8.03,73,320,2489,12.9,0.36539564
20916,20916,Pat Graham,1983-84,22.0,3,6,20,20,1,5,6,25.0,,62,7,13,20,76.0,80,7.73,71,310,2444,12.7,0.34526923
20917,20917,Pat Graham,1984-85,23.0,4,8,41,41,4,4,8,46.0,,103,11,17,28,122.0,80,7.89,74,336,2448,12.9,0.29056224
20918,20918,Pat Kavanagh,2003-04,24.0,2,1,3,3,1,0,1,4.0,31.0,3,1,0,1,4.0,82,5.31,60,363,2326,9.4,0.20980963
20919,20919,Pat Kavanagh,2004-05,25.0,3,1,3,3,1,0,1,1.0,24.0,6,2,0,2,5.0,82,5.14,57,348,2300,9.2,0.19358969
20920,20920,Pat Kavanagh,2006-07,27.0,4,0,8,8,0,0,0,1.0,42.0,14,2,0,2,6.0,82,6.05,85,480,2458,10.1,0.1478293
20921,20921,Pat LaFontaine,1984-85,19.0,2,19,15,15,13,6,19,35.0,,15,13,6,19,35.0,80,7.89,74,336,2448,12.9,0.77559185
20922,20922,Pat LaFontaine,1985-86,20.0,3,54,67,67,19,35,54,172.0,,82,32,41,73,207.0,80,7.77,71,321,2447,12.7,0.80240333
20923,20923,Pat LaFontaine,1986-87,21.0,4,53,65,65,30,23,53,172.0,,147,62,64,126,379.0,80,7.94,82,370,2484,12.8,0.85230374
20924,20924,Pat LaFontaine,1987-88,22.0,5,70,80,80,38,32,70,219.0,,227,100,96,196,598.0,80,7.34,72,344,2400,12.2,0.97120535
20925,20925,Pat LaFontaine,1988-89,23.0,6,92,75,75,47,45,92,242.0,,302,147,141,288,840.0,80,7.43,89,437,2435,12.2,1.0619924
20926,20926,Pat LaFontaine,1989-90,24.0,7,88,79,79,45,43,88,288.0,,381,192,184,376,1128.0,80,7.48,85,403,2430,12.3,1.1040523
20927,20927,Pat LaFontaine,1990-91,25.0,8,105,74,74,54,51,105,286.0,,455,246,235,481,1414.0,80,7.37,76,367,2421,12.2,1.1586394
20928,20928,Pat LaFontaine,1991-92,26.0,9,85,75,75,41,44,85,225.0,,530,287,279,566,1639.0,80,6.91,71,366,2385,11.6,1.1668475
20929,20929,Pat LaFontaine,1992-93,27.0,10,93,57,57,46,47,93,203.0,,587,333,326,659,1842.0,80,6.96,77,402,2440,11.4,1.5017058
20930,20930,Pat LaFontaine,1993-94,28.0,11,148,84,84,53,95,148,306.0,,671,386,421,807,2148.0,84,7.25,87,443,2603,11.7,1.251187
20931,20931,Pat LaFontaine,1994-95,29.0,12,18,16,16,5,13,18,40.0,,687,391,434,825,2188.0,84,6.48,76,407,2545,10.7,1.0395738
20932,20932,Pat LaFontaine,1995-96,30.0,13,27,22,22,12,15,27,54.0,,709,403,449,852,2242.0,48,5.97,37,209,1408,10.2,1.0608189
20933,20933,Pat LaFontaine,1996-97,31.0,14,91,76,76,40,51,91,224.0,,785,443,500,943,2466.0,82,6.29,74,413,2481,10.4,0.96192336
20934,20934,Pat LaFontaine,1997-98,32.0,15,8,13,13,2,6,8,38.0,,798,445,506,951,2504.0,82,5.83,55,336,2444,9.8,0.6881112
20935,20935,Pat LaFontaine,1998-99,33.0,16,62,67,67,23,39,62,160.0,,865,468,545,1013,2664.0,82,5.28,57,380,2242,9.6,0.83035374
20936,20936,Pat MacLeod,1991-92,22.0,2,1,1,1,0,1,1,1.0,,1,0,1,1,1.0,80,6.91,71,366,2385,11.6,0.22784156
20937,20937,Pat MacLeod,1992-93,23.0,3,16,37,37,5,11,16,77.0,,38,5,12,17,78.0,80,6.96,77,402,2440,11.4,0.42722192
20938,20938,Pat MacLeod,1993-94,24.0,4,1,13,13,0,1,1,20.0,,51,5,13,18,98.0,84,7.25,87,443,2603,11.7,0.24499482
20939,20939,Pat MacLeod,1996-97,27.0,5,0,2,2,0,0,0,2.0,,53,5,13,18,100.0,82,6.29,74,413,2481,10.4,0.1646908
20940,20940,Pat Maroon,2012-13,24.0,2,0,2,2,0,0,0,1.0,25.0,2,0,0,0,1.0,82,5.32,47,271,2439,8.9,0.15986353
20941,20941,Pat Maroon,2013-14,25.0,3,3,13,13,2,1,3,21.0,127.0,15,2,1,3,22.0,48,5.31,29,160,1399,9.1,0.27083004
20942,20942,Pat Maroon,2014-15,26.0,4,29,62,62,11,18,29,93.0,763.0,77,13,19,32,115.0,82,5.34,48,269,2463,8.9,0.35894197
20943,20943,Pat Maroon,2015-16,27.0,5,34,71,71,9,25,34,120.0,1014.0,148,22,44,66,235.0,82,5.32,47,251,2453,8.9,0.40680274
20944,20944,Pat Maroon,2016-17,28.0,6,27,72,72,12,15,27,104.0,888.0,220,34,59,93,339.0,82,5.34,48,255,2438,9.0,0.32604408
20945,20945,Pat Maroon,2017-18,29.0,7,42,81,81,27,15,42,178.0,1356.0,301,61,74,135,517.0,82,5.45,47,245,2478,9.0,0.53886515
20946,20946,Pat Maroon,2018-19,30.0,8,43,74,74,17,26,43,141.0,1224.0,375,78,100,178,658.0,82,5.86,50,250,2620,9.2,0.4819556
20947,20947,Pat Maroon,2019-20,31.0,9,28,74,74,10,18,28,118.0,1049.0,449,88,118,206,776.0,82,5.96,47,239,2579,9.5,0.31946462
20948,20948,Pat Maroon,2020-21,32.0,10,23,64,64,9,14,23,80.0,794.0,513,97,132,229,856.0,70,5.96,42,208,2192,9.5,0.30798462
20949,20949,Pat Mayer,1988-89,27.0,2,0,1,1,0,0,0,0.0,,1,0,0,0,0.0,80,7.43,89,437,2435,12.2,0.16129571
20950,20950,Pat Micheletti,1988-89,25.0,2,2,12,12,2,0,2,18.0,,12,2,0,2,18.0,80,7.43,89,437,2435,12.2,0.29549244
20951,20951,Pat Murray,1991-92,22.0,2,3,16,16,2,1,3,16.0,,16,2,1,3,16.0,80,6.91,71,366,2385,11.6,0.3073476
20952,20952,Pat Murray,1992-93,23.0,3,1,9,9,1,0,1,8.0,,25,3,1,4,24.0,80,6.96,77,402,2440,11.4,0.24886307
20953,20953,Pat Neaton,1994-95,23.0,2,2,9,9,1,1,2,11.0,,9,1,1,2,11.0,84,6.48,76,407,2545,10.7,0.24886334
20954,20954,Pat Peake,1994-95,21.0,2,29,49,49,11,18,29,91.0,,49,11,18,29,91.0,84,6.48,76,407,2545,10.7,0.48961976
20955,20955,Pat Peake,1995-96,22.0,3,4,18,18,0,4,4,30.0,,67,11,22,33,121.0,48,5.97,37,209,1408,10.2,0.37334222
20956,20956,Pat Peake,1996-97,23.0,4,36,62,62,17,19,36,129.0,,129,28,41,69,250.0,82,6.29,74,413,2481,10.4,0.50555044
20957,20957,Pat Peake,1997-98,24.0,5,0,4,4,0,0,0,9.0,,133,28,41,69,259.0,82,5.83,55,336,2444,9.8,0.299096
20958,20958,Pat Peake,1998-99,25.0,6,0,1,1,0,0,0,0.0,,134,28,41,69,259.0,82,5.28,57,380,2242,9.6,0.2899802
20959,20959,Pat Verbeek,1983-84,19.0,2,5,6,6,3,2,5,12.0,,6,3,2,5,12.0,80,7.73,71,310,2444,12.7,0.40507233
20960,20960,Pat Verbeek,1984-85,20.0,3,47,79,79,20,27,47,167.0,,85,23,29,52,179.0,80,7.89,74,336,2448,12.9,0.66360915
20961,20961,Pat Verbeek,1985-86,21.0,4,33,78,78,15,18,33,148.0,,163,38,47,85,327.0,80,7.77,71,321,2447,12.7,0.5253207
20962,20962,Pat Verbeek,1986-87,22.0,5,52,76,76,25,27,52,159.0,,239,63,74,137,486.0,80,7.94,82,370,2484,12.8,0.71785843
20963,20963,Pat Verbeek,1987-88,23.0,6,59,74,74,35,24,59,144.0,,313,98,98,196,630.0,80,7.34,72,344,2400,12.2,0.79797363
20964,20964,Pat Verbeek,1988-89,24.0,7,77,73,73,46,31,77,179.0,,386,144,129,273,809.0,80,7.43,89,437,2435,12.2,0.88022184
20965,20965,Pat Verbeek,1989-90,25.0,8,47,77,77,26,21,47,175.0,,463,170,150,320,984.0,80,7.48,85,403,2430,12.3,0.6835396
20966,20966,Pat Verbeek,1990-91,26.0,9,89,80,80,44,45,89,219.0,,543,214,195,409,1203.0,80,7.37,76,367,2421,12.2,1.0384777
20967,20967,Pat Verbeek,1991-92,27.0,10,82,80,80,43,39,82,247.0,,623,257,234,491,1450.0,80,6.91,71,366,2385,11.6,0.9113387
20968,20968,Pat Verbeek,1992-93,28.0,11,57,76,76,22,35,57,163.0,,699,279,269,548,1613.0,80,6.96,77,402,2440,11.4,0.712987
20969,20969,Pat Verbeek,1993-94,29.0,12,82,84,84,39,43,82,235.0,,783,318,312,630,1848.0,84,7.25,87,443,2603,11.7,0.79415786
20970,20970,Pat Verbeek,1994-95,30.0,13,75,84,84,37,38,75,226.0,,867,355,350,705,2074.0,84,6.48,76,407,2545,10.7,0.75709796
20971,20971,Pat Verbeek,1995-96,31.0,14,33,48,48,17,16,33,131.0,,915,372,366,738,2205.0,48,5.97,37,209,1408,10.2,0.7456342
20972,20972,Pat Verbeek,1996-97,32.0,15,82,69,69,41,41,82,252.0,,984,413,407,820,2457.0,82,6.29,74,413,2481,10.4,0.8367491
20973,20973,Pat Verbeek,1997-98,33.0,16,53,81,81,17,36,53,172.0,,1065,430,443,873,2629.0,82,5.83,55,336,2444,9.8,0.6209395
20974,20974,Pat Verbeek,1998-99,34.0,17,57,82,82,31,26,57,190.0,,1147,461,469,930,2819.0,82,5.28,57,380,2242,9.6,0.6304012
20975,20975,Pat Verbeek,1999-00,35.0,18,34,78,78,17,17,34,134.0,1136.0,1225,478,486,964,2953.0,82,5.27,57,359,2285,9.4,0.4955752
20976,20976,Pat Verbeek,2000-01,36.0,19,48,68,68,22,26,48,138.0,1092.0,1293,500,512,1012,3091.0,82,5.49,53,331,2294,9.8,0.56502545
20977,20977,Pat Verbeek,2001-02,37.0,20,30,67,67,15,15,30,113.0,905.0,1360,515,527,1042,3204.0,82,5.51,63,376,2272,9.9,0.40508246
20978,20978,Pat Verbeek,2002-03,38.0,21,20,64,64,7,13,20,81.0,745.0,1424,522,540,1062,3285.0,82,5.24,53,338,2262,9.5,0.2844612
20979,20979,Patric Hornqvist,2009-10,23.0,2,7,28,28,2,5,7,54.0,319.0,28,2,5,7,54.0,82,5.7,65,341,2477,9.4,0.27387226
20980,20980,Patric Hornqvist,2010-11,24.0,3,51,80,80,30,21,51,275.0,1255.0,108,32,26,58,329.0,82,5.53,56,304,2486,9.1,0.6590864
20981,20981,Patric Hornqvist,2011-12,25.0,4,48,79,79,21,27,48,265.0,1242.0,187,53,53,106,594.0,82,5.46,52,291,2492,9.0,0.6126694
20982,20982,Patric Hornqvist,2012-13,26.0,5,43,76,76,27,16,43,230.0,1165.0,263,80,69,149,824.0,82,5.32,47,271,2439,8.9,0.59512264
20983,20983,Patric Hornqvist,2013-14,27.0,6,14,24,24,4,10,14,87.0,389.0,287,84,79,163,911.0,48,5.31,29,160,1399,9.1,0.5696304
20984,20984,Patric Hornqvist,2014-15,28.0,7,53,76,76,22,31,53,248.0,1281.0,363,106,110,216,1159.0,82,5.34,48,269,2463,8.9,0.64692557
20985,20985,Patric Hornqvist,2015-16,29.0,8,51,64,64,25,26,51,220.0,1130.0,427,131,136,267,1379.0,82,5.32,47,251,2453,8.9,0.70094216
20986,20986,Patric Hornqvist,2016-17,30.0,9,51,82,82,22,29,51,257.0,1382.0,509,153,165,318,1636.0,82,5.34,48,255,2438,9.0,0.6008856
20987,20987,Patric Hornqvist,2017-18,31.0,10,44,70,70,21,23,44,223.0,1117.0,579,174,188,362,1859.0,82,5.45,47,245,2478,9.0,0.6380883
20988,20988,Patric Hornqvist,2018-19,32.0,11,49,70,70,29,20,49,247.0,1213.0,649,203,208,411,2106.0,82,5.86,50,250,2620,9.2,0.64884275
20989,20989,Patric Hornqvist,2019-20,33.0,12,37,69,69,18,19,37,197.0,1068.0,718,221,227,448,2303.0,82,5.96,47,239,2579,9.5,0.543995
20990,20990,Patric Hornqvist,2020-21,34.0,13,32,52,52,17,15,32,168.0,828.0,770,238,242,480,2471.0,70,5.96,42,208,2192,9.5,0.5756209
20991,20991,Patric Kjellberg,1993-94,24.0,2,0,7,7,0,0,0,7.0,,7,0,0,0,7.0,84,7.25,87,443,2603,11.7,0.21853414
20992,20992,Patric Kjellberg,1999-00,30.0,3,31,71,71,11,20,31,103.0,1256.0,78,11,20,31,110.0,82,5.27,57,359,2285,9.4,0.39999527
20993,20993,Patric Kjellberg,2000-01,31.0,4,46,82,82,23,23,46,129.0,1492.0,160,34,43,77,239.0,82,5.49,53,331,2294,9.8,0.5047834
20994,20994,Patric Kjellberg,2001-02,32.0,5,45,81,81,14,31,45,139.0,1430.0,241,48,74,122,378.0,82,5.51,63,376,2272,9.9,0.48994324
20995,20995,Patric Kjellberg,2002-03,33.0,6,19,77,77,8,11,19,88.0,1314.0,318,56,85,141,466.0,82,5.24,53,338,2262,9.5,0.29808378
20996,20996,Patric Kjellberg,2003-04,34.0,7,19,76,76,8,11,19,95.0,1188.0,394,64,96,160,561.0,82,5.31,60,363,2326,9.4,0.28327703
20997,20997,Patrice Bergeron,2004-05,19.0,2,39,71,71,16,23,39,133.0,1161.0,71,16,23,39,133.0,82,5.14,57,348,2300,9.2,0.7673178
20998,20998,Patrice Bergeron,2006-07,21.0,3,73,81,81,31,42,73,310.0,1668.0,152,47,65,112,443.0,82,6.05,85,480,2458,10.1,0.9132124
20999,20999,Patrice Bergeron,2007-08,22.0,4,70,77,77,22,48,70,224.0,1603.0,229,69,113,182,667.0,82,5.76,70,398,2426,9.7,0.9091041
21000,21000,Patrice Bergeron,2008-09,23.0,5,7,10,10,3,4,7,24.0,182.0,239,72,117,189,691.0,82,5.44,62,351,2383,9.4,0.6416225
21001,21001,Patrice Bergeron,2009-10,24.0,6,39,64,64,8,31,39,155.0,1151.0,303,80,148,228,846.0,82,5.7,65,341,2477,9.4,0.63777184
21002,21002,Patrice Bergeron,2010-11,25.0,7,52,73,73,19,33,52,184.0,1380.0,376,99,181,280,1030.0,82,5.53,56,304,2486,9.1,0.6716635
21003,21003,Patrice Bergeron,2011-12,26.0,8,57,80,80,22,35,57,211.0,1431.0,456,121,216,337,1241.0,82,5.46,52,291,2492,9.0,0.7174617
21004,21004,Patrice Bergeron,2012-13,27.0,9,64,81,81,22,42,64,191.0,1505.0,537,143,258,401,1432.0,82,5.32,47,271,2439,8.9,0.78207636
21005,21005,Patrice Bergeron,2013-14,28.0,10,32,42,42,10,22,32,125.0,810.0,579,153,280,433,1557.0,48,5.31,29,160,1399,9.1,0.7151114
21006,21006,Patrice Bergeron,2014-15,29.0,11,62,80,80,30,32,62,243.0,1439.0,659,183,312,495,1800.0,82,5.34,48,269,2463,8.9,0.7315196
21007,21007,Patrice Bergeron,2015-16,30.0,12,55,81,81,23,32,55,234.0,1469.0,740,206,344,550,2034.0,82,5.32,47,251,2453,8.9,0.6622236
21008,21008,Patrice Bergeron,2016-17,31.0,13,68,80,80,32,36,68,282.0,1587.0,820,238,380,618,2316.0,82,5.34,48,255,2438,9.0,0.8071927
21009,21009,Patrice Bergeron,2017-18,32.0,14,53,79,79,21,32,53,302.0,1534.0,899,259,412,671,2618.0,82,5.45,47,245,2478,9.0,0.67109716
21010,21010,Patrice Bergeron,2018-19,33.0,15,63,64,64,30,33,63,224.0,1244.0,963,289,445,734,2842.0,82,5.86,50,250,2620,9.2,0.87859833
21011,21011,Patrice Bergeron,2019-20,34.0,16,79,65,65,32,47,79,205.0,1200.0,1028,321,492,813,3047.0,82,5.96,47,239,2579,9.5,0.9669902
21012,21012,Patrice Bergeron,2020-21,35.0,17,56,61,61,31,25,56,203.0,1143.0,1089,352,517,869,3250.0,70,5.96,42,208,2192,9.5,0.79361916
21013,21013,Patrice Brisebois,1991-92,21.0,2,2,10,10,0,2,2,11.0,,10,0,2,2,11.0,80,6.91,71,366,2385,11.6,0.27101633
21014,21014,Patrice Brisebois,1992-93,22.0,3,10,26,26,2,8,10,37.0,,36,2,10,12,48.0,80,6.96,77,402,2440,11.4,0.3423347
21015,21015,Patrice Brisebois,1993-94,23.0,4,31,70,70,10,21,31,123.0,,106,12,31,43,171.0,84,7.25,87,443,2603,11.7,0.45432073
21016,21016,Patrice Brisebois,1994-95,24.0,5,23,53,53,2,21,23,71.0,,159,14,52,66,242.0,84,6.48,76,407,2545,10.7,0.3342928
21017,21017,Patrice Brisebois,1995-96,25.0,6,12,35,35,4,8,12,67.0,,194,18,60,78,309.0,48,5.97,37,209,1408,10.2,0.33098477
21018,21018,Patrice Brisebois,1996-97,26.0,7,36,69,69,9,27,36,127.0,,263,27,87,114,436.0,82,6.29,74,413,2481,10.4,0.45367432
21019,21019,Patrice Brisebois,1997-98,27.0,8,15,49,49,2,13,15,72.0,,312,29,100,129,508.0,82,5.83,55,336,2444,9.8,0.29091394
21020,21020,Patrice Brisebois,1998-99,28.0,9,37,79,79,10,27,37,125.0,,391,39,127,166,633.0,82,5.28,57,380,2242,9.6,0.43565443
21021,21021,Patrice Brisebois,1999-00,29.0,10,12,54,54,3,9,12,90.0,1211.0,445,42,136,178,723.0,82,5.27,57,359,2285,9.4,0.2888806
21022,21022,Patrice Brisebois,2000-01,30.0,11,35,54,54,10,25,35,88.0,1254.0,499,52,161,213,811.0,82,5.49,53,331,2294,9.8,0.5024121
21023,21023,Patrice Brisebois,2001-02,31.0,12,36,77,77,15,21,36,178.0,1903.0,576,67,182,249,989.0,82,5.51,63,376,2272,9.9,0.44728357
21024,21024,Patrice Brisebois,2002-03,32.0,13,33,71,71,4,29,33,95.0,1696.0,647,71,211,282,1084.0,82,5.24,53,338,2262,9.5,0.37934738
21025,21025,Patrice Brisebois,2003-04,33.0,14,29,73,73,4,25,29,105.0,1707.0,720,75,236,311,1189.0,82,5.31,60,363,2326,9.4,0.31172666
21026,21026,Patrice Brisebois,2004-05,34.0,15,31,71,71,4,27,31,96.0,1515.0,791,79,263,342,1285.0,82,5.14,57,348,2300,9.2,0.4067838
21027,21027,Patrice Brisebois,2006-07,36.0,16,38,80,80,10,28,38,107.0,1785.0,871,89,291,380,1392.0,82,6.05,85,480,2458,10.1,0.3521042
21028,21028,Patrice Brisebois,2007-08,37.0,17,11,33,33,1,10,11,36.0,640.0,904,90,301,391,1428.0,82,5.76,70,398,2426,9.7,0.19459388
21029,21029,Patrice Brisebois,2008-09,38.0,18,11,43,43,3,8,11,42.0,724.0,947,93,309,402,1470.0,82,5.44,62,351,2383,9.4,0.16708982
21030,21030,Patrice Brisebois,2009-10,39.0,19,18,62,62,5,13,18,68.0,986.0,1009,98,322,420,1538.0,82,5.7,65,341,2477,9.4,0.22781897
21031,21031,Patrice Cormier,2011-12,21.0,2,2,21,21,1,1,2,27.0,203.0,21,1,1,2,27.0,82,5.46,52,291,2492,9.0,0.24846643
21032,21032,Patrice Cormier,2012-13,22.0,3,0,9,9,0,0,0,8.0,57.0,30,1,1,2,35.0,82,5.32,47,271,2439,8.9,0.16164783
21033,21033,Patrice Cormier,2013-14,23.0,4,0,10,10,0,0,0,4.0,39.0,40,1,1,2,39.0,48,5.31,29,160,1399,9.1,0.1731466
21034,21034,Patrice Cormier,2014-15,24.0,5,3,9,9,0,3,3,4.0,63.0,49,1,4,5,43.0,82,5.34,48,269,2463,8.9,0.1604847
21035,21035,Patrice Cormier,2015-16,25.0,6,0,1,1,0,0,0,0.0,5.0,50,1,4,5,43.0,82,5.32,47,251,2453,8.9,0.12966087
21036,21036,Patrice Cormier,2016-17,26.0,7,0,2,2,0,0,0,1.0,9.0,52,1,4,5,44.0,82,5.34,48,255,2438,9.0,0.13004002
21037,21037,Patrice Lefebvre,1999-00,32.0,2,0,3,3,0,0,0,2.0,34.0,3,0,0,0,2.0,82,5.27,57,359,2285,9.4,0.16194889
21038,21038,Patrice Tardif,1995-96,25.0,2,13,27,27,3,10,13,46.0,,27,3,10,13,46.0,48,5.97,37,209,1408,10.2,0.33734882
21039,21039,Patrice Tardif,1996-97,26.0,3,5,38,38,4,1,5,50.0,,65,7,11,18,96.0,82,6.29,74,413,2481,10.4,0.21309194
21040,21040,Patrick Boileau,1997-98,22.0,2,0,1,1,0,0,0,0.0,,1,0,0,0,0.0,82,5.83,55,336,2444,9.8,0.157395
21041,21041,Patrick Boileau,1999-00,24.0,3,1,4,4,0,1,1,7.0,64.0,5,0,1,1,7.0,82,5.27,57,359,2285,9.4,0.18285108
21042,21042,Patrick Boileau,2002-03,27.0,4,0,2,2,0,0,0,0.0,24.0,7,0,1,1,7.0,82,5.24,53,338,2262,9.5,0.1585913
21043,21043,Patrick Boileau,2003-04,28.0,5,8,25,25,2,6,8,18.0,349.0,32,2,7,9,25.0,82,5.31,60,363,2326,9.4,0.18903375
21044,21044,Patrick Boileau,2004-05,29.0,6,7,16,16,3,4,7,41.0,318.0,48,5,11,16,66.0,82,5.14,57,348,2300,9.2,0.26067585
21045,21045,Patrick Bordeleau,2013-14,27.0,2,5,46,46,2,3,5,24.0,286.0,46,2,3,5,24.0,48,5.31,29,160,1399,9.1,0.14255992
21046,21046,Patrick Bordeleau,2014-15,28.0,3,11,82,82,6,5,11,37.0,565.0,128,8,8,16,61.0,82,5.34,48,269,2463,8.9,0.13867617
21047,21047,Patrick Bordeleau,2015-16,29.0,4,0,1,1,0,0,0,0.0,7.0,129,8,8,16,61.0,82,5.32,47,251,2453,8.9,0.12116149
21048,21048,Patrick Brown,2015-16,23.0,2,0,7,7,0,0,0,4.0,62.0,7,0,0,0,4.0,82,5.32,47,251,2453,8.9,0.17318648
21049,21049,Patrick Brown,2016-17,24.0,3,2,7,7,1,1,2,8.0,88.0,14,1,1,2,12.0,82,5.34,48,255,2438,9.0,0.18672949
21050,21050,Patrick Brown,2017-18,25.0,4,0,14,14,0,0,0,12.0,136.0,28,1,1,2,24.0,82,5.45,47,245,2478,9.0,0.17439726
21051,21051,Patrick Brown,2020-21,28.0,5,1,1,1,1,0,1,2.0,10.0,29,2,1,3,26.0,70,5.96,42,208,2192,9.5,0.24500135
21052,21052,Patrick Cannone,2017-18,31.0,2,0,3,3,0,0,0,2.0,24.0,3,0,0,0,2.0,82,5.45,47,245,2478,9.0,0.17226657
21053,21053,Patrick Cote,1996-97,22.0,2,0,2,2,0,0,0,0.0,,2,0,0,0,0.0,82,6.29,74,413,2481,10.4,0.1544433
21054,21054,Patrick Cote,1997-98,23.0,3,0,3,3,0,0,0,1.0,,5,0,0,0,1.0,82,5.83,55,336,2444,9.8,0.15911222
21055,21055,Patrick Cote,1998-99,24.0,4,0,3,3,0,0,0,3.0,,8,0,0,0,4.0,82,5.28,57,380,2242,9.6,0.16511017
21056,21056,Patrick Cote,1999-00,25.0,5,3,70,70,1,2,3,21.0,296.0,78,1,2,3,25.0,82,5.27,57,359,2285,9.4,0.09368855
21057,21057,Patrick Cote,2000-01,26.0,6,0,21,21,0,0,0,8.0,110.0,99,1,2,3,33.0,82,5.49,53,331,2294,9.8,0.08121899
21058,21058,Patrick Cote,2001-02,27.0,7,0,6,6,0,0,0,0.0,19.0,105,1,2,3,33.0,82,5.51,63,376,2272,9.9,0.10226357
21059,21059,Patrick Coulombe,2007-08,22.0,2,1,7,7,0,1,1,11.0,95.0,7,0,1,1,11.0,82,5.76,70,398,2426,9.7,0.21138015
21060,21060,Patrick Davis,2009-10,23.0,2,0,1,1,0,0,0,0.0,5.0,1,0,0,0,0.0,82,5.7,65,341,2477,9.4,0.16788644
21061,21061,Patrick Davis,2010-11,24.0,3,1,8,8,1,0,1,8.0,101.0,9,1,0,1,8.0,82,5.53,56,304,2486,9.1,0.19888216
21062,21062,Patrick Dwyer,2009-10,26.0,2,1,13,13,1,0,1,9.0,111.0,13,1,0,1,9.0,82,5.7,65,341,2477,9.4,0.19640052
21063,21063,Patrick Dwyer,2010-11,27.0,3,12,58,58,7,5,12,80.0,725.0,71,8,5,13,89.0,82,5.53,56,304,2486,9.1,0.23088184
21064,21064,Patrick Dwyer,2011-12,28.0,4,18,80,80,8,10,18,104.0,1006.0,151,16,15,31,193.0,82,5.46,52,291,2492,9.0,0.22650042
21065,21065,Patrick Dwyer,2012-13,29.0,5,12,73,73,5,7,12,120.0,1122.0,224,21,22,43,313.0,82,5.32,47,271,2439,8.9,0.2118986
21066,21066,Patrick Dwyer,2013-14,30.0,6,16,46,46,8,8,16,93.0,710.0,270,29,30,59,406.0,48,5.31,29,160,1399,9.1,0.332713
21067,21067,Patrick Dwyer,2014-15,31.0,7,22,75,75,8,14,22,134.0,1099.0,345,37,44,81,540.0,82,5.34,48,269,2463,8.9,0.26142383
21068,21068,Patrick Dwyer,2015-16,32.0,8,12,71,71,5,7,12,77.0,907.0,416,42,51,93,617.0,82,5.32,47,251,2453,8.9,0.18722928
21069,21069,Patrick Eaves,2006-07,22.0,2,29,58,58,20,9,29,100.0,724.0,58,20,9,29,100.0,82,6.05,85,480,2458,10.1,0.49234325
21070,21070,Patrick Eaves,2007-08,23.0,3,32,73,73,14,18,32,130.0,892.0,131,34,27,61,230.0,82,5.76,70,398,2426,9.7,0.4479955
21071,21071,Patrick Eaves,2008-09,24.0,4,15,37,37,5,10,15,81.0,473.0,168,39,37,76,311.0,82,5.44,62,351,2383,9.4,0.4366233
21072,21072,Patrick Eaves,2009-10,25.0,5,14,74,74,6,8,14,115.0,833.0,242,45,45,90,426.0,82,5.7,65,341,2477,9.4,0.26109463
21073,21073,Patrick Eaves,2010-11,26.0,6,22,65,65,12,10,22,120.0,874.0,307,57,55,112,546.0,82,5.53,56,304,2486,9.1,0.31452227
21074,21074,Patrick Eaves,2011-12,27.0,7,20,63,63,13,7,20,108.0,800.0,370,70,62,132,654.0,82,5.46,52,291,2492,9.0,0.33376878
21075,21075,Patrick Eaves,2012-13,28.0,8,1,10,10,0,1,1,24.0,110.0,380,70,63,133,678.0,82,5.32,47,271,2439,8.9,0.3456046
21076,21076,Patrick Eaves,2013-14,29.0,9,8,34,34,2,6,8,42.0,360.0,414,72,69,141,720.0,48,5.31,29,160,1399,9.1,0.27009755
21077,21077,Patrick Eaves,2014-15,30.0,10,5,30,30,2,3,5,53.0,338.0,444,74,72,146,773.0,82,5.34,48,269,2463,8.9,0.27619764
21078,21078,Patrick Eaves,2015-16,31.0,11,27,47,47,14,13,27,91.0,645.0,491,88,85,173,864.0,82,5.32,47,251,2453,8.9,0.43795812
21079,21079,Patrick Eaves,2016-17,32.0,12,17,54,54,11,6,17,86.0,700.0,545,99,91,190,950.0,82,5.34,48,255,2438,9.0,0.32554996
21080,21080,Patrick Eaves,2017-18,33.0,13,51,79,79,32,19,51,209.0,1296.0,624,131,110,241,1159.0,82,5.45,47,245,2478,9.0,0.54593784
21081,21081,Patrick Eaves,2018-19,34.0,14,1,2,2,1,0,1,3.0,33.0,626,132,110,242,1162.0,82,5.86,50,250,2620,9.2,0.1557579
21082,21082,Patrick Eaves,2019-20,35.0,15,0,7,7,0,0,0,6.0,97.0,633,132,110,242,1168.0,82,5.96,47,239,2579,9.5,0.141758
21083,21083,Patrick Fischer,2007-08,32.0,2,10,27,27,4,6,10,32.0,293.0,27,4,6,10,32.0,82,5.76,70,398,2426,9.7,0.23512232
21084,21084,Patrick Holland,2014-15,23.0,2,0,5,5,0,0,0,2.0,38.0,5,0,0,0,2.0,82,5.34,48,269,2463,8.9,0.17318648
21085,21085,Patrick Kaleta,2007-08,21.0,2,2,7,7,0,2,2,6.0,48.0,7,0,2,2,6.0,82,5.76,70,398,2426,9.7,0.24433336
21086,21086,Patrick Kaleta,2008-09,22.0,3,5,40,40,3,2,5,26.0,253.0,47,3,4,7,32.0,82,5.44,62,351,2383,9.4,0.19784144
21087,21087,Patrick Kaleta,2009-10,23.0,4,9,51,51,4,5,9,35.0,455.0,98,7,9,16,67.0,82,5.7,65,341,2477,9.4,0.21362475
21088,21088,Patrick Kaleta,2010-11,24.0,5,15,55,55,10,5,15,64.0,558.0,153,17,14,31,131.0,82,5.53,56,304,2486,9.1,0.23415148
21089,21089,Patrick Kaleta,2011-12,25.0,6,9,51,51,4,5,9,65.0,520.0,204,21,19,40,196.0,82,5.46,52,291,2492,9.0,0.20038903
21090,21090,Patrick Kaleta,2012-13,26.0,7,10,63,63,5,5,10,69.0,829.0,267,26,24,50,265.0,82,5.32,47,271,2439,8.9,0.20101488
21091,21091,Patrick Kaleta,2013-14,27.0,8,1,34,34,1,0,1,34.0,367.0,301,27,24,51,299.0,48,5.31,29,160,1399,9.1,0.15114659
21092,21092,Patrick Kaleta,2014-15,28.0,9,0,5,5,0,0,0,0.0,42.0,306,27,24,51,299.0,82,5.34,48,269,2463,8.9,0.1787068
21093,21093,Patrick Kaleta,2015-16,29.0,10,3,42,42,0,3,3,25.0,372.0,348,27,27,54,324.0,82,5.32,47,251,2453,8.9,0.1214765
21094,21094,Patrick Kane,2008-09,20.0,2,72,82,82,21,51,72,191.0,1506.0,82,21,51,72,191.0,82,5.44,62,351,2383,9.4,0.9001756
21095,21095,Patrick Kane,2009-10,21.0,3,70,80,80,25,45,70,254.0,1493.0,162,46,96,142,445.0,82,5.7,65,341,2477,9.4,0.92418265
21096,21096,Patrick Kane,2010-11,22.0,4,88,82,82,30,58,88,261.0,1574.0,244,76,154,230,706.0,82,5.53,56,304,2486,9.1,1.1056249
21097,21097,Patrick Kane,2011-12,23.0,5,73,73,73,27,46,73,216.0,1408.0,317,103,200,303,922.0,82,5.46,52,291,2492,9.0,0.9478291
21098,21098,Patrick Kane,2012-13,24.0,6,66,82,82,23,43,66,253.0,1656.0,399,126,243,369,1175.0,82,5.32,47,271,2439,8.9,0.90474385
21099,21099,Patrick Kane,2013-14,25.0,7,55,47,47,23,32,55,138.0,943.0,446,149,275,424,1313.0,48,5.31,29,160,1399,9.1,1.1328855
21100,21100,Patrick Kane,2014-15,26.0,8,69,69,69,29,40,69,227.0,1353.0,515,178,315,493,1540.0,82,5.34,48,269,2463,8.9,0.97272265
21101,21101,Patrick Kane,2015-16,27.0,9,64,61,61,27,37,64,186.0,1211.0,576,205,352,557,1726.0,82,5.32,47,251,2453,8.9,1.0112188
21102,21102,Patrick Kane,2016-17,28.0,10,106,82,82,46,60,106,287.0,1674.0,658,251,412,663,2013.0,82,5.34,48,255,2438,9.0,1.1312661
21103,21103,Patrick Kane,2017-18,29.0,11,89,82,82,34,55,89,292.0,1754.0,740,285,467,752,2305.0,82,5.45,47,245,2478,9.0,1.0037591
21104,21104,Patrick Kane,2018-19,30.0,12,76,82,82,27,49,76,285.0,1655.0,822,312,516,828,2590.0,82,5.86,50,250,2620,9.2,0.944633
21105,21105,Patrick Kane,2019-20,31.0,13,110,81,81,44,66,110,341.0,1822.0,903,356,582,938,2931.0,82,5.96,47,239,2579,9.5,1.1918893
21106,21106,Patrick Kane,2020-21,32.0,14,84,70,70,33,51,84,275.0,1494.0,973,389,633,1022,3206.0,70,5.96,42,208,2192,9.5,1.0587404
21107,21107,Patrick Leahy,2004-05,25.0,2,0,6,6,0,0,0,2.0,33.0,6,0,0,0,2.0,82,5.14,57,348,2300,9.2,0.1864537
21108,21108,Patrick Leahy,2006-07,27.0,3,8,43,43,4,4,8,46.0,391.0,49,4,4,8,48.0,82,6.05,85,480,2458,10.1,0.16110536
21109,21109,Patrick Leahy,2007-08,28.0,4,0,1,1,0,0,0,0.0,6.0,50,4,4,8,48.0,82,5.76,70,398,2426,9.7,0.14688072
21110,21110,Patrick Lebeau,1991-92,21.0,2,2,2,2,1,1,2,3.0,,2,1,1,2,3.0,80,6.91,71,366,2385,11.6,0.29929906
21111,21111,Patrick Lebeau,1993-94,23.0,3,0,1,1,0,0,0,0.0,,3,1,1,2,3.0,84,7.25,87,443,2603,11.7,0.19052178
21112,21112,Patrick Lebeau,1994-95,24.0,4,2,4,4,1,1,2,4.0,,7,2,2,4,7.0,84,6.48,76,407,2545,10.7,0.22209653
21113,21113,Patrick Lebeau,1999-00,29.0,5,1,8,8,1,0,1,4.0,76.0,15,3,2,5,11.0,82,5.27,57,359,2285,9.4,0.15843543
21114,21114,Patrick Marleau,1998-99,19.0,2,32,74,74,13,19,32,90.0,,74,13,19,32,90.0,82,5.28,57,380,2242,9.6,0.53257275
21115,21115,Patrick Marleau,1999-00,20.0,3,45,81,81,21,24,45,134.0,1230.0,155,34,43,77,224.0,82,5.27,57,359,2285,9.4,0.627887
21116,21116,Patrick Marleau,2000-01,21.0,4,40,81,81,17,23,40,161.0,1149.0,236,51,66,117,385.0,82,5.49,53,331,2294,9.8,0.5940557
21117,21117,Patrick Marleau,2001-02,22.0,5,52,81,81,25,27,52,146.0,1319.0,317,76,93,169,531.0,82,5.51,63,376,2272,9.9,0.6881545
21118,21118,Patrick Marleau,2002-03,23.0,6,44,79,79,21,23,44,121.0,1111.0,396,97,116,213,652.0,82,5.24,53,338,2262,9.5,0.60758865
21119,21119,Patrick Marleau,2003-04,24.0,7,57,82,82,28,29,57,172.0,1519.0,478,125,145,270,824.0,82,5.31,60,363,2326,9.4,0.7197064
21120,21120,Patrick Marleau,2004-05,25.0,8,57,80,80,28,29,57,220.0,1456.0,558,153,174,327,1044.0,82,5.14,57,348,2300,9.2,0.8083633
21121,21121,Patrick Marleau,2006-07,27.0,9,86,82,82,34,52,86,260.0,1634.0,640,187,226,413,1304.0,82,6.05,85,480,2458,10.1,0.97322774
21122,21122,Patrick Marleau,2007-08,28.0,10,78,77,77,32,46,78,180.0,1429.0,717,219,272,491,1484.0,82,5.76,70,398,2426,9.7,0.8077904
21123,21123,Patrick Marleau,2008-09,29.0,11,48,78,78,19,29,48,185.0,1422.0,795,238,301,539,1669.0,82,5.44,62,351,2383,9.4,0.60020155
21124,21124,Patrick Marleau,2009-10,30.0,12,71,76,76,38,33,71,251.0,1623.0,871,276,334,610,1920.0,82,5.7,65,341,2477,9.4,0.81702995
21125,21125,Patrick Marleau,2010-11,31.0,13,83,82,82,44,39,83,274.0,1739.0,953,320,373,693,2194.0,82,5.53,56,304,2486,9.1,0.8363702
21126,21126,Patrick Marleau,2011-12,32.0,14,73,82,82,37,36,73,279.0,1705.0,1035,357,409,766,2473.0,82,5.46,52,291,2492,9.0,0.79397875
21127,21127,Patrick Marleau,2012-13,33.0,15,64,82,82,30,34,64,251.0,1679.0,1117,387,443,830,2724.0,82,5.32,47,271,2439,8.9,0.71352065
21128,21128,Patrick Marleau,2013-14,34.0,16,31,48,48,17,14,31,150.0,917.0,1165,404,457,861,2874.0,48,5.31,29,160,1399,9.1,0.70581996
21129,21129,Patrick Marleau,2014-15,35.0,17,70,82,82,33,37,70,285.0,1683.0,1247,437,494,931,3159.0,82,5.34,48,269,2463,8.9,0.7559904
21130,21130,Patrick Marleau,2015-16,36.0,18,57,82,82,19,38,57,233.0,1606.0,1329,456,532,988,3392.0,82,5.32,47,251,2453,8.9,0.62557167
21131,21131,Patrick Marleau,2016-17,37.0,19,48,82,82,25,23,48,216.0,1560.0,1411,481,555,1036,3608.0,82,5.34,48,255,2438,9.0,0.57468903
21132,21132,Patrick Marleau,2017-18,38.0,20,46,82,82,27,19,46,190.0,1407.0,1493,508,574,1082,3798.0,82,5.45,47,245,2478,9.0,0.52979845
21133,21133,Patrick Marleau,2018-19,39.0,21,47,82,82,27,20,47,203.0,1393.0,1575,535,594,1129,4001.0,82,5.86,50,250,2620,9.2,0.5573059
21134,21134,Patrick Marleau,2019-20,40.0,22,37,82,82,16,21,37,161.0,1340.0,1657,551,615,1166,4162.0,82,5.96,47,239,2579,9.5,0.4518309
21135,21135,Patrick Marleau,2020-21,41.0,23,22,66,66,11,11,22,117.0,1028.0,1723,562,626,1188,4279.0,70,5.96,42,208,2192,9.5,0.34459203
21136,21136,Patrick O'Sullivan,2007-08,22.0,2,19,44,44,5,14,19,92.0,619.0,44,5,14,19,92.0,82,5.76,70,398,2426,9.7,0.39870018
21137,21137,Patrick O'Sullivan,2008-09,23.0,3,53,82,82,22,31,53,220.0,1534.0,126,27,45,72,312.0,82,5.44,62,351,2383,9.4,0.6669947
21138,21138,Patrick O'Sullivan,2009-10,24.0,4,43,81,81,16,27,43,259.0,1551.0,207,43,72,115,571.0,82,5.7,65,341,2477,9.4,0.5885001
21139,21139,Patrick O'Sullivan,2010-11,25.0,5,34,73,73,11,23,34,191.0,1279.0,280,54,95,149,762.0,82,5.53,56,304,2486,9.1,0.49547622
21140,21140,Patrick O'Sullivan,2011-12,26.0,6,8,31,31,2,6,8,50.0,378.0,311,56,101,157,812.0,82,5.46,52,291,2492,9.0,0.3406137
21141,21141,Patrick O'Sullivan,2012-13,27.0,7,4,23,23,2,2,4,34.0,254.0,334,58,103,161,846.0,82,5.32,47,271,2439,8.9,0.32422554
21142,21142,Patrick Poulin,1992-93,19.0,2,0,1,1,0,0,0,0.0,,1,0,0,0,0.0,80,6.96,77,402,2440,11.4,0.23279491
21143,21143,Patrick Poulin,1993-94,20.0,3,51,81,81,20,31,51,160.0,,82,20,31,51,160.0,84,7.25,87,443,2603,11.7,0.6259385
21144,21144,Patrick Poulin,1994-95,21.0,4,28,67,67,14,14,28,96.0,,149,34,45,79,256.0,84,6.48,76,407,2545,10.7,0.53679436
21145,21145,Patrick Poulin,1995-96,22.0,5,30,45,45,15,15,30,77.0,,194,49,60,109,333.0,48,5.97,37,209,1408,10.2,0.60591745
21146,21146,Patrick Poulin,1996-97,23.0,6,16,46,46,7,9,16,51.0,,240,56,69,125,384.0,82,6.29,74,413,2481,10.4,0.42266715
21147,21147,Patrick Poulin,1997-98,24.0,7,26,73,73,12,14,26,124.0,,313,68,83,151,508.0,82,5.83,55,336,2444,9.8,0.44839057
21148,21148,Patrick Poulin,1998-99,25.0,8,19,78,78,6,13,19,88.0,,391,74,96,170,596.0,82,5.28,57,380,2242,9.6,0.32142636
21149,21149,Patrick Poulin,1999-00,26.0,9,25,81,81,8,17,25,87.0,1094.0,472,82,113,195,683.0,82,5.27,57,359,2285,9.4,0.35126108
21150,21150,Patrick Poulin,2000-01,27.0,10,15,82,82,10,5,15,82.0,1030.0,554,92,118,210,765.0,82,5.49,53,331,2294,9.8,0.29814535
21151,21151,Patrick Poulin,2001-02,28.0,11,20,52,52,9,11,20,65.0,690.0,606,101,129,230,830.0,82,5.51,63,376,2272,9.9,0.33893234
21152,21152,Patrick Poulin,2002-03,29.0,12,5,28,28,0,5,5,15.0,258.0,634,101,134,235,845.0,82,5.24,53,338,2262,9.5,0.22918043
21153,21153,Patrick Rissmiller,2004-05,26.0,2,0,4,4,0,0,0,2.0,28.0,4,0,0,0,2.0,82,5.14,57,348,2300,9.2,0.19870546
21154,21154,Patrick Rissmiller,2006-07,28.0,3,6,18,18,3,3,6,26.0,169.0,22,3,3,6,28.0,82,6.05,85,480,2458,10.1,0.23375335
21155,21155,Patrick Rissmiller,2007-08,29.0,4,22,79,79,7,15,22,100.0,961.0,101,10,18,28,128.0,82,5.76,70,398,2426,9.7,0.25934184
21156,21156,Patrick Rissmiller,2008-09,30.0,5,17,79,79,8,9,17,119.0,1040.0,180,18,27,45,247.0,82,5.44,62,351,2383,9.4,0.23138252
21157,21157,Patrick Rissmiller,2009-10,31.0,6,0,2,2,0,0,0,2.0,18.0,182,18,27,45,249.0,82,5.7,65,341,2477,9.4,0.16138545
21158,21158,Patrick Rissmiller,2011-12,33.0,7,1,10,10,0,1,1,14.0,104.0,192,18,28,46,263.0,82,5.46,52,291,2492,9.0,0.15683192
21159,21159,Patrick Russell,2019-20,27.0,2,0,6,6,0,0,0,6.0,53.0,6,0,0,0,6.0,82,5.96,47,239,2579,9.5,0.1832191
21160,21160,Patrick Russell,2020-21,28.0,3,5,45,45,0,5,5,58.0,511.0,51,0,5,5,64.0,70,5.96,42,208,2192,9.5,0.13658658
21161,21161,Patrick Sharp,2003-04,22.0,2,0,3,3,0,0,0,3.0,18.0,3,0,0,0,3.0,82,5.31,60,363,2326,9.4,0.19251204
21162,21162,Patrick Sharp,2004-05,23.0,3,7,41,41,5,2,7,44.0,407.0,44,5,2,7,47.0,82,5.14,57,348,2300,9.2,0.305764
21163,21163,Patrick Sharp,2006-07,25.0,4,31,72,72,14,17,31,144.0,986.0,116,19,19,38,191.0,82,6.05,85,480,2458,10.1,0.43702555
21164,21164,Patrick Sharp,2007-08,26.0,5,35,80,80,20,15,35,160.0,1366.0,196,39,34,73,351.0,82,5.76,70,398,2426,9.7,0.44755924
21165,21165,Patrick Sharp,2008-09,27.0,6,62,80,80,36,26,62,209.0,1502.0,276,75,60,135,560.0,82,5.44,62,351,2383,9.4,0.70443076
21166,21166,Patrick Sharp,2009-10,28.0,7,44,61,61,26,18,44,184.0,1095.0,337,101,78,179,744.0,82,5.7,65,341,2477,9.4,0.6585357
21167,21167,Patrick Sharp,2010-11,29.0,8,66,82,82,25,41,66,266.0,1486.0,419,126,119,245,1010.0,82,5.53,56,304,2486,9.1,0.74458456
21168,21168,Patrick Sharp,2011-12,30.0,9,71,74,74,34,37,71,268.0,1437.0,493,160,156,316,1278.0,82,5.46,52,291,2492,9.0,0.8012998
21169,21169,Patrick Sharp,2012-13,31.0,10,69,74,74,33,36,69,282.0,1473.0,567,193,192,385,1560.0,82,5.32,47,271,2439,8.9,0.81428486
21170,21170,Patrick Sharp,2013-14,32.0,11,20,28,28,6,14,20,88.0,527.0,595,199,206,405,1648.0,48,5.31,29,160,1399,9.1,0.6616783
21171,21171,Patrick Sharp,2014-15,33.0,12,78,82,82,34,44,78,313.0,1549.0,677,233,250,483,1961.0,82,5.34,48,269,2463,8.9,0.8078076
21172,21172,Patrick Sharp,2015-16,34.0,13,43,68,68,16,27,43,230.0,1143.0,745,249,277,526,2191.0,82,5.32,47,251,2453,8.9,0.61342335
21173,21173,Patrick Sharp,2016-17,35.0,14,55,76,76,20,35,55,226.0,1339.0,821,269,312,581,2417.0,82,5.34,48,255,2438,9.0,0.61576575
21174,21174,Patrick Sharp,2017-18,36.0,15,18,48,48,8,10,18,146.0,765.0,869,277,322,599,2563.0,82,5.45,47,245,2478,9.0,0.4164849
21175,21175,Patrick Sharp,2018-19,37.0,16,21,70,70,10,11,21,143.0,902.0,939,287,333,620,2706.0,82,5.86,50,250,2620,9.2,0.30751312
21176,21176,Patrick Sieloff,2016-17,22.0,2,1,1,1,1,0,1,1.0,18.0,1,1,0,1,1.0,82,5.34,48,255,2438,9.0,0.2832615
21177,21177,Patrick Sieloff,2018-19,24.0,3,1,1,1,1,0,1,3.0,11.0,2,2,0,2,4.0,82,5.86,50,250,2620,9.2,0.20015779
21178,21178,Patrick Thoresen,2007-08,24.0,2,16,68,68,4,12,16,73.0,777.0,68,4,12,16,73.0,82,5.76,70,398,2426,9.7,0.24336454
21179,21179,Patrick Thoresen,2008-09,25.0,3,8,38,38,2,6,8,39.0,447.0,106,6,18,24,112.0,82,5.44,62,351,2383,9.4,0.2086721
21180,21180,Patrick Traverse,1996-97,22.0,2,0,5,5,0,0,0,2.0,,5,0,0,0,2.0,82,6.29,74,413,2481,10.4,0.16508633
21181,21181,Patrick Traverse,1999-00,25.0,3,10,46,46,1,9,10,35.0,687.0,51,1,9,10,37.0,82,5.27,57,359,2285,9.4,0.17481762
21182,21182,Patrick Traverse,2000-01,26.0,4,23,66,66,6,17,23,73.0,1235.0,117,7,26,33,110.0,82,5.49,53,331,2294,9.8,0.29409724
21183,21183,Patrick Traverse,2001-02,27.0,5,14,71,71,5,9,14,62.0,1286.0,188,12,35,47,172.0,82,5.51,63,376,2272,9.9,0.20551834
21184,21184,Patrick Traverse,2002-03,28.0,6,5,25,25,2,3,5,24.0,456.0,213,14,38,52,196.0,82,5.24,53,338,2262,9.5,0.21388304
21185,21185,Patrick Traverse,2003-04,29.0,7,13,65,65,0,13,13,63.0,1313.0,278,14,51,65,259.0,82,5.31,60,363,2326,9.4,0.15116358
21186,21186,Patrick Traverse,2006-07,32.0,8,0,1,1,0,0,0,1.0,11.0,279,14,51,65,260.0,82,6.05,85,480,2458,10.1,0.18509215
21187,21187,Patrick Wey,2014-15,23.0,2,3,9,9,0,3,3,5.0,131.0,9,0,3,3,5.0,82,5.34,48,269,2463,8.9,0.202393
21188,21188,Patrick Wiercioch,2011-12,21.0,2,2,8,8,0,2,2,3.0,111.0,8,0,2,2,3.0,82,5.46,52,291,2492,9.0,0.24168444
21189,21189,Patrick Wiercioch,2013-14,23.0,3,19,42,42,5,14,19,81.0,659.0,50,5,16,21,84.0,48,5.31,29,160,1399,9.1,0.44335443
21190,21190,Patrick Wiercioch,2014-15,24.0,4,23,53,53,4,19,23,97.0,868.0,103,9,35,44,181.0,82,5.34,48,269,2463,8.9,0.36564615
21191,21191,Patrick Wiercioch,2015-16,25.0,5,13,56,56,3,10,13,79.0,1011.0,159,12,45,57,260.0,82,5.32,47,251,2453,8.9,0.23468298
21192,21192,Patrick Wiercioch,2016-17,26.0,6,5,52,52,0,5,5,56.0,902.0,211,12,50,62,316.0,82,5.34,48,255,2438,9.0,0.1685082
21193,21193,Patrick Wiercioch,2017-18,27.0,7,12,57,57,4,8,12,63.0,950.0,268,16,58,74,379.0,82,5.45,47,245,2478,9.0,0.19437829
21194,21194,Patrik Augusta,1994-95,25.0,2,0,2,2,0,0,0,3.0,,2,0,0,0,3.0,84,6.48,76,407,2545,10.7,0.17292508
21195,21195,Patrik Augusta,1999-00,30.0,3,0,2,2,0,0,0,4.0,27.0,4,0,0,0,7.0,82,5.27,57,359,2285,9.4,0.16303483
21196,21196,Patrik Berglund,2009-10,21.0,2,47,76,76,21,26,47,143.0,1119.0,76,21,26,47,143.0,82,5.7,65,341,2477,9.4,0.6493788
21197,21197,Patrik Berglund,2010-11,22.0,3,26,71,71,13,13,26,129.0,959.0,147,34,39,73,272.0,82,5.53,56,304,2486,9.1,0.4520462
21198,21198,Patrik Berglund,2011-12,23.0,4,52,81,81,22,30,52,175.0,1392.0,228,56,69,125,447.0,82,5.46,52,291,2492,9.0,0.6235718
21199,21199,Patrik Berglund,2012-13,24.0,5,38,82,82,19,19,38,188.0,1473.0,310,75,88,163,635.0,82,5.32,47,271,2439,8.9,0.55309165
21200,21200,Patrik Berglund,2013-14,25.0,6,25,48,48,17,8,25,74.0,808.0,358,92,96,188,709.0,48,5.31,29,160,1399,9.1,0.5602393
21201,21201,Patrik Berglund,2014-15,26.0,7,32,78,78,14,18,32,144.0,1261.0,436,106,114,220,853.0,82,5.34,48,269,2463,8.9,0.45048246
21202,21202,Patrik Berglund,2015-16,27.0,8,27,77,77,12,15,27,145.0,1122.0,513,118,129,247,998.0,82,5.32,47,251,2453,8.9,0.3631869
21203,21203,Patrik Berglund,2016-17,28.0,9,15,42,42,10,5,15,80.0,651.0,555,128,134,262,1078.0,82,5.34,48,255,2438,9.0,0.41668722
21204,21204,Patrik Berglund,2017-18,29.0,10,34,82,82,23,11,34,153.0,1311.0,637,151,145,296,1231.0,82,5.45,47,245,2478,9.0,0.44948226
21205,21205,Patrik Berglund,2018-19,30.0,11,26,57,57,17,9,26,112.0,921.0,694,168,154,322,1343.0,82,5.86,50,250,2620,9.2,0.4170128
21206,21206,Patrik Berglund,2019-20,31.0,12,4,23,23,2,2,4,25.0,300.0,717,170,156,326,1368.0,82,5.96,47,239,2579,9.5,0.2635042
21207,21207,Patrik Carnback,1993-94,25.0,2,0,6,6,0,0,0,4.0,,6,0,0,0,4.0,84,7.25,87,443,2603,11.7,0.21475294
21208,21208,Patrik Carnback,1994-95,26.0,3,23,73,73,12,11,23,81.0,,79,12,11,23,85.0,84,6.48,76,407,2545,10.7,0.31313068
21209,21209,Patrik Carnback,1995-96,27.0,4,21,41,41,6,15,21,58.0,,120,18,26,44,143.0,48,5.97,37,209,1408,10.2,0.4261572
21210,21210,Patrik Carnback,1996-97,28.0,5,18,34,34,6,12,18,54.0,,154,24,38,62,197.0,82,6.29,74,413,2481,10.4,0.38496512
21211,21211,Patrik Elias,1996-97,20.0,2,0,1,1,0,0,0,2.0,,1,0,0,0,2.0,82,6.29,74,413,2481,10.4,0.23215792
21212,21212,Patrik Elias,1997-98,21.0,3,5,17,17,2,3,5,23.0,,18,2,3,5,25.0,82,5.83,55,336,2444,9.8,0.29924318
21213,21213,Patrik Elias,1998-99,22.0,4,37,74,74,18,19,37,147.0,,92,20,22,42,172.0,82,5.28,57,380,2242,9.6,0.54703295
21214,21214,Patrik Elias,1999-00,23.0,5,50,74,74,17,33,50,157.0,1172.0,166,37,55,92,329.0,82,5.27,57,359,2285,9.4,0.63215977
21215,21215,Patrik Elias,2000-01,24.0,6,72,72,72,35,37,72,183.0,1257.0,238,72,92,164,512.0,82,5.49,53,331,2294,9.8,0.9100308
21216,21216,Patrik Elias,2001-02,25.0,7,96,82,82,40,56,96,220.0,1535.0,320,112,148,260,732.0,82,5.51,63,376,2272,9.9,1.0049853
21217,21217,Patrik Elias,2002-03,26.0,8,61,75,75,29,32,61,199.0,1421.0,395,141,180,321,931.0,82,5.24,53,338,2262,9.5,0.7565764
21218,21218,Patrik Elias,2003-04,27.0,9,57,81,81,28,29,57,255.0,1465.0,476,169,209,378,1186.0,82,5.31,60,363,2326,9.4,0.7713431
21219,21219,Patrik Elias,2004-05,28.0,10,81,82,82,38,43,81,300.0,1539.0,558,207,252,459,1486.0,82,5.14,57,348,2300,9.2,1.003169
21220,21220,Patrik Elias,2006-07,30.0,11,45,38,38,16,29,45,142.0,706.0,596,223,281,504,1628.0,82,6.05,85,480,2458,10.1,0.7824744
21221,21221,Patrik Elias,2007-08,31.0,12,69,75,75,21,48,69,267.0,1396.0,671,244,329,573,1895.0,82,5.76,70,398,2426,9.7,0.8005829
21222,21222,Patrik Elias,2008-09,32.0,13,55,74,74,20,35,55,263.0,1367.0,745,264,364,628,2158.0,82,5.44,62,351,2383,9.4,0.7495886
21223,21223,Patrik Elias,2009-10,33.0,14,78,77,77,31,47,78,247.0,1430.0,822,295,411,706,2405.0,82,5.7,65,341,2477,9.4,0.8570256
21224,21224,Patrik Elias,2010-11,34.0,15,48,58,58,19,29,48,145.0,1022.0,880,314,440,754,2550.0,82,5.53,56,304,2486,9.1,0.7095687
21225,21225,Patrik Elias,2011-12,35.0,16,62,81,81,21,41,62,204.0,1510.0,961,335,481,816,2754.0,82,5.46,52,291,2492,9.0,0.64822954
21226,21226,Patrik Elias,2012-13,36.0,17,78,81,81,26,52,78,164.0,1608.0,1042,361,533,894,2918.0,82,5.32,47,271,2439,8.9,0.7577562
21227,21227,Patrik Elias,2013-14,37.0,18,36,48,48,14,22,36,118.0,899.0,1090,375,555,930,3036.0,48,5.31,29,160,1399,9.1,0.69088495
21228,21228,Patrik Elias,2014-15,38.0,19,53,65,65,18,35,53,116.0,1162.0,1155,393,590,983,3152.0,82,5.34,48,269,2463,8.9,0.59154737
21229,21229,Patrik Elias,2015-16,39.0,20,34,69,69,13,21,34,114.0,1217.0,1224,406,611,1017,3266.0,82,5.32,47,251,2453,8.9,0.4340731
21230,21230,Patrik Elias,2016-17,40.0,21,8,16,16,2,6,8,21.0,247.0,1240,408,617,1025,3287.0,82,5.34,48,255,2438,9.0,0.49526146
21231,21231,Patrik Juhlin,1995-96,25.0,2,7,42,42,4,3,7,44.0,,42,4,3,7,44.0,48,5.97,37,209,1408,10.2,0.22030419
21232,21232,Patrik Juhlin,1996-97,26.0,3,6,14,14,3,3,6,14.0,,56,7,6,13,58.0,82,6.29,74,413,2481,10.4,0.2433351
21233,21233,Patrik Laine,2017-18,19.0,2,64,73,73,36,28,64,204.0,1308.0,73,36,28,64,204.0,82,5.45,47,245,2478,9.0,0.8529488
21234,21234,Patrik Laine,2018-19,20.0,3,70,82,82,44,26,70,241.0,1351.0,155,80,54,134,445.0,82,5.86,50,250,2620,9.2,0.8300645
21235,21235,Patrik Laine,2019-20,21.0,4,50,82,82,30,20,50,245.0,1413.0,237,110,74,184,690.0,82,5.96,47,239,2579,9.5,0.78311765
21236,21236,Patrik Laine,2020-21,22.0,5,63,68,68,28,35,63,226.0,1320.0,305,138,109,247,916.0,70,5.96,42,208,2192,9.5,0.97611344
21237,21237,Patrik Nemeth,2014-15,22.0,2,0,8,8,0,0,0,3.0,110.0,8,0,0,0,3.0,82,5.34,48,269,2463,8.9,0.17568615
21238,21238,Patrik Nemeth,2015-16,23.0,3,3,22,22,0,3,3,16.0,357.0,30,0,3,3,19.0,82,5.32,47,251,2453,8.9,0.15870556
21239,21239,Patrik Nemeth,2016-17,24.0,4,8,38,38,0,8,8,36.0,594.0,68,0,11,11,55.0,82,5.34,48,255,2438,9.0,0.14566648
21240,21240,Patrik Nemeth,2017-18,25.0,5,3,40,40,0,3,3,46.0,631.0,108,0,14,14,101.0,82,5.45,47,245,2478,9.0,0.16100803
21241,21241,Patrik Nemeth,2018-19,26.0,6,15,68,68,3,12,15,73.0,1350.0,176,3,26,29,174.0,82,5.86,50,250,2620,9.2,0.18623179
21242,21242,Patrik Nemeth,2019-20,27.0,7,10,74,74,1,9,10,57.0,1220.0,250,4,35,39,231.0,82,5.96,47,239,2579,9.5,0.14359426
21243,21243,Patrik Nemeth,2020-21,28.0,8,9,64,64,1,8,9,89.0,1410.0,314,5,43,48,320.0,70,5.96,42,208,2192,9.5,0.18577674
21244,21244,Patrik Stefan,2000-01,20.0,2,25,72,72,5,20,25,117.0,1067.0,72,5,20,25,117.0,82,5.49,53,331,2294,9.8,0.36937279
21245,21245,Patrik Stefan,2001-02,21.0,3,31,66,66,10,21,31,93.0,932.0,138,15,41,56,210.0,82,5.51,63,376,2272,9.9,0.45062947
21246,21246,Patrik Stefan,2002-03,22.0,4,23,59,59,7,16,23,67.0,942.0,197,22,57,79,277.0,82,5.24,53,338,2262,9.5,0.39969888
21247,21247,Patrik Stefan,2003-04,23.0,5,34,71,71,13,21,34,96.0,1195.0,268,35,78,113,373.0,82,5.31,60,363,2326,9.4,0.52842736
21248,21248,Patrik Stefan,2004-05,24.0,6,40,82,82,14,26,40,110.0,1351.0,350,49,104,153,483.0,82,5.14,57,348,2300,9.2,0.52820736
21249,21249,Patrik Stefan,2006-07,26.0,7,24,64,64,10,14,24,81.0,885.0,414,59,118,177,564.0,82,6.05,85,480,2458,10.1,0.35722148
21250,21250,Patrik Stefan,2007-08,27.0,8,11,41,41,5,6,11,41.0,501.0,455,64,124,188,605.0,82,5.76,70,398,2426,9.7,0.31077224
21251,21251,Patrik Sundstrom,1983-84,22.0,2,46,74,74,23,23,46,156.0,,74,23,23,46,156.0,80,7.73,71,310,2444,12.7,0.704016
21252,21252,Patrik Sundstrom,1984-85,23.0,3,91,78,78,38,53,91,215.0,,152,61,76,137,371.0,80,7.89,74,336,2448,12.9,1.0802194
21253,21253,Patrik Sundstrom,1985-86,24.0,4,68,71,71,25,43,68,186.0,,223,86,119,205,557.0,80,7.77,71,321,2447,12.7,0.89136064
21254,21254,Patrik Sundstrom,1986-87,25.0,5,66,79,79,18,48,66,154.0,,302,104,167,271,711.0,80,7.94,82,370,2484,12.8,0.80668426
21255,21255,Patrik Sundstrom,1987-88,26.0,6,71,72,72,29,42,71,141.0,,374,133,209,342,852.0,80,7.34,72,344,2400,12.2,0.9198632
21256,21256,Patrik Sundstrom,1988-89,27.0,7,51,78,78,15,36,51,126.0,,452,148,245,393,978.0,80,7.43,89,437,2435,12.2,0.7054322
21257,21257,Patrik Sundstrom,1989-90,28.0,8,69,65,65,28,41,69,156.0,,517,176,286,462,1134.0,80,7.48,85,403,2430,12.3,1.0704081
21258,21258,Patrik Sundstrom,1990-91,29.0,9,76,74,74,27,49,76,142.0,,591,203,335,538,1276.0,80,7.37,76,367,2421,12.2,0.8127472
21259,21259,Patrik Sundstrom,1991-92,30.0,10,46,71,71,15,31,46,96.0,,662,218,366,584,1372.0,80,6.91,71,366,2385,11.6,0.55959326
21260,21260,Patrik Sundstrom,1992-93,31.0,11,4,17,17,1,3,4,16.0,,679,219,369,588,1388.0,80,6.96,77,402,2440,11.4,0.49118647
21261,21261,Paul Baxter,1980-81,25.0,2,20,61,61,7,13,20,90.0,,61,7,13,20,90.0,80,7.03,61,280,2352,12.0,0.3302237
21262,21262,Paul Baxter,1981-82,26.0,3,19,51,51,5,14,19,62.0,,112,12,27,39,152.0,80,7.69,77,340,2441,12.6,0.3905305
21263,21263,Paul Baxter,1982-83,27.0,4,43,76,76,9,34,43,177.0,,188,21,61,82,329.0,80,8.03,73,320,2489,12.9,0.4957086
21264,21264,Paul Baxter,1983-84,28.0,5,32,75,75,11,21,32,157.0,,263,32,82,114,486.0,80,7.73,71,310,2444,12.7,0.44953334
21265,21265,Paul Baxter,1984-85,29.0,6,27,74,74,7,20,27,87.0,,337,39,102,141,573.0,80,7.89,74,336,2448,12.9,0.3788429
21266,21266,Paul Baxter,1985-86,30.0,7,19,70,70,5,14,19,83.0,,407,44,116,160,656.0,80,7.77,71,321,2447,12.7,0.30337358
21267,21267,Paul Baxter,1986-87,31.0,8,7,47,47,4,3,7,41.0,,454,48,119,167,697.0,80,7.94,82,370,2484,12.8,0.19245127
21268,21268,Paul Baxter,1987-88,32.0,9,2,18,18,0,2,2,13.0,,472,48,121,169,710.0,80,7.34,72,344,2400,12.2,0.20944262
21269,21269,Paul Beraldo,1988-89,21.0,2,0,3,3,0,0,0,1.0,,3,0,0,0,1.0,80,7.43,89,437,2435,12.2,0.2297807
21270,21270,Paul Beraldo,1989-90,22.0,3,0,7,7,0,0,0,1.0,,10,0,0,0,2.0,80,7.48,85,403,2430,12.3,0.18243748
21271,21271,Paul Bissonnette,2009-10,24.0,2,1,15,15,0,1,1,4.0,53.0,15,0,1,1,4.0,82,5.7,65,341,2477,9.4,0.16033778
21272,21272,Paul Bissonnette,2010-11,25.0,3,5,41,41,3,2,5,25.0,240.0,56,3,3,6,29.0,82,5.53,56,304,2486,9.1,0.13826329
21273,21273,Paul Bissonnette,2011-12,26.0,4,1,48,48,1,0,1,18.0,252.0,104,4,3,7,47.0,82,5.46,52,291,2492,9.0,0.10280886
21274,21274,Paul Bissonnette,2012-13,27.0,5,1,31,31,1,0,1,15.0,188.0,135,5,3,8,62.0,82,5.32,47,271,2439,8.9,0.09829494
21275,21275,Paul Bissonnette,2013-14,28.0,6,6,28,28,0,6,6,13.0,152.0,163,5,9,14,75.0,48,5.31,29,160,1399,9.1,0.11250538
21276,21276,Paul Bissonnette,2014-15,29.0,7,8,39,39,2,6,8,25.0,185.0,202,7,15,22,100.0,82,5.34,48,269,2463,8.9,0.12933496
21277,21277,Paul Boutilier,1982-83,19.0,2,0,1,1,0,0,0,0.0,,1,0,0,0,0.0,80,8.03,73,320,2489,12.9,0.25628674
21278,21278,Paul Boutilier,1983-84,20.0,3,9,29,29,4,5,9,52.0,,30,4,5,9,52.0,80,7.73,71,310,2444,12.7,0.35356456
21279,21279,Paul Boutilier,1984-85,21.0,4,11,28,28,0,11,11,31.0,,58,4,16,20,83.0,80,7.89,74,336,2448,12.9,0.37511653
21280,21280,Paul Boutilier,1985-86,22.0,5,35,78,78,12,23,35,138.0,,136,16,39,55,221.0,80,7.77,71,321,2447,12.7,0.47239262
21281,21281,Paul Boutilier,1986-87,23.0,6,34,77,77,4,30,34,124.0,,213,20,69,89,345.0,80,7.94,82,370,2484,12.8,0.40374514
21282,21282,Paul Boutilier,1987-88,24.0,7,20,62,62,7,13,20,89.0,,275,27,82,109,434.0,80,7.34,72,344,2400,12.2,0.35500127
21283,21283,Paul Boutilier,1988-89,25.0,8,1,10,10,0,1,1,9.0,,285,27,83,110,443.0,80,7.43,89,437,2435,12.2,0.23154464
21284,21284,Paul Boutilier,1989-90,26.0,9,0,3,3,0,0,0,4.0,,288,27,83,110,447.0,80,7.48,85,403,2430,12.3,0.21461022
21285,21285,Paul Broten,1990-91,25.0,2,8,32,32,5,3,8,43.0,,32,5,3,8,43.0,80,7.37,76,367,2421,12.2,0.29378054
21286,21286,Paul Broten,1991-92,26.0,3,10,28,28,4,6,10,34.0,,60,9,9,18,77.0,80,6.91,71,366,2385,11.6,0.32096177
21287,21287,Paul Broten,1992-93,27.0,4,28,74,74,13,15,28,96.0,,134,22,24,46,173.0,80,6.96,77,402,2440,11.4,0.35973936
21288,21288,Paul Broten,1993-94,28.0,5,14,60,60,5,9,14,57.0,,194,27,33,60,230.0,84,7.25,87,443,2603,11.7,0.2428146
21289,21289,Paul Broten,1994-95,29.0,6,24,64,64,12,12,24,76.0,,258,39,45,84,306.0,84,6.48,76,407,2545,10.7,0.2970363
21290,21290,Paul Broten,1995-96,30.0,7,16,47,47,7,9,16,67.0,,305,46,54,100,373.0,48,5.97,37,209,1408,10.2,0.3156722
21291,21291,Paul Broten,1996-97,31.0,8,1,17,17,0,1,1,11.0,,322,46,55,101,384.0,82,6.29,74,413,2481,10.4,0.20024255
21292,21292,Paul Brousseau,1996-97,23.0,2,2,8,8,1,1,2,10.0,,8,1,1,2,10.0,82,6.29,74,413,2481,10.4,0.24459186
21293,21293,Paul Brousseau,1997-98,24.0,3,0,6,6,0,0,0,3.0,,14,1,1,2,13.0,82,5.83,55,336,2444,9.8,0.15387744
21294,21294,Paul Brousseau,1998-99,25.0,4,2,11,11,0,2,2,6.0,,25,1,3,4,19.0,82,5.28,57,380,2242,9.6,0.15992033
21295,21295,Paul Brousseau,2001-02,28.0,5,0,1,1,0,0,0,0.0,2.0,26,1,3,4,19.0,82,5.51,63,376,2272,9.9,0.13776684
21296,21296,Paul Brydges,1987-88,22.0,2,4,15,15,2,2,4,8.0,,15,2,2,4,8.0,80,7.34,72,344,2400,12.2,0.34034616
21297,21297,Paul Byron,2011-12,22.0,2,2,8,8,1,1,2,5.0,88.0,8,1,1,2,5.0,82,5.46,52,291,2492,9.0,0.2214163
21298,21298,Paul Byron,2012-13,23.0,3,5,22,22,3,2,5,13.0,225.0,30,4,3,7,18.0,82,5.32,47,271,2439,8.9,0.24394739
21299,21299,Paul Byron,2013-14,24.0,4,1,4,4,0,1,1,1.0,42.0,34,4,4,8,19.0,48,5.31,29,160,1399,9.1,0.20693967
21300,21300,Paul Byron,2014-15,25.0,5,21,47,47,7,14,21,46.0,679.0,81,11,18,29,65.0,82,5.34,48,269,2463,8.9,0.3218489
21301,21301,Paul Byron,2015-16,26.0,6,19,57,57,6,13,19,62.0,825.0,138,17,31,48,127.0,82,5.32,47,251,2453,8.9,0.26492575
21302,21302,Paul Byron,2016-17,27.0,7,18,62,62,11,7,18,50.0,853.0,200,28,38,66,177.0,82,5.34,48,255,2438,9.0,0.24489024
21303,21303,Paul Byron,2017-18,28.0,8,43,81,81,22,21,43,96.0,1220.0,281,50,59,109,273.0,82,5.45,47,245,2478,9.0,0.4562279
21304,21304,Paul Byron,2018-19,29.0,9,35,82,82,20,15,35,115.0,1322.0,363,70,74,144,388.0,82,5.86,50,250,2620,9.2,0.38577247
21305,21305,Paul Byron,2019-20,30.0,10,31,56,56,15,16,31,94.0,816.0,419,85,90,175,482.0,82,5.96,47,239,2579,9.5,0.4513854
21306,21306,Paul Byron,2020-21,31.0,11,10,29,29,4,6,10,29.0,415.0,448,89,96,185,511.0,70,5.96,42,208,2192,9.5,0.32356977
21307,21307,Paul Carey,2014-15,26.0,2,0,12,12,0,0,0,6.0,77.0,12,0,0,0,6.0,82,5.34,48,269,2463,8.9,0.15866745
21308,21308,Paul Carey,2015-16,27.0,3,1,10,10,0,1,1,5.0,79.0,22,0,1,1,11.0,82,5.32,47,251,2453,8.9,0.15286341
21309,21309,Paul Carey,2016-17,28.0,4,1,4,4,1,0,1,5.0,40.0,26,1,1,2,16.0,82,5.34,48,255,2438,9.0,0.16866583
21310,21310,Paul Carey,2017-18,29.0,5,0,6,6,0,0,0,8.0,63.0,32,1,1,2,24.0,82,5.45,47,245,2478,9.0,0.16188315
21311,21311,Paul Carey,2018-19,30.0,6,14,60,60,7,7,14,51.0,616.0,92,8,8,16,75.0,82,5.86,50,250,2620,9.2,0.1913181
21312,21312,Paul Carey,2019-20,31.0,7,0,7,7,0,0,0,4.0,75.0,99,8,8,16,79.0,82,5.96,47,239,2579,9.5,0.13805914
21313,21313,Paul Carey,2020-21,32.0,8,0,1,1,0,0,0,0.0,6.0,100,8,8,16,79.0,70,5.96,42,208,2192,9.5,0.16581848
21314,21314,Paul Cavallini,1987-88,22.0,2,2,6,6,0,2,2,6.0,,6,0,2,2,6.0,80,7.34,72,344,2400,12.2,0.25923365
21315,21315,Paul Cavallini,1988-89,23.0,3,16,72,72,6,10,16,71.0,,78,6,12,18,77.0,80,7.43,89,437,2435,12.2,0.28444704
21316,21316,Paul Cavallini,1989-90,24.0,4,24,65,65,4,20,24,93.0,,143,10,32,42,170.0,80,7.48,85,403,2430,12.3,0.30211127
21317,21317,Paul Cavallini,1990-91,25.0,5,47,80,80,8,39,47,135.0,,223,18,71,89,305.0,80,7.37,76,367,2421,12.2,0.55361056
21318,21318,Paul Cavallini,1991-92,26.0,6,35,67,67,10,25,35,116.0,,290,28,96,124,421.0,80,6.91,71,366,2385,11.6,0.4675142
21319,21319,Paul Cavallini,1992-93,27.0,7,35,66,66,10,25,35,164.0,,356,38,121,159,585.0,80,6.96,77,402,2440,11.4,0.4868895
21320,21320,Paul Cavallini,1993-94,28.0,8,18,82,82,6,12,18,99.0,,438,44,133,177,684.0,84,7.25,87,443,2603,11.7,0.30100155
21321,21321,Paul Cavallini,1994-95,29.0,9,44,74,74,11,33,44,145.0,,512,55,166,221,829.0,84,6.48,76,407,2545,10.7,0.45513037
21322,21322,Paul Cavallini,1995-96,30.0,10,12,44,44,1,11,12,69.0,,556,56,177,233,898.0,48,5.97,37,209,1408,10.2,0.2489067
21323,21323,Paul Cavallini,1996-97,31.0,11,0,8,8,0,0,0,5.0,,564,56,177,233,903.0,82,6.29,74,413,2481,10.4,0.16347316
21324,21324,Paul Coffey,1981-82,20.0,2,32,74,74,9,23,32,113.0,,74,9,23,32,113.0,80,7.69,77,340,2441,12.6,0.5653657
21325,21325,Paul Coffey,1982-83,21.0,3,89,80,80,29,60,89,234.0,,154,38,83,121,347.0,80,8.03,73,320,2489,12.9,1.1373276
21326,21326,Paul Coffey,1983-84,22.0,4,96,80,80,29,67,96,260.0,,234,67,150,217,607.0,80,7.73,71,310,2444,12.7,1.2924888
21327,21327,Paul Coffey,1984-85,23.0,5,126,80,80,40,86,126,259.0,,314,107,236,343,866.0,80,7.89,74,336,2448,12.9,1.4716692
21328,21328,Paul Coffey,1985-86,24.0,6,121,80,80,37,84,121,285.0,,394,144,320,464,1151.0,80,7.77,71,321,2447,12.7,1.4873514
21329,21329,Paul Coffey,1986-87,25.0,7,138,79,79,48,90,138,308.0,,473,192,410,602,1459.0,80,7.94,82,370,2484,12.8,1.3748703
21330,21330,Paul Coffey,1987-88,26.0,8,67,59,59,17,50,67,165.0,,532,209,460,669,1624.0,80,7.34,72,344,2400,12.2,1.2832906
21331,21331,Paul Coffey,1988-89,27.0,9,67,46,46,15,52,67,193.0,,578,224,512,736,1817.0,80,7.43,89,437,2435,12.2,1.3776596
21332,21332,Paul Coffey,1989-90,28.0,10,113,75,75,30,83,113,342.0,,653,254,595,849,2159.0,80,7.48,85,403,2430,12.3,1.259793
21333,21333,Paul Coffey,1990-91,29.0,11,103,80,80,29,74,103,324.0,,733,283,669,952,2483.0,80,7.37,76,367,2421,12.2,1.198997
21334,21334,Paul Coffey,1991-92,30.0,12,93,76,76,24,69,93,240.0,,809,307,738,1045,2723.0,80,6.91,71,366,2385,11.6,1.1511672
21335,21335,Paul Coffey,1992-93,31.0,13,69,64,64,11,58,69,232.0,,873,318,796,1114,2955.0,80,6.96,77,402,2440,11.4,1.0661571
21336,21336,Paul Coffey,1993-94,32.0,14,87,80,80,12,75,87,254.0,,953,330,871,1201,3209.0,84,7.25,87,443,2603,11.7,1.0166202
21337,21337,Paul Coffey,1994-95,33.0,15,77,80,80,14,63,77,278.0,,1033,344,934,1278,3487.0,84,6.48,76,407,2545,10.7,0.9434601
21338,21338,Paul Coffey,1995-96,34.0,16,58,45,45,14,44,58,181.0,,1078,358,978,1336,3668.0,48,5.97,37,209,1408,10.2,1.1242678
21339,21339,Paul Coffey,1996-97,35.0,17,74,76,76,14,60,74,234.0,,1154,372,1038,1410,3902.0,82,6.29,74,413,2481,10.4,0.7563095
21340,21340,Paul Coffey,1997-98,36.0,18,34,57,57,9,25,34,110.0,,1211,381,1063,1444,4012.0,82,5.83,55,336,2444,9.8,0.52471304
21341,21341,Paul Coffey,1998-99,37.0,19,29,57,57,2,27,29,107.0,,1268,383,1090,1473,4119.0,82,5.28,57,380,2242,9.6,0.385781
21342,21342,Paul Coffey,1999-00,38.0,20,14,54,54,2,12,14,87.0,1020.0,1322,385,1102,1487,4206.0,82,5.27,57,359,2285,9.4,0.39863262
21343,21343,Paul Coffey,2000-01,39.0,21,40,69,69,11,29,40,155.0,1558.0,1391,396,1131,1527,4361.0,82,5.49,53,331,2294,9.8,0.4775881
21344,21344,Paul Coffey,2001-02,40.0,22,4,18,18,0,4,4,28.0,341.0,1409,396,1135,1531,4389.0,82,5.51,63,376,2272,9.9,0.4407968
21345,21345,Paul Comrie,2000-01,23.0,2,3,15,15,1,2,3,11.0,155.0,15,1,2,3,11.0,82,5.49,53,331,2294,9.8,0.21724099
21346,21346,Paul Cyr,1983-84,20.0,2,27,37,37,15,12,27,66.0,,37,15,12,27,66.0,80,7.73,71,310,2444,12.7,0.58048946
21347,21347,Paul Cyr,1984-85,21.0,3,43,71,71,16,27,43,142.0,,108,31,39,70,208.0,80,7.89,74,336,2448,12.9,0.64365304
21348,21348,Paul Cyr,1985-86,22.0,4,46,71,71,22,24,46,170.0,,179,53,63,116,378.0,80,7.77,71,321,2447,12.7,0.6700938
21349,21349,Paul Cyr,1986-87,23.0,5,51,71,71,20,31,51,151.0,,250,73,94,167,529.0,80,7.94,82,370,2484,12.8,0.68446004
21350,21350,Paul Cyr,1987-88,24.0,6,27,73,73,11,16,27,131.0,,323,84,110,194,660.0,80,7.34,72,344,2400,12.2,0.48434505
21351,21351,Paul Cyr,1988-89,25.0,7,19,60,60,5,14,19,92.0,,383,89,124,213,752.0,80,7.43,89,437,2435,12.2,0.3529481
21352,21352,Paul Cyr,1989-90,26.0,8,0,1,1,0,0,0,0.0,,384,89,124,213,752.0,80,7.48,85,403,2430,12.3,0.57692206
21353,21353,Paul Cyr,1991-92,28.0,9,25,70,70,12,13,25,128.0,,454,101,137,238,880.0,80,6.91,71,366,2385,11.6,0.3385465
21354,21354,Paul Cyr,1992-93,29.0,10,3,17,17,0,3,3,20.0,,471,101,140,241,900.0,80,6.96,77,402,2440,11.4,0.30109408
21355,21355,Paul DiPietro,1992-93,22.0,2,10,33,33,4,6,10,27.0,,33,4,6,10,27.0,80,6.96,77,402,2440,11.4,0.33480805
21356,21356,Paul DiPietro,1993-94,23.0,3,17,29,29,4,13,17,43.0,,62,8,19,27,70.0,84,7.25,87,443,2603,11.7,0.39537707
21357,21357,Paul DiPietro,1994-95,24.0,4,33,70,70,13,20,33,115.0,,132,21,39,60,185.0,84,6.48,76,407,2545,10.7,0.4311915
21358,21358,Paul DiPietro,1995-96,25.0,5,11,34,34,5,6,11,60.0,,166,26,45,71,245.0,48,5.97,37,209,1408,10.2,0.35340738
21359,21359,Paul DiPietro,1996-97,26.0,6,8,20,20,4,4,8,23.0,,186,30,49,79,268.0,82,6.29,74,413,2481,10.4,0.2817238
21360,21360,Paul DiPietro,1997-98,27.0,7,1,6,6,1,0,1,10.0,,192,31,49,80,278.0,82,5.83,55,336,2444,9.8,0.26139012
21361,21361,Paul Fenton,1985-86,26.0,2,12,33,33,7,5,12,53.0,,33,7,5,12,53.0,80,7.77,71,321,2447,12.7,0.3404749
21362,21362,Paul Fenton,1986-87,27.0,3,0,1,1,0,0,0,3.0,,34,7,5,12,56.0,80,7.94,82,370,2484,12.8,0.18897092
21363,21363,Paul Fenton,1987-88,28.0,4,0,8,8,0,0,0,11.0,,42,7,5,12,67.0,80,7.34,72,344,2400,12.2,0.18358561
21364,21364,Paul Fenton,1988-89,29.0,5,43,71,71,20,23,43,166.0,,113,27,28,55,233.0,80,7.43,89,437,2435,12.2,0.50111055
21365,21365,Paul Fenton,1989-90,30.0,6,28,80,80,16,12,28,135.0,,193,43,40,83,368.0,80,7.48,85,403,2430,12.3,0.4116505
21366,21366,Paul Fenton,1990-91,31.0,7,50,80,80,32,18,50,152.0,,273,75,58,133,520.0,80,7.37,76,367,2421,12.2,0.5576356
21367,21367,Paul Fenton,1991-92,32.0,8,35,78,78,14,21,35,133.0,,351,89,79,168,653.0,80,6.91,71,366,2385,11.6,0.39496255
21368,21368,Paul Fenton,1992-93,33.0,9,15,60,60,11,4,15,96.0,,411,100,83,183,749.0,80,6.96,77,402,2440,11.4,0.29207432
21369,21369,Paul Gagne,1981-82,19.0,2,41,61,61,25,16,41,99.0,,61,25,16,41,99.0,80,7.69,77,340,2441,12.6,0.6989227
21370,21370,Paul Gagne,1982-83,20.0,3,22,59,59,10,12,22,104.0,,120,35,28,63,203.0,80,8.03,73,320,2489,12.9,0.47364852
21371,21371,Paul Gagne,1983-84,21.0,4,29,53,53,14,15,29,76.0,,173,49,43,92,279.0,80,7.73,71,310,2444,12.7,0.553143
21372,21372,Paul Gagne,1984-85,22.0,5,32,66,66,14,18,32,109.0,,239,63,61,124,388.0,80,7.89,74,336,2448,12.9,0.4856212
21373,21373,Paul Gagne,1985-86,23.0,6,43,79,79,24,19,43,155.0,,318,87,80,167,543.0,80,7.77,71,321,2447,12.7,0.60143334
21374,21374,Paul Gagne,1986-87,24.0,7,38,47,47,19,19,38,91.0,,365,106,99,205,634.0,80,7.94,82,370,2484,12.8,0.61145324
21375,21375,Paul Gagne,1989-90,27.0,8,5,16,16,3,2,5,14.0,,381,109,101,210,648.0,80,7.48,85,403,2430,12.3,0.35814503
21376,21376,Paul Gagne,1990-91,28.0,9,1,9,9,1,0,1,10.0,,390,110,101,211,658.0,80,7.37,76,367,2421,12.2,0.34329224
21377,21377,Paul Gaustad,2003-04,21.0,2,0,1,1,0,0,0,0.0,6.0,1,0,0,0,0.0,82,5.31,60,363,2326,9.4,0.20099464
21378,21378,Paul Gaustad,2006-07,24.0,3,24,78,78,9,15,24,113.0,946.0,79,9,15,24,113.0,82,6.05,85,480,2458,10.1,0.3238623
21379,21379,Paul Gaustad,2007-08,25.0,4,22,54,54,9,13,22,75.0,719.0,133,18,28,46,188.0,82,5.76,70,398,2426,9.7,0.36907542
21380,21380,Paul Gaustad,2008-09,26.0,5,36,82,82,10,26,36,136.0,1407.0,215,28,54,82,324.0,82,5.44,62,351,2383,9.4,0.4466157
21381,21381,Paul Gaustad,2009-10,27.0,6,29,62,62,12,17,29,122.0,999.0,277,40,71,111,446.0,82,5.7,65,341,2477,9.4,0.40020922
21382,21382,Paul Gaustad,2010-11,28.0,7,22,65,65,12,10,22,111.0,1023.0,342,52,81,133,557.0,82,5.53,56,304,2486,9.1,0.33204418
21383,21383,Paul Gaustad,2011-12,29.0,8,31,81,81,12,19,31,117.0,1226.0,423,64,100,164,674.0,82,5.46,52,291,2492,9.0,0.37113857
21384,21384,Paul Gaustad,2012-13,30.0,9,21,70,70,7,14,21,75.0,1034.0,493,71,114,185,749.0,82,5.32,47,271,2439,8.9,0.30145752
21385,21385,Paul Gaustad,2013-14,31.0,10,5,23,23,2,3,5,35.0,350.0,516,73,117,190,784.0,48,5.31,29,160,1399,9.1,0.31719896
21386,21386,Paul Gaustad,2014-15,32.0,11,21,75,75,10,11,21,74.0,1036.0,591,83,128,211,858.0,82,5.34,48,269,2463,8.9,0.2436882
21387,21387,Paul Gaustad,2015-16,33.0,12,14,73,73,4,10,14,54.0,908.0,664,87,138,225,912.0,82,5.32,47,251,2453,8.9,0.16808534
21388,21388,Paul Gaustad,2016-17,34.0,13,6,63,63,2,4,6,46.0,708.0,727,89,142,231,958.0,82,5.34,48,255,2438,9.0,0.14257705
21389,21389,Paul Gillis,1983-84,20.0,2,2,7,7,0,2,2,1.0,,7,0,2,2,1.0,80,7.73,71,310,2444,12.7,0.29814816
21390,21390,Paul Gillis,1984-85,21.0,3,17,57,57,8,9,17,60.0,,64,8,11,19,61.0,80,7.89,74,336,2448,12.9,0.32577735
21391,21391,Paul Gillis,1985-86,22.0,4,42,77,77,14,28,42,104.0,,141,22,39,61,165.0,80,7.77,71,321,2447,12.7,0.5186148
21392,21392,Paul Gillis,1986-87,23.0,5,43,80,80,19,24,43,136.0,,221,41,63,104,301.0,80,7.94,82,370,2484,12.8,0.5507939
21393,21393,Paul Gillis,1987-88,24.0,6,39,76,76,13,26,39,118.0,,297,54,89,143,419.0,80,7.34,72,344,2400,12.2,0.49143928
21394,21394,Paul Gillis,1988-89,25.0,7,17,80,80,7,10,17,82.0,,377,61,99,160,501.0,80,7.43,89,437,2435,12.2,0.3370694
21395,21395,Paul Gillis,1989-90,26.0,8,40,79,79,15,25,40,97.0,,456,76,124,200,598.0,80,7.48,85,403,2430,12.3,0.49688423
21396,21396,Paul Gillis,1990-91,27.0,9,22,71,71,8,14,22,68.0,,527,84,138,222,666.0,80,7.37,76,367,2421,12.2,0.2865146
21397,21397,Paul Gillis,1991-92,28.0,10,16,62,62,3,13,16,66.0,,589,87,151,238,732.0,80,6.91,71,366,2385,11.6,0.28495264
21398,21398,Paul Gillis,1992-93,29.0,11,2,14,14,0,2,2,7.0,,603,87,153,240,739.0,80,6.96,77,402,2440,11.4,0.25899094
21399,21399,Paul Gillis,1993-94,30.0,12,2,21,21,1,1,2,8.0,,624,88,154,242,747.0,84,7.25,87,443,2603,11.7,0.20352384
21400,21400,Paul Guay,1984-85,21.0,2,8,14,14,2,6,8,20.0,,14,2,6,8,20.0,80,7.89,74,336,2448,12.9,0.40545285
21401,21401,Paul Guay,1985-86,22.0,3,1,2,2,0,1,1,2.0,,16,2,7,9,22.0,80,7.77,71,321,2447,12.7,0.25148222
21402,21402,Paul Guay,1986-87,23.0,4,6,23,23,3,3,6,18.0,,39,5,10,15,40.0,80,7.94,82,370,2484,12.8,0.31018603
21403,21403,Paul Guay,1987-88,24.0,5,7,35,35,2,5,7,18.0,,74,7,15,22,58.0,80,7.34,72,344,2400,12.2,0.23618025
21404,21404,Paul Guay,1988-89,25.0,6,8,33,33,4,4,8,42.0,,107,11,19,30,100.0,80,7.43,89,437,2435,12.2,0.29596716
21405,21405,Paul Guay,1989-90,26.0,7,2,7,7,0,2,2,3.0,,114,11,21,32,103.0,80,7.48,85,403,2430,12.3,0.2597186
21406,21406,Paul Guay,1991-92,28.0,8,2,3,3,0,2,2,5.0,,117,11,23,34,108.0,80,6.91,71,366,2385,11.6,0.21205738
21407,21407,Paul Healey,1997-98,22.0,2,0,2,2,0,0,0,0.0,,2,0,0,0,0.0,82,5.83,55,336,2444,9.8,0.157395
21408,21408,Paul Healey,1998-99,23.0,3,0,4,4,0,0,0,0.0,,6,0,0,0,0.0,82,5.28,57,380,2242,9.6,0.14922568
21409,21409,Paul Healey,2002-03,27.0,4,10,21,21,3,7,10,29.0,232.0,27,3,7,10,29.0,82,5.24,53,338,2262,9.5,0.24592945
21410,21410,Paul Healey,2003-04,28.0,5,10,44,44,3,7,10,43.0,528.0,71,6,14,20,72.0,82,5.31,60,363,2326,9.4,0.19153503
21411,21411,Paul Healey,2004-05,29.0,6,0,4,4,0,0,0,0.0,19.0,75,6,14,20,72.0,82,5.14,57,348,2300,9.2,0.18273908
21412,21412,Paul Healey,2006-07,31.0,7,0,2,2,0,0,0,0.0,11.0,77,6,14,20,72.0,82,6.05,85,480,2458,10.1,0.14716882
21413,21413,Paul Higgins,1982-83,21.0,2,0,3,3,0,0,0,0.0,,3,0,0,0,0.0,80,8.03,73,320,2489,12.9,0.2213017
21414,21414,Paul Higgins,1983-84,22.0,3,0,23,23,0,0,0,2.0,,26,0,0,0,2.0,80,7.73,71,310,2444,12.7,0.1354751
21415,21415,Paul Houck,1986-87,23.0,2,1,3,3,1,0,1,3.0,,3,1,0,1,3.0,80,7.94,82,370,2484,12.8,0.26137036
21416,21416,Paul Houck,1987-88,24.0,3,2,12,12,0,2,2,10.0,,15,1,2,3,13.0,80,7.34,72,344,2400,12.2,0.23247474
21417,21417,Paul Houck,1988-89,25.0,4,0,1,1,0,0,0,1.0,,16,1,2,3,14.0,80,7.43,89,437,2435,12.2,0.19017795
21418,21418,Paul Jerrard,1989-90,24.0,2,0,5,5,0,0,0,8.0,,5,0,0,0,8.0,80,7.48,85,403,2430,12.3,0.22017291
21419,21419,Paul Kariya,1995-96,21.0,2,39,47,47,18,21,39,134.0,,47,18,21,39,134.0,48,5.97,37,209,1408,10.2,0.92312884
21420,21420,Paul Kariya,1996-97,22.0,3,108,82,82,50,58,108,349.0,,129,68,79,147,483.0,82,6.29,74,413,2481,10.4,1.2236893
21421,21421,Paul Kariya,1997-98,23.0,4,99,69,69,44,55,99,340.0,,198,112,134,246,823.0,82,5.83,55,336,2444,9.8,1.2694724
21422,21422,Paul Kariya,1998-99,24.0,5,31,22,22,17,14,31,103.0,,220,129,148,277,926.0,82,5.28,57,380,2242,9.6,1.2532101
21423,21423,Paul Kariya,1999-00,25.0,6,101,82,82,39,62,101,429.0,2094.0,302,168,210,378,1355.0,82,5.27,57,359,2285,9.4,1.1136656
21424,21424,Paul Kariya,2000-01,26.0,7,86,74,74,42,44,86,324.0,1803.0,376,210,254,464,1679.0,82,5.49,53,331,2294,9.8,1.1555792
21425,21425,Paul Kariya,2001-02,27.0,8,67,66,66,33,34,67,230.0,1520.0,442,243,288,531,1909.0,82,5.51,63,376,2272,9.9,0.9248564
21426,21426,Paul Kariya,2002-03,28.0,9,57,82,82,32,25,57,289.0,1822.0,524,275,313,588,2198.0,82,5.24,53,338,2262,9.5,0.8120102
21427,21427,Paul Kariya,2003-04,29.0,10,81,82,82,25,56,81,257.0,1664.0,606,300,369,669,2455.0,82,5.31,60,363,2326,9.4,0.91782236
21428,21428,Paul Kariya,2004-05,30.0,11,36,51,51,11,25,36,110.0,950.0,657,311,394,705,2565.0,82,5.14,57,348,2300,9.2,0.7801376
21429,21429,Paul Kariya,2006-07,32.0,12,85,82,82,31,54,85,245.0,1565.0,739,342,448,790,2810.0,82,6.05,85,480,2458,10.1,0.9316404
21430,21430,Paul Kariya,2007-08,33.0,13,76,82,82,24,52,76,224.0,1671.0,821,366,500,866,3034.0,82,5.76,70,398,2426,9.7,0.8572551
21431,21431,Paul Kariya,2008-09,34.0,14,65,82,82,16,49,65,223.0,1536.0,903,382,549,931,3257.0,82,5.44,62,351,2383,9.4,0.8237277
21432,21432,Paul Kariya,2009-10,35.0,15,15,11,11,2,13,15,31.0,199.0,914,384,562,946,3288.0,82,5.7,65,341,2477,9.4,0.52066386
21433,21433,Paul Kariya,2010-11,36.0,16,43,75,75,18,25,43,221.0,1287.0,989,402,587,989,3509.0,82,5.53,56,304,2486,9.1,0.5755594
21434,21434,Paul Kruse,1991-92,21.0,2,0,1,1,0,0,0,0.0,,1,0,0,0,0.0,80,6.91,71,366,2385,11.6,0.21852574
21435,21435,Paul Kruse,1992-93,22.0,3,4,16,16,3,1,4,12.0,,17,3,1,4,12.0,80,6.96,77,402,2440,11.4,0.33196718
21436,21436,Paul Kruse,1993-94,23.0,4,5,27,27,2,3,5,17.0,,44,5,4,9,29.0,84,7.25,87,443,2603,11.7,0.25117445
21437,21437,Paul Kruse,1994-95,24.0,5,11,68,68,3,8,11,52.0,,112,8,12,20,81.0,84,6.48,76,407,2545,10.7,0.19498044
21438,21438,Paul Kruse,1995-96,25.0,6,16,45,45,11,5,16,52.0,,157,19,17,36,133.0,48,5.97,37,209,1408,10.2,0.33286878
21439,21439,Paul Kruse,1996-97,26.0,7,15,75,75,3,12,15,83.0,,232,22,29,51,216.0,82,6.29,74,413,2481,10.4,0.20679793
21440,21440,Paul Kruse,1997-98,27.0,8,8,62,62,6,2,8,49.0,,294,28,31,59,265.0,82,5.83,55,336,2444,9.8,0.15824917
21441,21441,Paul Kruse,1998-99,28.0,9,9,74,74,7,2,9,52.0,,368,35,33,68,317.0,82,5.28,57,380,2242,9.6,0.15469623
21442,21442,Paul Kruse,1999-00,29.0,10,3,43,43,3,0,3,33.0,275.0,411,38,33,71,350.0,82,5.27,57,359,2285,9.4,0.14445102
21443,21443,Paul Kruse,2000-01,30.0,11,0,11,11,0,0,0,7.0,69.0,422,38,33,71,357.0,82,5.49,53,331,2294,9.8,0.13660029
21444,21444,Paul Kruse,2001-02,31.0,12,0,1,1,0,0,0,0.0,4.0,423,38,33,71,357.0,82,5.51,63,376,2272,9.9,0.17763534
21445,21445,Paul Ladue,2017-18,25.0,2,8,22,22,0,8,8,27.0,339.0,22,0,8,8,27.0,82,5.45,47,245,2478,9.0,0.20282543
21446,21446,Paul Ladue,2018-19,26.0,3,4,12,12,3,1,4,13.0,168.0,34,3,9,12,40.0,82,5.86,50,250,2620,9.2,0.23527062
21447,21447,Paul Ladue,2019-20,27.0,4,5,33,33,2,3,5,33.0,436.0,67,5,12,17,73.0,82,5.96,47,239,2579,9.5,0.21625736
21448,21448,Paul Ladue,2020-21,28.0,5,1,2,2,0,1,1,2.0,26.0,69,5,13,18,75.0,70,5.96,42,208,2192,9.5,0.1814751
21449,21449,Paul Laus,1994-95,24.0,2,2,39,39,2,0,2,15.0,,39,2,0,2,15.0,84,6.48,76,407,2545,10.7,0.14769086
21450,21450,Paul Laus,1995-96,25.0,3,7,37,37,0,7,7,18.0,,76,2,7,9,33.0,48,5.97,37,209,1408,10.2,0.1452882
21451,21451,Paul Laus,1996-97,26.0,4,9,78,78,3,6,9,45.0,,154,5,13,18,78.0,82,6.29,74,413,2481,10.4,0.14120376
21452,21452,Paul Laus,1997-98,27.0,5,12,77,77,0,12,12,63.0,,231,5,25,30,141.0,82,5.83,55,336,2444,9.8,0.13185567
21453,21453,Paul Laus,1998-99,28.0,6,11,77,77,0,11,11,64.0,,308,5,36,41,205.0,82,5.28,57,380,2242,9.6,0.14046878
21454,21454,Paul Laus,1999-00,29.0,7,10,75,75,1,9,10,54.0,836.0,383,6,45,51,259.0,82,5.27,57,359,2285,9.4,0.15201327
21455,21455,Paul Laus,2000-01,30.0,8,11,77,77,3,8,11,44.0,586.0,460,9,53,62,303.0,82,5.49,53,331,2294,9.8,0.14409605
21456,21456,Paul Laus,2001-02,31.0,9,3,25,25,1,2,3,18.0,359.0,485,10,55,65,321.0,82,5.51,63,376,2272,9.9,0.13778049
21457,21457,Paul Laus,2002-03,32.0,10,7,45,45,4,3,7,39.0,638.0,530,14,58,72,360.0,82,5.24,53,338,2262,9.5,0.13995561
21458,21458,Paul Lawless,1983-84,19.0,2,15,47,47,6,9,15,85.0,,47,6,9,15,85.0,80,7.73,71,310,2444,12.7,0.4140702
21459,21459,Paul Lawless,1984-85,20.0,3,3,6,6,0,3,3,7.0,,53,6,12,18,92.0,80,7.89,74,336,2448,12.9,0.36082947
21460,21460,Paul Lawless,1986-87,22.0,4,38,64,64,17,21,38,140.0,,117,23,33,56,232.0,80,7.94,82,370,2484,12.8,0.64193606
21461,21461,Paul Lawless,1987-88,23.0,5,54,60,60,22,32,54,161.0,,177,45,65,110,393.0,80,7.34,72,344,2400,12.2,0.7757089
21462,21462,Paul Lawless,1988-89,24.0,6,15,49,49,4,11,15,96.0,,226,49,76,125,489.0,80,7.43,89,437,2435,12.2,0.35935307
21463,21463,Paul Lawless,1989-90,25.0,7,0,7,7,0,0,0,11.0,,233,49,76,125,500.0,80,7.48,85,403,2430,12.3,0.315238
21464,21464,Paul Lawless,1990-91,26.0,8,1,6,6,0,1,1,6.0,,239,49,77,126,506.0,80,7.37,76,367,2421,12.2,0.30593497
21465,21465,Paul MacDermid,1982-83,19.0,2,1,3,3,1,0,1,4.0,,3,1,0,1,4.0,80,8.03,73,320,2489,12.9,0.31482497
21466,21466,Paul MacDermid,1983-84,20.0,3,0,7,7,0,0,0,7.0,,10,1,0,1,11.0,80,7.73,71,310,2444,12.7,0.26265568
21467,21467,Paul MacDermid,1984-85,21.0,4,1,3,3,0,1,1,2.0,,13,1,1,2,13.0,80,7.89,74,336,2448,12.9,0.29315978
21468,21468,Paul MacDermid,1985-86,22.0,5,11,31,31,4,7,11,27.0,,44,5,8,13,40.0,80,7.77,71,321,2447,12.7,0.30350888
21469,21469,Paul MacDermid,1986-87,23.0,6,23,74,74,13,10,23,88.0,,118,18,18,36,128.0,80,7.94,82,370,2484,12.8,0.3590477
21470,21470,Paul MacDermid,1987-88,24.0,7,18,72,72,7,11,18,73.0,,190,25,29,54,201.0,80,7.34,72,344,2400,12.2,0.31580907
21471,21471,Paul MacDermid,1988-89,25.0,8,35,80,80,20,15,35,96.0,,270,45,44,89,297.0,80,7.43,89,437,2435,12.2,0.4190238
21472,21472,Paul MacDermid,1989-90,26.0,9,44,74,74,17,27,44,113.0,,344,62,71,133,410.0,80,7.48,85,403,2430,12.3,0.49583885
21473,21473,Paul MacDermid,1990-91,27.0,10,35,73,73,13,22,35,85.0,,417,75,93,168,495.0,80,7.37,76,367,2421,12.2,0.38119113
21474,21474,Paul MacDermid,1991-92,28.0,11,36,69,69,15,21,36,94.0,,486,90,114,204,589.0,80,6.91,71,366,2385,11.6,0.42134288
21475,21475,Paul MacDermid,1992-93,29.0,12,28,74,74,12,16,28,92.0,,560,102,130,232,681.0,80,6.96,77,402,2440,11.4,0.30735475
21476,21476,Paul MacDermid,1993-94,30.0,13,17,72,72,9,8,17,45.0,,632,111,138,249,726.0,84,7.25,87,443,2603,11.7,0.2217538
21477,21477,Paul MacDermid,1994-95,31.0,14,5,44,44,2,3,5,16.0,,676,113,141,254,742.0,84,6.48,76,407,2545,10.7,0.16317588
21478,21478,Paul MacDermid,1995-96,32.0,15,4,14,14,3,1,4,13.0,,690,116,142,258,755.0,48,5.97,37,209,1408,10.2,0.2961555
21479,21479,Paul MacKinnon,1980-81,22.0,2,12,63,63,1,11,12,68.0,,63,1,11,12,68.0,80,7.03,61,280,2352,12.0,0.22741044
21480,21480,Paul MacKinnon,1981-82,23.0,3,0,14,14,0,0,0,7.0,,77,1,11,12,75.0,80,7.69,77,340,2441,12.6,0.20479983
21481,21481,Paul MacKinnon,1982-83,24.0,4,11,39,39,2,9,11,28.0,,116,3,20,23,103.0,80,8.03,73,320,2489,12.9,0.2633919
21482,21482,Paul MacKinnon,1983-84,25.0,5,4,19,19,2,2,4,10.0,,135,5,22,27,113.0,80,7.73,71,310,2444,12.7,0.220817
21483,21483,Paul MacKinnon,1984-85,26.0,6,1,12,12,0,1,1,3.0,,147,5,23,28,116.0,80,7.89,74,336,2448,12.9,0.18568209
21484,21484,Paul MacLean,1981-82,23.0,2,0,1,1,0,0,0,1.0,,1,0,0,0,1.0,80,7.69,77,340,2441,12.6,0.22857976
21485,21485,Paul MacLean,1982-83,24.0,3,61,74,74,36,25,61,164.0,,75,36,25,61,165.0,80,8.03,73,320,2489,12.9,0.7627244
21486,21486,Paul MacLean,1983-84,25.0,4,76,80,80,32,44,76,164.0,,155,68,69,137,329.0,80,7.73,71,310,2444,12.7,0.8573212
21487,21487,Paul MacLean,1984-85,26.0,5,71,76,76,40,31,71,158.0,,231,108,100,208,487.0,80,7.89,74,336,2448,12.9,0.8911233
21488,21488,Paul MacLean,1985-86,27.0,6,101,79,79,41,60,101,185.0,,310,149,160,309,672.0,80,7.77,71,321,2447,12.7,1.0807194
21489,21489,Paul MacLean,1986-87,28.0,7,56,69,69,27,29,56,169.0,,379,176,189,365,841.0,80,7.94,82,370,2484,12.8,0.7776239
21490,21490,Paul MacLean,1987-88,29.0,8,74,72,72,32,42,74,155.0,,451,208,231,439,996.0,80,7.34,72,344,2400,12.2,0.87946475
21491,21491,Paul MacLean,1988-89,30.0,9,79,77,77,40,39,79,176.0,,528,248,270,518,1172.0,80,7.43,89,437,2435,12.2,0.8734107
21492,21492,Paul MacLean,1989-90,31.0,10,71,76,76,36,35,71,148.0,,604,284,305,589,1320.0,80,7.48,85,403,2430,12.3,0.7798873
21493,21493,Paul MacLean,1990-91,32.0,11,67,78,78,34,33,67,141.0,,682,318,338,656,1461.0,80,7.37,76,367,2421,12.2,0.6906142
21494,21494,Paul MacLean,1991-92,33.0,12,17,37,37,6,11,17,53.0,,719,324,349,673,1514.0,80,6.91,71,366,2385,11.6,0.5338681
21495,21495,Paul Manning,2003-04,24.0,2,0,8,8,0,0,0,4.0,104.0,8,0,0,0,4.0,82,5.31,60,363,2326,9.4,0.16697755
21496,21496,Paul Mara,1999-00,20.0,2,2,1,1,1,1,2,1.0,20.0,1,1,1,2,1.0,82,5.27,57,359,2285,9.4,0.3033602
21497,21497,Paul Mara,2000-01,21.0,3,18,54,54,7,11,18,78.0,1200.0,55,8,12,20,79.0,82,5.49,53,331,2294,9.8,0.39114207
21498,21498,Paul Mara,2001-02,22.0,4,20,62,62,6,14,20,78.0,1373.0,117,14,26,40,157.0,82,5.51,63,376,2272,9.9,0.33406425
21499,21499,Paul Mara,2002-03,23.0,5,24,75,75,7,17,24,112.0,1618.0,192,21,43,64,269.0,82,5.24,53,338,2262,9.5,0.37747845
21500,21500,Paul Mara,2003-04,24.0,6,25,73,73,10,15,25,95.0,1541.0,265,31,58,89,364.0,82,5.31,60,363,2326,9.4,0.36364824
21501,21501,Paul Mara,2004-05,25.0,7,42,81,81,6,36,42,140.0,1913.0,346,37,94,131,504.0,82,5.14,57,348,2300,9.2,0.59694123
21502,21502,Paul Mara,2006-07,27.0,8,47,78,78,15,32,47,157.0,1676.0,424,52,126,178,661.0,82,6.05,85,480,2458,10.1,0.51374894
21503,21503,Paul Mara,2007-08,28.0,9,23,78,78,5,18,23,100.0,1726.0,502,57,144,201,761.0,82,5.76,70,398,2426,9.7,0.31211936
21504,21504,Paul Mara,2008-09,29.0,10,17,61,61,1,16,17,80.0,1091.0,563,58,160,218,841.0,82,5.44,62,351,2383,9.4,0.26709208
21505,21505,Paul Mara,2009-10,30.0,11,21,76,76,5,16,21,102.0,1441.0,639,63,176,239,943.0,82,5.7,65,341,2477,9.4,0.2798893
21506,21506,Paul Mara,2010-11,31.0,12,8,42,42,0,8,8,30.0,787.0,681,63,184,247,973.0,82,5.53,56,304,2486,9.1,0.15366903
21507,21507,Paul Mara,2011-12,32.0,13,6,53,53,1,5,6,50.0,969.0,734,64,189,253,1023.0,82,5.46,52,291,2492,9.0,0.16764966
21508,21508,Paul Marshall,1980-81,20.0,2,21,46,46,9,12,21,68.0,,46,9,12,21,68.0,80,7.03,61,280,2352,12.0,0.435646
21509,21509,Paul Marshall,1981-82,21.0,3,5,26,26,3,2,5,16.0,,72,12,14,26,84.0,80,7.69,77,340,2441,12.6,0.39213613
21510,21510,Paul Marshall,1982-83,22.0,4,4,10,10,2,2,4,14.0,,82,14,16,30,98.0,80,8.03,73,320,2489,12.9,0.3598063
21511,21511,Paul Marshall,1983-84,23.0,5,3,13,13,1,2,3,10.0,,95,15,18,33,108.0,80,7.73,71,310,2444,12.7,0.3179555
21512,21512,Paul Martin,2004-05,23.0,2,24,70,70,6,18,24,82.0,1409.0,70,6,18,24,82.0,82,5.14,57,348,2300,9.2,0.44646618
21513,21513,Paul Martin,2006-07,25.0,3,37,80,80,5,32,37,97.0,1889.0,150,11,50,61,179.0,82,6.05,85,480,2458,10.1,0.4141211
21514,21514,Paul Martin,2007-08,26.0,4,26,82,82,3,23,26,84.0,2068.0,232,14,73,87,263.0,82,5.76,70,398,2426,9.7,0.3337493
21515,21515,Paul Martin,2008-09,27.0,5,32,73,73,5,27,32,93.0,1743.0,305,19,100,119,356.0,82,5.44,62,351,2383,9.4,0.45122492
21516,21516,Paul Martin,2009-10,28.0,6,33,73,73,5,28,33,107.0,1779.0,378,24,128,152,463.0,82,5.7,65,341,2477,9.4,0.4167304
21517,21517,Paul Martin,2010-11,29.0,7,11,22,22,2,9,11,21.0,495.0,400,26,137,163,484.0,82,5.53,56,304,2486,9.1,0.3032974
21518,21518,Paul Martin,2011-12,30.0,8,24,77,77,3,21,24,104.0,1799.0,477,29,158,187,588.0,82,5.46,52,291,2492,9.0,0.29629377
21519,21519,Paul Martin,2012-13,31.0,9,27,73,73,2,25,27,93.0,1679.0,550,31,183,214,681.0,82,5.32,47,271,2439,8.9,0.3214857
21520,21520,Paul Martin,2013-14,32.0,10,23,34,34,6,17,23,38.0,861.0,584,37,200,237,719.0,48,5.31,29,160,1399,9.1,0.44492826
21521,21521,Paul Martin,2014-15,33.0,11,15,39,39,3,12,15,54.0,958.0,623,40,212,252,773.0,82,5.34,48,269,2463,8.9,0.26459807
21522,21522,Paul Martin,2015-16,34.0,12,20,74,74,3,17,20,61.0,1687.0,697,43,229,272,834.0,82,5.32,47,251,2453,8.9,0.23153433
21523,21523,Paul Martin,2016-17,35.0,13,20,78,78,3,17,20,49.0,1617.0,775,46,246,292,883.0,82,5.34,48,255,2438,9.0,0.2146469
21524,21524,Paul Martin,2017-18,36.0,14,26,81,81,4,22,26,57.0,1557.0,856,50,268,318,940.0,82,5.45,47,245,2478,9.0,0.21753025
21525,21525,Paul Martin,2018-19,37.0,15,2,14,14,0,2,2,6.0,207.0,870,50,270,320,946.0,82,5.86,50,250,2620,9.2,0.14049837
21526,21526,Paul Miller,1982-83,23.0,2,3,3,3,0,3,3,0.0,,3,0,3,3,0.0,80,8.03,73,320,2489,12.9,0.25751996
21527,21527,Paul Pooley,1985-86,25.0,2,2,12,12,0,2,2,1.0,,12,0,2,2,1.0,80,7.77,71,321,2447,12.7,0.22920164
21528,21528,Paul Pooley,1986-87,26.0,3,1,3,3,0,1,1,2.0,,15,0,3,3,3.0,80,7.94,82,370,2484,12.8,0.19875956
21529,21529,Paul Postma,2011-12,22.0,2,0,1,1,0,0,0,1.0,10.0,1,0,0,0,1.0,82,5.46,52,291,2492,9.0,0.1675331
21530,21530,Paul Postma,2012-13,23.0,3,0,3,3,0,0,0,3.0,26.0,4,0,0,0,4.0,82,5.32,47,271,2439,8.9,0.16868499
21531,21531,Paul Postma,2013-14,24.0,4,9,34,34,4,5,9,32.0,511.0,38,4,5,9,36.0,48,5.31,29,160,1399,9.1,0.24555293
21532,21532,Paul Postma,2014-15,25.0,5,3,20,20,1,2,3,19.0,323.0,58,5,7,12,55.0,82,5.34,48,269,2463,8.9,0.14673159
21533,21533,Paul Postma,2015-16,26.0,6,6,42,42,2,4,6,40.0,593.0,100,7,11,18,95.0,82,5.32,47,251,2453,8.9,0.1690534
21534,21534,Paul Postma,2016-17,27.0,7,2,26,26,2,0,2,24.0,298.0,126,9,11,20,119.0,82,5.34,48,255,2438,9.0,0.15718472
21535,21535,Paul Postma,2017-18,28.0,8,14,65,65,1,13,14,50.0,706.0,191,10,24,34,169.0,82,5.45,47,245,2478,9.0,0.13230997
21536,21536,Paul Postma,2018-19,29.0,9,1,14,14,0,1,1,14.0,143.0,205,10,25,35,183.0,82,5.86,50,250,2620,9.2,0.15202871
21537,21537,Paul Ranger,2006-07,22.0,2,18,76,76,1,17,18,73.0,1301.0,76,1,17,18,73.0,82,6.05,85,480,2458,10.1,0.27403963
21538,21538,Paul Ranger,2007-08,23.0,3,28,72,72,4,24,28,90.0,1463.0,148,5,41,46,163.0,82,5.76,70,398,2426,9.7,0.37557685
21539,21539,Paul Ranger,2008-09,24.0,4,31,72,72,10,21,31,105.0,1816.0,220,15,62,77,268.0,82,5.44,62,351,2383,9.4,0.43185306
21540,21540,Paul Ranger,2009-10,25.0,5,13,42,42,2,11,13,69.0,1029.0,262,17,73,90,337.0,82,5.7,65,341,2477,9.4,0.2554503
21541,21541,Paul Ranger,2010-11,26.0,6,2,8,8,1,1,2,11.0,163.0,270,18,74,92,348.0,82,5.53,56,304,2486,9.1,0.2348432
21542,21542,Paul Ranger,2014-15,30.0,7,14,53,53,6,8,14,59.0,923.0,323,24,82,106,407.0,82,5.34,48,269,2463,8.9,0.27202022
21543,21543,Paul Ranheim,1989-90,24.0,2,0,5,5,0,0,0,4.0,,5,0,0,0,4.0,80,7.48,85,403,2430,12.3,0.22017291
21544,21544,Paul Ranheim,1990-91,25.0,3,54,80,80,26,28,54,197.0,,85,26,28,54,201.0,80,7.37,76,367,2421,12.2,0.66955733
21545,21545,Paul Ranheim,1991-92,26.0,4,30,39,39,14,16,30,108.0,,124,40,44,84,309.0,80,6.91,71,366,2385,11.6,0.6876797
21546,21546,Paul Ranheim,1992-93,27.0,5,43,80,80,23,20,43,159.0,,204,63,64,127,468.0,80,6.96,77,402,2440,11.4,0.51733536
21547,21547,Paul Ranheim,1993-94,28.0,6,43,83,83,21,22,43,179.0,,287,84,86,170,647.0,84,7.25,87,443,2603,11.7,0.46760875
21548,21548,Paul Ranheim,1994-95,29.0,7,27,82,82,10,17,27,131.0,,369,94,103,197,778.0,84,6.48,76,407,2545,10.7,0.35655856
21549,21549,Paul Ranheim,1995-96,30.0,8,20,47,47,6,14,20,73.0,,416,100,117,217,851.0,48,5.97,37,209,1408,10.2,0.43903816
21550,21550,Paul Ranheim,1996-97,31.0,9,30,73,73,10,20,30,126.0,,489,110,137,247,977.0,82,6.29,74,413,2481,10.4,0.35200664
21551,21551,Paul Ranheim,1997-98,32.0,10,21,67,67,10,11,21,96.0,,556,120,148,268,1073.0,82,5.83,55,336,2444,9.8,0.29487777
21552,21552,Paul Ranheim,1998-99,33.0,11,14,73,73,5,9,14,77.0,,629,125,157,282,1150.0,82,5.28,57,380,2242,9.6,0.21761689
21553,21553,Paul Ranheim,1999-00,34.0,12,19,78,78,9,10,19,67.0,705.0,707,134,167,301,1217.0,82,5.27,57,359,2285,9.4,0.22722095
21554,21554,Paul Ranheim,2000-01,35.0,13,22,79,79,9,13,22,98.0,894.0,786,143,180,323,1315.0,82,5.49,53,331,2294,9.8,0.25092006
21555,21555,Paul Ranheim,2001-02,36.0,14,17,80,80,10,7,17,123.0,1036.0,866,153,187,340,1438.0,82,5.51,63,376,2272,9.9,0.21288899
21556,21556,Paul Ranheim,2002-03,37.0,15,9,79,79,5,4,9,75.0,731.0,945,158,191,349,1513.0,82,5.24,53,338,2262,9.5,0.16311407
21557,21557,Paul Ranheim,2003-04,38.0,16,11,68,68,3,8,11,71.0,813.0,1013,161,199,360,1584.0,82,5.31,60,363,2326,9.4,0.15361741
21558,21558,Paul Reinhart,1980-81,21.0,2,47,79,79,9,38,47,130.0,,79,9,38,47,130.0,80,7.03,61,280,2352,12.0,0.66719526
21559,21559,Paul Reinhart,1981-82,22.0,3,67,74,74,18,49,67,122.0,,153,27,87,114,252.0,80,7.69,77,340,2441,12.6,0.83894217
21560,21560,Paul Reinhart,1982-83,23.0,4,61,62,62,13,48,61,116.0,,215,40,135,175,368.0,80,8.03,73,320,2489,12.9,0.8522054
21561,21561,Paul Reinhart,1983-84,24.0,5,75,78,78,17,58,75,153.0,,293,57,193,250,521.0,80,7.73,71,310,2444,12.7,0.8795474
21562,21562,Paul Reinhart,1984-85,25.0,6,21,27,27,6,15,21,92.0,,320,63,208,271,613.0,80,7.89,74,336,2448,12.9,0.8419528
21563,21563,Paul Reinhart,1985-86,26.0,7,69,75,75,23,46,69,173.0,,395,86,254,340,786.0,80,7.77,71,321,2447,12.7,0.88529015
21564,21564,Paul Reinhart,1986-87,27.0,8,33,32,32,8,25,33,58.0,,427,94,279,373,844.0,80,7.94,82,370,2484,12.8,0.80681854
21565,21565,Paul Reinhart,1987-88,28.0,9,68,76,76,15,53,68,119.0,,503,109,332,441,963.0,80,7.34,72,344,2400,12.2,0.75392485
21566,21566,Paul Reinhart,1988-89,29.0,10,4,14,14,0,4,4,22.0,,517,109,336,445,985.0,80,7.43,89,437,2435,12.2,0.5209357
21567,21567,Paul Reinhart,1989-90,30.0,11,57,64,64,7,50,57,133.0,,581,116,386,502,1118.0,80,7.48,85,403,2430,12.3,0.7826102
21568,21568,Paul Reinhart,1990-91,31.0,12,57,67,67,17,40,57,139.0,,648,133,426,559,1257.0,80,7.37,76,367,2421,12.2,0.7472467
21569,21569,Paul Stanton,1991-92,24.0,2,23,75,75,5,18,23,72.0,,75,5,18,23,72.0,80,6.91,71,366,2385,11.6,0.2914026
21570,21570,Paul Stanton,1992-93,25.0,3,10,54,54,2,8,10,70.0,,129,7,26,33,142.0,80,6.96,77,402,2440,11.4,0.2584206
21571,21571,Paul Stanton,1993-94,26.0,4,16,77,77,4,12,16,106.0,,206,11,38,49,248.0,84,7.25,87,443,2603,11.7,0.24224111
21572,21572,Paul Stanton,1994-95,27.0,5,10,71,71,3,7,10,136.0,,277,14,45,59,384.0,84,6.48,76,407,2545,10.7,0.22597572
21573,21573,Paul Stanton,1995-96,28.0,6,4,18,18,0,4,4,28.0,,295,14,49,63,412.0,48,5.97,37,209,1408,10.2,0.22245848
21574,21574,Paul Stastny,2007-08,22.0,2,78,82,82,28,50,78,185.0,1490.0,82,28,50,78,185.0,82,5.76,70,398,2426,9.7,0.90699625
21575,21575,Paul Stastny,2008-09,23.0,3,71,66,66,24,47,71,138.0,1391.0,148,52,97,149,323.0,82,5.44,62,351,2383,9.4,0.9440248
21576,21576,Paul Stastny,2009-10,24.0,4,36,45,45,11,25,36,118.0,956.0,193,63,122,185,441.0,82,5.7,65,341,2477,9.4,0.7907934
21577,21577,Paul Stastny,2010-11,25.0,5,79,81,81,20,59,79,199.0,1733.0,274,83,181,264,640.0,82,5.53,56,304,2486,9.1,0.8393916
21578,21578,Paul Stastny,2011-12,26.0,6,57,74,74,22,35,57,181.0,1460.0,348,105,216,321,821.0,82,5.46,52,291,2492,9.0,0.70905626
21579,21579,Paul Stastny,2012-13,27.0,7,53,79,79,21,32,53,190.0,1488.0,427,126,248,374,1011.0,82,5.32,47,271,2439,8.9,0.6952258
21580,21580,Paul Stastny,2013-14,28.0,8,24,40,40,9,15,24,87.0,774.0,467,135,263,398,1098.0,48,5.31,29,160,1399,9.1,0.68147683
21581,21581,Paul Stastny,2014-15,29.0,9,60,71,71,25,35,60,150.0,1306.0,538,160,298,458,1248.0,82,5.34,48,269,2463,8.9,0.75238335
21582,21582,Paul Stastny,2015-16,30.0,10,46,74,74,16,30,46,143.0,1304.0,612,176,328,504,1391.0,82,5.32,47,251,2453,8.9,0.55348563
21583,21583,Paul Stastny,2016-17,31.0,11,49,64,64,10,39,49,103.0,1226.0,676,186,367,553,1494.0,82,5.34,48,255,2438,9.0,0.6282649
21584,21584,Paul Stastny,2017-18,32.0,12,40,66,66,18,22,40,112.0,1263.0,742,204,389,593,1606.0,82,5.45,47,245,2478,9.0,0.57576454
21585,21585,Paul Stastny,2018-19,33.0,13,53,82,82,16,37,53,159.0,1501.0,824,220,426,646,1765.0,82,5.86,50,250,2620,9.2,0.66874343
21586,21586,Paul Stastny,2019-20,34.0,14,42,50,50,13,29,42,103.0,905.0,874,233,455,688,1868.0,82,5.96,47,239,2579,9.5,0.65629053
21587,21587,Paul Stastny,2020-21,35.0,15,38,71,71,17,21,38,136.0,1216.0,945,250,476,726,2004.0,70,5.96,42,208,2192,9.5,0.5137999
21588,21588,Paul Stewart,1980-81,26.0,2,2,21,21,2,0,2,9.0,,21,2,0,2,9.0,80,7.03,61,280,2352,12.0,0.256523
21589,21589,Paul Szczechura,2009-10,24.0,2,9,31,31,4,5,9,51.0,420.0,31,4,5,9,51.0,82,5.7,65,341,2477,9.4,0.27513993
21590,21590,Paul Szczechura,2010-11,25.0,3,7,52,52,5,2,7,83.0,681.0,83,9,7,16,134.0,82,5.53,56,304,2486,9.1,0.24586493
21591,21591,Paul Szczechura,2012-13,27.0,4,4,9,9,1,3,4,11.0,103.0,92,10,10,20,145.0,82,5.32,47,271,2439,8.9,0.19712603
21592,21592,Paul Thompson,2016-17,28.0,2,0,3,3,0,0,0,3.0,38.0,3,0,0,0,3.0,82,5.34,48,255,2438,9.0,0.15759674
21593,21593,Paul Thompson,2017-18,29.0,3,3,21,21,0,3,3,19.0,166.0,24,0,3,3,22.0,82,5.45,47,245,2478,9.0,0.13809577
21594,21594,Paul Ysebaert,1989-90,23.0,2,4,5,5,0,4,4,4.0,,5,0,4,4,4.0,80,7.48,85,403,2430,12.3,0.25427067
21595,21595,Paul Ysebaert,1990-91,24.0,3,3,5,5,1,2,3,6.0,,10,1,6,7,10.0,80,7.37,76,367,2421,12.2,0.23608798
21596,21596,Paul Ysebaert,1991-92,25.0,4,40,62,62,19,21,40,128.0,,72,20,27,47,138.0,80,6.91,71,366,2385,11.6,0.5751875
21597,21597,Paul Ysebaert,1992-93,26.0,5,75,79,79,35,40,75,211.0,,151,55,67,122,349.0,80,6.96,77,402,2440,11.4,0.9098705
21598,21598,Paul Ysebaert,1993-94,27.0,6,62,80,80,34,28,62,186.0,,231,89,95,184,535.0,84,7.25,87,443,2603,11.7,0.6395866
21599,21599,Paul Ysebaert,1994-95,28.0,7,35,71,71,14,21,35,151.0,,302,103,116,219,686.0,84,6.48,76,407,2545,10.7,0.49366093
21600,21600,Paul Ysebaert,1995-96,29.0,8,28,44,44,12,16,28,93.0,,346,115,132,247,779.0,48,5.97,37,209,1408,10.2,0.66159916
21601,21601,Paul Ysebaert,1996-97,30.0,9,31,55,55,16,15,31,135.0,,401,131,147,278,914.0,82,6.29,74,413,2481,10.4,0.558974
21602,21602,Paul Ysebaert,1997-98,31.0,10,17,39,39,5,12,17,91.0,,440,136,159,295,1005.0,82,5.83,55,336,2444,9.8,0.40541148
21603,21603,Paul Ysebaert,1998-99,32.0,11,40,82,82,13,27,40,145.0,,522,149,186,335,1150.0,82,5.28,57,380,2242,9.6,0.44828367
21604,21604,Paul Ysebaert,1999-00,33.0,12,1,10,10,0,1,1,10.0,98.0,532,149,187,336,1160.0,82,5.27,57,359,2285,9.4,0.29398513
21605,21605,Pavel Brendl,2002-03,21.0,2,1,8,8,1,0,1,6.0,72.0,8,1,0,1,6.0,82,5.24,53,338,2262,9.5,0.20484716
21606,21606,Pavel Brendl,2003-04,22.0,3,13,50,50,5,8,13,94.0,554.0,58,6,8,14,100.0,82,5.31,60,363,2326,9.4,0.31511495
21607,21607,Pavel Brendl,2004-05,23.0,4,8,18,18,5,3,8,27.0,266.0,76,11,11,22,127.0,82,5.14,57,348,2300,9.2,0.38240665
21608,21608,Pavel Brendl,2006-07,25.0,5,0,2,2,0,0,0,3.0,18.0,78,11,11,22,130.0,82,6.05,85,480,2458,10.1,0.17929822
21609,21609,Pavel Buchnevich,2017-18,22.0,2,20,41,41,8,12,20,55.0,544.0,41,8,12,20,55.0,82,5.45,47,245,2478,9.0,0.41222036
21610,21610,Pavel Buchnevich,2018-19,23.0,3,43,74,74,14,29,43,136.0,1111.0,115,22,41,63,191.0,82,5.86,50,250,2620,9.2,0.5361152
21611,21611,Pavel Buchnevich,2019-20,24.0,4,38,64,64,21,17,38,119.0,971.0,179,43,58,101,310.0,82,5.96,47,239,2579,9.5,0.6013821
21612,21612,Pavel Buchnevich,2020-21,25.0,5,46,68,68,16,30,46,148.0,1151.0,247,59,88,147,458.0,70,5.96,42,208,2192,9.5,0.65085065
21613,21613,Pavel Bure,1992-93,21.0,2,60,65,65,34,26,60,268.0,,65,34,26,60,268.0,80,6.96,77,402,2440,11.4,1.0393424
21614,21614,Pavel Bure,1993-94,22.0,3,110,83,83,60,50,110,407.0,,148,94,76,170,675.0,84,7.25,87,443,2603,11.7,1.1834755
21615,21615,Pavel Bure,1994-95,23.0,4,107,76,76,60,47,107,374.0,,224,154,123,277,1049.0,84,6.48,76,407,2545,10.7,1.1742007
21616,21616,Pavel Bure,1995-96,24.0,5,43,44,44,20,23,43,198.0,,268,174,146,320,1247.0,48,5.97,37,209,1408,10.2,1.0046098
21617,21617,Pavel Bure,1996-97,25.0,6,13,15,15,6,7,13,78.0,,283,180,153,333,1325.0,82,6.29,74,413,2481,10.4,0.74082595
21618,21618,Pavel Bure,1997-98,26.0,7,55,63,63,23,32,55,265.0,,346,203,185,388,1590.0,82,5.83,55,336,2444,9.8,0.8968016
21619,21619,Pavel Bure,1998-99,27.0,8,90,82,82,51,39,90,329.0,,428,254,224,478,1919.0,82,5.28,57,380,2242,9.6,1.0517857
21620,21620,Pavel Bure,1999-00,28.0,9,16,11,11,13,3,16,44.0,239.0,439,267,227,494,1963.0,82,5.27,57,359,2285,9.4,1.1158987
21621,21621,Pavel Bure,2000-01,29.0,10,94,74,74,58,36,94,360.0,1804.0,513,325,263,588,2323.0,82,5.49,53,331,2294,9.8,1.0934484
21622,21622,Pavel Bure,2001-02,30.0,11,92,82,82,59,33,92,384.0,2203.0,595,384,296,680,2707.0,82,5.51,63,376,2272,9.9,0.9773207
21623,21623,Pavel Bure,2002-03,31.0,12,69,68,68,34,35,69,287.0,1701.0,663,418,331,749,2994.0,82,5.24,53,338,2262,9.5,0.9025258
21624,21624,Pavel Bure,2003-04,32.0,13,30,39,39,19,11,30,136.0,739.0,702,437,342,779,3130.0,82,5.31,60,363,2326,9.4,0.73232883
21625,21625,Pavel Datsyuk,2002-03,24.0,2,35,70,70,11,24,35,79.0,955.0,70,11,24,35,79.0,82,5.24,53,338,2262,9.5,0.43731824
21626,21626,Pavel Datsyuk,2003-04,25.0,3,51,64,64,12,39,51,82.0,989.0,134,23,63,86,161.0,82,5.31,60,363,2326,9.4,0.6589656
21627,21627,Pavel Datsyuk,2004-05,26.0,4,68,75,75,30,38,68,136.0,1370.0,209,53,101,154,297.0,82,5.14,57,348,2300,9.2,0.9671562
21628,21628,Pavel Datsyuk,2006-07,28.0,5,87,75,75,28,59,87,145.0,1342.0,284,81,160,241,442.0,82,6.05,85,480,2458,10.1,1.0197098
21629,21629,Pavel Datsyuk,2007-08,29.0,6,87,79,79,27,60,87,207.0,1577.0,363,108,220,328,649.0,82,5.76,70,398,2426,9.7,1.061476
21630,21630,Pavel Datsyuk,2008-09,30.0,7,97,82,82,31,66,97,264.0,1753.0,445,139,286,425,913.0,82,5.44,62,351,2383,9.4,1.0223132
21631,21631,Pavel Datsyuk,2009-10,31.0,8,97,81,81,32,65,97,248.0,1556.0,526,171,351,522,1161.0,82,5.7,65,341,2477,9.4,1.0005382
21632,21632,Pavel Datsyuk,2010-11,32.0,9,70,80,80,27,43,70,203.0,1628.0,606,198,394,592,1364.0,82,5.53,56,304,2486,9.1,0.82184875
21633,21633,Pavel Datsyuk,2011-12,33.0,10,59,56,56,23,36,59,137.0,1082.0,662,221,430,651,1501.0,82,5.46,52,291,2492,9.0,0.9084967
21634,21634,Pavel Datsyuk,2012-13,34.0,11,67,70,70,19,48,67,164.0,1370.0,732,240,478,718,1665.0,82,5.32,47,271,2439,8.9,0.85686606
21635,21635,Pavel Datsyuk,2013-14,35.0,12,49,47,47,15,34,49,107.0,949.0,779,255,512,767,1772.0,48,5.31,29,160,1399,9.1,0.9250521
21636,21636,Pavel Datsyuk,2014-15,36.0,13,37,45,45,17,20,37,126.0,912.0,824,272,532,804,1898.0,82,5.34,48,269,2463,8.9,0.7767476
21637,21637,Pavel Datsyuk,2015-16,37.0,14,65,63,63,26,39,65,165.0,1200.0,887,298,571,869,2063.0,82,5.32,47,251,2453,8.9,0.79918706
21638,21638,Pavel Datsyuk,2016-17,38.0,15,49,66,66,16,33,49,181.0,1297.0,953,314,604,918,2244.0,82,5.34,48,255,2438,9.0,0.6791187
21639,21639,Pavel Kolarik,2001-02,29.0,2,0,10,10,0,0,0,1.0,88.0,10,0,0,0,1.0,82,5.51,63,376,2272,9.9,0.12847137
21640,21640,Pavel Kolarik,2002-03,30.0,3,0,13,13,0,0,0,6.0,88.0,23,0,0,0,7.0,82,5.24,53,338,2262,9.5,0.1484913
21641,21641,Pavel Kubina,1998-99,21.0,2,3,10,10,1,2,3,8.0,,10,1,2,3,8.0,82,5.28,57,380,2242,9.6,0.24075642
21642,21642,Pavel Kubina,1999-00,22.0,3,21,68,68,9,12,21,119.0,1549.0,78,10,14,24,127.0,82,5.27,57,359,2285,9.4,0.37125814
21643,21643,Pavel Kubina,2000-01,23.0,4,26,69,69,8,18,26,128.0,1555.0,147,18,32,50,255.0,82,5.49,53,331,2294,9.8,0.3798266
21644,21644,Pavel Kubina,2001-02,24.0,5,30,70,70,11,19,30,128.0,1687.0,217,29,51,80,383.0,82,5.51,63,376,2272,9.9,0.4230988
21645,21645,Pavel Kubina,2002-03,25.0,6,34,82,82,11,23,34,189.0,1940.0,299,40,74,114,572.0,82,5.24,53,338,2262,9.5,0.46815732
21646,21646,Pavel Kubina,2003-04,26.0,7,22,75,75,3,19,22,139.0,1606.0,374,43,93,136,711.0,82,5.31,60,363,2326,9.4,0.3203218
21647,21647,Pavel Kubina,2004-05,27.0,8,35,81,81,17,18,35,153.0,1713.0,455,60,111,171,864.0,82,5.14,57,348,2300,9.2,0.5525338
21648,21648,Pavel Kubina,2006-07,29.0,9,38,76,76,5,33,38,155.0,1704.0,531,65,144,209,1019.0,82,6.05,85,480,2458,10.1,0.44277892
21649,21649,Pavel Kubina,2007-08,30.0,10,21,61,61,7,14,21,97.0,1300.0,592,72,158,230,1116.0,82,5.76,70,398,2426,9.7,0.32815677
21650,21650,Pavel Kubina,2008-09,31.0,11,40,72,72,11,29,40,136.0,1722.0,664,83,187,270,1252.0,82,5.44,62,351,2383,9.4,0.42916462
21651,21651,Pavel Kubina,2009-10,32.0,12,40,82,82,14,26,40,184.0,1808.0,746,97,213,310,1436.0,82,5.7,65,341,2477,9.4,0.49527302
21652,21652,Pavel Kubina,2010-11,33.0,13,38,76,76,6,32,38,159.0,1720.0,822,103,245,348,1595.0,82,5.53,56,304,2486,9.1,0.42933476
21653,21653,Pavel Kubina,2011-12,34.0,14,23,79,79,4,19,23,78.0,1519.0,901,107,264,371,1673.0,82,5.46,52,291,2492,9.0,0.22275406
21654,21654,Pavel Kubina,2012-13,35.0,15,15,69,69,3,12,15,75.0,1330.0,970,110,276,386,1748.0,82,5.32,47,271,2439,8.9,0.19831648
21655,21655,Pavel Patera,2000-01,29.0,2,5,12,12,1,4,5,18.0,169.0,12,1,4,5,18.0,82,5.49,53,331,2294,9.8,0.24894392
21656,21656,Pavel Patera,2001-02,30.0,3,4,20,20,1,3,4,14.0,289.0,32,2,7,9,32.0,82,5.51,63,376,2272,9.9,0.11318335
21657,21657,Pavel Rosa,1999-00,22.0,2,16,29,29,4,12,16,61.0,393.0,29,4,12,16,61.0,82,5.27,57,359,2285,9.4,0.41950333
21658,21658,Pavel Rosa,2000-01,23.0,3,0,3,3,0,0,0,1.0,34.0,32,4,12,16,62.0,82,5.49,53,331,2294,9.8,0.22595993
21659,21659,Pavel Rosa,2003-04,26.0,4,0,2,2,0,0,0,4.0,28.0,34,4,12,16,66.0,82,5.31,60,363,2326,9.4,0.19750285
21660,21660,Pavel Rosa,2004-05,27.0,5,2,2,2,1,1,2,4.0,25.0,36,5,13,18,70.0,82,5.14,57,348,2300,9.2,0.21155566
21661,21661,Pavel Skrbek,1999-00,21.0,2,0,4,4,0,0,0,1.0,57.0,4,0,0,0,1.0,82,5.27,57,359,2285,9.4,0.18241435
21662,21662,Pavel Skrbek,2001-02,23.0,3,0,5,5,0,0,0,2.0,59.0,9,0,0,0,3.0,82,5.51,63,376,2272,9.9,0.16394505
21663,21663,Pavel Skrbek,2002-03,24.0,4,0,3,3,0,0,0,0.0,31.0,12,0,0,0,3.0,82,5.24,53,338,2262,9.5,0.1439324
21664,21664,Pavel Torgaev,1996-97,31.0,2,16,41,41,6,10,16,50.0,,41,6,10,16,50.0,82,6.29,74,413,2481,10.4,0.3106531
21665,21665,Pavel Torgaev,2000-01,35.0,3,4,14,14,0,4,4,18.0,173.0,55,6,14,20,68.0,82,5.49,53,331,2294,9.8,0.18977109
21666,21666,Pavel Trnka,1998-99,22.0,2,7,48,48,3,4,7,46.0,,48,3,4,7,46.0,82,5.28,57,380,2242,9.6,0.21236205
21667,21667,Pavel Trnka,1999-00,23.0,3,4,63,63,0,4,4,50.0,1014.0,111,3,8,11,96.0,82,5.27,57,359,2285,9.4,0.16647801
21668,21668,Pavel Trnka,2000-01,24.0,4,17,57,57,2,15,17,54.0,1103.0,168,5,23,28,150.0,82,5.49,53,331,2294,9.8,0.22966886
21669,21669,Pavel Trnka,2001-02,25.0,5,8,59,59,1,7,8,59.0,1187.0,227,6,30,36,209.0,82,5.51,63,376,2272,9.9,0.16485643
21670,21670,Pavel Trnka,2002-03,26.0,6,13,71,71,2,11,13,78.0,1211.0,298,8,41,49,287.0,82,5.24,53,338,2262,9.5,0.19849724
21671,21671,Pavel Trnka,2003-04,27.0,7,12,46,46,3,9,12,58.0,767.0,344,11,50,61,345.0,82,5.31,60,363,2326,9.4,0.19630891
21672,21672,Pavel Trnka,2004-05,28.0,8,16,67,67,3,13,16,66.0,1146.0,411,14,63,77,411.0,82,5.14,57,348,2300,9.2,0.21262804
21673,21673,Pavel Vorobiev,2004-05,22.0,2,4,18,18,1,3,4,20.0,230.0,18,1,3,4,20.0,82,5.14,57,348,2300,9.2,0.2919613
21674,21674,Pavel Vorobiev,2006-07,24.0,3,21,39,39,9,12,21,87.0,558.0,57,10,15,25,107.0,82,6.05,85,480,2458,10.1,0.44233385
21675,21675,Pavel Zacha,2016-17,19.0,2,2,1,1,0,2,2,3.0,17.0,1,0,2,2,3.0,82,5.34,48,255,2438,9.0,0.2719143
21676,21676,Pavel Zacha,2017-18,20.0,3,24,70,70,8,16,24,83.0,1002.0,71,8,18,26,86.0,82,5.45,47,245,2478,9.0,0.3940683
21677,21677,Pavel Zacha,2018-19,21.0,4,25,69,69,8,17,25,112.0,992.0,140,16,35,51,198.0,82,5.86,50,250,2620,9.2,0.3923629
21678,21678,Pavel Zacha,2019-20,22.0,5,25,61,61,13,12,25,99.0,981.0,201,29,47,76,297.0,82,5.96,47,239,2579,9.5,0.41742378
21679,21679,Pavel Zacha,2020-21,23.0,6,32,65,65,8,24,32,97.0,1057.0,266,37,71,108,394.0,70,5.96,42,208,2192,9.5,0.48715076
21680,21680,Pavol Demitra,1994-95,20.0,2,2,12,12,1,1,2,10.0,,12,1,1,2,10.0,84,6.48,76,407,2545,10.7,0.27587092
21681,21681,Pavol Demitra,1995-96,21.0,3,7,16,16,4,3,7,21.0,,28,5,4,9,31.0,48,5.97,37,209,1408,10.2,0.3937933
21682,21682,Pavol Demitra,1996-97,22.0,4,17,31,31,7,10,17,66.0,,59,12,14,26,97.0,82,6.29,74,413,2481,10.4,0.42611334
21683,21683,Pavol Demitra,1997-98,23.0,5,3,8,8,3,0,3,15.0,,67,15,14,29,112.0,82,5.83,55,336,2444,9.8,0.298823
21684,21684,Pavol Demitra,1998-99,24.0,6,52,61,61,22,30,52,147.0,,128,37,44,81,259.0,82,5.28,57,380,2242,9.6,0.7493326
21685,21685,Pavol Demitra,1999-00,25.0,7,89,82,82,37,52,89,259.0,1654.0,210,74,96,170,518.0,82,5.27,57,359,2285,9.4,0.9684316
21686,21686,Pavol Demitra,2000-01,26.0,8,75,71,71,28,47,75,241.0,1365.0,281,102,143,245,759.0,82,5.49,53,331,2294,9.8,0.9433076
21687,21687,Pavol Demitra,2001-02,27.0,9,45,44,44,20,25,45,124.0,794.0,325,122,168,290,883.0,82,5.51,63,376,2272,9.9,0.8051058
21688,21688,Pavol Demitra,2002-03,28.0,10,78,82,82,35,43,78,212.0,1573.0,407,157,211,368,1095.0,82,5.24,53,338,2262,9.5,0.8826939
21689,21689,Pavol Demitra,2003-04,29.0,11,93,78,78,36,57,93,205.0,1544.0,485,193,268,461,1300.0,82,5.31,60,363,2326,9.4,1.0095202
21690,21690,Pavol Demitra,2004-05,30.0,12,58,68,68,23,35,58,179.0,1395.0,553,216,303,519,1479.0,82,5.14,57,348,2300,9.2,0.87635565
21691,21691,Pavol Demitra,2006-07,32.0,13,62,58,58,25,37,62,184.0,1222.0,611,241,340,581,1663.0,82,6.05,85,480,2458,10.1,0.87539124
21692,21692,Pavol Demitra,2007-08,33.0,14,64,71,71,25,39,64,175.0,1466.0,682,266,379,645,1838.0,82,5.76,70,398,2426,9.7,0.76879644
21693,21693,Pavol Demitra,2008-09,34.0,15,54,68,68,15,39,54,126.0,1340.0,750,281,418,699,1964.0,82,5.44,62,351,2383,9.4,0.6856417
21694,21694,Pavol Demitra,2009-10,35.0,16,53,69,69,20,33,53,143.0,1206.0,819,301,451,752,2107.0,82,5.7,65,341,2477,9.4,0.627675
21695,21695,Pavol Demitra,2010-11,36.0,17,16,28,28,3,13,16,53.0,454.0,847,304,464,768,2160.0,82,5.53,56,304,2486,9.1,0.45034477
21696,21696,Paxton Schulte,1994-95,22.0,2,0,1,1,0,0,0,0.0,,1,0,0,0,0.0,84,6.48,76,407,2545,10.7,0.16517103
21697,21697,Paxton Schulte,1997-98,25.0,3,0,1,1,0,0,0,1.0,,2,0,0,0,1.0,82,5.83,55,336,2444,9.8,0.1539371
21698,21698,Pekka Rautakallio,1980-81,27.0,2,30,79,79,5,25,30,104.0,,79,5,25,30,104.0,80,7.03,61,280,2352,12.0,0.41267452
21699,21699,Pekka Rautakallio,1981-82,28.0,3,56,76,76,11,45,56,129.0,,155,16,70,86,233.0,80,7.69,77,340,2441,12.6,0.6176872
21700,21700,Pekka Rautakallio,1982-83,29.0,4,68,80,80,17,51,68,176.0,,235,33,121,154,409.0,80,8.03,73,320,2489,12.9,0.7312991
21701,21701,Pelle Eklund,1986-87,23.0,2,66,70,70,15,51,66,141.0,,70,15,51,66,141.0,80,7.94,82,370,2484,12.8,0.8231189
21702,21702,Pelle Eklund,1987-88,24.0,3,55,72,72,14,41,55,127.0,,142,29,92,121,268.0,80,7.34,72,344,2400,12.2,0.7139019
21703,21703,Pelle Eklund,1988-89,25.0,4,42,71,71,10,32,42,101.0,,213,39,124,163,369.0,80,7.43,89,437,2435,12.2,0.62894386
21704,21704,Pelle Eklund,1989-90,26.0,5,69,79,79,18,51,69,121.0,,292,57,175,232,490.0,80,7.48,85,403,2430,12.3,0.82245535
21705,21705,Pelle Eklund,1990-91,27.0,6,62,70,70,23,39,62,126.0,,362,80,214,294,616.0,80,7.37,76,367,2421,12.2,0.79744244
21706,21706,Pelle Eklund,1991-92,28.0,7,69,73,73,19,50,69,131.0,,435,99,264,363,747.0,80,6.91,71,366,2385,11.6,0.8060845
21707,21707,Pelle Eklund,1992-93,29.0,8,23,51,51,7,16,23,74.0,,486,106,280,386,821.0,80,6.96,77,402,2440,11.4,0.50187826
21708,21708,Pelle Eklund,1993-94,30.0,9,49,55,55,11,38,49,82.0,,541,117,318,435,903.0,84,7.25,87,443,2603,11.7,0.65623486
21709,21709,Pelle Eklund,1994-95,31.0,10,20,53,53,3,17,20,53.0,,594,120,335,455,956.0,84,6.48,76,407,2545,10.7,0.3546112
21710,21710,Per Djoos,1991-92,23.0,2,12,26,26,0,12,12,23.0,,26,0,12,12,23.0,80,6.91,71,366,2385,11.6,0.25952238
21711,21711,Per Djoos,1992-93,24.0,3,19,50,50,1,18,19,39.0,,76,1,30,31,62.0,80,6.96,77,402,2440,11.4,0.31553644
21712,21712,Per Djoos,1993-94,25.0,4,2,6,6,1,1,2,4.0,,82,2,31,33,66.0,84,7.25,87,443,2603,11.7,0.21619192
21713,21713,Per Gustafsson,1997-98,27.0,2,29,58,58,7,22,29,105.0,,58,7,22,29,105.0,82,5.83,55,336,2444,9.8,0.4191959
21714,21714,Per Gustafsson,1998-99,28.0,3,6,31,31,1,5,6,36.0,,89,8,27,35,141.0,82,5.28,57,380,2242,9.6,0.21511117
21715,21715,Per Ledin,2009-10,31.0,2,0,3,3,0,0,0,2.0,30.0,3,0,0,0,2.0,82,5.7,65,341,2477,9.4,0.16293341
21716,21716,Per Svartvadet,2000-01,25.0,2,7,38,38,3,4,7,36.0,509.0,38,3,4,7,36.0,82,5.49,53,331,2294,9.8,0.19582728
21717,21717,Per Svartvadet,2001-02,26.0,3,21,69,69,10,11,21,98.0,1015.0,107,13,15,28,134.0,82,5.51,63,376,2272,9.9,0.2932334
21718,21718,Per Svartvadet,2002-03,27.0,4,15,78,78,3,12,15,80.0,1043.0,185,16,27,43,214.0,82,5.24,53,338,2262,9.5,0.18403557
21719,21719,Per Svartvadet,2003-04,28.0,5,8,62,62,1,7,8,47.0,730.0,247,17,34,51,261.0,82,5.31,60,363,2326,9.4,0.16092804
21720,21720,Perry Anderson,1982-83,21.0,2,3,5,5,1,2,3,9.0,,5,1,2,3,9.0,80,8.03,73,320,2489,12.9,0.3538875
21721,21721,Perry Anderson,1983-84,22.0,3,7,18,18,5,2,7,26.0,,23,6,4,10,35.0,80,7.73,71,310,2444,12.7,0.39784205
21722,21722,Perry Anderson,1984-85,23.0,4,12,50,50,7,5,12,49.0,,73,13,9,22,84.0,80,7.89,74,336,2448,12.9,0.33993635
21723,21723,Perry Anderson,1985-86,24.0,5,18,71,71,9,9,18,84.0,,144,22,18,40,168.0,80,7.77,71,321,2447,12.7,0.31168044
21724,21724,Perry Anderson,1986-87,25.0,6,19,51,51,7,12,19,61.0,,195,29,30,59,229.0,80,7.94,82,370,2484,12.8,0.36573917
21725,21725,Perry Anderson,1987-88,26.0,7,19,57,57,10,9,19,46.0,,252,39,39,78,275.0,80,7.34,72,344,2400,12.2,0.3129471
21726,21726,Perry Anderson,1988-89,27.0,8,10,60,60,4,6,10,40.0,,312,43,45,88,315.0,80,7.43,89,437,2435,12.2,0.22725642
21727,21727,Perry Anderson,1989-90,28.0,9,9,39,39,3,6,9,36.0,,351,46,51,97,351.0,80,7.48,85,403,2430,12.3,0.20128909
21728,21728,Perry Anderson,1991-92,30.0,10,0,1,1,0,0,0,1.0,,352,46,51,97,352.0,80,6.91,71,366,2385,11.6,0.2315416
21729,21729,Perry Anderson,1992-93,31.0,11,12,48,48,4,8,12,57.0,,400,50,59,109,409.0,80,6.96,77,402,2440,11.4,0.21929985
21730,21730,Perry Berezan,1985-86,21.0,2,5,9,9,3,2,5,13.0,,9,3,2,5,13.0,80,7.77,71,321,2447,12.7,0.39921507
21731,21731,Perry Berezan,1986-87,22.0,3,33,55,55,12,21,33,117.0,,64,15,23,38,130.0,80,7.94,82,370,2484,12.8,0.57777494
21732,21732,Perry Berezan,1987-88,23.0,4,8,24,24,5,3,8,31.0,,88,20,26,46,161.0,80,7.34,72,344,2400,12.2,0.41690335
21733,21733,Perry Berezan,1988-89,24.0,5,19,29,29,7,12,19,69.0,,117,27,38,65,230.0,80,7.43,89,437,2435,12.2,0.4738579
21734,21734,Perry Berezan,1989-90,25.0,6,13,51,51,5,8,13,65.0,,168,32,46,78,295.0,80,7.48,85,403,2430,12.3,0.33368325
21735,21735,Perry Berezan,1990-91,26.0,7,15,64,64,3,12,15,75.0,,232,35,58,93,370.0,80,7.37,76,367,2421,12.2,0.28153473
21736,21736,Perry Berezan,1991-92,27.0,8,17,52,52,11,6,17,73.0,,284,46,64,110,443.0,80,6.91,71,366,2385,11.6,0.34890008
21737,21737,Perry Berezan,1992-93,28.0,9,19,66,66,12,7,19,112.0,,350,58,71,129,555.0,80,6.96,77,402,2440,11.4,0.3057319
21738,21738,Perry Berezan,1993-94,29.0,10,7,28,28,3,4,7,37.0,,378,61,75,136,592.0,84,7.25,87,443,2603,11.7,0.29010248
21739,21739,Perry Ganchar,1984-85,21.0,2,0,1,1,0,0,0,0.0,,1,0,0,0,0.0,80,7.89,74,336,2448,12.9,0.22589162
21740,21740,Perry Ganchar,1985-86,22.0,3,2,7,7,0,2,2,4.0,,8,0,2,2,4.0,80,7.77,71,321,2447,12.7,0.23666027
21741,21741,Perry Ganchar,1988-89,25.0,4,8,31,31,3,5,8,35.0,,39,3,7,10,39.0,80,7.43,89,437,2435,12.2,0.25766325
21742,21742,Perry Ganchar,1989-90,26.0,5,0,3,3,0,0,0,3.0,,42,3,7,10,42.0,80,7.48,85,403,2430,12.3,0.18558946
21743,21743,Perry Pelensky,1984-85,22.0,2,0,4,4,0,0,0,4.0,,4,0,0,0,4.0,80,7.89,74,336,2448,12.9,0.24830586
21744,21744,Perry Turnbull,1980-81,21.0,2,35,80,80,16,19,35,139.0,,80,16,19,35,139.0,80,7.03,61,280,2352,12.0,0.5721147
21745,21745,Perry Turnbull,1981-82,22.0,3,56,75,75,34,22,56,209.0,,155,50,41,91,348.0,80,7.69,77,340,2441,12.6,0.8093624
21746,21746,Perry Turnbull,1982-83,23.0,4,59,79,79,33,26,59,215.0,,234,83,67,150,563.0,80,8.03,73,320,2489,12.9,0.7424625
21747,21747,Perry Turnbull,1983-84,24.0,5,47,79,79,32,15,47,206.0,,313,115,82,197,769.0,80,7.73,71,310,2444,12.7,0.7052021
21748,21748,Perry Turnbull,1984-85,25.0,6,35,72,72,20,15,35,153.0,,385,135,97,232,922.0,80,7.89,74,336,2448,12.9,0.5841236
21749,21749,Perry Turnbull,1985-86,26.0,7,43,66,66,22,21,43,138.0,,451,157,118,275,1060.0,80,7.77,71,321,2447,12.7,0.70291984
21750,21750,Perry Turnbull,1986-87,27.0,8,51,80,80,20,31,51,167.0,,531,177,149,326,1227.0,80,7.94,82,370,2484,12.8,0.5683855
21751,21751,Perry Turnbull,1987-88,28.0,9,6,26,26,1,5,6,29.0,,557,178,154,332,1256.0,80,7.34,72,344,2400,12.2,0.404088
21752,21752,Perry Turnbull,1988-89,29.0,10,19,51,51,10,9,19,62.0,,608,188,163,351,1318.0,80,7.43,89,437,2435,12.2,0.3892453
21753,21753,Perttu Lindgren,2010-11,23.0,2,0,1,1,0,0,0,0.0,9.0,1,0,0,0,0.0,82,5.53,56,304,2486,9.1,0.1638569
21754,21754,Peter Ahola,1992-93,24.0,2,19,71,71,7,12,19,74.0,,71,7,12,19,74.0,80,6.96,77,402,2440,11.4,0.31655937
21755,21755,Peter Ahola,1993-94,25.0,3,8,50,50,3,5,8,40.0,,121,10,17,27,114.0,84,7.25,87,443,2603,11.7,0.17865413
21756,21756,Peter Ahola,1994-95,26.0,4,0,2,2,0,0,0,1.0,,123,10,17,27,115.0,84,6.48,76,407,2545,10.7,0.15076232
21757,21757,Peter Allen,1996-97,26.0,2,0,8,8,0,0,0,2.0,,8,0,0,0,2.0,82,6.29,74,413,2481,10.4,0.15552464
21758,21758,Peter Ambroziak,1995-96,24.0,2,1,12,12,0,1,1,3.0,,12,0,1,1,3.0,48,5.97,37,209,1408,10.2,0.2018306
21759,21759,Peter Andersson,1984-85,22.0,2,10,42,42,3,7,10,49.0,,42,3,7,10,49.0,80,7.89,74,336,2448,12.9,0.29153997
21760,21760,Peter Andersson,1985-86,23.0,3,10,57,57,0,10,10,61.0,,99,3,17,20,110.0,80,7.77,71,321,2447,12.7,0.2455082
21761,21761,Peter Andersson,1986-87,24.0,4,31,73,73,7,24,31,100.0,,172,10,41,51,210.0,80,7.94,82,370,2484,12.8,0.40855327
21762,21762,Peter Andersson0,1993-94,28.0,2,15,31,31,4,11,15,68.0,,31,4,11,15,68.0,84,7.25,87,443,2603,11.7,0.3141904
21763,21763,Peter Andersson0,1994-95,29.0,3,4,16,16,2,2,4,21.0,,47,6,13,19,89.0,84,6.48,76,407,2545,10.7,0.21853289
21764,21764,Peter Bakovic,1988-89,24.0,2,2,10,10,2,0,2,7.0,,10,2,0,2,7.0,80,7.43,89,437,2435,12.2,0.30269134
21765,21765,Peter Bartos,2001-02,28.0,2,6,13,13,4,2,6,18.0,180.0,13,4,2,6,18.0,82,5.51,63,376,2272,9.9,0.23810667
21766,21766,Peter Bondra,1991-92,23.0,2,28,54,54,12,16,28,95.0,,54,12,16,28,95.0,80,6.91,71,366,2385,11.6,0.52392614
21767,21767,Peter Bondra,1992-93,24.0,3,56,71,71,28,28,56,158.0,,125,40,44,84,253.0,80,6.96,77,402,2440,11.4,0.77565086
21768,21768,Peter Bondra,1993-94,25.0,4,85,83,83,37,48,85,239.0,,208,77,92,169,492.0,84,7.25,87,443,2603,11.7,0.87052846
21769,21769,Peter Bondra,1994-95,26.0,5,43,69,69,24,19,43,200.0,,277,101,111,212,692.0,84,6.48,76,407,2545,10.7,0.7379706
21770,21770,Peter Bondra,1995-96,27.0,6,43,47,47,34,9,43,177.0,,324,135,120,255,869.0,48,5.97,37,209,1408,10.2,0.9018374
21771,21771,Peter Bondra,1996-97,28.0,7,80,67,67,52,28,80,322.0,,391,187,148,335,1191.0,82,6.29,74,413,2481,10.4,0.8602618
21772,21772,Peter Bondra,1997-98,29.0,8,77,77,77,46,31,77,314.0,,468,233,179,412,1505.0,82,5.83,55,336,2444,9.8,0.8657887
21773,21773,Peter Bondra,1998-99,30.0,9,78,76,76,52,26,78,284.0,,544,285,205,490,1789.0,82,5.28,57,380,2242,9.6,0.9267972
21774,21774,Peter Bondra,1999-00,31.0,10,55,66,66,31,24,55,284.0,1359.0,610,316,229,545,2073.0,82,5.27,57,359,2285,9.4,0.74960995
21775,21775,Peter Bondra,2000-01,32.0,11,38,62,62,21,17,38,187.0,1166.0,672,337,246,583,2260.0,82,5.49,53,331,2294,9.8,0.6714995
21776,21776,Peter Bondra,2001-02,33.0,12,81,82,82,45,36,81,305.0,1705.0,754,382,282,664,2565.0,82,5.51,63,376,2272,9.9,0.8774414
21777,21777,Peter Bondra,2002-03,34.0,13,70,77,77,39,31,70,333.0,1672.0,831,421,313,734,2898.0,82,5.24,53,338,2262,9.5,0.8036301
21778,21778,Peter Bondra,2003-04,35.0,14,56,76,76,30,26,56,256.0,1436.0,907,451,339,790,3154.0,82,5.31,60,363,2326,9.4,0.6400143
21779,21779,Peter Bondra,2004-05,36.0,15,49,77,77,26,23,49,188.0,1433.0,984,477,362,839,3342.0,82,5.14,57,348,2300,9.2,0.68155074
21780,21780,Peter Bondra,2006-07,38.0,16,39,60,60,21,18,39,143.0,956.0,1044,498,380,878,3485.0,82,6.05,85,480,2458,10.1,0.55165356
21781,21781,Peter Bondra,2007-08,39.0,17,14,37,37,5,9,14,46.0,445.0,1081,503,389,892,3531.0,82,5.76,70,398,2426,9.7,0.3660043
21782,21782,Peter Cehlarik,2017-18,22.0,2,2,11,11,0,2,2,8.0,153.0,11,0,2,2,8.0,82,5.45,47,245,2478,9.0,0.19278565
21783,21783,Peter Cehlarik,2018-19,23.0,3,2,6,6,1,1,2,3.0,84.0,17,1,3,4,11.0,82,5.86,50,250,2620,9.2,0.2041539
21784,21784,Peter Cehlarik,2019-20,24.0,4,6,20,20,4,2,6,30.0,252.0,37,5,5,10,41.0,82,5.96,47,239,2579,9.5,0.25443202
21785,21785,Peter Cehlarik,2020-21,25.0,5,1,3,3,0,1,1,0.0,34.0,40,5,6,11,41.0,70,5.96,42,208,2192,9.5,0.18479446
21786,21786,Peter Ciavaglia,1992-93,23.0,2,0,2,2,0,0,0,1.0,,2,0,0,0,1.0,80,6.96,77,402,2440,11.4,0.21528733
21787,21787,Peter Ciavaglia,1993-94,24.0,3,0,3,3,0,0,0,2.0,,5,0,0,0,3.0,84,7.25,87,443,2603,11.7,0.20231736
21788,21788,Peter Dineen,1987-88,27.0,2,2,11,11,0,2,2,5.0,,11,0,2,2,5.0,80,7.34,72,344,2400,12.2,0.23368162
21789,21789,Peter Dineen,1990-91,30.0,3,0,2,2,0,0,0,0.0,,13,0,2,2,5.0,80,7.37,76,367,2421,12.2,0.17174393
21790,21790,Peter Douris,1986-87,20.0,2,0,11,11,0,0,0,0.0,,11,0,0,0,0.0,80,7.94,82,370,2484,12.8,0.19405687
21791,21791,Peter Douris,1987-88,21.0,3,0,6,6,0,0,0,3.0,,17,0,0,0,3.0,80,7.34,72,344,2400,12.2,0.21135387
21792,21792,Peter Douris,1988-89,22.0,4,2,4,4,0,2,2,2.0,,21,0,2,2,5.0,80,7.43,89,437,2435,12.2,0.23419502
21793,21793,Peter Douris,1990-91,24.0,5,11,36,36,5,6,11,63.0,,57,5,8,13,68.0,80,7.37,76,367,2421,12.2,0.27392477
21794,21794,Peter Douris,1991-92,25.0,6,7,39,39,5,2,7,46.0,,96,10,10,20,114.0,80,6.91,71,366,2385,11.6,0.23994035
21795,21795,Peter Douris,1992-93,26.0,7,23,54,54,10,13,23,107.0,,150,20,23,43,221.0,80,6.96,77,402,2440,11.4,0.37630197
21796,21796,Peter Douris,1993-94,27.0,8,8,19,19,4,4,8,33.0,,169,24,27,51,254.0,84,7.25,87,443,2603,11.7,0.28318375
21797,21797,Peter Douris,1994-95,28.0,9,34,74,74,12,22,34,142.0,,243,36,49,85,396.0,84,6.48,76,407,2545,10.7,0.39138624
21798,21798,Peter Douris,1995-96,29.0,10,21,46,46,10,11,21,69.0,,289,46,60,106,465.0,48,5.97,37,209,1408,10.2,0.37093693
21799,21799,Peter Douris,1996-97,30.0,11,15,31,31,8,7,15,45.0,,320,54,67,121,510.0,82,6.29,74,413,2481,10.4,0.27614287
21800,21800,Peter Douris,1998-99,32.0,12,0,1,1,0,0,0,3.0,,321,54,67,121,513.0,82,5.28,57,380,2242,9.6,0.21496588
21801,21801,Peter Driscoll,1980-81,26.0,2,6,39,39,1,5,6,23.0,,39,1,5,6,23.0,80,7.03,61,280,2352,12.0,0.1887047
21802,21802,Peter Driscoll,1981-82,27.0,3,5,21,21,2,3,5,17.0,,60,3,8,11,40.0,80,7.69,77,340,2441,12.6,0.23573497
21803,21803,Peter Eriksson,1990-91,25.0,2,6,20,20,3,3,6,23.0,,20,3,3,6,23.0,80,7.37,76,367,2421,12.2,0.3208734
21804,21804,Peter Ferraro,1996-97,24.0,2,1,5,5,0,1,1,6.0,,5,0,1,1,6.0,82,6.29,74,413,2481,10.4,0.18681282
21805,21805,Peter Ferraro,1997-98,25.0,3,0,2,2,0,0,0,3.0,,7,0,1,1,9.0,82,5.83,55,336,2444,9.8,0.1596331
21806,21806,Peter Ferraro,1998-99,26.0,4,7,30,30,3,4,7,37.0,,37,3,5,8,46.0,82,5.28,57,380,2242,9.6,0.21426374
21807,21807,Peter Ferraro,1999-00,27.0,5,14,46,46,6,8,14,61.0,469.0,83,9,13,22,107.0,82,5.27,57,359,2285,9.4,0.26357728
21808,21808,Peter Ferraro,2000-01,28.0,6,1,5,5,0,1,1,3.0,41.0,88,9,14,23,110.0,82,5.49,53,331,2294,9.8,0.15782505
21809,21809,Peter Ferraro,2002-03,30.0,7,1,4,4,0,1,1,3.0,52.0,92,9,15,24,113.0,82,5.24,53,338,2262,9.5,0.15826169
21810,21810,Peter Fiorentino,1992-93,24.0,2,0,1,1,0,0,0,2.0,,1,0,0,0,2.0,80,6.96,77,402,2440,11.4,0.21249864
21811,21811,Peter Forsberg,1995-96,22.0,2,50,47,47,15,35,50,86.0,,47,15,35,50,86.0,48,5.97,37,209,1408,10.2,1.0766156
21812,21812,Peter Forsberg,1996-97,23.0,3,116,82,82,30,86,116,217.0,,129,45,121,166,303.0,82,6.29,74,413,2481,10.4,1.2607613
21813,21813,Peter Forsberg,1997-98,24.0,4,86,65,65,28,58,86,188.0,,194,73,179,252,491.0,82,5.83,55,336,2444,9.8,1.2526911
21814,21814,Peter Forsberg,1998-99,25.0,5,91,72,72,25,66,91,202.0,,266,98,245,343,693.0,82,5.28,57,380,2242,9.6,1.1664243
21815,21815,Peter Forsberg,1999-00,26.0,6,97,78,78,30,67,97,217.0,1832.0,344,128,312,440,910.0,82,5.27,57,359,2285,9.4,1.101244
21816,21816,Peter Forsberg,2000-01,27.0,7,51,49,49,14,37,51,105.0,1025.0,393,142,349,491,1015.0,82,5.49,53,331,2294,9.8,1.072478
21817,21817,Peter Forsberg,2001-02,28.0,8,89,73,73,27,62,89,178.0,1518.0,466,169,411,580,1193.0,82,5.51,63,376,2272,9.9,1.0839926
21818,21818,Peter Forsberg,2003-04,30.0,9,106,75,75,29,77,106,166.0,1450.0,541,198,488,686,1359.0,82,5.31,60,363,2326,9.4,1.2612746
21819,21819,Peter Forsberg,2004-05,31.0,10,55,39,39,18,37,55,85.0,749.0,580,216,525,741,1444.0,82,5.14,57,348,2300,9.2,1.1909943
21820,21820,Peter Forsberg,2006-07,33.0,11,75,60,60,19,56,75,132.0,1127.0,640,235,581,816,1576.0,82,6.05,85,480,2458,10.1,1.0170414
21821,21821,Peter Forsberg,2007-08,34.0,12,55,57,57,13,42,55,99.0,1043.0,697,248,623,871,1675.0,82,5.76,70,398,2426,9.7,0.9768561
21822,21822,Peter Forsberg,2008-09,35.0,13,14,9,9,1,13,14,15.0,173.0,706,249,636,885,1690.0,82,5.44,62,351,2383,9.4,0.41993546
21823,21823,Peter Forsberg,2011-12,38.0,14,0,2,2,0,0,0,3.0,35.0,708,249,636,885,1693.0,82,5.46,52,291,2492,9.0,0.36291435
21824,21824,Peter Gustavsson,1982-83,24.0,2,0,2,2,0,0,0,2.0,,2,0,0,0,2.0,80,8.03,73,320,2489,12.9,0.22581163
21825,21825,Peter Harrold,2007-08,24.0,2,2,12,12,0,2,2,11.0,182.0,12,0,2,2,11.0,82,5.76,70,398,2426,9.7,0.19651598
21826,21826,Peter Harrold,2008-09,25.0,3,5,25,25,2,3,5,16.0,410.0,37,2,5,7,27.0,82,5.44,62,351,2383,9.4,0.19084921
21827,21827,Peter Harrold,2009-10,26.0,4,12,69,69,4,8,12,95.0,909.0,106,6,13,19,122.0,82,5.7,65,341,2477,9.4,0.21995565
21828,21828,Peter Harrold,2010-11,27.0,5,3,39,39,1,2,3,23.0,361.0,145,7,15,22,145.0,82,5.53,56,304,2486,9.1,0.11247143
21829,21829,Peter Harrold,2011-12,28.0,6,4,19,19,1,3,4,12.0,233.0,164,8,18,26,157.0,82,5.46,52,291,2492,9.0,0.109726995
21830,21830,Peter Harrold,2012-13,29.0,7,2,11,11,0,2,2,11.0,161.0,175,8,20,28,168.0,82,5.32,47,271,2439,8.9,0.14262787
21831,21831,Peter Harrold,2013-14,30.0,8,5,23,23,2,3,5,36.0,406.0,198,10,23,33,204.0,48,5.31,29,160,1399,9.1,0.23233029
21832,21832,Peter Harrold,2014-15,31.0,9,4,33,33,0,4,4,32.0,616.0,231,10,27,37,236.0,82,5.34,48,269,2463,8.9,0.13348949
21833,21833,Peter Harrold,2015-16,32.0,10,5,43,43,3,2,5,31.0,655.0,274,13,29,42,267.0,82,5.32,47,251,2453,8.9,0.10874823
21834,21834,Peter Hayek,1982-83,25.0,2,0,1,1,0,0,0,0.0,,1,0,0,0,0.0,80,8.03,73,320,2489,12.9,0.21092343
21835,21835,Peter Helander,1983-84,32.0,2,1,7,7,0,1,1,2.0,,7,0,1,1,2.0,80,7.73,71,310,2444,12.7,0.18856844
21836,21836,Peter Holland,2012-13,22.0,2,1,4,4,1,0,1,1.0,31.0,4,1,0,1,1.0,82,5.32,47,271,2439,8.9,0.2797293
21837,21837,Peter Holland,2013-14,23.0,3,5,21,21,3,2,5,26.0,243.0,25,4,2,6,27.0,48,5.31,29,160,1399,9.1,0.3137856
21838,21838,Peter Holland,2014-15,24.0,4,11,43,43,6,5,11,43.0,488.0,68,10,7,17,70.0,82,5.34,48,269,2463,8.9,0.22889501
21839,21839,Peter Holland,2015-16,25.0,5,25,62,62,11,14,25,93.0,900.0,130,21,21,42,163.0,82,5.32,47,251,2453,8.9,0.33158964
21840,21840,Peter Holland,2016-17,26.0,6,27,65,65,9,18,27,138.0,953.0,195,30,39,69,301.0,82,5.34,48,255,2438,9.0,0.35144967
21841,21841,Peter Holland,2017-18,27.0,7,12,48,48,5,7,12,79.0,612.0,243,35,46,81,380.0,82,5.45,47,245,2478,9.0,0.25439268
21842,21842,Peter Holland,2018-19,28.0,8,4,23,23,1,3,4,30.0,285.0,266,36,49,85,410.0,82,5.86,50,250,2620,9.2,0.20370775
21843,21843,Peter Ihnacak,1983-84,26.0,2,66,80,80,28,38,66,160.0,,80,28,38,66,160.0,80,7.73,71,310,2444,12.7,0.7726456
21844,21844,Peter Ihnacak,1984-85,27.0,3,23,47,47,10,13,23,76.0,,127,38,51,89,236.0,80,7.89,74,336,2448,12.9,0.46599275
21845,21845,Peter Ihnacak,1985-86,28.0,4,44,70,70,22,22,44,118.0,,197,60,73,133,354.0,80,7.77,71,321,2447,12.7,0.6034031
21846,21846,Peter Ihnacak,1986-87,29.0,5,45,63,63,18,27,45,96.0,,260,78,100,178,450.0,80,7.94,82,370,2484,12.8,0.61785793
21847,21847,Peter Ihnacak,1987-88,30.0,6,39,58,58,12,27,39,98.0,,318,90,127,217,548.0,80,7.34,72,344,2400,12.2,0.5707889
21848,21848,Peter Ihnacak,1988-89,31.0,7,30,68,68,10,20,30,75.0,,386,100,147,247,623.0,80,7.43,89,437,2435,12.2,0.43437555
21849,21849,Peter Ihnacak,1989-90,32.0,8,18,26,26,2,16,18,30.0,,412,102,163,265,653.0,80,7.48,85,403,2430,12.3,0.43442532
21850,21850,Peter Ihnacak,1990-91,33.0,9,2,5,5,0,2,2,5.0,,417,102,165,267,658.0,80,7.37,76,367,2421,12.2,0.2643385
21851,21851,Peter Lappin,1990-91,25.0,2,0,6,6,0,0,0,8.0,,6,0,0,0,8.0,80,7.37,76,367,2421,12.2,0.21491268
21852,21852,Peter Lappin,1992-93,27.0,3,0,1,1,0,0,0,2.0,,7,0,0,0,10.0,80,6.96,77,402,2440,11.4,0.1902012
21853,21853,Peter Laviolette,1989-90,25.0,2,0,12,12,0,0,0,2.0,,12,0,0,0,2.0,80,7.48,85,403,2430,12.3,0.2019575
21854,21854,Peter LeBlanc,2014-15,26.0,2,0,1,1,0,0,0,0.0,9.0,1,0,0,0,0.0,82,5.34,48,269,2463,8.9,0.1332545
21855,21855,Peter LeBoutillier,1997-98,23.0,2,1,23,23,1,0,1,5.0,,23,1,0,1,5.0,82,5.83,55,336,2444,9.8,0.15327826
21856,21856,Peter LeBoutillier,1998-99,24.0,3,2,12,12,1,1,2,6.0,,35,2,1,3,11.0,82,5.28,57,380,2242,9.6,0.18312413
21857,21857,Peter Loob,1985-86,28.0,2,3,8,8,1,2,3,10.0,,8,1,2,3,10.0,80,7.77,71,321,2447,12.7,0.29020604
21858,21858,Peter Marsh,1980-81,24.0,2,38,57,57,18,20,38,187.0,,57,18,20,38,187.0,80,7.03,61,280,2352,12.0,0.65395015
21859,21859,Peter Marsh,1981-82,25.0,3,23,53,53,10,13,23,111.0,,110,28,33,61,298.0,80,7.69,77,340,2441,12.6,0.4619593
21860,21860,Peter Marsh,1982-83,26.0,4,28,57,57,10,18,28,122.0,,167,38,51,89,420.0,80,8.03,73,320,2489,12.9,0.45505196
21861,21861,Peter Marsh,1983-84,27.0,5,20,68,68,6,14,20,121.0,,235,44,65,109,541.0,80,7.73,71,310,2444,12.7,0.35940748
21862,21862,Peter Marsh,1984-85,28.0,6,10,43,43,4,6,10,86.0,,278,48,71,119,627.0,80,7.89,74,336,2448,12.9,0.32118106
21863,21863,Peter Mueller,2008-09,20.0,2,54,81,81,22,32,54,201.0,1398.0,81,22,32,54,201.0,82,5.44,62,351,2383,9.4,0.7336665
21864,21864,Peter Mueller,2009-10,21.0,3,36,72,72,13,23,36,138.0,1158.0,153,35,55,90,339.0,82,5.7,65,341,2477,9.4,0.5366379
21865,21865,Peter Mueller,2010-11,22.0,4,37,69,69,13,24,37,124.0,965.0,222,48,79,127,463.0,82,5.53,56,304,2486,9.1,0.54929113
21866,21866,Peter Mueller,2012-13,24.0,5,16,32,32,7,9,16,82.0,469.0,254,55,88,143,545.0,82,5.32,47,271,2439,8.9,0.52832127
21867,21867,Peter Mueller,2013-14,25.0,6,17,43,43,8,9,17,131.0,699.0,297,63,97,160,676.0,48,5.31,29,160,1399,9.1,0.5223914
21868,21868,Peter Nordstrom,1999-00,25.0,2,0,2,2,0,0,0,0.0,16.0,2,0,0,0,0.0,82,5.27,57,359,2285,9.4,0.16462103
21869,21869,Peter Olvecky,2009-10,24.0,2,7,31,31,2,5,7,19.0,277.0,31,2,5,7,19.0,82,5.7,65,341,2477,9.4,0.20784447
21870,21870,Peter Olvecky,2010-11,25.0,3,0,1,1,0,0,0,0.0,8.0,32,2,5,7,19.0,82,5.53,56,304,2486,9.1,0.15283257
21871,21871,Peter Popovic,1994-95,26.0,2,14,47,47,2,12,14,58.0,,47,2,12,14,58.0,84,6.48,76,407,2545,10.7,0.22469631
21872,21872,Peter Popovic,1995-96,27.0,3,5,33,33,0,5,5,23.0,,80,2,17,19,81.0,48,5.97,37,209,1408,10.2,0.18473944
21873,21873,Peter Popovic,1996-97,28.0,4,14,76,76,2,12,14,59.0,,156,4,29,33,140.0,82,6.29,74,413,2481,10.4,0.16704017
21874,21874,Peter Popovic,1997-98,29.0,5,14,78,78,1,13,14,82.0,,234,5,42,47,222.0,82,5.83,55,336,2444,9.8,0.17212379
21875,21875,Peter Popovic,1998-99,30.0,6,8,69,69,2,6,8,40.0,,303,7,48,55,262.0,82,5.28,57,380,2242,9.6,0.14857784
21876,21876,Peter Popovic,1999-00,31.0,7,5,68,68,1,4,5,64.0,1406.0,371,8,52,60,326.0,82,5.27,57,359,2285,9.4,0.1366454
21877,21877,Peter Popovic,2000-01,32.0,8,6,54,54,1,5,6,23.0,875.0,425,9,57,66,349.0,82,5.49,53,331,2294,9.8,0.11104292
21878,21878,Peter Popovic,2001-02,33.0,9,7,60,60,1,6,7,34.0,1121.0,485,10,63,73,383.0,82,5.51,63,376,2272,9.9,0.13412306
21879,21879,Peter Ratchuk,1999-00,22.0,2,2,24,24,1,1,2,34.0,334.0,24,1,1,2,34.0,82,5.27,57,359,2285,9.4,0.21365261
21880,21880,Peter Ratchuk,2001-02,24.0,3,0,8,8,0,0,0,11.0,105.0,32,1,1,2,45.0,82,5.51,63,376,2272,9.9,0.16099462
21881,21881,Peter Regin,2009-10,23.0,2,2,11,11,1,1,2,7.0,116.0,11,1,1,2,7.0,82,5.7,65,341,2477,9.4,0.21812126
21882,21882,Peter Regin,2010-11,24.0,3,29,75,75,13,16,29,135.0,967.0,86,14,17,31,142.0,82,5.53,56,304,2486,9.1,0.4041142
21883,21883,Peter Regin,2011-12,25.0,4,17,55,55,3,14,17,87.0,736.0,141,17,31,48,229.0,82,5.46,52,291,2492,9.0,0.27605373
21884,21884,Peter Regin,2012-13,26.0,5,4,10,10,2,2,4,15.0,141.0,151,19,33,52,244.0,82,5.32,47,271,2439,8.9,0.26715514
21885,21885,Peter Regin,2013-14,27.0,6,3,27,27,0,3,3,37.0,311.0,178,19,36,55,281.0,48,5.31,29,160,1399,9.1,0.1999493
21886,21886,Peter Regin,2014-15,28.0,7,11,61,61,4,7,11,69.0,698.0,239,23,43,66,350.0,82,5.34,48,269,2463,8.9,0.20929787
21887,21887,Peter Regin,2015-16,29.0,8,1,4,4,0,1,1,3.0,33.0,243,23,44,67,353.0,82,5.32,47,251,2453,8.9,0.22016308
21888,21888,Peter Sarno,2004-05,25.0,2,1,6,6,1,0,1,5.0,62.0,6,1,0,1,5.0,82,5.14,57,348,2300,9.2,0.201651
21889,21889,Peter Sarno,2006-07,27.0,3,0,1,1,0,0,0,0.0,11.0,7,1,0,1,5.0,82,6.05,85,480,2458,10.1,0.15974158
21890,21890,Peter Schaefer,1999-00,22.0,2,8,25,25,4,4,8,24.0,334.0,25,4,4,8,24.0,82,5.27,57,359,2285,9.4,0.31627205
21891,21891,Peter Schaefer,2000-01,23.0,3,31,71,71,16,15,31,101.0,1098.0,96,20,19,39,125.0,82,5.49,53,331,2294,9.8,0.46240568
21892,21892,Peter Schaefer,2001-02,24.0,4,36,82,82,16,20,36,163.0,1337.0,178,36,39,75,288.0,82,5.51,63,376,2272,9.9,0.4881704
21893,21893,Peter Schaefer,2003-04,26.0,5,23,75,75,6,17,23,93.0,1124.0,253,42,56,98,381.0,82,5.31,60,363,2326,9.4,0.33816814
21894,21894,Peter Schaefer,2004-05,27.0,6,39,81,81,15,24,39,112.0,1264.0,334,57,80,137,493.0,82,5.14,57,348,2300,9.2,0.5381943
21895,21895,Peter Schaefer,2006-07,29.0,7,50,82,82,20,30,50,137.0,1297.0,416,77,110,187,630.0,82,6.05,85,480,2458,10.1,0.51489305
21896,21896,Peter Schaefer,2007-08,30.0,8,46,77,77,12,34,46,132.0,1288.0,493,89,144,233,762.0,82,5.76,70,398,2426,9.7,0.47929248
21897,21897,Peter Schaefer,2008-09,31.0,9,26,63,63,9,17,26,91.0,943.0,556,98,161,259,853.0,82,5.44,62,351,2383,9.4,0.33474058
21898,21898,Peter Schaefer,2011-12,34.0,10,2,16,16,1,1,2,10.0,155.0,572,99,162,261,863.0,82,5.46,52,291,2492,9.0,0.23128337
21899,21899,Peter Sejna,2003-04,24.0,2,1,1,1,1,0,1,3.0,15.0,1,1,0,1,3.0,82,5.31,60,363,2326,9.4,0.22263741
21900,21900,Peter Sejna,2004-05,25.0,3,4,20,20,2,2,4,36.0,299.0,21,3,2,5,39.0,82,5.14,57,348,2300,9.2,0.2165209
21901,21901,Peter Sejna,2006-07,27.0,4,2,6,6,1,1,2,9.0,70.0,27,4,3,7,48.0,82,6.05,85,480,2458,10.1,0.17832646
21902,21902,Peter Sejna,2007-08,28.0,5,4,22,22,3,1,4,34.0,220.0,49,7,4,11,82.0,82,5.76,70,398,2426,9.7,0.20365098
21903,21903,Peter Smrek,2001-02,22.0,2,5,20,20,2,3,5,14.0,313.0,20,2,3,5,14.0,82,5.51,63,376,2272,9.9,0.21434447
21904,21904,Peter Smrek,2002-03,23.0,3,1,8,8,0,1,1,2.0,116.0,28,2,4,6,16.0,82,5.24,53,338,2262,9.5,0.18633607
21905,21905,Peter Stastny,1981-82,25.0,2,109,77,77,39,70,109,232.0,,77,39,70,109,232.0,80,7.69,77,340,2441,12.6,1.4056556
21906,21906,Peter Stastny,1982-83,26.0,3,139,80,80,46,93,139,227.0,,157,85,163,248,459.0,80,8.03,73,320,2489,12.9,1.5971074
21907,21907,Peter Stastny,1983-84,27.0,4,124,75,75,47,77,124,201.0,,232,132,240,372,660.0,80,7.73,71,310,2444,12.7,1.4006996
21908,21908,Peter Stastny,1984-85,28.0,5,119,80,80,46,73,119,189.0,,312,178,313,491,849.0,80,7.89,74,336,2448,12.9,1.2964201
21909,21909,Peter Stastny,1985-86,29.0,6,100,75,75,32,68,100,208.0,,387,210,381,591,1057.0,80,7.77,71,321,2447,12.7,1.3989196
21910,21910,Peter Stastny,1986-87,30.0,7,122,76,76,41,81,122,207.0,,463,251,462,713,1264.0,80,7.94,82,370,2484,12.8,1.246877
21911,21911,Peter Stastny,1987-88,31.0,8,77,64,64,24,53,77,156.0,,527,275,515,790,1420.0,80,7.34,72,344,2400,12.2,1.2275958
21912,21912,Peter Stastny,1988-89,32.0,9,111,76,76,46,65,111,199.0,,603,321,580,901,1619.0,80,7.43,89,437,2435,12.2,1.1714673
21913,21913,Peter Stastny,1989-90,33.0,10,85,72,72,35,50,85,195.0,,675,356,630,986,1814.0,80,7.48,85,403,2430,12.3,1.0880027
21914,21914,Peter Stastny,1990-91,34.0,11,73,74,74,29,44,73,156.0,,749,385,674,1059,1970.0,80,7.37,76,367,2421,12.2,0.8602861
21915,21915,Peter Stastny,1991-92,35.0,12,60,77,77,18,42,60,117.0,,826,403,716,1119,2087.0,80,6.91,71,366,2385,11.6,0.8123253
21916,21916,Peter Stastny,1992-93,36.0,13,62,66,66,24,38,62,142.0,,892,427,754,1181,2229.0,80,6.96,77,402,2440,11.4,0.82267976
21917,21917,Peter Stastny,1993-94,37.0,14,40,62,62,17,23,40,106.0,,954,444,777,1221,2335.0,84,7.25,87,443,2603,11.7,0.63840383
21918,21918,Peter Stastny,1994-95,38.0,15,16,17,17,5,11,16,30.0,,971,449,788,1237,2365.0,84,6.48,76,407,2545,10.7,0.5809405
21919,21919,Peter Stastny,1995-96,39.0,16,2,6,6,1,1,2,9.0,,977,450,789,1239,2374.0,48,5.97,37,209,1408,10.2,0.42354518
21920,21920,Peter Sturgeon,1980-81,26.0,2,0,2,2,0,0,0,1.0,,2,0,0,0,1.0,80,7.03,61,280,2352,12.0,0.22837335
21921,21921,Peter Sturgeon,1981-82,27.0,3,1,4,4,0,1,1,4.0,,6,0,1,1,5.0,80,7.69,77,340,2441,12.6,0.20187667
21922,21922,Peter Sullivan,1980-81,29.0,2,59,79,79,24,35,59,166.0,,79,24,35,59,166.0,80,7.03,61,280,2352,12.0,0.65905344
21923,21923,Peter Sullivan,1981-82,30.0,3,23,47,47,4,19,23,42.0,,126,28,54,82,208.0,80,7.69,77,340,2441,12.6,0.385416
21924,21924,Peter Sundstrom,1984-85,23.0,2,44,77,77,22,22,44,148.0,,77,22,22,44,148.0,80,7.89,74,336,2448,12.9,0.5669929
21925,21925,Peter Sundstrom,1985-86,24.0,3,43,76,76,18,25,43,161.0,,153,40,47,87,309.0,80,7.77,71,321,2447,12.7,0.55169904
21926,21926,Peter Sundstrom,1986-87,25.0,4,23,53,53,8,15,23,63.0,,206,48,62,110,372.0,80,7.94,82,370,2484,12.8,0.458766
21927,21927,Peter Sundstrom,1988-89,27.0,5,25,76,76,8,17,25,89.0,,282,56,79,135,461.0,80,7.43,89,437,2435,12.2,0.3480876
21928,21928,Peter Sundstrom,1989-90,28.0,6,6,35,35,4,2,6,39.0,,317,60,81,141,500.0,80,7.48,85,403,2430,12.3,0.28404805
21929,21929,Peter Sundstrom,1990-91,29.0,7,3,21,21,1,2,3,16.0,,338,61,83,144,516.0,80,7.37,76,367,2421,12.2,0.21523592
21930,21930,Peter Taglianetti,1985-86,22.0,2,0,1,1,0,0,0,2.0,,1,0,0,0,2.0,80,7.77,71,321,2447,12.7,0.22890192
21931,21931,Peter Taglianetti,1986-87,23.0,3,0,18,18,0,0,0,8.0,,19,0,0,0,10.0,80,7.94,82,370,2484,12.8,0.18364617
21932,21932,Peter Taglianetti,1987-88,24.0,4,0,3,3,0,0,0,2.0,,22,0,0,0,12.0,80,7.34,72,344,2400,12.2,0.19168037
21933,21933,Peter Taglianetti,1988-89,25.0,5,23,70,70,6,17,23,92.0,,92,6,17,23,104.0,80,7.43,89,437,2435,12.2,0.31035036
21934,21934,Peter Taglianetti,1989-90,26.0,6,15,66,66,1,14,15,72.0,,158,7,31,38,176.0,80,7.48,85,403,2430,12.3,0.21417573
21935,21935,Peter Taglianetti,1990-91,27.0,7,9,49,49,3,6,9,57.0,,207,10,37,47,233.0,80,7.37,76,367,2421,12.2,0.19668227
21936,21936,Peter Taglianetti,1991-92,28.0,8,12,55,55,3,9,12,40.0,,262,13,46,59,273.0,80,6.91,71,366,2385,11.6,0.22892785
21937,21937,Peter Taglianetti,1992-93,29.0,9,4,44,44,1,3,4,23.0,,306,14,49,63,296.0,80,6.96,77,402,2440,11.4,0.12743741
21938,21938,Peter Taglianetti,1993-94,30.0,10,14,72,72,2,12,14,78.0,,378,16,61,77,374.0,84,7.25,87,443,2603,11.7,0.17679557
21939,21939,Peter Taglianetti,1994-95,31.0,11,14,60,60,2,12,14,57.0,,438,18,73,91,431.0,84,6.48,76,407,2545,10.7,0.16644448
21940,21940,Peter Taglianetti,1995-96,32.0,12,1,13,13,0,1,1,5.0,,451,18,74,92,436.0,48,5.97,37,209,1408,10.2,0.13388035
21941,21941,Peter Vandermeer,2008-09,33.0,2,0,2,2,0,0,0,0.0,15.0,2,0,0,0,0.0,82,5.44,62,351,2383,9.4,0.16079316
21942,21942,Peter Wallin,1981-82,24.0,2,6,12,12,1,5,6,14.0,,12,1,5,6,14.0,80,7.69,77,340,2441,12.6,0.27077416
21943,21943,Peter Wallin,1982-83,25.0,3,11,40,40,2,9,11,49.0,,52,3,14,17,63.0,80,8.03,73,320,2489,12.9,0.26070887
21944,21944,Peter White,1994-95,25.0,2,8,26,26,3,5,8,17.0,,26,3,5,8,17.0,84,6.48,76,407,2545,10.7,0.21750328
21945,21945,Peter White,1995-96,26.0,3,6,9,9,2,4,6,13.0,,35,5,9,14,30.0,48,5.97,37,209,1408,10.2,0.28021684
21946,21946,Peter White,1996-97,27.0,4,8,27,27,5,3,8,34.0,,62,10,12,22,64.0,82,6.29,74,413,2481,10.4,0.23384395
21947,21947,Peter White,1999-00,30.0,5,0,3,3,0,0,0,0.0,6.0,65,10,12,22,64.0,82,5.27,57,359,2285,9.4,0.15392837
21948,21948,Peter White,2000-01,31.0,6,6,21,21,1,5,6,24.0,274.0,86,11,17,28,88.0,82,5.49,53,331,2294,9.8,0.1978943
21949,21949,Peter White,2001-02,32.0,7,25,77,77,9,16,25,68.0,995.0,163,20,33,53,156.0,82,5.51,63,376,2272,9.9,0.24431345
21950,21950,Peter White,2002-03,33.0,8,6,48,48,3,3,6,21.0,505.0,211,23,36,59,177.0,82,5.24,53,338,2262,9.5,0.14104506
21951,21951,Peter White,2003-04,34.0,9,1,6,6,0,1,1,2.0,54.0,217,23,37,60,179.0,82,5.31,60,363,2326,9.4,0.2029728
21952,21952,Peter White,2004-05,35.0,10,0,3,3,0,0,0,2.0,19.0,220,23,37,60,181.0,82,5.14,57,348,2300,9.2,0.22721925
21953,21953,Peter Worrell,1998-99,21.0,2,0,19,19,0,0,0,15.0,,19,0,0,0,15.0,82,5.28,57,380,2242,9.6,0.14252174
21954,21954,Peter Worrell,1999-00,22.0,3,9,62,62,4,5,9,50.0,388.0,81,4,5,9,65.0,82,5.27,57,359,2285,9.4,0.18969035
21955,21955,Peter Worrell,2000-01,23.0,4,9,48,48,3,6,9,45.0,404.0,129,7,11,18,110.0,82,5.49,53,331,2294,9.8,0.19893965
21956,21956,Peter Worrell,2001-02,24.0,5,10,71,71,3,7,10,86.0,672.0,200,10,18,28,196.0,82,5.51,63,376,2272,9.9,0.211784
21957,21957,Peter Worrell,2002-03,25.0,6,9,79,79,4,5,9,65.0,691.0,279,14,23,37,261.0,82,5.24,53,338,2262,9.5,0.15401438
21958,21958,Peter Worrell,2003-04,26.0,7,5,63,63,2,3,5,52.0,583.0,342,16,26,42,313.0,82,5.31,60,363,2326,9.4,0.14748886
21959,21959,Peter Worrell,2004-05,27.0,8,4,49,49,3,1,4,32.0,290.0,391,19,27,46,345.0,82,5.14,57,348,2300,9.2,0.15282354
21960,21960,Peter Zezel,1985-86,20.0,2,60,65,65,15,45,60,93.0,,65,15,45,60,93.0,80,7.77,71,321,2447,12.7,0.80615914
21961,21961,Peter Zezel,1986-87,21.0,3,54,79,79,17,37,54,146.0,,144,32,82,114,239.0,80,7.94,82,370,2484,12.8,0.7599595
21962,21962,Peter Zezel,1987-88,22.0,4,72,71,71,33,39,72,181.0,,215,65,121,186,420.0,80,7.34,72,344,2400,12.2,0.9822185
21963,21963,Peter Zezel,1988-89,23.0,5,57,69,69,22,35,57,133.0,,284,87,156,243,553.0,80,7.43,89,437,2435,12.2,0.82222354
21964,21964,Peter Zezel,1989-90,24.0,6,70,78,78,21,49,70,149.0,,362,108,205,313,702.0,80,7.48,85,403,2430,12.3,0.89754105
21965,21965,Peter Zezel,1990-91,25.0,7,72,73,73,25,47,72,158.0,,435,133,252,385,860.0,80,7.37,76,367,2421,12.2,0.88834345
21966,21966,Peter Zezel,1991-92,26.0,8,40,52,52,21,19,40,90.0,,487,154,271,425,950.0,80,6.91,71,366,2385,11.6,0.7533914
21967,21967,Peter Zezel,1992-93,27.0,9,49,64,64,16,33,49,125.0,,551,170,304,474,1075.0,80,6.96,77,402,2440,11.4,0.6920669
21968,21968,Peter Zezel,1993-94,28.0,10,35,70,70,12,23,35,102.0,,621,182,327,509,1177.0,84,7.25,87,443,2603,11.7,0.47471023
21969,21969,Peter Zezel,1994-95,29.0,11,16,41,41,8,8,16,47.0,,662,190,335,525,1224.0,84,6.48,76,407,2545,10.7,0.45980883
21970,21970,Peter Zezel,1995-96,30.0,12,11,30,30,6,5,11,47.0,,692,196,340,536,1271.0,48,5.97,37,209,1408,10.2,0.4408938
21971,21971,Peter Zezel,1996-97,31.0,13,21,57,57,8,13,21,87.0,,749,204,353,557,1358.0,82,6.29,74,413,2481,10.4,0.33784318
21972,21972,Peter Zezel,1997-98,32.0,14,16,53,53,4,12,16,62.0,,802,208,365,573,1420.0,82,5.83,55,336,2444,9.8,0.3454846
21973,21973,Peter Zezel,1998-99,33.0,15,20,30,30,5,15,20,40.0,,832,213,380,593,1460.0,82,5.28,57,380,2242,9.6,0.46721426
21974,21974,Peter Zezel,1999-00,34.0,16,14,41,41,6,8,14,45.0,538.0,873,219,388,607,1505.0,82,5.27,57,359,2285,9.4,0.28953472
21975,21975,Petr Buzek,1998-99,21.0,2,0,2,2,0,0,0,0.0,,2,0,0,0,0.0,82,5.28,57,380,2242,9.6,0.16920802
21976,21976,Petr Buzek,1999-00,22.0,3,0,2,2,0,0,0,0.0,28.0,4,0,0,0,0.0,82,5.27,57,359,2285,9.4,0.17214978
21977,21977,Petr Buzek,2000-01,23.0,4,19,63,63,5,14,19,90.0,1159.0,67,5,14,19,90.0,82,5.49,53,331,2294,9.8,0.29062787
21978,21978,Petr Buzek,2001-02,24.0,5,0,5,5,0,0,0,11.0,87.0,72,5,14,19,101.0,82,5.51,63,376,2272,9.9,0.1823956
21979,21979,Petr Buzek,2002-03,25.0,6,4,41,41,1,3,4,36.0,694.0,113,6,17,23,137.0,82,5.24,53,338,2262,9.5,0.17030352
21980,21980,Petr Buzek,2003-04,26.0,7,8,44,44,3,5,8,48.0,632.0,157,9,22,31,185.0,82,5.31,60,363,2326,9.4,0.16927966
21981,21981,Petr Cajanek,2003-04,28.0,2,38,51,51,9,29,38,90.0,812.0,51,9,29,38,90.0,82,5.31,60,363,2326,9.4,0.5544517
21982,21982,Petr Cajanek,2004-05,29.0,3,26,70,70,12,14,26,126.0,1246.0,121,21,43,64,216.0,82,5.14,57,348,2300,9.2,0.42675108
21983,21983,Petr Cajanek,2006-07,31.0,4,41,71,71,10,31,41,150.0,1340.0,192,31,74,105,366.0,82,6.05,85,480,2458,10.1,0.4621075
21984,21984,Petr Cajanek,2007-08,32.0,5,48,77,77,15,33,48,167.0,1251.0,269,46,107,153,533.0,82,5.76,70,398,2426,9.7,0.5427268
21985,21985,Petr Hubacek,2001-02,22.0,2,1,6,6,1,0,1,5.0,68.0,6,1,0,1,5.0,82,5.51,63,376,2272,9.9,0.22387156
21986,21986,Petr Kalus,2007-08,20.0,2,5,9,9,4,1,5,8.0,101.0,9,4,1,5,8.0,82,5.76,70,398,2426,9.7,0.33480552
21987,21987,Petr Kalus,2010-11,23.0,3,0,2,2,0,0,0,0.0,15.0,11,4,1,5,8.0,82,5.53,56,304,2486,9.1,0.20058191
21988,21988,Petr Kanko,2006-07,22.0,2,1,10,10,1,0,1,7.0,47.0,10,1,0,1,7.0,82,6.05,85,480,2458,10.1,0.2136985
21989,21989,Petr Klima,1986-87,22.0,2,56,74,74,32,24,56,178.0,,74,32,24,56,178.0,80,7.94,82,370,2484,12.8,0.7854222
21990,21990,Petr Klima,1987-88,23.0,3,53,77,77,30,23,53,210.0,,151,62,47,109,388.0,80,7.34,72,344,2400,12.2,0.7574272
21991,21991,Petr Klima,1988-89,24.0,4,62,78,78,37,25,62,174.0,,229,99,72,171,562.0,80,7.43,89,437,2435,12.2,0.8014147
21992,21992,Petr Klima,1989-90,25.0,5,41,51,51,25,16,41,145.0,,280,124,88,212,707.0,80,7.48,85,403,2430,12.3,0.79554164
21993,21993,Petr Klima,1990-91,26.0,6,63,76,76,30,33,63,186.0,,356,154,121,275,893.0,80,7.37,76,367,2421,12.2,0.7680384
21994,21994,Petr Klima,1991-92,27.0,7,68,70,70,40,28,68,204.0,,426,194,149,343,1097.0,80,6.91,71,366,2385,11.6,0.84173995
21995,21995,Petr Klima,1992-93,28.0,8,34,57,57,21,13,34,107.0,,483,215,162,377,1204.0,80,6.96,77,402,2440,11.4,0.5766065
21996,21996,Petr Klima,1993-94,29.0,9,48,68,68,32,16,48,175.0,,551,247,178,425,1379.0,84,7.25,87,443,2603,11.7,0.6655472
21997,21997,Petr Klima,1994-95,30.0,10,55,75,75,28,27,55,167.0,,626,275,205,480,1546.0,84,6.48,76,407,2545,10.7,0.624403
21998,21998,Petr Klima,1995-96,31.0,11,26,47,47,13,13,26,75.0,,673,288,218,506,1621.0,48,5.97,37,209,1408,10.2,0.55078757
21999,21999,Petr Klima,1996-97,32.0,12,52,67,67,22,30,52,164.0,,740,310,248,558,1785.0,82,6.29,74,413,2481,10.4,0.5554036
22000,22000,Petr Klima,1997-98,33.0,13,14,33,33,2,12,14,55.0,,773,312,260,572,1840.0,82,5.83,55,336,2444,9.8,0.37665102
22001,22001,Petr Klima,1999-00,35.0,14,1,13,13,1,0,1,12.0,78.0,786,313,260,573,1852.0,82,5.27,57,359,2285,9.4,0.3414864
22002,22002,Petr Mika,2000-01,21.0,2,0,3,3,0,0,0,1.0,14.0,3,0,0,0,1.0,82,5.49,53,331,2294,9.8,0.17530924
22003,22003,Petr Nedved,1991-92,20.0,2,16,61,61,10,6,16,97.0,,61,10,6,16,97.0,80,6.91,71,366,2385,11.6,0.37238812
22004,22004,Petr Nedved,1992-93,21.0,3,37,77,77,15,22,37,99.0,,138,25,28,53,196.0,80,6.96,77,402,2440,11.4,0.5794488
22005,22005,Petr Nedved,1993-94,22.0,4,71,84,84,38,33,71,149.0,,222,63,61,124,345.0,84,7.25,87,443,2603,11.7,0.8021475
22006,22006,Petr Nedved,1994-95,23.0,5,20,19,19,6,14,20,63.0,,241,69,75,144,408.0,84,6.48,76,407,2545,10.7,0.72693557
22007,22007,Petr Nedved,1995-96,24.0,6,23,46,46,11,12,23,123.0,,287,80,87,167,531.0,48,5.97,37,209,1408,10.2,0.66896224
22008,22008,Petr Nedved,1996-97,25.0,7,99,80,80,45,54,99,204.0,,367,125,141,266,735.0,82,6.29,74,413,2481,10.4,1.0163776
22009,22009,Petr Nedved,1997-98,26.0,8,71,74,74,33,38,71,189.0,,441,158,179,337,924.0,82,5.83,55,336,2444,9.8,0.8654003
22010,22010,Petr Nedved,1999-00,28.0,9,47,56,56,20,27,47,153.0,1149.0,497,178,206,384,1077.0,82,5.27,57,359,2285,9.4,0.7886698
22011,22011,Petr Nedved,2000-01,29.0,10,68,76,76,24,44,68,201.0,1513.0,573,202,250,452,1278.0,82,5.49,53,331,2294,9.8,0.8000157
22012,22012,Petr Nedved,2001-02,30.0,11,78,79,79,32,46,78,230.0,1602.0,652,234,296,530,1508.0,82,5.51,63,376,2272,9.9,0.79497147
22013,22013,Petr Nedved,2002-03,31.0,12,46,78,78,21,25,46,175.0,1510.0,730,255,321,576,1683.0,82,5.24,53,338,2262,9.5,0.5925789
22014,22014,Petr Nedved,2003-04,32.0,13,58,78,78,27,31,58,205.0,1587.0,808,282,352,634,1888.0,82,5.31,60,363,2326,9.4,0.67714936
22015,22015,Petr Nedved,2004-05,33.0,14,46,81,81,19,27,46,190.0,1517.0,889,301,379,680,2078.0,82,5.14,57,348,2300,9.2,0.6381748
22016,22016,Petr Nedved,2006-07,35.0,15,25,53,53,7,18,25,90.0,891.0,942,308,397,705,2168.0,82,6.05,85,480,2458,10.1,0.4247448
22017,22017,Petr Nedved,2007-08,36.0,16,12,40,40,2,10,12,39.0,592.0,982,310,407,717,2207.0,82,5.76,70,398,2426,9.7,0.29963624
22018,22018,Petr Prajsler,1988-89,23.0,2,0,7,7,0,0,0,2.0,,7,0,0,0,2.0,80,7.43,89,437,2435,12.2,0.22999275
22019,22019,Petr Prajsler,1989-90,24.0,3,3,2,2,0,3,3,1.0,,9,0,3,3,3.0,80,7.48,85,403,2430,12.3,0.24094406
22020,22020,Petr Prajsler,1990-91,25.0,4,10,34,34,3,7,10,49.0,,43,3,10,13,52.0,80,7.37,76,367,2421,12.2,0.25362366
22021,22021,Petr Prajsler,1992-93,27.0,5,0,3,3,0,0,0,3.0,,46,3,10,13,55.0,80,6.96,77,402,2440,11.4,0.16917774
22022,22022,Petr Prucha,2006-07,24.0,2,47,68,68,30,17,47,130.0,931.0,68,30,17,47,130.0,82,6.05,85,480,2458,10.1,0.6299782
22023,22023,Petr Prucha,2007-08,25.0,3,40,79,79,22,18,40,136.0,1027.0,147,52,35,87,266.0,82,5.76,70,398,2426,9.7,0.48021764
22024,22024,Petr Prucha,2008-09,26.0,4,17,62,62,7,10,17,89.0,722.0,209,59,45,104,355.0,82,5.44,62,351,2383,9.4,0.3451488
22025,22025,Petr Prucha,2009-10,27.0,5,19,47,47,6,13,19,67.0,690.0,256,65,58,123,422.0,82,5.7,65,341,2477,9.4,0.41924888
22026,22026,Petr Prucha,2010-11,28.0,6,22,79,79,13,9,22,128.0,1109.0,335,78,67,145,550.0,82,5.53,56,304,2486,9.1,0.30117583
22027,22027,Petr Prucha,2011-12,29.0,7,1,11,11,0,1,1,10.0,126.0,346,78,68,146,560.0,82,5.46,52,291,2492,9.0,0.30117124
22028,22028,Petr Schastlivy,2000-01,21.0,2,7,13,13,2,5,7,22.0,160.0,13,2,5,7,22.0,82,5.49,53,331,2294,9.8,0.3118103
22029,22029,Petr Schastlivy,2001-02,22.0,3,5,17,17,3,2,5,32.0,193.0,30,5,7,12,54.0,82,5.51,63,376,2272,9.9,0.32522863
22030,22030,Petr Schastlivy,2002-03,23.0,4,1,1,1,0,1,1,0.0,3.0,31,5,8,13,54.0,82,5.24,53,338,2262,9.5,0.2233608
22031,22031,Petr Schastlivy,2003-04,24.0,5,19,33,33,9,10,19,68.0,440.0,64,14,18,32,122.0,82,5.31,60,363,2326,9.4,0.40397483
22032,22032,Petr Schastlivy,2004-05,25.0,6,8,65,65,4,4,8,85.0,660.0,129,18,22,40,207.0,82,5.14,57,348,2300,9.2,0.20923874
22033,22033,Petr Straka,2015-16,23.0,2,2,3,3,0,2,2,2.0,28.0,3,0,2,2,2.0,82,5.32,47,251,2453,8.9,0.20550823
22034,22034,Petr Svoboda,1985-86,19.0,2,31,73,73,4,27,31,81.0,,73,4,27,31,81.0,80,7.77,71,321,2447,12.7,0.4442131
22035,22035,Petr Svoboda,1986-87,20.0,3,19,73,73,1,18,19,60.0,,146,5,45,50,141.0,80,7.94,82,370,2484,12.8,0.35507762
22036,22036,Petr Svoboda,1987-88,21.0,4,22,70,70,5,17,22,79.0,,216,10,62,72,220.0,80,7.34,72,344,2400,12.2,0.3814323
22037,22037,Petr Svoboda,1988-89,22.0,5,29,69,69,7,22,29,138.0,,285,17,84,101,358.0,80,7.43,89,437,2435,12.2,0.4668309
22038,22038,Petr Svoboda,1989-90,23.0,6,45,71,71,8,37,45,131.0,,356,25,121,146,489.0,80,7.48,85,403,2430,12.3,0.5868392
22039,22039,Petr Svoboda,1990-91,24.0,7,36,60,60,5,31,36,90.0,,416,30,152,182,579.0,80,7.37,76,367,2421,12.2,0.46516836
22040,22040,Petr Svoboda,1991-92,25.0,8,26,60,60,4,22,26,67.0,,476,34,174,208,646.0,80,6.91,71,366,2385,11.6,0.36406907
22041,22041,Petr Svoboda,1992-93,26.0,9,28,71,71,6,22,28,111.0,,547,40,196,236,757.0,80,6.96,77,402,2440,11.4,0.40957436
22042,22042,Petr Svoboda,1993-94,27.0,10,26,40,40,2,24,26,61.0,,587,42,220,262,818.0,84,7.25,87,443,2603,11.7,0.4832415
22043,22043,Petr Svoboda,1994-95,28.0,11,16,60,60,2,14,16,80.0,,647,44,234,278,898.0,84,6.48,76,407,2545,10.7,0.2565233
22044,22044,Petr Svoboda,1995-96,29.0,12,8,37,37,0,8,8,39.0,,684,44,242,286,937.0,48,5.97,37,209,1408,10.2,0.21014163
22045,22045,Petr Svoboda,1996-97,30.0,13,29,73,73,1,28,29,91.0,,757,45,270,315,1028.0,82,6.29,74,413,2481,10.4,0.30021757
22046,22046,Petr Svoboda,1997-98,31.0,14,14,67,67,2,12,14,36.0,,824,47,282,329,1064.0,82,5.83,55,336,2444,9.8,0.1635313
22047,22047,Petr Svoboda,1998-99,32.0,15,18,56,56,3,15,18,44.0,,880,50,297,347,1108.0,82,5.28,57,380,2242,9.6,0.25324333
22048,22048,Petr Svoboda,1999-00,33.0,16,23,59,59,5,18,23,83.0,1375.0,939,55,315,370,1191.0,82,5.27,57,359,2285,9.4,0.29874295
22049,22049,Petr Svoboda,2000-01,34.0,17,25,70,70,2,23,25,93.0,1610.0,1009,57,338,395,1284.0,82,5.49,53,331,2294,9.8,0.28008443
22050,22050,Petr Svoboda,2001-02,35.0,18,4,19,19,1,3,4,16.0,357.0,1028,58,341,399,1300.0,82,5.51,63,376,2272,9.9,0.15270317
22051,22051,Petr Svoboda0,2001-02,21.0,2,3,18,18,1,2,3,17.0,269.0,18,1,2,3,17.0,82,5.51,63,376,2272,9.9,0.22847247
22052,22052,Petr Sykora,1996-97,20.0,2,42,63,63,18,24,42,128.0,,63,18,24,42,128.0,82,6.29,74,413,2481,10.4,0.61964387
22053,22053,Petr Sykora,1997-98,21.0,3,3,19,19,1,2,3,26.0,,82,19,26,45,154.0,82,5.83,55,336,2444,9.8,0.35058343
22054,22054,Petr Sykora,1998-99,22.0,4,36,58,58,16,20,36,130.0,,140,35,46,81,284.0,82,5.28,57,380,2242,9.6,0.662584
22055,22055,Petr Sykora,1999-00,23.0,5,72,80,80,29,43,72,222.0,1299.0,220,64,89,153,506.0,82,5.27,57,359,2285,9.4,0.8622418
22056,22056,Petr Sykora,2000-01,24.0,6,68,79,79,25,43,68,222.0,1351.0,299,89,132,221,728.0,82,5.49,53,331,2294,9.8,0.8654686
22057,22057,Petr Sykora,2001-02,25.0,7,81,73,73,35,46,81,249.0,1295.0,372,124,178,302,977.0,82,5.51,63,376,2272,9.9,0.91221774
22058,22058,Petr Sykora,2002-03,26.0,8,48,73,73,21,27,48,194.0,1303.0,445,145,205,350,1171.0,82,5.24,53,338,2262,9.5,0.69286525
22059,22059,Petr Sykora,2003-04,27.0,9,59,82,82,34,25,59,299.0,1515.0,527,179,230,409,1470.0,82,5.31,60,363,2326,9.4,0.7851435
22060,22060,Petr Sykora,2004-05,28.0,10,52,81,81,23,29,52,277.0,1455.0,608,202,259,461,1747.0,82,5.14,57,348,2300,9.2,0.72580725
22061,22061,Petr Sykora,2006-07,30.0,11,51,74,74,23,28,51,230.0,1191.0,682,225,287,512,1977.0,82,6.05,85,480,2458,10.1,0.6377979
22062,22062,Petr Sykora,2007-08,31.0,12,53,82,82,22,31,53,206.0,1366.0,764,247,318,565,2183.0,82,5.76,70,398,2426,9.7,0.6270534
22063,22063,Petr Sykora,2008-09,32.0,13,63,81,81,28,35,63,201.0,1365.0,845,275,353,628,2384.0,82,5.44,62,351,2383,9.4,0.6815147
22064,22064,Petr Sykora,2009-10,33.0,14,46,76,76,25,21,46,180.0,1238.0,921,300,374,674,2564.0,82,5.7,65,341,2477,9.4,0.5330655
22065,22065,Petr Sykora,2010-11,34.0,15,3,14,14,2,1,3,13.0,168.0,935,302,375,677,2577.0,82,5.53,56,304,2486,9.1,0.40399948
22066,22066,Petr Sykora,2012-13,36.0,16,44,82,82,21,23,44,170.0,1304.0,1017,323,398,721,2747.0,82,5.32,47,271,2439,8.9,0.5221238
22067,22067,Petr Sykora0,1999-00,21.0,2,0,2,2,0,0,0,2.0,17.0,2,0,0,0,2.0,82,5.27,57,359,2285,9.4,0.19281691
22068,22068,Petr Sykora0,2006-07,28.0,3,4,10,10,2,2,4,9.0,107.0,12,2,2,4,11.0,82,6.05,85,480,2458,10.1,0.21709794
22069,22069,Petr Taticek,2006-07,23.0,2,0,3,3,0,0,0,3.0,18.0,3,0,0,0,3.0,82,6.05,85,480,2458,10.1,0.1751594
22070,22070,Petr Tenkrat,2001-02,24.0,2,14,46,46,5,9,14,79.0,589.0,46,5,9,14,79.0,82,5.51,63,376,2272,9.9,0.28694397
22071,22071,Petr Tenkrat,2002-03,25.0,3,24,67,67,8,16,24,95.0,802.0,113,13,25,38,174.0,82,5.24,53,338,2262,9.5,0.34447747
22072,22072,Petr Tenkrat,2007-08,30.0,4,14,64,64,9,5,14,82.0,801.0,177,22,30,52,256.0,82,5.76,70,398,2426,9.7,0.21752575
22073,22073,Petr Vrana,2009-10,24.0,2,1,16,16,1,0,1,6.0,110.0,16,1,0,1,6.0,82,5.7,65,341,2477,9.4,0.18538466
22074,22074,Petri Kontiola,2008-09,24.0,2,5,12,12,0,5,5,13.0,175.0,12,0,5,5,13.0,82,5.44,62,351,2383,9.4,0.21084881
22075,22075,Petri Skriko,1985-86,23.0,2,35,72,72,21,14,35,156.0,,72,21,14,35,156.0,80,7.77,71,321,2447,12.7,0.5660988
22076,22076,Petri Skriko,1986-87,24.0,3,78,80,80,38,40,78,191.0,,152,59,54,113,347.0,80,7.94,82,370,2484,12.8,0.86062056
22077,22077,Petri Skriko,1987-88,25.0,4,74,76,76,33,41,74,224.0,,228,92,95,187,571.0,80,7.34,72,344,2400,12.2,0.89062583
22078,22078,Petri Skriko,1988-89,26.0,5,64,73,73,30,34,64,172.0,,301,122,129,251,743.0,80,7.43,89,437,2435,12.2,0.78789186
22079,22079,Petri Skriko,1989-90,27.0,6,66,74,74,30,36,66,204.0,,375,152,165,317,947.0,80,7.48,85,403,2430,12.3,0.7940969
22080,22080,Petri Skriko,1990-91,28.0,7,48,77,77,15,33,48,172.0,,452,167,198,365,1119.0,80,7.37,76,367,2421,12.2,0.642298
22081,22081,Petri Skriko,1991-92,29.0,8,27,48,48,9,18,27,120.0,,500,176,216,392,1239.0,80,6.91,71,366,2385,11.6,0.60408074
22082,22082,Petri Skriko,1992-93,30.0,9,6,24,24,3,3,6,47.0,,524,179,219,398,1286.0,80,6.96,77,402,2440,11.4,0.46396768
22083,22083,Petri Skriko,1993-94,31.0,10,7,17,17,4,3,7,35.0,,541,183,222,405,1321.0,84,7.25,87,443,2603,11.7,0.44875082
22084,22084,Petri Varis,1998-99,29.0,2,0,1,1,0,0,0,0.0,,1,0,0,0,0.0,82,5.28,57,380,2242,9.6,0.1446931
22085,22085,Petter Granberg,2014-15,22.0,2,0,1,1,0,0,0,0.0,12.0,1,0,0,0,0.0,82,5.34,48,269,2463,8.9,0.14922687
22086,22086,Petter Granberg,2015-16,23.0,3,0,7,7,0,0,0,1.0,80.0,8,0,0,0,1.0,82,5.32,47,251,2453,8.9,0.1600422
22087,22087,Petter Granberg,2016-17,24.0,4,2,27,27,0,2,2,12.0,370.0,35,0,2,2,13.0,82,5.34,48,255,2438,9.0,0.11099455
22088,22088,Petter Granberg,2017-18,25.0,5,0,10,10,0,0,0,4.0,96.0,45,0,2,2,17.0,82,5.45,47,245,2478,9.0,0.13572612
22089,22089,Petteri Lehto,1985-86,24.0,2,0,6,6,0,0,0,5.0,,6,0,0,0,5.0,80,7.77,71,321,2447,12.7,0.2206254
22090,22090,Petteri Lindbohm,2015-16,22.0,2,3,23,23,2,1,3,32.0,358.0,23,2,1,3,32.0,82,5.32,47,251,2453,8.9,0.24660593
22091,22091,Petteri Lindbohm,2016-17,23.0,3,0,10,10,0,0,0,9.0,138.0,33,2,1,3,41.0,82,5.34,48,255,2438,9.0,0.17736042
22092,22092,Petteri Lindbohm,2017-18,24.0,4,0,7,7,0,0,0,10.0,91.0,40,2,1,3,51.0,82,5.45,47,245,2478,9.0,0.1693908
22093,22093,Petteri Nokelainen,2006-07,21.0,2,2,15,15,1,1,2,13.0,117.0,15,1,1,2,13.0,82,6.05,85,480,2458,10.1,0.2501132
22094,22094,Petteri Nokelainen,2008-09,23.0,3,10,57,57,7,3,10,40.0,472.0,72,8,4,12,53.0,82,5.44,62,351,2383,9.4,0.23420283
22095,22095,Petteri Nokelainen,2009-10,24.0,4,9,50,50,4,5,9,56.0,563.0,122,12,9,21,109.0,82,5.7,65,341,2477,9.4,0.17870772
22096,22096,Petteri Nokelainen,2010-11,25.0,5,13,67,67,5,8,13,88.0,823.0,189,17,17,34,197.0,82,5.53,56,304,2486,9.1,0.20820683
22097,22097,Petteri Nokelainen,2012-13,27.0,6,7,56,56,3,4,7,37.0,493.0,245,20,21,41,234.0,82,5.32,47,271,2439,8.9,0.15029678
22098,22098,Petteri Nummelin,2001-02,29.0,2,16,61,61,4,12,16,99.0,1051.0,61,4,12,16,99.0,82,5.51,63,376,2272,9.9,0.27589178
22099,22099,Petteri Nummelin,2007-08,35.0,3,20,51,51,3,17,20,69.0,1035.0,112,7,29,36,168.0,82,5.76,70,398,2426,9.7,0.32033014
22100,22100,Petteri Nummelin,2008-09,36.0,4,9,27,27,2,7,9,31.0,414.0,139,9,36,45,199.0,82,5.44,62,351,2383,9.4,0.23437071
22101,22101,Petteri Wirtanen,2008-09,22.0,2,1,3,3,1,0,1,1.0,13.0,3,1,0,1,1.0,82,5.44,62,351,2383,9.4,0.28950977
22102,22102,Phil Bourque,1984-85,22.0,2,1,5,5,0,1,1,6.0,,5,0,1,1,6.0,80,7.89,74,336,2448,12.9,0.2603547
22103,22103,Phil Bourque,1986-87,24.0,3,0,4,4,0,0,0,0.0,,9,0,1,1,6.0,80,7.94,82,370,2484,12.8,0.18425214
22104,22104,Phil Bourque,1987-88,25.0,4,5,22,22,2,3,5,23.0,,31,2,4,6,29.0,80,7.34,72,344,2400,12.2,0.29169068
22105,22105,Phil Bourque,1988-89,26.0,5,16,21,21,4,12,16,56.0,,52,6,16,22,85.0,80,7.43,89,437,2435,12.2,0.49516445
22106,22106,Phil Bourque,1989-90,27.0,6,43,80,80,17,26,43,153.0,,132,23,42,65,238.0,80,7.48,85,403,2430,12.3,0.49578962
22107,22107,Phil Bourque,1990-91,28.0,7,39,76,76,22,17,39,110.0,,208,45,59,104,348.0,80,7.37,76,367,2421,12.2,0.45450404
22108,22108,Phil Bourque,1991-92,29.0,8,34,78,78,20,14,34,122.0,,286,65,73,138,470.0,80,6.91,71,366,2385,11.6,0.38775697
22109,22109,Phil Bourque,1992-93,30.0,9,26,58,58,10,16,26,51.0,,344,75,89,164,521.0,80,6.96,77,402,2440,11.4,0.35467613
22110,22110,Phil Bourque,1993-94,31.0,10,20,55,55,6,14,20,71.0,,399,81,103,184,592.0,84,7.25,87,443,2603,11.7,0.33599278
22111,22111,Phil Bourque,1994-95,32.0,11,6,27,27,2,4,6,21.0,,426,83,107,190,613.0,84,6.48,76,407,2545,10.7,0.2354753
22112,22112,Phil Bourque,1995-96,33.0,12,7,38,38,4,3,7,34.0,,464,87,110,197,647.0,48,5.97,37,209,1408,10.2,0.22837478
22113,22113,Phil Bourque,1996-97,34.0,13,2,13,13,1,1,2,12.0,,477,88,111,199,659.0,82,6.29,74,413,2481,10.4,0.18581739
22114,22114,Phil Crowe,1994-95,24.0,2,2,31,31,0,2,2,5.0,,31,0,2,2,5.0,84,6.48,76,407,2545,10.7,0.12373927
22115,22115,Phil Crowe,1996-97,26.0,3,2,16,16,1,1,2,6.0,,47,1,3,4,11.0,82,6.29,74,413,2481,10.4,0.1544581
22116,22116,Phil Crowe,1997-98,27.0,4,1,26,26,0,1,1,8.0,,73,1,4,5,19.0,82,5.83,55,336,2444,9.8,0.08912557
22117,22117,Phil Crowe,1998-99,28.0,5,3,9,9,3,0,3,6.0,,82,4,4,8,25.0,82,5.28,57,380,2242,9.6,0.18951601
22118,22118,Phil Crowe,1999-00,29.0,6,1,8,8,0,1,1,2.0,33.0,90,4,5,9,27.0,82,5.27,57,359,2285,9.4,0.13486657
22119,22119,Phil Crowe,2000-01,30.0,7,0,4,4,0,0,0,1.0,16.0,94,4,5,9,28.0,82,5.49,53,331,2294,9.8,0.11792469
22120,22120,Phil Housley,1983-84,19.0,2,66,77,77,19,47,66,183.0,,77,19,47,66,183.0,80,7.73,71,310,2444,12.7,0.8830131
22121,22121,Phil Housley,1984-85,20.0,3,77,75,75,31,46,77,235.0,,152,50,93,143,418.0,80,7.89,74,336,2448,12.9,0.9749311
22122,22122,Phil Housley,1985-86,21.0,4,69,73,73,16,53,69,189.0,,225,66,146,212,607.0,80,7.77,71,321,2447,12.7,0.8995433
22123,22123,Phil Housley,1986-87,22.0,5,62,79,79,15,47,62,180.0,,304,81,193,274,787.0,80,7.94,82,370,2484,12.8,0.7872175
22124,22124,Phil Housley,1987-88,23.0,6,67,78,78,21,46,67,200.0,,382,102,239,341,987.0,80,7.34,72,344,2400,12.2,0.9629143
22125,22125,Phil Housley,1988-89,24.0,7,66,74,74,29,37,66,231.0,,456,131,276,407,1218.0,80,7.43,89,437,2435,12.2,0.9764222
22126,22126,Phil Housley,1989-90,25.0,8,70,72,72,26,44,70,178.0,,528,157,320,477,1396.0,80,7.48,85,403,2430,12.3,0.9501364
22127,22127,Phil Housley,1990-91,26.0,9,81,80,80,21,60,81,201.0,,608,178,380,558,1597.0,80,7.37,76,367,2421,12.2,0.9582466
22128,22128,Phil Housley,1991-92,27.0,10,76,78,78,23,53,76,206.0,,686,201,433,634,1803.0,80,6.91,71,366,2385,11.6,0.92704344
22129,22129,Phil Housley,1992-93,28.0,11,86,74,74,23,63,86,234.0,,760,224,496,720,2037.0,80,6.96,77,402,2440,11.4,1.1564
22130,22130,Phil Housley,1993-94,29.0,12,97,80,80,18,79,97,249.0,,840,242,575,817,2286.0,84,7.25,87,443,2603,11.7,1.0044413
22131,22131,Phil Housley,1994-95,30.0,13,22,26,26,7,15,22,60.0,,866,249,590,839,2346.0,84,6.48,76,407,2545,10.7,0.8683238
22132,22132,Phil Housley,1995-96,31.0,14,43,43,43,8,35,43,135.0,,909,257,625,882,2481.0,48,5.97,37,209,1408,10.2,0.954741
22133,22133,Phil Housley,1996-97,32.0,15,68,81,81,17,51,68,205.0,,990,274,676,950,2686.0,82,6.29,74,413,2481,10.4,0.7397339
22134,22134,Phil Housley,1997-98,33.0,16,40,77,77,11,29,40,167.0,,1067,285,705,990,2853.0,82,5.83,55,336,2444,9.8,0.50299233
22135,22135,Phil Housley,1998-99,34.0,17,31,64,64,6,25,31,116.0,,1131,291,730,1021,2969.0,82,5.28,57,380,2242,9.6,0.5322964
22136,22136,Phil Housley,1999-00,35.0,18,54,79,79,11,43,54,193.0,1648.0,1210,302,773,1075,3162.0,82,5.27,57,359,2285,9.4,0.68052995
22137,22137,Phil Housley,2000-01,36.0,19,55,78,78,11,44,55,176.0,1832.0,1288,313,817,1130,3338.0,82,5.49,53,331,2294,9.8,0.61335427
22138,22138,Phil Housley,2001-02,37.0,20,34,69,69,4,30,34,115.0,1253.0,1357,317,847,1164,3453.0,82,5.51,63,376,2272,9.9,0.38540426
22139,22139,Phil Housley,2002-03,38.0,21,39,80,80,15,24,39,218.0,1741.0,1437,332,871,1203,3671.0,82,5.24,53,338,2262,9.5,0.54099286
22140,22140,Phil Housley,2003-04,39.0,22,29,58,58,6,23,29,137.0,1121.0,1495,338,894,1232,3808.0,82,5.31,60,363,2326,9.4,0.51068085
22141,22141,Phil Kessel,2007-08,20.0,2,29,70,70,11,18,29,170.0,984.0,70,11,18,29,170.0,82,5.76,70,398,2426,9.7,0.4965342
22142,22142,Phil Kessel,2008-09,21.0,3,37,82,82,19,18,37,213.0,1249.0,152,30,36,66,383.0,82,5.44,62,351,2383,9.4,0.6038937
22143,22143,Phil Kessel,2009-10,22.0,4,60,70,70,36,24,60,232.0,1159.0,222,66,60,126,615.0,82,5.7,65,341,2477,9.4,0.8234845
22144,22144,Phil Kessel,2010-11,23.0,5,55,70,70,30,25,55,297.0,1368.0,292,96,85,181,912.0,82,5.53,56,304,2486,9.1,0.76950514
22145,22145,Phil Kessel,2011-12,24.0,6,64,82,82,32,32,64,325.0,1611.0,374,128,117,245,1237.0,82,5.46,52,291,2492,9.0,0.7775351
22146,22146,Phil Kessel,2012-13,25.0,7,82,82,82,37,45,82,295.0,1645.0,456,165,162,327,1532.0,82,5.32,47,271,2439,8.9,0.91710234
22147,22147,Phil Kessel,2013-14,26.0,8,52,48,48,20,32,52,161.0,951.0,504,185,194,379,1693.0,48,5.31,29,160,1399,9.1,1.0178885
22148,22148,Phil Kessel,2014-15,27.0,9,80,82,82,37,43,80,305.0,1695.0,586,222,237,459,1998.0,82,5.34,48,269,2463,8.9,0.86600506
22149,22149,Phil Kessel,2015-16,28.0,10,61,82,82,25,36,61,280.0,1541.0,668,247,273,520,2278.0,82,5.32,47,251,2453,8.9,0.7572905
22150,22150,Phil Kessel,2016-17,29.0,11,59,82,82,26,33,59,274.0,1507.0,750,273,306,579,2552.0,82,5.34,48,255,2438,9.0,0.7397287
22151,22151,Phil Kessel,2017-18,30.0,12,70,82,82,23,47,70,229.0,1471.0,832,296,353,649,2781.0,82,5.45,47,245,2478,9.0,0.8576017
22152,22152,Phil Kessel,2018-19,31.0,13,92,82,82,34,58,92,261.0,1532.0,914,330,411,741,3042.0,82,5.86,50,250,2620,9.2,0.96898615
22153,22153,Phil Kessel,2019-20,32.0,14,82,82,82,27,55,82,215.0,1474.0,996,357,466,823,3257.0,82,5.96,47,239,2579,9.5,0.8081127
22154,22154,Phil Kessel,2020-21,33.0,15,38,70,70,14,24,38,153.0,1200.0,1066,371,490,861,3410.0,70,5.96,42,208,2192,9.5,0.5361589
22155,22155,Phil Oreskovic,2009-10,23.0,2,2,10,10,1,1,2,12.0,162.0,10,1,1,2,12.0,82,5.7,65,341,2477,9.4,0.2373414
22156,22156,Phil Sykes,1983-84,24.0,2,2,7,7,2,0,2,5.0,,7,2,0,2,5.0,80,7.73,71,310,2444,12.7,0.33662912
22157,22157,Phil Sykes,1984-85,25.0,3,0,3,3,0,0,0,2.0,,10,2,0,2,7.0,80,7.89,74,336,2448,12.9,0.20270863
22158,22158,Phil Sykes,1985-86,26.0,4,32,79,79,17,15,32,97.0,,89,19,15,34,104.0,80,7.77,71,321,2447,12.7,0.43626955
22159,22159,Phil Sykes,1986-87,27.0,5,44,76,76,20,24,44,132.0,,165,39,39,78,236.0,80,7.94,82,370,2484,12.8,0.5052338
22160,22160,Phil Sykes,1987-88,28.0,6,21,58,58,6,15,21,62.0,,223,45,54,99,298.0,80,7.34,72,344,2400,12.2,0.34239623
22161,22161,Phil Sykes,1988-89,29.0,7,21,40,40,9,12,21,61.0,,263,54,66,120,359.0,80,7.43,89,437,2435,12.2,0.43605587
22162,22162,Phil Sykes,1989-90,30.0,8,1,23,23,0,1,1,5.0,,286,54,67,121,364.0,80,7.48,85,403,2430,12.3,0.19329277
22163,22163,Phil Sykes,1990-91,31.0,9,15,48,48,9,6,15,50.0,,334,63,73,136,414.0,80,7.37,76,367,2421,12.2,0.28625506
22164,22164,Phil Sykes,1991-92,32.0,10,22,70,70,12,10,22,65.0,,404,75,83,158,479.0,80,6.91,71,366,2385,11.6,0.25699008
22165,22165,Phil Sykes,1992-93,33.0,11,6,52,52,4,2,6,34.0,,456,79,85,164,513.0,80,6.96,77,402,2440,11.4,0.18941212
22166,22166,Phil Varone,2014-15,24.0,2,2,9,9,1,1,2,15.0,103.0,9,1,1,2,15.0,82,5.34,48,269,2463,8.9,0.21409205
22167,22167,Phil Varone,2015-16,25.0,3,5,28,28,3,2,5,28.0,376.0,37,4,3,7,43.0,82,5.32,47,251,2453,8.9,0.20739868
22168,22168,Phil Varone,2016-17,26.0,4,3,6,6,1,2,3,2.0,51.0,43,5,5,10,45.0,82,5.34,48,255,2438,9.0,0.1819692
22169,22169,Phil Varone,2017-18,27.0,5,0,7,7,0,0,0,1.0,56.0,50,5,5,10,46.0,82,5.45,47,245,2478,9.0,0.13811052
22170,22170,Phil Varone,2019-20,29.0,6,7,47,47,3,4,7,34.0,372.0,97,8,9,17,80.0,82,5.96,47,239,2579,9.5,0.15424731
22171,22171,Phil Von Stefenelli,1996-97,27.0,2,4,27,27,0,4,4,20.0,,27,0,4,4,20.0,82,6.29,74,413,2481,10.4,0.1715028
22172,22172,Phil Von Stefenelli,1997-98,28.0,3,1,6,6,0,1,1,2.0,,33,0,5,5,22.0,82,5.83,55,336,2444,9.8,0.14314821
22173,22173,Philip Holm,2018-19,27.0,2,0,1,1,0,0,0,0.0,15.0,1,0,0,0,0.0,82,5.86,50,250,2620,9.2,0.1396032
22174,22174,Philip Larsen,2010-11,21.0,2,1,2,2,0,1,1,1.0,25.0,2,0,1,1,1.0,82,5.53,56,304,2486,9.1,0.24290621
22175,22175,Philip Larsen,2011-12,22.0,3,2,6,6,0,2,2,11.0,81.0,8,0,3,3,12.0,82,5.46,52,291,2492,9.0,0.2114569
22176,22176,Philip Larsen,2012-13,23.0,4,11,55,55,3,8,11,69.0,988.0,63,3,11,14,81.0,82,5.32,47,271,2439,8.9,0.23914671
22177,22177,Philip Larsen,2013-14,24.0,5,5,32,32,2,3,5,30.0,476.0,95,5,14,19,111.0,48,5.31,29,160,1399,9.1,0.24543923
22178,22178,Philip Larsen,2014-15,25.0,6,12,30,30,3,9,12,47.0,515.0,125,8,23,31,158.0,82,5.34,48,269,2463,8.9,0.2190673
22179,22179,Philip Larsen,2017-18,28.0,7,6,26,26,1,5,6,32.0,428.0,151,9,28,37,190.0,82,5.45,47,245,2478,9.0,0.16808438
22180,22180,Philip McRae,2011-12,21.0,2,3,15,15,1,2,3,13.0,136.0,15,1,2,3,13.0,82,5.46,52,291,2492,9.0,0.2543942
22181,22181,Philip Samuelsson,2014-15,23.0,2,0,5,5,0,0,0,5.0,78.0,5,0,0,0,5.0,82,5.34,48,269,2463,8.9,0.17318648
22182,22182,Philip Samuelsson,2015-16,24.0,3,0,4,4,0,0,0,4.0,68.0,9,0,0,0,9.0,82,5.32,47,251,2453,8.9,0.16434428
22183,22183,Philip Samuelsson,2016-17,25.0,4,0,4,4,0,0,0,5.0,64.0,13,0,0,0,14.0,82,5.34,48,255,2438,9.0,0.15615934
22184,22184,Philippe Audet,1999-00,22.0,2,0,4,4,0,0,0,3.0,17.0,4,0,0,0,3.0,82,5.27,57,359,2285,9.4,0.18884975
22185,22185,Philippe Boucher,1993-94,20.0,2,4,18,18,0,4,4,28.0,,18,0,4,4,28.0,84,7.25,87,443,2603,11.7,0.3070038
22186,22186,Philippe Boucher,1994-95,21.0,3,14,38,38,6,8,14,67.0,,56,6,12,18,95.0,84,6.48,76,407,2545,10.7,0.37147725
22187,22187,Philippe Boucher,1995-96,22.0,4,6,15,15,2,4,6,30.0,,71,8,16,24,125.0,48,5.97,37,209,1408,10.2,0.3826074
22188,22188,Philippe Boucher,1996-97,23.0,5,23,53,53,7,16,23,145.0,,124,15,32,47,270.0,82,6.29,74,413,2481,10.4,0.45180085
22189,22189,Philippe Boucher,1997-98,24.0,6,25,60,60,7,18,25,159.0,,184,22,50,72,429.0,82,5.83,55,336,2444,9.8,0.41857857
22190,22190,Philippe Boucher,1998-99,25.0,7,16,45,45,6,10,16,80.0,,229,28,60,88,509.0,82,5.28,57,380,2242,9.6,0.33976948
22191,22191,Philippe Boucher,1999-00,26.0,8,8,45,45,2,6,8,87.0,803.0,274,30,66,96,596.0,82,5.27,57,359,2285,9.4,0.22884762
22192,22192,Philippe Boucher,2000-01,27.0,9,0,1,1,0,0,0,3.0,17.0,275,30,66,96,599.0,82,5.49,53,331,2294,9.8,0.2524758
22193,22193,Philippe Boucher,2001-02,28.0,10,6,22,22,2,4,6,40.0,405.0,297,32,70,102,639.0,82,5.51,63,376,2272,9.9,0.23781896
22194,22194,Philippe Boucher,2002-03,29.0,11,30,80,80,7,23,30,198.0,1727.0,377,39,93,132,837.0,82,5.24,53,338,2262,9.5,0.43712166
22195,22195,Philippe Boucher,2003-04,30.0,12,27,80,80,7,20,27,137.0,1639.0,457,46,113,159,974.0,82,5.31,60,363,2326,9.4,0.341485
22196,22196,Philippe Boucher,2004-05,31.0,13,24,70,70,8,16,24,134.0,1568.0,527,54,129,183,1108.0,82,5.14,57,348,2300,9.2,0.39471895
22197,22197,Philippe Boucher,2006-07,33.0,14,43,66,66,16,27,43,174.0,1545.0,593,70,156,226,1282.0,82,6.05,85,480,2458,10.1,0.5509665
22198,22198,Philippe Boucher,2007-08,34.0,15,51,76,76,19,32,51,222.0,1740.0,669,89,188,277,1504.0,82,5.76,70,398,2426,9.7,0.51539475
22199,22199,Philippe Boucher,2008-09,35.0,16,14,38,38,2,12,14,72.0,817.0,707,91,200,291,1576.0,82,5.44,62,351,2383,9.4,0.24968648
22200,22200,Philippe Boucher,2009-10,36.0,17,9,41,41,3,6,9,66.0,824.0,748,94,206,300,1642.0,82,5.7,65,341,2477,9.4,0.19120619
22201,22201,Philippe Bozon,1992-93,26.0,2,4,9,9,1,3,4,19.0,,9,1,3,4,19.0,80,6.96,77,402,2440,11.4,0.26492906
22202,22202,Philippe Bozon,1993-94,27.0,3,12,54,54,6,6,12,90.0,,63,7,9,16,109.0,84,7.25,87,443,2603,11.7,0.28041947
22203,22203,Philippe Bozon,1994-95,28.0,4,25,80,80,9,16,25,118.0,,143,16,25,41,227.0,84,6.48,76,407,2545,10.7,0.27115625
22204,22204,Philippe Bozon,1995-96,29.0,5,0,1,1,0,0,0,0.0,,144,16,25,41,227.0,48,5.97,37,209,1408,10.2,0.15767002
22205,22205,Philippe Cornet,2012-13,22.0,2,1,2,2,0,1,1,0.0,21.0,2,0,1,1,0.0,82,5.32,47,271,2439,8.9,0.19065946
22206,22206,Philippe Dupuis,2009-10,24.0,2,0,8,8,0,0,0,11.0,76.0,8,0,0,0,11.0,82,5.7,65,341,2477,9.4,0.18105423
22207,22207,Philippe Dupuis,2010-11,25.0,3,1,4,4,0,1,1,4.0,33.0,12,0,1,1,15.0,82,5.53,56,304,2486,9.1,0.17876673
22208,22208,Philippe Dupuis,2011-12,26.0,4,17,74,74,6,11,17,101.0,674.0,86,6,12,18,116.0,82,5.46,52,291,2492,9.0,0.25170147
22209,22209,Philippe Dupuis,2012-13,27.0,5,0,30,30,0,0,0,30.0,315.0,116,6,12,18,146.0,82,5.32,47,271,2439,8.9,0.15027225
22210,22210,Philippe Myers,2019-20,23.0,2,2,21,21,1,1,2,25.0,323.0,21,1,1,2,25.0,82,5.96,47,239,2579,9.5,0.22415426
22211,22211,Philippe Myers,2020-21,24.0,3,16,50,50,4,12,16,78.0,855.0,71,5,13,18,103.0,70,5.96,42,208,2192,9.5,0.3337477
22212,22212,Phillip Danault,2015-16,22.0,2,0,2,2,0,0,0,2.0,19.0,2,0,0,0,2.0,82,5.32,47,251,2453,8.9,0.17298314
22213,22213,Phillip Danault,2016-17,23.0,3,10,51,51,4,6,10,72.0,651.0,53,4,6,10,74.0,82,5.34,48,255,2438,9.0,0.27691776
22214,22214,Phillip Danault,2017-18,24.0,4,40,82,82,13,27,40,133.0,1278.0,135,17,33,50,207.0,82,5.45,47,245,2478,9.0,0.47438598
22215,22215,Phillip Danault,2018-19,25.0,5,25,52,52,8,17,25,94.0,863.0,187,25,50,75,301.0,82,5.86,50,250,2620,9.2,0.43318632
22216,22216,Phillip Danault,2019-20,26.0,6,53,81,81,12,41,53,132.0,1440.0,268,37,91,128,433.0,82,5.96,47,239,2579,9.5,0.6150201
22217,22217,Phillip Danault,2020-21,27.0,7,47,71,71,13,34,47,131.0,1338.0,339,50,125,175,564.0,70,5.96,42,208,2192,9.5,0.58966935
22218,22218,Phillip Di Giuseppe,2016-17,23.0,2,17,41,41,7,10,17,68.0,585.0,41,7,10,17,68.0,82,5.34,48,255,2438,9.0,0.3627211
22219,22219,Phillip Di Giuseppe,2017-18,24.0,3,7,36,36,1,6,7,68.0,443.0,77,8,16,24,136.0,82,5.45,47,245,2478,9.0,0.24872151
22220,22220,Phillip Di Giuseppe,2018-19,25.0,4,13,49,49,5,8,13,64.0,515.0,126,13,24,37,200.0,82,5.86,50,250,2620,9.2,0.24588102
22221,22221,Phillip Di Giuseppe,2019-20,26.0,5,4,24,24,1,3,4,31.0,243.0,150,14,27,41,231.0,82,5.96,47,239,2579,9.5,0.18790004
22222,22222,Phillip Di Giuseppe,2020-21,27.0,6,4,20,20,1,3,4,35.0,226.0,170,15,30,45,266.0,70,5.96,42,208,2192,9.5,0.21825054
22223,22223,Pierre Aubry,1981-82,21.0,2,0,1,1,0,0,0,0.0,,1,0,0,0,0.0,80,7.69,77,340,2441,12.6,0.216385
22224,22224,Pierre Aubry,1982-83,22.0,3,23,62,62,10,13,23,62.0,,63,10,13,23,62.0,80,8.03,73,320,2489,12.9,0.36093974
22225,22225,Pierre Aubry,1983-84,23.0,4,16,76,76,7,9,16,63.0,,139,17,22,39,125.0,80,7.73,71,310,2444,12.7,0.27204698
22226,22226,Pierre Aubry,1984-85,24.0,5,7,37,37,5,2,7,22.0,,176,22,24,46,147.0,80,7.89,74,336,2448,12.9,0.27243507
22227,22227,Pierre Aubry,1985-86,25.0,6,4,25,25,2,2,4,21.0,,201,24,26,50,168.0,80,7.77,71,321,2447,12.7,0.26870868
22228,22228,Pierre Dagenais,2001-02,23.0,2,5,9,9,3,2,5,20.0,111.0,9,3,2,5,20.0,82,5.51,63,376,2272,9.9,0.2878626
22229,22229,Pierre Dagenais,2002-03,24.0,3,14,42,42,10,4,14,77.0,462.0,51,13,6,19,97.0,82,5.24,53,338,2262,9.5,0.31218618
22230,22230,Pierre Dagenais,2003-04,25.0,4,0,9,9,0,0,0,5.0,54.0,60,13,6,19,102.0,82,5.31,60,363,2326,9.4,0.18299651
22231,22231,Pierre Dagenais,2004-05,26.0,5,27,50,50,17,10,27,149.0,694.0,110,30,16,46,251.0,82,5.14,57,348,2300,9.2,0.5400313
22232,22232,Pierre Dagenais,2006-07,28.0,6,12,32,32,5,7,12,74.0,317.0,142,35,23,58,325.0,82,6.05,85,480,2458,10.1,0.26917708
22233,22233,Pierre Engvall,2020-21,24.0,2,15,48,48,8,7,15,72.0,573.0,48,8,7,15,72.0,70,5.96,42,208,2192,9.5,0.3460276
22234,22234,Pierre Giroux,1983-84,28.0,2,1,6,6,1,0,1,1.0,,6,1,0,1,1.0,80,7.73,71,310,2444,12.7,0.23553991
22235,22235,Pierre Hedin,2004-05,26.0,2,1,3,3,0,1,1,4.0,58.0,3,0,1,1,4.0,82,5.14,57,348,2300,9.2,0.1828919
22236,22236,Pierre Lacroix,1980-81,21.0,2,30,76,76,9,21,30,86.0,,76,9,21,30,86.0,80,7.03,61,280,2352,12.0,0.45519274
22237,22237,Pierre Lacroix,1981-82,22.0,3,39,61,61,5,34,39,96.0,,137,14,55,69,182.0,80,7.69,77,340,2441,12.6,0.56028116
22238,22238,Pierre Lacroix,1982-83,23.0,4,27,68,68,4,23,27,73.0,,205,18,78,96,255.0,80,8.03,73,320,2489,12.9,0.38811252
22239,22239,Pierre Lacroix,1983-84,24.0,5,36,69,69,6,30,36,97.0,,274,24,108,132,352.0,80,7.73,71,310,2444,12.7,0.5051102
22240,22240,Pierre Rioux,1983-84,21.0,2,3,14,14,1,2,3,9.0,,14,1,2,3,9.0,80,7.73,71,310,2444,12.7,0.32224274
22241,22241,Pierre Sevigny,1994-95,23.0,2,9,43,43,4,5,9,19.0,,43,4,5,9,19.0,84,6.48,76,407,2545,10.7,0.18987256
22242,22242,Pierre Sevigny,1995-96,24.0,3,0,19,19,0,0,0,6.0,,62,4,5,9,25.0,48,5.97,37,209,1408,10.2,0.13880214
22243,22243,Pierre Sevigny,1997-98,26.0,4,0,13,13,0,0,0,1.0,,75,4,5,9,26.0,82,5.83,55,336,2444,9.8,0.119520575
22244,22244,Pierre Sevigny,1998-99,27.0,5,0,3,3,0,0,0,1.0,,78,4,5,9,27.0,82,5.28,57,380,2242,9.6,0.13625795
22245,22245,Pierre Turgeon,1988-89,19.0,2,42,76,76,14,28,42,101.0,,76,14,28,42,101.0,80,7.43,89,437,2435,12.2,0.63264096
22246,22246,Pierre Turgeon,1989-90,20.0,3,88,80,80,34,54,88,182.0,,156,48,82,130,283.0,80,7.48,85,403,2430,12.3,1.1182483
22247,22247,Pierre Turgeon,1990-91,21.0,4,106,80,80,40,66,106,193.0,,236,88,148,236,476.0,80,7.37,76,367,2421,12.2,1.2279413
22248,22248,Pierre Turgeon,1991-92,22.0,5,79,78,78,32,47,79,174.0,,314,120,195,315,650.0,80,6.91,71,366,2385,11.6,1.0623748
22249,22249,Pierre Turgeon,1992-93,23.0,6,95,77,77,40,55,95,207.0,,391,160,250,410,857.0,80,6.96,77,402,2440,11.4,1.2928816
22250,22250,Pierre Turgeon,1993-94,24.0,7,132,83,83,58,74,132,301.0,,474,218,324,542,1158.0,84,7.25,87,443,2603,11.7,1.2945325
22251,22251,Pierre Turgeon,1994-95,25.0,8,94,69,69,38,56,94,254.0,,543,256,380,636,1412.0,84,6.48,76,407,2545,10.7,1.1121945
22252,22252,Pierre Turgeon,1995-96,26.0,9,47,49,49,24,23,47,160.0,,592,280,403,683,1572.0,48,5.97,37,209,1408,10.2,1.2020752
22253,22253,Pierre Turgeon,1996-97,27.0,10,96,80,80,38,58,96,297.0,,672,318,461,779,1869.0,82,6.29,74,413,2481,10.4,1.072594
22254,22254,Pierre Turgeon,1997-98,28.0,11,85,78,78,26,59,85,216.0,,750,344,520,864,2085.0,82,5.83,55,336,2444,9.8,1.0638857
22255,22255,Pierre Turgeon,1998-99,29.0,12,68,60,60,22,46,68,140.0,,810,366,566,932,2225.0,82,5.28,57,380,2242,9.6,1.0613327
22256,22256,Pierre Turgeon,1999-00,30.0,13,65,67,67,31,34,65,193.0,1281.0,877,397,600,997,2418.0,82,5.27,57,359,2285,9.4,0.9584644
22257,22257,Pierre Turgeon,2000-01,31.0,14,66,52,52,26,40,66,139.0,999.0,929,423,640,1063,2557.0,82,5.49,53,331,2294,9.8,1.132782
22258,22258,Pierre Turgeon,2001-02,32.0,15,82,79,79,30,52,82,171.0,1488.0,1008,453,692,1145,2728.0,82,5.51,63,376,2272,9.9,0.83767086
22259,22259,Pierre Turgeon,2002-03,33.0,16,47,66,66,15,32,47,121.0,1090.0,1074,468,724,1192,2849.0,82,5.24,53,338,2262,9.5,0.6571127
22260,22260,Pierre Turgeon,2003-04,34.0,17,42,65,65,12,30,42,76.0,951.0,1139,480,754,1234,2925.0,82,5.31,60,363,2326,9.4,0.52306503
22261,22261,Pierre Turgeon,2004-05,35.0,18,40,76,76,15,25,40,104.0,1081.0,1215,495,779,1274,3029.0,82,5.14,57,348,2300,9.2,0.60105824
22262,22262,Pierre Turgeon,2006-07,37.0,19,46,62,62,16,30,46,94.0,793.0,1277,511,809,1320,3123.0,82,6.05,85,480,2458,10.1,0.54531616
22263,22263,Pierre Turgeon,2007-08,38.0,20,7,17,17,4,3,7,31.0,173.0,1294,515,812,1327,3154.0,82,5.76,70,398,2426,9.7,0.4649105
22264,22264,Pierre-Cedric Labrie,2012-13,26.0,2,2,14,14,0,2,2,5.0,83.0,14,0,2,2,5.0,82,5.32,47,271,2439,8.9,0.1587033
22265,22265,Pierre-Cedric Labrie,2013-14,27.0,3,3,19,19,2,1,3,16.0,163.0,33,2,3,5,21.0,48,5.31,29,160,1399,9.1,0.2057527
22266,22266,Pierre-Cedric Labrie,2014-15,28.0,4,0,13,13,0,0,0,2.0,89.0,46,2,3,5,23.0,82,5.34,48,269,2463,8.9,0.11655244
22267,22267,Pierre-Edouard Bellemare,2015-16,30.0,2,12,81,81,6,6,12,113.0,1039.0,81,6,6,12,113.0,82,5.32,47,251,2453,8.9,0.2054078
22268,22268,Pierre-Edouard Bellemare,2016-17,31.0,3,14,74,74,7,7,14,102.0,1004.0,155,13,13,26,215.0,82,5.34,48,255,2438,9.0,0.19768697
22269,22269,Pierre-Edouard Bellemare,2017-18,32.0,4,8,82,82,4,4,8,90.0,1064.0,237,17,17,34,305.0,82,5.45,47,245,2478,9.0,0.16153416
22270,22270,Pierre-Edouard Bellemare,2018-19,33.0,5,16,72,72,6,10,16,92.0,888.0,309,23,27,50,397.0,82,5.86,50,250,2620,9.2,0.21856493
22271,22271,Pierre-Edouard Bellemare,2019-20,34.0,6,15,76,76,6,9,15,108.0,945.0,385,29,36,65,505.0,82,5.96,47,239,2579,9.5,0.20908451
22272,22272,Pierre-Edouard Bellemare,2020-21,35.0,7,22,69,69,9,13,22,85.0,926.0,454,38,49,87,590.0,70,5.96,42,208,2192,9.5,0.27444232
22273,22273,Pierre-Luc Dubois,2018-19,20.0,2,48,82,82,20,28,48,165.0,1364.0,82,20,28,48,165.0,82,5.86,50,250,2620,9.2,0.6353122
22274,22274,Pierre-Luc Dubois,2019-20,21.0,3,61,82,82,27,34,61,174.0,1453.0,164,47,62,109,339.0,82,5.96,47,239,2579,9.5,0.754125
22275,22275,Pierre-Luc Dubois,2020-21,22.0,4,49,70,70,18,31,49,158.0,1255.0,234,65,93,158,497.0,70,5.96,42,208,2192,9.5,0.76050967
22276,22276,Pierre-Luc Letourneau-Leblond,2009-10,24.0,2,1,8,8,0,1,1,3.0,39.0,8,0,1,1,3.0,82,5.7,65,341,2477,9.4,0.1839855
22277,22277,Pierre-Luc Letourneau-Leblond,2010-11,25.0,3,2,27,27,0,2,2,9.0,149.0,35,0,3,3,12.0,82,5.53,56,304,2486,9.1,0.11350757
22278,22278,Pierre-Luc Letourneau-Leblond,2011-12,26.0,4,0,2,2,0,0,0,0.0,7.0,37,0,3,3,12.0,82,5.46,52,291,2492,9.0,0.12821147
22279,22279,Pierre-Luc Letourneau-Leblond,2012-13,27.0,5,0,3,3,0,0,0,3.0,15.0,40,0,3,3,15.0,82,5.32,47,271,2439,8.9,0.12167859
22280,22280,Pierre-Luc Letourneau-Leblond,2014-15,29.0,6,0,1,1,0,0,0,1.0,5.0,41,0,3,3,16.0,82,5.34,48,269,2463,8.9,0.11607152
22281,22281,Pierre-Marc Bouchard,2003-04,19.0,2,20,50,50,7,13,20,53.0,664.0,50,7,13,20,53.0,82,5.31,60,363,2326,9.4,0.39215297
22282,22282,Pierre-Marc Bouchard,2004-05,20.0,3,22,61,61,4,18,22,60.0,854.0,111,11,31,42,113.0,82,5.14,57,348,2300,9.2,0.4945659
22283,22283,Pierre-Marc Bouchard,2006-07,22.0,4,59,80,80,17,42,59,118.0,1220.0,191,28,73,101,231.0,82,6.05,85,480,2458,10.1,0.6790159
22284,22284,Pierre-Marc Bouchard,2007-08,23.0,5,57,82,82,20,37,57,173.0,1311.0,273,48,110,158,404.0,82,5.76,70,398,2426,9.7,0.7152572
22285,22285,Pierre-Marc Bouchard,2008-09,24.0,6,63,81,81,13,50,63,129.0,1364.0,354,61,160,221,533.0,82,5.44,62,351,2383,9.4,0.7435833
22286,22286,Pierre-Marc Bouchard,2009-10,25.0,7,46,71,71,16,30,46,142.0,1205.0,425,77,190,267,675.0,82,5.7,65,341,2477,9.4,0.575434
22287,22287,Pierre-Marc Bouchard,2010-11,26.0,8,0,1,1,0,0,0,0.0,11.0,426,77,190,267,675.0,82,5.53,56,304,2486,9.1,0.5723497
22288,22288,Pierre-Marc Bouchard,2011-12,27.0,9,38,59,59,12,26,38,98.0,927.0,485,89,216,305,773.0,82,5.46,52,291,2492,9.0,0.58246386
22289,22289,Pierre-Marc Bouchard,2012-13,28.0,10,22,37,37,9,13,22,84.0,604.0,522,98,229,327,857.0,82,5.32,47,271,2439,8.9,0.52913404
22290,22290,Pierre-Marc Bouchard,2013-14,29.0,11,20,43,43,8,12,20,71.0,600.0,565,106,241,347,928.0,48,5.31,29,160,1399,9.1,0.48208368
22291,22291,Pierre-Marc Bouchard,2014-15,30.0,12,9,28,28,4,5,9,51.0,391.0,593,110,246,356,979.0,82,5.34,48,269,2463,8.9,0.3289725
22292,22292,Pontus Aberg,2017-18,24.0,2,2,15,15,1,1,2,12.0,185.0,15,1,1,2,12.0,82,5.45,47,245,2478,9.0,0.20261666
22293,22293,Pontus Aberg,2018-19,25.0,3,16,53,53,4,12,16,70.0,645.0,68,5,13,18,82.0,82,5.86,50,250,2620,9.2,0.28001988
22294,22294,Pontus Aberg,2019-20,26.0,4,25,59,59,12,13,25,101.0,861.0,127,17,26,43,183.0,82,5.96,47,239,2579,9.5,0.36701363
22295,22295,Pontus Aberg,2020-21,27.0,5,1,5,5,0,1,1,4.0,44.0,132,17,27,44,187.0,70,5.96,42,208,2192,9.5,0.1889807
22296,22296,Prestin Ryan,2006-07,26.0,2,0,1,1,0,0,0,0.0,8.0,1,0,0,0,0.0,82,6.05,85,480,2458,10.1,0.14312965
22297,22297,Quinn Hughes,2019-20,20.0,2,3,5,5,0,3,3,6.0,90.0,5,0,3,3,6.0,82,5.96,47,239,2579,9.5,0.29746267
22298,22298,Quinn Hughes,2020-21,21.0,3,53,68,68,8,45,53,126.0,1488.0,73,8,48,56,132.0,70,5.96,42,208,2192,9.5,0.726658
22299,22299,Quintin Laing,2004-05,25.0,2,1,3,3,0,1,1,3.0,36.0,3,0,1,1,3.0,82,5.14,57,348,2300,9.2,0.17582637
22300,22300,Quintin Laing,2008-09,29.0,3,6,39,39,1,5,6,48.0,451.0,42,1,6,7,51.0,82,5.44,62,351,2383,9.4,0.17106554
22301,22301,Quintin Laing,2009-10,30.0,4,0,1,1,0,0,0,2.0,10.0,43,1,6,7,53.0,82,5.7,65,341,2477,9.4,0.13643542
22302,22302,Quintin Laing,2010-11,31.0,5,4,36,36,2,2,4,38.0,347.0,79,3,8,11,91.0,82,5.53,56,304,2486,9.1,0.1619133
22303,22303,Quinton Howden,2013-14,22.0,2,0,18,18,0,0,0,22.0,188.0,18,0,0,0,22.0,48,5.31,29,160,1399,9.1,0.20488933
22304,22304,Quinton Howden,2014-15,23.0,3,6,16,16,4,2,6,23.0,220.0,34,4,2,6,45.0,82,5.34,48,269,2463,8.9,0.29831803
22305,22305,Quinton Howden,2016-17,25.0,4,11,58,58,6,5,11,54.0,602.0,92,10,7,17,99.0,82,5.34,48,255,2438,9.0,0.21084505
22306,22306,Quinton Howden,2017-18,26.0,5,0,5,5,0,0,0,5.0,43.0,97,10,7,17,104.0,82,5.45,47,245,2478,9.0,0.16992894
22307,22307,R.J. Umberger,2006-07,24.0,2,38,73,73,20,18,38,138.0,966.0,73,20,18,38,138.0,82,6.05,85,480,2458,10.1,0.47163323
22308,22308,R.J. Umberger,2007-08,25.0,3,28,81,81,16,12,28,134.0,1178.0,154,36,30,66,272.0,82,5.76,70,398,2426,9.7,0.40807655
22309,22309,R.J. Umberger,2008-09,26.0,4,50,74,74,13,37,50,173.0,1322.0,228,49,67,116,445.0,82,5.44,62,351,2383,9.4,0.63078684
22310,22310,R.J. Umberger,2009-10,27.0,5,46,82,82,26,20,46,234.0,1539.0,310,75,87,162,679.0,82,5.7,65,341,2477,9.4,0.5907319
22311,22311,R.J. Umberger,2010-11,28.0,6,55,82,82,23,32,55,221.0,1572.0,392,98,119,217,900.0,82,5.53,56,304,2486,9.1,0.6324852
22312,22312,R.J. Umberger,2011-12,29.0,7,57,82,82,25,32,57,220.0,1576.0,474,123,151,274,1120.0,82,5.46,52,291,2492,9.0,0.6385812
22313,22313,R.J. Umberger,2012-13,30.0,8,40,77,77,20,20,40,200.0,1401.0,551,143,171,314,1320.0,82,5.32,47,271,2439,8.9,0.5258328
22314,22314,R.J. Umberger,2013-14,31.0,9,18,48,48,8,10,18,96.0,887.0,599,151,181,332,1416.0,48,5.31,29,160,1399,9.1,0.43182176
22315,22315,R.J. Umberger,2014-15,32.0,10,34,74,74,18,16,34,136.0,1197.0,673,169,197,366,1552.0,82,5.34,48,269,2463,8.9,0.3906161
22316,22316,R.J. Umberger,2015-16,33.0,11,15,67,67,9,6,15,96.0,926.0,740,178,203,381,1648.0,82,5.32,47,251,2453,8.9,0.25557372
22317,22317,R.J. Umberger,2016-17,34.0,12,11,39,39,2,9,11,48.0,396.0,779,180,212,392,1696.0,82,5.34,48,255,2438,9.0,0.23575017
22318,22318,Radek Bonk,1995-96,20.0,2,11,42,42,3,8,11,40.0,,42,3,8,11,40.0,48,5.97,37,209,1408,10.2,0.30479854
22319,22319,Radek Bonk,1996-97,21.0,3,35,76,76,16,19,35,161.0,,118,19,27,46,201.0,82,6.29,74,413,2481,10.4,0.5090375
22320,22320,Radek Bonk,1997-98,22.0,4,18,53,53,5,13,18,82.0,,171,24,40,64,283.0,82,5.83,55,336,2444,9.8,0.3906149
22321,22321,Radek Bonk,1998-99,23.0,5,16,65,65,7,9,16,93.0,,236,31,49,80,376.0,82,5.28,57,380,2242,9.6,0.3334477
22322,22322,Radek Bonk,1999-00,24.0,6,32,81,81,16,16,32,110.0,1112.0,317,47,65,112,486.0,82,5.27,57,359,2285,9.4,0.4655226
22323,22323,Radek Bonk,2000-01,25.0,7,60,80,80,23,37,60,167.0,1458.0,397,70,102,172,653.0,82,5.49,53,331,2294,9.8,0.70268905
22324,22324,Radek Bonk,2001-02,26.0,8,59,74,74,23,36,59,139.0,1352.0,471,93,138,231,792.0,82,5.51,63,376,2272,9.9,0.6926115
22325,22325,Radek Bonk,2002-03,27.0,9,70,82,82,25,45,70,170.0,1472.0,553,118,183,301,962.0,82,5.24,53,338,2262,9.5,0.8180096
22326,22326,Radek Bonk,2003-04,28.0,10,54,70,70,22,32,54,146.0,1228.0,623,140,215,355,1108.0,82,5.31,60,363,2326,9.4,0.6741673
22327,22327,Radek Bonk,2004-05,29.0,11,44,66,66,12,32,44,98.0,1164.0,689,152,247,399,1206.0,82,5.14,57,348,2300,9.2,0.5950793
22328,22328,Radek Bonk,2006-07,31.0,12,21,61,61,6,15,21,76.0,925.0,750,158,262,420,1282.0,82,6.05,85,480,2458,10.1,0.30868345
22329,22329,Radek Bonk,2007-08,32.0,13,23,74,74,13,10,23,111.0,1174.0,824,171,272,443,1393.0,82,5.76,70,398,2426,9.7,0.3162865
22330,22330,Radek Bonk,2008-09,33.0,14,29,79,79,14,15,29,138.0,1258.0,903,185,287,472,1531.0,82,5.44,62,351,2383,9.4,0.34361857
22331,22331,Radek Bonk,2009-10,34.0,15,25,66,66,9,16,25,102.0,1019.0,969,194,303,497,1633.0,82,5.7,65,341,2477,9.4,0.311827
22332,22332,Radek Dvorak,1996-97,19.0,2,27,77,77,13,14,27,126.0,,77,13,14,27,126.0,82,6.29,74,413,2481,10.4,0.41877824
22333,22333,Radek Dvorak,1997-98,20.0,3,39,78,78,18,21,39,139.0,,155,31,35,66,265.0,82,5.83,55,336,2444,9.8,0.54487616
22334,22334,Radek Dvorak,1998-99,21.0,4,36,64,64,12,24,36,112.0,,219,43,59,102,377.0,82,5.28,57,380,2242,9.6,0.56552863
22335,22335,Radek Dvorak,1999-00,22.0,5,43,82,82,19,24,43,182.0,1330.0,301,62,83,145,559.0,82,5.27,57,359,2285,9.4,0.6327962
22336,22336,Radek Dvorak,2000-01,23.0,6,50,81,81,18,32,50,157.0,1386.0,382,80,115,195,716.0,82,5.49,53,331,2294,9.8,0.66628397
22337,22337,Radek Dvorak,2001-02,24.0,7,67,82,82,31,36,67,230.0,1564.0,464,111,151,262,946.0,82,5.51,63,376,2272,9.9,0.8411057
22338,22338,Radek Dvorak,2002-03,25.0,8,37,65,65,17,20,37,210.0,1283.0,529,128,171,299,1156.0,82,5.24,53,338,2262,9.5,0.6365981
22339,22339,Radek Dvorak,2003-04,26.0,9,35,75,75,10,25,35,166.0,1183.0,604,138,196,334,1322.0,82,5.31,60,363,2326,9.4,0.48392755
22340,22340,Radek Dvorak,2004-05,27.0,10,50,78,78,15,35,50,188.0,1320.0,682,153,231,384,1510.0,82,5.14,57,348,2300,9.2,0.7243884
22341,22341,Radek Dvorak,2006-07,29.0,11,28,64,64,8,20,28,131.0,1060.0,746,161,251,412,1641.0,82,6.05,85,480,2458,10.1,0.43447965
22342,22342,Radek Dvorak,2007-08,30.0,12,37,82,82,10,27,37,139.0,1282.0,828,171,278,449,1780.0,82,5.76,70,398,2426,9.7,0.4322437
22343,22343,Radek Dvorak,2008-09,31.0,13,17,67,67,8,9,17,146.0,1013.0,895,179,287,466,1926.0,82,5.44,62,351,2383,9.4,0.30395883
22344,22344,Radek Dvorak,2009-10,32.0,14,36,81,81,15,21,36,136.0,1331.0,976,194,308,502,2062.0,82,5.7,65,341,2477,9.4,0.39237472
22345,22345,Radek Dvorak,2010-11,33.0,15,32,76,76,14,18,32,140.0,1325.0,1052,208,326,534,2202.0,82,5.53,56,304,2486,9.1,0.35179588
22346,22346,Radek Dvorak,2011-12,34.0,16,22,66,66,7,15,22,109.0,1061.0,1118,215,341,556,2311.0,82,5.46,52,291,2492,9.0,0.28838313
22347,22347,Radek Dvorak,2012-13,35.0,17,21,73,73,4,17,21,83.0,1042.0,1191,219,358,577,2394.0,82,5.32,47,271,2439,8.9,0.2444467
22348,22348,Radek Dvorak,2013-14,36.0,18,4,9,9,4,0,4,17.0,118.0,1200,223,358,581,2411.0,48,5.31,29,160,1399,9.1,0.3011024
22349,22349,Radek Dvorak,2014-15,37.0,19,9,60,60,4,5,9,52.0,638.0,1260,227,363,590,2463.0,82,5.34,48,269,2463,8.9,0.17863238
22350,22350,Radek Faksa,2016-17,23.0,2,12,45,45,5,7,12,67.0,556.0,45,5,7,12,67.0,82,5.34,48,255,2438,9.0,0.28631973
22351,22351,Radek Faksa,2017-18,24.0,3,33,80,80,12,21,33,132.0,1294.0,125,17,28,45,199.0,82,5.45,47,245,2478,9.0,0.4038493
22352,22352,Radek Faksa,2018-19,25.0,4,33,79,79,17,16,33,118.0,1206.0,204,34,44,78,317.0,82,5.86,50,250,2620,9.2,0.42874226
22353,22353,Radek Faksa,2019-20,26.0,5,30,81,81,15,15,30,114.0,1331.0,285,49,59,108,431.0,82,5.96,47,239,2579,9.5,0.41778603
22354,22354,Radek Faksa,2020-21,27.0,6,20,66,66,11,9,20,109.0,1049.0,351,60,68,128,540.0,70,5.96,42,208,2192,9.5,0.32743964
22355,22355,Radek Hamr,1993-94,19.0,2,0,4,4,0,0,0,2.0,,4,0,0,0,2.0,84,7.25,87,443,2603,11.7,0.26365224
22356,22356,Radek Hamr,1994-95,20.0,3,0,7,7,0,0,0,5.0,,11,0,0,0,7.0,84,6.48,76,407,2545,10.7,0.23034084
22357,22357,Radek Martinek,2002-03,26.0,2,5,23,23,1,4,5,25.0,486.0,23,1,4,5,25.0,82,5.24,53,338,2262,9.5,0.20659432
22358,22358,Radek Martinek,2003-04,27.0,3,13,66,66,2,11,13,67.0,1138.0,89,3,15,18,92.0,82,5.31,60,363,2326,9.4,0.18389192
22359,22359,Radek Martinek,2004-05,28.0,4,7,47,47,4,3,7,48.0,613.0,136,7,18,25,140.0,82,5.14,57,348,2300,9.2,0.18005651
22360,22360,Radek Martinek,2006-07,30.0,5,17,74,74,1,16,17,79.0,1351.0,210,8,34,42,219.0,82,6.05,85,480,2458,10.1,0.19639269
22361,22361,Radek Martinek,2007-08,31.0,6,17,43,43,2,15,17,44.0,856.0,253,10,49,59,263.0,82,5.76,70,398,2426,9.7,0.25516766
22362,22362,Radek Martinek,2008-09,32.0,7,15,69,69,0,15,15,98.0,1578.0,322,10,64,74,361.0,82,5.44,62,351,2383,9.4,0.19931662
22363,22363,Radek Martinek,2009-10,33.0,8,10,51,51,6,4,10,54.0,1099.0,373,16,68,84,415.0,82,5.7,65,341,2477,9.4,0.20068887
22364,22364,Radek Martinek,2010-11,34.0,9,3,16,16,2,1,3,24.0,365.0,389,18,69,87,439.0,82,5.53,56,304,2486,9.1,0.20852056
22365,22365,Radek Martinek,2011-12,35.0,10,16,64,64,3,13,16,97.0,1334.0,453,21,82,103,536.0,82,5.46,52,291,2492,9.0,0.22560683
22366,22366,Radek Martinek,2012-13,36.0,11,1,7,7,1,0,1,10.0,136.0,460,22,82,104,546.0,82,5.32,47,271,2439,8.9,0.16303545
22367,22367,Radek Martinek,2013-14,37.0,12,3,13,13,3,0,3,12.0,210.0,473,25,82,107,558.0,48,5.31,29,160,1399,9.1,0.24353147
22368,22368,Radek Martinek,2014-15,38.0,13,3,13,13,0,3,3,12.0,201.0,486,25,85,110,570.0,82,5.34,48,269,2463,8.9,0.17536101
22369,22369,Radek Smolenak,2009-10,23.0,2,1,6,6,0,1,1,14.0,50.0,6,0,1,1,14.0,82,5.7,65,341,2477,9.4,0.20605317
22370,22370,Radek Smolenak,2010-11,24.0,3,0,1,1,0,0,0,1.0,5.0,7,0,1,1,15.0,82,5.53,56,304,2486,9.1,0.16542035
22371,22371,Radim Bicanek,1995-96,21.0,2,0,6,6,0,0,0,6.0,,6,0,0,0,6.0,48,5.97,37,209,1408,10.2,0.21357235
22372,22372,Radim Bicanek,1997-98,23.0,3,1,21,21,0,1,1,27.0,,27,0,1,1,33.0,82,5.83,55,336,2444,9.8,0.18883768
22373,22373,Radim Bicanek,1998-99,24.0,4,0,1,1,0,0,0,0.0,,28,0,1,1,33.0,82,5.28,57,380,2242,9.6,0.15140653
22374,22374,Radim Bicanek,1999-00,25.0,5,0,14,14,0,0,0,13.0,188.0,42,0,1,1,46.0,82,5.27,57,359,2285,9.4,0.14794016
22375,22375,Radim Bicanek,2000-01,26.0,6,3,11,11,0,3,3,8.0,203.0,53,0,4,4,54.0,82,5.49,53,331,2294,9.8,0.13754085
22376,22376,Radim Bicanek,2001-02,27.0,7,2,9,9,0,2,2,11.0,154.0,62,0,6,6,65.0,82,5.51,63,376,2272,9.9,0.15773952
22377,22377,Radim Bicanek,2002-03,28.0,8,6,60,60,1,5,6,43.0,812.0,122,1,11,12,108.0,82,5.24,53,338,2262,9.5,0.12125775
22378,22378,Radim Simek,2019-20,27.0,2,9,41,41,1,8,9,41.0,624.0,41,1,8,9,41.0,82,5.96,47,239,2579,9.5,0.16889745
22379,22379,Radim Simek,2020-21,28.0,3,9,48,48,2,7,9,40.0,825.0,89,3,15,18,81.0,70,5.96,42,208,2192,9.5,0.19198027
22380,22380,Radim Vrbata,2002-03,21.0,2,30,52,52,18,12,30,112.0,756.0,52,18,12,30,112.0,82,5.24,53,338,2262,9.5,0.57531285
22381,22381,Radim Vrbata,2003-04,22.0,3,35,76,76,16,19,35,215.0,1108.0,128,34,31,65,327.0,82,5.31,60,363,2326,9.4,0.51514333
22382,22382,Radim Vrbata,2004-05,23.0,4,25,80,80,12,13,25,195.0,1096.0,208,46,44,90,522.0,82,5.14,57,348,2300,9.2,0.6317368
22383,22383,Radim Vrbata,2006-07,25.0,5,39,61,61,15,24,39,185.0,909.0,269,61,68,129,707.0,82,6.05,85,480,2458,10.1,0.6100047
22384,22384,Radim Vrbata,2007-08,26.0,6,41,77,77,14,27,41,215.0,1300.0,346,75,95,170,922.0,82,5.76,70,398,2426,9.7,0.56610465
22385,22385,Radim Vrbata,2008-09,27.0,7,56,76,76,27,29,56,246.0,1383.0,422,102,124,226,1168.0,82,5.44,62,351,2383,9.4,0.6615942
22386,22386,Radim Vrbata,2009-10,28.0,8,6,18,18,3,3,6,41.0,256.0,440,105,127,232,1209.0,82,5.7,65,341,2477,9.4,0.36808136
22387,22387,Radim Vrbata,2010-11,29.0,9,43,82,82,24,19,43,266.0,1330.0,522,129,146,275,1475.0,82,5.53,56,304,2486,9.1,0.5894846
22388,22388,Radim Vrbata,2011-12,30.0,10,48,79,79,19,29,48,240.0,1293.0,601,148,175,323,1715.0,82,5.46,52,291,2492,9.0,0.5817019
22389,22389,Radim Vrbata,2012-13,31.0,11,62,77,77,35,27,62,232.0,1435.0,678,183,202,385,1947.0,82,5.32,47,271,2439,8.9,0.70268655
22390,22390,Radim Vrbata,2013-14,32.0,12,28,34,34,12,16,28,106.0,623.0,712,195,218,413,2053.0,48,5.31,29,160,1399,9.1,0.66867286
22391,22391,Radim Vrbata,2014-15,33.0,13,51,80,80,20,31,51,263.0,1437.0,792,215,249,464,2316.0,82,5.34,48,269,2463,8.9,0.6012009
22392,22392,Radim Vrbata,2015-16,34.0,14,63,79,79,31,32,63,267.0,1312.0,871,246,281,527,2583.0,82,5.32,47,251,2453,8.9,0.6430526
22393,22393,Radim Vrbata,2016-17,35.0,15,27,63,63,13,14,27,199.0,1011.0,934,259,295,554,2782.0,82,5.34,48,255,2438,9.0,0.43089792
22394,22394,Radim Vrbata,2017-18,36.0,16,55,81,81,20,35,55,233.0,1369.0,1015,279,330,609,3015.0,82,5.45,47,245,2478,9.0,0.5858538
22395,22395,Radim Vrbata,2018-19,37.0,17,14,42,42,5,9,14,88.0,542.0,1057,284,339,623,3103.0,82,5.86,50,250,2620,9.2,0.32075298
22396,22396,Radko Gudas,2013-14,23.0,2,5,22,22,2,3,5,31.0,374.0,22,2,3,5,31.0,48,5.31,29,160,1399,9.1,0.29959416
22397,22397,Radko Gudas,2014-15,24.0,3,22,73,73,3,19,22,114.0,1396.0,95,5,22,27,145.0,82,5.34,48,269,2463,8.9,0.28664368
22398,22398,Radko Gudas,2015-16,25.0,4,5,31,31,2,3,5,63.0,527.0,126,7,25,32,208.0,82,5.32,47,251,2453,8.9,0.21917742
22399,22399,Radko Gudas,2016-17,26.0,5,14,76,76,5,9,14,150.0,1508.0,202,12,34,46,358.0,82,5.34,48,255,2438,9.0,0.24311519
22400,22400,Radko Gudas,2017-18,27.0,6,23,67,67,6,17,23,113.0,1293.0,269,18,51,69,471.0,82,5.45,47,245,2478,9.0,0.29281157
22401,22401,Radko Gudas,2018-19,28.0,7,16,70,70,2,14,16,142.0,1197.0,339,20,65,85,613.0,82,5.86,50,250,2620,9.2,0.2609172
22402,22402,Radko Gudas,2019-20,29.0,8,20,77,77,4,16,20,136.0,1376.0,416,24,81,105,749.0,82,5.96,47,239,2579,9.5,0.2834856
22403,22403,Radko Gudas,2020-21,30.0,9,15,63,63,2,13,15,90.0,1054.0,479,26,94,120,839.0,70,5.96,42,208,2192,9.5,0.24865806
22404,22404,Radoslav Hecl,2003-04,29.0,2,0,14,14,0,0,0,3.0,140.0,14,0,0,0,3.0,82,5.31,60,363,2326,9.4,0.13064644
22405,22405,Radoslav Suchy,2000-01,24.0,2,6,60,60,0,6,6,36.0,909.0,60,0,6,6,36.0,82,5.49,53,331,2294,9.8,0.13950524
22406,22406,Radoslav Suchy,2001-02,25.0,3,10,72,72,0,10,10,33.0,1235.0,132,0,16,16,69.0,82,5.51,63,376,2272,9.9,0.123158306
22407,22407,Radoslav Suchy,2002-03,26.0,4,17,81,81,4,13,17,49.0,1465.0,213,4,29,33,118.0,82,5.24,53,338,2262,9.5,0.17002827
22408,22408,Radoslav Suchy,2003-04,27.0,5,9,77,77,1,8,9,48.0,1265.0,290,5,37,42,166.0,82,5.31,60,363,2326,9.4,0.1381453
22409,22409,Radoslav Suchy,2004-05,28.0,6,21,82,82,7,14,21,82.0,1613.0,372,12,51,63,248.0,82,5.14,57,348,2300,9.2,0.24925897
22410,22410,Radoslav Suchy,2006-07,30.0,7,8,79,79,1,7,8,33.0,1574.0,451,13,58,71,281.0,82,6.05,85,480,2458,10.1,0.1278536
22411,22411,Radovan Somik,2003-04,26.0,2,18,60,60,8,10,18,95.0,949.0,60,8,10,18,95.0,82,5.31,60,363,2326,9.4,0.30566913
22412,22412,Radovan Somik,2004-05,27.0,3,14,53,53,4,10,14,41.0,584.0,113,12,20,32,136.0,82,5.14,57,348,2300,9.2,0.23842487
22413,22413,Raffi Torres,2002-03,21.0,2,1,14,14,0,1,1,9.0,106.0,14,0,1,1,9.0,82,5.24,53,338,2262,9.5,0.21098521
22414,22414,Raffi Torres,2003-04,22.0,3,5,17,17,0,5,5,12.0,130.0,31,0,6,6,21.0,82,5.31,60,363,2326,9.4,0.19605964
22415,22415,Raffi Torres,2004-05,23.0,4,34,80,80,20,14,34,136.0,1011.0,111,20,20,40,157.0,82,5.14,57,348,2300,9.2,0.5827146
22416,22416,Raffi Torres,2006-07,25.0,5,41,82,82,27,14,41,164.0,1099.0,193,47,34,81,321.0,82,6.05,85,480,2458,10.1,0.52776253
22417,22417,Raffi Torres,2007-08,26.0,6,34,82,82,15,19,34,154.0,1175.0,275,62,53,115,475.0,82,5.76,70,398,2426,9.7,0.44905567
22418,22418,Raffi Torres,2008-09,27.0,7,11,32,32,5,6,11,87.0,544.0,307,67,59,126,562.0,82,5.44,62,351,2383,9.4,0.35698837
22419,22419,Raffi Torres,2009-10,28.0,8,20,51,51,12,8,20,74.0,617.0,358,79,67,146,636.0,82,5.7,65,341,2477,9.4,0.37873414
22420,22420,Raffi Torres,2010-11,29.0,9,36,74,74,19,17,36,120.0,1001.0,432,98,84,182,756.0,82,5.53,56,304,2486,9.1,0.40970993
22421,22421,Raffi Torres,2011-12,30.0,10,29,80,80,14,15,29,115.0,999.0,512,112,99,211,871.0,82,5.46,52,291,2492,9.0,0.34345636
22422,22422,Raffi Torres,2012-13,31.0,11,26,79,79,15,11,26,99.0,898.0,591,127,110,237,970.0,82,5.32,47,271,2439,8.9,0.32048488
22423,22423,Raffi Torres,2013-14,32.0,12,18,39,39,7,11,18,60.0,518.0,630,134,121,255,1030.0,48,5.31,29,160,1399,9.1,0.43160272
22424,22424,Raffi Torres,2014-15,33.0,13,5,5,5,3,2,5,9.0,52.0,635,137,123,260,1039.0,82,5.34,48,269,2463,8.9,0.25549442
22425,22425,Raimo Helminen,1986-87,22.0,2,40,66,66,10,30,40,125.0,,66,10,30,40,125.0,80,7.94,82,370,2484,12.8,0.5561461
22426,22426,Raimo Helminen,1987-88,23.0,3,7,27,27,2,5,7,30.0,,93,12,35,47,155.0,80,7.34,72,344,2400,12.2,0.41504598
22427,22427,Raimo Helminen,1989-90,25.0,4,12,24,24,1,11,12,22.0,,117,13,46,59,177.0,80,7.48,85,403,2430,12.3,0.29395336
22428,22428,Raimo Summanen,1984-85,22.0,2,5,2,2,1,4,5,3.0,,2,1,4,5,3.0,80,7.89,74,336,2448,12.9,0.33229324
22429,22429,Raimo Summanen,1985-86,23.0,3,4,9,9,0,4,4,5.0,,11,1,8,9,8.0,80,7.77,71,321,2447,12.7,0.24358815
22430,22430,Raimo Summanen,1986-87,24.0,4,37,73,73,19,18,37,83.0,,84,20,26,46,91.0,80,7.94,82,370,2484,12.8,0.45220277
22431,22431,Raimo Summanen,1987-88,25.0,5,25,58,58,14,11,25,73.0,,142,34,37,71,164.0,80,7.34,72,344,2400,12.2,0.42085385
22432,22432,Raimo Summanen,1988-89,26.0,6,5,9,9,2,3,5,11.0,,151,36,40,76,175.0,80,7.43,89,437,2435,12.2,0.3499253
22433,22433,Raitis Ivanans,2006-07,28.0,2,0,4,4,0,0,0,0.0,12.0,4,0,0,0,0.0,82,6.05,85,480,2458,10.1,0.14065385
22434,22434,Raitis Ivanans,2007-08,29.0,3,8,66,66,4,4,8,37.0,461.0,70,4,4,8,37.0,82,5.76,70,398,2426,9.7,0.14029893
22435,22435,Raitis Ivanans,2008-09,30.0,4,8,73,73,6,2,8,48.0,548.0,143,10,6,16,85.0,82,5.44,62,351,2383,9.4,0.14229092
22436,22436,Raitis Ivanans,2009-10,31.0,5,2,76,76,2,0,2,25.0,484.0,219,12,6,18,110.0,82,5.7,65,341,2477,9.4,0.09416607
22437,22437,Raitis Ivanans,2010-11,32.0,6,0,61,61,0,0,0,18.0,299.0,280,12,6,18,128.0,82,5.53,56,304,2486,9.1,0.059513777
22438,22438,Raitis Ivanans,2011-12,33.0,7,0,1,1,0,0,0,0.0,8.0,281,12,6,18,128.0,82,5.46,52,291,2492,9.0,0.10648194
22439,22439,Raitis Ivanans,2012-13,34.0,8,0,1,1,0,0,0,0.0,11.0,282,12,6,18,128.0,82,5.32,47,271,2439,8.9,0.11653209
22440,22440,Ralph Barahona,1991-92,26.0,2,3,3,3,2,1,3,5.0,,3,2,1,3,5.0,80,6.91,71,366,2385,11.6,0.3403815
22441,22441,Ralph Barahona,1992-93,27.0,3,1,3,3,0,1,1,0.0,,6,2,2,4,5.0,80,6.96,77,402,2440,11.4,0.19896978
22442,22442,Ralph Intranuovo,1995-96,22.0,2,1,1,1,0,1,1,1.0,,1,0,1,1,1.0,48,5.97,37,209,1408,10.2,0.22567412
22443,22443,Ralph Intranuovo,1996-97,23.0,3,3,13,13,1,2,3,19.0,,14,1,3,4,20.0,82,6.29,74,413,2481,10.4,0.22777456
22444,22444,Ralph Intranuovo,1997-98,24.0,4,2,8,8,1,1,2,6.0,,22,2,4,6,26.0,82,5.83,55,336,2444,9.8,0.18651557
22445,22445,Raman Hrabarenka,2015-16,23.0,2,0,1,1,0,0,0,0.0,12.0,1,0,0,0,0.0,82,5.32,47,251,2453,8.9,0.14718214
22446,22446,Ramzi Abid,2003-04,23.0,2,18,33,33,10,8,18,59.0,428.0,33,10,8,18,59.0,82,5.31,60,363,2326,9.4,0.44426554
22447,22447,Ramzi Abid,2004-05,24.0,3,5,16,16,3,2,5,35.0,207.0,49,13,10,23,94.0,82,5.14,57,348,2300,9.2,0.31116378
22448,22448,Ramzi Abid,2006-07,26.0,4,2,6,6,0,2,2,6.0,49.0,55,13,12,25,100.0,82,6.05,85,480,2458,10.1,0.20927781
22449,22449,Ramzi Abid,2007-08,27.0,5,5,13,13,1,4,5,12.0,141.0,68,14,16,30,112.0,82,5.76,70,398,2426,9.7,0.21384585
22450,22450,Randy Boyd,1982-83,21.0,2,2,23,23,0,2,2,26.0,,23,0,2,2,26.0,80,8.03,73,320,2489,12.9,0.32133073
22451,22451,Randy Boyd,1983-84,22.0,3,18,56,56,4,14,18,101.0,,79,4,16,20,127.0,80,7.73,71,310,2444,12.7,0.38450432
22452,22452,Randy Boyd,1984-85,23.0,4,5,28,28,0,5,5,33.0,,107,4,21,25,160.0,80,7.89,74,336,2448,12.9,0.27991486
22453,22453,Randy Boyd,1985-86,24.0,5,0,3,3,0,0,0,3.0,,110,4,21,25,163.0,80,7.77,71,321,2447,12.7,0.22467363
22454,22454,Randy Boyd,1986-87,25.0,6,14,55,55,2,12,14,52.0,,165,6,33,39,215.0,80,7.94,82,370,2484,12.8,0.24943486
22455,22455,Randy Boyd,1987-88,26.0,7,24,30,30,7,17,24,69.0,,195,13,50,63,284.0,80,7.34,72,344,2400,12.2,0.44727948
22456,22456,Randy Boyd,1988-89,27.0,8,23,60,60,7,16,23,85.0,,255,20,66,86,369.0,80,7.43,89,437,2435,12.2,0.3319267
22457,22457,Randy Boyd,1989-90,28.0,9,1,2,2,0,1,1,6.0,,257,20,67,87,375.0,80,7.48,85,403,2430,12.3,0.24924678
22458,22458,Randy Bucyk,1986-87,24.0,2,6,17,17,4,2,6,21.0,,17,4,2,6,21.0,80,7.94,82,370,2484,12.8,0.3283354
22459,22459,Randy Bucyk,1988-89,26.0,3,0,2,2,0,0,0,2.0,,19,4,2,6,23.0,80,7.43,89,437,2435,12.2,0.20734522
22460,22460,Randy Burridge,1986-87,21.0,2,42,52,52,17,25,42,90.0,,52,17,25,42,90.0,80,7.94,82,370,2484,12.8,0.6152879
22461,22461,Randy Burridge,1987-88,22.0,3,5,23,23,1,4,5,28.0,,75,18,29,47,118.0,80,7.34,72,344,2400,12.2,0.47579592
22462,22462,Randy Burridge,1988-89,23.0,4,55,79,79,27,28,55,159.0,,154,45,57,102,277.0,80,7.43,89,437,2435,12.2,0.710272
22463,22463,Randy Burridge,1989-90,24.0,5,61,80,80,31,30,61,189.0,,234,76,87,163,466.0,80,7.48,85,403,2430,12.3,0.7820684
22464,22464,Randy Burridge,1990-91,25.0,6,32,63,63,17,15,32,118.0,,297,93,102,195,584.0,80,7.37,76,367,2421,12.2,0.59515005
22465,22465,Randy Burridge,1991-92,26.0,7,28,62,62,15,13,28,108.0,,359,108,115,223,692.0,80,6.91,71,366,2385,11.6,0.55473953
22466,22466,Randy Burridge,1992-93,27.0,8,67,66,66,23,44,67,131.0,,425,131,159,290,823.0,80,6.96,77,402,2440,11.4,0.69380414
22467,22467,Randy Burridge,1993-94,28.0,9,0,4,4,0,0,0,7.0,,429,131,159,290,830.0,84,7.25,87,443,2603,11.7,0.32615212
22468,22468,Randy Burridge,1994-95,29.0,10,42,78,78,25,17,42,150.0,,507,156,176,332,980.0,84,6.48,76,407,2545,10.7,0.48841634
22469,22469,Randy Burridge,1995-96,30.0,11,19,40,40,4,15,19,52.0,,547,160,191,351,1032.0,48,5.97,37,209,1408,10.2,0.5396489
22470,22470,Randy Burridge,1996-97,31.0,12,58,74,74,25,33,58,154.0,,621,185,224,409,1186.0,82,6.29,74,413,2481,10.4,0.59485465
22471,22471,Randy Burridge,1997-98,32.0,13,31,55,55,10,21,31,85.0,,676,195,245,440,1271.0,82,5.83,55,336,2444,9.8,0.45482203
22472,22472,Randy Burridge,1998-99,33.0,14,10,30,30,4,6,10,40.0,,706,199,251,450,1311.0,82,5.28,57,380,2242,9.6,0.26773536
22473,22473,Randy Cunneyworth,1981-82,20.0,2,0,1,1,0,0,0,1.0,,1,0,0,0,1.0,80,7.69,77,340,2441,12.6,0.29201615
22474,22474,Randy Cunneyworth,1982-83,21.0,3,6,20,20,2,4,6,33.0,,21,2,4,6,34.0,80,8.03,73,320,2489,12.9,0.39836136
22475,22475,Randy Cunneyworth,1986-87,25.0,4,45,75,75,15,30,45,134.0,,96,17,34,51,168.0,80,7.94,82,370,2484,12.8,0.5520404
22476,22476,Randy Cunneyworth,1987-88,26.0,5,53,79,79,26,27,53,171.0,,175,43,61,104,339.0,80,7.34,72,344,2400,12.2,0.6901028
22477,22477,Randy Cunneyworth,1988-89,27.0,6,74,71,71,35,39,74,229.0,,246,78,100,178,568.0,80,7.43,89,437,2435,12.2,0.8352746
22478,22478,Randy Cunneyworth,1989-90,28.0,7,44,70,70,25,19,44,163.0,,316,103,119,222,731.0,80,7.48,85,403,2430,12.3,0.60419893
22479,22479,Randy Cunneyworth,1990-91,29.0,8,29,71,71,14,15,29,121.0,,387,117,134,251,852.0,80,7.37,76,367,2421,12.2,0.4111273
22480,22480,Randy Cunneyworth,1991-92,30.0,9,14,32,32,9,5,14,56.0,,419,126,139,265,908.0,80,6.91,71,366,2385,11.6,0.3908787
22481,22481,Randy Cunneyworth,1992-93,31.0,10,17,39,39,7,10,17,63.0,,458,133,149,282,971.0,80,6.96,77,402,2440,11.4,0.39091736
22482,22482,Randy Cunneyworth,1993-94,32.0,11,9,39,39,5,4,9,47.0,,497,138,153,291,1018.0,84,7.25,87,443,2603,11.7,0.24418229
22483,22483,Randy Cunneyworth,1994-95,33.0,12,24,79,79,13,11,24,154.0,,576,151,164,315,1172.0,84,6.48,76,407,2545,10.7,0.31947374
22484,22484,Randy Cunneyworth,1995-96,34.0,13,10,48,48,5,5,10,71.0,,624,156,169,325,1243.0,48,5.97,37,209,1408,10.2,0.25271764
22485,22485,Randy Cunneyworth,1996-97,35.0,14,36,81,81,17,19,36,142.0,,705,173,188,361,1385.0,82,6.29,74,413,2481,10.4,0.35298783
22486,22486,Randy Cunneyworth,1997-98,36.0,15,36,76,76,12,24,36,115.0,,781,185,212,397,1500.0,82,5.83,55,336,2444,9.8,0.34227967
22487,22487,Randy Cunneyworth,1998-99,37.0,16,13,71,71,2,11,13,81.0,,852,187,223,410,1581.0,82,5.28,57,380,2242,9.6,0.18954363
22488,22488,Randy Cunneyworth,1999-00,38.0,17,4,14,14,2,2,4,12.0,126.0,866,189,225,414,1593.0,82,5.27,57,359,2285,9.4,0.2706411
22489,22489,Randy Gilhen,1983-84,20.0,2,1,2,2,0,1,1,4.0,,2,0,1,1,4.0,80,7.73,71,310,2444,12.7,0.31590405
22490,22490,Randy Gilhen,1987-88,24.0,3,0,2,2,0,0,0,3.0,,4,0,1,1,7.0,80,7.34,72,344,2400,12.2,0.20778516
22491,22491,Randy Gilhen,1988-89,25.0,4,5,13,13,3,2,5,21.0,,17,3,3,6,28.0,80,7.43,89,437,2435,12.2,0.31457096
22492,22492,Randy Gilhen,1989-90,26.0,5,8,64,64,5,3,8,76.0,,81,8,6,14,104.0,80,7.48,85,403,2430,12.3,0.22856748
22493,22493,Randy Gilhen,1990-91,27.0,6,16,61,61,5,11,16,67.0,,142,13,17,30,171.0,80,7.37,76,367,2421,12.2,0.24747673
22494,22494,Randy Gilhen,1991-92,28.0,7,25,72,72,15,10,25,112.0,,214,28,27,55,283.0,80,6.91,71,366,2385,11.6,0.32193592
22495,22495,Randy Gilhen,1992-93,29.0,8,23,73,73,10,13,23,99.0,,287,38,40,78,382.0,80,6.96,77,402,2440,11.4,0.27882922
22496,22496,Randy Gilhen,1993-94,30.0,9,7,44,44,3,4,7,45.0,,331,41,44,85,427.0,84,7.25,87,443,2603,11.7,0.17901403
22497,22497,Randy Gilhen,1994-95,31.0,10,14,60,60,7,7,14,95.0,,391,48,51,99,522.0,84,6.48,76,407,2545,10.7,0.21949983
22498,22498,Randy Gilhen,1995-96,32.0,11,11,44,44,5,6,11,47.0,,435,53,57,110,569.0,48,5.97,37,209,1408,10.2,0.21697173
22499,22499,Randy Gilhen,1996-97,33.0,12,5,22,22,2,3,5,26.0,,457,55,60,115,595.0,82,6.29,74,413,2481,10.4,0.19882783
22500,22500,Randy Gregg,1983-84,27.0,2,28,80,80,6,22,28,94.0,,80,6,22,28,94.0,80,7.73,71,310,2444,12.7,0.37522867
22501,22501,Randy Gregg,1984-85,28.0,3,40,80,80,13,27,40,90.0,,160,19,49,68,184.0,80,7.89,74,336,2448,12.9,0.42743915
22502,22502,Randy Gregg,1985-86,29.0,4,23,57,57,3,20,23,60.0,,217,22,69,91,244.0,80,7.77,71,321,2447,12.7,0.3594169
22503,22503,Randy Gregg,1986-87,30.0,5,28,64,64,2,26,28,56.0,,281,24,95,119,300.0,80,7.94,82,370,2484,12.8,0.35639927
22504,22504,Randy Gregg,1987-88,31.0,6,24,52,52,8,16,24,59.0,,333,32,111,143,359.0,80,7.34,72,344,2400,12.2,0.438367
22505,22505,Randy Gregg,1988-89,32.0,7,3,15,15,1,2,3,20.0,,348,33,113,146,379.0,80,7.43,89,437,2435,12.2,0.30425107
22506,22506,Randy Gregg,1989-90,33.0,8,18,57,57,3,15,18,42.0,,405,36,128,164,421.0,80,7.48,85,403,2430,12.3,0.29278135
22507,22507,Randy Gregg,1990-91,34.0,9,24,48,48,4,20,24,41.0,,453,40,148,188,462.0,80,7.37,76,367,2421,12.2,0.32537818
22508,22508,Randy Gregg,1992-93,36.0,10,5,21,21,1,4,5,19.0,,474,41,152,193,481.0,80,6.96,77,402,2440,11.4,0.20565018
22509,22509,Randy Heath,1985-86,21.0,2,5,12,12,2,3,5,18.0,,12,2,3,5,18.0,80,7.77,71,321,2447,12.7,0.36899224
22510,22510,Randy Heath,1986-87,22.0,3,1,1,1,0,1,1,1.0,,13,2,4,6,19.0,80,7.94,82,370,2484,12.8,0.22951275
22511,22511,Randy Hillier,1982-83,22.0,2,8,25,25,0,8,8,17.0,,25,0,8,8,17.0,80,8.03,73,320,2489,12.9,0.21365151
22512,22512,Randy Hillier,1983-84,23.0,3,10,70,70,0,10,10,45.0,,95,0,18,18,62.0,80,7.73,71,310,2444,12.7,0.21211708
22513,22513,Randy Hillier,1984-85,24.0,4,15,69,69,3,12,15,63.0,,164,3,30,33,125.0,80,7.89,74,336,2448,12.9,0.25001112
22514,22514,Randy Hillier,1985-86,25.0,5,21,45,45,2,19,21,58.0,,209,5,49,54,183.0,80,7.77,71,321,2447,12.7,0.34044743
22515,22515,Randy Hillier,1986-87,26.0,6,3,28,28,0,3,3,22.0,,237,5,52,57,205.0,80,7.94,82,370,2484,12.8,0.1824354
22516,22516,Randy Hillier,1987-88,27.0,7,12,55,55,4,8,12,51.0,,292,9,60,69,256.0,80,7.34,72,344,2400,12.2,0.22959384
22517,22517,Randy Hillier,1988-89,28.0,8,13,55,55,1,12,13,44.0,,347,10,72,82,300.0,80,7.43,89,437,2435,12.2,0.20457333
22518,22518,Randy Hillier,1989-90,29.0,9,24,68,68,1,23,24,37.0,,415,11,95,106,337.0,80,7.48,85,403,2430,12.3,0.26404008
22519,22519,Randy Hillier,1990-91,30.0,10,15,61,61,3,12,15,45.0,,476,14,107,121,382.0,80,7.37,76,367,2421,12.2,0.2410109
22520,22520,Randy Hillier,1991-92,31.0,11,4,31,31,2,2,4,14.0,,507,16,109,125,396.0,80,6.91,71,366,2385,11.6,0.17460987
22521,22521,Randy Hillier,1992-93,32.0,12,1,36,36,0,1,1,23.0,,543,16,110,126,419.0,80,6.96,77,402,2440,11.4,0.12662369
22522,22522,Randy Johnston,1980-81,22.0,2,0,4,4,0,0,0,2.0,,4,0,0,0,2.0,80,7.03,61,280,2352,12.0,0.22890192
22523,22523,Randy Jones,2004-05,23.0,2,0,5,5,0,0,0,5.0,60.0,5,0,0,0,5.0,82,5.14,57,348,2300,9.2,0.20593247
22524,22524,Randy Jones,2006-07,25.0,3,8,28,28,0,8,8,21.0,419.0,33,0,8,8,26.0,82,6.05,85,480,2458,10.1,0.18375787
22525,22525,Randy Jones,2007-08,26.0,4,22,66,66,4,18,22,67.0,1062.0,99,4,26,30,93.0,82,5.76,70,398,2426,9.7,0.2536525
22526,22526,Randy Jones,2008-09,27.0,5,31,71,71,5,26,31,103.0,1377.0,170,9,52,61,196.0,82,5.44,62,351,2383,9.4,0.40345085
22527,22527,Randy Jones,2009-10,28.0,6,8,47,47,4,4,8,45.0,898.0,217,13,56,69,241.0,82,5.7,65,341,2477,9.4,0.17243204
22528,22528,Randy Jones,2010-11,29.0,7,21,48,48,5,16,21,54.0,872.0,265,18,72,90,295.0,82,5.53,56,304,2486,9.1,0.3040561
22529,22529,Randy Jones,2011-12,30.0,8,13,61,61,1,12,13,52.0,1041.0,326,19,84,103,347.0,82,5.46,52,291,2492,9.0,0.19422755
22530,22530,Randy Jones,2012-13,31.0,9,2,39,39,1,1,2,24.0,578.0,365,20,85,105,371.0,82,5.32,47,271,2439,8.9,0.14656076
22531,22531,Randy Ladouceur,1983-84,23.0,2,4,27,27,0,4,4,19.0,,27,0,4,4,19.0,80,7.73,71,310,2444,12.7,0.21201491
22532,22532,Randy Ladouceur,1984-85,24.0,3,20,71,71,3,17,20,89.0,,98,3,21,24,108.0,80,7.89,74,336,2448,12.9,0.30796057
22533,22533,Randy Ladouceur,1985-86,25.0,4,30,80,80,3,27,30,83.0,,178,6,48,54,191.0,80,7.77,71,321,2447,12.7,0.354802
22534,22534,Randy Ladouceur,1986-87,26.0,5,18,78,78,5,13,18,92.0,,256,11,61,72,283.0,80,7.94,82,370,2484,12.8,0.2542209
22535,22535,Randy Ladouceur,1987-88,27.0,6,14,70,70,5,9,14,54.0,,326,16,70,86,337.0,80,7.34,72,344,2400,12.2,0.23005247
22536,22536,Randy Ladouceur,1988-89,28.0,7,8,67,67,1,7,8,37.0,,393,17,77,94,374.0,80,7.43,89,437,2435,12.2,0.19132364
22537,22537,Randy Ladouceur,1989-90,29.0,8,7,75,75,2,5,7,56.0,,468,19,82,101,430.0,80,7.48,85,403,2430,12.3,0.17564583
22538,22538,Randy Ladouceur,1990-91,30.0,9,15,71,71,3,12,15,45.0,,539,22,94,116,475.0,80,7.37,76,367,2421,12.2,0.1965194
22539,22539,Randy Ladouceur,1991-92,31.0,10,4,67,67,1,3,4,44.0,,606,23,97,120,519.0,80,6.91,71,366,2385,11.6,0.1511958
22540,22540,Randy Ladouceur,1992-93,32.0,11,10,74,74,1,9,10,59.0,,680,24,106,130,578.0,80,6.96,77,402,2440,11.4,0.15546966
22541,22541,Randy Ladouceur,1993-94,33.0,12,6,62,62,2,4,6,37.0,,742,26,110,136,615.0,84,7.25,87,443,2603,11.7,0.14498204
22542,22542,Randy Ladouceur,1994-95,34.0,13,10,81,81,1,9,10,66.0,,823,27,119,146,681.0,84,6.48,76,407,2545,10.7,0.11649546
22543,22543,Randy Ladouceur,1995-96,35.0,14,6,44,44,2,4,6,42.0,,867,29,123,152,723.0,48,5.97,37,209,1408,10.2,0.14654136
22544,22544,Randy Ladouceur,1996-97,36.0,15,4,63,63,1,3,4,48.0,,930,30,126,156,771.0,82,6.29,74,413,2481,10.4,0.10399729
22545,22545,Randy MacGregor,1982-83,29.0,2,2,2,2,1,1,2,1.0,,2,1,1,2,1.0,80,8.03,73,320,2489,12.9,0.28666693
22546,22546,Randy McKay,1989-90,23.0,2,0,3,3,0,0,0,2.0,,3,0,0,0,2.0,80,7.48,85,403,2430,12.3,0.21825555
22547,22547,Randy McKay,1990-91,24.0,3,9,33,33,3,6,9,33.0,,36,3,6,9,35.0,80,7.37,76,367,2421,12.2,0.27043977
22548,22548,Randy McKay,1991-92,25.0,4,8,47,47,1,7,8,22.0,,83,4,13,17,57.0,80,6.91,71,366,2385,11.6,0.17301425
22549,22549,Randy McKay,1992-93,26.0,5,33,80,80,17,16,33,111.0,,163,21,29,50,168.0,80,6.96,77,402,2440,11.4,0.39922848
22550,22550,Randy McKay,1993-94,27.0,6,22,73,73,11,11,22,94.0,,236,32,40,72,262.0,84,7.25,87,443,2603,11.7,0.2831334
22551,22551,Randy McKay,1994-95,28.0,7,27,78,78,12,15,27,77.0,,314,44,55,99,339.0,84,6.48,76,407,2545,10.7,0.29252946
22552,22552,Randy McKay,1995-96,29.0,8,12,33,33,5,7,12,44.0,,347,49,62,111,383.0,48,5.97,37,209,1408,10.2,0.30525297
22553,22553,Randy McKay,1996-97,30.0,9,21,76,76,11,10,21,97.0,,423,60,72,132,480.0,82,6.29,74,413,2481,10.4,0.25209355
22554,22554,Randy McKay,1997-98,31.0,10,27,77,77,9,18,27,92.0,,500,69,90,159,572.0,82,5.83,55,336,2444,9.8,0.2916076
22555,22555,Randy McKay,1998-99,32.0,11,48,74,74,24,24,48,141.0,,574,93,114,207,713.0,82,5.28,57,380,2242,9.6,0.51404023
22556,22556,Randy McKay,1999-00,33.0,12,37,70,70,17,20,37,136.0,1127.0,644,110,134,244,849.0,82,5.27,57,359,2285,9.4,0.457248
22557,22557,Randy McKay,2000-01,34.0,13,39,67,67,16,23,39,116.0,1048.0,711,126,157,283,965.0,82,5.49,53,331,2294,9.8,0.4496534
22558,22558,Randy McKay,2001-02,35.0,14,43,77,77,23,20,43,120.0,1076.0,788,149,177,326,1085.0,82,5.51,63,376,2272,9.9,0.3824006
22559,22559,Randy McKay,2002-03,36.0,15,18,69,69,7,11,18,73.0,898.0,857,156,188,344,1158.0,82,5.24,53,338,2262,9.5,0.22898915
22560,22560,Randy McKay,2003-04,37.0,16,19,75,75,6,13,19,52.0,829.0,932,162,201,363,1210.0,82,5.31,60,363,2326,9.4,0.19686225
22561,22561,Randy Moller,1983-84,20.0,2,14,75,75,2,12,14,75.0,,75,2,12,14,75.0,80,7.73,71,310,2444,12.7,0.300601
22562,22562,Randy Moller,1984-85,21.0,3,18,74,74,4,14,18,78.0,,149,6,26,32,153.0,80,7.89,74,336,2448,12.9,0.3563574
22563,22563,Randy Moller,1985-86,22.0,4,29,79,79,7,22,29,126.0,,228,13,48,61,279.0,80,7.77,71,321,2447,12.7,0.39259508
22564,22564,Randy Moller,1986-87,23.0,5,23,69,69,5,18,23,105.0,,297,18,66,84,384.0,80,7.94,82,370,2484,12.8,0.32261175
22565,22565,Randy Moller,1987-88,24.0,6,14,71,71,5,9,14,106.0,,368,23,75,98,490.0,80,7.34,72,344,2400,12.2,0.30465752
22566,22566,Randy Moller,1988-89,25.0,7,25,66,66,3,22,25,116.0,,434,26,97,123,606.0,80,7.43,89,437,2435,12.2,0.32801628
22567,22567,Randy Moller,1989-90,26.0,8,29,74,74,7,22,29,117.0,,508,33,119,152,723.0,80,7.48,85,403,2430,12.3,0.388875
22568,22568,Randy Moller,1990-91,27.0,9,13,60,60,1,12,13,47.0,,568,34,131,165,770.0,80,7.37,76,367,2421,12.2,0.19856587
22569,22569,Randy Moller,1991-92,28.0,10,23,61,61,4,19,23,75.0,,629,38,150,188,845.0,80,6.91,71,366,2385,11.6,0.3040651
22570,22570,Randy Moller,1992-93,29.0,11,12,56,56,3,9,12,63.0,,685,41,159,200,908.0,80,6.96,77,402,2440,11.4,0.2296116
22571,22571,Randy Moller,1993-94,30.0,12,9,35,35,2,7,9,25.0,,720,43,166,209,933.0,84,7.25,87,443,2603,11.7,0.21002936
22572,22572,Randy Moller,1994-95,31.0,13,13,78,78,2,11,13,77.0,,798,45,177,222,1010.0,84,6.48,76,407,2545,10.7,0.16247952
22573,22573,Randy Moller,1995-96,32.0,14,3,17,17,0,3,3,12.0,,815,45,180,225,1022.0,48,5.97,37,209,1408,10.2,0.1866495
22574,22574,Randy Robitaille,1997-98,22.0,2,0,1,1,0,0,0,0.0,,1,0,0,0,0.0,82,5.83,55,336,2444,9.8,0.157395
22575,22575,Randy Robitaille,1998-99,23.0,3,0,4,4,0,0,0,5.0,,5,0,0,0,5.0,82,5.28,57,380,2242,9.6,0.1733998
22576,22576,Randy Robitaille,1999-00,24.0,4,2,4,4,0,2,2,5.0,41.0,9,0,2,2,10.0,82,5.27,57,359,2285,9.4,0.19170845
22577,22577,Randy Robitaille,2000-01,25.0,5,25,69,69,11,14,25,113.0,888.0,78,11,16,27,123.0,82,5.49,53,331,2294,9.8,0.32976696
22578,22578,Randy Robitaille,2001-02,26.0,6,26,62,62,9,17,26,121.0,879.0,140,20,33,53,244.0,82,5.51,63,376,2272,9.9,0.36936375
22579,22579,Randy Robitaille,2002-03,27.0,7,37,58,58,14,23,37,121.0,957.0,198,34,56,90,365.0,82,5.24,53,338,2262,9.5,0.5540487
22580,22580,Randy Robitaille,2003-04,28.0,8,20,51,51,6,14,20,69.0,697.0,249,40,70,110,434.0,82,5.31,60,363,2326,9.4,0.35507
22581,22581,Randy Robitaille,2004-05,29.0,9,37,69,69,11,26,37,121.0,1094.0,318,51,96,147,555.0,82,5.14,57,348,2300,9.2,0.49889883
22582,22582,Randy Robitaille,2006-07,31.0,10,40,67,67,12,28,40,112.0,987.0,385,63,124,187,667.0,82,6.05,85,480,2458,10.1,0.44984445
22583,22583,Randy Robitaille,2007-08,32.0,11,40,78,78,11,29,40,120.0,1103.0,463,74,153,227,787.0,82,5.76,70,398,2426,9.7,0.39369804
22584,22584,Randy Robitaille,2008-09,33.0,12,29,68,68,10,19,29,99.0,922.0,531,84,172,256,886.0,82,5.44,62,351,2383,9.4,0.3371824
22585,22585,Randy Skarda,1990-91,22.0,2,5,25,25,0,5,5,8.0,,25,0,5,5,8.0,80,7.37,76,367,2421,12.2,0.175179
22586,22586,Randy Skarda,1992-93,24.0,3,0,1,1,0,0,0,0.0,,26,0,5,5,8.0,80,6.96,77,402,2440,11.4,0.18642482
22587,22587,Randy Smith,1986-87,21.0,2,0,1,1,0,0,0,0.0,,1,0,0,0,0.0,80,7.94,82,370,2484,12.8,0.20334706
22588,22588,Randy Smith,1987-88,22.0,3,0,2,2,0,0,0,0.0,,3,0,0,0,0.0,80,7.34,72,344,2400,12.2,0.19149631
22589,22589,Randy Turnbull,1982-83,20.0,2,0,1,1,0,0,0,0.0,,1,0,0,0,0.0,80,8.03,73,320,2489,12.9,0.27148372
22590,22590,Randy Velischek,1983-84,21.0,2,0,3,3,0,0,0,4.0,,3,0,0,0,4.0,80,7.73,71,310,2444,12.7,0.25479347
22591,22591,Randy Velischek,1984-85,22.0,3,4,33,33,2,2,4,15.0,,36,2,2,4,19.0,80,7.89,74,336,2448,12.9,0.24217254
22592,22592,Randy Velischek,1985-86,23.0,4,13,52,52,4,9,13,31.0,,88,6,11,17,50.0,80,7.77,71,321,2447,12.7,0.26667058
22593,22593,Randy Velischek,1986-87,24.0,5,9,47,47,2,7,9,24.0,,135,8,18,26,74.0,80,7.94,82,370,2484,12.8,0.16420996
22594,22594,Randy Velischek,1987-88,25.0,6,18,64,64,2,16,18,39.0,,199,10,34,44,113.0,80,7.34,72,344,2400,12.2,0.24833596
22595,22595,Randy Velischek,1988-89,26.0,7,12,51,51,3,9,12,39.0,,250,13,43,56,152.0,80,7.43,89,437,2435,12.2,0.2453531
22596,22596,Randy Velischek,1989-90,27.0,8,18,80,80,4,14,18,77.0,,330,17,57,74,229.0,80,7.48,85,403,2430,12.3,0.22245514
22597,22597,Randy Velischek,1990-91,28.0,9,6,62,62,0,6,6,34.0,,392,17,63,80,263.0,80,7.37,76,367,2421,12.2,0.15423685
22598,22598,Randy Velischek,1991-92,29.0,10,12,79,79,2,10,12,47.0,,471,19,73,92,310.0,80,6.91,71,366,2385,11.6,0.18926522
22599,22599,Randy Velischek,1992-93,30.0,11,5,38,38,2,3,5,23.0,,509,21,76,97,333.0,80,6.96,77,402,2440,11.4,0.15780887
22600,22600,Randy Wood,1987-88,24.0,2,1,6,6,1,0,1,4.0,,6,1,0,1,4.0,80,7.34,72,344,2400,12.2,0.26850945
22601,22601,Randy Wood,1988-89,25.0,3,38,75,75,22,16,38,106.0,,81,23,16,39,110.0,80,7.43,89,437,2435,12.2,0.47721043
22602,22602,Randy Wood,1989-90,26.0,4,28,77,77,15,13,28,115.0,,158,38,29,67,225.0,80,7.48,85,403,2430,12.3,0.42385224
22603,22603,Randy Wood,1990-91,27.0,5,48,74,74,24,24,48,185.0,,232,62,53,115,410.0,80,7.37,76,367,2421,12.2,0.61485887
22604,22604,Randy Wood,1991-92,28.0,6,42,76,76,24,18,42,186.0,,308,86,71,157,596.0,80,6.91,71,366,2385,11.6,0.5249454
22605,22605,Randy Wood,1992-93,29.0,7,40,78,78,22,18,40,215.0,,386,108,89,197,811.0,80,6.96,77,402,2440,11.4,0.5324569
22606,22606,Randy Wood,1993-94,30.0,8,43,82,82,18,25,43,176.0,,468,126,114,240,987.0,84,7.25,87,443,2603,11.7,0.45150632
22607,22607,Randy Wood,1994-95,31.0,9,38,84,84,22,16,38,161.0,,552,148,130,278,1148.0,84,6.48,76,407,2545,10.7,0.4407396
22608,22608,Randy Wood,1995-96,32.0,10,24,48,48,13,11,24,125.0,,600,161,141,302,1273.0,48,5.97,37,209,1408,10.2,0.46456388
22609,22609,Randy Wood,1996-97,33.0,11,21,76,76,8,13,21,159.0,,676,169,154,323,1432.0,82,6.29,74,413,2481,10.4,0.28197536
22610,22610,Randy Wood,1997-98,34.0,12,11,65,65,6,5,11,96.0,,741,175,159,334,1528.0,82,5.83,55,336,2444,9.8,0.198289
22611,22611,Raphael Diaz,2012-13,27.0,2,16,59,59,3,13,16,61.0,1062.0,59,3,13,16,61.0,82,5.32,47,271,2439,8.9,0.23728797
22612,22612,Raphael Diaz,2013-14,28.0,3,14,23,23,1,13,14,34.0,473.0,82,4,26,30,95.0,48,5.31,29,160,1399,9.1,0.28634518
22613,22613,Raphael Diaz,2014-15,29.0,4,15,63,63,2,13,15,68.0,1133.0,145,6,39,45,163.0,82,5.34,48,269,2463,8.9,0.19119784
22614,22614,Raphael Diaz,2015-16,30.0,5,4,56,56,2,2,4,52.0,673.0,201,8,41,49,215.0,82,5.32,47,251,2453,8.9,0.15281284
22615,22615,Rasmus Andersson,2017-18,21.0,2,0,1,1,0,0,0,0.0,19.0,1,0,0,0,0.0,82,5.45,47,245,2478,9.0,0.22606894
22616,22616,Rasmus Andersson,2018-19,22.0,3,0,10,10,0,0,0,8.0,154.0,11,0,0,0,8.0,82,5.86,50,250,2620,9.2,0.16576752
22617,22617,Rasmus Andersson,2019-20,23.0,4,19,79,79,2,17,19,115.0,1267.0,90,2,17,19,123.0,82,5.96,47,239,2579,9.5,0.27271858
22618,22618,Rasmus Andersson,2020-21,24.0,5,22,70,70,5,17,22,124.0,1396.0,160,7,34,41,247.0,70,5.96,42,208,2192,9.5,0.29562587
22619,22619,Rasmus Asplund,2020-21,23.0,2,3,29,29,1,2,3,36.0,314.0,29,1,2,3,36.0,70,5.96,42,208,2192,9.5,0.22001845
22620,22620,Rasmus Dahlin,2019-20,19.0,2,44,82,82,9,35,44,177.0,1735.0,82,9,35,44,177.0,82,5.96,47,239,2579,9.5,0.60067433
22621,22621,Rasmus Dahlin,2020-21,20.0,3,40,59,59,4,36,40,90.0,1138.0,141,13,71,84,267.0,70,5.96,42,208,2192,9.5,0.5805225
22622,22622,Rasmus Rissanen,2015-16,24.0,2,0,6,6,0,0,0,3.0,90.0,6,0,0,0,3.0,82,5.32,47,251,2453,8.9,0.16720265
22623,22623,Rasmus Ristolainen,2014-15,20.0,2,4,34,34,2,2,4,52.0,650.0,34,2,2,4,52.0,82,5.34,48,269,2463,8.9,0.2734424
22624,22624,Rasmus Ristolainen,2015-16,21.0,3,20,78,78,8,12,20,121.0,1608.0,112,10,14,24,173.0,82,5.32,47,251,2453,8.9,0.3473713
22625,22625,Rasmus Ristolainen,2016-17,22.0,4,41,82,82,9,32,41,202.0,2073.0,194,19,46,65,375.0,82,5.34,48,255,2438,9.0,0.53862226
22626,22626,Rasmus Ristolainen,2017-18,23.0,5,45,79,79,6,39,45,186.0,2091.0,273,25,85,110,561.0,82,5.45,47,245,2478,9.0,0.58931094
22627,22627,Rasmus Ristolainen,2018-19,24.0,6,41,73,73,6,35,41,182.0,1934.0,346,31,120,151,743.0,82,5.86,50,250,2620,9.2,0.58569235
22628,22628,Rasmus Ristolainen,2019-20,25.0,7,43,78,78,5,38,43,182.0,1922.0,424,36,158,194,925.0,82,5.96,47,239,2579,9.5,0.55890775
22629,22629,Rasmus Ristolainen,2020-21,26.0,8,33,69,69,6,27,33,128.0,1573.0,493,42,185,227,1053.0,70,5.96,42,208,2192,9.5,0.4701813
22630,22630,Rasmus Sandin,2020-21,20.0,2,8,28,28,1,7,8,22.0,401.0,28,1,7,8,22.0,70,5.96,42,208,2192,9.5,0.2863016
22631,22631,Ravil Gusmanov,1996-97,24.0,2,0,4,4,0,0,0,6.0,,4,0,0,0,6.0,82,6.29,74,413,2481,10.4,0.1724348
22632,22632,Ray Allison,1980-81,21.0,2,28,64,64,16,12,28,79.0,,64,16,12,28,79.0,80,7.03,61,280,2352,12.0,0.49428928
22633,22633,Ray Allison,1981-82,22.0,3,1,6,6,1,0,1,6.0,,70,17,12,29,85.0,80,7.69,77,340,2441,12.6,0.38860816
22634,22634,Ray Allison,1982-83,23.0,4,54,51,51,17,37,54,131.0,,121,34,49,83,216.0,80,8.03,73,320,2489,12.9,0.81475604
22635,22635,Ray Allison,1983-84,24.0,5,51,67,67,21,30,51,148.0,,188,55,79,134,364.0,80,7.73,71,310,2444,12.7,0.6994815
22636,22636,Ray Allison,1984-85,25.0,6,21,37,37,8,13,21,74.0,,225,63,92,155,438.0,80,7.89,74,336,2448,12.9,0.58046013
22637,22637,Ray Allison,1985-86,26.0,7,2,11,11,1,1,2,16.0,,236,64,93,157,454.0,80,7.77,71,321,2447,12.7,0.31892386
22638,22638,Ray Allison,1987-88,28.0,8,0,2,2,0,0,0,1.0,,238,64,93,157,455.0,80,7.34,72,344,2400,12.2,0.27183
22639,22639,Ray Bourque,1980-81,20.0,2,65,80,80,17,48,65,185.0,,80,17,48,65,185.0,80,7.03,61,280,2352,12.0,0.86648846
22640,22640,Ray Bourque,1981-82,21.0,3,56,67,67,27,29,56,207.0,,147,44,77,121,392.0,80,7.69,77,340,2441,12.6,0.9422489
22641,22641,Ray Bourque,1982-83,22.0,4,66,65,65,17,49,66,211.0,,212,61,126,187,603.0,80,8.03,73,320,2489,12.9,1.0230272
22642,22642,Ray Bourque,1983-84,23.0,5,73,65,65,22,51,73,205.0,,277,83,177,260,808.0,80,7.73,71,310,2444,12.7,1.1353354
22643,22643,Ray Bourque,1984-85,24.0,6,96,78,78,31,65,96,343.0,,355,114,242,356,1151.0,80,7.89,74,336,2448,12.9,1.1296359
22644,22644,Ray Bourque,1985-86,25.0,7,86,73,73,20,66,86,333.0,,428,134,308,442,1484.0,80,7.77,71,321,2447,12.7,1.1073728
22645,22645,Ray Bourque,1986-87,26.0,8,77,74,74,19,58,77,289.0,,502,153,366,519,1773.0,80,7.94,82,370,2484,12.8,1.0274708
22646,22646,Ray Bourque,1987-88,27.0,9,95,78,78,23,72,95,334.0,,580,176,438,614,2107.0,80,7.34,72,344,2400,12.2,1.1510437
22647,22647,Ray Bourque,1988-89,28.0,10,81,78,78,17,64,81,344.0,,658,193,502,695,2451.0,80,7.43,89,437,2435,12.2,0.9747853
22648,22648,Ray Bourque,1989-90,29.0,11,61,60,60,18,43,61,243.0,,718,211,545,756,2694.0,80,7.48,85,403,2430,12.3,0.9807638
22649,22649,Ray Bourque,1990-91,30.0,12,84,76,76,19,65,84,310.0,,794,230,610,840,3004.0,80,7.37,76,367,2421,12.2,1.0782336
22650,22650,Ray Bourque,1991-92,31.0,13,94,76,76,21,73,94,323.0,,870,251,683,934,3327.0,80,6.91,71,366,2385,11.6,1.0428739
22651,22651,Ray Bourque,1992-93,32.0,14,81,80,80,21,60,81,334.0,,950,272,743,1015,3661.0,80,6.96,77,402,2440,11.4,0.998098
22652,22652,Ray Bourque,1993-94,33.0,15,82,78,78,19,63,82,330.0,,1028,291,806,1097,3991.0,84,7.25,87,443,2603,11.7,0.9965202
22653,22653,Ray Bourque,1994-95,34.0,16,91,72,72,20,71,91,386.0,,1100,311,877,1188,4377.0,84,6.48,76,407,2545,10.7,1.0607259
22654,22654,Ray Bourque,1995-96,35.0,17,43,46,46,12,31,43,210.0,,1146,323,908,1231,4587.0,48,5.97,37,209,1408,10.2,0.92569035
22655,22655,Ray Bourque,1996-97,36.0,18,82,82,82,20,62,82,390.0,,1228,343,970,1313,4977.0,82,6.29,74,413,2481,10.4,0.8352494
22656,22656,Ray Bourque,1997-98,37.0,19,50,62,62,19,31,50,230.0,,1290,362,1001,1363,5207.0,82,5.83,55,336,2444,9.8,0.6586863
22657,22657,Ray Bourque,1998-99,38.0,20,48,82,82,13,35,48,264.0,,1372,375,1036,1411,5471.0,82,5.28,57,380,2242,9.6,0.6466954
22658,22658,Ray Bourque,1999-00,39.0,21,57,81,81,10,47,57,262.0,2391.0,1453,385,1083,1468,5733.0,82,5.27,57,359,2285,9.4,0.6810365
22659,22659,Ray Bourque,2000-01,40.0,22,52,79,79,18,34,52,260.0,2148.0,1532,403,1117,1520,5993.0,82,5.49,53,331,2294,9.8,0.64679855
22660,22660,Ray Bourque,2001-02,41.0,23,59,80,80,7,52,59,216.0,2088.0,1612,410,1169,1579,6209.0,82,5.51,63,376,2272,9.9,0.6700468
22661,22661,Ray Cote,1984-85,23.0,2,0,13,13,0,0,0,12.0,,13,0,0,0,12.0,80,7.89,74,336,2448,12.9,0.22519708
22662,22662,Ray Cote,1985-86,24.0,3,0,2,2,0,0,0,1.0,,15,0,0,0,13.0,80,7.77,71,321,2447,12.7,0.19448632
22663,22663,Ray Ferraro,1985-86,21.0,2,28,44,44,11,17,28,59.0,,44,11,17,28,59.0,80,7.77,71,321,2447,12.7,0.54481936
22664,22664,Ray Ferraro,1986-87,22.0,3,77,76,76,30,47,77,131.0,,120,41,64,105,190.0,80,7.94,82,370,2484,12.8,0.84990776
22665,22665,Ray Ferraro,1987-88,23.0,4,59,80,80,27,32,59,96.0,,200,68,96,164,286.0,80,7.34,72,344,2400,12.2,0.72093654
22666,22666,Ray Ferraro,1988-89,24.0,5,50,68,68,21,29,50,105.0,,268,89,125,214,391.0,80,7.43,89,437,2435,12.2,0.7483697
22667,22667,Ray Ferraro,1989-90,25.0,6,76,80,80,41,35,76,169.0,,348,130,160,290,560.0,80,7.48,85,403,2430,12.3,0.8716432
22668,22668,Ray Ferraro,1990-91,26.0,7,54,79,79,25,29,54,138.0,,427,155,189,344,698.0,80,7.37,76,367,2421,12.2,0.6879357
22669,22669,Ray Ferraro,1991-92,27.0,8,42,76,76,21,21,42,109.0,,503,176,210,386,807.0,80,6.91,71,366,2385,11.6,0.58547044
22670,22670,Ray Ferraro,1992-93,28.0,9,80,80,80,40,40,80,154.0,,583,216,250,466,961.0,80,6.96,77,402,2440,11.4,0.84058034
22671,22671,Ray Ferraro,1993-94,29.0,10,27,46,46,14,13,27,72.0,,629,230,263,493,1033.0,84,7.25,87,443,2603,11.7,0.5498712
22672,22672,Ray Ferraro,1994-95,30.0,11,53,82,82,21,32,53,136.0,,711,251,295,546,1169.0,84,6.48,76,407,2545,10.7,0.5927433
22673,22673,Ray Ferraro,1995-96,31.0,12,43,47,47,22,21,43,94.0,,758,273,316,589,1263.0,48,5.97,37,209,1408,10.2,0.75293535
22674,22674,Ray Ferraro,1996-97,32.0,13,60,76,76,29,31,60,178.0,,834,302,347,649,1441.0,82,6.29,74,413,2481,10.4,0.62370944
22675,22675,Ray Ferraro,1997-98,33.0,14,46,81,81,25,21,46,152.0,,915,327,368,695,1593.0,82,5.83,55,336,2444,9.8,0.4927917
22676,22676,Ray Ferraro,1998-99,34.0,15,15,40,40,6,9,15,45.0,,955,333,377,710,1638.0,82,5.28,57,380,2242,9.6,0.36118245
22677,22677,Ray Ferraro,1999-00,35.0,16,31,65,65,13,18,31,84.0,947.0,1020,346,395,741,1722.0,82,5.27,57,359,2285,9.4,0.39476115
22678,22678,Ray Ferraro,2000-01,36.0,17,44,81,81,19,25,44,170.0,1309.0,1101,365,420,785,1892.0,82,5.49,53,331,2294,9.8,0.5056963
22679,22679,Ray Ferraro,2001-02,37.0,18,76,81,81,29,47,76,172.0,1483.0,1182,394,467,861,2064.0,82,5.51,63,376,2272,9.9,0.68221045
22680,22680,Ray Ferraro,2002-03,38.0,19,37,76,76,14,23,37,99.0,1187.0,1258,408,490,898,2163.0,82,5.24,53,338,2262,9.5,0.43929636
22681,22681,Ray Giroux,2000-01,24.0,2,9,14,14,0,9,9,24.0,205.0,14,0,9,9,24.0,82,5.49,53,331,2294,9.8,0.21382347
22682,22682,Ray Giroux,2002-03,26.0,3,0,2,2,0,0,0,2.0,25.0,16,0,9,9,26.0,82,5.24,53,338,2262,9.5,0.15760472
22683,22683,Ray Giroux,2003-04,27.0,4,1,11,11,0,1,1,20.0,201.0,27,0,10,10,46.0,82,5.31,60,363,2326,9.4,0.21360555
22684,22684,Ray Giroux,2004-05,28.0,5,3,11,11,0,3,3,17.0,230.0,38,0,13,13,63.0,82,5.14,57,348,2300,9.2,0.2081568
22685,22685,Ray Macias,2009-10,23.0,2,1,6,6,0,1,1,4.0,108.0,6,0,1,1,4.0,82,5.7,65,341,2477,9.4,0.1946064
22686,22686,Ray Macias,2011-12,25.0,3,0,2,2,0,0,0,0.0,30.0,8,0,1,1,4.0,82,5.46,52,291,2492,9.0,0.1479868
22687,22687,Ray Markham,1980-81,23.0,2,2,14,14,1,1,2,6.0,,14,1,1,2,6.0,80,7.03,61,280,2352,12.0,0.26810414
22688,22688,Ray Neufeld,1980-81,21.0,2,1,8,8,1,0,1,4.0,,8,1,0,1,4.0,80,7.03,61,280,2352,12.0,0.27385646
22689,22689,Ray Neufeld,1981-82,22.0,3,15,52,52,5,10,15,55.0,,60,6,10,16,59.0,80,7.69,77,340,2441,12.6,0.3428375
22690,22690,Ray Neufeld,1982-83,23.0,4,7,19,19,4,3,7,33.0,,79,10,13,23,92.0,80,8.03,73,320,2489,12.9,0.3839129
22691,22691,Ray Neufeld,1983-84,24.0,5,57,80,80,26,31,57,166.0,,159,36,44,80,258.0,80,7.73,71,310,2444,12.7,0.67931074
22692,22692,Ray Neufeld,1984-85,25.0,6,69,80,80,27,42,69,163.0,,239,63,86,149,421.0,80,7.89,74,336,2448,12.9,0.7968217
22693,22693,Ray Neufeld,1985-86,26.0,7,62,76,76,27,35,62,177.0,,315,90,121,211,598.0,80,7.77,71,321,2447,12.7,0.75958514
22694,22694,Ray Neufeld,1986-87,27.0,8,63,76,76,25,38,63,168.0,,391,115,159,274,766.0,80,7.94,82,370,2484,12.8,0.67158824
22695,22695,Ray Neufeld,1987-88,28.0,9,36,80,80,18,18,36,134.0,,471,133,177,310,900.0,80,7.34,72,344,2400,12.2,0.48637086
22696,22696,Ray Neufeld,1988-89,29.0,10,36,78,78,18,18,36,115.0,,549,151,195,346,1015.0,80,7.43,89,437,2435,12.2,0.4377626
22697,22697,Ray Neufeld,1989-90,30.0,11,11,45,45,6,5,11,63.0,,594,157,200,357,1078.0,80,7.48,85,403,2430,12.3,0.3182649
22698,22698,Ray Neufeld,1990-91,31.0,12,0,1,1,0,0,0,1.0,,595,157,200,357,1079.0,80,7.37,76,367,2421,12.2,0.33838144
22699,22699,Ray Podloski,1989-90,24.0,2,1,8,8,0,1,1,3.0,,8,0,1,1,3.0,80,7.48,85,403,2430,12.3,0.23277095
22700,22700,Ray Schultz,1998-99,22.0,2,1,13,13,0,1,1,4.0,,13,0,1,1,4.0,82,5.28,57,380,2242,9.6,0.17217866
22701,22701,Ray Schultz,1999-00,23.0,3,0,4,4,0,0,0,2.0,61.0,17,0,1,1,6.0,82,5.27,57,359,2285,9.4,0.15990022
22702,22702,Ray Schultz,2000-01,24.0,4,1,9,9,0,1,1,2.0,129.0,26,0,2,2,8.0,82,5.49,53,331,2294,9.8,0.15619662
22703,22703,Ray Schultz,2001-02,25.0,5,2,13,13,0,2,2,3.0,141.0,39,0,4,4,11.0,82,5.51,63,376,2272,9.9,0.14638063
22704,22704,Ray Schultz,2002-03,26.0,6,0,2,2,0,0,0,0.0,7.0,41,0,4,4,11.0,82,5.24,53,338,2262,9.5,0.12243405
22705,22705,Ray Schultz,2003-04,27.0,7,0,4,4,0,0,0,1.0,22.0,45,0,4,4,12.0,82,5.31,60,363,2326,9.4,0.122007966
22706,22706,Ray Sheppard,1988-89,22.0,2,65,74,74,38,27,65,173.0,,74,38,27,65,173.0,80,7.43,89,437,2435,12.2,0.8940123
22707,22707,Ray Sheppard,1989-90,23.0,3,43,67,67,22,21,43,147.0,,141,60,48,108,320.0,80,7.48,85,403,2430,12.3,0.62582195
22708,22708,Ray Sheppard,1990-91,24.0,4,6,18,18,4,2,6,31.0,,159,64,50,114,351.0,80,7.37,76,367,2421,12.2,0.5493947
22709,22709,Ray Sheppard,1991-92,25.0,5,47,59,59,24,23,47,129.0,,218,88,73,161,480.0,80,6.91,71,366,2385,11.6,0.75676095
22710,22710,Ray Sheppard,1992-93,26.0,6,62,74,74,36,26,62,178.0,,292,124,99,223,658.0,80,6.96,77,402,2440,11.4,0.80018234
22711,22711,Ray Sheppard,1993-94,27.0,7,66,70,70,32,34,66,183.0,,362,156,133,289,841.0,84,7.25,87,443,2603,11.7,0.80197245
22712,22712,Ray Sheppard,1994-95,28.0,8,93,82,82,52,41,93,260.0,,444,208,174,382,1101.0,84,6.48,76,407,2545,10.7,0.92581594
22713,22713,Ray Sheppard,1995-96,29.0,9,40,43,43,30,10,40,125.0,,487,238,184,422,1226.0,48,5.97,37,209,1408,10.2,0.8623658
22714,22714,Ray Sheppard,1996-97,30.0,10,60,70,70,37,23,60,231.0,,557,275,207,482,1457.0,82,6.29,74,413,2481,10.4,0.81574994
22715,22715,Ray Sheppard,1997-98,31.0,11,60,68,68,29,31,60,226.0,,625,304,238,542,1683.0,82,5.83,55,336,2444,9.8,0.6888467
22716,22716,Ray Sheppard,1998-99,32.0,12,37,71,71,18,19,37,169.0,,696,322,257,579,1852.0,82,5.28,57,380,2242,9.6,0.5615471
22717,22717,Ray Sheppard,1999-00,33.0,13,58,74,74,25,33,58,188.0,1347.0,770,347,290,637,2040.0,82,5.27,57,359,2285,9.4,0.6734836
22718,22718,Ray Sheppard,2000-01,34.0,14,20,47,47,10,10,20,74.0,640.0,817,357,300,657,2114.0,82,5.49,53,331,2294,9.8,0.41917524
22719,22719,Ray Staszak,1986-87,24.0,2,1,4,4,0,1,1,9.0,,4,0,1,1,9.0,80,7.94,82,370,2484,12.8,0.23476022
22720,22720,Ray Whitney,1992-93,20.0,2,3,2,2,0,3,3,4.0,,2,0,3,3,4.0,80,6.96,77,402,2440,11.4,0.32135284
22721,22721,Ray Whitney,1993-94,21.0,3,10,26,26,4,6,10,24.0,,28,4,9,13,28.0,84,7.25,87,443,2603,11.7,0.36806053
22722,22722,Ray Whitney,1994-95,22.0,4,40,61,61,14,26,40,82.0,,89,18,35,53,110.0,84,6.48,76,407,2545,10.7,0.52994174
22723,22723,Ray Whitney,1995-96,23.0,5,25,39,39,13,12,25,67.0,,128,31,47,78,177.0,48,5.97,37,209,1408,10.2,0.6027092
22724,22724,Ray Whitney,1996-97,24.0,6,41,60,60,17,24,41,106.0,,188,48,71,119,283.0,82,6.29,74,413,2481,10.4,0.55823034
22725,22725,Ray Whitney,1997-98,25.0,7,2,12,12,0,2,2,24.0,,200,48,73,121,307.0,82,5.83,55,336,2444,9.8,0.42809436
22726,22726,Ray Whitney,1998-99,26.0,8,65,77,77,33,32,65,175.0,,277,81,105,186,482.0,82,5.28,57,380,2242,9.6,0.7786001
22727,22727,Ray Whitney,1999-00,27.0,9,64,81,81,26,38,64,193.0,1485.0,358,107,143,250,675.0,82,5.27,57,359,2285,9.4,0.75341636
22728,22728,Ray Whitney,2000-01,28.0,10,71,81,81,29,42,71,198.0,1514.0,439,136,185,321,873.0,82,5.49,53,331,2294,9.8,0.81953484
22729,22729,Ray Whitney,2001-02,29.0,11,34,46,46,10,24,34,120.0,821.0,485,146,209,355,993.0,82,5.51,63,376,2272,9.9,0.628474
22730,22730,Ray Whitney,2002-03,30.0,12,61,67,67,21,40,61,210.0,1355.0,552,167,249,416,1203.0,82,5.24,53,338,2262,9.5,0.8454984
22731,22731,Ray Whitney,2003-04,31.0,13,76,81,81,24,52,76,235.0,1701.0,633,191,301,492,1438.0,82,5.31,60,363,2326,9.4,0.80646414
22732,22732,Ray Whitney,2004-05,32.0,14,43,67,67,14,29,43,119.0,1099.0,700,205,330,535,1557.0,82,5.14,57,348,2300,9.2,0.6258707
22733,22733,Ray Whitney,2006-07,34.0,15,55,63,63,17,38,55,147.0,1083.0,763,222,368,590,1704.0,82,6.05,85,480,2458,10.1,0.72151303
22734,22734,Ray Whitney,2007-08,35.0,16,83,81,81,32,51,83,215.0,1515.0,844,254,419,673,1919.0,82,5.76,70,398,2426,9.7,0.8584691
22735,22735,Ray Whitney,2008-09,36.0,17,61,66,66,25,36,61,204.0,1250.0,910,279,455,734,2123.0,82,5.44,62,351,2383,9.4,0.75331265
22736,22736,Ray Whitney,2009-10,37.0,18,77,82,82,24,53,77,219.0,1510.0,992,303,508,811,2342.0,82,5.7,65,341,2477,9.4,0.76032025
22737,22737,Ray Whitney,2010-11,38.0,19,58,80,80,21,37,58,171.0,1532.0,1072,324,545,869,2513.0,82,5.53,56,304,2486,9.1,0.6424496
22738,22738,Ray Whitney,2011-12,39.0,20,57,75,75,17,40,57,156.0,1272.0,1147,341,585,926,2669.0,82,5.46,52,291,2492,9.0,0.6307246
22739,22739,Ray Whitney,2012-13,40.0,21,77,82,82,24,53,77,185.0,1529.0,1229,365,638,1003,2854.0,82,5.32,47,271,2439,8.9,0.7760743
22740,22740,Ray Whitney,2013-14,41.0,22,29,32,32,11,18,29,62.0,621.0,1261,376,656,1032,2916.0,48,5.31,29,160,1399,9.1,0.6113016
22741,22741,Ray Whitney,2014-15,42.0,23,32,69,69,9,23,32,124.0,963.0,1330,385,679,1064,3040.0,82,5.34,48,269,2463,8.9,0.40310112
22742,22742,Raymond Sawada,2009-10,24.0,2,1,5,5,1,0,1,2.0,43.0,5,1,0,1,2.0,82,5.7,65,341,2477,9.4,0.21310806
22743,22743,Raymond Sawada,2010-11,25.0,3,0,5,5,0,0,0,2.0,41.0,10,1,0,1,4.0,82,5.53,56,304,2486,9.1,0.16502044
22744,22744,Raymond Sawada,2011-12,26.0,4,0,1,1,0,0,0,1.0,6.0,11,1,0,1,5.0,82,5.46,52,291,2492,9.0,0.15450764
22745,22745,Real Cloutier,1980-81,24.0,2,89,67,67,42,47,89,254.0,,67,42,47,89,254.0,80,7.03,61,280,2352,12.0,1.1396897
22746,22746,Real Cloutier,1981-82,25.0,3,31,34,34,15,16,31,89.0,,101,57,63,120,343.0,80,7.69,77,340,2441,12.6,1.0301201
22747,22747,Real Cloutier,1982-83,26.0,4,97,67,67,37,60,97,214.0,,168,94,123,217,557.0,80,8.03,73,320,2489,12.9,1.157718
22748,22748,Real Cloutier,1983-84,27.0,5,67,68,68,28,39,67,185.0,,236,122,162,284,742.0,80,7.73,71,310,2444,12.7,0.8632685
22749,22749,Real Cloutier,1984-85,28.0,6,60,77,77,24,36,60,169.0,,313,146,198,344,911.0,80,7.89,74,336,2448,12.9,0.6655533
22750,22750,Real Cloutier,1985-86,29.0,7,0,5,5,0,0,0,7.0,,318,146,198,344,918.0,80,7.77,71,321,2447,12.7,0.45132565
22751,22751,Reed Low,2001-02,25.0,2,6,56,56,1,5,6,31.0,352.0,56,1,5,6,31.0,82,5.51,63,376,2272,9.9,0.12268227
22752,22752,Reed Low,2002-03,26.0,3,5,58,58,0,5,5,25.0,311.0,114,1,10,11,56.0,82,5.24,53,338,2262,9.5,0.10456738
22753,22753,Reed Low,2003-04,27.0,4,6,79,79,2,4,6,48.0,499.0,193,3,14,17,104.0,82,5.31,60,363,2326,9.4,0.13064092
22754,22754,Reed Low,2004-05,28.0,5,2,57,57,0,2,2,28.0,325.0,250,3,16,19,132.0,82,5.14,57,348,2300,9.2,0.12081885
22755,22755,Reed Low,2007-08,31.0,6,0,6,6,0,0,0,0.0,21.0,256,3,16,19,132.0,82,5.76,70,398,2426,9.7,0.118703455
22756,22756,Reg Thomas,1980-81,27.0,2,16,39,39,9,7,16,89.0,,39,9,7,16,89.0,80,7.03,61,280,2352,12.0,0.44837043
22757,22757,Reggie Savage,1991-92,21.0,2,0,1,1,0,0,0,2.0,,1,0,0,0,2.0,80,6.91,71,366,2385,11.6,0.22542247
22758,22758,Reggie Savage,1993-94,23.0,3,5,16,16,2,3,5,20.0,,17,2,3,5,22.0,84,7.25,87,443,2603,11.7,0.30187684
22759,22759,Reggie Savage,1994-95,24.0,4,7,17,17,3,4,7,25.0,,34,5,7,12,47.0,84,6.48,76,407,2545,10.7,0.294551
22760,22760,Reid Bailey,1981-82,25.0,2,4,17,17,1,3,4,16.0,,17,1,3,4,16.0,80,7.69,77,340,2441,12.6,0.25359508
22761,22761,Reid Bailey,1982-83,26.0,3,0,10,10,0,0,0,7.0,,27,1,3,4,23.0,80,8.03,73,320,2489,12.9,0.19498065
22762,22762,Reid Bailey,1983-84,27.0,4,0,1,1,0,0,0,0.0,,28,1,3,4,23.0,80,7.73,71,310,2444,12.7,0.1788131
22763,22763,Reid Bailey,1984-85,28.0,5,0,12,12,0,0,0,8.0,,40,1,3,4,31.0,80,7.89,74,336,2448,12.9,0.14673755
22764,22764,Reid Boucher,2014-15,21.0,2,7,23,23,2,5,7,27.0,261.0,23,2,5,7,27.0,82,5.34,48,269,2463,8.9,0.30700096
22765,22765,Reid Boucher,2015-16,22.0,3,1,11,11,1,0,1,20.0,123.0,34,3,5,8,47.0,82,5.32,47,251,2453,8.9,0.25840762
22766,22766,Reid Boucher,2016-17,23.0,4,19,39,39,8,11,19,74.0,557.0,73,11,16,27,121.0,82,5.34,48,255,2438,9.0,0.45397392
22767,22767,Reid Boucher,2017-18,24.0,5,10,39,39,6,4,10,70.0,465.0,112,17,20,37,191.0,82,5.45,47,245,2478,9.0,0.28938693
22768,22768,Reid Boucher,2018-19,25.0,6,5,20,20,3,2,5,37.0,228.0,132,20,22,42,228.0,82,5.86,50,250,2620,9.2,0.2453028
22769,22769,Reid Boucher,2019-20,26.0,7,0,1,1,0,0,0,0.0,5.0,133,20,22,42,228.0,82,5.96,47,239,2579,9.5,0.18900165
22770,22770,Reid Simpson,1992-93,23.0,2,0,1,1,0,0,0,0.0,,1,0,0,0,0.0,80,6.96,77,402,2440,11.4,0.18171716
22771,22771,Reid Simpson,1993-94,24.0,3,0,1,1,0,0,0,0.0,,2,0,0,0,0.0,84,7.25,87,443,2603,11.7,0.15572512
22772,22772,Reid Simpson,1995-96,26.0,4,0,9,9,0,0,0,5.0,,11,0,0,0,5.0,48,5.97,37,209,1408,10.2,0.1765233
22773,22773,Reid Simpson,1996-97,27.0,5,6,23,23,1,5,6,8.0,,34,1,5,6,13.0,82,6.29,74,413,2481,10.4,0.14709818
22774,22774,Reid Simpson,1997-98,28.0,6,4,27,27,0,4,4,17.0,,61,1,9,10,30.0,82,5.83,55,336,2444,9.8,0.12741646
22775,22775,Reid Simpson,1998-99,29.0,7,5,44,44,3,2,5,24.0,,105,4,11,15,54.0,82,5.28,57,380,2242,9.6,0.12284851
22776,22776,Reid Simpson,1999-00,30.0,8,9,53,53,5,4,9,23.0,314.0,158,9,15,24,77.0,82,5.27,57,359,2285,9.4,0.10723013
22777,22777,Reid Simpson,2000-01,31.0,9,1,26,26,1,0,1,13.0,118.0,184,10,15,25,90.0,82,5.49,53,331,2294,9.8,0.09252411
22778,22778,Reid Simpson,2001-02,32.0,10,3,38,38,2,1,3,23.0,264.0,222,12,16,28,113.0,82,5.51,63,376,2272,9.9,0.11743972
22779,22779,Reid Simpson,2002-03,33.0,11,7,51,51,6,1,7,22.0,259.0,273,18,17,35,135.0,82,5.24,53,338,2262,9.5,0.10735056
22780,22780,Reid Simpson,2003-04,34.0,12,1,26,26,0,1,1,11.0,132.0,299,18,18,36,146.0,82,5.31,60,363,2326,9.4,0.07375783
22781,22781,Reid Simpson,2004-05,35.0,13,0,2,2,0,0,0,2.0,10.0,301,18,18,36,148.0,82,5.14,57,348,2300,9.2,0.13870132
22782,22782,Reijo Ruotsalainen,1982-83,22.0,2,56,78,78,18,38,56,247.0,,78,18,38,56,247.0,80,8.03,73,320,2489,12.9,0.7151887
22783,22783,Reijo Ruotsalainen,1983-84,23.0,3,69,77,77,16,53,69,230.0,,155,34,91,125,477.0,80,7.73,71,310,2444,12.7,0.8564408
22784,22784,Reijo Ruotsalainen,1984-85,24.0,4,59,74,74,20,39,59,288.0,,229,54,130,184,765.0,80,7.89,74,336,2448,12.9,0.8017533
22785,22785,Reijo Ruotsalainen,1985-86,25.0,5,73,80,80,28,45,73,256.0,,309,82,175,257,1021.0,80,7.77,71,321,2447,12.7,0.9129178
22786,22786,Reijo Ruotsalainen,1986-87,26.0,6,59,80,80,17,42,59,229.0,,389,99,217,316,1250.0,80,7.94,82,370,2484,12.8,0.75811005
22787,22787,Reijo Ruotsalainen,1987-88,27.0,7,13,16,16,5,8,13,52.0,,405,104,225,329,1302.0,80,7.34,72,344,2400,12.2,0.53493834
22788,22788,Reijo Ruotsalainen,1990-91,30.0,8,15,41,41,3,12,15,80.0,,446,107,237,344,1382.0,80,7.37,76,367,2421,12.2,0.43462726
22789,22789,Reilly Smith,2012-13,21.0,2,0,3,3,0,0,0,2.0,25.0,3,0,0,0,2.0,82,5.32,47,271,2439,8.9,0.21160346
22790,22790,Reilly Smith,2013-14,22.0,3,9,37,37,3,6,9,34.0,404.0,40,3,6,9,36.0,48,5.31,29,160,1399,9.1,0.2612548
22791,22791,Reilly Smith,2014-15,23.0,4,51,82,82,20,31,51,146.0,1206.0,122,23,37,60,182.0,82,5.34,48,269,2463,8.9,0.59170425
22792,22792,Reilly Smith,2015-16,24.0,5,40,81,81,13,27,40,143.0,1247.0,203,36,64,100,325.0,82,5.32,47,251,2453,8.9,0.49956363
22793,22793,Reilly Smith,2016-17,25.0,6,50,82,82,25,25,50,173.0,1526.0,285,61,89,150,498.0,82,5.34,48,255,2438,9.0,0.60616225
22794,22794,Reilly Smith,2017-18,26.0,7,37,80,80,15,22,37,160.0,1468.0,365,76,111,187,658.0,82,5.45,47,245,2478,9.0,0.54140353
22795,22795,Reilly Smith,2018-19,27.0,8,60,67,67,22,38,60,162.0,1201.0,432,98,149,247,820.0,82,5.86,50,250,2620,9.2,0.7215096
22796,22796,Reilly Smith,2019-20,28.0,9,53,74,74,19,34,53,178.0,1352.0,506,117,183,300,998.0,82,5.96,47,239,2579,9.5,0.67106634
22797,22797,Reilly Smith,2020-21,29.0,10,54,71,71,27,27,54,169.0,1272.0,577,144,210,354,1167.0,70,5.96,42,208,2192,9.5,0.72655976
22798,22798,Rejean Cloutier,1980-81,20.0,2,1,3,3,0,1,1,1.0,,3,0,1,1,1.0,80,7.03,61,280,2352,12.0,0.31316084
22799,22799,Rejean Cloutier,1982-83,22.0,3,1,2,2,0,1,1,0.0,,5,0,2,2,1.0,80,8.03,73,320,2489,12.9,0.22020486
22800,22800,Rem Murray,1997-98,25.0,2,31,82,82,11,20,31,85.0,,82,11,20,31,85.0,82,5.83,55,336,2444,9.8,0.38311407
22801,22801,Rem Murray,1998-99,26.0,3,18,61,61,9,9,18,59.0,,143,20,29,49,144.0,82,5.28,57,380,2242,9.6,0.2918504
22802,22802,Rem Murray,1999-00,27.0,4,39,78,78,21,18,39,116.0,1235.0,221,41,47,88,260.0,82,5.27,57,359,2285,9.4,0.46262425
22803,22803,Rem Murray,2000-01,28.0,5,14,44,44,9,5,14,65.0,628.0,265,50,52,102,325.0,82,5.49,53,331,2294,9.8,0.32812697
22804,22804,Rem Murray,2001-02,29.0,6,36,82,82,15,21,36,122.0,1259.0,347,65,73,138,447.0,82,5.51,63,376,2272,9.9,0.4241584
22805,22805,Rem Murray,2002-03,30.0,7,27,80,80,8,19,27,98.0,1172.0,427,73,92,165,545.0,82,5.24,53,338,2262,9.5,0.35763773
22806,22806,Rem Murray,2003-04,31.0,8,31,85,85,12,19,31,143.0,1416.0,512,85,111,196,688.0,82,5.31,60,363,2326,9.4,0.36571085
22807,22807,Rem Murray,2004-05,32.0,9,17,39,39,8,9,17,58.0,648.0,551,93,120,213,746.0,82,5.14,57,348,2300,9.2,0.36347708
22808,22808,Rem Murray,2006-07,34.0,10,2,9,9,1,1,2,6.0,70.0,560,94,121,215,752.0,82,6.05,85,480,2458,10.1,0.1933417
22809,22809,Rem Pitlick,2019-20,22.0,2,0,1,1,0,0,0,0.0,10.0,1,0,0,0,0.0,82,5.96,47,239,2579,9.5,0.17225754
22810,22810,Remi Elie,2017-18,22.0,2,7,18,18,1,6,7,15.0,281.0,18,1,6,7,15.0,82,5.45,47,245,2478,9.0,0.24635509
22811,22811,Remi Elie,2018-19,23.0,3,14,72,72,6,8,14,70.0,738.0,90,7,14,21,85.0,82,5.86,50,250,2620,9.2,0.23973128
22812,22812,Remi Elie,2019-20,24.0,4,1,16,16,0,1,1,9.0,166.0,106,7,15,22,94.0,82,5.96,47,239,2579,9.5,0.20198
22813,22813,Remi Royer,1999-00,21.0,2,0,18,18,0,0,0,24.0,245.0,18,0,0,0,24.0,82,5.27,57,359,2285,9.4,0.20498925
22814,22814,Rene Bourque,2006-07,25.0,2,34,77,77,16,18,34,180.0,1181.0,77,16,18,34,180.0,82,6.05,85,480,2458,10.1,0.45612442
22815,22815,Rene Bourque,2007-08,26.0,3,17,44,44,7,10,17,82.0,705.0,121,23,28,51,262.0,82,5.76,70,398,2426,9.7,0.3512646
22816,22816,Rene Bourque,2008-09,27.0,4,24,62,62,10,14,24,103.0,947.0,183,33,42,75,365.0,82,5.44,62,351,2383,9.4,0.37202996
22817,22817,Rene Bourque,2009-10,28.0,5,40,58,58,21,19,40,149.0,933.0,241,54,61,115,514.0,82,5.7,65,341,2477,9.4,0.59527856
22818,22818,Rene Bourque,2010-11,29.0,6,58,73,73,27,31,58,215.0,1337.0,314,81,92,173,729.0,82,5.53,56,304,2486,9.1,0.6792782
22819,22819,Rene Bourque,2011-12,30.0,7,50,80,80,27,23,50,218.0,1420.0,394,108,115,223,947.0,82,5.46,52,291,2492,9.0,0.5805551
22820,22820,Rene Bourque,2012-13,31.0,8,24,76,76,18,6,24,158.0,1355.0,470,126,121,247,1105.0,82,5.32,47,271,2439,8.9,0.3606822
22821,22821,Rene Bourque,2013-14,32.0,9,13,27,27,7,6,13,63.0,441.0,497,133,127,260,1168.0,48,5.31,29,160,1399,9.1,0.37896216
22822,22822,Rene Bourque,2014-15,33.0,10,16,63,63,9,7,16,118.0,894.0,560,142,134,276,1286.0,82,5.34,48,269,2463,8.9,0.27069756
22823,22823,Rene Bourque,2015-16,34.0,11,14,51,51,6,8,14,85.0,644.0,611,148,142,290,1371.0,82,5.32,47,251,2453,8.9,0.28577948
22824,22824,Rene Bourque,2016-17,35.0,12,8,49,49,3,5,8,77.0,512.0,660,151,147,298,1448.0,82,5.34,48,255,2438,9.0,0.22033492
22825,22825,Rene Bourque,2017-18,36.0,13,18,65,65,12,6,18,111.0,906.0,725,163,153,316,1559.0,82,5.45,47,245,2478,9.0,0.26440305
22826,22826,Rene Chapdelaine,1991-92,25.0,2,1,3,3,0,1,1,1.0,,3,0,1,1,1.0,80,6.91,71,366,2385,11.6,0.20556521
22827,22827,Rene Chapdelaine,1992-93,26.0,3,1,16,16,0,1,1,6.0,,19,0,2,2,7.0,80,6.96,77,402,2440,11.4,0.1930488
22828,22828,Rene Chapdelaine,1993-94,27.0,4,0,13,13,0,0,0,5.0,,32,0,2,2,12.0,84,7.25,87,443,2603,11.7,0.16450289
22829,22829,Rene Corbet,1994-95,21.0,2,2,9,9,1,1,2,14.0,,9,1,1,2,14.0,84,6.48,76,407,2545,10.7,0.26859754
22830,22830,Rene Corbet,1995-96,22.0,3,3,8,8,0,3,3,4.0,,17,1,4,5,18.0,48,5.97,37,209,1408,10.2,0.22183469
22831,22831,Rene Corbet,1996-97,23.0,4,9,33,33,3,6,9,35.0,,50,4,10,14,53.0,82,6.29,74,413,2481,10.4,0.26835454
22832,22832,Rene Corbet,1997-98,24.0,5,27,76,76,12,15,27,128.0,,126,16,25,41,181.0,82,5.83,55,336,2444,9.8,0.33393973
22833,22833,Rene Corbet,1998-99,25.0,6,28,68,68,16,12,28,117.0,,194,32,37,69,298.0,82,5.28,57,380,2242,9.6,0.41191933
22834,22834,Rene Corbet,1999-00,26.0,7,31,73,73,13,18,31,127.0,979.0,267,45,55,100,425.0,82,5.27,57,359,2285,9.4,0.43211278
22835,22835,Rene Corbet,2000-01,27.0,8,15,52,52,5,10,15,109.0,605.0,319,50,65,115,534.0,82,5.49,53,331,2294,9.8,0.30041617
22836,22836,Rene Corbet,2001-02,28.0,9,17,43,43,8,9,17,85.0,493.0,362,58,74,132,619.0,82,5.51,63,376,2272,9.9,0.36130202
22837,22837,Reto Von Arx,2001-02,25.0,2,4,19,19,3,1,4,12.0,217.0,19,3,1,4,12.0,82,5.51,63,376,2272,9.9,0.17162886
22838,22838,Rhett Gardner,2020-21,24.0,2,0,8,8,0,0,0,8.0,81.0,8,0,0,0,8.0,70,5.96,42,208,2192,9.5,0.1911138
22839,22839,Rhett Rakhshani,2011-12,23.0,2,0,2,2,0,0,0,2.0,23.0,2,0,0,0,2.0,82,5.46,52,291,2492,9.0,0.17343244
22840,22840,Rhett Rakhshani,2012-13,24.0,3,0,5,5,0,0,0,3.0,61.0,7,0,0,0,5.0,82,5.32,47,271,2439,8.9,0.16270116
22841,22841,Rhett Warrener,1996-97,21.0,2,3,28,28,0,3,3,19.0,,28,0,3,3,19.0,82,6.29,74,413,2481,10.4,0.21659884
22842,22842,Rhett Warrener,1997-98,22.0,3,13,62,62,4,9,13,58.0,,90,4,12,16,77.0,82,5.83,55,336,2444,9.8,0.20868751
22843,22843,Rhett Warrener,1998-99,23.0,4,4,79,79,0,4,4,66.0,,169,4,16,20,143.0,82,5.28,57,380,2242,9.6,0.16281822
22844,22844,Rhett Warrener,1999-00,24.0,5,8,61,61,1,7,8,44.0,1150.0,230,5,23,28,187.0,82,5.27,57,359,2285,9.4,0.17098385
22845,22845,Rhett Warrener,2000-01,25.0,6,3,61,61,0,3,3,68.0,1211.0,291,5,26,31,255.0,82,5.49,53,331,2294,9.8,0.13436142
22846,22846,Rhett Warrener,2001-02,26.0,7,19,77,77,3,16,19,103.0,1570.0,368,8,42,50,358.0,82,5.51,63,376,2272,9.9,0.23475987
22847,22847,Rhett Warrener,2002-03,27.0,8,10,65,65,5,5,10,66.0,1277.0,433,13,47,60,424.0,82,5.24,53,338,2262,9.5,0.18278727
22848,22848,Rhett Warrener,2003-04,28.0,9,9,50,50,0,9,9,47.0,912.0,483,13,56,69,471.0,82,5.31,60,363,2326,9.4,0.151517
22849,22849,Rhett Warrener,2004-05,29.0,10,17,77,77,3,14,17,82.0,1530.0,560,16,70,86,553.0,82,5.14,57,348,2300,9.2,0.19383472
22850,22850,Rhett Warrener,2006-07,31.0,11,6,61,61,3,3,6,40.0,1171.0,621,19,73,92,593.0,82,6.05,85,480,2458,10.1,0.12400401
22851,22851,Rhett Warrener,2007-08,32.0,12,10,62,62,4,6,10,31.0,1062.0,683,23,79,102,624.0,82,5.76,70,398,2426,9.7,0.12258458
22852,22852,Rhett Warrener,2008-09,33.0,13,4,31,31,1,3,4,15.0,416.0,714,24,82,106,639.0,82,5.44,62,351,2383,9.4,0.1271685
22853,22853,Ric Jackman,2000-01,22.0,2,3,22,22,1,2,3,16.0,178.0,22,1,2,3,16.0,82,5.49,53,331,2294,9.8,0.18079531
22854,22854,Ric Jackman,2001-02,23.0,3,0,16,16,0,0,0,10.0,142.0,38,1,2,3,26.0,82,5.51,63,376,2272,9.9,0.15560931
22855,22855,Ric Jackman,2002-03,24.0,4,0,2,2,0,0,0,4.0,27.0,40,1,2,3,30.0,82,5.24,53,338,2262,9.5,0.15050226
22856,22856,Ric Jackman,2003-04,25.0,5,2,42,42,0,2,2,35.0,587.0,82,1,4,5,65.0,82,5.31,60,363,2326,9.4,0.14754018
22857,22857,Ric Jackman,2004-05,26.0,6,30,54,54,9,21,30,91.0,1128.0,136,10,25,35,156.0,82,5.14,57,348,2300,9.2,0.4635959
22858,22858,Ric Jackman,2006-07,28.0,7,30,64,64,7,23,30,120.0,1110.0,200,17,48,65,276.0,82,6.05,85,480,2458,10.1,0.4195763
22859,22859,Ric Jackman,2007-08,29.0,8,12,31,31,2,10,12,36.0,425.0,231,19,58,77,312.0,82,5.76,70,398,2426,9.7,0.23478723
22860,22860,Ric Nattress,1983-84,21.0,2,4,40,40,1,3,4,44.0,,40,1,3,4,44.0,80,7.73,71,310,2444,12.7,0.2580911
22861,22861,Ric Nattress,1984-85,22.0,3,12,34,34,0,12,12,31.0,,74,1,15,16,75.0,80,7.89,74,336,2448,12.9,0.21900177
22862,22862,Ric Nattress,1985-86,23.0,4,1,5,5,0,1,1,3.0,,79,1,16,17,78.0,80,7.77,71,321,2447,12.7,0.2334911
22863,22863,Ric Nattress,1986-87,24.0,5,24,78,78,4,20,24,124.0,,157,5,36,41,202.0,80,7.94,82,370,2484,12.8,0.27888933
22864,22864,Ric Nattress,1987-88,25.0,6,28,73,73,6,22,28,135.0,,230,11,58,69,337.0,80,7.34,72,344,2400,12.2,0.40108684
22865,22865,Ric Nattress,1988-89,26.0,7,15,63,63,2,13,15,48.0,,293,13,71,84,385.0,80,7.43,89,437,2435,12.2,0.23936951
22866,22866,Ric Nattress,1989-90,27.0,8,9,38,38,1,8,9,28.0,,331,14,79,93,413.0,80,7.48,85,403,2430,12.3,0.18551186
22867,22867,Ric Nattress,1990-91,28.0,9,15,49,49,1,14,15,65.0,,380,15,93,108,478.0,80,7.37,76,367,2421,12.2,0.2527908
22868,22868,Ric Nattress,1991-92,29.0,10,18,58,58,5,13,18,81.0,,438,20,106,126,559.0,80,6.91,71,366,2385,11.6,0.2941486
22869,22869,Ric Nattress,1992-93,30.0,11,21,54,54,2,19,21,66.0,,492,22,125,147,625.0,80,6.96,77,402,2440,11.4,0.32221523
22870,22870,Ric Nattress,1993-94,31.0,12,17,44,44,7,10,17,57.0,,536,29,135,164,682.0,84,7.25,87,443,2603,11.7,0.28798527
22871,22871,Ricard Persson,1996-97,27.0,2,3,12,12,2,1,3,41.0,,12,2,1,3,41.0,82,6.29,74,413,2481,10.4,0.2869674
22872,22872,Ricard Persson,1997-98,28.0,3,12,54,54,4,8,12,70.0,,66,6,9,15,111.0,82,5.83,55,336,2444,9.8,0.21763286
22873,22873,Ricard Persson,1998-99,29.0,4,0,1,1,0,0,0,0.0,,67,6,9,15,111.0,82,5.28,57,380,2242,9.6,0.17463991
22874,22874,Ricard Persson,1999-00,30.0,5,13,54,54,1,12,13,52.0,1078.0,121,7,21,28,163.0,82,5.27,57,359,2285,9.4,0.17530769
22875,22875,Ricard Persson,2000-01,31.0,6,8,41,41,0,8,8,30.0,508.0,162,7,29,36,193.0,82,5.49,53,331,2294,9.8,0.117767036
22876,22876,Ricard Persson,2001-02,32.0,7,9,33,33,1,8,9,43.0,564.0,195,8,37,45,236.0,82,5.51,63,376,2272,9.9,0.18954766
22877,22877,Ricard Persson,2002-03,33.0,8,9,34,34,2,7,9,35.0,495.0,229,10,44,54,271.0,82,5.24,53,338,2262,9.5,0.18949687
22878,22878,Rich Brennan,1997-98,25.0,2,0,2,2,0,0,0,0.0,,2,0,0,0,0.0,82,5.83,55,336,2444,9.8,0.14142263
22879,22879,Rich Brennan,1998-99,26.0,3,3,11,11,1,2,3,24.0,,13,1,2,3,24.0,82,5.28,57,380,2242,9.6,0.2540597
22880,22880,Rich Brennan,1999-00,27.0,4,4,24,24,1,3,4,36.0,313.0,37,2,5,7,60.0,82,5.27,57,359,2285,9.4,0.17493227
22881,22881,Rich Brennan,2001-02,29.0,5,0,2,2,0,0,0,1.0,29.0,39,2,5,7,61.0,82,5.51,63,376,2272,9.9,0.13448155
22882,22882,Rich Brennan,2002-03,30.0,6,0,4,4,0,0,0,0.0,58.0,43,2,5,7,61.0,82,5.24,53,338,2262,9.5,0.1355412
22883,22883,Rich Brennan,2003-04,31.0,7,1,7,7,0,1,1,12.0,95.0,50,2,6,8,73.0,82,5.31,60,363,2326,9.4,0.16215786
22884,22884,Rich Chernomaz,1982-83,19.0,2,0,2,2,0,0,0,2.0,,2,0,0,0,2.0,80,8.03,73,320,2489,12.9,0.27447498
22885,22885,Rich Chernomaz,1984-85,21.0,3,3,7,7,2,1,3,7.0,,9,2,1,3,9.0,80,7.89,74,336,2448,12.9,0.36254472
22886,22886,Rich Chernomaz,1985-86,22.0,4,2,3,3,0,2,2,2.0,,12,2,3,5,11.0,80,7.77,71,321,2447,12.7,0.26694852
22887,22887,Rich Chernomaz,1987-88,24.0,5,10,25,25,6,4,10,44.0,,37,8,7,15,55.0,80,7.34,72,344,2400,12.2,0.37262735
22888,22888,Rich Chernomaz,1988-89,25.0,6,1,2,2,1,0,1,5.0,,39,9,7,16,60.0,80,7.43,89,437,2435,12.2,0.23055363
22889,22889,Rich Chernomaz,1989-90,26.0,7,0,1,1,0,0,0,2.0,,40,9,7,16,62.0,80,7.48,85,403,2430,12.3,0.20160475
22890,22890,Rich Chernomaz,1992-93,29.0,8,0,11,11,0,0,0,21.0,,51,9,7,16,83.0,80,6.96,77,402,2440,11.4,0.2284866
22891,22891,Rich Clune,2010-11,23.0,2,2,14,14,0,2,2,7.0,102.0,14,0,2,2,7.0,82,5.53,56,304,2486,9.1,0.18028048
22892,22892,Rich Clune,2013-14,26.0,3,9,47,47,4,5,9,46.0,442.0,61,4,7,11,53.0,48,5.31,29,160,1399,9.1,0.19100538
22893,22893,Rich Clune,2014-15,27.0,4,7,58,58,3,4,7,29.0,491.0,119,7,11,18,82.0,82,5.34,48,269,2463,8.9,0.1173372
22894,22894,Rich Clune,2015-16,28.0,5,0,1,1,0,0,0,0.0,6.0,120,7,11,18,82.0,82,5.32,47,251,2453,8.9,0.13915381
22895,22895,Rich Clune,2016-17,29.0,6,4,19,19,0,4,4,10.0,154.0,139,7,15,22,92.0,82,5.34,48,255,2438,9.0,0.09789622
22896,22896,Rich Costello,1984-85,21.0,2,3,10,10,2,1,3,7.0,,10,2,1,3,7.0,80,7.89,74,336,2448,12.9,0.37054864
22897,22897,Rich Costello,1986-87,23.0,3,1,2,2,0,1,1,2.0,,12,2,2,4,9.0,80,7.94,82,370,2484,12.8,0.23299184
22898,22898,Rich Peverley,2007-08,25.0,2,1,13,13,0,1,1,9.0,98.0,13,0,1,1,9.0,82,5.76,70,398,2426,9.7,0.17710084
22899,22899,Rich Peverley,2008-09,26.0,3,10,33,33,5,5,10,43.0,341.0,46,5,6,11,52.0,82,5.44,62,351,2383,9.4,0.2378115
22900,22900,Rich Peverley,2009-10,27.0,4,44,66,66,15,29,44,117.0,1062.0,112,20,35,55,169.0,82,5.7,65,341,2477,9.4,0.51751775
22901,22901,Rich Peverley,2010-11,28.0,5,55,82,82,22,33,55,166.0,1530.0,194,42,68,110,335.0,82,5.53,56,304,2486,9.1,0.58011264
22902,22902,Rich Peverley,2011-12,29.0,6,41,82,82,18,23,41,201.0,1497.0,276,60,91,151,536.0,82,5.46,52,291,2492,9.0,0.5370413
22903,22903,Rich Peverley,2012-13,30.0,7,42,57,57,11,31,42,112.0,963.0,333,71,122,193,648.0,82,5.32,47,271,2439,8.9,0.576756
22904,22904,Rich Peverley,2013-14,31.0,8,18,47,47,6,12,18,95.0,717.0,380,77,134,211,743.0,48,5.31,29,160,1399,9.1,0.43713877
22905,22905,Rich Peverley,2014-15,32.0,9,30,62,62,7,23,30,122.0,954.0,442,84,157,241,865.0,82,5.34,48,269,2463,8.9,0.42641518
22906,22906,Rich Pilon,1989-90,21.0,2,14,62,62,0,14,14,47.0,,62,0,14,14,47.0,80,7.48,85,403,2430,12.3,0.2673368
22907,22907,Rich Pilon,1990-91,22.0,3,2,14,14,0,2,2,5.0,,76,0,16,16,52.0,80,7.37,76,367,2421,12.2,0.21021077
22908,22908,Rich Pilon,1991-92,23.0,4,5,60,60,1,4,5,33.0,,136,1,20,21,85.0,80,6.91,71,366,2385,11.6,0.18151411
22909,22909,Rich Pilon,1992-93,24.0,5,7,65,65,1,6,7,27.0,,201,2,26,28,112.0,80,6.96,77,402,2440,11.4,0.13314307
22910,22910,Rich Pilon,1993-94,25.0,6,4,44,44,1,3,4,20.0,,245,3,29,32,132.0,84,7.25,87,443,2603,11.7,0.110194206
22911,22911,Rich Pilon,1994-95,26.0,7,5,28,28,1,4,5,20.0,,273,4,33,37,152.0,84,6.48,76,407,2545,10.7,0.15739772
22912,22912,Rich Pilon,1995-96,27.0,8,2,20,20,1,1,2,11.0,,293,5,34,39,163.0,48,5.97,37,209,1408,10.2,0.11142042
22913,22913,Rich Pilon,1996-97,28.0,9,3,27,27,0,3,3,7.0,,320,5,37,42,170.0,82,6.29,74,413,2481,10.4,0.115475714
22914,22914,Rich Pilon,1997-98,29.0,10,5,52,52,1,4,5,17.0,,372,6,41,47,187.0,82,5.83,55,336,2444,9.8,0.101162374
22915,22915,Rich Pilon,1998-99,30.0,11,7,76,76,0,7,7,37.0,,448,6,48,54,224.0,82,5.28,57,380,2242,9.6,0.11828765
22916,22916,Rich Pilon,1999-00,31.0,12,4,52,52,0,4,4,27.0,862.0,500,6,52,58,251.0,82,5.27,57,359,2285,9.4,0.09537697
22917,22917,Rich Pilon,2000-01,32.0,13,6,54,54,0,6,6,16.0,889.0,554,6,58,64,267.0,82,5.49,53,331,2294,9.8,0.09572378
22918,22918,Rich Pilon,2001-02,33.0,14,11,69,69,2,9,11,24.0,1164.0,623,8,67,75,291.0,82,5.51,63,376,2272,9.9,0.1192272
22919,22919,Rich Pilon,2002-03,34.0,15,2,8,8,0,2,2,3.0,102.0,631,8,69,77,294.0,82,5.24,53,338,2262,9.5,0.12757891
22920,22920,Rich Preston,1980-81,28.0,2,61,80,80,31,30,61,205.0,,80,31,30,61,205.0,80,7.03,61,280,2352,12.0,0.68082744
22921,22921,Rich Preston,1981-82,29.0,3,21,47,47,7,14,21,100.0,,127,38,44,82,305.0,80,7.69,77,340,2441,12.6,0.468566
22922,22922,Rich Preston,1982-83,30.0,4,43,75,75,15,28,43,122.0,,202,53,72,125,427.0,80,8.03,73,320,2489,12.9,0.49167842
22923,22923,Rich Preston,1983-84,31.0,5,53,79,79,25,28,53,161.0,,281,78,100,178,588.0,80,7.73,71,310,2444,12.7,0.5956014
22924,22924,Rich Preston,1984-85,32.0,6,28,75,75,10,18,28,109.0,,356,88,118,206,697.0,80,7.89,74,336,2448,12.9,0.38974905
22925,22925,Rich Preston,1985-86,33.0,7,27,75,75,12,15,27,106.0,,431,100,133,233,803.0,80,7.77,71,321,2447,12.7,0.3454707
22926,22926,Rich Preston,1986-87,34.0,8,41,76,76,19,22,41,118.0,,507,119,155,274,921.0,80,7.94,82,370,2484,12.8,0.4351121
22927,22927,Rich Preston,1987-88,35.0,9,17,73,73,8,9,17,55.0,,580,127,164,291,976.0,80,7.34,72,344,2400,12.2,0.25419813
22928,22928,Rich Sutter,1983-84,20.0,2,0,4,4,0,0,0,3.0,,4,0,0,0,3.0,80,7.73,71,310,2444,12.7,0.2855187
22929,22929,Rich Sutter,1984-85,21.0,3,28,75,75,16,12,28,134.0,,79,16,12,28,137.0,80,7.89,74,336,2448,12.9,0.51147413
22930,22930,Rich Sutter,1985-86,22.0,4,16,56,56,6,10,16,62.0,,135,22,22,44,199.0,80,7.77,71,321,2447,12.7,0.3829982
22931,22931,Rich Sutter,1986-87,23.0,5,39,78,78,14,25,39,123.0,,213,36,47,83,322.0,80,7.94,82,370,2484,12.8,0.5022402
22932,22932,Rich Sutter,1987-88,24.0,6,42,74,74,20,22,42,166.0,,287,56,69,125,488.0,80,7.34,72,344,2400,12.2,0.531529
22933,22933,Rich Sutter,1988-89,25.0,7,30,80,80,15,15,30,132.0,,367,71,84,155,620.0,80,7.43,89,437,2435,12.2,0.45550433
22934,22934,Rich Sutter,1989-90,26.0,8,32,75,75,17,15,32,125.0,,442,88,99,187,745.0,80,7.48,85,403,2430,12.3,0.43277413
22935,22935,Rich Sutter,1990-91,27.0,9,20,74,74,11,9,20,122.0,,516,99,108,207,867.0,80,7.37,76,367,2421,12.2,0.31007767
22936,22936,Rich Sutter,1991-92,28.0,10,27,77,77,16,11,27,130.0,,593,115,119,234,997.0,80,6.91,71,366,2385,11.6,0.37231845
22937,22937,Rich Sutter,1992-93,29.0,11,25,77,77,9,16,25,113.0,,670,124,135,259,1110.0,80,6.96,77,402,2440,11.4,0.2990172
22938,22938,Rich Sutter,1993-94,30.0,12,27,84,84,13,14,27,148.0,,754,137,149,286,1258.0,84,7.25,87,443,2603,11.7,0.34382325
22939,22939,Rich Sutter,1994-95,31.0,13,26,83,83,12,14,26,122.0,,837,149,163,312,1380.0,84,6.48,76,407,2545,10.7,0.2746409
22940,22940,Rich Sutter,1995-96,32.0,14,3,37,37,0,3,3,39.0,,874,149,166,315,1419.0,48,5.97,37,209,1408,10.2,0.2074115
22941,22941,Richard David,1980-81,22.0,2,0,10,10,0,0,0,10.0,,10,0,0,0,10.0,80,7.03,61,280,2352,12.0,0.23352721
22942,22942,Richard David,1982-83,24.0,3,2,5,5,1,1,2,6.0,,15,1,1,2,16.0,80,8.03,73,320,2489,12.9,0.23895478
22943,22943,Richard David,1983-84,25.0,4,6,16,16,3,3,6,13.0,,31,4,4,8,29.0,80,7.73,71,310,2444,12.7,0.2932093
22944,22944,Richard Hajdu,1986-87,21.0,2,0,3,3,0,0,0,2.0,,3,0,0,0,2.0,80,7.94,82,370,2484,12.8,0.23389101
22945,22945,Richard Hajdu,1987-88,22.0,3,0,2,2,0,0,0,1.0,,5,0,0,0,3.0,80,7.34,72,344,2400,12.2,0.21975204
22946,22946,Richard Kromm,1984-85,20.0,2,23,53,53,11,12,23,66.0,,53,11,12,23,66.0,80,7.89,74,336,2448,12.9,0.45287824
22947,22947,Richard Kromm,1985-86,21.0,3,52,73,73,20,32,52,140.0,,126,31,44,75,206.0,80,7.77,71,321,2447,12.7,0.70887834
22948,22948,Richard Kromm,1986-87,22.0,4,43,77,77,19,24,43,120.0,,203,50,68,118,326.0,80,7.94,82,370,2484,12.8,0.56383973
22949,22949,Richard Kromm,1987-88,23.0,5,29,70,70,12,17,29,109.0,,273,62,85,147,435.0,80,7.34,72,344,2400,12.2,0.4968999
22950,22950,Richard Kromm,1988-89,24.0,6,15,71,71,5,10,15,84.0,,344,67,95,162,519.0,80,7.43,89,437,2435,12.2,0.38545257
22951,22951,Richard Kromm,1989-90,25.0,7,7,20,20,1,6,7,12.0,,364,68,101,169,531.0,80,7.48,85,403,2430,12.3,0.3357829
22952,22952,Richard Kromm,1991-92,27.0,8,1,6,6,1,0,1,6.0,,370,69,101,170,537.0,80,6.91,71,366,2385,11.6,0.30570436
22953,22953,Richard Kromm,1992-93,28.0,9,0,1,1,0,0,0,0.0,,371,69,101,170,537.0,80,6.96,77,402,2440,11.4,1.6139976
22954,22954,Richard Kromm,1993-94,29.0,10,3,1,1,1,2,3,2.0,,372,70,103,173,539.0,84,7.25,87,443,2603,11.7,0.6659879
22955,22955,Richard Lintner,2000-01,23.0,2,6,33,33,1,5,6,58.0,490.0,33,1,5,6,58.0,82,5.49,53,331,2294,9.8,0.22946489
22956,22956,Richard Lintner,2001-02,24.0,3,8,50,50,3,5,8,81.0,654.0,83,4,10,14,139.0,82,5.51,63,376,2272,9.9,0.232954
22957,22957,Richard Lintner,2003-04,26.0,4,6,29,29,4,2,6,45.0,504.0,112,8,12,20,184.0,82,5.31,60,363,2326,9.4,0.2264381
22958,22958,Richard Matvichuk,1993-94,20.0,2,5,53,53,2,3,5,51.0,,53,2,3,5,51.0,84,7.25,87,443,2603,11.7,0.24397287
22959,22959,Richard Matvichuk,1994-95,21.0,3,3,25,25,0,3,3,18.0,,78,2,6,8,69.0,84,6.48,76,407,2545,10.7,0.22030511
22960,22960,Richard Matvichuk,1995-96,22.0,4,2,14,14,0,2,2,21.0,,92,2,8,10,90.0,48,5.97,37,209,1408,10.2,0.24905464
22961,22961,Richard Matvichuk,1996-97,23.0,5,22,73,73,6,16,22,81.0,,165,8,24,32,171.0,82,6.29,74,413,2481,10.4,0.293954
22962,22962,Richard Matvichuk,1997-98,24.0,6,12,57,57,5,7,12,83.0,,222,13,31,44,254.0,82,5.83,55,336,2444,9.8,0.24017638
22963,22963,Richard Matvichuk,1998-99,25.0,7,18,74,74,3,15,18,71.0,,296,16,46,62,325.0,82,5.28,57,380,2242,9.6,0.22739449
22964,22964,Richard Matvichuk,1999-00,26.0,8,12,64,64,3,9,12,54.0,1364.0,360,19,55,74,379.0,82,5.27,57,359,2285,9.4,0.17790127
22965,22965,Richard Matvichuk,2000-01,27.0,9,25,70,70,4,21,25,73.0,1712.0,430,23,76,99,452.0,82,5.49,53,331,2294,9.8,0.2727287
22966,22966,Richard Matvichuk,2001-02,28.0,10,20,78,78,4,16,20,85.0,1786.0,508,27,92,119,537.0,82,5.51,63,376,2272,9.9,0.23315525
22967,22967,Richard Matvichuk,2002-03,29.0,11,21,82,82,9,12,21,109.0,1951.0,590,36,104,140,646.0,82,5.24,53,338,2262,9.5,0.27009112
22968,22968,Richard Matvichuk,2003-04,30.0,12,6,68,68,1,5,6,59.0,1318.0,658,37,109,146,705.0,82,5.31,60,363,2326,9.4,0.1414035
22969,22969,Richard Matvichuk,2004-05,31.0,13,21,75,75,1,20,21,85.0,1638.0,733,38,129,167,790.0,82,5.14,57,348,2300,9.2,0.21634051
22970,22970,Richard Matvichuk,2006-07,33.0,14,11,62,62,1,10,11,43.0,1130.0,795,39,139,178,833.0,82,6.05,85,480,2458,10.1,0.11732656
22971,22971,Richard Matvichuk,2007-08,34.0,15,0,1,1,0,0,0,0.0,13.0,796,39,139,178,833.0,82,5.76,70,398,2426,9.7,0.22822735
22972,22972,Richard Panik,2013-14,22.0,2,9,25,25,5,4,9,34.0,283.0,25,5,4,9,34.0,48,5.31,29,160,1399,9.1,0.34775445
22973,22973,Richard Panik,2014-15,23.0,3,13,50,50,3,10,13,56.0,635.0,75,8,14,22,90.0,82,5.34,48,269,2463,8.9,0.27792138
22974,22974,Richard Panik,2015-16,24.0,4,17,76,76,11,6,17,87.0,885.0,151,19,20,39,177.0,82,5.32,47,251,2453,8.9,0.25344306
22975,22975,Richard Panik,2016-17,25.0,5,8,30,30,6,2,8,39.0,325.0,181,25,22,47,216.0,82,5.34,48,255,2438,9.0,0.27641112
22976,22976,Richard Panik,2017-18,26.0,6,44,82,82,22,22,44,155.0,1208.0,263,47,44,91,371.0,82,5.45,47,245,2478,9.0,0.5053316
22977,22977,Richard Panik,2018-19,27.0,7,35,72,72,14,21,35,136.0,1094.0,335,61,65,126,507.0,82,5.86,50,250,2620,9.2,0.44608337
22978,22978,Richard Panik,2019-20,28.0,8,33,75,75,14,19,33,140.0,1246.0,410,75,84,159,647.0,82,5.96,47,239,2579,9.5,0.40734166
22979,22979,Richard Panik,2020-21,29.0,9,22,59,59,9,13,22,67.0,669.0,469,84,97,181,714.0,70,5.96,42,208,2192,9.5,0.3326348
22980,22980,Richard Park,1995-96,19.0,2,1,1,1,0,1,1,4.0,,1,0,1,1,4.0,48,5.97,37,209,1408,10.2,0.26746184
22981,22981,Richard Park,1996-97,20.0,3,10,56,56,4,6,10,62.0,,57,4,7,11,66.0,82,6.29,74,413,2481,10.4,0.26660794
22982,22982,Richard Park,1997-98,21.0,4,2,12,12,1,1,2,10.0,,69,5,8,13,76.0,82,5.83,55,336,2444,9.8,0.2790748
22983,22983,Richard Park,1998-99,22.0,5,2,15,15,0,2,2,14.0,,84,5,10,15,90.0,82,5.28,57,380,2242,9.6,0.22113258
22984,22984,Richard Park,1999-00,23.0,6,0,7,7,0,0,0,5.0,65.0,91,5,10,15,95.0,82,5.27,57,359,2285,9.4,0.19418716
22985,22985,Richard Park,2002-03,26.0,7,25,63,63,10,15,25,115.0,1037.0,154,15,25,40,210.0,82,5.24,53,338,2262,9.5,0.35593945
22986,22986,Richard Park,2003-04,27.0,8,24,81,81,14,10,24,149.0,1345.0,235,29,35,64,359.0,82,5.31,60,363,2326,9.4,0.3263631
22987,22987,Richard Park,2004-05,28.0,9,25,73,73,13,12,25,142.0,1204.0,308,42,47,89,501.0,82,5.14,57,348,2300,9.2,0.38681537
22988,22988,Richard Park,2006-07,30.0,10,18,60,60,8,10,18,97.0,660.0,368,50,57,107,598.0,82,6.05,85,480,2458,10.1,0.2894917
22989,22989,Richard Park,2007-08,31.0,11,26,82,82,10,16,26,93.0,955.0,450,60,73,133,691.0,82,5.76,70,398,2426,9.7,0.2750578
22990,22990,Richard Park,2008-09,32.0,12,32,82,82,12,20,32,132.0,1249.0,532,72,93,165,823.0,82,5.44,62,351,2383,9.4,0.35910505
22991,22991,Richard Park,2009-10,33.0,13,31,71,71,14,17,31,138.0,1219.0,603,86,110,196,961.0,82,5.7,65,341,2477,9.4,0.3553734
22992,22992,Richard Park,2010-11,34.0,14,31,81,81,9,22,31,146.0,1276.0,684,95,132,227,1107.0,82,5.53,56,304,2486,9.1,0.3268655
22993,22993,Richard Park,2012-13,36.0,15,14,54,54,7,7,14,44.0,589.0,738,102,139,241,1151.0,82,5.32,47,271,2439,8.9,0.20423064
22994,22994,Richard Petiot,2006-07,24.0,2,0,2,2,0,0,0,1.0,10.0,2,0,0,0,1.0,82,6.05,85,480,2458,10.1,0.16345963
22995,22995,Richard Petiot,2009-10,27.0,3,3,11,11,0,3,3,10.0,227.0,13,0,3,3,11.0,82,5.7,65,341,2477,9.4,0.19312015
22996,22996,Richard Petiot,2011-12,29.0,4,0,2,2,0,0,0,1.0,26.0,15,0,3,3,12.0,82,5.46,52,291,2492,9.0,0.15918452
22997,22997,Richard Scott,2002-03,24.0,2,0,5,5,0,0,0,1.0,12.0,5,0,0,0,1.0,82,5.24,53,338,2262,9.5,0.15924224
22998,22998,Richard Scott,2004-05,26.0,3,0,5,5,0,0,0,1.0,30.0,10,0,0,0,2.0,82,5.14,57,348,2300,9.2,0.15919992
22999,22999,Richard Smehlik,1993-94,24.0,2,31,80,80,4,27,31,82.0,,80,4,27,31,82.0,84,7.25,87,443,2603,11.7,0.3899903
23000,23000,Richard Smehlik,1994-95,25.0,3,41,84,84,14,27,41,106.0,,164,18,54,72,188.0,84,6.48,76,407,2545,10.7,0.45241675
23001,23001,Richard Smehlik,1995-96,26.0,4,11,39,39,4,7,11,49.0,,203,22,61,83,237.0,48,5.97,37,209,1408,10.2,0.33834726
23002,23002,Richard Smehlik,1997-98,28.0,5,30,62,62,11,19,30,100.0,,265,33,80,113,337.0,82,5.83,55,336,2444,9.8,0.42399627
23003,23003,Richard Smehlik,1998-99,29.0,6,20,72,72,3,17,20,90.0,,337,36,97,133,427.0,82,5.28,57,380,2242,9.6,0.2963398
23004,23004,Richard Smehlik,1999-00,30.0,7,14,72,72,3,11,14,61.0,1572.0,409,39,108,147,488.0,82,5.27,57,359,2285,9.4,0.20405397
23005,23005,Richard Smehlik,2000-01,31.0,8,11,64,64,2,9,11,67.0,1349.0,473,41,117,158,555.0,82,5.49,53,331,2294,9.8,0.19822633
23006,23006,Richard Smehlik,2001-02,32.0,9,15,56,56,3,12,15,40.0,1087.0,529,44,129,173,595.0,82,5.51,63,376,2272,9.9,0.19671294
23007,23007,Richard Smehlik,2002-03,33.0,10,9,60,60,3,6,9,52.0,1222.0,589,47,135,182,647.0,82,5.24,53,338,2262,9.5,0.18434083
23008,23008,Richard Smehlik,2003-04,34.0,11,13,55,55,2,11,13,49.0,1055.0,644,49,146,195,696.0,82,5.31,60,363,2326,9.4,0.17756143
23009,23009,Richard Zednik,1996-97,21.0,2,0,1,1,0,0,0,0.0,,1,0,0,0,0.0,82,6.29,74,413,2481,10.4,0.18428248
23010,23010,Richard Zednik,1997-98,22.0,3,3,11,11,2,1,3,21.0,,12,2,1,3,21.0,82,5.83,55,336,2444,9.8,0.26845425
23011,23011,Richard Zednik,1998-99,23.0,4,26,65,65,17,9,26,148.0,,77,19,10,29,169.0,82,5.28,57,380,2242,9.6,0.44370282
23012,23012,Richard Zednik,1999-00,24.0,5,17,49,49,9,8,17,115.0,742.0,126,28,18,46,284.0,82,5.27,57,359,2285,9.4,0.3687821
23013,23013,Richard Zednik,2000-01,25.0,6,35,69,69,19,16,35,179.0,1074.0,195,47,34,81,463.0,82,5.49,53,331,2294,9.8,0.52119756
23014,23014,Richard Zednik,2001-02,26.0,7,44,74,74,19,25,44,178.0,1185.0,269,66,59,125,641.0,82,5.51,63,376,2272,9.9,0.56247383
23015,23015,Richard Zednik,2002-03,27.0,8,44,82,82,22,22,44,249.0,1448.0,351,88,81,169,890.0,82,5.24,53,338,2262,9.5,0.5455673
23016,23016,Richard Zednik,2003-04,28.0,9,50,80,80,31,19,50,250.0,1474.0,431,119,100,219,1140.0,82,5.31,60,363,2326,9.4,0.6077248
23017,23017,Richard Zednik,2004-05,29.0,10,50,81,81,26,24,50,218.0,1418.0,512,145,124,269,1358.0,82,5.14,57,348,2300,9.2,0.65153205
23018,23018,Richard Zednik,2006-07,31.0,11,30,67,67,16,14,30,161.0,1057.0,579,161,138,299,1519.0,82,6.05,85,480,2458,10.1,0.41154507
23019,23019,Richard Zednik,2007-08,32.0,12,21,42,42,7,14,21,83.0,631.0,621,168,152,320,1602.0,82,5.76,70,398,2426,9.7,0.41501915
23020,23020,Richard Zednik,2008-09,33.0,13,26,54,54,15,11,26,140.0,950.0,675,183,163,346,1742.0,82,5.44,62,351,2383,9.4,0.49951228
23021,23021,Richard Zednik,2009-10,34.0,14,33,70,70,17,16,33,153.0,1091.0,745,200,179,379,1895.0,82,5.7,65,341,2477,9.4,0.38880068
23022,23022,Richard Zemlak,1987-88,24.0,2,2,21,21,0,2,2,2.0,,21,0,2,2,2.0,80,7.34,72,344,2400,12.2,0.18136957
23023,23023,Richard Zemlak,1988-89,25.0,3,5,54,54,1,4,5,19.0,,75,1,6,7,21.0,80,7.43,89,437,2435,12.2,0.1259107
23024,23024,Richard Zemlak,1989-90,26.0,4,0,34,34,0,0,0,3.0,,109,1,6,7,24.0,80,7.48,85,403,2430,12.3,0.1322456
23025,23025,Richard Zemlak,1990-91,27.0,5,6,19,19,1,5,6,11.0,,128,2,11,13,35.0,80,7.37,76,367,2421,12.2,0.15475163
23026,23026,Richard Zemlak,1992-93,29.0,6,1,5,5,0,1,1,4.0,,133,2,12,14,39.0,80,6.96,77,402,2440,11.4,0.14152524
23027,23027,Richie Regehr,2006-07,24.0,2,2,14,14,0,2,2,12.0,159.0,14,0,2,2,12.0,82,6.05,85,480,2458,10.1,0.1842717
23028,23028,Richie Regehr,2007-08,25.0,3,2,6,6,1,1,2,4.0,52.0,20,1,3,4,16.0,82,5.76,70,398,2426,9.7,0.18551889
23029,23029,Rick Bennett,1990-91,23.0,2,1,6,6,1,0,1,6.0,,6,1,0,1,6.0,80,7.37,76,367,2421,12.2,0.26586708
23030,23030,Rick Bennett,1991-92,24.0,3,0,6,6,0,0,0,3.0,,12,1,0,1,9.0,80,6.91,71,366,2385,11.6,0.19328338
23031,23031,Rick Bennett,1992-93,25.0,4,1,3,3,0,1,1,2.0,,15,1,1,2,11.0,80,6.96,77,402,2440,11.4,0.20306233
23032,23032,Rick Berry,2001-02,23.0,2,4,19,19,0,4,4,10.0,231.0,19,0,4,4,10.0,82,5.51,63,376,2272,9.9,0.13112336
23033,23033,Rick Berry,2002-03,24.0,3,2,70,70,0,2,2,49.0,796.0,89,0,6,6,59.0,82,5.24,53,338,2262,9.5,0.13284749
23034,23034,Rick Berry,2003-04,25.0,4,3,43,43,2,1,3,40.0,557.0,132,2,7,9,99.0,82,5.31,60,363,2326,9.4,0.14965099
23035,23035,Rick Berry,2004-05,26.0,5,6,65,65,0,6,6,43.0,792.0,197,2,13,15,142.0,82,5.14,57,348,2300,9.2,0.15476921
23036,23036,Rick Boh,1988-89,24.0,2,3,8,8,2,1,3,8.0,,8,2,1,3,8.0,80,7.43,89,437,2435,12.2,0.3174907
23037,23037,Rick Hayward,1991-92,25.0,2,0,4,4,0,0,0,0.0,,4,0,0,0,0.0,80,6.91,71,366,2385,11.6,0.17548954
23038,23038,Rick Hodgson,1980-81,24.0,2,0,6,6,0,0,0,1.0,,6,0,0,0,1.0,80,7.03,61,280,2352,12.0,0.21454602
23039,23039,Rick Lanz,1981-82,20.0,2,29,76,76,7,22,29,134.0,,76,7,22,29,134.0,80,7.69,77,340,2441,12.6,0.5129389
23040,23040,Rick Lanz,1982-83,21.0,3,14,39,39,3,11,14,94.0,,115,10,33,43,228.0,80,8.03,73,320,2489,12.9,0.4471912
23041,23041,Rick Lanz,1983-84,22.0,4,48,74,74,10,38,48,179.0,,189,20,71,91,407.0,80,7.73,71,310,2444,12.7,0.66794306
23042,23042,Rick Lanz,1984-85,23.0,5,57,79,79,18,39,57,230.0,,268,38,110,148,637.0,80,7.89,74,336,2448,12.9,0.67377496
23043,23043,Rick Lanz,1985-86,24.0,6,19,57,57,2,17,19,131.0,,325,40,127,167,768.0,80,7.77,71,321,2447,12.7,0.46175456
23044,23044,Rick Lanz,1986-87,25.0,7,53,75,75,15,38,53,190.0,,400,55,165,220,958.0,80,7.94,82,370,2484,12.8,0.667173
23045,23045,Rick Lanz,1987-88,26.0,8,28,61,61,3,25,28,130.0,,461,58,190,248,1088.0,80,7.34,72,344,2400,12.2,0.46689925
23046,23046,Rick Lanz,1988-89,27.0,9,28,75,75,6,22,28,145.0,,536,64,212,276,1233.0,80,7.43,89,437,2435,12.2,0.3990931
23047,23047,Rick Lanz,1989-90,28.0,10,10,32,32,1,9,10,56.0,,568,65,221,286,1289.0,80,7.48,85,403,2430,12.3,0.2611213
23048,23048,Rick Lanz,1992-93,31.0,11,0,1,1,0,0,0,0.0,,569,65,221,286,1289.0,80,6.96,77,402,2440,11.4,0.3497842
23049,23049,Rick Lessard,1989-90,22.0,2,1,6,6,0,1,1,0.0,,6,0,1,1,0.0,80,7.48,85,403,2430,12.3,0.20547149
23050,23050,Rick Lessard,1991-92,24.0,3,1,1,1,0,1,1,0.0,,7,0,2,2,0.0,80,6.91,71,366,2385,11.6,0.20028454
23051,23051,Rick Lessard,1992-93,25.0,4,2,8,8,0,2,2,4.0,,15,0,4,4,4.0,80,6.96,77,402,2440,11.4,0.20692396
23052,23052,Rick Meagher,1980-81,27.0,2,0,2,2,0,0,0,0.0,,2,0,0,0,0.0,80,7.03,61,280,2352,12.0,0.18987319
23053,23053,Rick Meagher,1981-82,28.0,3,17,27,27,7,10,17,73.0,,29,7,10,17,73.0,80,7.69,77,340,2441,12.6,0.48860198
23054,23054,Rick Meagher,1982-83,29.0,4,43,65,65,24,19,43,171.0,,94,31,29,60,244.0,80,8.03,73,320,2489,12.9,0.6047943
23055,23055,Rick Meagher,1983-84,30.0,5,29,61,61,15,14,29,138.0,,155,46,43,89,382.0,80,7.73,71,310,2444,12.7,0.47914964
23056,23056,Rick Meagher,1984-85,31.0,6,28,52,52,14,14,28,126.0,,207,60,57,117,508.0,80,7.89,74,336,2448,12.9,0.5117764
23057,23057,Rick Meagher,1985-86,32.0,7,31,71,71,11,20,31,140.0,,278,71,77,148,648.0,80,7.77,71,321,2447,12.7,0.40754205
23058,23058,Rick Meagher,1986-87,33.0,8,30,79,79,11,19,30,109.0,,357,82,96,178,757.0,80,7.94,82,370,2484,12.8,0.34475076
23059,23059,Rick Meagher,1987-88,34.0,9,39,80,80,18,21,39,170.0,,437,100,117,217,927.0,80,7.34,72,344,2400,12.2,0.47785804
23060,23060,Rick Meagher,1988-89,35.0,10,34,76,76,18,16,34,113.0,,513,118,133,251,1040.0,80,7.43,89,437,2435,12.2,0.37086713
23061,23061,Rick Meagher,1989-90,36.0,11,29,78,78,15,14,29,109.0,,591,133,147,280,1149.0,80,7.48,85,403,2430,12.3,0.33376747
23062,23062,Rick Meagher,1990-91,37.0,12,25,76,76,8,17,25,99.0,,667,141,164,305,1248.0,80,7.37,76,367,2421,12.2,0.2686013
23063,23063,Rick Meagher,1991-92,38.0,13,4,24,24,3,1,4,21.0,,691,144,165,309,1269.0,80,6.91,71,366,2385,11.6,0.2532277
23064,23064,Rick Mrozik,2003-04,29.0,2,0,2,2,0,0,0,2.0,20.0,2,0,0,0,2.0,82,5.31,60,363,2326,9.4,0.1719929
23065,23065,Rick Nash,2003-04,19.0,2,39,74,74,17,22,39,154.0,1032.0,74,17,22,39,154.0,82,5.31,60,363,2326,9.4,0.6219553
23066,23066,Rick Nash,2004-05,20.0,3,57,80,80,41,16,57,269.0,1410.0,154,58,38,96,423.0,82,5.14,57,348,2300,9.2,0.8818964
23067,23067,Rick Nash,2006-07,22.0,4,54,54,54,31,23,54,170.0,986.0,208,89,61,150,593.0,82,6.05,85,480,2458,10.1,0.863884
23068,23068,Rick Nash,2007-08,23.0,5,57,75,75,27,30,57,228.0,1440.0,283,116,91,207,821.0,82,5.76,70,398,2426,9.7,0.7732969
23069,23069,Rick Nash,2008-09,24.0,6,69,80,80,38,31,69,329.0,1639.0,363,154,122,276,1150.0,82,5.44,62,351,2383,9.4,0.91161275
23070,23070,Rick Nash,2009-10,25.0,7,79,78,78,40,39,79,263.0,1650.0,441,194,161,355,1413.0,82,5.7,65,341,2477,9.4,0.9267136
23071,23071,Rick Nash,2010-11,26.0,8,67,76,76,33,34,67,254.0,1591.0,517,227,195,422,1667.0,82,5.53,56,304,2486,9.1,0.8774489
23072,23072,Rick Nash,2011-12,27.0,9,66,75,75,32,34,66,305.0,1420.0,592,259,229,488,1972.0,82,5.46,52,291,2492,9.0,0.8056574
23073,23073,Rick Nash,2012-13,28.0,10,59,82,82,30,29,59,306.0,1565.0,674,289,258,547,2278.0,82,5.32,47,271,2439,8.9,0.75091547
23074,23074,Rick Nash,2013-14,29.0,11,42,44,44,21,21,42,176.0,879.0,718,310,279,589,2454.0,48,5.31,29,160,1399,9.1,0.7575339
23075,23075,Rick Nash,2014-15,30.0,12,39,65,65,26,13,39,258.0,1106.0,783,336,292,628,2712.0,82,5.34,48,269,2463,8.9,0.7329552
23076,23076,Rick Nash,2015-16,31.0,13,69,79,79,42,27,69,304.0,1379.0,862,378,319,697,3016.0,82,5.32,47,251,2453,8.9,0.7404454
23077,23077,Rick Nash,2016-17,32.0,14,36,60,60,15,21,36,183.0,1016.0,922,393,340,733,3199.0,82,5.34,48,255,2438,9.0,0.56831557
23078,23078,Rick Nash,2017-18,33.0,15,38,67,67,23,15,38,195.0,1103.0,989,416,355,771,3394.0,82,5.45,47,245,2478,9.0,0.5384166
23079,23079,Rick Nash,2018-19,34.0,16,34,71,71,21,13,34,230.0,1211.0,1060,437,368,805,3624.0,82,5.86,50,250,2620,9.2,0.50066817
23080,23080,Rick Paterson,1980-81,22.0,2,2,11,11,0,2,2,11.0,,11,0,2,2,11.0,80,7.03,61,280,2352,12.0,0.25277466
23081,23081,Rick Paterson,1981-82,23.0,3,10,49,49,8,2,10,38.0,,60,8,4,12,49.0,80,7.69,77,340,2441,12.6,0.2879781
23082,23082,Rick Paterson,1982-83,24.0,4,11,48,48,4,7,11,45.0,,108,12,11,23,94.0,80,8.03,73,320,2489,12.9,0.3005907
23083,23083,Rick Paterson,1983-84,25.0,5,23,79,79,14,9,23,80.0,,187,26,20,46,174.0,80,7.73,71,310,2444,12.7,0.32712066
23084,23084,Rick Paterson,1984-85,26.0,6,13,72,72,7,6,13,64.0,,259,33,26,59,238.0,80,7.89,74,336,2448,12.9,0.24199304
23085,23085,Rick Paterson,1985-86,27.0,7,19,79,79,7,12,19,54.0,,338,40,38,78,292.0,80,7.77,71,321,2447,12.7,0.24719355
23086,23086,Rick Paterson,1986-87,28.0,8,12,70,70,9,3,12,36.0,,408,49,41,90,328.0,80,7.94,82,370,2484,12.8,0.16882002
23087,23087,Rick Paterson,1987-88,29.0,9,3,22,22,1,2,3,4.0,,430,50,43,93,332.0,80,7.34,72,344,2400,12.2,0.16472554
23088,23088,Rick Rypien,2006-07,22.0,2,1,5,5,1,0,1,6.0,32.0,5,1,0,1,6.0,82,6.05,85,480,2458,10.1,0.2391203
23089,23089,Rick Rypien,2007-08,23.0,3,0,2,2,0,0,0,0.0,10.0,7,1,0,1,6.0,82,5.76,70,398,2426,9.7,0.17080542
23090,23090,Rick Rypien,2008-09,24.0,4,3,22,22,1,2,3,8.0,178.0,29,2,2,4,14.0,82,5.44,62,351,2383,9.4,0.1405285
23091,23091,Rick Rypien,2009-10,25.0,5,3,12,12,3,0,3,16.0,112.0,41,5,2,7,30.0,82,5.7,65,341,2477,9.4,0.22193304
23092,23092,Rick Rypien,2010-11,26.0,6,8,69,69,4,4,8,61.0,499.0,110,9,6,15,91.0,82,5.53,56,304,2486,9.1,0.17383364
23093,23093,Rick Rypien,2011-12,27.0,7,1,9,9,0,1,1,6.0,46.0,119,9,7,16,97.0,82,5.46,52,291,2492,9.0,0.1406869
23094,23094,Rick Tocchet,1985-86,21.0,2,39,75,75,14,25,39,114.0,,75,14,25,39,114.0,80,7.77,71,321,2447,12.7,0.56252646
23095,23095,Rick Tocchet,1986-87,22.0,3,35,69,69,14,21,35,109.0,,144,28,46,74,223.0,80,7.94,82,370,2484,12.8,0.5064396
23096,23096,Rick Tocchet,1987-88,23.0,4,49,69,69,21,28,49,147.0,,213,49,74,123,370.0,80,7.34,72,344,2400,12.2,0.7200531
23097,23097,Rick Tocchet,1988-89,24.0,5,64,65,65,31,33,64,182.0,,278,80,107,187,552.0,80,7.43,89,437,2435,12.2,1.0123903
23098,23098,Rick Tocchet,1989-90,25.0,6,81,66,66,45,36,81,220.0,,344,125,143,268,772.0,80,7.48,85,403,2430,12.3,1.1582167
23099,23099,Rick Tocchet,1990-91,26.0,7,96,75,75,37,59,96,269.0,,419,162,202,364,1041.0,80,7.37,76,367,2421,12.2,1.0738239
23100,23100,Rick Tocchet,1991-92,27.0,8,71,70,70,40,31,71,217.0,,489,202,233,435,1258.0,80,6.91,71,366,2385,11.6,0.9000462
23101,23101,Rick Tocchet,1992-93,28.0,9,59,61,61,27,32,59,166.0,,550,229,265,494,1424.0,80,6.96,77,402,2440,11.4,0.9454965
23102,23102,Rick Tocchet,1993-94,29.0,10,109,80,80,48,61,109,240.0,,630,277,326,603,1664.0,84,7.25,87,443,2603,11.7,1.0344652
23103,23103,Rick Tocchet,1994-95,30.0,11,40,51,51,14,26,40,150.0,,681,291,352,643,1814.0,84,6.48,76,407,2545,10.7,0.8184639
23104,23104,Rick Tocchet,1995-96,31.0,12,35,36,36,18,17,35,95.0,,717,309,369,678,1909.0,48,5.97,37,209,1408,10.2,0.78993964
23105,23105,Rick Tocchet,1996-97,32.0,13,60,71,71,29,31,60,185.0,,788,338,400,738,2094.0,82,6.29,74,413,2481,10.4,0.7075573
23106,23106,Rick Tocchet,1997-98,33.0,14,40,53,53,21,19,40,157.0,,841,359,419,778,2251.0,82,5.83,55,336,2444,9.8,0.7048323
23107,23107,Rick Tocchet,1998-99,34.0,15,45,68,68,26,19,45,161.0,,909,385,438,823,2412.0,82,5.28,57,380,2242,9.6,0.6010548
23108,23108,Rick Tocchet,1999-00,35.0,16,56,81,81,26,30,56,178.0,1504.0,990,411,468,879,2590.0,82,5.27,57,359,2285,9.4,0.610216
23109,23109,Rick Tocchet,2000-01,36.0,17,35,80,80,15,20,35,130.0,1255.0,1070,426,488,914,2720.0,82,5.49,53,331,2294,9.8,0.42826766
23110,23110,Rick Tocchet,2001-02,37.0,18,36,60,60,14,22,36,76.0,920.0,1130,440,510,950,2796.0,82,5.51,63,376,2272,9.9,0.4130038
23111,23111,Rick Tocchet,2002-03,38.0,19,2,14,14,0,2,2,10.0,129.0,1144,440,512,952,2806.0,82,5.24,53,338,2262,9.5,0.3575564
23112,23112,Rick Vaive,1980-81,21.0,2,37,69,69,22,15,37,144.0,,69,22,15,37,144.0,80,7.03,61,280,2352,12.0,0.69099474
23113,23113,Rick Vaive,1981-82,22.0,3,62,75,75,33,29,62,195.0,,144,55,44,99,339.0,80,7.69,77,340,2441,12.6,0.8666214
23114,23114,Rick Vaive,1982-83,23.0,4,89,77,77,54,35,89,267.0,,221,109,79,188,606.0,80,8.03,73,320,2489,12.9,1.0700676
23115,23115,Rick Vaive,1983-84,24.0,5,79,78,78,51,28,79,296.0,,299,160,107,267,902.0,80,7.73,71,310,2444,12.7,0.9816221
23116,23116,Rick Vaive,1984-85,25.0,6,93,76,76,52,41,93,261.0,,375,212,148,360,1163.0,80,7.89,74,336,2448,12.9,1.0632656
23117,23117,Rick Vaive,1985-86,26.0,7,68,72,72,35,33,68,259.0,,447,247,181,428,1422.0,80,7.77,71,321,2447,12.7,0.9437736
23118,23118,Rick Vaive,1986-87,27.0,8,64,61,61,33,31,64,226.0,,508,280,212,492,1648.0,80,7.94,82,370,2484,12.8,0.9328995
23119,23119,Rick Vaive,1987-88,28.0,9,66,73,73,32,34,66,213.0,,581,312,246,558,1861.0,80,7.34,72,344,2400,12.2,0.8876812
23120,23120,Rick Vaive,1988-89,29.0,10,69,76,76,43,26,69,229.0,,657,355,272,627,2090.0,80,7.43,89,437,2435,12.2,0.8282496
23121,23121,Rick Vaive,1989-90,30.0,11,57,58,58,31,26,57,138.0,,715,386,298,684,2228.0,80,7.48,85,403,2430,12.3,0.83420587
23122,23122,Rick Vaive,1990-91,31.0,12,48,70,70,29,19,48,195.0,,785,415,317,732,2423.0,80,7.37,76,367,2421,12.2,0.66954595
23123,23123,Rick Vaive,1991-92,32.0,13,52,71,71,25,27,52,155.0,,856,440,344,784,2578.0,80,6.91,71,366,2385,11.6,0.60498434
23124,23124,Rick Vaive,1992-93,33.0,14,4,20,20,1,3,4,25.0,,876,441,347,788,2603.0,80,6.96,77,402,2440,11.4,0.45362577
23125,23125,Rick Zombo,1985-86,22.0,2,0,1,1,0,0,0,0.0,,1,0,0,0,0.0,80,7.77,71,321,2447,12.7,0.19461161
23126,23126,Rick Zombo,1986-87,23.0,3,1,14,14,0,1,1,8.0,,15,0,1,1,8.0,80,7.94,82,370,2484,12.8,0.2008813
23127,23127,Rick Zombo,1987-88,24.0,4,5,44,44,1,4,5,28.0,,59,1,5,6,36.0,80,7.34,72,344,2400,12.2,0.15037477
23128,23128,Rick Zombo,1988-89,25.0,5,17,62,62,3,14,17,48.0,,121,4,19,23,84.0,80,7.43,89,437,2435,12.2,0.23307016
23129,23129,Rick Zombo,1989-90,26.0,6,21,75,75,1,20,21,64.0,,196,5,39,44,148.0,80,7.48,85,403,2430,12.3,0.23676735
23130,23130,Rick Zombo,1990-91,27.0,7,25,77,77,5,20,25,62.0,,273,10,59,69,210.0,80,7.37,76,367,2421,12.2,0.25550383
23131,23131,Rick Zombo,1991-92,28.0,8,23,77,77,4,19,23,68.0,,350,14,78,92,278.0,80,6.91,71,366,2385,11.6,0.24199528
23132,23132,Rick Zombo,1992-93,29.0,9,18,67,67,3,15,18,48.0,,417,17,93,110,326.0,80,6.96,77,402,2440,11.4,0.2178908
23133,23133,Rick Zombo,1993-94,30.0,10,15,71,71,0,15,15,43.0,,488,17,108,125,369.0,84,7.25,87,443,2603,11.7,0.15557197
23134,23134,Rick Zombo,1994-95,31.0,11,10,74,74,2,8,10,53.0,,562,19,116,135,422.0,84,6.48,76,407,2545,10.7,0.14506409
23135,23135,Rick Zombo,1995-96,32.0,12,5,23,23,1,4,5,18.0,,585,20,120,140,440.0,48,5.97,37,209,1408,10.2,0.1691353
23136,23136,Rick Zombo,1996-97,33.0,13,14,67,67,4,10,14,68.0,,652,24,130,154,508.0,82,6.29,74,413,2481,10.4,0.1520434
23137,23137,Rickard Rakell,2013-14,20.0,2,0,4,4,0,0,0,3.0,36.0,4,0,0,0,3.0,48,5.31,29,160,1399,9.1,0.23965779
23138,23138,Rickard Rakell,2014-15,21.0,3,4,18,18,0,4,4,22.0,211.0,22,0,4,4,25.0,82,5.34,48,269,2463,8.9,0.24579671
23139,23139,Rickard Rakell,2015-16,22.0,4,31,71,71,9,22,31,105.0,893.0,93,9,26,35,130.0,82,5.32,47,251,2453,8.9,0.45086557
23140,23140,Rickard Rakell,2016-17,23.0,5,43,72,72,20,23,43,169.0,1157.0,165,29,49,78,299.0,82,5.34,48,255,2438,9.0,0.5645113
23141,23141,Rickard Rakell,2017-18,24.0,6,51,71,71,33,18,51,177.0,1234.0,236,62,67,129,476.0,82,5.45,47,245,2478,9.0,0.684076
23142,23142,Rickard Rakell,2018-19,25.0,7,69,77,77,34,35,69,230.0,1495.0,313,96,102,198,706.0,82,5.86,50,250,2620,9.2,0.8232807
23143,23143,Rickard Rakell,2019-20,26.0,8,43,69,69,18,25,43,194.0,1275.0,382,114,127,241,900.0,82,5.96,47,239,2579,9.5,0.66594326
23144,23144,Rickard Rakell,2020-21,27.0,9,42,65,65,15,27,42,186.0,1180.0,447,129,154,283,1086.0,70,5.96,42,208,2192,9.5,0.6539432
23145,23145,Rickard Wallin,2003-04,23.0,2,1,4,4,1,0,1,1.0,31.0,4,1,0,1,1.0,82,5.31,60,363,2326,9.4,0.28421348
23146,23146,Rickard Wallin,2004-05,24.0,3,9,15,15,5,4,9,16.0,215.0,19,6,4,10,17.0,82,5.14,57,348,2300,9.2,0.31125665
23147,23147,Rickard Wallin,2010-11,30.0,4,9,60,60,2,7,9,72.0,759.0,79,8,11,19,89.0,82,5.53,56,304,2486,9.1,0.17815393
23148,23148,Rico Fata,1999-00,19.0,2,1,20,20,0,1,1,13.0,152.0,20,0,1,1,13.0,82,5.27,57,359,2285,9.4,0.17487332
23149,23149,Rico Fata,2000-01,20.0,3,0,2,2,0,0,0,0.0,20.0,22,0,1,1,13.0,82,5.49,53,331,2294,9.8,0.19934052
23150,23150,Rico Fata,2001-02,21.0,4,0,5,5,0,0,0,6.0,47.0,27,0,1,1,19.0,82,5.51,63,376,2272,9.9,0.18772021
23151,23151,Rico Fata,2002-03,22.0,5,0,10,10,0,0,0,8.0,85.0,37,0,1,1,27.0,82,5.24,53,338,2262,9.5,0.14326245
23152,23152,Rico Fata,2003-04,23.0,6,19,63,63,7,12,19,79.0,742.0,100,7,13,20,106.0,82,5.31,60,363,2326,9.4,0.3172581
23153,23153,Rico Fata,2004-05,24.0,7,34,73,73,16,18,34,163.0,1312.0,173,23,31,54,269.0,82,5.14,57,348,2300,9.2,0.49329773
23154,23154,Rico Fata,2006-07,26.0,8,7,47,47,3,4,7,50.0,478.0,220,26,35,61,319.0,82,6.05,85,480,2458,10.1,0.18808529
23155,23155,Rico Fata,2007-08,27.0,9,2,10,10,1,1,2,15.0,104.0,230,27,36,63,334.0,82,5.76,70,398,2426,9.7,0.23424646
23156,23156,Rik Wilson,1982-83,20.0,2,21,48,48,3,18,21,95.0,,48,3,18,21,95.0,80,8.03,73,320,2489,12.9,0.45667768
23157,23157,Rik Wilson,1983-84,21.0,3,14,56,56,3,11,14,77.0,,104,6,29,35,172.0,80,7.73,71,310,2444,12.7,0.36820284
23158,23158,Rik Wilson,1984-85,22.0,4,18,48,48,7,11,18,72.0,,152,13,40,53,244.0,80,7.89,74,336,2448,12.9,0.43768263
23159,23159,Rik Wilson,1985-86,23.0,5,24,51,51,8,16,24,85.0,,203,21,56,77,329.0,80,7.77,71,321,2447,12.7,0.4620703
23160,23160,Rik Wilson,1986-87,24.0,6,4,34,34,0,4,4,48.0,,237,21,60,81,377.0,80,7.94,82,370,2484,12.8,0.30929857
23161,23161,Rik Wilson,1988-89,26.0,7,9,14,14,4,5,9,27.0,,251,25,65,90,404.0,80,7.43,89,437,2435,12.2,0.38184544
23162,23162,Riku Hahl,2002-03,22.0,2,5,22,22,2,3,5,17.0,208.0,22,2,3,5,17.0,82,5.24,53,338,2262,9.5,0.22755569
23163,23163,Riku Hahl,2003-04,23.0,3,7,42,42,3,4,7,61.0,464.0,64,5,7,12,78.0,82,5.31,60,363,2326,9.4,0.24566182
23164,23164,Riku Hahl,2004-05,24.0,4,1,28,28,0,1,1,40.0,344.0,92,5,8,13,118.0,82,5.14,57,348,2300,9.2,0.1967268
23165,23165,Riley Armstrong,2009-10,25.0,2,0,2,2,0,0,0,1.0,15.0,2,0,0,0,1.0,82,5.7,65,341,2477,9.4,0.17050758
23166,23166,Riley Barber,2017-18,23.0,2,0,3,3,0,0,0,2.0,26.0,3,0,0,0,2.0,82,5.45,47,245,2478,9.0,0.18307745
23167,23167,Riley Barber,2020-21,26.0,3,0,9,9,0,0,0,6.0,74.0,12,0,0,0,8.0,70,5.96,42,208,2192,9.5,0.1788291
23168,23168,Riley Cote,2007-08,25.0,2,0,8,8,0,0,0,3.0,36.0,8,0,0,0,3.0,82,5.76,70,398,2426,9.7,0.16489819
23169,23169,Riley Cote,2008-09,26.0,3,4,70,70,1,3,4,17.0,299.0,78,1,3,4,20.0,82,5.44,62,351,2383,9.4,0.09189761
23170,23170,Riley Cote,2009-10,27.0,4,3,63,63,0,3,3,24.0,262.0,141,1,6,7,44.0,82,5.7,65,341,2477,9.4,0.084920496
23171,23171,Riley Cote,2010-11,28.0,5,0,15,15,0,0,0,7.0,45.0,156,1,6,7,51.0,82,5.53,56,304,2486,9.1,0.112320006
23172,23172,Riley Nash,2012-13,23.0,2,1,5,5,0,1,1,2.0,53.0,5,0,1,1,2.0,82,5.32,47,271,2439,8.9,0.19055843
23173,23173,Riley Nash,2013-14,24.0,3,9,32,32,4,5,9,36.0,410.0,37,4,6,10,38.0,48,5.31,29,160,1399,9.1,0.27331752
23174,23174,Riley Nash,2014-15,25.0,4,24,73,73,10,14,24,86.0,925.0,110,14,20,34,124.0,82,5.34,48,269,2463,8.9,0.30359524
23175,23175,Riley Nash,2015-16,26.0,5,25,68,68,8,17,25,94.0,1109.0,178,22,37,59,218.0,82,5.32,47,251,2453,8.9,0.3224068
23176,23176,Riley Nash,2016-17,27.0,6,22,64,64,9,13,22,76.0,829.0,242,31,50,81,294.0,82,5.34,48,255,2438,9.0,0.28747624
23177,23177,Riley Nash,2017-18,28.0,7,17,81,81,7,10,17,125.0,1118.0,323,38,60,98,419.0,82,5.45,47,245,2478,9.0,0.24635696
23178,23178,Riley Nash,2018-19,29.0,8,41,76,76,15,26,41,113.0,1171.0,399,53,86,139,532.0,82,5.86,50,250,2620,9.2,0.44337606
23179,23179,Riley Nash,2019-20,30.0,9,12,78,78,3,9,12,79.0,846.0,477,56,95,151,611.0,82,5.96,47,239,2579,9.5,0.21114781
23180,23180,Riley Nash,2020-21,31.0,10,14,64,64,5,9,14,64.0,758.0,541,61,104,165,675.0,70,5.96,42,208,2192,9.5,0.23345006
23181,23181,Riley Sheahan,2012-13,21.0,2,0,1,1,0,0,0,3.0,6.0,1,0,0,0,3.0,82,5.32,47,271,2439,8.9,0.22231701
23182,23182,Riley Sheahan,2013-14,22.0,3,0,1,1,0,0,0,1.0,7.0,2,0,0,0,4.0,48,5.31,29,160,1399,9.1,0.20400563
23183,23183,Riley Sheahan,2014-15,23.0,4,24,42,42,9,15,24,59.0,607.0,44,9,15,24,63.0,82,5.34,48,269,2463,8.9,0.41970256
23184,23184,Riley Sheahan,2015-16,24.0,5,36,79,79,13,23,36,123.0,1236.0,123,22,38,60,186.0,82,5.32,47,251,2453,8.9,0.42033678
23185,23185,Riley Sheahan,2016-17,25.0,6,25,81,81,14,11,25,128.0,1234.0,204,36,49,85,314.0,82,5.34,48,255,2438,9.0,0.3543228
23186,23186,Riley Sheahan,2017-18,26.0,7,13,80,80,2,11,13,109.0,1118.0,284,38,60,98,423.0,82,5.45,47,245,2478,9.0,0.21870497
23187,23187,Riley Sheahan,2018-19,27.0,8,32,81,81,11,21,32,109.0,1188.0,365,49,81,130,532.0,82,5.86,50,250,2620,9.2,0.38972467
23188,23188,Riley Sheahan,2019-20,28.0,9,19,82,82,9,10,19,110.0,1104.0,447,58,91,149,642.0,82,5.96,47,239,2579,9.5,0.28925955
23189,23189,Riley Sheahan,2020-21,29.0,10,15,66,66,8,7,15,70.0,844.0,513,66,98,164,712.0,70,5.96,42,208,2192,9.5,0.26900798
23190,23190,Riley Stillman,2019-20,21.0,2,0,1,1,0,0,0,1.0,11.0,1,0,0,0,1.0,82,5.96,47,239,2579,9.5,0.2324872
23191,23191,Riley Stillman,2020-21,22.0,3,5,34,34,0,5,5,39.0,650.0,35,0,5,5,40.0,70,5.96,42,208,2192,9.5,0.1968317
23192,23192,Rinat Valiev,2016-17,21.0,2,0,10,10,0,0,0,7.0,123.0,10,0,0,0,7.0,82,5.34,48,255,2438,9.0,0.19114259
23193,23193,Rinat Valiev,2018-19,23.0,3,0,2,2,0,0,0,2.0,24.0,12,0,0,0,9.0,82,5.86,50,250,2620,9.2,0.16802183
23194,23194,Risto Jalo,1986-87,24.0,2,3,3,3,0,3,3,3.0,,3,0,3,3,3.0,80,7.94,82,370,2484,12.8,0.25096542
23195,23195,Risto Siltanen,1980-81,22.0,2,35,64,64,6,29,35,116.0,,64,6,29,35,116.0,80,7.03,61,280,2352,12.0,0.53121847
23196,23196,Risto Siltanen,1981-82,23.0,3,53,79,79,17,36,53,209.0,,143,23,65,88,325.0,80,7.69,77,340,2441,12.6,0.69225883
23197,23197,Risto Siltanen,1982-83,24.0,4,63,63,63,15,48,63,143.0,,206,38,113,151,468.0,80,8.03,73,320,2489,12.9,0.85353947
23198,23198,Risto Siltanen,1983-84,25.0,5,30,74,74,5,25,30,155.0,,280,43,138,181,623.0,80,7.73,71,310,2444,12.7,0.5431659
23199,23199,Risto Siltanen,1984-85,26.0,6,53,75,75,15,38,53,163.0,,355,58,176,234,786.0,80,7.89,74,336,2448,12.9,0.68944126
23200,23200,Risto Siltanen,1985-86,27.0,7,45,76,76,12,33,45,175.0,,431,70,209,279,961.0,80,7.77,71,321,2447,12.7,0.59198684
23201,23201,Risto Siltanen,1986-87,28.0,8,37,65,65,10,27,37,179.0,,496,80,236,316,1140.0,80,7.94,82,370,2484,12.8,0.566426
23202,23202,Risto Siltanen,1987-88,29.0,9,39,66,66,10,29,39,129.0,,562,90,265,355,1269.0,80,7.34,72,344,2400,12.2,0.54656434
23203,23203,Rob Blake,1990-91,21.0,2,0,4,4,0,0,0,3.0,,4,0,0,0,3.0,80,7.37,76,367,2421,12.2,0.25379035
23204,23204,Rob Blake,1991-92,22.0,3,46,75,75,12,34,46,150.0,,79,12,34,46,153.0,80,6.91,71,366,2385,11.6,0.6081637
23205,23205,Rob Blake,1992-93,23.0,4,20,57,57,7,13,20,131.0,,136,19,47,66,284.0,80,6.96,77,402,2440,11.4,0.46676052
23206,23206,Rob Blake,1993-94,24.0,5,59,76,76,16,43,59,243.0,,212,35,90,125,527.0,84,7.25,87,443,2603,11.7,0.6559239
23207,23207,Rob Blake,1994-95,25.0,6,68,84,84,20,48,68,304.0,,296,55,138,193,831.0,84,6.48,76,407,2545,10.7,0.745665
23208,23208,Rob Blake,1995-96,26.0,7,11,24,24,4,7,11,76.0,,320,59,145,204,907.0,48,5.97,37,209,1408,10.2,0.5217812
23209,23209,Rob Blake,1996-97,27.0,8,3,6,6,1,2,3,13.0,,326,60,147,207,920.0,82,6.29,74,413,2481,10.4,0.37868172
23210,23210,Rob Blake,1997-98,28.0,9,31,62,62,8,23,31,169.0,,388,68,170,238,1089.0,82,5.83,55,336,2444,9.8,0.5492208
23211,23211,Rob Blake,1998-99,29.0,10,50,81,81,23,27,50,261.0,,469,91,197,288,1350.0,82,5.28,57,380,2242,9.6,0.6207466
23212,23212,Rob Blake,1999-00,30.0,11,35,62,62,12,23,35,216.0,1542.0,531,103,220,323,1566.0,82,5.27,57,359,2285,9.4,0.6130135
23213,23213,Rob Blake,2000-01,31.0,12,57,77,77,18,39,57,327.0,2194.0,608,121,259,380,1893.0,82,5.49,53,331,2294,9.8,0.7109272
23214,23214,Rob Blake,2001-02,32.0,13,59,67,67,19,40,59,267.0,1860.0,675,140,299,439,2160.0,82,5.51,63,376,2272,9.9,0.748078
23215,23215,Rob Blake,2002-03,33.0,14,56,75,75,16,40,56,229.0,2068.0,750,156,339,495,2389.0,82,5.24,53,338,2262,9.5,0.68683696
23216,23216,Rob Blake,2003-04,34.0,15,45,79,79,17,28,45,269.0,2082.0,829,173,367,540,2658.0,82,5.31,60,363,2326,9.4,0.56912196
23217,23217,Rob Blake,2004-05,35.0,16,46,74,74,13,33,46,242.0,1805.0,903,186,400,586,2900.0,82,5.14,57,348,2300,9.2,0.6537224
23218,23218,Rob Blake,2006-07,37.0,17,51,81,81,14,37,51,264.0,1974.0,984,200,437,637,3164.0,82,6.05,85,480,2458,10.1,0.5738852
23219,23219,Rob Blake,2007-08,38.0,18,34,72,72,14,20,34,208.0,1757.0,1056,214,457,671,3372.0,82,5.76,70,398,2426,9.7,0.48112065
23220,23220,Rob Blake,2008-09,39.0,19,31,71,71,9,22,31,144.0,1614.0,1127,223,479,702,3516.0,82,5.44,62,351,2383,9.4,0.40826276
23221,23221,Rob Blake,2009-10,40.0,20,45,73,73,10,35,45,198.0,1553.0,1200,233,514,747,3714.0,82,5.7,65,341,2477,9.4,0.55392253
23222,23222,Rob Blake,2010-11,41.0,21,30,70,70,7,23,30,182.0,1495.0,1270,240,537,777,3896.0,82,5.53,56,304,2486,9.1,0.41536257
23223,23223,Rob Brown,1988-89,20.0,2,44,51,51,24,20,44,80.0,,51,24,20,44,80.0,80,7.43,89,437,2435,12.2,1.1007986
23224,23224,Rob Brown,1989-90,21.0,3,115,68,68,49,66,115,169.0,,119,73,86,159,249.0,80,7.48,85,403,2430,12.3,1.2027054
23225,23225,Rob Brown,1990-91,22.0,4,80,80,80,33,47,80,157.0,,199,106,133,239,406.0,80,7.37,76,367,2421,12.2,0.98128855
23226,23226,Rob Brown,1991-92,23.0,5,58,69,69,24,34,58,126.0,,268,130,167,297,532.0,80,6.91,71,366,2385,11.6,0.83153117
23227,23227,Rob Brown,1992-93,24.0,6,47,67,67,21,26,47,106.0,,335,151,193,344,638.0,80,6.96,77,402,2440,11.4,0.677437
23228,23228,Rob Brown,1993-94,25.0,7,7,15,15,1,6,7,16.0,,350,152,199,351,654.0,84,7.25,87,443,2603,11.7,0.35229886
23229,23229,Rob Brown,1994-95,26.0,8,0,1,1,0,0,0,1.0,,351,152,199,351,655.0,84,6.48,76,407,2545,10.7,0.34961808
23230,23230,Rob Brown,1995-96,27.0,9,0,2,2,0,0,0,1.0,,353,152,199,351,656.0,48,5.97,37,209,1408,10.2,0.4011534
23231,23231,Rob Brown,1998-99,30.0,10,40,82,82,15,25,40,172.0,,435,167,224,391,828.0,82,5.28,57,380,2242,9.6,0.5220168
23232,23232,Rob Brown,1999-00,31.0,11,24,58,58,13,11,24,78.0,730.0,493,180,235,415,906.0,82,5.27,57,359,2285,9.4,0.4145516
23233,23233,Rob Brown,2000-01,32.0,12,23,50,50,10,13,23,73.0,531.0,543,190,248,438,979.0,82,5.49,53,331,2294,9.8,0.43551287
23234,23234,Rob Cimetta,1989-90,19.0,2,2,7,7,2,0,2,4.0,,7,2,0,2,4.0,80,7.48,85,403,2430,12.3,0.34212148
23235,23235,Rob Cimetta,1990-91,20.0,3,17,47,47,8,9,17,28.0,,54,10,9,19,32.0,80,7.37,76,367,2421,12.2,0.35204154
23236,23236,Rob Cimetta,1991-92,21.0,4,6,25,25,2,4,6,18.0,,79,12,13,25,50.0,80,6.91,71,366,2385,11.6,0.3440737
23237,23237,Rob Cimetta,1992-93,22.0,5,7,24,24,4,3,7,31.0,,103,16,16,32,81.0,80,6.96,77,402,2440,11.4,0.39252144
23238,23238,Rob Collins,2006-07,28.0,2,2,8,8,1,1,2,8.0,52.0,8,1,1,2,8.0,82,6.05,85,480,2458,10.1,0.2191545
23239,23239,Rob Conn,1992-93,24.0,2,0,2,2,0,0,0,3.0,,2,0,0,0,3.0,80,6.96,77,402,2440,11.4,0.21770963
23240,23240,Rob Conn,1996-97,28.0,3,7,28,28,2,5,7,36.0,,30,2,5,7,39.0,82,6.29,74,413,2481,10.4,0.21185574
23241,23241,Rob Cowie,1995-96,28.0,2,9,32,32,2,7,9,39.0,,32,2,7,9,39.0,48,5.97,37,209,1408,10.2,0.25726682
23242,23242,Rob Cowie,1996-97,29.0,3,10,46,46,5,5,10,86.0,,78,7,12,19,125.0,82,6.29,74,413,2481,10.4,0.25723004
23243,23243,Rob Davison,2003-04,23.0,2,3,15,15,1,2,3,15.0,268.0,15,1,2,3,15.0,82,5.31,60,363,2326,9.4,0.22477862
23244,23244,Rob Davison,2004-05,24.0,3,3,55,55,0,3,3,33.0,790.0,70,1,5,6,48.0,82,5.14,57,348,2300,9.2,0.14301556
23245,23245,Rob Davison,2006-07,26.0,4,6,69,69,1,5,6,36.0,955.0,139,2,10,12,84.0,82,6.05,85,480,2458,10.1,0.13277772
23246,23246,Rob Davison,2007-08,27.0,5,2,22,22,0,2,2,14.0,205.0,161,2,12,14,98.0,82,5.76,70,398,2426,9.7,0.09385121
23247,23247,Rob Davison,2008-09,28.0,6,2,34,34,1,1,2,32.0,471.0,195,3,13,16,130.0,82,5.44,62,351,2383,9.4,0.1363272
23248,23248,Rob Davison,2009-10,29.0,7,2,23,23,0,2,2,15.0,232.0,218,3,15,18,145.0,82,5.7,65,341,2477,9.4,0.101591974
23249,23249,Rob Davison,2010-11,30.0,8,0,1,1,0,0,0,0.0,4.0,219,3,15,18,145.0,82,5.53,56,304,2486,9.1,0.13023692
23250,23250,Rob DiMaio,1989-90,21.0,2,1,16,16,1,0,1,16.0,,16,1,0,1,16.0,80,7.48,85,403,2430,12.3,0.25837803
23251,23251,Rob DiMaio,1990-91,22.0,3,0,7,7,0,0,0,2.0,,23,1,0,1,18.0,80,7.37,76,367,2421,12.2,0.18601006
23252,23252,Rob DiMaio,1991-92,23.0,4,0,1,1,0,0,0,0.0,,24,1,0,1,18.0,80,6.91,71,366,2385,11.6,0.18222263
23253,23253,Rob DiMaio,1992-93,24.0,5,7,50,50,5,2,7,43.0,,74,6,2,8,61.0,80,6.96,77,402,2440,11.4,0.21785185
23254,23254,Rob DiMaio,1993-94,25.0,6,24,54,54,9,15,24,75.0,,128,15,17,32,136.0,84,7.25,87,443,2603,11.7,0.36620423
23255,23255,Rob DiMaio,1994-95,26.0,7,23,53,53,11,12,23,81.0,,181,26,29,55,217.0,84,6.48,76,407,2545,10.7,0.3557974
23256,23256,Rob DiMaio,1995-96,27.0,8,4,36,36,3,1,4,34.0,,217,29,30,59,251.0,48,5.97,37,209,1408,10.2,0.20072326
23257,23257,Rob DiMaio,1996-97,28.0,9,21,59,59,6,15,21,49.0,,276,35,45,80,300.0,82,6.29,74,413,2481,10.4,0.25947037
23258,23258,Rob DiMaio,1997-98,29.0,10,28,72,72,13,15,28,152.0,,348,48,60,108,452.0,82,5.83,55,336,2444,9.8,0.37020767
23259,23259,Rob DiMaio,1998-99,30.0,11,27,79,79,10,17,27,112.0,,427,58,77,135,564.0,82,5.28,57,380,2242,9.6,0.28835654
23260,23260,Rob DiMaio,1999-00,31.0,12,21,71,71,7,14,21,121.0,1185.0,498,65,91,156,685.0,82,5.27,57,359,2285,9.4,0.28973126
23261,23261,Rob DiMaio,2000-01,32.0,13,25,62,62,6,19,25,111.0,1025.0,560,71,110,181,796.0,82,5.49,53,331,2294,9.8,0.3352124
23262,23262,Rob DiMaio,2001-02,33.0,14,24,74,74,6,18,24,99.0,1108.0,634,77,128,205,895.0,82,5.51,63,376,2272,9.9,0.25632706
23263,23263,Rob DiMaio,2002-03,34.0,15,12,61,61,6,6,12,63.0,663.0,695,83,134,217,958.0,82,5.24,53,338,2262,9.5,0.1663582
23264,23264,Rob DiMaio,2003-04,35.0,16,19,69,69,10,9,19,81.0,895.0,764,93,143,236,1039.0,82,5.31,60,363,2326,9.4,0.23324716
23265,23265,Rob DiMaio,2004-05,36.0,17,24,69,69,9,15,24,76.0,895.0,833,102,158,260,1115.0,82,5.14,57,348,2300,9.2,0.28354234
23266,23266,Rob DiMaio,2006-07,38.0,18,17,61,61,4,13,17,72.0,713.0,894,106,171,277,1187.0,82,6.05,85,480,2458,10.1,0.21517995
23267,23267,Rob Garner,1983-84,25.0,2,0,1,1,0,0,0,1.0,,1,0,0,0,1.0,80,7.73,71,310,2444,12.7,0.21705627
23268,23268,Rob Gaudreau,1993-94,24.0,2,43,59,59,23,20,43,191.0,,59,23,20,43,191.0,84,7.25,87,443,2603,11.7,0.66835046
23269,23269,Rob Gaudreau,1994-95,25.0,3,35,84,84,15,20,35,151.0,,143,38,40,78,342.0,84,6.48,76,407,2545,10.7,0.460671
23270,23270,Rob Gaudreau,1995-96,26.0,4,14,36,36,5,9,14,65.0,,179,43,49,92,407.0,48,5.97,37,209,1408,10.2,0.39905936
23271,23271,Rob Gaudreau,1996-97,27.0,5,13,52,52,8,5,13,76.0,,231,51,54,105,483.0,82,6.29,74,413,2481,10.4,0.33932573
23272,23272,Rob Globke,2006-07,24.0,2,1,18,18,1,0,1,18.0,131.0,18,1,0,1,18.0,82,6.05,85,480,2458,10.1,0.19233656
23273,23273,Rob Globke,2007-08,25.0,3,1,19,19,0,1,1,15.0,115.0,37,1,1,2,33.0,82,5.76,70,398,2426,9.7,0.1349436
23274,23274,Rob Globke,2008-09,26.0,4,0,9,9,0,0,0,4.0,70.0,46,1,1,2,37.0,82,5.44,62,351,2383,9.4,0.14927223
23275,23275,Rob Klinkhammer,2011-12,25.0,2,0,1,1,0,0,0,1.0,12.0,1,0,0,0,1.0,82,5.46,52,291,2492,9.0,0.15797141
23276,23276,Rob Klinkhammer,2012-13,26.0,3,2,15,15,0,2,2,26.0,172.0,16,0,2,2,27.0,82,5.32,47,271,2439,8.9,0.19037563
23277,23277,Rob Klinkhammer,2013-14,27.0,4,11,22,22,5,6,11,34.0,269.0,38,5,8,13,61.0,48,5.31,29,160,1399,9.1,0.32725793
23278,23278,Rob Klinkhammer,2014-15,28.0,5,20,72,72,11,9,20,103.0,818.0,110,16,17,33,164.0,82,5.34,48,269,2463,8.9,0.2614889
23279,23279,Rob Klinkhammer,2015-16,29.0,6,9,69,69,5,4,9,64.0,774.0,179,21,21,42,228.0,82,5.32,47,251,2453,8.9,0.1767123
23280,23280,Rob Klinkhammer,2016-17,30.0,7,1,14,14,1,0,1,10.0,132.0,193,22,21,43,238.0,82,5.34,48,255,2438,9.0,0.17634514
23281,23281,Rob McClanahan,1980-81,23.0,2,7,13,13,2,5,7,13.0,,13,2,5,7,13.0,80,7.03,61,280,2352,12.0,0.34537935
23282,23282,Rob McClanahan,1981-82,24.0,3,15,53,53,3,12,15,67.0,,66,5,17,22,80.0,80,7.69,77,340,2441,12.6,0.33384413
23283,23283,Rob McClanahan,1982-83,25.0,4,17,39,39,5,12,17,45.0,,105,10,29,39,125.0,80,8.03,73,320,2489,12.9,0.38746482
23284,23284,Rob McClanahan,1983-84,26.0,5,48,78,78,22,26,48,118.0,,183,32,55,87,243.0,80,7.73,71,310,2444,12.7,0.55359584
23285,23285,Rob McClanahan,1984-85,27.0,6,14,41,41,6,8,14,52.0,,224,38,63,101,295.0,80,7.89,74,336,2448,12.9,0.35560492
23286,23286,Rob Murphy,1988-89,19.0,2,0,5,5,0,0,0,4.0,,5,0,0,0,4.0,80,7.43,89,437,2435,12.2,0.27806568
23287,23287,Rob Murphy,1989-90,20.0,3,1,8,8,0,1,1,10.0,,13,0,1,1,14.0,80,7.48,85,403,2430,12.3,0.28722498
23288,23288,Rob Murphy,1990-91,21.0,4,2,12,12,1,1,2,6.0,,25,1,2,3,20.0,80,7.37,76,367,2421,12.2,0.2783193
23289,23289,Rob Murphy,1991-92,22.0,5,6,42,42,5,1,6,19.0,,67,6,3,9,39.0,80,6.91,71,366,2385,11.6,0.20335391
23290,23290,Rob Murphy,1992-93,23.0,6,1,6,6,0,1,1,2.0,,73,6,4,10,41.0,80,6.96,77,402,2440,11.4,0.20724255
23291,23291,Rob Murphy,1993-94,24.0,7,10,44,44,3,7,10,55.0,,117,9,11,20,96.0,84,7.25,87,443,2603,11.7,0.22909561
23292,23292,Rob Murphy,1994-95,25.0,8,1,8,8,0,1,1,4.0,,125,9,12,21,100.0,84,6.48,76,407,2545,10.7,0.13941514
23293,23293,Rob Murray,1990-91,23.0,2,9,41,41,2,7,9,29.0,,41,2,7,9,29.0,80,7.37,76,367,2421,12.2,0.21244493
23294,23294,Rob Murray,1991-92,24.0,3,3,17,17,0,3,3,8.0,,58,2,10,12,37.0,80,6.91,71,366,2385,11.6,0.1998851
23295,23295,Rob Murray,1992-93,25.0,4,1,9,9,0,1,1,2.0,,67,2,11,13,39.0,80,6.96,77,402,2440,11.4,0.18672556
23296,23296,Rob Murray,1993-94,26.0,5,1,10,10,1,0,1,4.0,,77,3,11,14,43.0,84,7.25,87,443,2603,11.7,0.1760124
23297,23297,Rob Murray,1994-95,27.0,6,0,6,6,0,0,0,1.0,,83,3,11,14,44.0,84,6.48,76,407,2545,10.7,0.13121971
23298,23298,Rob Murray,1995-96,28.0,7,2,10,10,0,2,2,5.0,,93,3,13,16,49.0,48,5.97,37,209,1408,10.2,0.15908802
23299,23299,Rob Murray,1996-97,29.0,8,0,1,1,0,0,0,1.0,,94,3,13,16,50.0,82,6.29,74,413,2481,10.4,0.15144643
23300,23300,Rob Murray,1999-00,32.0,9,3,13,13,1,2,3,11.0,108.0,107,4,15,19,61.0,82,5.27,57,359,2285,9.4,0.2088486
23301,23301,Rob Niedermayer,1994-95,20.0,2,26,65,65,9,17,26,67.0,,65,9,17,26,67.0,84,6.48,76,407,2545,10.7,0.3822718
23302,23302,Rob Niedermayer,1995-96,21.0,3,10,48,48,4,6,10,58.0,,113,13,23,36,125.0,48,5.97,37,209,1408,10.2,0.372424
23303,23303,Rob Niedermayer,1996-97,22.0,4,61,82,82,26,35,61,155.0,,195,39,58,97,280.0,82,6.29,74,413,2481,10.4,0.72329044
23304,23304,Rob Niedermayer,1997-98,23.0,5,38,60,60,14,24,38,136.0,,255,53,82,135,416.0,82,5.83,55,336,2444,9.8,0.6026603
23305,23305,Rob Niedermayer,1998-99,24.0,6,15,33,33,8,7,15,64.0,,288,61,89,150,480.0,82,5.28,57,380,2242,9.6,0.46570545
23306,23306,Rob Niedermayer,1999-00,25.0,7,51,82,82,18,33,51,142.0,1745.0,370,79,122,201,622.0,82,5.27,57,359,2285,9.4,0.60934806
23307,23307,Rob Niedermayer,2000-01,26.0,8,33,81,81,10,23,33,135.0,1545.0,451,89,145,234,757.0,82,5.49,53,331,2294,9.8,0.4659993
23308,23308,Rob Niedermayer,2001-02,27.0,9,32,67,67,12,20,32,115.0,1373.0,518,101,165,266,872.0,82,5.51,63,376,2272,9.9,0.43095574
23309,23309,Rob Niedermayer,2002-03,28.0,10,20,57,57,6,14,20,87.0,1027.0,575,107,179,286,959.0,82,5.24,53,338,2262,9.5,0.34346956
23310,23310,Rob Niedermayer,2003-04,29.0,11,22,66,66,10,12,22,125.0,1128.0,641,117,191,308,1084.0,82,5.31,60,363,2326,9.4,0.33421004
23311,23311,Rob Niedermayer,2004-05,30.0,12,28,55,55,12,16,28,111.0,1071.0,696,129,207,336,1195.0,82,5.14,57,348,2300,9.2,0.5437508
23312,23312,Rob Niedermayer,2006-07,32.0,13,39,76,76,15,24,39,140.0,1358.0,772,144,231,375,1335.0,82,6.05,85,480,2458,10.1,0.43851313
23313,23313,Rob Niedermayer,2007-08,33.0,14,16,82,82,5,11,16,106.0,1365.0,854,149,242,391,1441.0,82,5.76,70,398,2426,9.7,0.22331327
23314,23314,Rob Niedermayer,2008-09,34.0,15,16,78,78,8,8,16,111.0,1382.0,932,157,250,407,1552.0,82,5.44,62,351,2383,9.4,0.2198757
23315,23315,Rob Niedermayer,2009-10,35.0,16,21,79,79,14,7,21,88.0,1230.0,1011,171,257,428,1640.0,82,5.7,65,341,2477,9.4,0.27175027
23316,23316,Rob Niedermayer,2010-11,36.0,17,22,71,71,10,12,22,93.0,1194.0,1082,181,269,450,1733.0,82,5.53,56,304,2486,9.1,0.2710013
23317,23317,Rob Niedermayer,2011-12,37.0,18,19,71,71,5,14,19,80.0,906.0,1153,186,283,469,1813.0,82,5.46,52,291,2492,9.0,0.23948088
23318,23318,Rob O'Gara,2017-18,24.0,2,0,3,3,0,0,0,2.0,48.0,3,0,0,0,2.0,82,5.45,47,245,2478,9.0,0.17709363
23319,23319,Rob O'Gara,2018-19,25.0,3,3,30,30,0,3,3,21.0,465.0,33,0,3,3,23.0,82,5.86,50,250,2620,9.2,0.15674749
23320,23320,Rob Pearson,1992-93,21.0,2,24,47,47,14,10,24,79.0,,47,14,10,24,79.0,80,6.96,77,402,2440,11.4,0.48587516
23321,23321,Rob Pearson,1993-94,22.0,3,37,78,78,23,14,37,164.0,,125,37,24,61,243.0,84,7.25,87,443,2603,11.7,0.54307884
23322,23322,Rob Pearson,1994-95,23.0,4,30,67,67,12,18,30,119.0,,192,49,42,91,362.0,84,6.48,76,407,2545,10.7,0.4627899
23323,23323,Rob Pearson,1995-96,24.0,5,6,32,32,0,6,6,34.0,,224,49,48,97,396.0,48,5.97,37,209,1408,10.2,0.3658405
23324,23324,Rob Pearson,1996-97,25.0,6,10,27,27,6,4,10,51.0,,251,55,52,107,447.0,82,6.29,74,413,2481,10.4,0.38046557
23325,23325,Rob Pearson,1997-98,26.0,7,3,18,18,1,2,3,14.0,,269,56,54,110,461.0,82,5.83,55,336,2444,9.8,0.27298287
23326,23326,Rob Ramage,1980-81,22.0,2,28,75,75,8,20,28,218.0,,75,8,20,28,218.0,80,7.03,61,280,2352,12.0,0.52828246
23327,23327,Rob Ramage,1981-82,23.0,3,62,79,79,20,42,62,289.0,,154,28,62,90,507.0,80,7.69,77,340,2441,12.6,0.73325115
23328,23328,Rob Ramage,1982-83,24.0,4,42,80,80,13,29,42,270.0,,234,41,91,132,777.0,80,8.03,73,320,2489,12.9,0.5847341
23329,23329,Rob Ramage,1983-84,25.0,5,51,78,78,16,35,51,278.0,,312,57,126,183,1055.0,80,7.73,71,310,2444,12.7,0.73510927
23330,23330,Rob Ramage,1984-85,26.0,6,60,80,80,15,45,60,267.0,,392,72,171,243,1322.0,80,7.89,74,336,2448,12.9,0.7192327
23331,23331,Rob Ramage,1985-86,27.0,7,38,80,80,7,31,38,284.0,,472,79,202,281,1606.0,80,7.77,71,321,2447,12.7,0.61606085
23332,23332,Rob Ramage,1986-87,28.0,8,66,77,77,10,56,66,228.0,,549,89,258,347,1834.0,80,7.94,82,370,2484,12.8,0.7195909
23333,23333,Rob Ramage,1987-88,29.0,9,39,59,59,11,28,39,161.0,,608,100,286,386,1995.0,80,7.34,72,344,2400,12.2,0.58917034
23334,23334,Rob Ramage,1988-89,30.0,10,49,79,79,9,40,49,215.0,,687,109,326,435,2210.0,80,7.43,89,437,2435,12.2,0.59899825
23335,23335,Rob Ramage,1989-90,31.0,11,16,68,68,3,13,16,91.0,,755,112,339,451,2301.0,80,7.48,85,403,2430,12.3,0.33532023
23336,23336,Rob Ramage,1990-91,32.0,12,49,80,80,8,41,49,196.0,,835,120,380,500,2497.0,80,7.37,76,367,2421,12.2,0.60045314
23337,23337,Rob Ramage,1991-92,33.0,13,35,80,80,10,25,35,169.0,,915,130,405,535,2666.0,80,6.91,71,366,2385,11.6,0.43672544
23338,23338,Rob Ramage,1992-93,34.0,14,9,34,34,4,5,9,63.0,,949,134,410,544,2729.0,80,6.96,77,402,2440,11.4,0.2804782
23339,23339,Rob Ramage,1993-94,35.0,15,18,74,74,5,13,18,131.0,,1023,139,423,562,2860.0,84,7.25,87,443,2603,11.7,0.2576257
23340,23340,Rob Ramage,1994-95,36.0,16,2,21,21,0,2,2,23.0,,1044,139,425,564,2883.0,84,6.48,76,407,2545,10.7,0.22086361
23341,23341,Rob Ray,1990-91,22.0,2,3,27,27,2,1,3,20.0,,27,2,1,3,20.0,80,7.37,76,367,2421,12.2,0.29176617
23342,23342,Rob Ray,1991-92,23.0,3,16,66,66,8,8,16,54.0,,93,10,9,19,74.0,80,6.91,71,366,2385,11.6,0.26230508
23343,23343,Rob Ray,1992-93,24.0,4,8,63,63,5,3,8,29.0,,156,15,12,27,103.0,80,6.96,77,402,2440,11.4,0.17994618
23344,23344,Rob Ray,1993-94,25.0,5,5,68,68,3,2,5,28.0,,224,18,14,32,131.0,84,7.25,87,443,2603,11.7,0.12083331
23345,23345,Rob Ray,1994-95,26.0,6,7,82,82,3,4,7,34.0,,306,21,18,39,165.0,84,6.48,76,407,2545,10.7,0.14215961
23346,23346,Rob Ray,1995-96,27.0,7,3,47,47,0,3,3,7.0,,353,21,21,42,172.0,48,5.97,37,209,1408,10.2,0.10489836
23347,23347,Rob Ray,1996-97,28.0,8,9,71,71,3,6,9,21.0,,424,24,27,51,193.0,82,6.29,74,413,2481,10.4,0.11262646
23348,23348,Rob Ray,1997-98,29.0,9,10,82,82,7,3,10,45.0,,506,31,30,61,238.0,82,5.83,55,336,2444,9.8,0.14961478
23349,23349,Rob Ray,1998-99,30.0,10,6,63,63,2,4,6,19.0,,569,33,34,67,257.0,82,5.28,57,380,2242,9.6,0.10616177
23350,23350,Rob Ray,1999-00,31.0,11,4,76,76,0,4,4,23.0,394.0,645,33,38,71,280.0,82,5.27,57,359,2285,9.4,0.08677584
23351,23351,Rob Ray,2000-01,32.0,12,4,69,69,1,3,4,17.0,290.0,714,34,41,75,297.0,82,5.49,53,331,2294,9.8,0.08460671
23352,23352,Rob Ray,2001-02,33.0,13,10,63,63,4,6,10,33.0,355.0,777,38,47,85,330.0,82,5.51,63,376,2272,9.9,0.117369086
23353,23353,Rob Ray,2002-03,34.0,14,5,71,71,2,3,5,23.0,364.0,848,40,50,90,353.0,82,5.24,53,338,2262,9.5,0.09124336
23354,23354,Rob Ray,2003-04,35.0,15,0,46,46,0,0,0,14.0,205.0,894,40,50,90,367.0,82,5.31,60,363,2326,9.4,0.078971654
23355,23355,Rob Ray,2004-05,36.0,16,1,6,6,1,0,1,3.0,28.0,900,41,50,91,370.0,82,5.14,57,348,2300,9.2,0.15284696
23356,23356,Rob Robinson,1992-93,25.0,2,1,22,22,0,1,1,9.0,,22,0,1,1,9.0,80,6.96,77,402,2440,11.4,0.16994211
23357,23357,Rob Schremp,2007-08,21.0,2,0,1,1,0,0,0,2.0,14.0,1,0,0,0,2.0,82,5.76,70,398,2426,9.7,0.19117922
23358,23358,Rob Schremp,2008-09,22.0,3,0,2,2,0,0,0,3.0,14.0,3,0,0,0,5.0,82,5.44,62,351,2383,9.4,0.18931857
23359,23359,Rob Schremp,2009-10,23.0,4,3,4,4,0,3,3,3.0,54.0,7,0,3,3,8.0,82,5.7,65,341,2477,9.4,0.21101955
23360,23360,Rob Schremp,2010-11,24.0,5,25,44,44,7,18,25,74.0,612.0,51,7,21,28,82.0,82,5.53,56,304,2486,9.1,0.4459664
23361,23361,Rob Schremp,2011-12,25.0,6,26,63,63,13,13,26,83.0,885.0,114,20,34,54,165.0,82,5.46,52,291,2492,9.0,0.36091593
23362,23362,Rob Scuderi,2004-05,26.0,2,3,13,13,1,2,3,4.0,261.0,13,1,2,3,4.0,82,5.14,57,348,2300,9.2,0.19996488
23363,23363,Rob Scuderi,2006-07,28.0,3,4,57,57,0,4,4,28.0,1154.0,70,1,6,7,32.0,82,6.05,85,480,2458,10.1,0.098546445
23364,23364,Rob Scuderi,2007-08,29.0,4,11,78,78,1,10,11,31.0,1467.0,148,2,16,18,63.0,82,5.76,70,398,2426,9.7,0.11039686
23365,23365,Rob Scuderi,2008-09,30.0,5,5,71,71,0,5,5,28.0,1331.0,219,2,21,23,91.0,82,5.44,62,351,2383,9.4,0.091279835
23366,23366,Rob Scuderi,2009-10,31.0,6,16,81,81,1,15,16,51.0,1552.0,300,3,36,39,142.0,82,5.7,65,341,2477,9.4,0.15858111
23367,23367,Rob Scuderi,2010-11,32.0,7,11,73,73,0,11,11,38.0,1407.0,373,3,47,50,180.0,82,5.53,56,304,2486,9.1,0.1346015
23368,23368,Rob Scuderi,2011-12,33.0,8,15,82,82,2,13,15,46.0,1664.0,455,5,60,65,226.0,82,5.46,52,291,2492,9.0,0.14315996
23369,23369,Rob Scuderi,2012-13,34.0,9,9,82,82,1,8,9,63.0,1690.0,537,6,68,74,289.0,82,5.32,47,271,2439,8.9,0.13194093
23370,23370,Rob Scuderi,2013-14,35.0,10,12,48,48,1,11,12,33.0,1046.0,585,7,79,86,322.0,48,5.31,29,160,1399,9.1,0.16886353
23371,23371,Rob Scuderi,2014-15,36.0,11,4,53,53,0,4,4,28.0,1003.0,638,7,83,90,350.0,82,5.34,48,269,2463,8.9,0.09325507
23372,23372,Rob Scuderi,2015-16,37.0,12,10,82,82,1,9,10,52.0,1570.0,720,8,92,100,402.0,82,5.32,47,251,2453,8.9,0.118456215
23373,23373,Rob Scuderi,2016-17,38.0,13,10,63,63,0,10,10,35.0,996.0,783,8,102,110,437.0,82,5.34,48,255,2438,9.0,0.108566135
23374,23374,Rob Shearer,2001-02,25.0,2,0,2,2,0,0,0,0.0,14.0,2,0,0,0,0.0,82,5.51,63,376,2272,9.9,0.15280735
23375,23375,Rob Skrlac,2004-05,28.0,2,1,8,8,1,0,1,3.0,18.0,8,1,0,1,3.0,82,5.14,57,348,2300,9.2,0.19177741
23376,23376,Rob Valicevic,1999-00,29.0,2,6,19,19,4,2,6,23.0,209.0,19,4,2,6,23.0,82,5.27,57,359,2285,9.4,0.25488114
23377,23377,Rob Valicevic,2000-01,30.0,3,25,80,80,14,11,25,113.0,1161.0,99,18,13,31,136.0,82,5.49,53,331,2294,9.8,0.31486112
23378,23378,Rob Valicevic,2001-02,31.0,4,14,60,60,8,6,14,62.0,846.0,159,26,19,45,198.0,82,5.51,63,376,2272,9.9,0.22588825
23379,23379,Rob Valicevic,2002-03,32.0,5,2,17,17,1,1,2,9.0,163.0,176,27,20,47,207.0,82,5.24,53,338,2262,9.5,0.16933739
23380,23380,Rob Valicevic,2003-04,33.0,6,1,10,10,1,0,1,7.0,86.0,186,28,20,48,214.0,82,5.31,60,363,2326,9.4,0.1657632
23381,23381,Rob Valicevic,2004-05,34.0,7,0,7,7,0,0,0,4.0,55.0,193,28,20,48,218.0,82,5.14,57,348,2300,9.2,0.19812202
23382,23382,Rob Whistle,1986-87,25.0,2,6,32,32,4,2,6,30.0,,32,4,2,6,30.0,80,7.94,82,370,2484,12.8,0.26327568
23383,23383,Rob Whistle,1988-89,27.0,3,6,19,19,3,3,6,17.0,,51,7,5,12,47.0,80,7.43,89,437,2435,12.2,0.2501152
23384,23384,Rob Zamuner,1992-93,23.0,2,3,9,9,1,2,3,11.0,,9,1,2,3,11.0,80,6.96,77,402,2440,11.4,0.28355443
23385,23385,Rob Zamuner,1993-94,24.0,3,43,84,84,15,28,43,183.0,,93,16,30,46,194.0,84,7.25,87,443,2603,11.7,0.5050492
23386,23386,Rob Zamuner,1994-95,25.0,4,12,59,59,6,6,12,109.0,,152,22,36,58,303.0,84,6.48,76,407,2545,10.7,0.2873213
23387,23387,Rob Zamuner,1995-96,26.0,5,15,43,43,9,6,15,74.0,,195,31,42,73,377.0,48,5.97,37,209,1408,10.2,0.3892854
23388,23388,Rob Zamuner,1996-97,27.0,6,35,72,72,15,20,35,152.0,,267,46,62,108,529.0,82,6.29,74,413,2481,10.4,0.44477218
23389,23389,Rob Zamuner,1997-98,28.0,7,50,82,82,17,33,50,216.0,,349,63,95,158,745.0,82,5.83,55,336,2444,9.8,0.53154504
23390,23390,Rob Zamuner,1998-99,29.0,8,26,77,77,14,12,26,126.0,,426,77,107,184,871.0,82,5.28,57,380,2242,9.6,0.3379746
23391,23391,Rob Zamuner,1999-00,30.0,9,19,58,58,8,11,19,89.0,953.0,484,85,118,203,960.0,82,5.27,57,359,2285,9.4,0.322721
23392,23392,Rob Zamuner,2000-01,31.0,10,21,57,57,9,12,21,103.0,851.0,541,94,130,224,1063.0,82,5.49,53,331,2294,9.8,0.32176054
23393,23393,Rob Zamuner,2001-02,32.0,11,37,79,79,19,18,37,123.0,1167.0,620,113,148,261,1186.0,82,5.51,63,376,2272,9.9,0.38388854
23394,23394,Rob Zamuner,2002-03,33.0,12,25,66,66,12,13,25,98.0,872.0,686,125,161,286,1284.0,82,5.24,53,338,2262,9.5,0.33290088
23395,23395,Rob Zamuner,2003-04,34.0,13,16,55,55,10,6,16,94.0,667.0,741,135,167,302,1378.0,82,5.31,60,363,2326,9.4,0.27158397
23396,23396,Rob Zamuner,2004-05,35.0,14,9,57,57,4,5,9,49.0,554.0,798,139,172,311,1427.0,82,5.14,57,348,2300,9.2,0.13545886
23397,23397,Rob Zettler,1989-90,21.0,2,0,2,2,0,0,0,0.0,,2,0,0,0,0.0,80,7.48,85,403,2430,12.3,0.20433158
23398,23398,Rob Zettler,1990-91,22.0,3,8,31,31,0,8,8,21.0,,33,0,8,8,21.0,80,7.37,76,367,2421,12.2,0.21735522
23399,23399,Rob Zettler,1991-92,23.0,4,5,47,47,1,4,5,30.0,,80,1,12,13,51.0,80,6.91,71,366,2385,11.6,0.15819168
23400,23400,Rob Zettler,1992-93,24.0,5,9,74,74,1,8,9,72.0,,154,2,20,22,123.0,80,6.96,77,402,2440,11.4,0.18991897
23401,23401,Rob Zettler,1993-94,25.0,6,7,80,80,0,7,7,60.0,,234,2,27,29,183.0,84,7.25,87,443,2603,11.7,0.14048445
23402,23402,Rob Zettler,1994-95,26.0,7,7,75,75,0,7,7,55.0,,309,2,34,36,238.0,84,6.48,76,407,2545,10.7,0.11752805
23403,23403,Rob Zettler,1995-96,27.0,8,1,32,32,0,1,1,17.0,,341,2,35,37,255.0,48,5.97,37,209,1408,10.2,0.09604058
23404,23404,Rob Zettler,1996-97,28.0,9,1,29,29,0,1,1,11.0,,370,2,36,38,266.0,82,6.29,74,413,2481,10.4,0.09066549
23405,23405,Rob Zettler,1997-98,29.0,10,14,48,48,2,12,14,31.0,,418,4,48,52,297.0,82,5.83,55,336,2444,9.8,0.16658911
23406,23406,Rob Zettler,1998-99,30.0,11,7,59,59,0,7,7,28.0,,477,4,55,59,325.0,82,5.28,57,380,2242,9.6,0.09916255
23407,23407,Rob Zettler,1999-00,31.0,12,0,2,2,0,0,0,0.0,33.0,479,4,55,59,325.0,82,5.27,57,359,2285,9.4,0.13978547
23408,23408,Rob Zettler,2000-01,32.0,13,2,12,12,0,2,2,15.0,184.0,491,4,57,61,340.0,82,5.49,53,331,2294,9.8,0.15403071
23409,23409,Rob Zettler,2001-02,33.0,14,4,29,29,0,4,4,17.0,352.0,520,4,61,65,357.0,82,5.51,63,376,2272,9.9,0.108927816
23410,23410,Rob Zettler,2002-03,34.0,15,5,49,49,1,4,5,28.0,706.0,569,5,65,70,385.0,82,5.24,53,338,2262,9.5,0.10911381
23411,23411,Robb Gordon,1999-00,24.0,2,0,4,4,0,0,0,1.0,35.0,4,0,0,0,1.0,82,5.27,57,359,2285,9.4,0.16871434
23412,23412,Robbie Earl,2008-09,23.0,2,1,9,9,0,1,1,9.0,83.0,9,0,1,1,9.0,82,5.44,62,351,2383,9.4,0.20145592
23413,23413,Robbie Earl,2010-11,25.0,3,6,32,32,6,0,6,29.0,286.0,41,6,1,7,38.0,82,5.53,56,304,2486,9.1,0.23116192
23414,23414,Robbie Earl,2011-12,26.0,4,0,6,6,0,0,0,6.0,53.0,47,6,1,7,44.0,82,5.46,52,291,2492,9.0,0.14740142
23415,23415,Robbie Laird,1980-81,26.0,2,0,1,1,0,0,0,0.0,,1,0,0,0,0.0,80,7.03,61,280,2352,12.0,0.19458798
23416,23416,Robbie Russo,2017-18,24.0,2,0,19,19,0,0,0,18.0,305.0,19,0,0,0,18.0,82,5.45,47,245,2478,9.0,0.144342
23417,23417,Robby Fabbri,2016-17,21.0,2,37,72,72,18,19,37,114.0,959.0,72,18,19,37,114.0,82,5.34,48,255,2438,9.0,0.5325259
23418,23418,Robby Fabbri,2017-18,22.0,3,29,51,51,11,18,29,91.0,796.0,123,29,37,66,205.0,82,5.45,47,245,2478,9.0,0.47967273
23419,23419,Robby Fabbri,2019-20,24.0,4,6,32,32,2,4,6,43.0,405.0,155,31,41,72,248.0,82,5.96,47,239,2579,9.5,0.31434017
23420,23420,Robby Fabbri,2020-21,25.0,5,32,61,61,15,17,32,111.0,985.0,216,46,58,104,359.0,70,5.96,42,208,2192,9.5,0.52838445
23421,23421,Robert Bortuzzo,2012-13,23.0,2,0,6,6,0,0,0,3.0,65.0,6,0,0,0,3.0,82,5.32,47,271,2439,8.9,0.17154336
23422,23422,Robert Bortuzzo,2013-14,24.0,3,4,15,15,2,2,4,10.0,199.0,21,2,2,4,13.0,48,5.31,29,160,1399,9.1,0.26139128
23423,23423,Robert Bortuzzo,2014-15,25.0,4,10,54,54,0,10,10,50.0,836.0,75,2,12,14,63.0,82,5.34,48,269,2463,8.9,0.15818784
23424,23424,Robert Bortuzzo,2015-16,26.0,5,8,51,51,3,5,8,56.0,771.0,126,5,17,22,119.0,82,5.32,47,251,2453,8.9,0.15150213
23425,23425,Robert Bortuzzo,2016-17,27.0,6,3,40,40,2,1,3,47.0,531.0,166,7,18,25,166.0,82,5.34,48,255,2438,9.0,0.16396251
23426,23426,Robert Bortuzzo,2017-18,28.0,7,4,38,38,1,3,4,45.0,535.0,204,8,21,29,211.0,82,5.45,47,245,2478,9.0,0.1338051
23427,23427,Robert Bortuzzo,2018-19,29.0,8,13,72,72,4,9,13,76.0,1066.0,276,12,30,42,287.0,82,5.86,50,250,2620,9.2,0.18418968
23428,23428,Robert Bortuzzo,2019-20,30.0,9,10,59,59,2,8,10,75.0,913.0,335,14,38,52,362.0,82,5.96,47,239,2579,9.5,0.1916095
23429,23429,Robert Bortuzzo,2020-21,31.0,10,6,42,42,2,4,6,36.0,551.0,377,16,42,58,398.0,70,5.96,42,208,2192,9.5,0.14975706
23430,23430,Robert Burakovsky,1994-95,28.0,2,5,23,23,2,3,5,40.0,,23,2,3,5,40.0,84,6.48,76,407,2545,10.7,0.2457813
23431,23431,Robert Dirk,1988-89,22.0,2,1,7,7,0,1,1,2.0,,7,0,1,1,2.0,80,7.43,89,437,2435,12.2,0.23165092
23432,23432,Robert Dirk,1989-90,23.0,3,1,9,9,0,1,1,7.0,,16,0,2,2,9.0,80,7.48,85,403,2430,12.3,0.21587214
23433,23433,Robert Dirk,1990-91,24.0,4,2,37,37,1,1,2,14.0,,53,1,3,4,23.0,80,7.37,76,367,2421,12.2,0.12866771
23434,23434,Robert Dirk,1991-92,25.0,5,5,52,52,2,3,5,29.0,,105,3,6,9,52.0,80,6.91,71,366,2385,11.6,0.13849658
23435,23435,Robert Dirk,1992-93,26.0,6,9,72,72,2,7,9,44.0,,177,5,13,18,96.0,80,6.96,77,402,2440,11.4,0.16654998
23436,23436,Robert Dirk,1993-94,27.0,7,12,69,69,4,8,12,41.0,,246,9,21,30,137.0,84,7.25,87,443,2603,11.7,0.14195439
23437,23437,Robert Dirk,1994-95,28.0,8,5,71,71,2,3,5,42.0,,317,11,24,35,179.0,84,6.48,76,407,2545,10.7,0.12125179
23438,23438,Robert Dirk,1995-96,29.0,9,4,38,38,1,3,4,15.0,,355,12,27,39,194.0,48,5.97,37,209,1408,10.2,0.08130652
23439,23439,Robert Dirk,1996-97,30.0,10,3,47,47,1,2,3,20.0,,402,13,29,42,214.0,82,6.29,74,413,2481,10.4,0.080611646
23440,23440,Robert Dome,1998-99,20.0,2,7,30,30,5,2,7,29.0,,30,5,2,7,29.0,82,5.28,57,380,2242,9.6,0.33086938
23441,23441,Robert Dome,2000-01,22.0,3,7,22,22,2,5,7,27.0,217.0,52,7,7,14,56.0,82,5.49,53,331,2294,9.8,0.30015194
23442,23442,Robert Dome,2003-04,25.0,4,0,1,1,0,0,0,1.0,8.0,53,7,7,14,57.0,82,5.31,60,363,2326,9.4,0.15818456
23443,23443,Robert Hagg,2017-18,22.0,2,0,1,1,0,0,0,5.0,21.0,1,0,0,0,5.0,82,5.45,47,245,2478,9.0,0.19091848
23444,23444,Robert Hagg,2018-19,23.0,3,9,70,70,3,6,9,89.0,1270.0,71,3,6,9,94.0,82,5.86,50,250,2620,9.2,0.21112794
23445,23445,Robert Hagg,2019-20,24.0,4,20,82,82,5,15,20,86.0,1390.0,153,8,21,29,180.0,82,5.96,47,239,2579,9.5,0.25264072
23446,23446,Robert Hagg,2020-21,25.0,5,13,49,49,3,10,13,38.0,764.0,202,11,31,42,218.0,70,5.96,42,208,2192,9.5,0.25131154
23447,23447,Robert Kron,1991-92,24.0,2,32,76,76,12,20,32,124.0,,76,12,20,32,124.0,80,6.91,71,366,2385,11.6,0.43709013
23448,23448,Robert Kron,1992-93,25.0,3,4,36,36,2,2,4,49.0,,112,14,22,36,173.0,80,6.96,77,402,2440,11.4,0.26378953
23449,23449,Robert Kron,1993-94,26.0,4,27,45,45,14,13,27,97.0,,157,28,35,63,270.0,84,7.25,87,443,2603,11.7,0.47185102
23450,23450,Robert Kron,1994-95,27.0,5,50,77,77,24,26,50,194.0,,234,52,61,113,464.0,84,6.48,76,407,2545,10.7,0.5368322
23451,23451,Robert Kron,1995-96,28.0,6,18,37,37,10,8,18,88.0,,271,62,69,131,552.0,48,5.97,37,209,1408,10.2,0.4846594
23452,23452,Robert Kron,1996-97,29.0,7,50,77,77,22,28,50,203.0,,348,84,97,181,755.0,82,6.29,74,413,2481,10.4,0.5387243
23453,23453,Robert Kron,1997-98,30.0,8,22,68,68,10,12,22,182.0,,416,94,109,203,937.0,82,5.83,55,336,2444,9.8,0.37802625
23454,23454,Robert Kron,1998-99,31.0,9,36,81,81,16,20,36,175.0,,497,110,129,239,1112.0,82,5.28,57,380,2242,9.6,0.45342106
23455,23455,Robert Kron,1999-00,32.0,10,25,75,75,9,16,25,134.0,1218.0,572,119,145,264,1246.0,82,5.27,57,359,2285,9.4,0.31947005
23456,23456,Robert Kron,2000-01,33.0,11,40,81,81,13,27,40,134.0,1233.0,653,132,172,304,1380.0,82,5.49,53,331,2294,9.8,0.42832488
23457,23457,Robert Kron,2001-02,34.0,12,19,59,59,8,11,19,134.0,1011.0,712,140,183,323,1514.0,82,5.51,63,376,2272,9.9,0.31885478
23458,23458,Robert Kron,2002-03,35.0,13,15,59,59,4,11,15,92.0,943.0,771,144,194,338,1606.0,82,5.24,53,338,2262,9.5,0.2427209
23459,23459,Robert Lang,1993-94,23.0,2,5,11,11,0,5,5,3.0,,11,0,5,5,3.0,84,7.25,87,443,2603,11.7,0.23087147
23460,23460,Robert Lang,1994-95,24.0,3,19,32,32,9,10,19,41.0,,43,9,15,24,44.0,84,6.48,76,407,2545,10.7,0.3742659
23461,23461,Robert Lang,1995-96,25.0,4,12,36,36,4,8,12,38.0,,79,13,23,36,82.0,48,5.97,37,209,1408,10.2,0.31379688
23462,23462,Robert Lang,1996-97,26.0,5,22,68,68,6,16,22,71.0,,147,19,39,58,153.0,82,6.29,74,413,2481,10.4,0.2817397
23463,23463,Robert Lang,1998-99,28.0,6,22,54,54,9,13,22,66.0,,201,28,52,80,219.0,82,5.28,57,380,2242,9.6,0.35299516
23464,23464,Robert Lang,1999-00,29.0,7,44,72,72,21,23,44,137.0,1181.0,273,49,75,124,356.0,82,5.27,57,359,2285,9.4,0.53922284
23465,23465,Robert Lang,2000-01,30.0,8,65,78,78,23,42,65,142.0,1510.0,351,72,117,189,498.0,82,5.49,53,331,2294,9.8,0.72795373
23466,23466,Robert Lang,2001-02,31.0,9,80,82,82,32,48,80,177.0,1673.0,433,104,165,269,675.0,82,5.51,63,376,2272,9.9,0.75134397
23467,23467,Robert Lang,2002-03,32.0,10,50,62,62,18,32,50,175.0,1422.0,495,122,197,319,850.0,82,5.24,53,338,2262,9.5,0.690614
23468,23468,Robert Lang,2003-04,33.0,11,69,82,82,22,47,69,146.0,1540.0,577,144,244,388,996.0,82,5.31,60,363,2326,9.4,0.7534702
23469,23469,Robert Lang,2004-05,34.0,12,79,69,69,30,49,79,163.0,1469.0,646,174,293,467,1159.0,82,5.14,57,348,2300,9.2,0.9586232
23470,23470,Robert Lang,2006-07,36.0,13,62,72,72,20,42,62,171.0,1170.0,718,194,335,529,1330.0,82,6.05,85,480,2458,10.1,0.69569546
23471,23471,Robert Lang,2007-08,37.0,14,52,81,81,19,33,52,166.0,1362.0,799,213,368,581,1496.0,82,5.76,70,398,2426,9.7,0.55647683
23472,23472,Robert Lang,2008-09,38.0,15,54,76,76,21,33,54,172.0,1400.0,875,234,401,635,1668.0,82,5.44,62,351,2383,9.4,0.61393994
23473,23473,Robert Lang,2009-10,39.0,16,39,50,50,18,21,39,101.0,844.0,925,252,422,674,1769.0,82,5.7,65,341,2477,9.4,0.60735565
23474,23474,Robert Lang,2010-11,40.0,17,29,64,64,9,20,29,84.0,965.0,989,261,442,703,1853.0,82,5.53,56,304,2486,9.1,0.32330987
23475,23475,Robert Logan,1987-88,23.0,2,10,22,22,7,3,10,22.0,,22,7,3,10,22.0,80,7.34,72,344,2400,12.2,0.40600106
23476,23476,Robert Logan,1988-89,24.0,3,5,16,16,3,2,5,15.0,,38,10,5,15,37.0,80,7.43,89,437,2435,12.2,0.3166308
23477,23477,Robert Logan,1989-90,25.0,4,0,4,4,0,0,0,0.0,,42,10,5,15,37.0,80,7.48,85,403,2430,12.3,0.18584949
23478,23478,Robert Nilsson,2006-07,22.0,2,20,53,53,6,14,20,70.0,629.0,53,6,14,20,70.0,82,6.05,85,480,2458,10.1,0.3874335
23479,23479,Robert Nilsson,2007-08,23.0,3,1,4,4,1,0,1,8.0,69.0,57,7,14,21,78.0,82,5.76,70,398,2426,9.7,0.26049367
23480,23480,Robert Nilsson,2008-09,24.0,4,41,71,71,10,31,41,102.0,989.0,128,17,45,62,180.0,82,5.44,62,351,2383,9.4,0.4602338
23481,23481,Robert Nilsson,2009-10,25.0,5,29,64,64,9,20,29,77.0,972.0,192,26,65,91,257.0,82,5.7,65,341,2477,9.4,0.389704
23482,23482,Robert Nilsson,2010-11,26.0,6,27,60,60,11,16,27,104.0,885.0,252,37,81,118,361.0,82,5.53,56,304,2486,9.1,0.4361833
23483,23483,Robert Nordmark,1988-89,26.0,2,21,67,67,3,18,21,78.0,,67,3,18,21,78.0,80,7.43,89,437,2435,12.2,0.30123413
23484,23484,Robert Nordmark,1989-90,27.0,3,41,80,80,6,35,41,156.0,,147,9,53,62,234.0,80,7.48,85,403,2430,12.3,0.46595088
23485,23485,Robert Nordmark,1990-91,28.0,4,13,44,44,2,11,13,86.0,,191,11,64,75,320.0,80,7.37,76,367,2421,12.2,0.3174662
23486,23486,Robert Nordmark,1991-92,29.0,5,8,45,45,2,6,8,65.0,,236,13,70,83,385.0,80,6.91,71,366,2385,11.6,0.2414383
23487,23487,Robert Petrovicky,1993-94,20.0,2,9,42,42,3,6,9,41.0,,42,3,6,9,41.0,84,7.25,87,443,2603,11.7,0.27040073
23488,23488,Robert Petrovicky,1994-95,21.0,3,11,33,33,6,5,11,33.0,,75,9,11,20,74.0,84,6.48,76,407,2545,10.7,0.32642055
23489,23489,Robert Petrovicky,1995-96,22.0,4,0,2,2,0,0,0,1.0,,77,9,11,20,75.0,48,5.97,37,209,1408,10.2,0.2511015
23490,23490,Robert Petrovicky,1996-97,23.0,5,2,5,5,1,1,2,3.0,,82,10,12,22,78.0,82,6.29,74,413,2481,10.4,0.27119884
23491,23491,Robert Petrovicky,1997-98,24.0,6,19,44,44,7,12,19,54.0,,126,17,24,41,132.0,82,5.83,55,336,2444,9.8,0.34307122
23492,23492,Robert Petrovicky,1999-00,26.0,7,7,28,28,3,4,7,32.0,295.0,154,20,28,48,164.0,82,5.27,57,359,2285,9.4,0.242894
23493,23493,Robert Petrovicky,2000-01,27.0,8,17,43,43,7,10,17,50.0,434.0,197,27,38,65,214.0,82,5.49,53,331,2294,9.8,0.30517608
23494,23494,Robert Petrovicky,2001-02,28.0,9,0,11,11,0,0,0,3.0,38.0,208,27,38,65,217.0,82,5.51,63,376,2272,9.9,0.20574722
23495,23495,Robert Reichel,1991-92,20.0,2,41,66,66,19,22,41,131.0,,66,19,22,41,131.0,80,6.91,71,366,2385,11.6,0.74043757
23496,23496,Robert Reichel,1992-93,21.0,3,54,77,77,20,34,54,181.0,,143,39,56,95,312.0,80,6.96,77,402,2440,11.4,0.789868
23497,23497,Robert Reichel,1993-94,22.0,4,88,80,80,40,48,88,238.0,,223,79,104,183,550.0,84,7.25,87,443,2603,11.7,1.0637372
23498,23498,Robert Reichel,1994-95,23.0,5,93,84,84,40,53,93,249.0,,307,119,157,276,799.0,84,6.48,76,407,2545,10.7,1.0412642
23499,23499,Robert Reichel,1995-96,24.0,6,35,48,48,18,17,35,160.0,,355,137,174,311,959.0,48,5.97,37,209,1408,10.2,0.7928324
23500,23500,Robert Reichel,1997-98,26.0,7,62,82,82,21,41,62,214.0,,437,158,215,373,1173.0,82,5.83,55,336,2444,9.8,0.75930434
23501,23501,Robert Reichel,1998-99,27.0,8,65,82,82,25,40,65,201.0,,519,183,255,438,1374.0,82,5.28,57,380,2242,9.6,0.82111657
23502,23502,Robert Reichel,1999-00,28.0,9,69,83,83,26,43,69,236.0,1633.0,602,209,298,507,1610.0,82,5.27,57,359,2285,9.4,0.7927063
23503,23503,Robert Reichel,2002-03,31.0,10,51,78,78,20,31,51,152.0,1184.0,680,229,329,558,1762.0,82,5.24,53,338,2262,9.5,0.5702086
23504,23504,Robert Reichel,2003-04,32.0,11,42,81,81,12,30,42,111.0,1178.0,761,241,359,600,1873.0,82,5.31,60,363,2326,9.4,0.49506277
23505,23505,Robert Reichel,2004-05,33.0,12,30,69,69,11,19,30,100.0,1070.0,830,252,378,630,1973.0,82,5.14,57,348,2300,9.2,0.52751315
23506,23506,Robert Schnabel,2002-03,24.0,2,0,1,1,0,0,0,0.0,7.0,1,0,0,0,0.0,82,5.24,53,338,2262,9.5,0.15586606
23507,23507,Robert Schnabel,2003-04,25.0,3,0,1,1,0,0,0,0.0,4.0,2,0,0,0,0.0,82,5.31,60,363,2326,9.4,0.16232452
23508,23508,Robert Schnabel,2004-05,26.0,4,3,20,20,0,3,3,10.0,292.0,22,0,3,3,10.0,82,5.14,57,348,2300,9.2,0.13011563
23509,23509,Robert Svehla,1995-96,27.0,2,2,5,5,1,1,2,6.0,,5,1,1,2,6.0,48,5.97,37,209,1408,10.2,0.25575104
23510,23510,Robert Svehla,1996-97,28.0,3,57,81,81,8,49,57,146.0,,86,9,50,59,152.0,82,6.29,74,413,2481,10.4,0.5496376
23511,23511,Robert Svehla,1997-98,29.0,4,45,82,82,13,32,45,159.0,,168,22,82,104,311.0,82,5.83,55,336,2444,9.8,0.49815157
23512,23512,Robert Svehla,1998-99,30.0,5,43,79,79,9,34,43,144.0,,247,31,116,147,455.0,82,5.28,57,380,2242,9.6,0.5102561
23513,23513,Robert Svehla,1999-00,31.0,6,37,80,80,8,29,37,157.0,1980.0,327,39,145,184,612.0,82,5.27,57,359,2285,9.4,0.49183118
23514,23514,Robert Svehla,2000-01,32.0,7,49,82,82,9,40,49,143.0,2013.0,409,48,185,233,755.0,82,5.49,53,331,2294,9.8,0.5508751
23515,23515,Robert Svehla,2001-02,33.0,8,28,82,82,6,22,28,121.0,2097.0,491,54,207,261,876.0,82,5.51,63,376,2272,9.9,0.34704003
23516,23516,Robert Svehla,2002-03,34.0,9,29,82,82,7,22,29,119.0,2106.0,573,61,229,290,995.0,82,5.24,53,338,2262,9.5,0.33953163
23517,23517,Robert Svehla,2003-04,35.0,10,45,82,82,7,38,45,110.0,1947.0,655,68,267,335,1105.0,82,5.31,60,363,2326,9.4,0.48604566
23518,23518,Robert Thomas,2019-20,20.0,2,33,70,70,9,24,33,80.0,915.0,70,9,24,33,80.0,82,5.96,47,239,2579,9.5,0.51994103
23519,23519,Robert Thomas,2020-21,21.0,3,42,66,66,10,32,42,87.0,961.0,136,19,56,75,167.0,70,5.96,42,208,2192,9.5,0.55256397
23520,23520,Robin Bartel,1986-87,25.0,2,0,1,1,0,0,0,0.0,,1,0,0,0,0.0,80,7.94,82,370,2484,12.8,0.16502598
23521,23521,Robin Bartel,1987-88,26.0,3,1,40,40,0,1,1,16.0,,41,0,1,1,16.0,80,7.34,72,344,2400,12.2,0.12642026
23522,23522,Robin Bawa,1990-91,24.0,2,1,5,5,1,0,1,1.0,,5,1,0,1,1.0,80,7.37,76,367,2421,12.2,0.25793642
23523,23523,Robin Bawa,1992-93,26.0,3,0,2,2,0,0,0,1.0,,7,1,0,1,2.0,80,6.96,77,402,2440,11.4,0.1904028
23524,23524,Robin Bawa,1993-94,27.0,4,5,42,42,5,0,5,25.0,,49,6,0,6,27.0,84,7.25,87,443,2603,11.7,0.14687216
23525,23525,Robin Bawa,1994-95,28.0,5,1,12,12,0,1,1,1.0,,61,6,1,7,28.0,84,6.48,76,407,2545,10.7,0.1183404
23526,23526,Robyn Regehr,2000-01,20.0,2,12,57,57,5,7,12,64.0,1049.0,57,5,7,12,64.0,82,5.49,53,331,2294,9.8,0.26185554
23527,23527,Robyn Regehr,2001-02,21.0,3,4,71,71,1,3,4,62.0,1400.0,128,6,10,16,126.0,82,5.51,63,376,2272,9.9,0.20525268
23528,23528,Robyn Regehr,2002-03,22.0,4,8,77,77,2,6,8,82.0,1609.0,205,8,16,24,208.0,82,5.24,53,338,2262,9.5,0.21298277
23529,23529,Robyn Regehr,2003-04,23.0,5,12,76,76,0,12,12,109.0,1729.0,281,8,28,36,317.0,82,5.31,60,363,2326,9.4,0.19774187
23530,23530,Robyn Regehr,2004-05,24.0,6,18,82,82,4,14,18,106.0,1832.0,363,12,42,54,423.0,82,5.14,57,348,2300,9.2,0.2714881
23531,23531,Robyn Regehr,2006-07,26.0,7,26,68,68,6,20,26,89.0,1573.0,431,18,62,80,512.0,82,6.05,85,480,2458,10.1,0.3171367
23532,23532,Robyn Regehr,2007-08,27.0,8,21,78,78,2,19,21,66.0,1709.0,509,20,81,101,578.0,82,5.76,70,398,2426,9.7,0.24020833
23533,23533,Robyn Regehr,2008-09,28.0,9,20,82,82,5,15,20,93.0,1750.0,591,25,96,121,671.0,82,5.44,62,351,2383,9.4,0.2546137
23534,23534,Robyn Regehr,2009-10,29.0,10,8,75,75,0,8,8,79.0,1586.0,666,25,104,129,750.0,82,5.7,65,341,2477,9.4,0.18082076
23535,23535,Robyn Regehr,2010-11,30.0,11,17,81,81,2,15,17,78.0,1753.0,747,27,119,146,828.0,82,5.53,56,304,2486,9.1,0.18419644
23536,23536,Robyn Regehr,2011-12,31.0,12,17,79,79,2,15,17,72.0,1697.0,826,29,134,163,900.0,82,5.46,52,291,2492,9.0,0.18109977
23537,23537,Robyn Regehr,2012-13,32.0,13,5,76,76,1,4,5,49.0,1416.0,902,30,138,168,949.0,82,5.32,47,271,2439,8.9,0.12353045
23538,23538,Robyn Regehr,2013-14,33.0,14,4,41,41,0,4,4,27.0,796.0,943,30,142,172,976.0,48,5.31,29,160,1399,9.1,0.11914873
23539,23539,Robyn Regehr,2014-15,34.0,15,14,79,79,3,11,14,73.0,1498.0,1022,33,153,186,1049.0,82,5.34,48,269,2463,8.9,0.14446089
23540,23540,Robyn Regehr,2015-16,35.0,16,13,67,67,3,10,13,63.0,1362.0,1089,36,163,199,1112.0,82,5.32,47,251,2453,8.9,0.13688481
23541,23541,Rocco Grimaldi,2015-16,22.0,2,1,7,7,1,0,1,18.0,88.0,7,1,0,1,18.0,82,5.32,47,251,2453,8.9,0.23386541
23542,23542,Rocco Grimaldi,2016-17,23.0,3,5,20,20,3,2,5,29.0,237.0,27,4,2,6,47.0,82,5.34,48,255,2438,9.0,0.2863501
23543,23543,Rocco Grimaldi,2017-18,24.0,4,1,4,4,0,1,1,11.0,44.0,31,4,3,7,58.0,82,5.45,47,245,2478,9.0,0.20918876
23544,23544,Rocco Grimaldi,2018-19,25.0,5,3,6,6,1,2,3,7.0,58.0,37,5,5,10,65.0,82,5.86,50,250,2620,9.2,0.18639892
23545,23545,Rocco Grimaldi,2019-20,26.0,6,13,53,53,5,8,13,81.0,530.0,90,10,13,23,146.0,82,5.96,47,239,2579,9.5,0.26961064
23546,23546,Rocco Grimaldi,2020-21,27.0,7,31,66,66,10,21,31,122.0,835.0,156,20,34,54,268.0,70,5.96,42,208,2192,9.5,0.40725094
23547,23547,Rocky Dundas,1990-91,24.0,2,0,5,5,0,0,0,1.0,,5,0,0,0,1.0,80,7.37,76,367,2421,12.2,0.21806824
23548,23548,Rocky Thompson,1998-99,21.0,2,0,12,12,0,0,0,3.0,,12,0,0,0,3.0,82,5.28,57,380,2242,9.6,0.15598187
23549,23549,Rocky Thompson,1999-00,22.0,3,0,3,3,0,0,0,0.0,6.0,15,0,0,0,3.0,82,5.27,57,359,2285,9.4,0.16321948
23550,23550,Rocky Thompson,2001-02,24.0,4,0,4,4,0,0,0,0.0,6.0,19,0,0,0,3.0,82,5.51,63,376,2272,9.9,0.13474253
23551,23551,Rocky Thompson,2002-03,25.0,5,0,6,6,0,0,0,1.0,24.0,25,0,0,0,4.0,82,5.24,53,338,2262,9.5,0.13376188
23552,23552,Rocky Trottier,1984-85,20.0,2,2,5,5,1,1,2,2.0,,5,1,1,2,2.0,80,7.89,74,336,2448,12.9,0.35511076
23553,23553,Rocky Trottier,1985-86,21.0,3,8,33,33,5,3,8,30.0,,38,6,4,10,32.0,80,7.77,71,321,2447,12.7,0.34575653
23554,23554,Rod Brind'Amour,1990-91,20.0,2,61,79,79,26,35,61,160.0,,79,26,35,61,160.0,80,7.37,76,367,2421,12.2,0.7773509
23555,23555,Rod Brind'Amour,1991-92,21.0,3,49,78,78,17,32,49,169.0,,157,43,67,110,329.0,80,6.91,71,366,2385,11.6,0.70660317
23556,23556,Rod Brind'Amour,1992-93,22.0,4,77,80,80,33,44,77,202.0,,237,76,111,187,531.0,80,6.96,77,402,2440,11.4,0.9852941
23557,23557,Rod Brind'Amour,1993-94,23.0,5,86,81,81,37,49,86,206.0,,318,113,160,273,737.0,84,7.25,87,443,2603,11.7,0.9741751
23558,23558,Rod Brind'Amour,1994-95,24.0,6,97,84,84,35,62,97,230.0,,402,148,222,370,967.0,84,6.48,76,407,2545,10.7,1.0176182
23559,23559,Rod Brind'Amour,1995-96,25.0,7,39,48,48,12,27,39,86.0,,450,160,249,409,1053.0,48,5.97,37,209,1408,10.2,0.8682916
23560,23560,Rod Brind'Amour,1996-97,26.0,8,87,82,82,26,61,87,213.0,,532,186,310,496,1266.0,82,6.29,74,413,2481,10.4,0.93624234
23561,23561,Rod Brind'Amour,1997-98,27.0,9,59,82,82,27,32,59,205.0,,614,213,342,555,1471.0,82,5.83,55,336,2444,9.8,0.73766536
23562,23562,Rod Brind'Amour,1998-99,28.0,10,74,82,82,36,38,74,205.0,,696,249,380,629,1676.0,82,5.28,57,380,2242,9.6,0.8694157
23563,23563,Rod Brind'Amour,1999-00,29.0,11,74,82,82,24,50,74,191.0,1762.0,778,273,430,703,1867.0,82,5.27,57,359,2285,9.4,0.86428183
23564,23564,Rod Brind'Amour,2000-01,30.0,12,22,45,45,9,13,22,87.0,929.0,823,282,443,725,1954.0,82,5.49,53,331,2294,9.8,0.59930795
23565,23565,Rod Brind'Amour,2001-02,31.0,13,56,79,79,20,36,56,163.0,1748.0,902,302,479,781,2117.0,82,5.51,63,376,2272,9.9,0.665593
23566,23566,Rod Brind'Amour,2002-03,32.0,14,55,81,81,23,32,55,162.0,1792.0,983,325,511,836,2279.0,82,5.24,53,338,2262,9.5,0.6722193
23567,23567,Rod Brind'Amour,2003-04,33.0,15,37,48,48,14,23,37,110.0,1141.0,1031,339,534,873,2389.0,82,5.31,60,363,2326,9.4,0.6588137
23568,23568,Rod Brind'Amour,2004-05,34.0,16,38,78,78,12,26,38,141.0,1668.0,1109,351,560,911,2530.0,82,5.14,57,348,2300,9.2,0.6448256
23569,23569,Rod Brind'Amour,2006-07,36.0,17,70,78,78,31,39,70,198.0,1895.0,1187,382,599,981,2728.0,82,6.05,85,480,2458,10.1,0.79786944
23570,23570,Rod Brind'Amour,2007-08,37.0,18,82,78,78,26,56,82,181.0,1819.0,1265,408,655,1063,2909.0,82,5.76,70,398,2426,9.7,0.79263324
23571,23571,Rod Brind'Amour,2008-09,38.0,19,51,59,59,19,32,51,151.0,1325.0,1324,427,687,1114,3060.0,82,5.44,62,351,2383,9.4,0.6837525
23572,23572,Rod Brind'Amour,2009-10,39.0,20,51,80,80,16,35,51,135.0,1518.0,1404,443,722,1165,3195.0,82,5.7,65,341,2477,9.4,0.53245723
23573,23573,Rod Brind'Amour,2010-11,40.0,21,19,80,80,9,10,19,95.0,1017.0,1484,452,732,1184,3290.0,82,5.53,56,304,2486,9.1,0.2945733
23574,23574,Rod Buskas,1983-84,23.0,2,4,41,41,2,2,4,27.0,,41,2,2,4,27.0,80,7.73,71,310,2444,12.7,0.19980961
23575,23575,Rod Buskas,1984-85,24.0,3,6,47,47,2,4,6,39.0,,88,4,6,10,66.0,80,7.89,74,336,2448,12.9,0.19912484
23576,23576,Rod Buskas,1985-86,25.0,4,9,69,69,2,7,9,53.0,,157,6,13,19,119.0,80,7.77,71,321,2447,12.7,0.18942085
23577,23577,Rod Buskas,1986-87,26.0,5,9,72,72,2,7,9,49.0,,229,8,20,28,168.0,80,7.94,82,370,2484,12.8,0.18625844
23578,23578,Rod Buskas,1987-88,27.0,6,18,68,68,3,15,18,91.0,,297,11,35,46,259.0,80,7.34,72,344,2400,12.2,0.24341765
23579,23579,Rod Buskas,1988-89,28.0,7,12,76,76,4,8,12,53.0,,373,15,43,58,312.0,80,7.43,89,437,2435,12.2,0.19221336
23580,23580,Rod Buskas,1989-90,29.0,8,6,52,52,1,5,6,15.0,,425,16,48,64,327.0,80,7.48,85,403,2430,12.3,0.13563746
23581,23581,Rod Buskas,1990-91,30.0,9,3,23,23,0,3,3,12.0,,448,16,51,67,339.0,80,7.37,76,367,2421,12.2,0.1451003
23582,23582,Rod Buskas,1991-92,31.0,10,11,57,57,3,8,11,60.0,,505,19,59,78,399.0,80,6.91,71,366,2385,11.6,0.20909494
23583,23583,Rod Buskas,1992-93,32.0,11,4,47,47,0,4,4,23.0,,552,19,63,82,422.0,80,6.96,77,402,2440,11.4,0.110931456
23584,23584,Rod Buskas,1993-94,33.0,12,0,4,4,0,0,0,3.0,,556,19,63,82,425.0,84,7.25,87,443,2603,11.7,0.14417398
23585,23585,Rod Dallman,1988-89,22.0,2,1,3,3,1,0,1,2.0,,3,1,0,1,2.0,80,7.43,89,437,2435,12.2,0.26788548
23586,23586,Rod Dallman,1989-90,23.0,3,0,1,1,0,0,0,1.0,,4,1,0,1,3.0,80,7.48,85,403,2430,12.3,0.20962113
23587,23587,Rod Dallman,1992-93,26.0,4,0,2,2,0,0,0,2.0,,6,1,0,1,5.0,80,6.96,77,402,2440,11.4,0.19381294
23588,23588,Rod Pelley,2007-08,23.0,2,0,9,9,0,0,0,8.0,99.0,9,0,0,0,8.0,82,5.76,70,398,2426,9.7,0.17466322
23589,23589,Rod Pelley,2008-09,24.0,3,6,58,58,2,4,6,59.0,540.0,67,2,4,6,67.0,82,5.44,62,351,2383,9.4,0.18043396
23590,23590,Rod Pelley,2010-11,26.0,4,10,63,63,2,8,10,74.0,496.0,130,4,12,16,141.0,82,5.53,56,304,2486,9.1,0.18009686
23591,23591,Rod Pelley,2011-12,27.0,5,10,74,74,3,7,10,88.0,874.0,204,7,19,26,229.0,82,5.46,52,291,2492,9.0,0.17247102
23592,23592,Rod Pelley,2012-13,28.0,6,3,52,52,2,1,3,44.0,403.0,256,9,20,29,273.0,82,5.32,47,271,2439,8.9,0.14350691
23593,23593,Rod Willard,1983-84,23.0,2,0,1,1,0,0,0,2.0,,1,0,0,0,2.0,80,7.73,71,310,2444,12.7,0.22910526
23594,23594,Roger Belanger,1985-86,20.0,2,8,44,44,3,5,8,65.0,,44,3,5,8,65.0,80,7.77,71,321,2447,12.7,0.28322744
23595,23595,Roger Hagglund,1985-86,24.0,2,0,3,3,0,0,0,5.0,,3,0,0,0,5.0,80,7.77,71,321,2447,12.7,0.22581163
23596,23596,Roger Johansson,1990-91,23.0,2,5,35,35,0,5,5,23.0,,35,0,5,5,23.0,80,7.37,76,367,2421,12.2,0.21179661
23597,23597,Roger Johansson,1991-92,24.0,3,17,38,38,4,13,17,41.0,,73,4,18,22,64.0,80,6.91,71,366,2385,11.6,0.34925765
23598,23598,Roger Johansson,1993-94,26.0,4,20,77,77,4,16,20,101.0,,150,8,34,42,165.0,84,7.25,87,443,2603,11.7,0.24586904
23599,23599,Roger Johansson,1995-96,28.0,5,1,11,11,1,0,1,10.0,,161,9,34,43,175.0,48,5.97,37,209,1408,10.2,0.21505877
23600,23600,Roger Kortko,1985-86,22.0,2,11,27,27,2,9,11,24.0,,27,2,9,11,24.0,80,7.77,71,321,2447,12.7,0.3502344
23601,23601,Roger Kortko,1986-87,23.0,3,13,52,52,5,8,13,49.0,,79,7,17,24,73.0,80,7.94,82,370,2484,12.8,0.32546312
23602,23602,Roger Melin,1981-82,25.0,2,0,1,1,0,0,0,1.0,,1,0,0,0,1.0,80,7.69,77,340,2441,12.6,0.21703571
23603,23603,Roger Melin,1982-83,26.0,3,0,2,2,0,0,0,0.0,,3,0,0,0,1.0,80,8.03,73,320,2489,12.9,0.19868684
23604,23604,Roland McKeown,2018-19,23.0,2,3,10,10,0,3,3,7.0,134.0,10,0,3,3,7.0,82,5.86,50,250,2620,9.2,0.1995281
23605,23605,Roland Stoltz,1982-83,28.0,2,4,14,14,2,2,4,6.0,,14,2,2,4,6.0,80,8.03,73,320,2489,12.9,0.31335068
23606,23606,Roman Cervenka,2013-14,28.0,2,17,39,39,9,8,17,51.0,512.0,39,9,8,17,51.0,48,5.31,29,160,1399,9.1,0.38310212
23607,23607,Roman Hamrlik,1993-94,19.0,2,21,67,67,6,15,21,113.0,,67,6,15,21,113.0,84,7.25,87,443,2603,11.7,0.3645613
23608,23608,Roman Hamrlik,1994-95,20.0,3,21,64,64,3,18,21,158.0,,131,9,33,42,271.0,84,6.48,76,407,2545,10.7,0.39399016
23609,23609,Roman Hamrlik,1995-96,21.0,4,23,48,48,12,11,23,134.0,,179,21,44,65,405.0,48,5.97,37,209,1408,10.2,0.59239894
23610,23610,Roman Hamrlik,1996-97,22.0,5,65,82,82,16,49,65,281.0,,261,37,93,130,686.0,82,6.29,74,413,2481,10.4,0.77587676
23611,23611,Roman Hamrlik,1997-98,23.0,6,40,79,79,12,28,40,238.0,,340,49,121,170,924.0,82,5.83,55,336,2444,9.8,0.5692914
23612,23612,Roman Hamrlik,1998-99,24.0,7,41,78,78,9,32,41,198.0,,418,58,153,211,1122.0,82,5.28,57,380,2242,9.6,0.5520394
23613,23613,Roman Hamrlik,1999-00,25.0,8,32,75,75,8,24,32,172.0,1786.0,493,66,177,243,1294.0,82,5.27,57,359,2285,9.4,0.49697706
23614,23614,Roman Hamrlik,2000-01,26.0,9,45,80,80,8,37,45,180.0,2023.0,573,74,214,288,1474.0,82,5.49,53,331,2294,9.8,0.61203504
23615,23615,Roman Hamrlik,2001-02,27.0,10,46,76,76,16,30,46,232.0,1916.0,649,90,244,334,1706.0,82,5.51,63,376,2272,9.9,0.5761508
23616,23616,Roman Hamrlik,2002-03,28.0,11,37,70,70,11,26,37,169.0,1787.0,719,101,270,371,1875.0,82,5.24,53,338,2262,9.5,0.52996886
23617,23617,Roman Hamrlik,2003-04,29.0,12,41,73,73,9,32,41,151.0,1940.0,792,110,302,412,2026.0,82,5.31,60,363,2326,9.4,0.4963788
23618,23618,Roman Hamrlik,2004-05,30.0,13,29,81,81,7,22,29,182.0,1991.0,873,117,324,441,2208.0,82,5.14,57,348,2300,9.2,0.5068101
23619,23619,Roman Hamrlik,2006-07,32.0,14,26,51,51,7,19,26,89.0,1114.0,924,124,343,467,2297.0,82,6.05,85,480,2458,10.1,0.4327867
23620,23620,Roman Hamrlik,2007-08,33.0,15,38,75,75,7,31,38,125.0,1865.0,999,131,374,505,2422.0,82,5.76,70,398,2426,9.7,0.3681445
23621,23621,Roman Hamrlik,2008-09,34.0,16,26,77,77,5,21,26,129.0,1781.0,1076,136,395,531,2551.0,82,5.44,62,351,2383,9.4,0.29919696
23622,23622,Roman Hamrlik,2009-10,35.0,17,33,81,81,6,27,33,143.0,1775.0,1157,142,422,564,2694.0,82,5.7,65,341,2477,9.4,0.353436
23623,23623,Roman Hamrlik,2010-11,36.0,18,26,75,75,6,20,26,100.0,1758.0,1232,148,442,590,2794.0,82,5.53,56,304,2486,9.1,0.31164956
23624,23624,Roman Hamrlik,2011-12,37.0,19,34,79,79,5,29,34,129.0,1760.0,1311,153,471,624,2923.0,82,5.46,52,291,2492,9.0,0.31174344
23625,23625,Roman Hamrlik,2012-13,38.0,20,13,68,68,2,11,13,58.0,1307.0,1379,155,482,637,2981.0,82,5.32,47,271,2439,8.9,0.16674367
23626,23626,Roman Hamrlik,2013-14,39.0,21,1,16,16,0,1,1,7.0,184.0,1395,155,483,638,2988.0,48,5.31,29,160,1399,9.1,0.22339645
23627,23627,Roman Horak,2012-13,21.0,2,11,61,61,3,8,11,53.0,622.0,61,3,8,11,53.0,82,5.32,47,271,2439,8.9,0.2298209
23628,23628,Roman Horak,2013-14,22.0,3,7,20,20,2,5,7,28.0,291.0,81,5,13,18,81.0,48,5.31,29,160,1399,9.1,0.34338403
23629,23629,Roman Horak,2014-15,23.0,4,1,3,3,1,0,1,2.0,28.0,84,6,13,19,83.0,82,5.34,48,269,2463,8.9,0.24288312
23630,23630,Roman Josi,2012-13,22.0,2,16,52,52,5,11,16,64.0,956.0,52,5,11,16,64.0,82,5.32,47,271,2439,8.9,0.32107472
23631,23631,Roman Josi,2013-14,23.0,3,18,48,48,5,13,18,96.0,1129.0,100,10,24,34,160.0,48,5.31,29,160,1399,9.1,0.41924945
23632,23632,Roman Josi,2014-15,24.0,4,40,72,72,13,27,40,168.0,1902.0,172,23,51,74,328.0,82,5.34,48,269,2463,8.9,0.5121408
23633,23633,Roman Josi,2015-16,25.0,5,55,81,81,15,40,55,201.0,2144.0,253,38,91,129,529.0,82,5.32,47,251,2453,8.9,0.6791466
23634,23634,Roman Josi,2016-17,26.0,6,61,81,81,14,47,61,198.0,2064.0,334,52,138,190,727.0,82,5.34,48,255,2438,9.0,0.7343251
23635,23635,Roman Josi,2017-18,27.0,7,49,72,72,12,37,49,217.0,1805.0,406,64,175,239,944.0,82,5.45,47,245,2478,9.0,0.5974948
23636,23636,Roman Josi,2018-19,28.0,8,53,75,75,14,39,53,253.0,1835.0,481,78,214,292,1197.0,82,5.86,50,250,2620,9.2,0.7257395
23637,23637,Roman Josi,2019-20,29.0,9,56,82,82,15,41,56,274.0,2064.0,563,93,255,348,1471.0,82,5.96,47,239,2579,9.5,0.7406145
23638,23638,Roman Josi,2020-21,30.0,10,65,69,69,16,49,65,260.0,1779.0,632,109,304,413,1731.0,70,5.96,42,208,2192,9.5,0.85347044
23639,23639,Roman Lyashenko,2000-01,21.0,2,12,58,58,6,6,12,51.0,634.0,58,6,6,12,51.0,82,5.49,53,331,2294,9.8,0.24922863
23640,23640,Roman Lyashenko,2001-02,22.0,3,9,60,60,6,3,9,48.0,575.0,118,12,9,21,99.0,82,5.51,63,376,2272,9.9,0.21884438
23641,23641,Roman Lyashenko,2002-03,23.0,4,2,19,19,2,0,2,16.0,148.0,137,14,9,23,115.0,82,5.24,53,338,2262,9.5,0.22442305
23642,23642,Roman Lyashenko,2003-04,24.0,5,0,2,2,0,0,0,4.0,24.0,139,14,9,23,119.0,82,5.31,60,363,2326,9.4,0.16108981
23643,23643,Roman Lyubimov,2017-18,26.0,2,6,47,47,4,2,6,41.0,450.0,47,4,2,6,41.0,82,5.45,47,245,2478,9.0,0.17081907
23644,23644,Roman Oksiuta,1994-95,24.0,2,3,10,10,1,2,3,18.0,,10,1,2,3,18.0,84,6.48,76,407,2545,10.7,0.22648743
23645,23645,Roman Oksiuta,1995-96,25.0,3,20,38,38,16,4,20,67.0,,48,17,6,23,85.0,48,5.97,37,209,1408,10.2,0.5153196
23646,23646,Roman Oksiuta,1996-97,26.0,4,51,70,70,23,28,51,119.0,,118,40,34,74,204.0,82,6.29,74,413,2481,10.4,0.5886489
23647,23647,Roman Oksiuta,1997-98,27.0,5,13,35,35,6,7,13,58.0,,153,46,41,87,262.0,82,5.83,55,336,2444,9.8,0.3366366
23648,23648,Roman Polak,2007-08,21.0,2,0,19,19,0,0,0,13.0,259.0,19,0,0,0,13.0,82,5.76,70,398,2426,9.7,0.14705661
23649,23649,Roman Polak,2008-09,22.0,3,1,6,6,0,1,1,2.0,69.0,25,0,1,1,15.0,82,5.44,62,351,2383,9.4,0.17134956
23650,23650,Roman Polak,2009-10,23.0,4,15,69,69,1,14,15,73.0,1486.0,94,1,15,16,88.0,82,5.7,65,341,2477,9.4,0.225595
23651,23651,Roman Polak,2010-11,24.0,5,21,78,78,4,17,21,73.0,1558.0,172,5,32,37,161.0,82,5.53,56,304,2486,9.1,0.23627773
23652,23652,Roman Polak,2011-12,25.0,6,12,55,55,3,9,12,54.0,1098.0,227,8,41,49,215.0,82,5.46,52,291,2492,9.0,0.19038859
23653,23653,Roman Polak,2012-13,26.0,7,11,77,77,0,11,11,88.0,1453.0,304,8,52,60,303.0,82,5.32,47,271,2439,8.9,0.16909453
23654,23654,Roman Polak,2013-14,27.0,8,6,48,48,1,5,6,39.0,884.0,352,9,57,66,342.0,48,5.31,29,160,1399,9.1,0.15476581
23655,23655,Roman Polak,2014-15,28.0,9,13,72,72,4,9,13,83.0,1248.0,424,13,66,79,425.0,82,5.34,48,269,2463,8.9,0.18811366
23656,23656,Roman Polak,2015-16,29.0,10,9,56,56,5,4,9,61.0,1181.0,480,18,70,88,486.0,82,5.32,47,251,2453,8.9,0.1699788
23657,23657,Roman Polak,2016-17,30.0,11,16,79,79,1,15,16,91.0,1513.0,559,19,85,104,577.0,82,5.34,48,255,2438,9.0,0.17728576
23658,23658,Roman Polak,2017-18,31.0,12,11,75,75,4,7,11,64.0,1344.0,634,23,92,115,641.0,82,5.45,47,245,2478,9.0,0.14247131
23659,23659,Roman Polak,2018-19,32.0,13,12,54,54,2,10,12,47.0,953.0,688,25,102,127,688.0,82,5.86,50,250,2620,9.2,0.15788114
23660,23660,Roman Polak,2019-20,33.0,14,9,77,77,1,8,9,77.0,1476.0,765,26,110,136,765.0,82,5.96,47,239,2579,9.5,0.12825426
23661,23661,Roman Polak,2020-21,34.0,15,4,41,41,0,4,4,34.0,683.0,806,26,114,140,799.0,70,5.96,42,208,2192,9.5,0.11200529
23662,23662,Roman Simicek,2001-02,30.0,2,15,57,57,5,10,15,33.0,629.0,57,5,10,15,33.0,82,5.51,63,376,2272,9.9,0.22801262
23663,23663,Roman Simicek,2002-03,31.0,3,2,6,6,2,0,2,4.0,80.0,63,7,10,17,37.0,82,5.24,53,338,2262,9.5,0.18633905
23664,23664,Roman Tvrdon,2004-05,24.0,2,1,9,9,0,1,1,7.0,96.0,9,0,1,1,7.0,82,5.14,57,348,2300,9.2,0.18707821
23665,23665,Roman Vopat,1996-97,20.0,2,5,25,25,2,3,5,33.0,,25,2,3,5,33.0,82,6.29,74,413,2481,10.4,0.30475822
23666,23666,Roman Vopat,1997-98,21.0,3,9,29,29,4,5,9,54.0,,54,6,8,14,87.0,82,5.83,55,336,2444,9.8,0.32196957
23667,23667,Roman Vopat,1998-99,22.0,4,3,25,25,0,3,3,36.0,,79,6,11,17,123.0,82,5.28,57,380,2242,9.6,0.23107046
23668,23668,Roman Vopat,1999-00,23.0,5,3,54,54,0,3,3,27.0,301.0,133,6,14,20,150.0,82,5.27,57,359,2285,9.4,0.14528275
23669,23669,Roman Wick,2011-12,26.0,2,0,7,7,0,0,0,4.0,60.0,7,0,0,0,4.0,82,5.46,52,291,2492,9.0,0.16366741
23670,23670,Ron Areshenkoff,1980-81,23.0,2,0,4,4,0,0,0,3.0,,4,0,0,0,3.0,80,7.03,61,280,2352,12.0,0.22812074
23671,23671,Ron Carter,1980-81,22.0,2,0,2,2,0,0,0,0.0,,2,0,0,0,0.0,80,7.03,61,280,2352,12.0,0.19461161
23672,23672,Ron Chipperfield,1980-81,26.0,2,45,79,79,22,23,45,155.0,,79,22,23,45,155.0,80,7.03,61,280,2352,12.0,0.56520283
23673,23673,Ron Chipperfield,1981-82,27.0,3,1,4,4,0,1,1,0.0,,83,22,24,46,155.0,80,7.69,77,340,2441,12.6,0.26878977
23674,23674,Ron Fischer,1982-83,23.0,2,7,15,15,0,7,7,16.0,,15,0,7,7,16.0,80,8.03,73,320,2489,12.9,0.2644338
23675,23675,Ron Fischer,1983-84,24.0,3,0,3,3,0,0,0,1.0,,18,0,7,7,17.0,80,7.73,71,310,2444,12.7,0.19144726
23676,23676,Ron Flockhart,1981-82,21.0,2,10,14,14,3,7,10,24.0,,14,3,7,10,24.0,80,7.69,77,340,2441,12.6,0.50295943
23677,23677,Ron Flockhart,1982-83,22.0,3,72,72,72,33,39,72,240.0,,86,36,46,82,264.0,80,8.03,73,320,2489,12.9,0.870432
23678,23678,Ron Flockhart,1983-84,23.0,4,60,73,73,29,31,60,241.0,,159,65,77,142,505.0,80,7.73,71,310,2444,12.7,0.79734784
23679,23679,Ron Flockhart,1984-85,24.0,5,48,76,76,27,21,48,214.0,,235,92,98,190,719.0,80,7.89,74,336,2448,12.9,0.6949147
23680,23680,Ron Flockhart,1985-86,25.0,6,27,54,54,10,17,27,78.0,,289,102,115,217,797.0,80,7.77,71,321,2447,12.7,0.6300334
23681,23681,Ron Flockhart,1986-87,26.0,7,67,79,79,22,45,67,199.0,,368,124,160,284,996.0,80,7.94,82,370,2484,12.8,0.7862436
23682,23682,Ron Flockhart,1987-88,27.0,8,35,60,60,16,19,35,103.0,,428,140,179,319,1099.0,80,7.34,72,344,2400,12.2,0.5326247
23683,23683,Ron Flockhart,1988-89,28.0,9,9,21,21,5,4,9,27.0,,449,145,183,328,1126.0,80,7.43,89,437,2435,12.2,0.4284311
23684,23684,Ron Flockhart,1989-90,29.0,10,0,4,4,0,0,0,3.0,,453,145,183,328,1129.0,80,7.48,85,403,2430,12.3,0.366672
23685,23685,Ron Francis,1982-83,19.0,2,68,59,59,25,43,68,163.0,,59,25,43,68,163.0,80,8.03,73,320,2489,12.9,1.0113146
23686,23686,Ron Francis,1983-84,20.0,3,90,79,79,31,59,90,210.0,,138,56,102,158,373.0,80,7.73,71,310,2444,12.7,1.1538159
23687,23687,Ron Francis,1984-85,21.0,4,83,72,72,23,60,83,202.0,,210,79,162,241,575.0,80,7.89,74,336,2448,12.9,1.0849917
23688,23688,Ron Francis,1985-86,22.0,5,81,80,80,24,57,81,199.0,,290,103,219,322,774.0,80,7.77,71,321,2447,12.7,1.1224737
23689,23689,Ron Francis,1986-87,23.0,6,77,53,53,24,53,77,120.0,,343,127,272,399,894.0,80,7.94,82,370,2484,12.8,1.1290201
23690,23690,Ron Francis,1987-88,24.0,7,93,75,75,30,63,93,189.0,,418,157,335,492,1083.0,80,7.34,72,344,2400,12.2,1.1138868
23691,23691,Ron Francis,1988-89,25.0,8,75,80,80,25,50,75,172.0,,498,182,385,567,1255.0,80,7.43,89,437,2435,12.2,0.9962445
23692,23692,Ron Francis,1989-90,26.0,9,77,69,69,29,48,77,156.0,,567,211,433,644,1411.0,80,7.48,85,403,2430,12.3,1.0759327
23693,23693,Ron Francis,1990-91,27.0,10,101,80,80,32,69,101,170.0,,647,243,502,745,1581.0,80,7.37,76,367,2421,12.2,1.0939324
23694,23694,Ron Francis,1991-92,28.0,11,87,81,81,23,64,87,174.0,,728,266,566,832,1755.0,80,6.91,71,366,2385,11.6,1.0225427
23695,23695,Ron Francis,1992-93,29.0,12,54,70,70,21,33,54,121.0,,798,287,599,886,1876.0,80,6.96,77,402,2440,11.4,0.88590646
23696,23696,Ron Francis,1993-94,30.0,13,100,84,84,24,76,100,215.0,,882,311,675,986,2091.0,84,7.25,87,443,2603,11.7,1.0714142
23697,23697,Ron Francis,1994-95,31.0,14,93,82,82,27,66,93,216.0,,964,338,741,1079,2307.0,84,6.48,76,407,2545,10.7,1.0067296
23698,23698,Ron Francis,1995-96,32.0,15,59,44,44,11,48,59,94.0,,1008,349,789,1138,2401.0,48,5.97,37,209,1408,10.2,1.230098
23699,23699,Ron Francis,1996-97,33.0,16,119,77,77,27,92,119,158.0,,1085,376,881,1257,2559.0,82,6.29,74,413,2481,10.4,1.0845201
23700,23700,Ron Francis,1997-98,34.0,17,90,81,81,27,63,90,183.0,,1166,403,944,1347,2742.0,82,5.83,55,336,2444,9.8,0.98330414
23701,23701,Ron Francis,1998-99,35.0,18,87,81,81,25,62,87,189.0,,1247,428,1006,1434,2931.0,82,5.28,57,380,2242,9.6,0.8908875
23702,23702,Ron Francis,1999-00,36.0,19,52,82,82,21,31,52,133.0,1797.0,1329,449,1037,1486,3064.0,82,5.27,57,359,2285,9.4,0.6368829
23703,23703,Ron Francis,2000-01,37.0,20,73,78,78,23,50,73,150.0,1714.0,1407,472,1087,1559,3214.0,82,5.49,53,331,2294,9.8,0.73194426
23704,23704,Ron Francis,2001-02,38.0,21,65,82,82,15,50,65,130.0,1661.0,1489,487,1137,1624,3344.0,82,5.51,63,376,2272,9.9,0.71549016
23705,23705,Ron Francis,2002-03,39.0,22,77,80,80,27,50,77,165.0,1655.0,1569,514,1187,1701,3509.0,82,5.24,53,338,2262,9.5,0.7388776
23706,23706,Ron Francis,2003-04,40.0,23,57,82,82,22,35,57,156.0,1635.0,1651,536,1222,1758,3665.0,82,5.31,60,363,2326,9.4,0.63869804
23707,23707,Ron Francis,2004-05,41.0,24,40,80,80,13,27,40,91.0,1266.0,1731,549,1249,1798,3756.0,82,5.14,57,348,2300,9.2,0.4969358
23708,23708,Ron Friest,1981-82,23.0,2,1,4,4,1,0,1,6.0,,4,1,0,1,6.0,80,7.69,77,340,2441,12.6,0.27675617
23709,23709,Ron Friest,1982-83,24.0,3,0,10,10,0,0,0,5.0,,14,1,0,1,11.0,80,8.03,73,320,2489,12.9,0.19759232
23710,23710,Ron Friest,1983-84,25.0,4,13,50,50,6,7,13,44.0,,64,7,7,14,55.0,80,7.73,71,310,2444,12.7,0.28072906
23711,23711,Ron Hainsey,2003-04,22.0,2,0,21,21,0,0,0,12.0,261.0,21,0,0,0,12.0,82,5.31,60,363,2326,9.4,0.11701417
23712,23712,Ron Hainsey,2004-05,23.0,3,2,11,11,1,1,2,11.0,146.0,32,1,1,2,23.0,82,5.14,57,348,2300,9.2,0.24396655
23713,23713,Ron Hainsey,2006-07,25.0,4,17,55,55,2,15,17,81.0,978.0,87,3,16,19,104.0,82,6.05,85,480,2458,10.1,0.27775353
23714,23714,Ron Hainsey,2007-08,26.0,5,34,80,80,9,25,34,136.0,1831.0,167,12,41,53,240.0,82,5.76,70,398,2426,9.7,0.40408182
23715,23715,Ron Hainsey,2008-09,27.0,6,32,78,78,8,24,32,161.0,1760.0,245,20,65,85,401.0,82,5.44,62,351,2383,9.4,0.43649992
23716,23716,Ron Hainsey,2009-10,28.0,7,39,81,81,6,33,39,148.0,1812.0,326,26,98,124,549.0,82,5.7,65,341,2477,9.4,0.4551755
23717,23717,Ron Hainsey,2010-11,29.0,8,26,80,80,5,21,26,121.0,1771.0,406,31,119,150,670.0,82,5.53,56,304,2486,9.1,0.30403638
23718,23718,Ron Hainsey,2011-12,30.0,9,19,82,82,3,16,19,83.0,1483.0,488,34,135,169,753.0,82,5.46,52,291,2492,9.0,0.24330944
23719,23719,Ron Hainsey,2012-13,31.0,10,10,56,56,0,10,10,57.0,1181.0,544,34,145,179,810.0,82,5.32,47,271,2439,8.9,0.18071887
23720,23720,Ron Hainsey,2013-14,32.0,11,13,47,47,0,13,13,52.0,1074.0,591,34,158,192,862.0,48,5.31,29,160,1399,9.1,0.20061943
23721,23721,Ron Hainsey,2014-15,33.0,12,15,82,82,4,11,15,72.0,1758.0,673,38,169,207,934.0,82,5.34,48,269,2463,8.9,0.17486903
23722,23722,Ron Hainsey,2015-16,34.0,13,10,81,81,2,8,10,83.0,1709.0,754,40,177,217,1017.0,82,5.32,47,251,2453,8.9,0.14845788
23723,23723,Ron Hainsey,2016-17,35.0,14,19,81,81,5,14,19,131.0,1808.0,835,45,191,236,1148.0,82,5.34,48,255,2438,9.0,0.24444833
23724,23724,Ron Hainsey,2017-18,36.0,15,17,72,72,4,13,17,71.0,1586.0,907,49,204,253,1219.0,82,5.45,47,245,2478,9.0,0.15872845
23725,23725,Ron Hainsey,2018-19,37.0,16,23,80,80,4,19,23,73.0,1749.0,987,53,223,276,1292.0,82,5.86,50,250,2620,9.2,0.2012715
23726,23726,Ron Hainsey,2019-20,38.0,17,23,81,81,5,18,23,81.0,1641.0,1068,58,241,299,1373.0,82,5.96,47,239,2579,9.5,0.20554823
23727,23727,Ron Hainsey,2020-21,39.0,18,12,64,64,1,11,12,43.0,1324.0,1132,59,252,311,1416.0,70,5.96,42,208,2192,9.5,0.14258885
23728,23728,Ron Handy,1985-86,23.0,2,2,10,10,0,2,2,6.0,,10,0,2,2,6.0,80,7.77,71,321,2447,12.7,0.24782705
23729,23729,Ron Handy,1988-89,26.0,3,1,4,4,0,1,1,4.0,,14,0,3,3,10.0,80,7.43,89,437,2435,12.2,0.20495507
23730,23730,Ron Hoover,1990-91,24.0,2,0,2,2,0,0,0,2.0,,2,0,0,0,2.0,80,7.37,76,367,2421,12.2,0.2231631
23731,23731,Ron Hoover,1991-92,25.0,3,4,15,15,4,0,4,17.0,,17,4,0,4,19.0,80,6.91,71,366,2385,11.6,0.28882366
23732,23732,Ron Hoover,1992-93,26.0,4,0,1,1,0,0,0,1.0,,18,4,0,4,20.0,80,6.96,77,402,2440,11.4,0.18771467
23733,23733,Ron Meighan,1982-83,19.0,2,2,7,7,1,1,2,4.0,,7,1,1,2,4.0,80,8.03,73,320,2489,12.9,0.34500402
23734,23734,Ron Meighan,1983-84,20.0,3,8,41,41,2,6,8,48.0,,48,3,7,10,52.0,80,7.73,71,310,2444,12.7,0.27459472
23735,23735,Ron Plumb,1980-81,30.0,2,7,26,26,3,4,7,38.0,,26,3,4,7,38.0,80,7.03,61,280,2352,12.0,0.30529267
23736,23736,Ron Shudra,1988-89,21.0,2,5,10,10,0,5,5,8.0,,10,0,5,5,8.0,80,7.43,89,437,2435,12.2,0.30483186
23737,23737,Ron Stern,1988-89,22.0,2,0,15,15,0,0,0,7.0,,15,0,0,0,7.0,80,7.43,89,437,2435,12.2,0.2109218
23738,23738,Ron Stern,1989-90,23.0,3,1,17,17,1,0,1,13.0,,32,1,0,1,20.0,80,7.48,85,403,2430,12.3,0.23809186
23739,23739,Ron Stern,1990-91,24.0,4,5,34,34,2,3,5,27.0,,66,3,3,6,47.0,80,7.37,76,367,2421,12.2,0.19679594
23740,23740,Ron Stern,1991-92,25.0,5,9,44,44,3,6,9,45.0,,110,6,9,15,92.0,80,6.91,71,366,2385,11.6,0.21362966
23741,23741,Ron Stern,1992-93,26.0,6,22,72,72,13,9,22,96.0,,182,19,18,37,188.0,80,6.96,77,402,2440,11.4,0.31660083
23742,23742,Ron Stern,1993-94,27.0,7,25,70,70,10,15,25,82.0,,252,29,33,62,270.0,84,7.25,87,443,2603,11.7,0.2816736
23743,23743,Ron Stern,1994-95,28.0,8,29,71,71,9,20,29,105.0,,323,38,53,91,375.0,84,6.48,76,407,2545,10.7,0.3342094
23744,23744,Ron Stern,1995-96,29.0,9,13,39,39,9,4,13,69.0,,362,47,57,104,444.0,48,5.97,37,209,1408,10.2,0.30889183
23745,23745,Ron Stern,1996-97,30.0,10,15,52,52,10,5,15,64.0,,414,57,62,119,508.0,82,6.29,74,413,2481,10.4,0.25204486
23746,23746,Ron Stern,1997-98,31.0,11,17,79,79,7,10,17,98.0,,493,64,72,136,606.0,82,5.83,55,336,2444,9.8,0.22750536
23747,23747,Ron Stern,1999-00,33.0,12,16,78,78,7,9,16,94.0,906.0,571,71,81,152,700.0,82,5.27,57,359,2285,9.4,0.22504386
23748,23748,Ron Stern,2000-01,34.0,13,9,67,67,4,5,9,63.0,611.0,638,75,86,161,763.0,82,5.49,53,331,2294,9.8,0.15170845
23749,23749,Ron Sutter,1983-84,20.0,2,2,10,10,1,1,2,4.0,,10,1,1,2,4.0,80,7.73,71,310,2444,12.7,0.332128
23750,23750,Ron Sutter,1984-85,21.0,3,51,79,79,19,32,51,146.0,,89,20,33,53,150.0,80,7.89,74,336,2448,12.9,0.660817
23751,23751,Ron Sutter,1985-86,22.0,4,45,73,73,16,29,45,144.0,,162,36,62,98,294.0,80,7.77,71,321,2447,12.7,0.63298875
23752,23752,Ron Sutter,1986-87,23.0,5,60,75,75,18,42,60,146.0,,237,54,104,158,440.0,80,7.94,82,370,2484,12.8,0.7129947
23753,23753,Ron Sutter,1987-88,24.0,6,28,39,39,10,18,28,68.0,,276,64,122,186,508.0,80,7.34,72,344,2400,12.2,0.6372985
23754,23754,Ron Sutter,1988-89,25.0,7,33,69,69,8,25,33,107.0,,345,72,147,219,615.0,80,7.43,89,437,2435,12.2,0.573798
23755,23755,Ron Sutter,1989-90,26.0,8,48,55,55,26,22,48,106.0,,400,98,169,267,721.0,80,7.48,85,403,2430,12.3,0.7491287
23756,23756,Ron Sutter,1990-91,27.0,9,48,75,75,22,26,48,157.0,,475,120,195,315,878.0,80,7.37,76,367,2421,12.2,0.6358697
23757,23757,Ron Sutter,1991-92,28.0,10,45,80,80,17,28,45,149.0,,555,137,223,360,1027.0,80,6.91,71,366,2385,11.6,0.58915067
23758,23758,Ron Sutter,1992-93,29.0,11,46,68,68,19,27,46,106.0,,623,156,250,406,1133.0,80,6.96,77,402,2440,11.4,0.5478088
23759,23759,Ron Sutter,1993-94,30.0,12,27,59,59,12,15,27,90.0,,682,168,265,433,1223.0,84,7.25,87,443,2603,11.7,0.37687463
23760,23760,Ron Sutter,1994-95,31.0,13,40,73,73,15,25,40,108.0,,755,183,290,473,1331.0,84,6.48,76,407,2545,10.7,0.43226677
23761,23761,Ron Sutter,1995-96,32.0,14,5,27,27,1,4,5,29.0,,782,184,294,478,1360.0,48,5.97,37,209,1408,10.2,0.39118215
23762,23762,Ron Sutter,1996-97,33.0,15,12,18,18,5,7,12,34.0,,800,189,301,490,1394.0,82,6.29,74,413,2481,10.4,0.35016614
23763,23763,Ron Sutter,1997-98,34.0,16,12,78,78,5,7,12,78.0,,878,194,308,502,1472.0,82,5.83,55,336,2444,9.8,0.20211154
23764,23764,Ron Sutter,1998-99,35.0,17,9,57,57,2,7,9,57.0,,935,196,315,511,1529.0,82,5.28,57,380,2242,9.6,0.16936028
23765,23765,Ron Sutter,1999-00,36.0,18,9,59,59,3,6,9,67.0,584.0,994,199,321,520,1596.0,82,5.27,57,359,2285,9.4,0.18030089
23766,23766,Ron Sutter,2000-01,37.0,19,11,78,78,5,6,11,68.0,746.0,1072,204,327,531,1664.0,82,5.49,53,331,2294,9.8,0.18134439
23767,23767,Ron Sutter,2001-02,38.0,20,4,21,21,1,3,4,16.0,248.0,1093,205,330,535,1680.0,82,5.51,63,376,2272,9.9,0.22915539
23768,23768,Ron Talakoski,1987-88,25.0,2,0,3,3,0,0,0,1.0,,3,0,0,0,1.0,80,7.34,72,344,2400,12.2,0.21146128
23769,23769,Ron Talakoski,1988-89,26.0,3,1,6,6,0,1,1,6.0,,9,0,1,1,7.0,80,7.43,89,437,2435,12.2,0.20585942
23770,23770,Ron Wilson,1980-81,24.0,2,57,79,79,21,36,57,176.0,,79,21,36,57,176.0,80,7.03,61,280,2352,12.0,0.72641385
23771,23771,Ron Wilson,1981-82,25.0,3,51,77,77,18,33,51,192.0,,156,39,69,108,368.0,80,7.69,77,340,2441,12.6,0.6106877
23772,23772,Ron Wilson,1982-83,26.0,4,16,39,39,3,13,16,53.0,,195,42,82,124,421.0,80,8.03,73,320,2489,12.9,0.4784208
23773,23773,Ron Wilson,1983-84,27.0,5,9,12,12,6,3,9,20.0,,207,48,85,133,441.0,80,7.73,71,310,2444,12.7,0.5069165
23774,23774,Ron Wilson,1984-85,28.0,6,15,51,51,3,12,15,51.0,,258,51,97,148,492.0,80,7.89,74,336,2448,12.9,0.34092125
23775,23775,Ron Wilson,1985-86,29.0,7,19,74,74,10,9,19,65.0,,332,61,106,167,557.0,80,7.77,71,321,2447,12.7,0.3466007
23776,23776,Ron Wilson,1986-87,30.0,8,13,54,54,6,7,13,64.0,,386,67,113,180,621.0,80,7.94,82,370,2484,12.8,0.32783133
23777,23777,Ron Wilson,1987-88,31.0,9,16,80,80,3,13,16,75.0,,466,70,126,196,696.0,80,7.34,72,344,2400,12.2,0.26341838
23778,23778,Ron Wilson,1988-89,32.0,10,13,69,69,5,8,13,80.0,,535,75,134,209,776.0,80,7.43,89,437,2435,12.2,0.3003198
23779,23779,Ron Wilson,1990-91,34.0,11,20,33,33,3,17,20,40.0,,568,78,151,229,816.0,80,7.37,76,367,2421,12.2,0.39981407
23780,23780,Ron Wilson,1991-92,35.0,12,37,73,73,10,27,37,101.0,,641,88,178,266,917.0,80,6.91,71,366,2385,11.6,0.39536107
23781,23781,Ron Wilson,1992-93,36.0,13,29,64,64,12,17,29,100.0,,705,100,195,295,1017.0,80,6.96,77,402,2440,11.4,0.32781723
23782,23782,Ron Wilson,1993-94,37.0,14,19,78,78,8,11,19,75.0,,783,108,206,314,1092.0,84,7.25,87,443,2603,11.7,0.21392459
23783,23783,Ron Wilson,1994-95,38.0,15,12,48,48,2,10,12,39.0,,831,110,216,326,1131.0,84,6.48,76,407,2545,10.7,0.16770944
23784,23784,Ronald Petrovicky,2001-02,24.0,2,9,30,30,4,5,9,30.0,346.0,30,4,5,9,30.0,82,5.51,63,376,2272,9.9,0.24766523
23785,23785,Ronald Petrovicky,2002-03,25.0,3,12,77,77,5,7,12,78.0,900.0,107,9,12,21,108.0,82,5.24,53,338,2262,9.5,0.21203163
23786,23786,Ronald Petrovicky,2003-04,26.0,4,14,66,66,5,9,14,65.0,820.0,173,14,21,35,173.0,82,5.31,60,363,2326,9.4,0.2013517
23787,23787,Ronald Petrovicky,2004-05,27.0,5,31,78,78,16,15,31,102.0,1113.0,251,30,36,66,275.0,82,5.14,57,348,2300,9.2,0.45692036
23788,23788,Ronald Petrovicky,2006-07,29.0,6,20,60,60,8,12,20,70.0,713.0,311,38,48,86,345.0,82,6.05,85,480,2458,10.1,0.25656185
23789,23789,Ronald Petrovicky,2007-08,30.0,7,6,31,31,3,3,6,27.0,259.0,342,41,51,92,372.0,82,5.76,70,398,2426,9.7,0.21577838
23790,23790,Ronalds Kenins,2015-16,24.0,2,12,30,30,4,8,12,38.0,368.0,30,4,8,12,38.0,82,5.32,47,251,2453,8.9,0.25009137
23791,23791,Ronalds Kenins,2016-17,25.0,3,0,8,8,0,0,0,6.0,91.0,38,4,8,12,44.0,82,5.34,48,255,2438,9.0,0.15802169
23792,23792,Ronnie Sundin,1998-99,28.0,2,0,1,1,0,0,0,0.0,,1,0,0,0,0.0,82,5.28,57,380,2242,9.6,0.14665735
23793,23793,Roope Hintz,2019-20,23.0,2,22,58,58,9,13,22,99.0,815.0,58,9,13,22,99.0,82,5.96,47,239,2579,9.5,0.38724506
23794,23794,Roope Hintz,2020-21,24.0,3,33,60,60,19,14,33,120.0,885.0,118,28,27,55,219.0,70,5.96,42,208,2192,9.5,0.49812576
23795,23795,Rory Fitzpatrick,1996-97,22.0,2,2,42,42,0,2,2,31.0,,42,0,2,2,31.0,82,6.29,74,413,2481,10.4,0.13741589
23796,23796,Rory Fitzpatrick,1997-98,23.0,3,1,8,8,0,1,1,6.0,,50,0,3,3,37.0,82,5.83,55,336,2444,9.8,0.16405702
23797,23797,Rory Fitzpatrick,1999-00,25.0,4,0,1,1,0,0,0,0.0,5.0,51,0,3,3,37.0,82,5.27,57,359,2285,9.4,0.1349391
23798,23798,Rory Fitzpatrick,2001-02,27.0,5,0,2,2,0,0,0,0.0,20.0,53,0,3,3,37.0,82,5.51,63,376,2272,9.9,0.11119476
23799,23799,Rory Fitzpatrick,2002-03,28.0,6,0,5,5,0,0,0,2.0,60.0,58,0,3,3,39.0,82,5.24,53,338,2262,9.5,0.12100664
23800,23800,Rory Fitzpatrick,2003-04,29.0,7,4,36,36,1,3,4,29.0,613.0,94,1,6,7,68.0,82,5.31,60,363,2326,9.4,0.13681656
23801,23801,Rory Fitzpatrick,2004-05,30.0,8,11,60,60,4,7,11,78.0,1142.0,154,5,13,18,146.0,82,5.14,57,348,2300,9.2,0.2011883
23802,23802,Rory Fitzpatrick,2006-07,32.0,9,9,56,56,4,5,9,45.0,916.0,210,9,18,27,191.0,82,6.05,85,480,2458,10.1,0.12718377
23803,23803,Rory Fitzpatrick,2007-08,33.0,10,7,58,58,1,6,7,41.0,817.0,268,10,24,34,232.0,82,5.76,70,398,2426,9.7,0.12407872
23804,23804,Rory Fitzpatrick,2008-09,34.0,11,1,19,19,0,1,1,10.0,242.0,287,10,25,35,242.0,82,5.44,62,351,2383,9.4,0.07509717
23805,23805,Ross Cory,1980-81,23.0,2,11,46,46,2,9,11,47.0,,46,2,9,11,47.0,80,7.03,61,280,2352,12.0,0.28106266
23806,23806,Ross Cory,1981-82,24.0,3,1,5,5,0,1,1,1.0,,51,2,10,12,48.0,80,7.69,77,340,2441,12.6,0.20889437
23807,23807,Ross Fitzpatrick,1983-84,23.0,2,0,1,1,0,0,0,3.0,,1,0,0,0,3.0,80,7.73,71,310,2444,12.7,0.22910526
23808,23808,Ross Fitzpatrick,1984-85,24.0,3,6,12,12,4,2,6,21.0,,13,4,2,6,24.0,80,7.89,74,336,2448,12.9,0.3407116
23809,23809,Ross Fitzpatrick,1985-86,25.0,4,1,5,5,1,0,1,10.0,,18,5,2,7,34.0,80,7.77,71,321,2447,12.7,0.22727466
23810,23810,Ross Fitzpatrick,1986-87,26.0,5,0,2,2,0,0,0,0.0,,20,5,2,7,34.0,80,7.94,82,370,2484,12.8,0.194395
23811,23811,Ross Johnston,2016-17,22.0,2,0,1,1,0,0,0,0.0,16.0,1,0,0,0,0.0,82,5.34,48,255,2438,9.0,0.15903813
23812,23812,Ross Johnston,2018-19,24.0,3,6,24,24,3,3,6,19.0,224.0,25,3,3,6,19.0,82,5.86,50,250,2620,9.2,0.21194679
23813,23813,Ross Johnston,2019-20,25.0,4,4,17,17,1,3,4,12.0,135.0,42,4,6,10,31.0,82,5.96,47,239,2579,9.5,0.1942837
23814,23814,Ross Johnston,2020-21,26.0,5,4,32,32,3,1,4,16.0,256.0,74,7,7,14,47.0,70,5.96,42,208,2192,9.5,0.205775
23815,23815,Ross Lupaschuk,2003-04,23.0,2,0,3,3,0,0,0,3.0,49.0,3,0,0,0,3.0,82,5.31,60,363,2326,9.4,0.17814761
23816,23816,Ross Yates,1984-85,25.0,2,2,7,7,1,1,2,6.0,,7,1,1,2,6.0,80,7.89,74,336,2448,12.9,0.27695894
23817,23817,Rostislav Klesla,2001-02,19.0,2,2,8,8,2,0,2,10.0,147.0,8,2,0,2,10.0,82,5.51,63,376,2272,9.9,0.24590233
23818,23818,Rostislav Klesla,2002-03,20.0,3,16,75,75,8,8,16,102.0,1415.0,83,10,8,18,112.0,82,5.24,53,338,2262,9.5,0.29754576
23819,23819,Rostislav Klesla,2003-04,21.0,4,16,72,72,2,14,16,89.0,1350.0,155,12,22,34,201.0,82,5.31,60,363,2326,9.4,0.30895376
23820,23820,Rostislav Klesla,2004-05,22.0,5,13,47,47,2,11,13,74.0,861.0,202,14,33,47,275.0,82,5.14,57,348,2300,9.2,0.36973503
23821,23821,Rostislav Klesla,2006-07,24.0,6,19,51,51,6,13,19,84.0,1094.0,253,20,46,66,359.0,82,6.05,85,480,2458,10.1,0.38381007
23822,23822,Rostislav Klesla,2007-08,25.0,7,22,75,75,9,13,22,159.0,1718.0,328,29,59,88,518.0,82,5.76,70,398,2426,9.7,0.29770923
23823,23823,Rostislav Klesla,2008-09,26.0,8,18,82,82,6,12,18,130.0,1903.0,410,35,71,106,648.0,82,5.44,62,351,2383,9.4,0.29750007
23824,23824,Rostislav Klesla,2009-10,27.0,9,9,34,34,1,8,9,30.0,713.0,444,36,79,115,678.0,82,5.7,65,341,2477,9.4,0.21530807
23825,23825,Rostislav Klesla,2010-11,28.0,10,8,26,26,2,6,8,24.0,523.0,470,38,85,123,702.0,82,5.53,56,304,2486,9.1,0.23388547
23826,23826,Rostislav Klesla,2011-12,29.0,11,11,61,61,4,7,11,67.0,1164.0,531,42,92,134,769.0,82,5.46,52,291,2492,9.0,0.18539467
23827,23827,Rostislav Klesla,2012-13,30.0,12,13,65,65,3,10,13,87.0,1258.0,596,45,102,147,856.0,82,5.32,47,271,2439,8.9,0.17749935
23828,23828,Rostislav Klesla,2013-14,31.0,13,8,38,38,2,6,8,44.0,670.0,634,47,108,155,900.0,48,5.31,29,160,1399,9.1,0.17947346
23829,23829,Rostislav Klesla,2014-15,32.0,14,4,25,25,1,3,4,22.0,388.0,659,48,111,159,922.0,82,5.34,48,269,2463,8.9,0.15919784
23830,23830,Rostislav Olesz,2006-07,21.0,2,21,59,59,8,13,21,105.0,877.0,59,8,13,21,105.0,82,6.05,85,480,2458,10.1,0.3910848
23831,23831,Rostislav Olesz,2007-08,22.0,3,30,75,75,11,19,30,164.0,1163.0,134,19,32,51,269.0,82,5.76,70,398,2426,9.7,0.44707227
23832,23832,Rostislav Olesz,2008-09,23.0,4,26,56,56,14,12,26,139.0,956.0,190,33,44,77,408.0,82,5.44,62,351,2383,9.4,0.55145097
23833,23833,Rostislav Olesz,2009-10,24.0,5,9,37,37,4,5,9,69.0,488.0,227,37,49,86,477.0,82,5.7,65,341,2477,9.4,0.3235677
23834,23834,Rostislav Olesz,2010-11,25.0,6,29,78,78,14,15,29,178.0,1201.0,305,51,64,115,655.0,82,5.53,56,304,2486,9.1,0.4240758
23835,23835,Rostislav Olesz,2011-12,26.0,7,17,44,44,6,11,17,71.0,611.0,349,57,75,132,726.0,82,5.46,52,291,2492,9.0,0.34473854
23836,23836,Rostislav Olesz,2012-13,27.0,8,0,6,6,0,0,0,6.0,55.0,355,57,75,132,732.0,82,5.32,47,271,2439,8.9,0.23222801
23837,23837,Rostislav Olesz,2014-15,29.0,9,2,10,10,0,2,2,9.0,114.0,365,57,77,134,741.0,82,5.34,48,269,2463,8.9,0.24445617
23838,23838,Rourke Chartier,2019-20,23.0,2,1,13,13,1,0,1,19.0,122.0,13,1,0,1,19.0,82,5.96,47,239,2579,9.5,0.23199058
23839,23839,Roy Mitchell,1993-94,24.0,2,0,3,3,0,0,0,0.0,,3,0,0,0,0.0,84,7.25,87,443,2603,11.7,0.15629503
23840,23840,Roy Sommer,1981-82,24.0,2,1,3,3,1,0,1,1.0,,3,1,0,1,1.0,80,7.69,77,340,2441,12.6,0.26882553
23841,23841,Rudolfs Balcers,2019-20,22.0,2,14,36,36,5,9,14,48.0,445.0,36,5,9,14,48.0,82,5.96,47,239,2579,9.5,0.33164978
23842,23842,Rudolfs Balcers,2020-21,23.0,3,3,15,15,1,2,3,23.0,182.0,51,6,11,17,71.0,70,5.96,42,208,2192,9.5,0.29827777
23843,23843,Rudy Poeschek,1988-89,22.0,2,0,1,1,0,0,0,1.0,,1,0,0,0,1.0,80,7.43,89,437,2435,12.2,0.21754727
23844,23844,Rudy Poeschek,1989-90,23.0,3,2,52,52,0,2,2,17.0,,53,0,2,2,18.0,80,7.48,85,403,2430,12.3,0.13910934
23845,23845,Rudy Poeschek,1990-91,24.0,4,0,15,15,0,0,0,1.0,,68,0,2,2,19.0,80,7.37,76,367,2421,12.2,0.15229097
23846,23846,Rudy Poeschek,1991-92,25.0,5,0,1,1,0,0,0,0.0,,69,0,2,2,19.0,80,6.91,71,366,2385,11.6,0.1359593
23847,23847,Rudy Poeschek,1992-93,26.0,6,0,4,4,0,0,0,1.0,,73,0,2,2,20.0,80,6.96,77,402,2440,11.4,0.14724556
23848,23848,Rudy Poeschek,1994-95,28.0,7,9,71,71,3,6,9,46.0,,144,3,8,11,66.0,84,6.48,76,407,2545,10.7,0.12886098
23849,23849,Rudy Poeschek,1995-96,29.0,8,2,25,25,1,1,2,14.0,,169,4,9,13,80.0,48,5.97,37,209,1408,10.2,0.09742108
23850,23850,Rudy Poeschek,1996-97,30.0,9,4,57,57,1,3,4,36.0,,226,5,12,17,116.0,82,6.29,74,413,2481,10.4,0.10616118
23851,23851,Rudy Poeschek,1997-98,31.0,10,6,60,60,0,6,6,30.0,,286,5,18,23,146.0,82,5.83,55,336,2444,9.8,0.07707727
23852,23852,Rudy Poeschek,1998-99,32.0,11,8,50,50,1,7,8,29.0,,336,6,25,31,175.0,82,5.28,57,380,2242,9.6,0.086351454
23853,23853,Rudy Poeschek,1999-00,33.0,12,0,16,16,0,0,0,8.0,164.0,352,6,25,31,183.0,82,5.27,57,359,2285,9.4,0.095641255
23854,23854,Rudy Poeschek,2000-01,34.0,13,0,12,12,0,0,0,8.0,135.0,364,6,25,31,191.0,82,5.49,53,331,2294,9.8,0.09451452
23855,23855,Rumun Ndur,1997-98,22.0,2,0,2,2,0,0,0,0.0,,2,0,0,0,0.0,82,5.83,55,336,2444,9.8,0.157395
23856,23856,Rumun Ndur,1998-99,23.0,3,0,1,1,0,0,0,0.0,,3,0,0,0,0.0,82,5.28,57,380,2242,9.6,0.1538156
23857,23857,Rumun Ndur,1999-00,24.0,4,4,39,39,1,3,4,22.0,459.0,42,1,3,4,22.0,82,5.27,57,359,2285,9.4,0.11684576
23858,23858,Rumun Ndur,2000-01,25.0,5,1,27,27,1,0,1,6.0,356.0,69,2,3,5,28.0,82,5.49,53,331,2294,9.8,0.09615177
23859,23859,Ruslan Batyrshin,1996-97,21.0,2,0,2,2,0,0,0,0.0,,2,0,0,0,0.0,82,6.29,74,413,2481,10.4,0.18428248
23860,23860,Ruslan Fedotenko,2001-02,23.0,2,36,74,74,16,20,36,119.0,1082.0,74,16,20,36,119.0,82,5.51,63,376,2272,9.9,0.4809577
23861,23861,Ruslan Fedotenko,2002-03,24.0,3,26,78,78,17,9,26,121.0,1087.0,152,33,29,62,240.0,82,5.24,53,338,2262,9.5,0.38681602
23862,23862,Ruslan Fedotenko,2003-04,25.0,4,32,76,76,19,13,32,114.0,1217.0,228,52,42,94,354.0,82,5.31,60,363,2326,9.4,0.45811704
23863,23863,Ruslan Fedotenko,2004-05,26.0,5,39,77,77,17,22,39,116.0,1128.0,305,69,64,133,470.0,82,5.14,57,348,2300,9.2,0.55300826
23864,23864,Ruslan Fedotenko,2006-07,28.0,6,41,80,80,26,15,41,164.0,1228.0,385,95,79,174,634.0,82,6.05,85,480,2458,10.1,0.51563334
23865,23865,Ruslan Fedotenko,2007-08,29.0,7,32,80,80,12,20,32,154.0,1301.0,465,107,99,206,788.0,82,5.76,70,398,2426,9.7,0.43258265
23866,23866,Ruslan Fedotenko,2008-09,30.0,8,33,67,67,16,17,33,121.0,1119.0,532,123,116,239,909.0,82,5.44,62,351,2383,9.4,0.42060202
23867,23867,Ruslan Fedotenko,2009-10,31.0,9,39,65,65,16,23,39,117.0,917.0,597,139,139,278,1026.0,82,5.7,65,341,2477,9.4,0.4743177
23868,23868,Ruslan Fedotenko,2010-11,32.0,10,30,80,80,11,19,30,158.0,1172.0,677,150,158,308,1184.0,82,5.53,56,304,2486,9.1,0.34736276
23869,23869,Ruslan Fedotenko,2011-12,33.0,11,25,66,66,10,15,25,120.0,990.0,743,160,173,333,1304.0,82,5.46,52,291,2492,9.0,0.3021627
23870,23870,Ruslan Fedotenko,2012-13,34.0,12,20,73,73,9,11,20,94.0,993.0,816,169,184,353,1398.0,82,5.32,47,271,2439,8.9,0.26488137
23871,23871,Ruslan Fedotenko,2013-14,35.0,13,13,47,47,4,9,13,43.0,591.0,863,173,193,366,1441.0,48,5.31,29,160,1399,9.1,0.2492258
23872,23872,Ruslan Salei,1997-98,23.0,2,1,30,30,0,1,1,14.0,,30,0,1,1,14.0,82,5.83,55,336,2444,9.8,0.13039735
23873,23873,Ruslan Salei,1998-99,24.0,3,15,66,66,5,10,15,104.0,,96,5,11,16,118.0,82,5.28,57,380,2242,9.6,0.26413715
23874,23874,Ruslan Salei,1999-00,25.0,4,16,74,74,2,14,16,123.0,1632.0,170,7,25,32,241.0,82,5.27,57,359,2285,9.4,0.24774268
23875,23875,Ruslan Salei,2000-01,26.0,5,10,71,71,5,5,10,116.0,1444.0,241,12,30,42,357.0,82,5.49,53,331,2294,9.8,0.20961487
23876,23876,Ruslan Salei,2001-02,27.0,6,6,50,50,1,5,6,73.0,1033.0,291,13,35,48,430.0,82,5.51,63,376,2272,9.9,0.17560902
23877,23877,Ruslan Salei,2002-03,28.0,7,11,82,82,4,7,11,96.0,1757.0,373,17,42,59,526.0,82,5.24,53,338,2262,9.5,0.19460511
23878,23878,Ruslan Salei,2003-04,29.0,8,12,61,61,4,8,12,93.0,1335.0,434,21,50,71,619.0,82,5.31,60,363,2326,9.4,0.21130064
23879,23879,Ruslan Salei,2004-05,30.0,9,15,82,82,4,11,15,145.0,1943.0,516,25,61,86,764.0,82,5.14,57,348,2300,9.2,0.24962848
23880,23880,Ruslan Salei,2006-07,32.0,10,19,78,78,1,18,19,108.0,1756.0,594,26,79,105,872.0,82,6.05,85,480,2458,10.1,0.22582084
23881,23881,Ruslan Salei,2007-08,33.0,11,32,82,82,6,26,32,148.0,1913.0,676,32,105,137,1020.0,82,5.76,70,398,2426,9.7,0.34769374
23882,23882,Ruslan Salei,2008-09,34.0,12,30,82,82,6,24,30,111.0,1841.0,758,38,129,167,1131.0,82,5.44,62,351,2383,9.4,0.31109858
23883,23883,Ruslan Salei,2009-10,35.0,13,21,70,70,4,17,21,93.0,1477.0,828,42,146,188,1224.0,82,5.7,65,341,2477,9.4,0.24624166
23884,23884,Ruslan Salei,2010-11,36.0,14,6,14,14,1,5,6,22.0,263.0,842,43,151,194,1246.0,82,5.53,56,304,2486,9.1,0.19596851
23885,23885,Ruslan Salei,2011-12,37.0,15,10,75,75,2,8,10,75.0,1347.0,917,45,159,204,1321.0,82,5.46,52,291,2492,9.0,0.13951981
23886,23886,Russ Adam,1983-84,22.0,2,3,8,8,1,2,3,4.0,,8,1,2,3,4.0,80,7.73,71,310,2444,12.7,0.30456096
23887,23887,Russ Courtnall,1984-85,19.0,2,12,14,14,3,9,12,30.0,,14,3,9,12,30.0,80,7.89,74,336,2448,12.9,0.4758437
23888,23888,Russ Courtnall,1985-86,20.0,3,22,69,69,12,10,22,119.0,,83,15,19,34,149.0,80,7.77,71,321,2447,12.7,0.44501832
23889,23889,Russ Courtnall,1986-87,21.0,4,60,73,73,22,38,60,204.0,,156,37,57,94,353.0,80,7.94,82,370,2484,12.8,0.8140178
23890,23890,Russ Courtnall,1987-88,22.0,5,73,79,79,29,44,73,282.0,,235,66,101,167,635.0,80,7.34,72,344,2400,12.2,0.9337228
23891,23891,Russ Courtnall,1988-89,23.0,6,49,65,65,23,26,49,212.0,,300,89,127,216,847.0,80,7.43,89,437,2435,12.2,0.77887625
23892,23892,Russ Courtnall,1989-90,24.0,7,41,73,73,23,18,41,147.0,,373,112,145,257,994.0,80,7.48,85,403,2430,12.3,0.595937
23893,23893,Russ Courtnall,1990-91,25.0,8,59,80,80,27,32,59,294.0,,453,139,177,316,1288.0,80,7.37,76,367,2421,12.2,0.7450098
23894,23894,Russ Courtnall,1991-92,26.0,9,76,79,79,26,50,76,279.0,,532,165,227,392,1567.0,80,6.91,71,366,2385,11.6,0.9327787
23895,23895,Russ Courtnall,1992-93,27.0,10,21,27,27,7,14,21,63.0,,559,172,241,413,1630.0,80,6.96,77,402,2440,11.4,0.6716146
23896,23896,Russ Courtnall,1993-94,28.0,11,79,84,84,36,43,79,294.0,,643,208,284,492,1924.0,84,7.25,87,443,2603,11.7,0.78677416
23897,23897,Russ Courtnall,1994-95,29.0,12,80,84,84,23,57,80,231.0,,727,231,341,572,2155.0,84,6.48,76,407,2545,10.7,0.7672603
23898,23898,Russ Courtnall,1995-96,30.0,13,35,45,45,11,24,35,132.0,,772,242,365,607,2287.0,48,5.97,37,209,1408,10.2,0.7682967
23899,23899,Russ Courtnall,1996-97,31.0,14,65,81,81,26,39,65,205.0,,853,268,404,672,2492.0,82,6.29,74,413,2481,10.4,0.7055281
23900,23900,Russ Courtnall,1997-98,32.0,15,35,61,61,11,24,35,125.0,,914,279,428,707,2617.0,82,5.83,55,336,2444,9.8,0.45212907
23901,23901,Russ Courtnall,1998-99,33.0,16,18,58,58,12,6,18,97.0,,972,291,434,725,2714.0,82,5.28,57,380,2242,9.6,0.34199837
23902,23902,Russ Courtnall,1999-00,34.0,17,19,57,57,6,13,19,77.0,858.0,1029,297,447,744,2791.0,82,5.27,57,359,2285,9.4,0.32508606
23903,23903,Russell Romaniuk,1992-93,22.0,2,8,27,27,3,5,8,32.0,,27,3,5,8,32.0,80,6.96,77,402,2440,11.4,0.34709823
23904,23904,Russell Romaniuk,1993-94,23.0,3,4,28,28,3,1,4,20.0,,55,6,6,12,52.0,84,7.25,87,443,2603,11.7,0.26413417
23905,23905,Russell Romaniuk,1994-95,24.0,4,12,24,24,4,8,12,36.0,,79,10,14,24,88.0,84,6.48,76,407,2545,10.7,0.2894622
23906,23906,Russell Romaniuk,1995-96,25.0,5,0,6,6,0,0,0,3.0,,85,10,14,24,91.0,48,5.97,37,209,1408,10.2,0.19971874
23907,23907,Russell Romaniuk,1996-97,26.0,6,3,17,17,3,0,3,13.0,,102,13,14,27,104.0,82,6.29,74,413,2481,10.4,0.24910858
23908,23908,Rusty Fitzgerald,1995-96,23.0,2,1,4,4,1,0,1,5.0,,4,1,0,1,5.0,48,5.97,37,209,1408,10.2,0.25043434
23909,23909,Rusty Fitzgerald,1996-97,24.0,3,3,21,21,1,2,3,15.0,,25,2,2,4,20.0,82,6.29,74,413,2481,10.4,0.15682304
23910,23910,Ryan Barnes,2004-05,25.0,2,0,2,2,0,0,0,0.0,5.0,2,0,0,0,0.0,82,5.14,57,348,2300,9.2,0.15451938
23911,23911,Ryan Bast,1999-00,24.0,2,1,2,2,0,1,1,1.0,27.0,2,0,1,1,1.0,82,5.27,57,359,2285,9.4,0.19811225
23912,23912,Ryan Bayda,2003-04,23.0,2,14,25,25,4,10,14,49.0,431.0,25,4,10,14,49.0,82,5.31,60,363,2326,9.4,0.33993462
23913,23913,Ryan Bayda,2004-05,24.0,3,6,44,44,3,3,6,65.0,482.0,69,7,13,20,114.0,82,5.14,57,348,2300,9.2,0.24101102
23914,23914,Ryan Bayda,2007-08,27.0,4,2,9,9,1,1,2,10.0,78.0,78,8,14,22,124.0,82,5.76,70,398,2426,9.7,0.20425943
23915,23915,Ryan Bayda,2008-09,28.0,5,6,31,31,3,3,6,58.0,391.0,109,11,17,28,182.0,82,5.44,62,351,2383,9.4,0.23063803
23916,23916,Ryan Bayda,2009-10,29.0,6,12,70,70,5,7,12,62.0,732.0,179,16,24,40,244.0,82,5.7,65,341,2477,9.4,0.17291859
23917,23917,Ryan Bonni,2000-01,21.0,2,0,3,3,0,0,0,1.0,29.0,3,0,0,0,1.0,82,5.49,53,331,2294,9.8,0.17530924
23918,23918,Ryan Bourque,2015-16,25.0,2,0,1,1,0,0,0,1.0,12.0,1,0,0,0,1.0,82,5.32,47,251,2453,8.9,0.15772545
23919,23919,Ryan Caldwell,2006-07,25.0,2,0,2,2,0,0,0,2.0,33.0,2,0,0,0,2.0,82,6.05,85,480,2458,10.1,0.16018337
23920,23920,Ryan Caldwell,2008-09,27.0,3,0,2,2,0,0,0,1.0,12.0,4,0,0,0,3.0,82,5.44,62,351,2383,9.4,0.16454643
23921,23921,Ryan Callahan,2007-08,22.0,2,6,14,14,4,2,6,40.0,147.0,14,4,2,6,40.0,82,5.76,70,398,2426,9.7,0.31816667
23922,23922,Ryan Callahan,2008-09,23.0,3,13,52,52,8,5,13,92.0,643.0,66,12,7,19,132.0,82,5.44,62,351,2383,9.4,0.33974725
23923,23923,Ryan Callahan,2009-10,24.0,4,40,81,81,22,18,40,237.0,1382.0,147,34,25,59,369.0,82,5.7,65,341,2477,9.4,0.52328247
23924,23924,Ryan Callahan,2010-11,25.0,5,37,77,77,19,18,37,204.0,1494.0,224,53,43,96,573.0,82,5.53,56,304,2486,9.1,0.52046055
23925,23925,Ryan Callahan,2011-12,26.0,6,48,60,60,23,25,48,179.0,1194.0,284,76,68,144,752.0,82,5.46,52,291,2492,9.0,0.6970537
23926,23926,Ryan Callahan,2012-13,27.0,7,54,76,76,29,25,54,235.0,1599.0,360,105,93,198,987.0,82,5.32,47,271,2439,8.9,0.6660823
23927,23927,Ryan Callahan,2013-14,28.0,8,31,45,45,16,15,31,144.0,968.0,405,121,108,229,1131.0,48,5.31,29,160,1399,9.1,0.6811585
23928,23928,Ryan Callahan,2014-15,29.0,9,36,65,65,17,19,36,163.0,1212.0,470,138,127,265,1294.0,82,5.34,48,269,2463,8.9,0.478662
23929,23929,Ryan Callahan,2015-16,30.0,10,54,77,77,24,30,54,191.0,1366.0,547,162,157,319,1485.0,82,5.32,47,251,2453,8.9,0.6261959
23930,23930,Ryan Callahan,2016-17,31.0,11,28,73,73,10,18,28,156.0,1258.0,620,172,175,347,1641.0,82,5.34,48,255,2438,9.0,0.3484594
23931,23931,Ryan Callahan,2017-18,32.0,12,4,18,18,2,2,4,22.0,255.0,638,174,177,351,1663.0,82,5.45,47,245,2478,9.0,0.27775258
23932,23932,Ryan Callahan,2018-19,33.0,13,18,67,67,5,13,18,104.0,893.0,705,179,190,369,1767.0,82,5.86,50,250,2620,9.2,0.26673958
23933,23933,Ryan Callahan,2019-20,34.0,14,17,52,52,7,10,17,76.0,579.0,757,186,200,386,1843.0,82,5.96,47,239,2579,9.5,0.33039302
23934,23934,Ryan Carpenter,2016-17,26.0,2,0,1,1,0,0,0,0.0,7.0,1,0,0,0,0.0,82,5.34,48,255,2438,9.0,0.14306575
23935,23935,Ryan Carpenter,2017-18,27.0,3,4,11,11,2,2,4,20.0,114.0,12,2,2,4,20.0,82,5.45,47,245,2478,9.0,0.23279306
23936,23936,Ryan Carpenter,2018-19,28.0,4,15,52,52,9,6,15,85.0,655.0,64,11,8,19,105.0,82,5.86,50,250,2620,9.2,0.30023053
23937,23937,Ryan Carpenter,2019-20,29.0,5,18,68,68,5,13,18,102.0,858.0,132,16,21,37,207.0,82,5.96,47,239,2579,9.5,0.2318824
23938,23938,Ryan Carpenter,2020-21,30.0,6,15,69,69,3,12,15,80.0,971.0,201,19,33,52,287.0,70,5.96,42,208,2192,9.5,0.25382143
23939,23939,Ryan Carter,2008-09,25.0,2,8,34,34,4,4,8,56.0,356.0,34,4,4,8,56.0,82,5.44,62,351,2383,9.4,0.24680495
23940,23940,Ryan Carter,2009-10,26.0,3,9,48,48,3,6,9,40.0,437.0,82,7,10,17,96.0,82,5.7,65,341,2477,9.4,0.1841532
23941,23941,Ryan Carter,2010-11,27.0,4,9,38,38,4,5,9,38.0,374.0,120,11,15,26,134.0,82,5.53,56,304,2486,9.1,0.16993484
23942,23942,Ryan Carter,2011-12,28.0,5,9,62,62,3,6,9,63.0,621.0,182,14,21,35,197.0,82,5.46,52,291,2492,9.0,0.1452221
23943,23943,Ryan Carter,2012-13,29.0,6,8,72,72,4,4,8,50.0,745.0,254,18,25,43,247.0,82,5.32,47,271,2439,8.9,0.14788312
23944,23944,Ryan Carter,2013-14,30.0,7,15,44,44,6,9,15,63.0,574.0,298,24,34,58,310.0,48,5.31,29,160,1399,9.1,0.28762633
23945,23945,Ryan Carter,2014-15,31.0,8,10,62,62,7,3,10,69.0,702.0,360,31,37,68,379.0,82,5.34,48,269,2463,8.9,0.1727354
23946,23946,Ryan Carter,2015-16,32.0,9,13,53,53,3,10,13,47.0,535.0,413,34,47,81,426.0,82,5.32,47,251,2453,8.9,0.16900182
23947,23947,Ryan Carter,2016-17,33.0,10,12,60,60,7,5,12,62.0,668.0,473,41,52,93,488.0,82,5.34,48,255,2438,9.0,0.17489496
23948,23948,Ryan Christie,2000-01,22.0,2,0,5,5,0,0,0,1.0,12.0,5,0,0,0,1.0,82,5.49,53,331,2294,9.8,0.16294318
23949,23949,Ryan Christie,2002-03,24.0,3,0,2,2,0,0,0,0.0,12.0,7,0,0,0,1.0,82,5.24,53,338,2262,9.5,0.15384755
23950,23950,Ryan Craig,2006-07,25.0,2,28,48,48,15,13,28,81.0,737.0,48,15,13,28,81.0,82,6.05,85,480,2458,10.1,0.46234268
23951,23951,Ryan Craig,2007-08,26.0,3,27,72,72,14,13,27,130.0,1104.0,120,29,26,55,211.0,82,5.76,70,398,2426,9.7,0.38274866
23952,23952,Ryan Craig,2008-09,27.0,4,2,7,7,1,1,2,8.0,91.0,127,30,27,57,219.0,82,5.44,62,351,2383,9.4,0.21258414
23953,23953,Ryan Craig,2009-10,28.0,5,6,54,54,2,4,6,64.0,555.0,181,32,31,63,283.0,82,5.7,65,341,2477,9.4,0.19399384
23954,23954,Ryan Craig,2010-11,29.0,6,0,3,3,0,0,0,5.0,29.0,184,32,31,63,288.0,82,5.53,56,304,2486,9.1,0.1858274
23955,23955,Ryan Craig,2011-12,30.0,7,0,6,6,0,0,0,7.0,59.0,190,32,31,63,295.0,82,5.46,52,291,2492,9.0,0.1713183
23956,23956,Ryan Craig,2014-15,33.0,8,0,6,6,0,0,0,4.0,42.0,196,32,31,63,299.0,82,5.34,48,269,2463,8.9,0.15569085
23957,23957,Ryan Craig,2015-16,34.0,9,0,2,2,0,0,0,2.0,15.0,198,32,31,63,301.0,82,5.32,47,251,2453,8.9,0.16403556
23958,23958,Ryan Donato,2018-19,22.0,2,9,12,12,5,4,9,24.0,176.0,12,5,4,9,24.0,82,5.86,50,250,2620,9.2,0.35586637
23959,23959,Ryan Donato,2019-20,23.0,3,25,56,56,10,15,25,139.0,767.0,68,15,19,34,163.0,82,5.96,47,239,2579,9.5,0.4851598
23960,23960,Ryan Donato,2020-21,24.0,4,23,62,62,14,9,23,95.0,659.0,130,29,28,57,258.0,70,5.96,42,208,2192,9.5,0.37044063
23961,23961,Ryan Dzingel,2016-17,24.0,2,9,30,30,3,6,9,23.0,324.0,30,3,6,9,23.0,82,5.34,48,255,2438,9.0,0.23814583
23962,23962,Ryan Dzingel,2017-18,25.0,3,32,81,81,14,18,32,123.0,1165.0,111,17,24,41,146.0,82,5.45,47,245,2478,9.0,0.41189867
23963,23963,Ryan Dzingel,2018-19,26.0,4,41,79,79,23,18,41,136.0,1303.0,190,40,42,82,282.0,82,5.86,50,250,2620,9.2,0.4952289
23964,23964,Ryan Dzingel,2019-20,27.0,5,56,78,78,26,30,56,159.0,1312.0,268,66,72,138,441.0,82,5.96,47,239,2579,9.5,0.60537636
23965,23965,Ryan Dzingel,2020-21,28.0,6,29,64,64,8,21,29,98.0,906.0,332,74,93,167,539.0,70,5.96,42,208,2192,9.5,0.48025358
23966,23966,Ryan Ellis,2012-13,22.0,2,11,32,32,3,8,11,34.0,474.0,32,3,8,11,34.0,82,5.32,47,271,2439,8.9,0.2653013
23967,23967,Ryan Ellis,2013-14,23.0,3,6,32,32,2,4,6,48.0,524.0,64,5,12,17,82.0,48,5.31,29,160,1399,9.1,0.30021405
23968,23968,Ryan Ellis,2014-15,24.0,4,27,80,80,6,21,27,123.0,1285.0,144,11,33,44,205.0,82,5.34,48,269,2463,8.9,0.33003327
23969,23969,Ryan Ellis,2015-16,25.0,5,27,58,58,9,18,27,118.0,1101.0,202,20,51,71,323.0,82,5.32,47,251,2453,8.9,0.3934772
23970,23970,Ryan Ellis,2016-17,26.0,6,32,79,79,10,22,32,152.0,1651.0,281,30,73,103,475.0,82,5.34,48,255,2438,9.0,0.41576242
23971,23971,Ryan Ellis,2017-18,27.0,7,38,71,71,16,22,38,140.0,1701.0,352,46,95,141,615.0,82,5.45,47,245,2478,9.0,0.4758768
23972,23972,Ryan Ellis,2018-19,28.0,8,32,44,44,9,23,32,110.0,1028.0,396,55,118,173,725.0,82,5.86,50,250,2620,9.2,0.5941657
23973,23973,Ryan Ellis,2019-20,29.0,9,41,82,82,7,34,41,149.0,1969.0,478,62,152,214,874.0,82,5.96,47,239,2579,9.5,0.49030775
23974,23974,Ryan Ellis,2020-21,30.0,10,38,49,49,8,30,38,114.0,1152.0,527,70,182,252,988.0,70,5.96,42,208,2192,9.5,0.63912
23975,23975,Ryan Flinn,2002-03,22.0,2,0,10,10,0,0,0,2.0,35.0,10,0,0,0,2.0,82,5.24,53,338,2262,9.5,0.15417206
23976,23976,Ryan Flinn,2003-04,23.0,3,1,19,19,1,0,1,13.0,104.0,29,1,0,1,15.0,82,5.31,60,363,2326,9.4,0.15244702
23977,23977,Ryan Flinn,2006-07,26.0,4,0,2,2,0,0,0,0.0,1.0,31,1,0,1,15.0,82,6.05,85,480,2458,10.1,0.14862704
23978,23978,Ryan Garbutt,2012-13,27.0,2,3,20,20,2,1,3,28.0,166.0,20,2,1,3,28.0,82,5.32,47,271,2439,8.9,0.21512446
23979,23979,Ryan Garbutt,2013-14,28.0,3,10,36,36,3,7,10,59.0,357.0,56,5,8,13,87.0,48,5.31,29,160,1399,9.1,0.27069652
23980,23980,Ryan Garbutt,2014-15,29.0,4,32,75,75,17,15,32,165.0,980.0,131,22,23,45,252.0,82,5.34,48,269,2463,8.9,0.41844147
23981,23981,Ryan Garbutt,2015-16,30.0,5,25,67,67,8,17,25,143.0,909.0,198,30,40,70,395.0,82,5.32,47,251,2453,8.9,0.33069888
23982,23982,Ryan Garbutt,2016-17,31.0,6,14,80,80,7,7,14,135.0,867.0,278,37,47,84,530.0,82,5.34,48,255,2438,9.0,0.21614236
23983,23983,Ryan Garbutt,2017-18,32.0,7,3,27,27,2,1,3,26.0,247.0,305,39,48,87,556.0,82,5.45,47,245,2478,9.0,0.19131103
23984,23984,Ryan Getzlaf,2006-07,21.0,2,39,57,57,14,25,39,116.0,717.0,57,14,25,39,116.0,82,6.05,85,480,2458,10.1,0.6505346
23985,23985,Ryan Getzlaf,2007-08,22.0,3,58,82,82,25,33,58,203.0,1235.0,139,39,58,97,319.0,82,5.76,70,398,2426,9.7,0.7727346
23986,23986,Ryan Getzlaf,2008-09,23.0,4,82,77,77,24,58,82,185.0,1513.0,216,63,116,179,504.0,82,5.44,62,351,2383,9.4,0.9680815
23987,23987,Ryan Getzlaf,2009-10,24.0,5,91,81,81,25,66,91,227.0,1631.0,297,88,182,270,731.0,82,5.7,65,341,2477,9.4,1.0298126
23988,23988,Ryan Getzlaf,2010-11,25.0,6,69,66,66,19,50,69,149.0,1430.0,363,107,232,339,880.0,82,5.53,56,304,2486,9.1,0.9453728
23989,23989,Ryan Getzlaf,2011-12,26.0,7,76,67,67,19,57,76,117.0,1464.0,430,126,289,415,997.0,82,5.46,52,291,2492,9.0,0.8924519
23990,23990,Ryan Getzlaf,2012-13,27.0,8,57,82,82,11,46,57,185.0,1771.0,512,137,335,472,1182.0,82,5.32,47,271,2439,8.9,0.7766365
23991,23991,Ryan Getzlaf,2013-14,28.0,9,49,44,44,15,34,49,99.0,889.0,556,152,369,521,1281.0,48,5.31,29,160,1399,9.1,1.0330415
23992,23992,Ryan Getzlaf,2014-15,29.0,10,87,77,77,31,56,87,204.0,1639.0,633,183,425,608,1485.0,82,5.34,48,269,2463,8.9,1.0228857
23993,23993,Ryan Getzlaf,2015-16,30.0,11,70,77,77,25,45,70,191.0,1548.0,710,208,470,678,1676.0,82,5.32,47,251,2453,8.9,0.8398051
23994,23994,Ryan Getzlaf,2016-17,31.0,12,63,77,77,13,50,63,178.0,1502.0,787,221,520,741,1854.0,82,5.34,48,255,2438,9.0,0.79443896
23995,23995,Ryan Getzlaf,2017-18,32.0,13,73,74,74,15,58,73,138.0,1559.0,861,236,578,814,1992.0,82,5.45,47,245,2478,9.0,0.85963035
23996,23996,Ryan Getzlaf,2018-19,33.0,14,61,56,56,11,50,61,117.0,1200.0,917,247,628,875,2109.0,82,5.86,50,250,2620,9.2,0.81966686
23997,23997,Ryan Getzlaf,2019-20,34.0,15,48,67,67,14,34,48,133.0,1304.0,984,261,662,923,2242.0,82,5.96,47,239,2579,9.5,0.61652553
23998,23998,Ryan Getzlaf,2020-21,35.0,16,42,69,69,13,29,42,143.0,1292.0,1053,274,691,965,2385.0,70,5.96,42,208,2192,9.5,0.5798358
23999,23999,Ryan Graves,2019-20,24.0,2,5,26,26,3,2,5,26.0,289.0,26,3,2,5,26.0,82,5.96,47,239,2579,9.5,0.23497385
24000,24000,Ryan Graves,2020-21,25.0,3,26,69,69,9,17,26,134.0,1307.0,95,12,19,31,160.0,70,5.96,42,208,2192,9.5,0.40005362
24001,24001,Ryan Hamilton,2012-13,27.0,2,1,2,2,0,1,1,1.0,26.0,2,0,1,1,1.0,82,5.32,47,271,2439,8.9,0.16775265
24002,24002,Ryan Hamilton,2013-14,28.0,3,2,10,10,0,2,2,6.0,109.0,12,0,3,3,7.0,48,5.31,29,160,1399,9.1,0.1904229
24003,24003,Ryan Hamilton,2014-15,29.0,4,0,2,2,0,0,0,0.0,20.0,14,0,3,3,7.0,82,5.34,48,269,2463,8.9,0.1402607
24004,24004,Ryan Hamilton,2015-16,30.0,5,2,16,16,1,1,2,12.0,211.0,30,1,4,5,19.0,82,5.32,47,251,2453,8.9,0.14937884
24005,24005,Ryan Hartman,2015-16,21.0,2,0,5,5,0,0,0,8.0,41.0,5,0,0,0,8.0,82,5.32,47,251,2453,8.9,0.22231701
24006,24006,Ryan Hartman,2016-17,22.0,3,1,3,3,0,1,1,3.0,28.0,8,0,1,1,11.0,82,5.34,48,255,2438,9.0,0.20525551
24007,24007,Ryan Hartman,2017-18,23.0,4,31,76,76,19,12,31,170.0,970.0,84,19,13,32,181.0,82,5.45,47,245,2478,9.0,0.48028177
24008,24008,Ryan Hartman,2018-19,24.0,5,31,78,78,11,20,31,129.0,1019.0,162,30,33,63,310.0,82,5.86,50,250,2620,9.2,0.39597675
24009,24009,Ryan Hartman,2019-20,25.0,6,26,83,83,12,14,26,145.0,1089.0,245,42,47,89,455.0,82,5.96,47,239,2579,9.5,0.36531425
24010,24010,Ryan Hartman,2020-21,26.0,7,20,69,69,9,11,20,114.0,846.0,314,51,58,109,569.0,70,5.96,42,208,2192,9.5,0.31522965
24011,24011,Ryan Hollweg,2006-07,23.0,2,5,52,52,2,3,5,32.0,377.0,52,2,3,5,32.0,82,6.05,85,480,2458,10.1,0.16367602
24012,24012,Ryan Hollweg,2007-08,24.0,3,3,78,78,1,2,3,63.0,643.0,130,3,5,8,95.0,82,5.76,70,398,2426,9.7,0.14180213
24013,24013,Ryan Hollweg,2008-09,25.0,4,4,70,70,2,2,4,59.0,581.0,200,5,7,12,154.0,82,5.44,62,351,2383,9.4,0.15836075
24014,24014,Ryan Hollweg,2009-10,26.0,5,2,25,25,0,2,2,12.0,162.0,225,5,9,14,166.0,82,5.7,65,341,2477,9.4,0.11381632
24015,24015,Ryan Hollweg,2011-12,28.0,6,0,3,3,0,0,0,0.0,20.0,228,5,9,14,166.0,82,5.46,52,291,2492,9.0,0.127085
24016,24016,Ryan Hughes,1996-97,25.0,2,0,3,3,0,0,0,2.0,,3,0,0,0,2.0,82,6.29,74,413,2481,10.4,0.15552464
24017,24017,Ryan Huska,1998-99,23.0,2,0,1,1,0,0,0,0.0,,1,0,0,0,0.0,82,5.28,57,380,2242,9.6,0.15889817
24018,24018,Ryan Jardine,2002-03,22.0,2,2,8,8,0,2,2,6.0,71.0,8,0,2,2,6.0,82,5.24,53,338,2262,9.5,0.1960339
24019,24019,Ryan Johansen,2012-13,20.0,2,21,67,67,9,12,21,99.0,853.0,67,9,12,21,99.0,82,5.32,47,271,2439,8.9,0.3587109
24020,24020,Ryan Johansen,2013-14,21.0,3,12,40,40,5,7,12,84.0,643.0,107,14,19,33,183.0,48,5.31,29,160,1399,9.1,0.4076301
24021,24021,Ryan Johansen,2014-15,22.0,4,63,82,82,33,30,63,237.0,1447.0,189,47,49,96,420.0,82,5.34,48,269,2463,8.9,0.7626575
24022,24022,Ryan Johansen,2015-16,23.0,5,71,82,82,26,45,71,202.0,1599.0,271,73,94,167,622.0,82,5.32,47,251,2453,8.9,0.89264536
24023,24023,Ryan Johansen,2016-17,24.0,6,60,80,80,14,46,60,185.0,1405.0,351,87,140,227,807.0,82,5.34,48,255,2438,9.0,0.7212046
24024,24024,Ryan Johansen,2017-18,25.0,7,61,82,82,14,47,61,154.0,1545.0,433,101,187,288,961.0,82,5.45,47,245,2478,9.0,0.72379214
24025,24025,Ryan Johansen,2018-19,26.0,8,54,79,79,15,39,54,129.0,1466.0,512,116,226,342,1090.0,82,5.86,50,250,2620,9.2,0.7283668
24026,24026,Ryan Johansen,2019-20,27.0,9,64,80,80,14,50,64,136.0,1564.0,592,130,276,406,1226.0,82,5.96,47,239,2579,9.5,0.7189013
24027,24027,Ryan Johansen,2020-21,28.0,10,36,68,68,14,22,36,101.0,1160.0,660,144,298,442,1327.0,70,5.96,42,208,2192,9.5,0.49688524
24028,24028,Ryan Johnson,1998-99,22.0,2,2,10,10,0,2,2,6.0,,10,0,2,2,6.0,82,5.28,57,380,2242,9.6,0.19505617
24029,24029,Ryan Johnson,1999-00,23.0,3,1,1,1,1,0,1,1.0,15.0,11,1,2,3,7.0,82,5.27,57,359,2285,9.4,0.21670958
24030,24030,Ryan Johnson,2000-01,24.0,4,18,80,80,4,14,18,49.0,932.0,91,5,16,21,56.0,82,5.49,53,331,2294,9.8,0.20183948
24031,24031,Ryan Johnson,2001-02,25.0,5,21,80,80,7,14,21,71.0,1262.0,171,12,30,42,127.0,82,5.51,63,376,2272,9.9,0.22552562
24032,24032,Ryan Johnson,2002-03,26.0,6,4,29,29,1,3,4,24.0,377.0,200,13,33,46,151.0,82,5.24,53,338,2262,9.5,0.1899555
24033,24033,Ryan Johnson,2003-04,27.0,7,7,75,75,2,5,7,67.0,798.0,275,15,38,53,218.0,82,5.31,60,363,2326,9.4,0.17414412
24034,24034,Ryan Johnson,2004-05,28.0,8,11,69,69,4,7,11,36.0,683.0,344,19,45,64,254.0,82,5.14,57,348,2300,9.2,0.17935038
24035,24035,Ryan Johnson,2006-07,30.0,9,9,65,65,3,6,9,57.0,741.0,409,22,51,73,311.0,82,6.05,85,480,2458,10.1,0.14088532
24036,24036,Ryan Johnson,2007-08,31.0,10,11,59,59,7,4,11,50.0,729.0,468,29,55,84,361.0,82,5.76,70,398,2426,9.7,0.17053047
24037,24037,Ryan Johnson,2008-09,32.0,11,18,79,79,5,13,18,85.0,1135.0,547,34,68,102,446.0,82,5.44,62,351,2383,9.4,0.20653349
24038,24038,Ryan Johnson,2009-10,33.0,12,9,62,62,2,7,9,22.0,683.0,609,36,75,111,468.0,82,5.7,65,341,2477,9.4,0.10799301
24039,24039,Ryan Johnson,2010-11,34.0,13,5,58,58,1,4,5,19.0,616.0,667,37,79,116,487.0,82,5.53,56,304,2486,9.1,0.103209496
24040,24040,Ryan Johnson,2011-12,35.0,14,6,34,34,1,5,6,25.0,352.0,701,38,84,122,512.0,82,5.46,52,291,2492,9.0,0.15298378
24041,24041,Ryan Johnston,2016-17,24.0,2,0,3,3,0,0,0,1.0,49.0,3,0,0,0,1.0,82,5.34,48,255,2438,9.0,0.15880582
24042,24042,Ryan Johnston,2017-18,25.0,3,0,7,7,0,0,0,3.0,69.0,10,0,0,0,4.0,82,5.45,47,245,2478,9.0,0.16660893
24043,24043,Ryan Jones,2009-10,25.0,2,17,46,46,7,10,17,63.0,526.0,46,7,10,17,63.0,82,5.7,65,341,2477,9.4,0.3073116
24044,24044,Ryan Jones,2010-11,26.0,3,12,49,49,8,4,12,62.0,522.0,95,15,14,29,125.0,82,5.53,56,304,2486,9.1,0.25763687
24045,24045,Ryan Jones,2011-12,27.0,4,25,81,81,18,7,25,126.0,1121.0,176,33,21,54,251.0,82,5.46,52,291,2492,9.0,0.32548147
24046,24046,Ryan Jones,2012-13,28.0,5,33,79,79,17,16,33,137.0,1219.0,255,50,37,87,388.0,82,5.32,47,271,2439,8.9,0.4186442
24047,24047,Ryan Jones,2013-14,29.0,6,7,27,27,2,5,7,38.0,350.0,282,52,42,94,426.0,48,5.31,29,160,1399,9.1,0.26667586
24048,24048,Ryan Jones,2014-15,30.0,7,6,52,52,2,4,6,59.0,512.0,334,54,46,100,485.0,82,5.34,48,269,2463,8.9,0.18080288
24049,24049,Ryan Keller,2010-11,27.0,2,0,6,6,0,0,0,5.0,37.0,6,0,0,0,5.0,82,5.53,56,304,2486,9.1,0.18110988
24050,24050,Ryan Kesler,2004-05,20.0,2,5,28,28,2,3,5,23.0,300.0,28,2,3,5,23.0,82,5.14,57,348,2300,9.2,0.29382914
24051,24051,Ryan Kesler,2006-07,22.0,3,23,82,82,10,13,23,119.0,1152.0,110,12,16,28,142.0,82,6.05,85,480,2458,10.1,0.34287238
24052,24052,Ryan Kesler,2007-08,23.0,4,16,48,48,6,10,16,88.0,789.0,158,18,26,44,230.0,82,5.76,70,398,2426,9.7,0.36144477
24053,24053,Ryan Kesler,2008-09,24.0,5,37,80,80,21,16,37,177.0,1524.0,238,39,42,81,407.0,82,5.44,62,351,2383,9.4,0.5588215
24054,24054,Ryan Kesler,2009-10,25.0,6,59,82,82,26,33,59,179.0,1596.0,320,65,75,140,586.0,82,5.7,65,341,2477,9.4,0.658685
24055,24055,Ryan Kesler,2010-11,26.0,7,75,82,82,25,50,75,214.0,1609.0,402,90,125,215,800.0,82,5.53,56,304,2486,9.1,0.82332236
24056,24056,Ryan Kesler,2011-12,27.0,8,73,82,82,41,32,73,260.0,1681.0,484,131,157,288,1060.0,82,5.46,52,291,2492,9.0,0.7876086
24057,24057,Ryan Kesler,2012-13,28.0,9,49,77,77,22,27,49,222.0,1547.0,561,153,184,337,1282.0,82,5.32,47,271,2439,8.9,0.6269894
24058,24058,Ryan Kesler,2013-14,29.0,10,13,17,17,4,9,13,36.0,322.0,578,157,193,350,1318.0,48,5.31,29,160,1399,9.1,0.4807564
24059,24059,Ryan Kesler,2014-15,30.0,11,43,77,77,25,18,43,239.0,1680.0,655,182,211,393,1557.0,82,5.34,48,269,2463,8.9,0.5768753
24060,24060,Ryan Kesler,2015-16,31.0,12,47,81,81,20,27,47,205.0,1581.0,736,202,238,440,1762.0,82,5.32,47,251,2453,8.9,0.5781909
24061,24061,Ryan Kesler,2016-17,32.0,13,53,79,79,21,32,53,164.0,1543.0,815,223,270,493,1926.0,82,5.34,48,255,2438,9.0,0.5905386
24062,24062,Ryan Kesler,2017-18,33.0,14,58,82,82,22,36,58,186.0,1747.0,897,245,306,551,2112.0,82,5.45,47,245,2478,9.0,0.61085904
24063,24063,Ryan Kesler,2018-19,34.0,15,14,44,44,8,6,14,78.0,794.0,941,253,312,565,2190.0,82,5.86,50,250,2620,9.2,0.32354924
24064,24064,Ryan Kesler,2019-20,35.0,16,8,60,60,5,3,8,86.0,990.0,1001,258,315,573,2276.0,82,5.96,47,239,2579,9.5,0.21804312
24065,24065,Ryan Kraft,2003-04,28.0,2,1,7,7,0,1,1,1.0,60.0,7,0,1,1,1.0,82,5.31,60,363,2326,9.4,0.15557772
24066,24066,Ryan Kuffner,2019-20,23.0,2,0,10,10,0,0,0,8.0,109.0,10,0,0,0,8.0,82,5.96,47,239,2579,9.5,0.17568076
24067,24067,Ryan Lindgren,2019-20,21.0,2,0,5,5,0,0,0,8.0,73.0,5,0,0,0,8.0,82,5.96,47,239,2579,9.5,0.2410365
24068,24068,Ryan Lindgren,2020-21,22.0,3,14,60,60,1,13,14,47.0,994.0,65,1,13,14,55.0,70,5.96,42,208,2192,9.5,0.21951044
24069,24069,Ryan Lomberg,2018-19,24.0,2,1,7,7,0,1,1,5.0,44.0,7,0,1,1,5.0,82,5.86,50,250,2620,9.2,0.18346974
24070,24070,Ryan Lomberg,2019-20,25.0,3,0,4,4,0,0,0,1.0,28.0,11,0,1,1,6.0,82,5.96,47,239,2579,9.5,0.16420972
24071,24071,Ryan MacInnis,2020-21,24.0,2,1,10,10,0,1,1,13.0,94.0,10,0,1,1,13.0,70,5.96,42,208,2192,9.5,0.2210508
24072,24072,Ryan Malone,2004-05,25.0,2,43,81,81,22,21,43,139.0,1530.0,81,22,21,43,139.0,82,5.14,57,348,2300,9.2,0.56634796
24073,24073,Ryan Malone,2006-07,27.0,3,44,77,77,22,22,44,153.0,1393.0,158,44,43,87,292.0,82,6.05,85,480,2458,10.1,0.48907605
24074,24074,Ryan Malone,2007-08,28.0,4,31,64,64,16,15,31,125.0,1040.0,222,60,58,118,417.0,82,5.76,70,398,2426,9.7,0.5224627
24075,24075,Ryan Malone,2008-09,29.0,5,51,77,77,27,24,51,159.0,1469.0,299,87,82,169,576.0,82,5.44,62,351,2383,9.4,0.6074798
24076,24076,Ryan Malone,2009-10,30.0,6,45,70,70,26,19,45,124.0,1243.0,369,113,101,214,700.0,82,5.7,65,341,2477,9.4,0.56571805
24077,24077,Ryan Malone,2010-11,31.0,7,47,69,69,21,26,47,172.0,1295.0,438,134,127,261,872.0,82,5.53,56,304,2486,9.1,0.5813764
24078,24078,Ryan Malone,2011-12,32.0,8,38,54,54,14,24,38,149.0,866.0,492,148,151,299,1021.0,82,5.46,52,291,2492,9.0,0.64793897
24079,24079,Ryan Malone,2012-13,33.0,9,48,68,68,20,28,48,144.0,1203.0,560,168,179,347,1165.0,82,5.32,47,271,2439,8.9,0.5659262
24080,24080,Ryan Malone,2013-14,34.0,10,8,24,24,6,2,8,37.0,378.0,584,174,181,355,1202.0,48,5.31,29,160,1399,9.1,0.33305806
24081,24081,Ryan Malone,2014-15,35.0,11,15,57,57,5,10,15,95.0,671.0,641,179,191,370,1297.0,82,5.34,48,269,2463,8.9,0.25128132
24082,24082,Ryan Malone,2015-16,36.0,12,0,6,6,0,0,0,6.0,60.0,647,179,191,370,1303.0,82,5.32,47,251,2453,8.9,0.21487817
24083,24083,Ryan McDonagh,2011-12,22.0,2,9,40,40,1,8,9,27.0,750.0,40,1,8,9,27.0,82,5.46,52,291,2492,9.0,0.18518084
24084,24084,Ryan McDonagh,2012-13,23.0,3,32,82,82,7,25,32,123.0,2029.0,122,8,33,41,150.0,82,5.32,47,271,2439,8.9,0.42088386
24085,24085,Ryan McDonagh,2013-14,24.0,4,19,47,47,4,15,19,83.0,1145.0,169,12,48,60,233.0,48,5.31,29,160,1399,9.1,0.40053004
24086,24086,Ryan McDonagh,2014-15,25.0,5,43,77,77,14,29,43,177.0,1911.0,246,26,77,103,410.0,82,5.34,48,269,2463,8.9,0.5239556
24087,24087,Ryan McDonagh,2015-16,26.0,6,33,71,71,8,25,33,148.0,1642.0,317,34,102,136,558.0,82,5.32,47,251,2453,8.9,0.48196134
24088,24088,Ryan McDonagh,2016-17,27.0,7,34,73,73,9,25,34,113.0,1632.0,390,43,127,170,671.0,82,5.34,48,255,2438,9.0,0.44878852
24089,24089,Ryan McDonagh,2017-18,28.0,8,42,77,77,6,36,42,153.0,1876.0,467,49,163,212,824.0,82,5.45,47,245,2478,9.0,0.48900855
24090,24090,Ryan McDonagh,2018-19,29.0,9,29,63,63,4,25,29,99.0,1470.0,530,53,188,241,923.0,82,5.86,50,250,2620,9.2,0.40720463
24091,24091,Ryan McDonagh,2019-20,30.0,10,46,82,82,9,37,46,128.0,1811.0,612,62,225,287,1051.0,82,5.96,47,239,2579,9.5,0.5054442
24092,24092,Ryan McDonagh,2020-21,31.0,11,12,50,50,1,11,12,50.0,1035.0,662,63,236,299,1101.0,70,5.96,42,208,2192,9.5,0.22335136
24093,24093,Ryan McGill,1992-93,23.0,2,2,9,9,0,2,2,15.0,,9,0,2,2,15.0,80,6.96,77,402,2440,11.4,0.25677383
24094,24094,Ryan McGill,1993-94,24.0,3,13,72,72,3,10,13,68.0,,81,3,12,15,83.0,84,7.25,87,443,2603,11.7,0.21184531
24095,24095,Ryan McGill,1994-95,25.0,4,4,50,50,1,3,4,53.0,,131,4,15,19,136.0,84,6.48,76,407,2545,10.7,0.14120945
24096,24096,Ryan McGill,1995-96,26.0,5,0,20,20,0,0,0,8.0,,151,4,15,19,144.0,48,5.97,37,209,1408,10.2,0.122367024
24097,24097,Ryan Mulhern,1998-99,26.0,2,0,3,3,0,0,0,1.0,,3,0,0,0,1.0,82,5.28,57,380,2242,9.6,0.14944527
24098,24098,Ryan Murphy,2013-14,20.0,2,0,4,4,0,0,0,7.0,84.0,4,0,0,0,7.0,48,5.31,29,160,1399,9.1,0.23965779
24099,24099,Ryan Murphy,2014-15,21.0,3,12,48,48,2,10,12,81.0,878.0,52,2,10,12,88.0,82,5.34,48,269,2463,8.9,0.30278355
24100,24100,Ryan Murphy,2015-16,22.0,4,13,37,37,4,9,13,61.0,677.0,89,6,19,25,149.0,82,5.32,47,251,2453,8.9,0.3161765
24101,24101,Ryan Murphy,2016-17,23.0,5,10,35,35,0,10,10,47.0,604.0,124,6,29,35,196.0,82,5.34,48,255,2438,9.0,0.24390733
24102,24102,Ryan Murphy,2017-18,24.0,6,2,27,27,0,2,2,17.0,356.0,151,6,31,37,213.0,82,5.45,47,245,2478,9.0,0.1500167
24103,24103,Ryan Murphy,2018-19,25.0,7,5,21,21,2,3,5,25.0,399.0,172,8,34,42,238.0,82,5.86,50,250,2620,9.2,0.2113795
24104,24104,Ryan Murphy,2019-20,26.0,8,1,3,3,0,1,1,1.0,34.0,175,8,35,43,239.0,82,5.96,47,239,2579,9.5,0.17464182
24105,24105,Ryan Murray,2014-15,21.0,2,21,66,66,4,17,21,62.0,1311.0,66,4,17,21,62.0,82,5.34,48,269,2463,8.9,0.30770165
24106,24106,Ryan Murray,2015-16,22.0,3,3,12,12,1,2,3,8.0,227.0,78,5,19,24,70.0,82,5.32,47,251,2453,8.9,0.25346622
24107,24107,Ryan Murray,2016-17,23.0,4,25,82,82,4,21,25,90.0,1873.0,160,9,40,49,160.0,82,5.34,48,255,2438,9.0,0.3045697
24108,24108,Ryan Murray,2017-18,24.0,5,11,60,60,2,9,11,52.0,1100.0,220,11,49,60,212.0,82,5.45,47,245,2478,9.0,0.23206401
24109,24109,Ryan Murray,2018-19,25.0,6,12,44,44,1,11,12,34.0,811.0,264,12,60,72,246.0,82,5.86,50,250,2620,9.2,0.1898956
24110,24110,Ryan Murray,2019-20,26.0,7,29,56,56,1,28,29,71.0,1201.0,320,13,88,101,317.0,82,5.96,47,239,2579,9.5,0.3961633
24111,24111,Ryan Murray,2020-21,27.0,8,9,27,27,2,7,9,32.0,539.0,347,15,95,110,349.0,70,5.96,42,208,2192,9.5,0.28697044
24112,24112,Ryan Nugent-Hopkins,2012-13,19.0,2,52,62,62,18,34,52,134.0,1092.0,62,18,34,52,134.0,82,5.32,47,271,2439,8.9,0.78537416
24113,24113,Ryan Nugent-Hopkins,2013-14,20.0,3,24,40,40,4,20,24,78.0,755.0,102,22,54,76,212.0,48,5.31,29,160,1399,9.1,0.60644966
24114,24114,Ryan Nugent-Hopkins,2014-15,21.0,4,56,80,80,19,37,56,178.0,1632.0,182,41,91,132,390.0,82,5.34,48,269,2463,8.9,0.715116
24115,24115,Ryan Nugent-Hopkins,2015-16,22.0,5,56,76,76,24,32,56,189.0,1569.0,258,65,123,188,579.0,82,5.32,47,251,2453,8.9,0.7650516
24116,24116,Ryan Nugent-Hopkins,2016-17,23.0,6,34,55,55,12,22,34,108.0,1048.0,313,77,145,222,687.0,82,5.34,48,255,2438,9.0,0.64690685
24117,24117,Ryan Nugent-Hopkins,2017-18,24.0,7,43,82,82,18,25,43,200.0,1451.0,395,95,170,265,887.0,82,5.45,47,245,2478,9.0,0.6101131
24118,24118,Ryan Nugent-Hopkins,2018-19,25.0,8,48,62,62,24,24,48,151.0,1122.0,457,119,194,313,1038.0,82,5.86,50,250,2620,9.2,0.7520345
24119,24119,Ryan Nugent-Hopkins,2019-20,26.0,9,69,82,82,28,41,69,208.0,1648.0,539,147,235,382,1246.0,82,5.96,47,239,2579,9.5,0.87118036
24120,24120,Ryan Nugent-Hopkins,2020-21,27.0,10,61,65,65,22,39,61,172.0,1330.0,604,169,274,443,1418.0,70,5.96,42,208,2192,9.5,0.8260416
24121,24121,Ryan O'Byrne,2008-09,24.0,2,7,33,33,1,6,7,10.0,442.0,33,1,6,7,10.0,82,5.44,62,351,2383,9.4,0.16920328
24122,24122,Ryan O'Byrne,2009-10,25.0,3,5,37,37,0,5,5,14.0,559.0,70,1,11,12,24.0,82,5.7,65,341,2477,9.4,0.115136474
24123,24123,Ryan O'Byrne,2010-11,26.0,4,4,55,55,1,3,4,27.0,839.0,125,2,14,16,51.0,82,5.53,56,304,2486,9.1,0.10002026
24124,24124,Ryan O'Byrne,2011-12,27.0,5,10,67,67,0,10,10,45.0,1351.0,192,2,24,26,96.0,82,5.46,52,291,2492,9.0,0.12834045
24125,24125,Ryan O'Byrne,2012-13,28.0,6,7,74,74,1,6,7,42.0,1395.0,266,3,30,33,138.0,82,5.32,47,271,2439,8.9,0.12705395
24126,24126,Ryan O'Byrne,2013-14,29.0,7,6,42,42,2,4,6,26.0,778.0,308,5,34,39,164.0,48,5.31,29,160,1399,9.1,0.11902332
24127,24127,Ryan O'Marra,2010-11,23.0,2,1,3,3,0,1,1,2.0,20.0,3,0,1,1,2.0,82,5.53,56,304,2486,9.1,0.20045206
24128,24128,Ryan O'Marra,2011-12,24.0,3,5,21,21,1,4,5,13.0,231.0,24,1,5,6,15.0,82,5.46,52,291,2492,9.0,0.15450683
24129,24129,Ryan O'Marra,2012-13,25.0,4,1,9,9,0,1,1,7.0,84.0,33,1,6,7,22.0,82,5.32,47,271,2439,8.9,0.15880474
24130,24130,Ryan O'Reilly,2010-11,19.0,2,26,81,81,8,18,26,135.0,1358.0,81,8,18,26,135.0,82,5.53,56,304,2486,9.1,0.40021175
24131,24131,Ryan O'Reilly,2011-12,20.0,3,26,74,74,13,13,26,119.0,1188.0,155,21,31,52,254.0,82,5.46,52,291,2492,9.0,0.4335139
24132,24132,Ryan O'Reilly,2012-13,21.0,4,55,81,81,18,37,55,189.0,1582.0,236,39,68,107,443.0,82,5.32,47,271,2439,8.9,0.71524954
24133,24133,Ryan O'Reilly,2013-14,22.0,5,20,29,29,6,14,20,66.0,537.0,265,45,82,127,509.0,48,5.31,29,160,1399,9.1,0.62530404
24134,24134,Ryan O'Reilly,2014-15,23.0,6,64,80,80,28,36,64,201.0,1586.0,345,73,118,191,710.0,82,5.34,48,269,2463,8.9,0.7752056
24135,24135,Ryan O'Reilly,2015-16,24.0,7,55,82,82,17,38,55,171.0,1617.0,427,90,156,246,881.0,82,5.32,47,251,2453,8.9,0.67501867
24136,24136,Ryan O'Reilly,2016-17,25.0,8,60,71,71,21,39,60,157.0,1543.0,498,111,195,306,1038.0,82,5.34,48,255,2438,9.0,0.7565732
24137,24137,Ryan O'Reilly,2017-18,26.0,9,55,72,72,20,35,55,189.0,1545.0,570,131,230,361,1227.0,82,5.45,47,245,2478,9.0,0.77256536
24138,24138,Ryan O'Reilly,2018-19,27.0,10,61,81,81,24,37,61,230.0,1686.0,651,155,267,422,1457.0,82,5.86,50,250,2620,9.2,0.7492149
24139,24139,Ryan O'Reilly,2019-20,28.0,11,77,82,82,28,49,77,234.0,1702.0,733,183,316,499,1691.0,82,5.96,47,239,2579,9.5,0.8396443
24140,24140,Ryan O'Reilly,2020-21,29.0,12,61,71,71,12,49,61,118.0,1461.0,804,195,365,560,1809.0,70,5.96,42,208,2192,9.5,0.7318532
24141,24141,Ryan Parent,2007-08,20.0,2,0,1,1,0,0,0,1.0,14.0,1,0,0,0,1.0,82,5.76,70,398,2426,9.7,0.23165298
24142,24142,Ryan Parent,2008-09,21.0,3,0,22,22,0,0,0,9.0,330.0,23,0,0,0,10.0,82,5.44,62,351,2383,9.4,0.1390624
24143,24143,Ryan Parent,2009-10,22.0,4,4,31,31,0,4,4,9.0,564.0,54,0,4,4,19.0,82,5.7,65,341,2477,9.4,0.12609714
24144,24144,Ryan Parent,2010-11,23.0,5,3,48,48,1,2,3,27.0,709.0,102,1,6,7,46.0,82,5.53,56,304,2486,9.1,0.14561296
24145,24145,Ryan Parent,2011-12,24.0,6,0,4,4,0,0,0,3.0,56.0,106,1,6,7,49.0,82,5.46,52,291,2492,9.0,0.13883355
24146,24146,Ryan Poehling,2019-20,21.0,2,3,1,1,3,0,3,3.0,11.0,1,3,0,3,3.0,82,5.96,47,239,2579,9.5,0.31510115
24147,24147,Ryan Poehling,2020-21,22.0,3,2,27,27,1,1,2,26.0,279.0,28,4,1,5,29.0,70,5.96,42,208,2192,9.5,0.23362523
24148,24148,Ryan Potulny,2006-07,22.0,2,1,2,2,0,1,1,0.0,12.0,2,0,1,1,0.0,82,6.05,85,480,2458,10.1,0.18331102
24149,24149,Ryan Potulny,2007-08,23.0,3,12,35,35,7,5,12,56.0,385.0,37,7,6,13,56.0,82,5.76,70,398,2426,9.7,0.31989276
24150,24150,Ryan Potulny,2008-09,24.0,4,1,7,7,0,1,1,5.0,46.0,44,7,7,14,61.0,82,5.44,62,351,2383,9.4,0.18222266
24151,24151,Ryan Potulny,2009-10,25.0,5,3,8,8,0,3,3,9.0,84.0,52,7,10,17,70.0,82,5.7,65,341,2477,9.4,0.19296008
24152,24152,Ryan Potulny,2010-11,26.0,6,32,64,64,15,17,32,152.0,1042.0,116,22,27,49,222.0,82,5.53,56,304,2486,9.1,0.4642611
24153,24153,Ryan Potulny,2011-12,27.0,7,0,10,10,0,0,0,7.0,79.0,126,22,27,49,229.0,82,5.46,52,291,2492,9.0,0.173861
24154,24154,Ryan Pulock,2016-17,22.0,2,4,15,15,2,2,4,15.0,236.0,15,2,2,4,15.0,82,5.34,48,255,2438,9.0,0.2503272
24155,24155,Ryan Pulock,2017-18,23.0,3,0,1,1,0,0,0,0.0,4.0,16,2,2,4,15.0,82,5.45,47,245,2478,9.0,0.17575318
24156,24156,Ryan Pulock,2018-19,24.0,4,32,68,68,10,22,32,184.0,1252.0,84,12,24,36,199.0,82,5.86,50,250,2620,9.2,0.4731558
24157,24157,Ryan Pulock,2019-20,25.0,5,37,82,82,9,28,37,180.0,1834.0,166,21,52,73,379.0,82,5.96,47,239,2579,9.5,0.5003215
24158,24158,Ryan Pulock,2020-21,26.0,6,35,68,68,10,25,35,163.0,1524.0,234,31,77,108,542.0,70,5.96,42,208,2192,9.5,0.5157516
24159,24159,Ryan Ready,2006-07,28.0,2,1,7,7,0,1,1,9.0,57.0,7,0,1,1,9.0,82,6.05,85,480,2458,10.1,0.19970682
24160,24160,Ryan Reaves,2011-12,25.0,2,4,28,28,2,2,4,16.0,191.0,28,2,2,4,16.0,82,5.46,52,291,2492,9.0,0.17709899
24161,24161,Ryan Reaves,2012-13,26.0,3,4,60,60,3,1,4,32.0,392.0,88,5,3,8,48.0,82,5.32,47,271,2439,8.9,0.11215094
24162,24162,Ryan Reaves,2013-14,27.0,4,6,43,43,4,2,6,24.0,320.0,131,9,5,14,72.0,48,5.31,29,160,1399,9.1,0.14196324
24163,24163,Ryan Reaves,2014-15,28.0,5,8,63,63,2,6,8,25.0,537.0,194,11,11,22,97.0,82,5.34,48,269,2463,8.9,0.10032207
24164,24164,Ryan Reaves,2015-16,29.0,6,12,81,81,6,6,12,55.0,690.0,275,17,17,34,152.0,82,5.32,47,251,2453,8.9,0.14232591
24165,24165,Ryan Reaves,2016-17,30.0,7,4,64,64,3,1,4,31.0,514.0,339,20,18,38,183.0,82,5.34,48,255,2438,9.0,0.09567803
24166,24166,Ryan Reaves,2017-18,31.0,8,13,80,80,7,6,13,58.0,711.0,419,27,24,51,241.0,82,5.45,47,245,2478,9.0,0.14993364
24167,24167,Ryan Reaves,2018-19,32.0,9,10,79,79,4,6,10,42.0,600.0,498,31,30,61,283.0,82,5.86,50,250,2620,9.2,0.13476059
24168,24168,Ryan Reaves,2019-20,33.0,10,20,80,80,9,11,20,95.0,870.0,578,40,41,81,378.0,82,5.96,47,239,2579,9.5,0.23032328
24169,24169,Ryan Reaves,2020-21,34.0,11,15,71,71,8,7,15,61.0,720.0,649,48,48,96,439.0,70,5.96,42,208,2192,9.5,0.19915596
24170,24170,Ryan Russell,2012-13,25.0,2,2,41,41,2,0,2,39.0,479.0,41,2,0,2,39.0,82,5.32,47,271,2439,8.9,0.15484247
24171,24171,Ryan Savoia,1999-00,26.0,2,0,3,3,0,0,0,0.0,7.0,3,0,0,0,0.0,82,5.27,57,359,2285,9.4,0.16186059
24172,24172,Ryan Shannon,2007-08,24.0,2,11,53,53,2,9,11,77.0,564.0,53,2,9,11,77.0,82,5.76,70,398,2426,9.7,0.24830031
24173,24173,Ryan Shannon,2008-09,25.0,3,13,27,27,5,8,13,34.0,348.0,80,7,17,24,111.0,82,5.44,62,351,2383,9.4,0.29815146
24174,24174,Ryan Shannon,2009-10,26.0,4,20,35,35,8,12,20,61.0,528.0,115,15,29,44,172.0,82,5.7,65,341,2477,9.4,0.3991787
24175,24175,Ryan Shannon,2010-11,27.0,5,16,66,66,5,11,16,109.0,837.0,181,20,40,60,281.0,82,5.53,56,304,2486,9.1,0.2564345
24176,24176,Ryan Shannon,2011-12,28.0,6,27,79,79,11,16,27,118.0,1021.0,260,31,56,87,399.0,82,5.46,52,291,2492,9.0,0.29218426
24177,24177,Ryan Shannon,2012-13,29.0,7,12,45,45,4,8,12,46.0,541.0,305,35,64,99,445.0,82,5.32,47,271,2439,8.9,0.21178868
24178,24178,Ryan Smyth,1995-96,19.0,2,0,3,3,0,0,0,2.0,,3,0,0,0,2.0,48,5.97,37,209,1408,10.2,0.23130968
24179,24179,Ryan Smyth,1996-97,20.0,3,11,48,48,2,9,11,65.0,,51,2,9,11,67.0,82,6.29,74,413,2481,10.4,0.2972741
24180,24180,Ryan Smyth,1997-98,21.0,4,61,82,82,39,22,61,265.0,,133,41,31,72,332.0,82,5.83,55,336,2444,9.8,0.7560319
24181,24181,Ryan Smyth,1998-99,22.0,5,33,65,65,20,13,33,205.0,,198,61,44,105,537.0,82,5.28,57,380,2242,9.6,0.59000516
24182,24182,Ryan Smyth,1999-00,23.0,6,31,71,71,13,18,31,161.0,1025.0,269,74,62,136,698.0,82,5.27,57,359,2285,9.4,0.52517956
24183,24183,Ryan Smyth,2000-01,24.0,7,54,82,82,28,26,54,238.0,1574.0,351,102,88,190,936.0,82,5.49,53,331,2294,9.8,0.74193156
24184,24184,Ryan Smyth,2001-02,25.0,8,70,82,82,31,39,70,245.0,1637.0,433,133,127,260,1181.0,82,5.51,63,376,2272,9.9,0.81676066
24185,24185,Ryan Smyth,2002-03,26.0,9,50,61,61,15,35,50,150.0,1187.0,494,148,162,310,1331.0,82,5.24,53,338,2262,9.5,0.80830145
24186,24186,Ryan Smyth,2003-04,27.0,10,61,66,66,27,34,61,199.0,1277.0,560,175,196,371,1530.0,82,5.31,60,363,2326,9.4,0.84101605
24187,24187,Ryan Smyth,2004-05,28.0,11,59,82,82,23,36,59,245.0,1612.0,642,198,232,430,1775.0,82,5.14,57,348,2300,9.2,0.7674196
24188,24188,Ryan Smyth,2006-07,30.0,12,66,75,75,36,30,66,230.0,1516.0,717,234,262,496,2005.0,82,6.05,85,480,2458,10.1,0.7926103
24189,24189,Ryan Smyth,2007-08,31.0,13,68,71,71,36,32,68,210.0,1472.0,788,270,294,564,2215.0,82,5.76,70,398,2426,9.7,0.77887654
24190,24190,Ryan Smyth,2008-09,32.0,14,37,55,55,14,23,37,168.0,1079.0,843,284,317,601,2383.0,82,5.44,62,351,2383,9.4,0.6281135
24191,24191,Ryan Smyth,2009-10,33.0,15,59,77,77,26,33,59,257.0,1562.0,920,310,350,660,2640.0,82,5.7,65,341,2477,9.4,0.6635123
24192,24192,Ryan Smyth,2010-11,34.0,16,53,67,67,22,31,53,206.0,1319.0,987,332,381,713,2846.0,82,5.53,56,304,2486,9.1,0.660532
24193,24193,Ryan Smyth,2011-12,35.0,17,47,82,82,23,24,47,195.0,1479.0,1069,355,405,760,3041.0,82,5.46,52,291,2492,9.0,0.5418455
24194,24194,Ryan Smyth,2012-13,36.0,18,46,82,82,19,27,46,194.0,1565.0,1151,374,432,806,3235.0,82,5.32,47,271,2439,8.9,0.49401915
24195,24195,Ryan Smyth,2013-14,37.0,19,13,47,47,2,11,13,69.0,722.0,1198,376,443,819,3304.0,48,5.31,29,160,1399,9.1,0.3342015
24196,24196,Ryan Smyth,2014-15,38.0,20,23,72,72,10,13,23,129.0,1111.0,1270,386,456,842,3433.0,82,5.34,48,269,2463,8.9,0.30881438
24197,24197,Ryan Spooner,2013-14,22.0,2,0,4,4,0,0,0,4.0,36.0,4,0,0,0,4.0,48,5.31,29,160,1399,9.1,0.2058757
24198,24198,Ryan Spooner,2014-15,23.0,3,11,23,23,0,11,11,42.0,295.0,27,0,11,11,46.0,82,5.34,48,269,2463,8.9,0.23170611
24199,24199,Ryan Spooner,2015-16,24.0,4,18,29,29,8,10,18,73.0,422.0,56,8,21,29,119.0,82,5.32,47,251,2453,8.9,0.4368398
24200,24200,Ryan Spooner,2016-17,25.0,5,49,80,80,13,36,49,162.0,1211.0,136,21,57,78,281.0,82,5.34,48,255,2438,9.0,0.58217394
24201,24201,Ryan Spooner,2017-18,26.0,6,39,78,78,11,28,39,145.0,1099.0,214,32,85,117,426.0,82,5.45,47,245,2478,9.0,0.50430435
24202,24202,Ryan Spooner,2018-19,27.0,7,41,59,59,13,28,41,107.0,902.0,273,45,113,158,533.0,82,5.86,50,250,2620,9.2,0.5310771
24203,24203,Ryan Spooner,2019-20,28.0,8,9,52,52,3,6,9,67.0,594.0,325,48,119,167,600.0,82,5.96,47,239,2579,9.5,0.2724992
24204,24204,Ryan Sproul,2014-15,22.0,2,0,1,1,0,0,0,3.0,18.0,1,0,0,0,3.0,82,5.34,48,269,2463,8.9,0.18369669
24205,24205,Ryan Sproul,2017-18,25.0,3,7,27,27,1,6,7,46.0,409.0,28,1,6,7,49.0,82,5.45,47,245,2478,9.0,0.21062675
24206,24206,Ryan Sproul,2018-19,26.0,4,5,16,16,1,4,5,15.0,262.0,44,2,10,12,64.0,82,5.86,50,250,2620,9.2,0.19518676
24207,24207,Ryan Stanton,2013-14,24.0,2,0,1,1,0,0,0,1.0,17.0,1,0,0,0,1.0,48,5.31,29,160,1399,9.1,0.19848764
24208,24208,Ryan Stanton,2014-15,25.0,3,16,64,64,1,15,16,65.0,942.0,65,1,15,16,66.0,82,5.34,48,269,2463,8.9,0.19982517
24209,24209,Ryan Stanton,2015-16,26.0,4,11,54,54,3,8,11,59.0,864.0,119,4,23,27,125.0,82,5.32,47,251,2453,8.9,0.20827138
24210,24210,Ryan Stanton,2016-17,27.0,5,0,1,1,0,0,0,0.0,9.0,120,4,23,27,125.0,82,5.34,48,255,2438,9.0,0.13788986
24211,24211,Ryan Stewart,1986-87,19.0,2,1,3,3,1,0,1,5.0,,3,1,0,1,5.0,80,7.94,82,370,2484,12.8,0.29237366
24212,24212,Ryan Stoa,2010-11,23.0,2,3,12,12,2,1,3,26.0,133.0,12,2,1,3,26.0,82,5.53,56,304,2486,9.1,0.29416448
24213,24213,Ryan Stoa,2011-12,24.0,3,4,25,25,2,2,4,45.0,334.0,37,4,3,7,71.0,82,5.46,52,291,2492,9.0,0.21246418
24214,24214,Ryan Stoa,2014-15,27.0,4,0,3,3,0,0,0,2.0,27.0,40,4,3,7,73.0,82,5.34,48,269,2463,8.9,0.15249336
24215,24215,Ryan Stone,2008-09,23.0,2,1,6,6,0,1,1,3.0,39.0,6,0,1,1,3.0,82,5.44,62,351,2383,9.4,0.19362187
24216,24216,Ryan Stone,2009-10,24.0,3,0,2,2,0,0,0,5.0,21.0,8,0,1,1,8.0,82,5.7,65,341,2477,9.4,0.1647686
24217,24217,Ryan Stone,2010-11,25.0,4,6,27,27,0,6,6,25.0,293.0,35,0,7,7,33.0,82,5.53,56,304,2486,9.1,0.18638721
24218,24218,Ryan Strome,2014-15,21.0,2,18,37,37,7,11,18,89.0,562.0,37,7,11,18,89.0,82,5.34,48,269,2463,8.9,0.483682
24219,24219,Ryan Strome,2015-16,22.0,3,50,81,81,17,33,50,179.0,1247.0,118,24,44,68,268.0,82,5.32,47,251,2453,8.9,0.6481638
24220,24220,Ryan Strome,2016-17,23.0,4,28,71,71,8,20,28,132.0,1112.0,189,32,64,96,400.0,82,5.34,48,255,2438,9.0,0.46246997
24221,24221,Ryan Strome,2017-18,24.0,5,30,69,69,13,17,30,114.0,1008.0,258,45,81,126,514.0,82,5.45,47,245,2478,9.0,0.51771104
24222,24222,Ryan Strome,2018-19,25.0,6,34,82,82,13,21,34,147.0,1248.0,340,58,102,160,661.0,82,5.86,50,250,2620,9.2,0.5078258
24223,24223,Ryan Strome,2019-20,26.0,7,35,81,81,19,16,35,110.0,1261.0,421,77,118,195,771.0,82,5.96,47,239,2579,9.5,0.47321725
24224,24224,Ryan Strome,2020-21,27.0,8,59,70,70,18,41,59,154.0,1371.0,491,95,159,254,925.0,70,5.96,42,208,2192,9.5,0.74807554
24225,24225,Ryan Suter,2006-07,22.0,2,16,71,71,1,15,16,84.0,1232.0,71,1,15,16,84.0,82,6.05,85,480,2458,10.1,0.25655836
24226,24226,Ryan Suter,2007-08,23.0,3,24,82,82,8,16,24,87.0,1652.0,153,9,31,40,171.0,82,5.76,70,398,2426,9.7,0.3409686
24227,24227,Ryan Suter,2008-09,24.0,4,31,76,76,7,24,31,138.0,1564.0,229,16,55,71,309.0,82,5.44,62,351,2383,9.4,0.4391141
24228,24228,Ryan Suter,2009-10,25.0,5,45,82,82,7,38,45,143.0,1989.0,311,23,93,116,452.0,82,5.7,65,341,2477,9.4,0.54024357
24229,24229,Ryan Suter,2010-11,26.0,6,37,82,82,4,33,37,125.0,1966.0,393,27,126,153,577.0,82,5.53,56,304,2486,9.1,0.44517118
24230,24230,Ryan Suter,2011-12,27.0,7,39,70,70,4,35,39,115.0,1764.0,463,31,161,192,692.0,82,5.46,52,291,2492,9.0,0.48574257
24231,24231,Ryan Suter,2012-13,28.0,8,46,79,79,7,39,46,134.0,2094.0,542,38,200,238,826.0,82,5.32,47,271,2439,8.9,0.51178396
24232,24232,Ryan Suter,2013-14,29.0,9,32,48,48,4,28,32,91.0,1309.0,590,42,228,270,917.0,48,5.31,29,160,1399,9.1,0.51287466
24233,24233,Ryan Suter,2014-15,30.0,10,43,82,82,8,35,43,150.0,2412.0,672,50,263,313,1067.0,82,5.34,48,269,2463,8.9,0.5063746
24234,24234,Ryan Suter,2015-16,31.0,11,38,77,77,2,36,38,150.0,2238.0,749,52,299,351,1217.0,82,5.32,47,251,2453,8.9,0.43960932
24235,24235,Ryan Suter,2016-17,32.0,12,51,82,82,8,43,51,188.0,2345.0,831,60,342,402,1405.0,82,5.34,48,255,2438,9.0,0.59198964
24236,24236,Ryan Suter,2017-18,33.0,13,40,82,82,9,31,40,164.0,2208.0,913,69,373,442,1569.0,82,5.45,47,245,2478,9.0,0.45198762
24237,24237,Ryan Suter,2018-19,34.0,14,51,78,78,6,45,51,149.0,2089.0,991,75,418,493,1718.0,82,5.86,50,250,2620,9.2,0.5426762
24238,24238,Ryan Suter,2019-20,35.0,15,47,82,82,7,40,47,136.0,2189.0,1073,82,458,540,1854.0,82,5.96,47,239,2579,9.5,0.50874126
24239,24239,Ryan Suter,2020-21,36.0,16,48,69,69,8,40,48,111.0,1700.0,1142,90,498,588,1965.0,70,5.96,42,208,2192,9.5,0.5432391
24240,24240,Ryan Thang,2012-13,25.0,2,0,1,1,0,0,0,0.0,9.0,1,0,0,0,0.0,82,5.32,47,271,2439,8.9,0.13161138
24241,24241,Ryan Tobler,2002-03,26.0,2,0,4,4,0,0,0,1.0,17.0,4,0,0,0,1.0,82,5.24,53,338,2262,9.5,0.15546104
24242,24242,Ryan VandenBussche,1997-98,24.0,2,1,11,11,1,0,1,4.0,,11,1,0,1,4.0,82,5.83,55,336,2444,9.8,0.18902805
24243,24243,Ryan VandenBussche,1998-99,25.0,3,2,20,20,1,1,2,2.0,,31,2,1,3,6.0,82,5.28,57,380,2242,9.6,0.12342724
24244,24244,Ryan VandenBussche,1999-00,26.0,4,0,6,6,0,0,0,3.0,57.0,37,2,1,3,9.0,82,5.27,57,359,2285,9.4,0.14758259
24245,24245,Ryan VandenBussche,2000-01,27.0,5,1,52,52,0,1,1,19.0,292.0,89,2,2,4,28.0,82,5.49,53,331,2294,9.8,0.0693295
24246,24246,Ryan VandenBussche,2001-02,28.0,6,7,64,64,2,5,7,24.0,497.0,153,4,7,11,52.0,82,5.51,63,376,2272,9.9,0.09763512
24247,24247,Ryan VandenBussche,2002-03,29.0,7,3,50,50,1,2,3,22.0,316.0,203,5,9,14,74.0,82,5.24,53,338,2262,9.5,0.08117178
24248,24248,Ryan VandenBussche,2003-04,30.0,8,0,22,22,0,0,0,7.0,143.0,225,5,9,14,81.0,82,5.31,60,363,2326,9.4,0.08994913
24249,24249,Ryan VandenBussche,2004-05,31.0,9,5,65,65,4,1,5,25.0,407.0,290,9,10,19,106.0,82,5.14,57,348,2300,9.2,0.10588384
24250,24250,Ryan VandenBussche,2006-07,33.0,10,1,20,20,1,0,1,5.0,87.0,310,10,10,20,111.0,82,6.05,85,480,2458,10.1,0.087277144
24251,24251,Ryan Vesce,2009-10,27.0,2,0,10,10,0,0,0,11.0,97.0,10,0,0,0,11.0,82,5.7,65,341,2477,9.4,0.19238669
24252,24252,Ryan Vesce,2010-11,28.0,3,5,9,9,3,2,5,20.0,99.0,19,3,2,5,31.0,82,5.53,56,304,2486,9.1,0.25409034
24253,24253,Ryan White,2010-11,22.0,2,2,16,16,0,2,2,5.0,178.0,16,0,2,2,5.0,82,5.53,56,304,2486,9.1,0.17820752
24254,24254,Ryan White,2011-12,23.0,3,5,27,27,2,3,5,30.0,241.0,43,2,5,7,35.0,82,5.46,52,291,2492,9.0,0.231141
24255,24255,Ryan White,2012-13,24.0,4,3,20,20,0,3,3,12.0,290.0,63,2,8,10,47.0,82,5.32,47,271,2439,8.9,0.1236676
24256,24256,Ryan White,2013-14,25.0,5,1,26,26,1,0,1,16.0,245.0,89,3,8,11,63.0,48,5.31,29,160,1399,9.1,0.15362757
24257,24257,Ryan White,2014-15,26.0,6,6,52,52,2,4,6,51.0,504.0,141,5,12,17,114.0,82,5.34,48,269,2463,8.9,0.14576662
24258,24258,Ryan White,2015-16,27.0,7,12,34,34,6,6,12,45.0,399.0,175,11,18,29,159.0,82,5.32,47,251,2453,8.9,0.21561787
24259,24259,Ryan White,2016-17,28.0,8,16,73,73,11,5,16,88.0,917.0,248,22,23,45,247.0,82,5.34,48,255,2438,9.0,0.2200366
24260,24260,Ryan White,2017-18,29.0,9,16,65,65,9,7,16,60.0,693.0,313,31,30,61,307.0,82,5.45,47,245,2478,9.0,0.18693554
24261,24261,Ryan Whitney,2006-07,23.0,2,38,68,68,6,32,38,113.0,1620.0,68,6,32,38,113.0,82,6.05,85,480,2458,10.1,0.5045585
24262,24262,Ryan Whitney,2007-08,24.0,3,59,81,81,14,45,59,129.0,1939.0,149,20,77,97,242.0,82,5.76,70,398,2426,9.7,0.63300025
24263,24263,Ryan Whitney,2008-09,25.0,4,40,76,76,12,28,40,119.0,1706.0,225,32,105,137,361.0,82,5.44,62,351,2383,9.4,0.55299306
24264,24264,Ryan Whitney,2009-10,26.0,5,23,48,48,2,21,23,71.0,1146.0,273,34,126,160,432.0,82,5.7,65,341,2477,9.4,0.4234348
24265,24265,Ryan Whitney,2010-11,27.0,6,39,81,81,7,32,39,151.0,2005.0,354,41,158,199,583.0,82,5.53,56,304,2486,9.1,0.5040708
24266,24266,Ryan Whitney,2011-12,28.0,7,27,35,35,2,25,27,43.0,887.0,389,43,183,226,626.0,82,5.46,52,291,2492,9.0,0.529686
24267,24267,Ryan Whitney,2012-13,29.0,8,20,51,51,3,17,20,41.0,1069.0,440,46,200,246,667.0,82,5.32,47,271,2439,8.9,0.34735274
24268,24268,Ryan Whitney,2013-14,30.0,9,13,34,34,4,9,13,30.0,628.0,474,50,209,259,697.0,48,5.31,29,160,1399,9.1,0.33593595
24269,24269,Ryan Whitney,2014-15,31.0,10,0,7,7,0,0,0,8.0,117.0,481,50,209,259,705.0,82,5.34,48,269,2463,8.9,0.26415983
24270,24270,Ryan Wilson,2010-11,23.0,2,21,61,61,3,18,21,46.0,993.0,61,3,18,21,46.0,82,5.53,56,304,2486,9.1,0.27615112
24271,24271,Ryan Wilson,2011-12,24.0,3,16,67,67,3,13,16,62.0,1327.0,128,6,31,37,108.0,82,5.46,52,291,2492,9.0,0.21876952
24272,24272,Ryan Wilson,2012-13,25.0,4,21,59,59,1,20,21,63.0,1105.0,187,7,51,58,171.0,82,5.32,47,271,2439,8.9,0.26587245
24273,24273,Ryan Wilson,2013-14,26.0,5,3,12,12,0,3,3,23.0,222.0,199,7,54,61,194.0,48,5.31,29,160,1399,9.1,0.31104428
24274,24274,Ryan Wilson,2014-15,27.0,6,6,28,28,0,6,6,23.0,411.0,227,7,60,67,217.0,82,5.34,48,269,2463,8.9,0.19303256
24275,24275,Ryan Wilson,2015-16,28.0,7,0,3,3,0,0,0,3.0,34.0,230,7,60,67,220.0,82,5.32,47,251,2453,8.9,0.19698122
24276,24276,Ryane Clowe,2006-07,24.0,2,2,18,18,0,2,2,14.0,174.0,18,0,2,2,14.0,82,6.05,85,480,2458,10.1,0.1767996
24277,24277,Ryane Clowe,2007-08,25.0,3,34,58,58,16,18,34,93.0,765.0,76,16,20,36,107.0,82,5.76,70,398,2426,9.7,0.48169765
24278,24278,Ryane Clowe,2008-09,26.0,4,8,15,15,3,5,8,22.0,214.0,91,19,25,44,129.0,82,5.44,62,351,2383,9.4,0.31831437
24279,24279,Ryane Clowe,2009-10,27.0,5,52,71,71,22,30,52,161.0,1262.0,162,41,55,96,290.0,82,5.7,65,341,2477,9.4,0.5797227
24280,24280,Ryane Clowe,2010-11,28.0,6,57,82,82,19,38,57,189.0,1408.0,244,60,93,153,479.0,82,5.53,56,304,2486,9.1,0.6542352
24281,24281,Ryane Clowe,2011-12,29.0,7,62,75,75,24,38,62,185.0,1347.0,319,84,131,215,664.0,82,5.46,52,291,2492,9.0,0.68223023
24282,24282,Ryane Clowe,2012-13,30.0,8,45,76,76,17,28,45,180.0,1358.0,395,101,159,260,844.0,82,5.32,47,271,2439,8.9,0.524105
24283,24283,Ryane Clowe,2013-14,31.0,9,19,40,40,3,16,19,87.0,665.0,435,104,175,279,931.0,48,5.31,29,160,1399,9.1,0.46572322
24284,24284,Ryane Clowe,2014-15,32.0,10,26,43,43,7,19,26,74.0,694.0,478,111,194,305,1005.0,82,5.34,48,269,2463,8.9,0.49907568
24285,24285,Ryane Clowe,2015-16,33.0,11,4,13,13,1,3,4,15.0,204.0,491,112,197,309,1020.0,82,5.32,47,251,2453,8.9,0.3038111
24286,24286,Saku Koivu,1996-97,22.0,2,45,82,82,20,25,45,136.0,,82,20,25,45,136.0,82,6.29,74,413,2481,10.4,0.5764439
24287,24287,Saku Koivu,1997-98,23.0,3,56,50,50,17,39,56,135.0,,132,37,64,101,271.0,82,5.83,55,336,2444,9.8,0.8491302
24288,24288,Saku Koivu,1998-99,24.0,4,57,69,69,14,43,57,145.0,,201,51,107,158,416.0,82,5.28,57,380,2242,9.6,0.7572857
24289,24289,Saku Koivu,1999-00,25.0,5,44,65,65,14,30,44,145.0,1302.0,266,65,137,202,561.0,82,5.27,57,359,2285,9.4,0.6545587
24290,24290,Saku Koivu,2000-01,26.0,6,21,24,24,3,18,21,53.0,461.0,290,68,155,223,614.0,82,5.49,53,331,2294,9.8,0.8021539
24291,24291,Saku Koivu,2001-02,27.0,7,47,54,54,17,30,47,113.0,1155.0,344,85,185,270,727.0,82,5.51,63,376,2272,9.9,0.7374961
24292,24292,Saku Koivu,2002-03,28.0,8,2,3,3,0,2,2,2.0,42.0,347,85,187,272,729.0,82,5.24,53,338,2262,9.5,0.47155857
24293,24293,Saku Koivu,2003-04,29.0,9,71,82,82,21,50,71,147.0,1578.0,429,106,237,343,876.0,82,5.31,60,363,2326,9.4,0.7853359
24294,24294,Saku Koivu,2004-05,30.0,10,55,68,68,14,41,55,112.0,1312.0,497,120,278,398,988.0,82,5.14,57,348,2300,9.2,0.75070965
24295,24295,Saku Koivu,2006-07,32.0,11,62,72,72,17,45,62,138.0,1334.0,569,137,323,460,1126.0,82,6.05,85,480,2458,10.1,0.77024835
24296,24296,Saku Koivu,2007-08,33.0,12,75,81,81,22,53,75,154.0,1467.0,650,159,376,535,1280.0,82,5.76,70,398,2426,9.7,0.77719104
24297,24297,Saku Koivu,2008-09,34.0,13,56,77,77,16,40,56,150.0,1395.0,727,175,416,591,1430.0,82,5.44,62,351,2383,9.4,0.7047578
24298,24298,Saku Koivu,2009-10,35.0,14,50,65,65,16,34,50,123.0,1108.0,792,191,450,641,1553.0,82,5.7,65,341,2477,9.4,0.6350765
24299,24299,Saku Koivu,2010-11,36.0,15,52,71,71,19,33,52,124.0,1319.0,863,210,483,693,1677.0,82,5.53,56,304,2486,9.1,0.5690416
24300,24300,Saku Koivu,2011-12,37.0,16,45,75,75,15,30,45,104.0,1435.0,938,225,513,738,1781.0,82,5.46,52,291,2492,9.0,0.48537377
24301,24301,Saku Koivu,2012-13,38.0,17,38,74,74,11,27,38,107.0,1341.0,1012,236,540,776,1888.0,82,5.32,47,271,2439,8.9,0.43429375
24302,24302,Saku Koivu,2013-14,39.0,18,27,47,47,8,19,27,55.0,827.0,1059,244,559,803,1943.0,48,5.31,29,160,1399,9.1,0.45877323
24303,24303,Saku Koivu,2014-15,40.0,19,29,65,65,11,18,29,81.0,978.0,1124,255,577,832,2024.0,82,5.34,48,269,2463,8.9,0.32940048
24304,24304,Saku Maenalanen,2019-20,25.0,2,8,34,34,4,4,8,36.0,321.0,34,4,4,8,36.0,82,5.96,47,239,2579,9.5,0.22533914
24305,24305,Sam Bennett,2015-16,19.0,2,1,1,1,0,1,1,1.0,16.0,1,0,1,1,1.0,82,5.32,47,251,2453,8.9,0.27857095
24306,24306,Sam Bennett,2016-17,20.0,3,36,77,77,18,18,36,136.0,1166.0,78,18,19,37,137.0,82,5.34,48,255,2438,9.0,0.51900524
24307,24307,Sam Bennett,2017-18,21.0,4,26,81,81,13,13,26,122.0,1214.0,159,31,32,63,259.0,82,5.45,47,245,2478,9.0,0.4027532
24308,24308,Sam Bennett,2018-19,22.0,5,26,82,82,11,15,26,157.0,1181.0,241,42,47,89,416.0,82,5.86,50,250,2620,9.2,0.43935597
24309,24309,Sam Bennett,2019-20,23.0,6,27,71,71,13,14,27,115.0,944.0,312,55,61,116,531.0,82,5.96,47,239,2579,9.5,0.420968
24310,24310,Sam Bennett,2020-21,24.0,7,12,52,52,8,4,12,82.0,651.0,364,63,65,128,613.0,70,5.96,42,208,2192,9.5,0.37826324
24311,24311,Sam Carrick,2015-16,23.0,2,2,16,16,1,1,2,17.0,104.0,16,1,1,2,17.0,82,5.32,47,251,2453,8.9,0.2102738
24312,24312,Sam Carrick,2016-17,24.0,3,0,3,3,0,0,0,4.0,34.0,19,1,1,2,21.0,82,5.34,48,255,2438,9.0,0.15552056
24313,24313,Sam Carrick,2019-20,27.0,4,1,6,6,0,1,1,5.0,61.0,25,1,2,3,26.0,82,5.96,47,239,2579,9.5,0.15437344
24314,24314,Sam Carrick,2020-21,28.0,5,2,9,9,1,1,2,16.0,124.0,34,2,3,5,42.0,70,5.96,42,208,2192,9.5,0.26540357
24315,24315,Sam Gagner,2008-09,19.0,2,49,79,79,13,36,49,135.0,1239.0,79,13,36,49,135.0,82,5.44,62,351,2383,9.4,0.62410206
24316,24316,Sam Gagner,2009-10,20.0,3,41,76,76,16,25,41,156.0,1274.0,155,29,61,90,291.0,82,5.7,65,341,2477,9.4,0.56860906
24317,24317,Sam Gagner,2010-11,21.0,4,41,68,68,15,26,41,170.0,1108.0,223,44,87,131,461.0,82,5.53,56,304,2486,9.1,0.6351771
24318,24318,Sam Gagner,2011-12,22.0,5,42,68,68,15,27,42,138.0,1207.0,291,59,114,173,599.0,82,5.46,52,291,2492,9.0,0.6328719
24319,24319,Sam Gagner,2012-13,23.0,6,47,75,75,18,29,47,149.0,1289.0,366,77,143,220,748.0,82,5.32,47,271,2439,8.9,0.6371113
24320,24320,Sam Gagner,2013-14,24.0,7,38,48,48,14,24,38,113.0,932.0,414,91,167,258,861.0,48,5.31,29,160,1399,9.1,0.7135711
24321,24321,Sam Gagner,2014-15,25.0,8,37,67,67,10,27,37,143.0,1231.0,481,101,194,295,1004.0,82,5.34,48,269,2463,8.9,0.52251893
24322,24322,Sam Gagner,2015-16,26.0,9,41,81,81,15,26,41,183.0,1397.0,562,116,220,336,1187.0,82,5.32,47,251,2453,8.9,0.5809883
24323,24323,Sam Gagner,2016-17,27.0,10,16,53,53,8,8,16,86.0,735.0,615,124,228,352,1273.0,82,5.34,48,255,2438,9.0,0.4076692
24324,24324,Sam Gagner,2017-18,28.0,11,50,81,81,18,32,50,178.0,1111.0,696,142,260,402,1451.0,82,5.45,47,245,2478,9.0,0.606488
24325,24325,Sam Gagner,2018-19,29.0,12,31,74,74,10,21,31,164.0,1118.0,770,152,281,433,1615.0,82,5.86,50,250,2620,9.2,0.4442713
24326,24326,Sam Gagner,2019-20,30.0,13,13,32,32,6,7,13,68.0,467.0,802,158,288,446,1683.0,82,5.96,47,239,2579,9.5,0.38989067
24327,24327,Sam Gagner,2020-21,31.0,14,13,42,42,6,7,13,79.0,561.0,844,164,295,459,1762.0,70,5.96,42,208,2192,9.5,0.35096186
24328,24328,Sam Lafferty,2020-21,25.0,2,13,50,50,6,7,13,56.0,481.0,50,6,7,13,56.0,70,5.96,42,208,2192,9.5,0.28563607
24329,24329,Sam Reinhart,2015-16,20.0,2,1,9,9,0,1,1,3.0,93.0,9,0,1,1,3.0,82,5.32,47,251,2453,8.9,0.25939482
24330,24330,Sam Reinhart,2016-17,21.0,3,42,79,79,23,19,42,165.0,1330.0,88,23,20,43,168.0,82,5.34,48,255,2438,9.0,0.58258814
24331,24331,Sam Reinhart,2017-18,22.0,4,47,79,79,17,30,47,178.0,1360.0,167,40,50,90,346.0,82,5.45,47,245,2478,9.0,0.64690775
24332,24332,Sam Reinhart,2018-19,23.0,5,50,82,82,25,25,50,188.0,1402.0,249,65,75,140,534.0,82,5.86,50,250,2620,9.2,0.68112075
24333,24333,Sam Reinhart,2019-20,24.0,6,65,82,82,22,43,65,180.0,1555.0,331,87,118,205,714.0,82,5.96,47,239,2579,9.5,0.8031219
24334,24334,Sam Reinhart,2020-21,25.0,7,50,69,69,22,28,50,144.0,1423.0,400,109,146,255,858.0,70,5.96,42,208,2192,9.5,0.6797577
24335,24335,Sam Steel,2019-20,21.0,2,11,22,22,6,5,11,33.0,329.0,22,6,5,11,33.0,82,5.96,47,239,2579,9.5,0.394926
24336,24336,Sam Steel,2020-21,22.0,3,22,65,65,6,16,22,85.0,1011.0,87,12,21,33,118.0,70,5.96,42,208,2192,9.5,0.36999536
24337,24337,Sami Helenius,1997-98,24.0,2,1,3,3,0,1,1,1.0,,3,0,1,1,1.0,82,5.83,55,336,2444,9.8,0.18883896
24338,24338,Sami Helenius,1999-00,26.0,3,1,8,8,1,0,1,4.0,109.0,11,1,1,2,5.0,82,5.27,57,359,2285,9.4,0.18749705
24339,24339,Sami Helenius,2000-01,27.0,4,0,33,33,0,0,0,6.0,233.0,44,1,1,2,11.0,82,5.49,53,331,2294,9.8,0.09220144
24340,24340,Sami Helenius,2001-02,28.0,5,3,57,57,1,2,3,18.0,607.0,101,2,3,5,29.0,82,5.51,63,376,2272,9.9,0.07201174
24341,24341,Sami Helenius,2002-03,29.0,6,0,39,39,0,0,0,18.0,378.0,140,2,3,5,47.0,82,5.24,53,338,2262,9.5,0.06835881
24342,24342,Sami Helenius,2003-04,30.0,7,1,15,15,0,1,1,7.0,162.0,155,2,4,6,54.0,82,5.31,60,363,2326,9.4,0.10468277
24343,24343,Sami Kapanen,1996-97,23.0,2,9,35,35,5,4,9,46.0,,35,5,4,9,46.0,82,6.29,74,413,2481,10.4,0.30894387
24344,24344,Sami Kapanen,1997-98,24.0,3,25,45,45,13,12,25,82.0,,80,18,16,34,128.0,82,5.83,55,336,2444,9.8,0.45844376
24345,24345,Sami Kapanen,1998-99,25.0,4,63,81,81,26,37,63,190.0,,161,44,53,97,318.0,82,5.28,57,380,2242,9.6,0.7172642
24346,24346,Sami Kapanen,1999-00,26.0,5,59,81,81,24,35,59,254.0,1573.0,242,68,88,156,572.0,82,5.27,57,359,2285,9.4,0.7344556
24347,24347,Sami Kapanen,2000-01,27.0,6,48,76,76,24,24,48,229.0,1512.0,318,92,112,204,801.0,82,5.49,53,331,2294,9.8,0.6432065
24348,24348,Sami Kapanen,2001-02,28.0,7,57,82,82,20,37,57,223.0,1552.0,400,112,149,261,1024.0,82,5.51,63,376,2272,9.9,0.6734377
24349,24349,Sami Kapanen,2002-03,29.0,8,69,77,77,27,42,69,248.0,1589.0,477,139,191,330,1272.0,82,5.24,53,338,2262,9.5,0.7982506
24350,24350,Sami Kapanen,2003-04,30.0,9,31,71,71,10,21,31,189.0,1342.0,548,149,212,361,1461.0,82,5.31,60,363,2326,9.4,0.5338666
24351,24351,Sami Kapanen,2004-05,31.0,10,30,74,74,12,18,30,149.0,1222.0,622,161,230,391,1610.0,82,5.14,57,348,2300,9.2,0.52932197
24352,24352,Sami Kapanen,2006-07,33.0,11,34,58,58,12,22,34,123.0,1048.0,680,173,252,425,1733.0,82,6.05,85,480,2458,10.1,0.49065775
24353,24353,Sami Kapanen,2007-08,34.0,12,25,77,77,11,14,25,129.0,1307.0,757,184,266,450,1862.0,82,5.76,70,398,2426,9.7,0.31073362
24354,24354,Sami Kapanen,2008-09,35.0,13,8,74,74,5,3,8,76.0,986.0,831,189,269,458,1938.0,82,5.44,62,351,2383,9.4,0.2285895
24355,24355,Sami Lepisto,2008-09,24.0,2,1,7,7,0,1,1,8.0,93.0,7,0,1,1,8.0,82,5.44,62,351,2383,9.4,0.18300098
24356,24356,Sami Lepisto,2009-10,25.0,3,4,7,7,0,4,4,7.0,137.0,14,0,5,5,15.0,82,5.7,65,341,2477,9.4,0.17403322
24357,24357,Sami Lepisto,2010-11,26.0,4,11,66,66,1,10,11,68.0,1203.0,80,1,15,16,83.0,82,5.53,56,304,2486,9.1,0.17639026
24358,24358,Sami Lepisto,2011-12,27.0,5,16,70,70,4,12,16,56.0,1229.0,150,5,27,32,139.0,82,5.46,52,291,2492,9.0,0.17503992
24359,24359,Sami Lepisto,2012-13,28.0,6,3,26,26,1,2,3,19.0,275.0,176,6,29,35,158.0,82,5.32,47,271,2439,8.9,0.12940073
24360,24360,Sami Niku,2018-19,22.0,2,1,1,1,1,0,1,2.0,15.0,1,1,0,1,2.0,82,5.86,50,250,2620,9.2,0.22395867
24361,24361,Sami Niku,2019-20,23.0,3,4,30,30,1,3,4,19.0,418.0,31,2,3,5,21.0,82,5.96,47,239,2579,9.5,0.1987684
24362,24362,Sami Niku,2020-21,24.0,4,5,17,17,0,5,5,27.0,275.0,48,2,8,10,48.0,70,5.96,42,208,2192,9.5,0.247098
24363,24363,Sami Salo,1999-00,25.0,2,19,61,61,7,12,19,106.0,1202.0,61,7,12,19,106.0,82,5.27,57,359,2285,9.4,0.33130175
24364,24364,Sami Salo,2000-01,26.0,3,14,37,37,6,8,14,85.0,751.0,98,13,20,33,191.0,82,5.49,53,331,2294,9.8,0.3342803
24365,24365,Sami Salo,2001-02,27.0,4,18,31,31,2,16,18,61.0,612.0,129,15,36,51,252.0,82,5.51,63,376,2272,9.9,0.38547084
24366,24366,Sami Salo,2002-03,28.0,5,18,66,66,4,14,18,122.0,1311.0,195,19,50,69,374.0,82,5.24,53,338,2262,9.5,0.3089976
24367,24367,Sami Salo,2003-04,29.0,6,30,79,79,9,21,30,126.0,1591.0,274,28,71,99,500.0,82,5.31,60,363,2326,9.4,0.36623046
24368,24368,Sami Salo,2004-05,30.0,7,26,74,74,7,19,26,143.0,1646.0,348,35,90,125,643.0,82,5.14,57,348,2300,9.2,0.4088337
24369,24369,Sami Salo,2006-07,32.0,8,33,59,59,10,23,33,140.0,1445.0,407,45,113,158,783.0,82,6.05,85,480,2458,10.1,0.48064128
24370,24370,Sami Salo,2007-08,33.0,9,37,67,67,14,23,37,143.0,1437.0,474,59,136,195,926.0,82,5.76,70,398,2426,9.7,0.44558987
24371,24371,Sami Salo,2008-09,34.0,10,25,63,63,8,17,25,122.0,1490.0,537,67,153,220,1048.0,82,5.44,62,351,2383,9.4,0.36320752
24372,24372,Sami Salo,2009-10,35.0,11,25,60,60,5,20,25,110.0,1211.0,597,72,173,245,1158.0,82,5.7,65,341,2477,9.4,0.33934698
24373,24373,Sami Salo,2010-11,36.0,12,28,68,68,9,19,28,119.0,1406.0,665,81,192,273,1277.0,82,5.53,56,304,2486,9.1,0.3137646
24374,24374,Sami Salo,2011-12,37.0,13,7,27,27,3,4,7,39.0,549.0,692,84,196,280,1316.0,82,5.46,52,291,2492,9.0,0.23333663
24375,24375,Sami Salo,2012-13,38.0,14,25,69,69,9,16,25,136.0,1411.0,761,93,212,305,1452.0,82,5.32,47,271,2439,8.9,0.3013863
24376,24376,Sami Salo,2013-14,39.0,15,17,46,46,2,15,17,48.0,965.0,807,95,227,322,1500.0,48,5.31,29,160,1399,9.1,0.290025
24377,24377,Sami Salo,2014-15,40.0,16,17,71,71,4,13,17,81.0,1292.0,878,99,240,339,1581.0,82,5.34,48,269,2463,8.9,0.19740614
24378,24378,Sami Vatanen,2013-14,22.0,2,2,8,8,2,0,2,6.0,127.0,8,2,0,2,6.0,48,5.31,29,160,1399,9.1,0.3006769
24379,24379,Sami Vatanen,2014-15,23.0,3,21,48,48,6,15,21,73.0,838.0,56,8,15,23,79.0,82,5.34,48,269,2463,8.9,0.39462095
24380,24380,Sami Vatanen,2015-16,24.0,4,37,67,67,12,25,37,122.0,1438.0,123,20,40,60,201.0,82,5.32,47,251,2453,8.9,0.46120903
24381,24381,Sami Vatanen,2016-17,25.0,5,38,71,71,9,29,38,140.0,1513.0,194,29,69,98,341.0,82,5.34,48,255,2438,9.0,0.48684233
24382,24382,Sami Vatanen,2017-18,26.0,6,24,71,71,3,21,24,117.0,1538.0,265,32,90,122,458.0,82,5.45,47,245,2478,9.0,0.3596195
24383,24383,Sami Vatanen,2018-19,27.0,7,32,72,72,4,28,32,145.0,1613.0,337,36,118,154,603.0,82,5.86,50,250,2620,9.2,0.41436043
24384,24384,Sami Vatanen,2019-20,28.0,8,17,50,50,4,13,17,107.0,1086.0,387,40,131,171,710.0,82,5.96,47,239,2579,9.5,0.35215873
24385,24385,Sami Vatanen,2020-21,29.0,9,23,47,47,5,18,23,95.0,1022.0,434,45,149,194,805.0,70,5.96,42,208,2192,9.5,0.41180918
24386,24386,Sammy Blais,2018-19,22.0,2,3,11,11,1,2,3,9.0,119.0,11,1,2,3,9.0,82,5.86,50,250,2620,9.2,0.22222555
24387,24387,Sammy Blais,2019-20,23.0,3,4,32,32,2,2,4,27.0,315.0,43,3,4,7,36.0,82,5.96,47,239,2579,9.5,0.2409086
24388,24388,Sammy Blais,2020-21,24.0,4,13,40,40,6,7,13,56.0,503.0,83,9,11,20,92.0,70,5.96,42,208,2192,9.5,0.33954114
24389,24389,Samuel Girard,2018-19,20.0,2,23,73,73,4,19,23,84.0,1288.0,73,4,19,23,84.0,82,5.86,50,250,2620,9.2,0.33794093
24390,24390,Samuel Girard,2019-20,21.0,3,27,82,82,4,23,27,116.0,1631.0,155,8,42,50,200.0,82,5.96,47,239,2579,9.5,0.37478113
24391,24391,Samuel Girard,2020-21,22.0,4,34,70,70,4,30,34,96.0,1492.0,225,12,72,84,296.0,70,5.96,42,208,2192,9.5,0.43371716
24392,24392,Samuel Henley,2017-18,24.0,2,1,1,1,1,0,1,1.0,5.0,1,1,0,1,1.0,82,5.45,47,245,2478,9.0,0.27171895
24393,24393,Samuel Morin,2017-18,22.0,2,0,1,1,0,0,0,2.0,18.0,1,0,0,0,2.0,82,5.45,47,245,2478,9.0,0.18287411
24394,24394,Samuel Morin,2018-19,23.0,3,0,2,2,0,0,0,1.0,32.0,3,0,0,0,3.0,82,5.86,50,250,2620,9.2,0.16534525
24395,24395,Samuel Morin,2019-20,24.0,4,0,5,5,0,0,0,5.0,62.0,8,0,0,0,8.0,82,5.96,47,239,2579,9.5,0.16811079
24396,24396,Samuel Morin,2020-21,25.0,5,0,1,1,0,0,0,0.0,13.0,9,0,0,0,8.0,70,5.96,42,208,2192,9.5,0.22954077
24397,24397,Samuel Pahlsson,2001-02,24.0,2,9,76,76,4,5,9,59.0,1083.0,76,4,5,9,59.0,82,5.51,63,376,2272,9.9,0.16637152
24398,24398,Samuel Pahlsson,2002-03,25.0,3,20,80,80,6,14,20,99.0,1313.0,156,10,19,29,158.0,82,5.24,53,338,2262,9.5,0.27029493
24399,24399,Samuel Pahlsson,2003-04,26.0,4,15,34,34,4,11,15,28.0,453.0,190,14,30,44,186.0,82,5.31,60,363,2326,9.4,0.2659437
24400,24400,Samuel Pahlsson,2004-05,27.0,5,22,82,82,8,14,22,134.0,1382.0,272,22,44,66,320.0,82,5.14,57,348,2300,9.2,0.36918896
24401,24401,Samuel Pahlsson,2006-07,29.0,6,21,82,82,11,10,21,116.0,1354.0,354,33,54,87,436.0,82,6.05,85,480,2458,10.1,0.24787822
24402,24402,Samuel Pahlsson,2007-08,30.0,7,26,82,82,8,18,26,111.0,1424.0,436,41,72,113,547.0,82,5.76,70,398,2426,9.7,0.29368317
24403,24403,Samuel Pahlsson,2008-09,31.0,8,15,56,56,6,9,15,94.0,1051.0,492,47,81,128,641.0,82,5.44,62,351,2383,9.4,0.2726224
24404,24404,Samuel Pahlsson,2009-10,32.0,9,18,65,65,7,11,18,88.0,1189.0,557,54,92,146,729.0,82,5.7,65,341,2477,9.4,0.2768547
24405,24405,Samuel Pahlsson,2010-11,33.0,10,16,79,79,3,13,16,93.0,1286.0,636,57,105,162,822.0,82,5.53,56,304,2486,9.1,0.23007277
24406,24406,Samuel Pahlsson,2011-12,34.0,11,20,82,82,7,13,20,108.0,1258.0,718,64,118,182,930.0,82,5.46,52,291,2492,9.0,0.24219805
24407,24407,Samuel Pahlsson,2012-13,35.0,12,17,80,80,4,13,17,93.0,1182.0,798,68,131,199,1023.0,82,5.32,47,271,2439,8.9,0.20628425
24408,24408,Sandis Ozolinsh,1993-94,21.0,2,23,37,37,7,16,23,83.0,,37,7,16,23,83.0,84,7.25,87,443,2603,11.7,0.5625595
24409,24409,Sandis Ozolinsh,1994-95,22.0,3,64,81,81,26,38,64,157.0,,118,33,54,87,240.0,84,6.48,76,407,2545,10.7,0.7218914
24410,24410,Sandis Ozolinsh,1995-96,23.0,4,25,48,48,9,16,25,83.0,,166,42,70,112,323.0,48,5.97,37,209,1408,10.2,0.58176947
24411,24411,Sandis Ozolinsh,1996-97,24.0,5,54,73,73,14,40,54,166.0,,239,56,110,166,489.0,82,6.29,74,413,2481,10.4,0.6859511
24412,24412,Sandis Ozolinsh,1997-98,25.0,6,68,80,80,23,45,68,232.0,,319,79,155,234,721.0,82,5.83,55,336,2444,9.8,0.79548585
24413,24413,Sandis Ozolinsh,1998-99,26.0,7,51,66,66,13,38,51,135.0,,385,92,193,285,856.0,82,5.28,57,380,2242,9.6,0.6981666
24414,24414,Sandis Ozolinsh,1999-00,27.0,8,32,39,39,7,25,32,81.0,862.0,424,99,218,317,937.0,82,5.27,57,359,2285,9.4,0.6757988
24415,24415,Sandis Ozolinsh,2000-01,28.0,9,52,82,82,16,36,52,210.0,1861.0,506,115,254,369,1147.0,82,5.49,53,331,2294,9.8,0.70239794
24416,24416,Sandis Ozolinsh,2001-02,29.0,10,44,72,72,12,32,44,145.0,1598.0,578,127,286,413,1292.0,82,5.51,63,376,2272,9.9,0.5335621
24417,24417,Sandis Ozolinsh,2002-03,30.0,11,52,83,83,14,38,52,172.0,2025.0,661,141,324,465,1464.0,82,5.24,53,338,2262,9.5,0.6172505
24418,24418,Sandis Ozolinsh,2003-04,31.0,12,44,82,82,12,32,44,137.0,2133.0,743,153,356,509,1601.0,82,5.31,60,363,2326,9.4,0.51858884
24419,24419,Sandis Ozolinsh,2004-05,32.0,13,16,36,36,5,11,16,58.0,718.0,779,158,367,525,1659.0,82,5.14,57,348,2300,9.2,0.54467815
24420,24420,Sandis Ozolinsh,2006-07,34.0,14,20,36,36,6,14,20,58.0,754.0,815,164,381,545,1717.0,82,6.05,85,480,2458,10.1,0.39332837
24421,24421,Sandis Ozolinsh,2007-08,35.0,15,3,21,21,0,3,3,15.0,396.0,836,164,384,548,1732.0,82,5.76,70,398,2426,9.7,0.222188
24422,24422,Sandis Ozolinsh,2008-09,36.0,16,16,39,39,3,13,16,39.0,662.0,875,167,397,564,1771.0,82,5.44,62,351,2383,9.4,0.31724936
24423,24423,Sandy Beadle,1981-82,21.0,2,1,6,6,1,0,1,7.0,,6,1,0,1,7.0,80,7.69,77,340,2441,12.6,0.2888162
24424,24424,Sandy McCarthy,1994-95,22.0,2,10,79,79,5,5,10,39.0,,79,5,5,10,39.0,84,6.48,76,407,2545,10.7,0.20759761
24425,24425,Sandy McCarthy,1995-96,23.0,3,8,37,37,5,3,8,29.0,,116,10,8,18,68.0,48,5.97,37,209,1408,10.2,0.25322518
24426,24426,Sandy McCarthy,1996-97,24.0,4,16,75,75,9,7,16,98.0,,191,19,15,34,166.0,82,6.29,74,413,2481,10.4,0.2603285
24427,24427,Sandy McCarthy,1997-98,25.0,5,8,33,33,3,5,8,38.0,,224,22,20,42,204.0,82,5.83,55,336,2444,9.8,0.22989291
24428,24428,Sandy McCarthy,1998-99,26.0,6,18,66,66,8,10,18,94.0,,290,30,30,60,298.0,82,5.28,57,380,2242,9.6,0.25942737
24429,24429,Sandy McCarthy,1999-00,27.0,7,13,80,80,5,8,13,107.0,884.0,370,35,38,73,405.0,82,5.27,57,359,2285,9.4,0.20517167
24430,24430,Sandy McCarthy,2000-01,28.0,8,11,71,71,6,5,11,80.0,702.0,441,41,43,84,485.0,82,5.49,53,331,2294,9.8,0.20809337
24431,24431,Sandy McCarthy,2001-02,29.0,9,21,81,81,11,10,21,95.0,843.0,522,52,53,105,580.0,82,5.51,63,376,2272,9.9,0.24834415
24432,24432,Sandy McCarthy,2002-03,30.0,10,23,82,82,10,13,23,90.0,696.0,604,62,66,128,670.0,82,5.24,53,338,2262,9.5,0.25903416
24433,24433,Sandy McCarthy,2003-04,31.0,11,15,82,82,6,9,15,81.0,609.0,686,68,75,143,751.0,82,5.31,60,363,2326,9.4,0.19616869
24434,24434,Sandy McCarthy,2004-05,32.0,12,5,50,50,4,1,5,38.0,365.0,736,72,76,148,789.0,82,5.14,57,348,2300,9.2,0.17180815
24435,24435,Sandy Moger,1995-96,26.0,2,8,18,18,2,6,8,32.0,,18,2,6,8,32.0,48,5.97,37,209,1408,10.2,0.3260589
24436,24436,Sandy Moger,1996-97,27.0,3,29,80,80,15,14,29,103.0,,98,17,20,37,135.0,82,6.29,74,413,2481,10.4,0.36442584
24437,24437,Sandy Moger,1997-98,28.0,4,13,34,34,10,3,13,54.0,,132,27,23,50,189.0,82,5.83,55,336,2444,9.8,0.27924055
24438,24438,Sandy Moger,1998-99,29.0,5,24,62,62,11,13,24,89.0,,194,38,36,74,278.0,82,5.28,57,380,2242,9.6,0.3317355
24439,24439,Sandy Moger,1999-00,30.0,6,5,42,42,3,2,5,28.0,433.0,236,41,38,79,306.0,82,5.27,57,359,2285,9.4,0.17677885
24440,24440,Sascha Goc,2001-02,22.0,2,0,11,11,0,0,0,7.0,150.0,11,0,0,0,7.0,82,5.51,63,376,2272,9.9,0.14623398
24441,24441,Sascha Goc,2002-03,23.0,3,0,11,11,0,0,0,4.0,89.0,22,0,0,0,11.0,82,5.24,53,338,2262,9.5,0.15685597
24442,24442,Sasha Lakovic,1997-98,26.0,2,1,19,19,0,1,1,10.0,,19,0,1,1,10.0,82,5.83,55,336,2444,9.8,0.113631845
24443,24443,Sasha Lakovic,1998-99,27.0,3,0,2,2,0,0,0,2.0,,21,0,1,1,12.0,82,5.28,57,380,2242,9.6,0.14918494
24444,24444,Sasha Lakovic,1999-00,28.0,4,3,16,16,0,3,3,10.0,101.0,37,0,4,4,22.0,82,5.27,57,359,2285,9.4,0.15500781
24445,24445,Scot Kleinendorst,1983-84,24.0,2,11,30,30,2,9,11,16.0,,30,2,9,11,16.0,80,7.73,71,310,2444,12.7,0.26196137
24446,24446,Scot Kleinendorst,1984-85,25.0,3,2,23,23,0,2,2,13.0,,53,2,11,13,29.0,80,7.89,74,336,2448,12.9,0.17280605
24447,24447,Scot Kleinendorst,1985-86,26.0,4,9,35,35,1,8,9,16.0,,88,3,19,22,45.0,80,7.77,71,321,2447,12.7,0.21391314
24448,24448,Scot Kleinendorst,1986-87,27.0,5,9,41,41,2,7,9,27.0,,129,5,26,31,72.0,80,7.94,82,370,2484,12.8,0.14374983
24449,24449,Scot Kleinendorst,1987-88,28.0,6,12,66,66,3,9,12,50.0,,195,8,35,43,122.0,80,7.34,72,344,2400,12.2,0.22327879
24450,24450,Scot Kleinendorst,1988-89,29.0,7,9,44,44,3,6,9,44.0,,239,11,41,52,166.0,80,7.43,89,437,2435,12.2,0.19937941
24451,24451,Scot Kleinendorst,1989-90,30.0,8,2,27,27,0,2,2,7.0,,266,11,43,54,173.0,80,7.48,85,403,2430,12.3,0.15905148
24452,24452,Scot Kleinendorst,1990-91,31.0,9,4,15,15,1,3,4,13.0,,281,12,46,58,186.0,80,7.37,76,367,2421,12.2,0.22490409
24453,24453,Scott Arniel,1982-83,20.0,2,9,17,17,1,8,9,18.0,,17,1,8,9,18.0,80,8.03,73,320,2489,12.9,0.3465134
24454,24454,Scott Arniel,1983-84,21.0,3,18,75,75,13,5,18,92.0,,92,14,13,27,110.0,80,7.73,71,310,2444,12.7,0.40704608
24455,24455,Scott Arniel,1984-85,22.0,4,56,80,80,21,35,56,140.0,,172,35,48,83,250.0,80,7.89,74,336,2448,12.9,0.672579
24456,24456,Scott Arniel,1985-86,23.0,5,44,79,79,22,22,44,141.0,,251,57,70,127,391.0,80,7.77,71,321,2447,12.7,0.5798148
24457,24457,Scott Arniel,1986-87,24.0,6,43,80,80,18,25,43,125.0,,331,75,95,170,516.0,80,7.94,82,370,2484,12.8,0.5015901
24458,24458,Scott Arniel,1987-88,25.0,7,25,63,63,11,14,25,90.0,,394,86,109,195,606.0,80,7.34,72,344,2400,12.2,0.42092705
24459,24459,Scott Arniel,1988-89,26.0,8,40,73,73,17,23,40,111.0,,467,103,132,235,717.0,80,7.43,89,437,2435,12.2,0.51213
24460,24460,Scott Arniel,1989-90,27.0,9,41,80,80,18,23,41,122.0,,547,121,155,276,839.0,80,7.48,85,403,2430,12.3,0.5033244
24461,24461,Scott Arniel,1990-91,28.0,10,32,79,79,18,14,32,123.0,,626,139,169,308,962.0,80,7.37,76,367,2421,12.2,0.39436024
24462,24462,Scott Arniel,1991-92,29.0,11,22,75,75,5,17,22,91.0,,701,144,186,330,1053.0,80,6.91,71,366,2385,11.6,0.29173738
24463,24463,Scott Arniel,1992-93,30.0,12,8,29,29,5,3,8,34.0,,730,149,189,338,1087.0,80,6.96,77,402,2440,11.4,0.32850605
24464,24464,Scott Barney,2003-04,24.0,2,0,5,5,0,0,0,5.0,45.0,5,0,0,0,5.0,82,5.31,60,363,2326,9.4,0.16697755
24465,24465,Scott Barney,2004-05,25.0,3,11,19,19,5,6,11,31.0,213.0,24,5,6,11,36.0,82,5.14,57,348,2300,9.2,0.29665118
24466,24466,Scott Barney,2006-07,27.0,4,0,3,3,0,0,0,4.0,20.0,27,5,6,11,40.0,82,6.05,85,480,2458,10.1,0.1495201
24467,24467,Scott Bjugstad,1984-85,23.0,2,0,5,5,0,0,0,5.0,,5,0,0,0,5.0,80,7.89,74,336,2448,12.9,0.22391903
24468,24468,Scott Bjugstad,1985-86,24.0,3,15,72,72,11,4,15,107.0,,77,11,4,15,112.0,80,7.77,71,321,2447,12.7,0.37176126
24469,24469,Scott Bjugstad,1986-87,25.0,4,76,80,80,43,33,76,217.0,,157,54,37,91,329.0,80,7.94,82,370,2484,12.8,0.7337727
24470,24470,Scott Bjugstad,1987-88,26.0,5,13,39,39,4,9,13,58.0,,196,58,46,104,387.0,80,7.34,72,344,2400,12.2,0.39839
24471,24471,Scott Bjugstad,1988-89,27.0,6,22,33,33,10,12,22,72.0,,229,68,58,126,459.0,80,7.43,89,437,2435,12.2,0.48964825
24472,24472,Scott Bjugstad,1989-90,28.0,7,3,24,24,3,0,3,21.0,,253,71,58,129,480.0,80,7.48,85,403,2430,12.3,0.33303946
24473,24473,Scott Bjugstad,1990-91,29.0,8,3,11,11,1,2,3,10.0,,264,72,60,132,490.0,80,7.37,76,367,2421,12.2,0.3499558
24474,24474,Scott Bjugstad,1991-92,30.0,9,6,31,31,2,4,6,39.0,,295,74,64,138,529.0,80,6.91,71,366,2385,11.6,0.30479535
24475,24475,Scott Bjugstad,1992-93,31.0,10,6,22,22,2,4,6,25.0,,317,76,68,144,554.0,80,6.96,77,402,2440,11.4,0.3012895
24476,24476,Scott Campbell,1980-81,23.0,2,20,63,63,3,17,20,92.0,,63,3,17,20,92.0,80,7.03,61,280,2352,12.0,0.3315086
24477,24477,Scott Campbell,1981-82,24.0,3,5,14,14,1,4,5,12.0,,77,4,21,25,104.0,80,7.69,77,340,2441,12.6,0.28779465
24478,24478,Scott Campbell,1982-83,25.0,4,0,3,3,0,0,0,0.0,,80,4,21,25,104.0,80,8.03,73,320,2489,12.9,0.21530035
24479,24479,Scott Daniels,1993-94,24.0,2,0,1,1,0,0,0,0.0,,1,0,0,0,0.0,84,7.25,87,443,2603,11.7,0.16088495
24480,24480,Scott Daniels,1995-96,26.0,3,2,12,12,0,2,2,7.0,,13,0,2,2,7.0,48,5.97,37,209,1408,10.2,0.19873685
24481,24481,Scott Daniels,1996-97,27.0,4,7,53,53,3,4,7,43.0,,66,3,6,9,50.0,82,6.29,74,413,2481,10.4,0.1492489
24482,24482,Scott Daniels,1997-98,28.0,5,8,56,56,5,3,8,48.0,,122,8,9,17,98.0,82,5.83,55,336,2444,9.8,0.13666719
24483,24483,Scott Daniels,1998-99,29.0,6,3,26,26,0,3,3,17.0,,148,8,12,20,115.0,82,5.28,57,380,2242,9.6,0.119324505
24484,24484,Scott Daniels,1999-00,30.0,7,0,1,1,0,0,0,0.0,2.0,149,8,12,20,115.0,82,5.27,57,359,2285,9.4,0.13122815
24485,24485,Scott Ferguson,1998-99,26.0,2,0,1,1,0,0,0,0.0,,1,0,0,0,0.0,82,5.28,57,380,2242,9.6,0.14913315
24486,24486,Scott Ferguson,1999-00,27.0,3,1,2,2,0,1,1,1.0,30.0,3,0,1,1,1.0,82,5.27,57,359,2285,9.4,0.17591119
24487,24487,Scott Ferguson,2001-02,29.0,4,1,20,20,0,1,1,8.0,218.0,23,0,2,2,9.0,82,5.51,63,376,2272,9.9,0.086814314
24488,24488,Scott Ferguson,2002-03,30.0,5,5,50,50,3,2,5,27.0,683.0,73,3,4,7,36.0,82,5.24,53,338,2262,9.5,0.09220523
24489,24489,Scott Ferguson,2003-04,31.0,6,8,78,78,3,5,8,45.0,959.0,151,6,9,15,81.0,82,5.31,60,363,2326,9.4,0.12548709
24490,24490,Scott Ferguson,2004-05,32.0,7,6,52,52,1,5,6,38.0,695.0,203,7,14,21,119.0,82,5.14,57,348,2300,9.2,0.1385073
24491,24491,Scott Ferguson,2006-07,34.0,8,0,15,15,0,0,0,6.0,138.0,218,7,14,21,125.0,82,6.05,85,480,2458,10.1,0.12007663
24492,24492,Scott Fraser,1996-97,24.0,2,2,14,14,2,0,2,9.0,,14,2,0,2,9.0,82,6.29,74,413,2481,10.4,0.24038503
24493,24493,Scott Fraser,1998-99,26.0,3,23,29,29,12,11,23,61.0,,43,14,11,25,70.0,82,5.28,57,380,2242,9.6,0.42120534
24494,24494,Scott Fraser,1999-00,27.0,4,6,28,28,2,4,6,35.0,283.0,71,16,15,31,105.0,82,5.27,57,359,2285,9.4,0.22814727
24495,24495,Scott Glennie,2012-13,21.0,2,0,1,1,0,0,0,0.0,10.0,1,0,0,0,0.0,82,5.32,47,271,2439,8.9,0.1915935
24496,24496,Scott Gomez,2000-01,21.0,2,70,82,82,19,51,70,204.0,1341.0,82,19,51,70,204.0,82,5.49,53,331,2294,9.8,0.9003247
24497,24497,Scott Gomez,2001-02,22.0,3,63,76,76,14,49,63,155.0,1198.0,158,33,100,133,359.0,82,5.51,63,376,2272,9.9,0.7622882
24498,24498,Scott Gomez,2002-03,23.0,4,48,76,76,10,38,48,156.0,1274.0,234,43,138,181,515.0,82,5.24,53,338,2262,9.5,0.70894915
24499,24499,Scott Gomez,2003-04,24.0,5,55,80,80,13,42,55,205.0,1281.0,314,56,180,236,720.0,82,5.31,60,363,2326,9.4,0.72980785
24500,24500,Scott Gomez,2004-05,25.0,6,70,80,80,14,56,70,189.0,1281.0,394,70,236,306,909.0,82,5.14,57,348,2300,9.2,0.963012
24501,24501,Scott Gomez,2006-07,27.0,7,84,82,82,33,51,84,244.0,1540.0,476,103,287,390,1153.0,82,6.05,85,480,2458,10.1,0.9149345
24502,24502,Scott Gomez,2007-08,28.0,8,60,72,72,13,47,60,248.0,1363.0,548,116,334,450,1401.0,82,5.76,70,398,2426,9.7,0.8220966
24503,24503,Scott Gomez,2008-09,29.0,9,70,81,81,16,54,70,242.0,1611.0,629,132,388,520,1643.0,82,5.44,62,351,2383,9.4,0.8753183
24504,24504,Scott Gomez,2009-10,30.0,10,58,77,77,16,42,58,271.0,1622.0,706,148,430,578,1914.0,82,5.7,65,341,2477,9.4,0.77226734
24505,24505,Scott Gomez,2010-11,31.0,11,59,78,78,12,47,59,180.0,1555.0,784,160,477,637,2094.0,82,5.53,56,304,2486,9.1,0.70209825
24506,24506,Scott Gomez,2011-12,32.0,12,38,80,80,7,31,38,157.0,1485.0,864,167,508,675,2251.0,82,5.46,52,291,2492,9.0,0.4980301
24507,24507,Scott Gomez,2012-13,33.0,13,11,38,38,2,9,11,59.0,537.0,902,169,517,686,2310.0,82,5.32,47,271,2439,8.9,0.34108588
24508,24508,Scott Gomez,2013-14,34.0,14,15,39,39,2,13,15,58.0,528.0,941,171,530,701,2368.0,48,5.31,29,160,1399,9.1,0.35729152
24509,24509,Scott Gomez,2014-15,35.0,15,12,46,46,2,10,12,56.0,604.0,987,173,540,713,2424.0,82,5.34,48,269,2463,8.9,0.29403353
24510,24510,Scott Gomez,2015-16,36.0,16,34,58,58,7,27,34,70.0,958.0,1045,180,567,747,2494.0,82,5.32,47,251,2453,8.9,0.40118533
24511,24511,Scott Gomez,2016-17,37.0,17,9,34,34,1,8,9,20.0,385.0,1079,181,575,756,2514.0,82,5.34,48,255,2438,9.0,0.31228727
24512,24512,Scott Gruhl,1982-83,23.0,2,3,7,7,2,1,3,8.0,,7,2,1,3,8.0,80,8.03,73,320,2489,12.9,0.35308588
24513,24513,Scott Gruhl,1983-84,24.0,3,2,7,7,0,2,2,13.0,,14,2,3,5,21.0,80,7.73,71,310,2444,12.7,0.23347983
24514,24514,Scott Gruhl,1988-89,29.0,4,1,6,6,1,0,1,7.0,,20,3,3,6,28.0,80,7.43,89,437,2435,12.2,0.20489442
24515,24515,Scott Hannan,1999-00,21.0,2,2,5,5,0,2,2,4.0,36.0,5,0,2,2,4.0,82,5.27,57,359,2285,9.4,0.23035869
24516,24516,Scott Hannan,2000-01,22.0,3,3,30,30,1,2,3,28.0,514.0,35,1,4,5,32.0,82,5.49,53,331,2294,9.8,0.20299125
24517,24517,Scott Hannan,2001-02,23.0,4,17,75,75,3,14,17,96.0,1427.0,110,4,18,22,128.0,82,5.51,63,376,2272,9.9,0.25339413
24518,24518,Scott Hannan,2002-03,24.0,5,14,75,75,2,12,14,68.0,1524.0,185,6,30,36,196.0,82,5.24,53,338,2262,9.5,0.18841183
24519,24519,Scott Hannan,2003-04,25.0,6,22,81,81,3,19,22,103.0,1965.0,266,9,49,58,299.0,82,5.31,60,363,2326,9.4,0.2647093
24520,24520,Scott Hannan,2004-05,26.0,7,21,82,82,6,15,21,114.0,1942.0,348,15,64,79,413.0,82,5.14,57,348,2300,9.2,0.27641472
24521,24521,Scott Hannan,2006-07,28.0,8,24,81,81,6,18,24,104.0,1991.0,429,21,82,103,517.0,82,6.05,85,480,2458,10.1,0.28037822
24522,24522,Scott Hannan,2007-08,29.0,9,24,79,79,4,20,24,79.0,1803.0,508,25,102,127,596.0,82,5.76,70,398,2426,9.7,0.24259391
24523,24523,Scott Hannan,2008-09,30.0,10,21,82,82,2,19,21,79.0,1860.0,590,27,121,148,675.0,82,5.44,62,351,2383,9.4,0.2224707
24524,24524,Scott Hannan,2009-10,31.0,11,10,81,81,1,9,10,70.0,1812.0,671,28,130,158,745.0,82,5.7,65,341,2477,9.4,0.13588235
24525,24525,Scott Hannan,2010-11,32.0,12,16,81,81,2,14,16,53.0,1776.0,752,30,144,174,798.0,82,5.53,56,304,2486,9.1,0.16945541
24526,24526,Scott Hannan,2011-12,33.0,13,11,78,78,1,10,11,56.0,1543.0,830,31,154,185,854.0,82,5.46,52,291,2492,9.0,0.13217285
24527,24527,Scott Hannan,2012-13,34.0,14,12,78,78,2,10,12,49.0,1588.0,908,33,164,197,903.0,82,5.32,47,271,2439,8.9,0.12484652
24528,24528,Scott Hannan,2013-14,35.0,15,1,33,33,0,1,1,25.0,639.0,941,33,165,198,928.0,48,5.31,29,160,1399,9.1,0.108487934
24529,24529,Scott Hannan,2014-15,36.0,16,12,56,56,3,9,12,52.0,995.0,997,36,174,210,980.0,82,5.34,48,269,2463,8.9,0.13963988
24530,24530,Scott Hannan,2015-16,37.0,17,7,58,58,2,5,7,53.0,946.0,1055,38,179,217,1033.0,82,5.32,47,251,2453,8.9,0.121735096
24531,24531,Scott Harlow,1988-89,25.0,2,1,1,1,0,1,1,2.0,,1,0,1,1,2.0,80,7.43,89,437,2435,12.2,0.22155422
24532,24532,Scott Harrington,2015-16,22.0,2,0,10,10,0,0,0,9.0,158.0,10,0,0,0,9.0,82,5.32,47,251,2453,8.9,0.17876622
24533,24533,Scott Harrington,2016-17,23.0,3,1,15,15,0,1,1,9.0,196.0,25,0,1,1,18.0,82,5.34,48,255,2438,9.0,0.16990444
24534,24534,Scott Harrington,2017-18,24.0,4,3,22,22,1,2,3,16.0,286.0,47,1,3,4,34.0,82,5.45,47,245,2478,9.0,0.16636854
24535,24535,Scott Harrington,2018-19,25.0,5,5,32,32,2,3,5,28.0,426.0,79,3,6,9,62.0,82,5.86,50,250,2620,9.2,0.1894851
24536,24536,Scott Harrington,2019-20,26.0,6,17,73,73,2,15,17,54.0,952.0,152,5,21,26,116.0,82,5.96,47,239,2579,9.5,0.17982072
24537,24537,Scott Harrington,2020-21,27.0,7,8,39,39,1,7,8,37.0,544.0,191,6,28,34,153.0,70,5.96,42,208,2192,9.5,0.16307104
24538,24538,Scott Hartnell,2001-02,19.0,2,16,75,75,2,14,16,92.0,818.0,75,2,14,16,92.0,82,5.51,63,376,2272,9.9,0.2772445
24539,24539,Scott Hartnell,2002-03,20.0,3,41,75,75,14,27,41,162.0,1273.0,150,16,41,57,254.0,82,5.24,53,338,2262,9.5,0.57470655
24540,24540,Scott Hartnell,2003-04,21.0,4,34,82,82,12,22,34,221.0,1254.0,232,28,63,91,475.0,82,5.31,60,363,2326,9.4,0.50946414
24541,24541,Scott Hartnell,2004-05,22.0,5,33,59,59,18,15,33,154.0,960.0,291,46,78,124,629.0,82,5.14,57,348,2300,9.2,0.6988666
24542,24542,Scott Hartnell,2006-07,24.0,6,48,81,81,25,23,48,211.0,1303.0,372,71,101,172,840.0,82,6.05,85,480,2458,10.1,0.6474712
24543,24543,Scott Hartnell,2007-08,25.0,7,39,64,64,22,17,39,150.0,1006.0,436,93,118,211,990.0,82,5.76,70,398,2426,9.7,0.6335247
24544,24544,Scott Hartnell,2008-09,26.0,8,43,80,80,24,19,43,176.0,1294.0,516,117,137,254,1166.0,82,5.44,62,351,2383,9.4,0.6001808
24545,24545,Scott Hartnell,2009-10,27.0,9,60,82,82,30,30,60,210.0,1460.0,598,147,167,314,1376.0,82,5.7,65,341,2477,9.4,0.64744186
24546,24546,Scott Hartnell,2010-11,28.0,10,44,81,81,14,30,44,171.0,1273.0,679,161,197,358,1547.0,82,5.53,56,304,2486,9.1,0.5360154
24547,24547,Scott Hartnell,2011-12,29.0,11,49,82,82,24,25,49,177.0,1362.0,761,185,222,407,1724.0,82,5.46,52,291,2492,9.0,0.6144188
24548,24548,Scott Hartnell,2012-13,30.0,12,67,82,82,37,30,67,232.0,1458.0,843,222,252,474,1956.0,82,5.32,47,271,2439,8.9,0.72226816
24549,24549,Scott Hartnell,2013-14,31.0,13,11,32,32,8,3,11,74.0,508.0,875,230,255,485,2030.0,48,5.31,29,160,1399,9.1,0.47702318
24550,24550,Scott Hartnell,2014-15,32.0,14,52,78,78,20,32,52,207.0,1317.0,953,250,287,537,2237.0,82,5.34,48,269,2463,8.9,0.56432843
24551,24551,Scott Hartnell,2015-16,33.0,15,60,77,77,28,32,60,204.0,1332.0,1030,278,319,597,2441.0,82,5.32,47,251,2453,8.9,0.6358546
24552,24552,Scott Hartnell,2016-17,34.0,16,49,79,79,23,26,49,150.0,1231.0,1109,301,345,646,2591.0,82,5.34,48,255,2438,9.0,0.51211023
24553,24553,Scott Hartnell,2017-18,35.0,17,37,78,78,13,24,37,104.0,941.0,1187,314,369,683,2695.0,82,5.45,47,245,2478,9.0,0.40692946
24554,24554,Scott Hartnell,2018-19,36.0,18,24,62,62,13,11,24,82.0,745.0,1249,327,380,707,2777.0,82,5.86,50,250,2620,9.2,0.3240669
24555,24555,Scott Howson,1985-86,25.0,2,5,8,8,4,1,5,6.0,,8,4,1,5,6.0,80,7.77,71,321,2447,12.7,0.34908336
24556,24556,Scott Howson,1986-87,26.0,3,3,10,10,1,2,3,8.0,,18,5,3,8,14.0,80,7.94,82,370,2484,12.8,0.22900373
24557,24557,Scott Jackson,2010-11,23.0,2,0,1,1,0,0,0,0.0,14.0,1,0,0,0,0.0,82,5.53,56,304,2486,9.1,0.1638569
24558,24558,Scott Kosmachuk,2016-17,23.0,2,3,8,8,0,3,3,9.0,92.0,8,0,3,3,9.0,82,5.34,48,255,2438,9.0,0.21211612
24559,24559,Scott Lachance,1992-93,20.0,2,5,17,17,1,4,5,20.0,,17,1,4,5,20.0,80,6.96,77,402,2440,11.4,0.3358451
24560,24560,Scott Lachance,1993-94,21.0,3,24,75,75,7,17,24,62.0,,92,8,21,29,82.0,84,7.25,87,443,2603,11.7,0.35889
24561,24561,Scott Lachance,1994-95,22.0,4,14,74,74,3,11,14,59.0,,166,11,32,43,141.0,84,6.48,76,407,2545,10.7,0.23037976
24562,24562,Scott Lachance,1995-96,23.0,5,13,26,26,6,7,13,56.0,,192,17,39,56,197.0,48,5.97,37,209,1408,10.2,0.4024241
24563,24563,Scott Lachance,1996-97,24.0,6,13,55,55,3,10,13,81.0,,247,20,49,69,278.0,82,6.29,74,413,2481,10.4,0.27586645
24564,24564,Scott Lachance,1997-98,25.0,7,14,81,81,3,11,14,97.0,,328,23,60,83,375.0,82,5.83,55,336,2444,9.8,0.21131241
24565,24565,Scott Lachance,1998-99,26.0,8,13,63,63,2,11,13,62.0,,391,25,71,96,437.0,82,5.28,57,380,2242,9.6,0.19352186
24566,24566,Scott Lachance,1999-00,27.0,9,11,76,76,2,9,11,59.0,1655.0,467,27,80,107,496.0,82,5.27,57,359,2285,9.4,0.19374639
24567,24567,Scott Lachance,2000-01,28.0,10,6,57,57,0,6,6,41.0,1013.0,524,27,86,113,537.0,82,5.49,53,331,2294,9.8,0.16667917
24568,24568,Scott Lachance,2001-02,29.0,11,14,76,76,3,11,14,55.0,1477.0,600,30,97,127,592.0,82,5.51,63,376,2272,9.9,0.15617946
24569,24569,Scott Lachance,2002-03,30.0,12,11,81,81,1,10,11,48.0,1623.0,681,31,107,138,640.0,82,5.24,53,338,2262,9.5,0.12742183
24570,24570,Scott Lachance,2003-04,31.0,13,1,61,61,0,1,1,35.0,1221.0,742,31,108,139,675.0,82,5.31,60,363,2326,9.4,0.114649296
24571,24571,Scott Lachance,2004-05,32.0,14,4,77,77,0,4,4,35.0,1461.0,819,31,112,143,710.0,82,5.14,57,348,2300,9.2,0.11576706
24572,24572,Scott Laughton,2013-14,19.0,2,0,5,5,0,0,0,10.0,58.0,5,0,0,0,10.0,48,5.31,29,160,1399,9.1,0.23590755
24573,24573,Scott Laughton,2015-16,21.0,3,6,31,31,2,4,6,51.0,394.0,36,2,4,6,61.0,82,5.32,47,251,2453,8.9,0.28406566
24574,24574,Scott Laughton,2016-17,22.0,4,21,71,71,7,14,21,85.0,741.0,107,9,18,27,146.0,82,5.34,48,255,2438,9.0,0.33064055
24575,24575,Scott Laughton,2017-18,23.0,5,0,2,2,0,0,0,4.0,20.0,109,9,18,27,150.0,82,5.45,47,245,2478,9.0,0.22990718
24576,24576,Scott Laughton,2018-19,24.0,6,20,81,81,10,10,20,108.0,901.0,190,19,28,47,258.0,82,5.86,50,250,2620,9.2,0.28226382
24577,24577,Scott Laughton,2019-20,25.0,7,32,82,82,12,20,32,130.0,1218.0,272,31,48,79,388.0,82,5.96,47,239,2579,9.5,0.4137953
24578,24578,Scott Laughton,2020-21,26.0,8,27,49,49,13,14,27,74.0,716.0,321,44,62,106,462.0,70,5.96,42,208,2192,9.5,0.44024795
24579,24579,Scott Lehman,2009-10,24.0,2,0,1,1,0,0,0,0.0,3.0,1,0,0,0,0.0,82,5.7,65,341,2477,9.4,0.15774
24580,24580,Scott Levins,1993-94,24.0,2,1,9,9,0,1,1,8.0,,9,0,1,1,8.0,84,7.25,87,443,2603,11.7,0.2152828
24581,24581,Scott Levins,1994-95,25.0,3,19,62,62,8,11,19,77.0,,71,8,12,20,85.0,84,6.48,76,407,2545,10.7,0.28765234
24582,24582,Scott Levins,1995-96,26.0,4,11,24,24,5,6,11,34.0,,95,13,18,31,119.0,48,5.97,37,209,1408,10.2,0.33899415
24583,24583,Scott Levins,1996-97,27.0,5,2,27,27,0,2,2,6.0,,122,13,20,33,125.0,82,6.29,74,413,2481,10.4,0.10347426
24584,24584,Scott Levins,1998-99,29.0,6,0,2,2,0,0,0,2.0,,124,13,20,33,127.0,82,5.28,57,380,2242,9.6,0.1409753
24585,24585,Scott Mayfield,2014-15,22.0,2,0,5,5,0,0,0,7.0,87.0,5,0,0,0,7.0,82,5.34,48,269,2463,8.9,0.18369669
24586,24586,Scott Mayfield,2016-17,24.0,3,1,6,6,1,0,1,4.0,103.0,11,1,0,1,11.0,82,5.34,48,255,2438,9.0,0.19139084
24587,24587,Scott Mayfield,2017-18,25.0,4,9,25,25,2,7,9,39.0,354.0,36,3,7,10,50.0,82,5.45,47,245,2478,9.0,0.2173447
24588,24588,Scott Mayfield,2018-19,26.0,5,12,47,47,2,10,12,58.0,839.0,83,5,17,22,108.0,82,5.86,50,250,2620,9.2,0.21812293
24589,24589,Scott Mayfield,2019-20,27.0,6,19,79,79,4,15,19,104.0,1480.0,162,9,32,41,212.0,82,5.96,47,239,2579,9.5,0.23258474
24590,24590,Scott Mayfield,2020-21,28.0,7,13,67,67,5,8,13,98.0,1336.0,229,14,40,54,310.0,70,5.96,42,208,2192,9.5,0.24804729
24591,24591,Scott McKay,1994-95,23.0,2,0,1,1,0,0,0,1.0,,1,0,0,0,1.0,84,6.48,76,407,2545,10.7,0.17551246
24592,24592,Scott McLellan,1983-84,20.0,2,0,2,2,0,0,0,0.0,,2,0,0,0,0.0,80,7.73,71,310,2444,12.7,0.25912797
24593,24593,Scott Mellanby,1986-87,20.0,2,0,2,2,0,0,0,0.0,,2,0,0,0,0.0,80,7.94,82,370,2484,12.8,0.24893919
24594,24594,Scott Mellanby,1987-88,21.0,3,32,71,71,11,21,32,118.0,,73,11,21,32,118.0,80,7.34,72,344,2400,12.2,0.5058408
24595,24595,Scott Mellanby,1988-89,22.0,4,51,75,75,25,26,51,190.0,,148,36,47,83,308.0,80,7.43,89,437,2435,12.2,0.7576225
24596,24596,Scott Mellanby,1989-90,23.0,5,50,76,76,21,29,50,202.0,,224,57,76,133,510.0,80,7.48,85,403,2430,12.3,0.6958687
24597,24597,Scott Mellanby,1990-91,24.0,6,23,57,57,6,17,23,104.0,,281,63,93,156,614.0,80,7.37,76,367,2421,12.2,0.44497985
24598,24598,Scott Mellanby,1991-92,25.0,7,41,74,74,20,21,41,165.0,,355,83,114,197,779.0,80,6.91,71,366,2385,11.6,0.60003906
24599,24599,Scott Mellanby,1992-93,26.0,8,50,80,80,23,27,50,159.0,,435,106,141,247,938.0,80,6.96,77,402,2440,11.4,0.61016107
24600,24600,Scott Mellanby,1993-94,27.0,9,32,69,69,15,17,32,114.0,,504,121,158,279,1052.0,84,7.25,87,443,2603,11.7,0.44645622
24601,24601,Scott Mellanby,1994-95,28.0,10,60,80,80,30,30,60,204.0,,584,151,188,339,1256.0,84,6.48,76,407,2545,10.7,0.62641156
24602,24602,Scott Mellanby,1995-96,29.0,11,25,48,48,13,12,25,130.0,,632,164,200,364,1386.0,48,5.97,37,209,1408,10.2,0.5902748
24603,24603,Scott Mellanby,1996-97,30.0,12,70,79,79,32,38,70,225.0,,711,196,238,434,1611.0,82,6.29,74,413,2481,10.4,0.7232298
24604,24604,Scott Mellanby,1997-98,31.0,13,56,82,82,27,29,56,221.0,,793,223,267,490,1832.0,82,5.83,55,336,2444,9.8,0.6241363
24605,24605,Scott Mellanby,1998-99,32.0,14,39,79,79,15,24,39,188.0,,872,238,291,529,2020.0,82,5.28,57,380,2242,9.6,0.4857948
24606,24606,Scott Mellanby,1999-00,33.0,15,45,67,67,18,27,45,136.0,1088.0,939,256,318,574,2156.0,82,5.27,57,359,2285,9.4,0.5323227
24607,24607,Scott Mellanby,2000-01,34.0,16,46,77,77,18,28,46,134.0,1144.0,1016,274,346,620,2290.0,82,5.49,53,331,2294,9.8,0.46659133
24608,24608,Scott Mellanby,2001-02,35.0,17,21,63,63,11,10,21,95.0,944.0,1079,285,356,641,2385.0,82,5.51,63,376,2272,9.9,0.30130008
24609,24609,Scott Mellanby,2002-03,36.0,18,41,64,64,15,26,41,137.0,1003.0,1143,300,382,682,2522.0,82,5.24,53,338,2262,9.5,0.5699165
24610,24610,Scott Mellanby,2003-04,37.0,19,57,80,80,26,31,57,132.0,1332.0,1223,326,413,739,2654.0,82,5.31,60,363,2326,9.4,0.57964647
24611,24611,Scott Mellanby,2004-05,38.0,20,31,68,68,14,17,31,103.0,1052.0,1291,340,430,770,2757.0,82,5.14,57,348,2300,9.2,0.48212403
24612,24612,Scott Mellanby,2006-07,40.0,21,34,71,71,12,22,34,100.0,952.0,1362,352,452,804,2857.0,82,6.05,85,480,2458,10.1,0.378962
24613,24613,Scott Mellanby,2007-08,41.0,22,36,69,69,12,24,36,103.0,947.0,1431,364,476,840,2960.0,82,5.76,70,398,2426,9.7,0.36983496
24614,24614,Scott Metcalfe,1988-89,22.0,2,1,3,3,0,1,1,1.0,,3,0,1,1,1.0,80,7.43,89,437,2435,12.2,0.23997626
24615,24615,Scott Metcalfe,1989-90,23.0,3,2,9,9,1,1,2,11.0,,12,1,2,3,12.0,80,7.48,85,403,2430,12.3,0.24951887
24616,24616,Scott Metcalfe,1990-91,24.0,4,0,7,7,0,0,0,5.0,,19,1,2,3,17.0,80,7.37,76,367,2421,12.2,0.1908099
24617,24617,Scott Morrow,1995-96,26.0,2,0,4,4,0,0,0,1.0,,4,0,0,0,1.0,48,5.97,37,209,1408,10.2,0.18043774
24618,24618,Scott Nichol,1996-97,22.0,2,0,2,2,0,0,0,4.0,,2,0,0,0,4.0,82,6.29,74,413,2481,10.4,0.18892884
24619,24619,Scott Nichol,1998-99,24.0,3,0,3,3,0,0,0,5.0,,5,0,0,0,9.0,82,5.28,57,380,2242,9.6,0.16741598
24620,24620,Scott Nichol,2002-03,28.0,4,17,60,60,8,9,17,49.0,761.0,65,8,9,17,58.0,82,5.24,53,338,2262,9.5,0.22356844
24621,24621,Scott Nichol,2003-04,29.0,5,10,68,68,5,5,10,66.0,733.0,133,13,14,27,124.0,82,5.31,60,363,2326,9.4,0.17250142
24622,24622,Scott Nichol,2004-05,30.0,6,18,75,75,7,11,18,112.0,1183.0,208,20,25,45,236.0,82,5.14,57,348,2300,9.2,0.2848128
24623,24623,Scott Nichol,2006-07,32.0,7,6,34,34,3,3,6,32.0,357.0,242,23,28,51,268.0,82,6.05,85,480,2458,10.1,0.18795443
24624,24624,Scott Nichol,2007-08,33.0,8,13,59,59,7,6,13,58.0,740.0,301,30,34,64,326.0,82,5.76,70,398,2426,9.7,0.18091258
24625,24625,Scott Nichol,2008-09,34.0,9,18,73,73,10,8,18,101.0,968.0,374,40,42,82,427.0,82,5.44,62,351,2383,9.4,0.25670964
24626,24626,Scott Nichol,2009-10,35.0,10,10,43,43,4,6,10,42.0,476.0,417,44,48,92,469.0,82,5.7,65,341,2477,9.4,0.17552215
24627,24627,Scott Nichol,2010-11,36.0,11,19,79,79,4,15,19,93.0,1032.0,496,48,63,111,562.0,82,5.53,56,304,2486,9.1,0.22258234
24628,24628,Scott Nichol,2011-12,37.0,12,7,56,56,4,3,7,61.0,546.0,552,52,66,118,623.0,82,5.46,52,291,2492,9.0,0.1431216
24629,24629,Scott Nichol,2012-13,38.0,13,8,80,80,3,5,8,67.0,745.0,632,55,71,126,690.0,82,5.32,47,271,2439,8.9,0.13784865
24630,24630,Scott Nichol,2013-14,39.0,14,1,30,30,1,0,1,13.0,293.0,662,56,71,127,703.0,48,5.31,29,160,1399,9.1,0.10754791
24631,24631,Scott Niedermayer,1992-93,19.0,2,1,4,4,0,1,1,4.0,,4,0,1,1,4.0,80,6.96,77,402,2440,11.4,0.30305094
24632,24632,Scott Niedermayer,1993-94,20.0,3,40,80,80,11,29,40,131.0,,84,11,30,41,135.0,84,7.25,87,443,2603,11.7,0.5165862
24633,24633,Scott Niedermayer,1994-95,21.0,4,46,81,81,10,36,46,135.0,,165,21,66,87,270.0,84,6.48,76,407,2545,10.7,0.51329565
24634,24634,Scott Niedermayer,1995-96,22.0,5,19,48,48,4,15,19,52.0,,213,25,81,106,322.0,48,5.97,37,209,1408,10.2,0.4570405
24635,24635,Scott Niedermayer,1996-97,23.0,6,33,79,79,8,25,33,179.0,,292,33,106,139,501.0,82,6.29,74,413,2481,10.4,0.49021384
24636,24636,Scott Niedermayer,1997-98,24.0,7,35,81,81,5,30,35,159.0,,373,38,136,174,660.0,82,5.83,55,336,2444,9.8,0.47595054
24637,24637,Scott Niedermayer,1998-99,25.0,8,57,81,81,14,43,57,175.0,,454,52,179,231,835.0,82,5.28,57,380,2242,9.6,0.6583766
24638,24638,Scott Niedermayer,1999-00,26.0,9,46,72,72,11,35,46,161.0,1776.0,526,63,214,277,996.0,82,5.27,57,359,2285,9.4,0.5784816
24639,24639,Scott Niedermayer,2000-01,27.0,10,38,71,71,7,31,38,109.0,1729.0,597,70,245,315,1105.0,82,5.49,53,331,2294,9.8,0.46190706
24640,24640,Scott Niedermayer,2001-02,28.0,11,35,57,57,6,29,35,87.0,1329.0,654,76,274,350,1192.0,82,5.51,63,376,2272,9.9,0.46337456
24641,24641,Scott Niedermayer,2002-03,29.0,12,33,76,76,11,22,33,129.0,1845.0,730,87,296,383,1321.0,82,5.24,53,338,2262,9.5,0.4432356
24642,24642,Scott Niedermayer,2003-04,30.0,13,39,81,81,11,28,39,164.0,1984.0,811,98,324,422,1485.0,82,5.31,60,363,2326,9.4,0.48597732
24643,24643,Scott Niedermayer,2004-05,31.0,14,54,81,81,14,40,54,165.0,2100.0,892,112,364,476,1650.0,82,5.14,57,348,2300,9.2,0.7150729
24644,24644,Scott Niedermayer,2006-07,33.0,15,63,82,82,13,50,63,181.0,2092.0,974,125,414,539,1831.0,82,6.05,85,480,2458,10.1,0.6954401
24645,24645,Scott Niedermayer,2007-08,34.0,16,69,79,79,15,54,69,172.0,2173.0,1053,140,468,608,2003.0,82,5.76,70,398,2426,9.7,0.65025574
24646,24646,Scott Niedermayer,2008-09,35.0,17,25,48,48,8,17,25,87.0,1148.0,1101,148,485,633,2090.0,82,5.44,62,351,2383,9.4,0.44309354
24647,24647,Scott Niedermayer,2009-10,36.0,18,59,82,82,14,45,59,178.0,2207.0,1183,162,530,692,2268.0,82,5.7,65,341,2477,9.4,0.62918633
24648,24648,Scott Niedermayer,2010-11,37.0,19,48,80,80,10,38,48,168.0,2120.0,1263,172,568,740,2436.0,82,5.53,56,304,2486,9.1,0.5210233
24649,24649,Scott Parker,1999-00,22.0,2,0,27,27,0,0,0,3.0,44.0,27,0,0,0,3.0,82,5.27,57,359,2285,9.4,0.11024088
24650,24650,Scott Parker,2001-02,24.0,3,5,69,69,2,3,5,35.0,394.0,96,2,3,5,38.0,82,5.51,63,376,2272,9.9,0.13810769
24651,24651,Scott Parker,2002-03,25.0,4,5,63,63,1,4,5,32.0,367.0,159,3,7,10,70.0,82,5.24,53,338,2262,9.5,0.11112833
24652,24652,Scott Parker,2003-04,26.0,5,4,43,43,1,3,4,20.0,269.0,202,4,10,14,90.0,82,5.31,60,363,2326,9.4,0.11195704
24653,24653,Scott Parker,2004-05,27.0,6,4,50,50,1,3,4,20.0,331.0,252,5,13,18,110.0,82,5.14,57,348,2300,9.2,0.1145713
24654,24654,Scott Parker,2006-07,29.0,7,1,10,10,1,0,1,6.0,56.0,262,6,13,19,116.0,82,6.05,85,480,2458,10.1,0.13781464
24655,24655,Scott Parker,2007-08,30.0,8,2,21,21,1,1,2,5.0,112.0,283,7,14,21,121.0,82,5.76,70,398,2426,9.7,0.07998857
24656,24656,Scott Parker,2008-09,31.0,9,0,25,25,0,0,0,5.0,92.0,308,7,14,21,126.0,82,5.44,62,351,2383,9.4,0.075642675
24657,24657,Scott Parse,2010-11,26.0,2,24,59,59,11,13,24,78.0,621.0,59,11,13,24,78.0,82,5.53,56,304,2486,9.1,0.3512148
24658,24658,Scott Parse,2011-12,27.0,3,4,5,5,1,3,4,6.0,69.0,64,12,16,28,84.0,82,5.46,52,291,2492,9.0,0.20517337
24659,24659,Scott Parse,2012-13,28.0,4,2,9,9,2,0,2,9.0,102.0,73,14,16,30,93.0,82,5.32,47,271,2439,8.9,0.2171312
24660,24660,Scott Pearson,1989-90,20.0,2,1,9,9,0,1,1,6.0,,9,0,1,1,6.0,80,7.48,85,403,2430,12.3,0.30324626
24661,24661,Scott Pearson,1990-91,21.0,3,15,41,41,5,10,15,66.0,,50,5,11,16,72.0,80,7.37,76,367,2421,12.2,0.37458348
24662,24662,Scott Pearson,1991-92,22.0,4,15,47,47,11,4,15,74.0,,97,16,15,31,146.0,80,6.91,71,366,2385,11.6,0.37583423
24663,24663,Scott Pearson,1992-93,23.0,5,3,10,10,1,2,3,14.0,,107,17,17,34,160.0,80,6.96,77,402,2440,11.4,0.31756312
24664,24664,Scott Pearson,1993-94,24.0,6,14,41,41,13,1,14,45.0,,148,30,18,48,205.0,84,7.25,87,443,2603,11.7,0.35626948
24665,24665,Scott Pearson,1994-95,25.0,7,37,72,72,19,18,37,160.0,,220,49,36,85,365.0,84,6.48,76,407,2545,10.7,0.47907835
24666,24666,Scott Pearson,1995-96,26.0,8,8,42,42,3,5,8,40.0,,262,52,41,93,405.0,48,5.97,37,209,1408,10.2,0.21510747
24667,24667,Scott Pearson,1996-97,27.0,9,4,27,27,4,0,4,26.0,,289,56,41,97,431.0,82,6.29,74,413,2481,10.4,0.2321235
24668,24668,Scott Pearson,1997-98,28.0,10,0,1,1,0,0,0,0.0,,290,56,41,97,431.0,82,5.83,55,336,2444,9.8,0.34030682
24669,24669,Scott Pearson,2000-01,31.0,11,1,2,2,0,1,1,5.0,26.0,292,56,42,98,436.0,82,5.49,53,331,2294,9.8,0.21922493
24670,24670,Scott Pellerin,1993-94,24.0,2,21,45,45,10,11,21,60.0,,45,10,11,21,60.0,84,7.25,87,443,2603,11.7,0.35958302
24671,24671,Scott Pellerin,1994-95,25.0,3,0,1,1,0,0,0,0.0,,46,10,11,21,60.0,84,6.48,76,407,2545,10.7,0.17043763
24672,24672,Scott Pellerin,1996-97,27.0,4,3,6,6,2,1,3,9.0,,52,12,12,24,69.0,82,6.29,74,413,2481,10.4,0.23154622
24673,24673,Scott Pellerin,1997-98,28.0,5,18,54,54,8,10,18,76.0,,106,20,22,42,145.0,82,5.83,55,336,2444,9.8,0.34552035
24674,24674,Scott Pellerin,1998-99,29.0,6,29,80,80,8,21,29,96.0,,186,28,43,71,241.0,82,5.28,57,380,2242,9.6,0.33342415
24675,24675,Scott Pellerin,1999-00,30.0,7,41,80,80,20,21,41,138.0,1384.0,266,48,64,112,379.0,82,5.27,57,359,2285,9.4,0.47367758
24676,24676,Scott Pellerin,2000-01,31.0,8,23,80,80,8,15,23,120.0,1183.0,346,56,79,135,499.0,82,5.49,53,331,2294,9.8,0.29818606
24677,24677,Scott Pellerin,2001-02,32.0,9,44,77,77,11,33,44,138.0,1353.0,423,67,112,179,637.0,82,5.51,63,376,2272,9.9,0.43340796
24678,24678,Scott Pellerin,2002-03,33.0,10,14,68,68,4,10,14,63.0,711.0,491,71,122,193,700.0,82,5.24,53,338,2262,9.5,0.20191824
24679,24679,Scott Pellerin,2003-04,34.0,11,5,43,43,1,4,5,37.0,433.0,534,72,126,198,737.0,82,5.31,60,363,2326,9.4,0.16165957
24680,24680,Scott Pellerin,2004-05,35.0,12,0,2,2,0,0,0,1.0,28.0,536,72,126,198,738.0,82,5.14,57,348,2300,9.2,0.2420589
24681,24681,Scott Robinson,1990-91,26.0,2,0,1,1,0,0,0,0.0,,1,0,0,0,0.0,80,7.37,76,367,2421,12.2,0.17421168
24682,24682,Scott Sabourin,2020-21,28.0,2,6,35,35,2,4,6,29.0,246.0,35,2,4,6,29.0,70,5.96,42,208,2192,9.5,0.20699391
24683,24683,Scott Sandelin,1987-88,23.0,2,0,1,1,0,0,0,0.0,,1,0,0,0,0.0,80,7.34,72,344,2400,12.2,0.19904593
24684,24684,Scott Sandelin,1988-89,24.0,3,1,8,8,0,1,1,5.0,,9,0,1,1,5.0,80,7.43,89,437,2435,12.2,0.21655422
24685,24685,Scott Sandelin,1991-92,27.0,4,3,15,15,0,3,3,4.0,,24,0,4,4,9.0,80,6.91,71,366,2385,11.6,0.17882514
24686,24686,Scott Sandelin,1992-93,28.0,5,0,1,1,0,0,0,1.0,,25,0,4,4,10.0,80,6.96,77,402,2440,11.4,0.17028746
24687,24687,Scott Scissons,1991-92,20.0,2,0,1,1,0,0,0,1.0,,1,0,0,0,1.0,80,6.91,71,366,2385,11.6,0.26589626
24688,24688,Scott Scissons,1994-95,23.0,3,0,1,1,0,0,0,0.0,,2,0,0,0,1.0,84,6.48,76,407,2545,10.7,0.16552785
24689,24689,Scott Shaunessy,1987-88,24.0,2,0,3,3,0,0,0,0.0,,3,0,0,0,0.0,80,7.34,72,344,2400,12.2,0.18592632
24690,24690,Scott Shaunessy,1989-90,26.0,3,0,4,4,0,0,0,0.0,,7,0,0,0,0.0,80,7.48,85,403,2430,12.3,0.15626073
24691,24691,Scott Stevens,1983-84,19.0,2,25,77,77,9,16,25,121.0,,77,9,16,25,121.0,80,7.73,71,310,2444,12.7,0.44278258
24692,24692,Scott Stevens,1984-85,20.0,3,45,78,78,13,32,45,155.0,,155,22,48,70,276.0,80,7.89,74,336,2448,12.9,0.6141937
24693,24693,Scott Stevens,1985-86,21.0,4,65,80,80,21,44,65,170.0,,235,43,92,135,446.0,80,7.77,71,321,2447,12.7,0.8195708
24694,24694,Scott Stevens,1986-87,22.0,5,53,73,73,15,38,53,121.0,,308,58,130,188,567.0,80,7.94,82,370,2484,12.8,0.72487736
24695,24695,Scott Stevens,1987-88,23.0,6,61,77,77,10,51,61,163.0,,385,68,181,249,730.0,80,7.34,72,344,2400,12.2,0.7473753
24696,24696,Scott Stevens,1988-89,24.0,7,72,80,80,12,60,72,231.0,,465,80,241,321,961.0,80,7.43,89,437,2435,12.2,0.84591645
24697,24697,Scott Stevens,1989-90,25.0,8,68,80,80,7,61,68,195.0,,545,87,302,389,1156.0,80,7.48,85,403,2430,12.3,0.7898209
24698,24698,Scott Stevens,1990-91,26.0,9,40,56,56,11,29,40,143.0,,601,98,331,429,1299.0,80,7.37,76,367,2421,12.2,0.672199
24699,24699,Scott Stevens,1991-92,27.0,10,49,78,78,5,44,49,160.0,,679,103,375,478,1459.0,80,6.91,71,366,2385,11.6,0.59971833
24700,24700,Scott Stevens,1992-93,28.0,11,59,68,68,17,42,59,156.0,,747,120,417,537,1615.0,80,6.96,77,402,2440,11.4,0.83199304
24701,24701,Scott Stevens,1993-94,29.0,12,57,81,81,12,45,57,146.0,,828,132,462,594,1761.0,84,7.25,87,443,2603,11.7,0.66580045
24702,24702,Scott Stevens,1994-95,30.0,13,78,83,83,18,60,78,215.0,,911,150,522,672,1976.0,84,6.48,76,407,2545,10.7,0.7516949
24703,24703,Scott Stevens,1995-96,31.0,14,22,48,48,2,20,22,111.0,,959,152,542,694,2087.0,48,5.97,37,209,1408,10.2,0.47049066
24704,24704,Scott Stevens,1996-97,32.0,15,28,82,82,5,23,28,174.0,,1041,157,565,722,2261.0,82,6.29,74,413,2481,10.4,0.36351544
24705,24705,Scott Stevens,1997-98,33.0,16,24,79,79,5,19,24,166.0,,1120,162,584,746,2427.0,82,5.83,55,336,2444,9.8,0.30357155
24706,24706,Scott Stevens,1998-99,34.0,17,26,80,80,4,22,26,94.0,,1200,166,606,772,2521.0,82,5.28,57,380,2242,9.6,0.29234076
24707,24707,Scott Stevens,1999-00,35.0,18,27,75,75,5,22,27,111.0,1814.0,1275,171,628,799,2632.0,82,5.27,57,359,2285,9.4,0.32259887
24708,24708,Scott Stevens,2000-01,36.0,19,29,78,78,8,21,29,133.0,1824.0,1353,179,649,828,2765.0,82,5.49,53,331,2294,9.8,0.35187805
24709,24709,Scott Stevens,2001-02,37.0,20,31,81,81,9,22,31,171.0,1994.0,1434,188,671,859,2936.0,82,5.51,63,376,2272,9.9,0.38489908
24710,24710,Scott Stevens,2002-03,38.0,21,17,82,82,1,16,17,121.0,1912.0,1516,189,687,876,3057.0,82,5.24,53,338,2262,9.5,0.25175864
24711,24711,Scott Stevens,2003-04,39.0,22,20,81,81,4,16,20,113.0,1870.0,1597,193,703,896,3170.0,82,5.31,60,363,2326,9.4,0.25902578
24712,24712,Scott Stevens,2004-05,40.0,23,12,38,38,3,9,12,68.0,913.0,1635,196,712,908,3238.0,82,5.14,57,348,2300,9.2,0.35220408
24713,24713,Scott Thomas,1993-94,24.0,2,2,7,7,1,1,2,4.0,,7,1,1,2,4.0,84,7.25,87,443,2603,11.7,0.24548286
24714,24714,Scott Thomas,1994-95,25.0,3,4,32,32,2,2,4,26.0,,39,3,3,6,30.0,84,6.48,76,407,2545,10.7,0.20489979
24715,24715,Scott Thomas,2001-02,32.0,4,4,24,24,3,1,4,16.0,195.0,63,6,4,10,46.0,82,5.51,63,376,2272,9.9,0.1781722
24716,24716,Scott Thornton,1991-92,21.0,2,4,33,33,1,3,4,31.0,,33,1,3,4,31.0,80,6.91,71,366,2385,11.6,0.2554838
24717,24717,Scott Thornton,1992-93,22.0,3,1,15,15,0,1,1,11.0,,48,1,4,5,42.0,80,6.96,77,402,2440,11.4,0.20956233
24718,24718,Scott Thornton,1993-94,23.0,4,1,9,9,0,1,1,7.0,,57,1,5,6,49.0,84,7.25,87,443,2603,11.7,0.1897929
24719,24719,Scott Thornton,1994-95,24.0,5,11,61,61,4,7,11,65.0,,118,5,12,17,114.0,84,6.48,76,407,2545,10.7,0.22643161
24720,24720,Scott Thornton,1995-96,25.0,6,22,47,47,10,12,22,69.0,,165,15,24,39,183.0,48,5.97,37,209,1408,10.2,0.36162254
24721,24721,Scott Thornton,1996-97,26.0,7,18,77,77,9,9,18,95.0,,242,24,33,57,278.0,82,6.29,74,413,2481,10.4,0.24842271
24722,24722,Scott Thornton,1997-98,27.0,8,20,73,73,10,10,20,110.0,,315,34,43,77,388.0,82,5.83,55,336,2444,9.8,0.26217228
24723,24723,Scott Thornton,1998-99,28.0,9,15,67,67,6,9,15,51.0,,382,40,52,92,439.0,82,5.28,57,380,2242,9.6,0.18921652
24724,24724,Scott Thornton,1999-00,29.0,10,11,47,47,7,4,11,56.0,583.0,429,47,56,103,495.0,82,5.27,57,359,2285,9.4,0.23419705
24725,24725,Scott Thornton,2000-01,30.0,11,14,65,65,8,6,14,83.0,835.0,494,55,62,117,578.0,82,5.49,53,331,2294,9.8,0.19528913
24726,24726,Scott Thornton,2001-02,31.0,12,36,73,73,19,17,36,159.0,1015.0,567,74,79,153,737.0,82,5.51,63,376,2272,9.9,0.38304844
24727,24727,Scott Thornton,2002-03,32.0,13,42,77,77,26,16,42,144.0,1041.0,644,100,95,195,881.0,82,5.24,53,338,2262,9.5,0.45426762
24728,24728,Scott Thornton,2003-04,33.0,14,21,41,41,9,12,21,64.0,569.0,685,109,107,216,945.0,82,5.31,60,363,2326,9.4,0.3593555
24729,24729,Scott Thornton,2004-05,34.0,15,27,80,80,13,14,27,127.0,1116.0,765,122,121,243,1072.0,82,5.14,57,348,2300,9.2,0.30314714
24730,24730,Scott Thornton,2006-07,36.0,16,21,71,71,10,11,21,122.0,945.0,836,132,132,264,1194.0,82,6.05,85,480,2458,10.1,0.23670074
24731,24731,Scott Thornton,2007-08,37.0,17,13,58,58,7,6,13,65.0,719.0,894,139,138,277,1259.0,82,5.76,70,398,2426,9.7,0.17538369
24732,24732,Scott Thornton,2008-09,38.0,18,8,47,47,5,3,8,35.0,413.0,941,144,141,285,1294.0,82,5.44,62,351,2383,9.4,0.1488609
24733,24733,Scott Timmins,2011-12,22.0,2,1,19,19,1,0,1,13.0,206.0,19,1,0,1,13.0,82,5.46,52,291,2492,9.0,0.15078178
24734,24734,Scott Timmins,2013-14,24.0,3,0,5,5,0,0,0,6.0,53.0,24,1,0,1,19.0,48,5.31,29,160,1399,9.1,0.1800617
24735,24735,Scott Walker,1995-96,22.0,2,1,11,11,0,1,1,8.0,,11,0,1,1,8.0,48,5.97,37,209,1408,10.2,0.20824936
24736,24736,Scott Walker,1996-97,23.0,3,12,63,63,4,8,12,45.0,,74,4,9,13,53.0,82,6.29,74,413,2481,10.4,0.19463977
24737,24737,Scott Walker,1997-98,24.0,4,18,64,64,3,15,18,55.0,,138,7,24,31,108.0,82,5.83,55,336,2444,9.8,0.22021577
24738,24738,Scott Walker,1998-99,25.0,5,13,59,59,3,10,13,40.0,,197,10,34,44,148.0,82,5.28,57,380,2242,9.6,0.21673924
24739,24739,Scott Walker,1999-00,26.0,6,40,71,71,15,25,40,96.0,1161.0,268,25,59,84,244.0,82,5.27,57,359,2285,9.4,0.47043788
24740,24740,Scott Walker,2000-01,27.0,7,28,69,69,7,21,28,98.0,1092.0,337,32,80,112,342.0,82,5.49,53,331,2294,9.8,0.397035
24741,24741,Scott Walker,2001-02,28.0,8,54,74,74,25,29,54,159.0,1427.0,411,57,109,166,501.0,82,5.51,63,376,2272,9.9,0.58114326
24742,24742,Scott Walker,2002-03,29.0,9,9,28,28,4,5,9,46.0,522.0,439,61,114,175,547.0,82,5.24,53,338,2262,9.5,0.31726208
24743,24743,Scott Walker,2003-04,30.0,10,33,60,60,15,18,33,124.0,1190.0,499,76,132,208,671.0,82,5.31,60,363,2326,9.4,0.45684075
24744,24744,Scott Walker,2004-05,31.0,11,67,75,75,25,42,67,157.0,1504.0,574,101,174,275,828.0,82,5.14,57,348,2300,9.2,0.6991235
24745,24745,Scott Walker,2006-07,33.0,12,16,33,33,5,11,16,57.0,574.0,607,106,185,291,885.0,82,6.05,85,480,2458,10.1,0.34367117
24746,24746,Scott Walker,2007-08,34.0,13,51,81,81,21,30,51,183.0,1310.0,688,127,215,342,1068.0,82,5.76,70,398,2426,9.7,0.54446983
24747,24747,Scott Walker,2008-09,35.0,14,32,58,58,14,18,32,122.0,964.0,746,141,233,374,1190.0,82,5.44,62,351,2383,9.4,0.44258556
24748,24748,Scott Walker,2009-10,36.0,15,15,41,41,5,10,15,71.0,547.0,787,146,243,389,1261.0,82,5.7,65,341,2477,9.4,0.26793665
24749,24749,Scott Walker,2010-11,37.0,16,8,42,42,5,3,8,63.0,407.0,829,151,246,397,1324.0,82,5.53,56,304,2486,9.1,0.1743651
24750,24750,Scott Wilson,2015-16,23.0,2,0,1,1,0,0,0,0.0,4.0,1,0,0,0,0.0,82,5.32,47,251,2453,8.9,0.14718214
24751,24751,Scott Wilson,2016-17,24.0,3,6,24,24,5,1,6,39.0,256.0,25,5,1,6,39.0,82,5.34,48,255,2438,9.0,0.25581333
24752,24752,Scott Wilson,2017-18,25.0,4,26,78,78,8,18,26,127.0,854.0,103,13,19,32,166.0,82,5.45,47,245,2478,9.0,0.32731095
24753,24753,Scott Wilson,2018-19,26.0,5,14,69,69,6,8,14,98.0,842.0,172,19,27,46,264.0,82,5.86,50,250,2620,9.2,0.2333369
24754,24754,Scott Wilson,2019-20,27.0,6,3,15,15,0,3,3,25.0,172.0,187,19,30,49,289.0,82,5.96,47,239,2579,9.5,0.21633095
24755,24755,Scott Wilson,2020-21,28.0,7,2,6,6,1,1,2,8.0,70.0,193,20,31,51,297.0,70,5.96,42,208,2192,9.5,0.20792034
24756,24756,Scott Young,1988-89,21.0,2,0,7,7,0,0,0,6.0,,7,0,0,0,6.0,80,7.43,89,437,2435,12.2,0.25452688
24757,24757,Scott Young,1989-90,22.0,3,59,76,76,19,40,59,203.0,,83,19,40,59,209.0,80,7.48,85,403,2430,12.3,0.75430536
24758,24758,Scott Young,1990-91,23.0,4,64,80,80,24,40,64,239.0,,163,43,80,123,448.0,80,7.37,76,367,2421,12.2,0.77409804
24759,24759,Scott Young,1991-92,24.0,5,42,77,77,17,25,42,210.0,,240,60,105,165,658.0,80,6.91,71,366,2385,11.6,0.6971776
24760,24760,Scott Young,1993-94,26.0,6,60,82,82,30,30,60,225.0,,322,90,135,225,883.0,84,7.25,87,443,2603,11.7,0.6613632
24761,24761,Scott Young,1994-95,27.0,7,51,76,76,26,25,51,236.0,,398,116,160,276,1119.0,84,6.48,76,407,2545,10.7,0.60816747
24762,24762,Scott Young,1995-96,28.0,8,39,48,48,18,21,39,167.0,,446,134,181,315,1286.0,48,5.97,37,209,1408,10.2,0.84469867
24763,24763,Scott Young,1996-97,29.0,9,60,81,81,21,39,60,229.0,,527,155,220,375,1515.0,82,6.29,74,413,2481,10.4,0.68482566
24764,24764,Scott Young,1997-98,30.0,10,37,72,72,18,19,37,164.0,,599,173,239,412,1679.0,82,5.83,55,336,2444,9.8,0.48795906
24765,24765,Scott Young,1998-99,31.0,11,33,73,73,13,20,33,187.0,,672,186,259,445,1866.0,82,5.28,57,380,2242,9.6,0.5026135
24766,24766,Scott Young,1999-00,32.0,12,52,75,75,24,28,52,205.0,1143.0,747,210,287,497,2071.0,82,5.27,57,359,2285,9.4,0.60613203
24767,24767,Scott Young,2000-01,33.0,13,39,75,75,24,15,39,244.0,1208.0,822,234,302,536,2315.0,82,5.49,53,331,2294,9.8,0.5812252
24768,24768,Scott Young,2001-02,34.0,14,73,81,81,40,33,73,321.0,1563.0,903,274,335,609,2636.0,82,5.51,63,376,2272,9.9,0.7571268
24769,24769,Scott Young,2002-03,35.0,15,41,67,67,19,22,41,210.0,1240.0,970,293,357,650,2846.0,82,5.24,53,338,2262,9.5,0.58507323
24770,24770,Scott Young,2003-04,36.0,16,42,79,79,23,19,42,237.0,1275.0,1049,316,376,692,3083.0,82,5.31,60,363,2326,9.4,0.49620003
24771,24771,Scott Young,2004-05,37.0,17,16,53,53,8,8,16,134.0,782.0,1102,324,384,708,3217.0,82,5.14,57,348,2300,9.2,0.5669756
24772,24772,Scott Young,2006-07,39.0,18,49,79,79,18,31,49,284.0,1452.0,1181,342,415,757,3501.0,82,6.05,85,480,2458,10.1,0.5738861
24773,24773,Scottie Upshall,2003-04,20.0,2,1,8,8,1,0,1,6.0,70.0,8,1,0,1,6.0,82,5.31,60,363,2326,9.4,0.26431626
24774,24774,Scottie Upshall,2004-05,21.0,3,1,7,7,0,1,1,6.0,64.0,15,1,1,2,12.0,82,5.14,57,348,2300,9.2,0.25284266
24775,24775,Scottie Upshall,2006-07,23.0,4,23,48,48,8,15,23,72.0,501.0,63,9,16,25,84.0,82,6.05,85,480,2458,10.1,0.42935273
24776,24776,Scottie Upshall,2007-08,24.0,5,16,32,32,8,8,16,87.0,472.0,95,17,24,41,171.0,82,5.76,70,398,2426,9.7,0.41453925
24777,24777,Scottie Upshall,2008-09,25.0,6,30,61,61,14,16,30,128.0,814.0,156,31,40,71,299.0,82,5.44,62,351,2383,9.4,0.46550897
24778,24778,Scottie Upshall,2009-10,26.0,7,34,74,74,15,19,34,192.0,1080.0,230,46,59,105,491.0,82,5.7,65,341,2477,9.4,0.47798878
24779,24779,Scottie Upshall,2010-11,27.0,8,32,49,49,18,14,32,119.0,737.0,279,64,73,137,610.0,82,5.53,56,304,2486,9.1,0.52076244
24780,24780,Scottie Upshall,2011-12,28.0,9,34,82,82,22,12,34,191.0,1151.0,361,86,85,171,801.0,82,5.46,52,291,2492,9.0,0.4348352
24781,24781,Scottie Upshall,2012-13,29.0,10,5,26,26,2,3,5,53.0,331.0,387,88,88,176,854.0,82,5.32,47,271,2439,8.9,0.28894964
24782,24782,Scottie Upshall,2013-14,30.0,11,5,27,27,4,1,5,54.0,364.0,414,92,89,181,908.0,48,5.31,29,160,1399,9.1,0.31709808
24783,24783,Scottie Upshall,2014-15,31.0,12,37,76,76,15,22,37,161.0,1210.0,490,107,111,218,1069.0,82,5.34,48,269,2463,8.9,0.4369707
24784,24784,Scottie Upshall,2015-16,32.0,13,15,63,63,8,7,15,93.0,799.0,553,115,118,233,1162.0,82,5.32,47,251,2453,8.9,0.23105362
24785,24785,Scottie Upshall,2016-17,33.0,14,14,70,70,6,8,14,113.0,766.0,623,121,126,247,1275.0,82,5.34,48,255,2438,9.0,0.20514438
24786,24786,Scottie Upshall,2017-18,34.0,15,18,73,73,10,8,18,85.0,802.0,696,131,134,265,1360.0,82,5.45,47,245,2478,9.0,0.22211325
24787,24787,Scottie Upshall,2018-19,35.0,16,19,63,63,7,12,19,71.0,684.0,759,138,146,284,1431.0,82,5.86,50,250,2620,9.2,0.22675058
24788,24788,Sean Avery,2002-03,22.0,2,4,36,36,2,2,4,30.0,283.0,36,2,2,4,30.0,82,5.24,53,338,2262,9.5,0.22120592
24789,24789,Sean Avery,2003-04,23.0,3,15,51,51,6,9,15,59.0,441.0,87,8,11,19,89.0,82,5.31,60,363,2326,9.4,0.31118488
24790,24790,Sean Avery,2004-05,24.0,4,28,76,76,9,19,28,125.0,889.0,163,17,30,47,214.0,82,5.14,57,348,2300,9.2,0.39857438
24791,24791,Sean Avery,2006-07,26.0,5,39,75,75,15,24,39,189.0,1021.0,238,32,54,86,403.0,82,6.05,85,480,2458,10.1,0.51693565
24792,24792,Sean Avery,2007-08,27.0,6,48,84,84,18,30,48,249.0,1444.0,322,50,84,134,652.0,82,5.76,70,398,2426,9.7,0.55249774
24793,24793,Sean Avery,2008-09,28.0,7,33,57,57,15,18,33,125.0,903.0,379,65,102,167,777.0,82,5.44,62,351,2383,9.4,0.5219081
24794,24794,Sean Avery,2009-10,29.0,8,22,41,41,8,14,22,99.0,646.0,420,73,116,189,876.0,82,5.7,65,341,2477,9.4,0.49423268
24795,24795,Sean Avery,2010-11,30.0,9,31,69,69,11,20,31,139.0,923.0,489,84,136,220,1015.0,82,5.53,56,304,2486,9.1,0.40564775
24796,24796,Sean Avery,2011-12,31.0,10,24,76,76,3,21,24,137.0,854.0,565,87,157,244,1152.0,82,5.46,52,291,2492,9.0,0.2909965
24797,24797,Sean Avery,2012-13,32.0,11,3,15,15,3,0,3,15.0,105.0,580,90,157,247,1167.0,82,5.32,47,271,2439,8.9,0.26738885
24798,24798,Sean Bentivoglio,2009-10,24.0,2,0,1,1,0,0,0,2.0,12.0,1,0,0,0,2.0,82,5.7,65,341,2477,9.4,0.17479372
24799,24799,Sean Bergenheim,2004-05,20.0,2,2,18,18,1,1,2,12.0,161.0,18,1,1,2,12.0,82,5.14,57,348,2300,9.2,0.2708568
24800,24800,Sean Bergenheim,2006-07,22.0,3,9,28,28,4,5,9,63.0,372.0,46,5,6,11,75.0,82,6.05,85,480,2458,10.1,0.29289407
24801,24801,Sean Bergenheim,2008-09,24.0,4,22,78,78,10,12,22,155.0,878.0,124,15,18,33,230.0,82,5.44,62,351,2383,9.4,0.31072235
24802,24802,Sean Bergenheim,2009-10,25.0,5,24,59,59,15,9,24,152.0,841.0,183,30,27,57,382.0,82,5.7,65,341,2477,9.4,0.44402623
24803,24803,Sean Bergenheim,2010-11,26.0,6,23,63,63,10,13,23,133.0,886.0,246,40,40,80,515.0,82,5.53,56,304,2486,9.1,0.35570097
24804,24804,Sean Bergenheim,2011-12,27.0,7,29,80,80,14,15,29,182.0,1118.0,326,54,55,109,697.0,82,5.46,52,291,2492,9.0,0.3931421
24805,24805,Sean Bergenheim,2012-13,28.0,8,23,62,62,17,6,23,185.0,1018.0,388,71,61,132,882.0,82,5.32,47,271,2439,8.9,0.36915994
24806,24806,Sean Bergenheim,2014-15,30.0,9,29,62,62,16,13,29,190.0,1023.0,450,87,74,161,1072.0,82,5.34,48,269,2463,8.9,0.43738562
24807,24807,Sean Bergenheim,2015-16,31.0,10,19,56,56,9,10,19,108.0,735.0,506,96,84,180,1180.0,82,5.32,47,251,2453,8.9,0.33386636
24808,24808,Sean Brown,1997-98,21.0,2,0,5,5,0,0,0,2.0,,5,0,0,0,2.0,82,5.83,55,336,2444,9.8,0.20066962
24809,24809,Sean Brown,1998-99,22.0,3,1,18,18,0,1,1,9.0,,23,0,1,1,11.0,82,5.28,57,380,2242,9.6,0.16699561
24810,24810,Sean Brown,1999-00,23.0,4,7,51,51,0,7,7,27.0,624.0,74,0,8,8,38.0,82,5.27,57,359,2285,9.4,0.13459861
24811,24811,Sean Brown,2000-01,24.0,5,12,72,72,4,8,12,36.0,914.0,146,4,16,20,74.0,82,5.49,53,331,2294,9.8,0.15779114
24812,24812,Sean Brown,2001-02,25.0,6,5,62,62,2,3,5,30.0,690.0,208,6,19,25,104.0,82,5.51,63,376,2272,9.9,0.11609349
24813,24813,Sean Brown,2002-03,26.0,7,11,73,73,6,5,11,64.0,965.0,281,12,24,36,168.0,82,5.24,53,338,2262,9.5,0.16568384
24814,24814,Sean Brown,2003-04,27.0,8,6,69,69,1,5,6,39.0,444.0,350,13,29,42,207.0,82,5.31,60,363,2326,9.4,0.12656933
24815,24815,Sean Brown,2004-05,28.0,9,3,39,39,0,3,3,25.0,544.0,389,13,32,45,232.0,82,5.14,57,348,2300,9.2,0.14769089
24816,24816,Sean Brown,2006-07,30.0,10,12,47,47,1,11,12,49.0,709.0,436,14,43,57,281.0,82,6.05,85,480,2458,10.1,0.16433176
24817,24817,Sean Collins,2009-10,26.0,2,2,15,15,1,1,2,14.0,218.0,15,1,1,2,14.0,82,5.7,65,341,2477,9.4,0.19517925
24818,24818,Sean Collins,2011-12,28.0,3,1,4,4,1,0,1,4.0,59.0,19,2,1,3,18.0,82,5.46,52,291,2492,9.0,0.16910952
24819,24819,Sean Collins,2012-13,29.0,4,0,2,2,0,0,0,3.0,22.0,21,2,1,3,21.0,82,5.32,47,271,2439,8.9,0.1380556
24820,24820,Sean Collins0,2013-14,25.0,2,0,5,5,0,0,0,0.0,62.0,5,0,0,0,0.0,48,5.31,29,160,1399,9.1,0.17027318
24821,24821,Sean Collins0,2014-15,26.0,3,1,6,6,0,1,1,6.0,49.0,11,0,1,1,6.0,82,5.34,48,269,2463,8.9,0.17249674
24822,24822,Sean Collins0,2015-16,27.0,4,2,8,8,0,2,2,4.0,83.0,19,0,3,3,10.0,82,5.32,47,251,2453,8.9,0.15261617
24823,24823,Sean Collins0,2016-17,28.0,5,0,2,2,0,0,0,0.0,17.0,21,0,3,3,10.0,82,5.34,48,255,2438,9.0,0.12762803
24824,24824,Sean Couturier,2012-13,20.0,2,27,77,77,13,14,27,116.0,1089.0,77,13,14,27,116.0,82,5.32,47,271,2439,8.9,0.39967516
24825,24825,Sean Couturier,2013-14,21.0,3,15,46,46,4,11,15,75.0,731.0,123,17,25,42,191.0,48,5.31,29,160,1399,9.1,0.4168536
24826,24826,Sean Couturier,2014-15,22.0,4,39,82,82,13,26,39,165.0,1565.0,205,30,51,81,356.0,82,5.34,48,269,2463,8.9,0.5247911
24827,24827,Sean Couturier,2015-16,23.0,5,37,82,82,15,22,37,148.0,1508.0,287,45,73,118,504.0,82,5.32,47,251,2453,8.9,0.53365827
24828,24828,Sean Couturier,2016-17,24.0,6,39,63,63,11,28,39,119.0,1172.0,350,56,101,157,623.0,82,5.34,48,255,2438,9.0,0.5527581
24829,24829,Sean Couturier,2017-18,25.0,7,34,66,66,14,20,34,120.0,1217.0,416,70,121,191,743.0,82,5.45,47,245,2478,9.0,0.4893
24830,24830,Sean Couturier,2018-19,26.0,8,76,82,82,31,45,76,227.0,1771.0,498,101,166,267,970.0,82,5.86,50,250,2620,9.2,0.8744157
24831,24831,Sean Couturier,2019-20,27.0,9,76,80,80,33,43,76,223.0,1770.0,578,134,209,343,1193.0,82,5.96,47,239,2579,9.5,0.8113371
24832,24832,Sean Couturier,2020-21,28.0,10,59,69,69,22,37,59,185.0,1368.0,647,156,246,402,1378.0,70,5.96,42,208,2192,9.5,0.7993046
24833,24833,Sean Gagnon,1998-99,25.0,2,1,5,5,0,1,1,3.0,,5,0,1,1,3.0,82,5.28,57,380,2242,9.6,0.17960274
24834,24834,Sean Gagnon,1999-00,26.0,3,0,2,2,0,0,0,1.0,16.0,7,0,1,1,4.0,82,5.27,57,359,2285,9.4,0.15949795
24835,24835,Sean Gagnon,2001-02,28.0,4,0,5,5,0,0,0,0.0,54.0,12,0,1,1,4.0,82,5.51,63,376,2272,9.9,0.12970564
24836,24836,Sean Haggerty,1996-97,20.0,2,0,1,1,0,0,0,0.0,,1,0,0,0,0.0,82,6.29,74,413,2481,10.4,0.22526118
24837,24837,Sean Haggerty,1998-99,22.0,3,0,5,5,0,0,0,2.0,,6,0,0,0,2.0,82,5.28,57,380,2242,9.6,0.16105202
24838,24838,Sean Haggerty,2000-01,24.0,4,2,5,5,1,1,2,2.0,48.0,11,1,1,2,4.0,82,5.49,53,331,2294,9.8,0.18894315
24839,24839,Sean Haggerty,2001-02,25.0,5,1,3,3,0,1,1,2.0,26.0,14,1,2,3,6.0,82,5.51,63,376,2272,9.9,0.15979144
24840,24840,Sean Hill,1993-94,23.0,2,8,31,31,2,6,8,37.0,,31,2,6,8,37.0,84,7.25,87,443,2603,11.7,0.28718135
24841,24841,Sean Hill,1994-95,24.0,3,27,68,68,7,20,27,165.0,,99,9,26,35,202.0,84,6.48,76,407,2545,10.7,0.39416727
24842,24842,Sean Hill,1995-96,25.0,4,15,45,45,1,14,15,107.0,,144,10,40,50,309.0,48,5.97,37,209,1408,10.2,0.3047127
24843,24843,Sean Hill,1996-97,26.0,5,21,80,80,7,14,21,157.0,,224,17,54,71,466.0,82,6.29,74,413,2481,10.4,0.3043977
24844,24844,Sean Hill,1997-98,27.0,6,0,5,5,0,0,0,9.0,,229,17,54,71,475.0,82,5.83,55,336,2444,9.8,0.22870722
24845,24845,Sean Hill,1998-99,28.0,7,7,55,55,1,6,7,53.0,,284,18,60,78,528.0,82,5.28,57,380,2242,9.6,0.15731785
24846,24846,Sean Hill,1999-00,29.0,8,10,54,54,0,10,10,44.0,1028.0,338,18,70,88,572.0,82,5.27,57,359,2285,9.4,0.18690333
24847,24847,Sean Hill,2000-01,30.0,9,44,62,62,13,31,44,150.0,1520.0,400,31,101,132,722.0,82,5.49,53,331,2294,9.8,0.51398075
24848,24848,Sean Hill,2001-02,31.0,10,11,48,48,1,10,11,47.0,835.0,448,32,111,143,769.0,82,5.51,63,376,2272,9.9,0.19458684
24849,24849,Sean Hill,2002-03,32.0,11,33,72,72,7,26,33,145.0,1541.0,520,39,137,176,914.0,82,5.24,53,338,2262,9.5,0.4064442
24850,24850,Sean Hill,2003-04,33.0,12,29,82,82,5,24,29,188.0,1996.0,602,44,161,205,1102.0,82,5.31,60,363,2326,9.4,0.373146
24851,24851,Sean Hill,2004-05,34.0,13,39,80,80,13,26,39,228.0,2032.0,682,57,187,244,1330.0,82,5.14,57,348,2300,9.2,0.47574916
24852,24852,Sean Hill,2006-07,36.0,14,20,78,78,2,18,20,110.0,1572.0,760,59,205,264,1440.0,82,6.05,85,480,2458,10.1,0.2395894
24853,24853,Sean Hill,2007-08,37.0,15,25,81,81,1,24,25,88.0,1826.0,841,60,229,289,1528.0,82,5.76,70,398,2426,9.7,0.23661283
24854,24854,Sean Hill,2008-09,38.0,16,9,35,35,2,7,9,18.0,532.0,876,62,236,298,1546.0,82,5.44,62,351,2383,9.4,0.17910853
24855,24855,Sean Kuraly,2017-18,25.0,2,1,8,8,0,1,1,11.0,74.0,8,0,1,1,11.0,82,5.45,47,245,2478,9.0,0.19402367
24856,24856,Sean Kuraly,2018-19,26.0,3,14,75,75,6,8,14,134.0,919.0,83,6,9,15,145.0,82,5.86,50,250,2620,9.2,0.25614843
24857,24857,Sean Kuraly,2019-20,27.0,4,21,71,71,8,13,21,134.0,978.0,154,14,22,36,279.0,82,5.96,47,239,2579,9.5,0.29501903
24858,24858,Sean Kuraly,2020-21,28.0,5,23,69,69,6,17,23,95.0,917.0,223,20,39,59,374.0,70,5.96,42,208,2192,9.5,0.32090482
24859,24859,Sean Malone,2017-18,22.0,2,0,1,1,0,0,0,1.0,12.0,1,0,0,0,1.0,82,5.45,47,245,2478,9.0,0.18236917
24860,24860,Sean McKenna,1982-83,20.0,2,1,3,3,0,1,1,6.0,,3,0,1,1,6.0,80,8.03,73,320,2489,12.9,0.32459444
24861,24861,Sean McKenna,1983-84,21.0,3,24,46,46,10,14,24,62.0,,49,10,15,25,68.0,80,7.73,71,310,2444,12.7,0.43650976
24862,24862,Sean McKenna,1984-85,22.0,4,30,78,78,20,10,30,107.0,,127,30,25,55,175.0,80,7.89,74,336,2448,12.9,0.4461396
24863,24863,Sean McKenna,1985-86,23.0,5,36,65,65,20,16,36,110.0,,192,50,41,91,285.0,80,7.77,71,321,2447,12.7,0.4876572
24864,24864,Sean McKenna,1986-87,24.0,6,22,75,75,10,12,22,130.0,,267,60,53,113,415.0,80,7.94,82,370,2484,12.8,0.34580976
24865,24865,Sean McKenna,1987-88,25.0,7,33,69,69,14,19,33,102.0,,336,74,72,146,517.0,80,7.34,72,344,2400,12.2,0.42653036
24866,24866,Sean McKenna,1988-89,26.0,8,15,70,70,8,7,15,80.0,,406,82,79,161,597.0,80,7.43,89,437,2435,12.2,0.2895211
24867,24867,Sean McKenna,1989-90,27.0,9,1,3,3,0,1,1,1.0,,409,82,80,162,598.0,80,7.48,85,403,2430,12.3,0.26215422
24868,24868,Sean McKenna,1990-91,28.0,10,0,5,5,0,0,0,6.0,,414,82,80,162,604.0,80,7.37,76,367,2421,12.2,0.2537264
24869,24869,Sean McMorrow,2003-04,22.0,2,0,1,1,0,0,0,0.0,1.0,1,0,0,0,0.0,82,5.31,60,363,2326,9.4,0.17115545
24870,24870,Sean Monahan,2014-15,20.0,2,34,75,75,22,12,34,140.0,1198.0,75,22,12,34,140.0,82,5.34,48,269,2463,8.9,0.5658535
24871,24871,Sean Monahan,2015-16,21.0,3,62,81,81,31,31,62,191.0,1589.0,156,53,43,96,331.0,82,5.32,47,251,2453,8.9,0.7782322
24872,24872,Sean Monahan,2016-17,22.0,4,63,81,81,27,36,63,197.0,1552.0,237,80,79,159,528.0,82,5.34,48,255,2438,9.0,0.80828375
24873,24873,Sean Monahan,2017-18,23.0,5,58,82,82,27,31,58,199.0,1441.0,319,107,110,217,727.0,82,5.45,47,245,2478,9.0,0.7726641
24874,24874,Sean Monahan,2018-19,24.0,6,64,74,74,31,33,64,202.0,1382.0,393,138,143,281,929.0,82,5.86,50,250,2620,9.2,0.83418137
24875,24875,Sean Monahan,2019-20,25.0,7,82,78,78,34,48,82,211.0,1486.0,471,172,191,363,1140.0,82,5.96,47,239,2579,9.5,0.89459
24876,24876,Sean Monahan,2020-21,26.0,8,48,70,70,22,26,48,166.0,1267.0,541,194,217,411,1306.0,70,5.96,42,208,2192,9.5,0.7793174
24877,24877,Sean O'Donnell,1995-96,24.0,2,2,15,15,0,2,2,12.0,,15,0,2,2,12.0,48,5.97,37,209,1408,10.2,0.2092458
24878,24878,Sean O'Donnell,1996-97,25.0,3,7,71,71,2,5,7,65.0,,86,2,7,9,77.0,82,6.29,74,413,2481,10.4,0.18401438
24879,24879,Sean O'Donnell,1997-98,26.0,4,17,55,55,5,12,17,68.0,,141,7,19,26,145.0,82,5.83,55,336,2444,9.8,0.24905413
24880,24880,Sean O'Donnell,1998-99,27.0,5,17,80,80,2,15,17,71.0,,221,9,34,43,216.0,82,5.28,57,380,2242,9.6,0.18583187
24881,24881,Sean O'Donnell,1999-00,28.0,6,14,80,80,1,13,14,64.0,1533.0,301,10,47,57,280.0,82,5.27,57,359,2285,9.4,0.15524754
24882,24882,Sean O'Donnell,2000-01,29.0,7,14,80,80,2,12,14,51.0,1415.0,381,12,59,71,331.0,82,5.49,53,331,2294,9.8,0.16195792
24883,24883,Sean O'Donnell,2001-02,30.0,8,17,80,80,4,13,17,67.0,1729.0,461,16,72,88,398.0,82,5.51,63,376,2272,9.9,0.18170235
24884,24884,Sean O'Donnell,2002-03,31.0,9,25,80,80,3,22,25,112.0,1986.0,541,19,94,113,510.0,82,5.24,53,338,2262,9.5,0.2650215
24885,24885,Sean O'Donnell,2003-04,32.0,10,16,70,70,1,15,16,61.0,1546.0,611,20,109,129,571.0,82,5.31,60,363,2326,9.4,0.18390357
24886,24886,Sean O'Donnell,2004-05,33.0,11,11,82,82,1,10,11,72.0,1689.0,693,21,119,140,643.0,82,5.14,57,348,2300,9.2,0.124295354
24887,24887,Sean O'Donnell,2006-07,35.0,12,11,78,78,2,9,11,33.0,1291.0,771,23,128,151,676.0,82,6.05,85,480,2458,10.1,0.12128925
24888,24888,Sean O'Donnell,2007-08,36.0,13,17,79,79,2,15,17,47.0,1574.0,850,25,143,168,723.0,82,5.76,70,398,2426,9.7,0.1563581
24889,24889,Sean O'Donnell,2008-09,37.0,14,9,82,82,2,7,9,25.0,1413.0,932,27,150,177,748.0,82,5.44,62,351,2383,9.4,0.10202274
24890,24890,Sean O'Donnell,2009-10,38.0,15,12,82,82,0,12,12,32.0,1680.0,1014,27,162,189,780.0,82,5.7,65,341,2477,9.4,0.097180426
24891,24891,Sean O'Donnell,2010-11,39.0,16,15,78,78,3,12,15,44.0,1462.0,1092,30,174,204,824.0,82,5.53,56,304,2486,9.1,0.1401937
24892,24892,Sean O'Donnell,2011-12,40.0,17,18,81,81,1,17,18,34.0,1259.0,1173,31,191,222,858.0,82,5.46,52,291,2492,9.0,0.17266956
24893,24893,Sean O'Donnell,2012-13,41.0,18,7,51,51,0,7,7,30.0,689.0,1224,31,198,229,888.0,82,5.32,47,271,2439,8.9,0.085492045
24894,24894,Sean Pronger,1996-97,24.0,2,1,7,7,0,1,1,3.0,,7,0,1,1,3.0,82,6.29,74,413,2481,10.4,0.18681282
24895,24895,Sean Pronger,1997-98,25.0,3,14,39,39,7,7,14,43.0,,46,7,8,15,46.0,82,5.83,55,336,2444,9.8,0.26335928
24896,24896,Sean Pronger,1998-99,26.0,4,21,67,67,6,15,21,73.0,,113,13,23,36,119.0,82,5.28,57,380,2242,9.6,0.2812969
24897,24897,Sean Pronger,1999-00,27.0,5,4,29,29,0,4,4,14.0,251.0,142,13,27,40,133.0,82,5.27,57,359,2285,9.4,0.12576264
24898,24898,Sean Pronger,2000-01,28.0,6,1,11,11,0,1,1,7.0,119.0,153,13,28,41,140.0,82,5.49,53,331,2294,9.8,0.13873452
24899,24899,Sean Pronger,2002-03,30.0,7,4,26,26,3,1,4,25.0,297.0,179,16,29,45,165.0,82,5.24,53,338,2262,9.5,0.19100049
24900,24900,Sean Pronger,2003-04,31.0,8,13,78,78,7,6,13,67.0,899.0,257,23,35,58,232.0,82,5.31,60,363,2326,9.4,0.18624437
24901,24901,Sean Pronger,2004-05,32.0,9,1,3,3,0,1,1,6.0,31.0,260,23,36,59,238.0,82,5.14,57,348,2300,9.2,0.21995533
24902,24902,Sean Selmser,2001-02,27.0,2,0,1,1,0,0,0,2.0,11.0,1,0,0,0,2.0,82,5.51,63,376,2272,9.9,0.15672335
24903,24903,Sean Toomey,1987-88,22.0,2,0,1,1,0,0,0,2.0,,1,0,0,0,2.0,80,7.34,72,344,2400,12.2,0.23175105
24904,24904,Sean Walker,2019-20,25.0,2,10,39,39,3,7,10,55.0,602.0,39,3,7,10,55.0,82,5.96,47,239,2579,9.5,0.22936738
24905,24905,Sean Walker,2020-21,26.0,3,24,70,70,5,19,24,127.0,1319.0,109,8,26,34,182.0,70,5.96,42,208,2192,9.5,0.33934787
24906,24906,Sean Whyte,1992-93,22.0,2,0,3,3,0,0,0,0.0,,3,0,0,0,0.0,80,6.96,77,402,2440,11.4,0.17917198
24907,24907,Sean Whyte,1993-94,23.0,3,2,18,18,0,2,2,7.0,,21,0,2,2,7.0,84,7.25,87,443,2603,11.7,0.2013514
24908,24908,Sean Williams,1992-93,25.0,2,0,2,2,0,0,0,0.0,,2,0,0,0,0.0,80,6.96,77,402,2440,11.4,0.1660105
24909,24909,Sebastian Aho,2017-18,20.0,2,49,82,82,24,25,49,214.0,1377.0,82,24,25,49,214.0,82,5.45,47,245,2478,9.0,0.73191136
24910,24910,Sebastian Aho,2018-19,21.0,3,65,78,78,29,36,65,200.0,1398.0,160,53,61,114,414.0,82,5.86,50,250,2620,9.2,0.8725413
24911,24911,Sebastian Aho,2019-20,22.0,4,83,82,82,30,53,83,243.0,1652.0,242,83,114,197,657.0,82,5.96,47,239,2579,9.5,1.016751
24912,24912,Sebastian Aho,2020-21,23.0,5,66,68,68,38,28,66,206.0,1321.0,310,121,142,263,863.0,70,5.96,42,208,2192,9.5,0.9950927
24913,24913,Sebastian Aho0,2018-19,22.0,2,4,22,22,1,3,4,24.0,357.0,22,1,3,4,24.0,82,5.86,50,250,2620,9.2,0.21744049
24914,24914,Sebastien Bisaillon,2007-08,21.0,2,0,2,2,0,0,0,3.0,28.0,2,0,0,0,3.0,82,5.76,70,398,2426,9.7,0.21502173
24915,24915,Sebastien Bordeleau,1996-97,21.0,2,0,4,4,0,0,0,0.0,,4,0,0,0,0.0,82,6.29,74,413,2481,10.4,0.17969257
24916,24916,Sebastien Bordeleau,1997-98,22.0,3,11,28,28,2,9,11,27.0,,32,2,9,11,27.0,82,5.83,55,336,2444,9.8,0.27069384
24917,24917,Sebastien Bordeleau,1998-99,23.0,4,14,53,53,6,8,14,55.0,,85,8,17,25,82.0,82,5.28,57,380,2242,9.6,0.308115
24918,24918,Sebastien Bordeleau,1999-00,24.0,5,40,72,72,16,24,40,168.0,1102.0,157,24,41,65,250.0,82,5.27,57,359,2285,9.4,0.53451294
24919,24919,Sebastien Bordeleau,2000-01,25.0,6,23,60,60,10,13,23,127.0,836.0,217,34,54,88,377.0,82,5.49,53,331,2294,9.8,0.36771035
24920,24920,Sebastien Bordeleau,2001-02,26.0,7,5,14,14,2,3,5,20.0,177.0,231,36,57,93,397.0,82,5.51,63,376,2272,9.9,0.2777507
24921,24921,Sebastien Bordeleau,2002-03,27.0,8,5,20,20,1,4,5,28.0,237.0,251,37,61,98,425.0,82,5.24,53,338,2262,9.5,0.23276296
24922,24922,Selmar Odelein,1986-87,20.0,2,0,4,4,0,0,0,2.0,,4,0,0,0,2.0,80,7.94,82,370,2484,12.8,0.27948314
24923,24923,Selmar Odelein,1988-89,22.0,3,2,12,12,0,2,2,17.0,,16,0,2,2,19.0,80,7.43,89,437,2435,12.2,0.230512
24924,24924,Selmar Odelein,1989-90,23.0,4,0,2,2,0,0,0,0.0,,18,0,2,2,19.0,80,7.48,85,403,2430,12.3,0.18741265
24925,24925,Serge Aubin,1999-00,24.0,2,0,1,1,0,0,0,1.0,4.0,1,0,0,0,1.0,82,5.27,57,359,2285,9.4,0.17854032
24926,24926,Serge Aubin,2000-01,25.0,3,3,15,15,2,1,3,14.0,99.0,16,2,1,3,15.0,82,5.49,53,331,2294,9.8,0.20703101
24927,24927,Serge Aubin,2001-02,26.0,4,30,81,81,13,17,30,110.0,1324.0,97,15,18,33,125.0,82,5.51,63,376,2272,9.9,0.3748238
24928,24928,Serge Aubin,2002-03,27.0,5,16,71,71,8,8,16,86.0,1100.0,168,23,26,49,211.0,82,5.24,53,338,2262,9.5,0.24198651
24929,24929,Serge Aubin,2003-04,28.0,6,10,66,66,4,6,10,62.0,789.0,234,27,32,59,273.0,82,5.31,60,363,2326,9.4,0.19330353
24930,24930,Serge Aubin,2004-05,29.0,7,25,66,66,10,15,25,97.0,1056.0,300,37,47,84,370.0,82,5.14,57,348,2300,9.2,0.3486572
24931,24931,Serge Aubin,2006-07,31.0,8,24,74,74,7,17,24,82.0,821.0,374,44,64,108,452.0,82,6.05,85,480,2458,10.1,0.26944053
24932,24932,Serge Beaudoin,1980-81,28.0,2,0,3,3,0,0,0,1.0,,3,0,0,0,1.0,80,7.03,61,280,2352,12.0,0.2083022
24933,24933,Serge Boisvert,1983-84,24.0,2,2,17,17,0,2,2,18.0,,17,0,2,2,18.0,80,7.73,71,310,2444,12.7,0.24619958
24934,24934,Serge Boisvert,1985-86,26.0,3,4,14,14,2,2,4,18.0,,31,2,4,6,36.0,80,7.77,71,321,2447,12.7,0.27709317
24935,24935,Serge Boisvert,1986-87,27.0,4,4,9,9,2,2,4,18.0,,40,4,6,10,54.0,80,7.94,82,370,2484,12.8,0.2387236
24936,24936,Serge Boisvert,1987-88,28.0,5,0,1,1,0,0,0,0.0,,41,4,6,10,54.0,80,7.34,72,344,2400,12.2,0.17322364
24937,24937,Serge Boisvert,1988-89,29.0,6,2,5,5,1,1,2,5.0,,46,5,7,12,59.0,80,7.43,89,437,2435,12.2,0.20152906
24938,24938,Serge Payer,2001-02,22.0,2,6,43,43,5,1,6,34.0,320.0,43,5,1,6,34.0,82,5.51,63,376,2272,9.9,0.23339015
24939,24939,Serge Payer,2004-05,25.0,3,1,5,5,0,1,1,2.0,53.0,48,5,2,7,36.0,82,5.14,57,348,2300,9.2,0.1588875
24940,24940,Serge Payer,2006-07,27.0,4,6,71,71,2,4,6,70.0,702.0,119,7,6,13,106.0,82,6.05,85,480,2458,10.1,0.15847003
24941,24941,Serge Payer,2007-08,28.0,5,0,5,5,0,0,0,4.0,35.0,124,7,6,13,110.0,82,5.76,70,398,2426,9.7,0.12620303
24942,24942,Serge Roberge,1991-92,26.0,2,0,9,9,0,0,0,0.0,,9,0,0,0,0.0,80,6.91,71,366,2385,11.6,0.17030331
24943,24943,Sergei Bautin,1993-94,26.0,2,23,71,71,5,18,23,82.0,,71,5,18,23,82.0,84,7.25,87,443,2603,11.7,0.3004579
24944,24944,Sergei Bautin,1994-95,27.0,3,7,60,60,0,7,7,39.0,,131,5,25,30,121.0,84,6.48,76,407,2545,10.7,0.13176304
24945,24945,Sergei Bautin,1996-97,29.0,4,0,1,1,0,0,0,0.0,,132,5,25,30,121.0,82,6.29,74,413,2481,10.4,0.14711335
24946,24946,Sergei Berezin,1997-98,26.0,2,41,73,73,25,16,41,177.0,,73,25,16,41,177.0,82,5.83,55,336,2444,9.8,0.5499167
24947,24947,Sergei Berezin,1998-99,27.0,3,31,68,68,16,15,31,167.0,,141,41,31,72,344.0,82,5.28,57,380,2242,9.6,0.4962206
24948,24948,Sergei Berezin,1999-00,28.0,4,59,76,76,37,22,59,263.0,1181.0,217,78,53,131,607.0,82,5.27,57,359,2285,9.4,0.7309784
24949,24949,Sergei Berezin,2000-01,29.0,5,39,61,61,26,13,39,241.0,1029.0,278,104,66,170,848.0,82,5.49,53,331,2294,9.8,0.69948584
24950,24950,Sergei Berezin,2001-02,30.0,6,50,79,79,22,28,50,256.0,1239.0,357,126,94,220,1104.0,82,5.51,63,376,2272,9.9,0.5727164
24951,24951,Sergei Berezin,2002-03,31.0,7,26,70,70,11,15,26,200.0,1044.0,427,137,109,246,1304.0,82,5.24,53,338,2262,9.5,0.42148173
24952,24952,Sergei Berezin,2003-04,32.0,8,40,75,75,23,17,40,199.0,1217.0,502,160,126,286,1503.0,82,5.31,60,363,2326,9.4,0.51879233
24953,24953,Sergei Brylin,1995-96,22.0,2,14,26,26,6,8,14,41.0,,26,6,8,14,41.0,48,5.97,37,209,1408,10.2,0.3874243
24954,24954,Sergei Brylin,1996-97,23.0,3,9,50,50,4,5,9,51.0,,76,10,13,23,92.0,82,6.29,74,413,2481,10.4,0.24945197
24955,24955,Sergei Brylin,1997-98,24.0,4,4,29,29,2,2,4,34.0,,105,12,15,27,126.0,82,5.83,55,336,2444,9.8,0.23509064
24956,24956,Sergei Brylin,1998-99,25.0,5,5,18,18,2,3,5,20.0,,123,14,18,32,146.0,82,5.28,57,380,2242,9.6,0.21000019
24957,24957,Sergei Brylin,1999-00,26.0,6,15,47,47,5,10,15,51.0,607.0,170,19,28,47,197.0,82,5.27,57,359,2285,9.4,0.2702813
24958,24958,Sergei Brylin,2000-01,27.0,7,20,64,64,9,11,20,84.0,857.0,234,28,39,67,281.0,82,5.49,53,331,2294,9.8,0.27663946
24959,24959,Sergei Brylin,2001-02,28.0,8,52,75,75,23,29,52,130.0,1163.0,309,51,68,119,411.0,82,5.51,63,376,2272,9.9,0.5470932
24960,24960,Sergei Brylin,2002-03,29.0,9,44,76,76,16,28,44,133.0,1306.0,385,67,96,163,544.0,82,5.24,53,338,2262,9.5,0.505632
24961,24961,Sergei Brylin,2003-04,30.0,10,19,52,52,11,8,19,86.0,841.0,437,78,104,182,630.0,82,5.31,60,363,2326,9.4,0.39343327
24962,24962,Sergei Brylin,2004-05,31.0,11,33,82,82,14,19,33,98.0,1346.0,519,92,123,215,728.0,82,5.14,57,348,2300,9.2,0.379801
24963,24963,Sergei Brylin,2006-07,33.0,12,37,82,82,15,22,37,126.0,1290.0,601,107,145,252,854.0,82,6.05,85,480,2458,10.1,0.38481733
24964,24964,Sergei Brylin,2007-08,34.0,13,40,82,82,16,24,40,97.0,1456.0,683,123,169,292,951.0,82,5.76,70,398,2426,9.7,0.39503464
24965,24965,Sergei Brylin,2008-09,35.0,14,16,82,82,6,10,16,65.0,1111.0,765,129,179,308,1016.0,82,5.44,62,351,2383,9.4,0.18890715
24966,24966,Sergei Fedorov,1991-92,22.0,2,79,77,77,31,48,79,259.0,,77,31,48,79,259.0,80,6.91,71,366,2385,11.6,1.0156944
24967,24967,Sergei Fedorov,1992-93,23.0,3,86,80,80,32,54,86,249.0,,157,63,102,165,508.0,80,6.96,77,402,2440,11.4,1.1575496
24968,24968,Sergei Fedorov,1993-94,24.0,4,87,73,73,34,53,87,217.0,,230,97,155,252,725.0,84,7.25,87,443,2603,11.7,1.0770841
24969,24969,Sergei Fedorov,1994-95,25.0,5,120,82,82,56,64,120,337.0,,312,153,219,372,1062.0,84,6.48,76,407,2545,10.7,1.2091377
24970,24970,Sergei Fedorov,1995-96,26.0,6,50,42,42,20,30,50,147.0,,354,173,249,422,1209.0,48,5.97,37,209,1408,10.2,1.2906234
24971,24971,Sergei Fedorov,1996-97,27.0,7,107,78,78,39,68,107,306.0,,432,212,317,529,1515.0,82,6.29,74,413,2481,10.4,1.1000285
24972,24972,Sergei Fedorov,1997-98,28.0,8,63,74,74,30,33,63,273.0,,506,242,350,592,1788.0,82,5.83,55,336,2444,9.8,0.8348756
24973,24973,Sergei Fedorov,1998-99,29.0,9,17,21,21,6,11,17,68.0,,527,248,361,609,1856.0,82,5.28,57,380,2242,9.6,0.88900864
24974,24974,Sergei Fedorov,1999-00,30.0,10,63,77,77,26,37,63,224.0,1490.0,604,274,398,672,2080.0,82,5.27,57,359,2285,9.4,0.79147744
24975,24975,Sergei Fedorov,2000-01,31.0,11,62,68,68,27,35,62,263.0,1366.0,672,301,433,734,2343.0,82,5.49,53,331,2294,9.8,0.8790635
24976,24976,Sergei Fedorov,2001-02,32.0,12,69,75,75,32,37,69,268.0,1581.0,747,333,470,803,2611.0,82,5.51,63,376,2272,9.9,0.8456303
24977,24977,Sergei Fedorov,2002-03,33.0,13,68,81,81,31,37,68,256.0,1583.0,828,364,507,871,2867.0,82,5.24,53,338,2262,9.5,0.8841412
24978,24978,Sergei Fedorov,2003-04,34.0,14,83,80,80,36,47,83,281.0,1694.0,908,400,554,954,3148.0,82,5.31,60,363,2326,9.4,0.913552
24979,24979,Sergei Fedorov,2004-05,35.0,15,65,80,80,31,34,65,268.0,1686.0,988,431,588,1019,3416.0,82,5.14,57,348,2300,9.2,0.8026615
24980,24980,Sergei Fedorov,2006-07,37.0,16,44,67,67,12,32,44,160.0,1409.0,1055,443,620,1063,3576.0,82,6.05,85,480,2458,10.1,0.55510086
24981,24981,Sergei Fedorov,2007-08,38.0,17,42,73,73,18,24,42,163.0,1455.0,1128,461,644,1105,3739.0,82,5.76,70,398,2426,9.7,0.5160505
24982,24982,Sergei Fedorov,2008-09,39.0,18,41,68,68,11,30,41,128.0,1202.0,1196,472,674,1146,3867.0,82,5.44,62,351,2383,9.4,0.5164298
24983,24983,Sergei Fedorov,2009-10,40.0,19,33,52,52,11,22,33,118.0,859.0,1248,483,696,1179,3985.0,82,5.7,65,341,2477,9.4,0.5964576
24984,24984,Sergei Gonchar,1995-96,21.0,2,7,31,31,2,5,7,38.0,,31,2,5,7,38.0,48,5.97,37,209,1408,10.2,0.31267697
24985,24985,Sergei Gonchar,1996-97,22.0,3,41,78,78,15,26,41,139.0,,109,17,31,48,177.0,82,6.29,74,413,2481,10.4,0.51908374
24986,24986,Sergei Gonchar,1997-98,23.0,4,30,57,57,13,17,30,129.0,,166,30,48,78,306.0,82,5.83,55,336,2444,9.8,0.52488256
24987,24987,Sergei Gonchar,1998-99,24.0,5,21,72,72,5,16,21,134.0,,238,35,64,99,440.0,82,5.28,57,380,2242,9.6,0.3504712
24988,24988,Sergei Gonchar,1999-00,25.0,6,31,53,53,21,10,31,180.0,1268.0,291,56,74,130,620.0,82,5.27,57,359,2285,9.4,0.6604476
24989,24989,Sergei Gonchar,2000-01,26.0,7,54,73,73,18,36,54,181.0,1589.0,364,74,110,184,801.0,82,5.49,53,331,2294,9.8,0.7446122
24990,24990,Sergei Gonchar,2001-02,27.0,8,57,76,76,19,38,57,241.0,1705.0,440,93,148,241,1042.0,82,5.51,63,376,2272,9.9,0.6888983
24991,24991,Sergei Gonchar,2002-03,28.0,9,59,76,76,26,33,59,216.0,1813.0,516,119,181,300,1258.0,82,5.24,53,338,2262,9.5,0.71240866
24992,24992,Sergei Gonchar,2003-04,29.0,10,67,82,82,18,49,67,224.0,2179.0,598,137,230,367,1482.0,82,5.31,60,363,2326,9.4,0.75070333
24993,24993,Sergei Gonchar,2004-05,30.0,11,58,71,71,11,47,58,161.0,1948.0,669,148,277,425,1643.0,82,5.14,57,348,2300,9.2,0.8135946
24994,24994,Sergei Gonchar,2006-07,32.0,12,58,75,75,12,46,58,192.0,1850.0,744,160,323,483,1835.0,82,6.05,85,480,2458,10.1,0.69154745
24995,24995,Sergei Gonchar,2007-08,33.0,13,67,82,82,13,54,67,191.0,2178.0,826,173,377,550,2026.0,82,5.76,70,398,2426,9.7,0.73931444
24996,24996,Sergei Gonchar,2008-09,34.0,14,65,78,78,12,53,65,173.0,2021.0,904,185,430,615,2199.0,82,5.44,62,351,2383,9.4,0.7070447
24997,24997,Sergei Gonchar,2009-10,35.0,15,19,25,25,6,13,19,71.0,630.0,929,191,443,634,2270.0,82,5.7,65,341,2477,9.4,0.6698328
24998,24998,Sergei Gonchar,2010-11,36.0,16,50,62,62,11,39,50,138.0,1513.0,991,202,482,684,2408.0,82,5.53,56,304,2486,9.1,0.5825714
24999,24999,Sergei Gonchar,2011-12,37.0,17,27,67,67,7,20,27,107.0,1554.0,1058,209,502,711,2515.0,82,5.46,52,291,2492,9.0,0.35825562
25000,25000,Sergei Gonchar,2012-13,38.0,18,37,74,74,5,32,37,131.0,1647.0,1132,214,534,748,2646.0,82,5.32,47,271,2439,8.9,0.42639542
25001,25001,Sergei Gonchar,2013-14,39.0,19,27,45,45,3,24,27,85.0,1080.0,1177,217,558,775,2731.0,48,5.31,29,160,1399,9.1,0.49980363
25002,25002,Sergei Gonchar,2014-15,40.0,20,22,76,76,2,20,22,89.0,1338.0,1253,219,578,797,2820.0,82,5.34,48,269,2463,8.9,0.27293402
25003,25003,Sergei Gonchar,2015-16,41.0,21,14,48,48,1,13,14,46.0,849.0,1301,220,591,811,2866.0,82,5.32,47,251,2453,8.9,0.27264434
25004,25004,Sergei Kharin,1991-92,28.0,2,5,7,7,2,3,5,13.0,,7,2,3,5,13.0,80,6.91,71,366,2385,11.6,0.31110924
25005,25005,Sergei Klimovich,1997-98,23.0,2,0,1,1,0,0,0,0.0,,1,0,0,0,0.0,82,5.83,55,336,2444,9.8,0.15535027
25006,25006,Sergei Kostitsyn,2008-09,21.0,2,27,52,52,9,18,27,49.0,746.0,52,9,18,27,49.0,82,5.44,62,351,2383,9.4,0.464122
25007,25007,Sergei Kostitsyn,2009-10,22.0,3,23,56,56,8,15,23,74.0,792.0,108,17,33,50,123.0,82,5.7,65,341,2477,9.4,0.43657133
25008,25008,Sergei Kostitsyn,2010-11,23.0,4,18,47,47,7,11,18,59.0,666.0,155,24,44,68,182.0,82,5.53,56,304,2486,9.1,0.41637123
25009,25009,Sergei Kostitsyn,2011-12,24.0,5,50,77,77,23,27,50,93.0,1170.0,232,47,71,118,275.0,82,5.46,52,291,2492,9.0,0.5932415
25010,25010,Sergei Kostitsyn,2012-13,25.0,6,43,75,75,17,26,43,97.0,1235.0,307,64,97,161,372.0,82,5.32,47,271,2439,8.9,0.52661264
25011,25011,Sergei Kostitsyn,2013-14,26.0,7,15,46,46,3,12,15,42.0,769.0,353,67,109,176,414.0,48,5.31,29,160,1399,9.1,0.38836184
25012,25012,Sergei Krivokrasov,1993-94,19.0,2,0,4,4,0,0,0,0.0,,4,0,0,0,0.0,84,7.25,87,443,2603,11.7,0.21678105
25013,25013,Sergei Krivokrasov,1994-95,20.0,3,1,9,9,1,0,1,7.0,,13,1,0,1,7.0,84,6.48,76,407,2545,10.7,0.25414565
25014,25014,Sergei Krivokrasov,1995-96,21.0,4,19,41,41,12,7,19,72.0,,54,13,7,20,79.0,48,5.97,37,209,1408,10.2,0.4786905
25015,25015,Sergei Krivokrasov,1996-97,22.0,5,16,46,46,6,10,16,52.0,,100,19,17,36,131.0,82,6.29,74,413,2481,10.4,0.3538865
25016,25016,Sergei Krivokrasov,1997-98,23.0,6,24,67,67,13,11,24,104.0,,167,32,28,60,235.0,82,5.83,55,336,2444,9.8,0.36768126
25017,25017,Sergei Krivokrasov,1998-99,24.0,7,23,58,58,10,13,23,127.0,,225,42,41,83,362.0,82,5.28,57,380,2242,9.6,0.42226088
25018,25018,Sergei Krivokrasov,1999-00,25.0,8,48,70,70,25,23,48,208.0,1129.0,295,67,64,131,570.0,82,5.27,57,359,2285,9.4,0.64852816
25019,25019,Sergei Krivokrasov,2000-01,26.0,9,37,75,75,10,27,37,159.0,988.0,370,77,91,168,729.0,82,5.49,53,331,2294,9.8,0.5045852
25020,25020,Sergei Krivokrasov,2001-02,27.0,10,22,54,54,7,15,22,107.0,706.0,424,84,106,190,836.0,82,5.51,63,376,2272,9.9,0.40959692
25021,25021,Sergei Krivokrasov,2002-03,28.0,11,5,26,26,2,3,5,51.0,315.0,450,86,109,195,887.0,82,5.24,53,338,2262,9.5,0.30414492
25022,25022,Sergei Makarov,1990-91,32.0,2,86,80,80,24,62,86,118.0,,80,24,62,86,118.0,80,7.37,76,367,2421,12.2,1.0060526
25023,25023,Sergei Makarov,1991-92,33.0,3,79,78,78,30,49,79,93.0,,158,54,111,165,211.0,80,6.91,71,366,2385,11.6,0.81578803
25024,25024,Sergei Makarov,1992-93,34.0,4,70,68,68,22,48,70,83.0,,226,76,159,235,294.0,80,6.96,77,402,2440,11.4,0.80524796
25025,25025,Sergei Makarov,1993-94,35.0,5,57,71,71,18,39,57,105.0,,297,94,198,292,399.0,84,7.25,87,443,2603,11.7,0.63713086
25026,25026,Sergei Makarov,1994-95,36.0,6,68,80,80,30,38,68,155.0,,377,124,236,360,554.0,84,6.48,76,407,2545,10.7,0.7030688
25027,25027,Sergei Makarov,1995-96,37.0,7,24,43,43,10,14,24,56.0,,420,134,250,384,610.0,48,5.97,37,209,1408,10.2,0.46870914
25028,25028,Sergei Makarov,1997-98,39.0,8,0,4,4,0,0,0,0.0,,424,134,250,384,610.0,82,5.83,55,336,2444,9.8,0.4418517
25029,25029,Sergei Nemchinov,1992-93,29.0,2,58,73,73,30,28,58,124.0,,73,30,28,58,124.0,80,6.96,77,402,2440,11.4,0.6634897
25030,25030,Sergei Nemchinov,1993-94,30.0,3,54,81,81,23,31,54,144.0,,154,53,59,112,268.0,84,7.25,87,443,2603,11.7,0.51323205
25031,25031,Sergei Nemchinov,1994-95,31.0,4,49,76,76,22,27,49,144.0,,230,75,86,161,412.0,84,6.48,76,407,2545,10.7,0.5079319
25032,25032,Sergei Nemchinov,1995-96,32.0,5,13,47,47,7,6,13,67.0,,277,82,92,174,479.0,48,5.97,37,209,1408,10.2,0.3882354
25033,25033,Sergei Nemchinov,1996-97,33.0,6,32,78,78,17,15,32,118.0,,355,99,107,206,597.0,82,6.29,74,413,2481,10.4,0.40016598
25034,25034,Sergei Nemchinov,1997-98,34.0,7,24,69,69,8,16,24,97.0,,424,107,123,230,694.0,82,5.83,55,336,2444,9.8,0.30814564
25035,25035,Sergei Nemchinov,1998-99,35.0,8,29,74,74,10,19,29,94.0,,498,117,142,259,788.0,82,5.28,57,380,2242,9.6,0.33254445
25036,25036,Sergei Nemchinov,1999-00,36.0,9,20,77,77,12,8,20,74.0,1117.0,575,129,150,279,862.0,82,5.27,57,359,2285,9.4,0.28995454
25037,25037,Sergei Nemchinov,2000-01,37.0,10,26,53,53,10,16,26,55.0,726.0,628,139,166,305,917.0,82,5.49,53,331,2294,9.8,0.40198842
25038,25038,Sergei Nemchinov,2001-02,38.0,11,30,65,65,8,22,30,70.0,859.0,693,147,188,335,987.0,82,5.51,63,376,2272,9.9,0.30602938
25039,25039,Sergei Nemchinov,2002-03,39.0,12,10,68,68,5,5,10,49.0,759.0,761,152,193,345,1036.0,82,5.24,53,338,2262,9.5,0.15751985
25040,25040,Sergei Petrenko,1994-95,26.0,2,4,14,14,0,4,4,7.0,,14,0,4,4,7.0,84,6.48,76,407,2545,10.7,0.1774615
25041,25041,Sergei Plotnikov,2016-17,26.0,2,3,45,45,0,3,3,41.0,445.0,45,0,3,3,41.0,82,5.34,48,255,2438,9.0,0.13010362
25042,25042,Sergei Priakin,1989-90,26.0,2,0,2,2,0,0,0,2.0,,2,0,0,0,2.0,80,7.48,85,403,2430,12.3,0.2067115
25043,25043,Sergei Priakin,1990-91,27.0,3,4,20,20,2,2,4,17.0,,22,2,2,4,19.0,80,7.37,76,367,2421,12.2,0.22562107
25044,25044,Sergei Priakin,1991-92,28.0,4,7,24,24,1,6,7,26.0,,46,3,8,11,45.0,80,6.91,71,366,2385,11.6,0.19764161
25045,25045,Sergei Samsonov,1998-99,20.0,2,47,81,81,22,25,47,159.0,,81,22,25,47,159.0,82,5.28,57,380,2242,9.6,0.65904033
25046,25046,Sergei Samsonov,1999-00,21.0,3,51,79,79,25,26,51,160.0,1294.0,160,47,51,98,319.0,82,5.27,57,359,2285,9.4,0.6929004
25047,25047,Sergei Samsonov,2000-01,22.0,4,45,77,77,19,26,45,145.0,1273.0,237,66,77,143,464.0,82,5.49,53,331,2294,9.8,0.6362151
25048,25048,Sergei Samsonov,2001-02,23.0,5,75,82,82,29,46,75,215.0,1590.0,319,95,123,218,679.0,82,5.51,63,376,2272,9.9,0.90832126
25049,25049,Sergei Samsonov,2002-03,24.0,6,70,74,74,29,41,70,192.0,1390.0,393,124,164,288,871.0,82,5.24,53,338,2262,9.5,0.9503408
25050,25050,Sergei Samsonov,2003-04,25.0,7,11,8,8,5,6,11,23.0,163.0,401,129,170,299,894.0,82,5.31,60,363,2326,9.4,0.5274633
25051,25051,Sergei Samsonov,2004-05,26.0,8,40,58,58,17,23,40,132.0,1012.0,459,146,193,339,1026.0,82,5.14,57,348,2300,9.2,0.7558726
25052,25052,Sergei Samsonov,2006-07,28.0,9,53,74,74,23,30,53,143.0,1222.0,533,169,223,392,1169.0,82,6.05,85,480,2458,10.1,0.6511171
25053,25053,Sergei Samsonov,2007-08,29.0,10,26,63,63,9,17,26,114.0,881.0,596,178,240,418,1283.0,82,5.76,70,398,2426,9.7,0.42777944
25054,25054,Sergei Samsonov,2008-09,30.0,11,36,61,61,14,22,36,109.0,970.0,657,192,262,454,1392.0,82,5.44,62,351,2383,9.4,0.5029916
25055,25055,Sergei Samsonov,2009-10,31.0,12,48,81,81,16,32,48,155.0,1403.0,738,208,294,502,1547.0,82,5.7,65,341,2477,9.4,0.56394196
25056,25056,Sergei Samsonov,2010-11,32.0,13,29,72,72,14,15,29,104.0,963.0,810,222,309,531,1651.0,82,5.53,56,304,2486,9.1,0.40797922
25057,25057,Sergei Samsonov,2011-12,33.0,14,40,78,78,13,27,40,123.0,1205.0,888,235,336,571,1774.0,82,5.46,52,291,2492,9.0,0.4272929
25058,25058,Sergei Shirokov,2010-11,24.0,2,0,6,6,0,0,0,4.0,77.0,6,0,0,0,4.0,82,5.53,56,304,2486,9.1,0.17076418
25059,25059,Sergei Shirokov,2011-12,25.0,3,1,2,2,1,0,1,6.0,21.0,8,1,0,1,10.0,82,5.46,52,291,2492,9.0,0.19094157
25060,25060,Sergei Starikov,1990-91,32.0,2,1,16,16,0,1,1,6.0,,16,0,1,1,6.0,80,7.37,76,367,2421,12.2,0.1987845
25061,25061,Sergei Varlamov,1998-99,20.0,2,0,1,1,0,0,0,0.0,,1,0,0,0,0.0,82,5.28,57,380,2242,9.6,0.21018672
25062,25062,Sergei Varlamov,2000-01,22.0,3,3,7,7,3,0,3,11.0,73.0,8,3,0,3,11.0,82,5.49,53,331,2294,9.8,0.2698279
25063,25063,Sergei Varlamov,2002-03,24.0,4,12,52,52,5,7,12,83.0,581.0,60,8,7,15,94.0,82,5.24,53,338,2262,9.5,0.2792989
25064,25064,Sergei Varlamov,2003-04,25.0,5,0,3,3,0,0,0,5.0,34.0,63,8,7,15,99.0,82,5.31,60,363,2326,9.4,0.17060745
25065,25065,Sergei Vyshedkevich,2000-01,26.0,2,4,7,7,1,3,4,5.0,163.0,7,1,3,4,5.0,82,5.49,53,331,2294,9.8,0.19949383
25066,25066,Sergei Vyshedkevich,2001-02,27.0,3,3,23,23,1,2,3,28.0,473.0,30,2,5,7,33.0,82,5.51,63,376,2272,9.9,0.17422691
25067,25067,Sergei Zholtok,1993-94,21.0,2,1,1,1,0,1,1,2.0,,1,0,1,1,2.0,84,7.25,87,443,2603,11.7,0.26998124
25068,25068,Sergei Zholtok,1994-95,22.0,3,3,24,24,2,1,3,25.0,,25,2,2,4,27.0,84,6.48,76,407,2545,10.7,0.26737475
25069,25069,Sergei Zholtok,1997-98,25.0,4,28,57,57,12,16,28,96.0,,82,14,18,32,123.0,82,5.83,55,336,2444,9.8,0.39656866
25070,25070,Sergei Zholtok,1998-99,26.0,5,23,78,78,10,13,23,127.0,,160,24,31,55,250.0,82,5.28,57,380,2242,9.6,0.2809777
25071,25071,Sergei Zholtok,1999-00,27.0,6,22,70,70,7,15,22,102.0,783.0,230,31,46,77,352.0,82,5.27,57,359,2285,9.4,0.3194049
25072,25072,Sergei Zholtok,2000-01,28.0,7,38,68,68,26,12,38,163.0,1175.0,298,57,58,115,515.0,82,5.49,53,331,2294,9.8,0.5427073
25073,25073,Sergei Zholtok,2001-02,29.0,8,31,69,69,5,26,31,139.0,979.0,367,62,84,146,654.0,82,5.51,63,376,2272,9.9,0.43416905
25074,25074,Sergei Zholtok,2002-03,30.0,9,39,73,73,19,20,39,146.0,1173.0,440,81,104,185,800.0,82,5.24,53,338,2262,9.5,0.491407
25075,25075,Sergei Zholtok,2003-04,31.0,10,42,78,78,16,26,42,153.0,1294.0,518,97,130,227,953.0,82,5.31,60,363,2326,9.4,0.46576667
25076,25076,Sergei Zholtok,2004-05,32.0,11,31,70,70,14,17,31,132.0,1085.0,588,111,147,258,1085.0,82,5.14,57,348,2300,9.2,0.43155134
25077,25077,Sergei Zinovjev,2004-05,24.0,2,1,10,10,0,1,1,8.0,98.0,10,0,1,1,8.0,82,5.14,57,348,2300,9.2,0.1823242
25078,25078,Sergei Zubov,1993-94,23.0,2,31,49,49,8,23,31,93.0,,49,8,23,31,93.0,84,7.25,87,443,2603,11.7,0.5872425
25079,25079,Sergei Zubov,1994-95,24.0,3,89,78,78,12,77,89,222.0,,127,20,100,120,315.0,84,6.48,76,407,2545,10.7,0.9520649
25080,25080,Sergei Zubov,1995-96,25.0,4,36,38,38,10,26,36,116.0,,165,30,126,156,431.0,48,5.97,37,209,1408,10.2,0.8497309
25081,25081,Sergei Zubov,1996-97,26.0,5,66,64,64,11,55,66,141.0,,229,41,181,222,572.0,82,6.29,74,413,2481,10.4,0.7997571
25082,25082,Sergei Zubov,1997-98,27.0,6,43,78,78,13,30,43,133.0,,307,54,211,265,705.0,82,5.83,55,336,2444,9.8,0.5648403
25083,25083,Sergei Zubov,1998-99,28.0,7,57,73,73,10,47,57,148.0,,380,64,258,322,853.0,82,5.28,57,380,2242,9.6,0.7037296
25084,25084,Sergei Zubov,1999-00,29.0,8,51,81,81,10,41,51,155.0,1963.0,461,74,299,373,1008.0,82,5.27,57,359,2285,9.4,0.59980494
25085,25085,Sergei Zubov,2000-01,30.0,9,42,77,77,9,33,42,179.0,2220.0,538,83,332,415,1187.0,82,5.49,53,331,2294,9.8,0.6106905
25086,25086,Sergei Zubov,2001-02,31.0,10,51,79,79,10,41,51,173.0,2102.0,617,93,373,466,1360.0,82,5.51,63,376,2272,9.9,0.5721339
25087,25087,Sergei Zubov,2002-03,32.0,11,44,80,80,12,32,44,198.0,2142.0,697,105,405,510,1558.0,82,5.24,53,338,2262,9.5,0.62063324
25088,25088,Sergei Zubov,2003-04,33.0,12,55,82,82,11,44,55,158.0,2118.0,779,116,449,565,1716.0,82,5.31,60,363,2326,9.4,0.63184977
25089,25089,Sergei Zubov,2004-05,34.0,13,42,77,77,7,35,42,154.0,1990.0,856,123,484,607,1870.0,82,5.14,57,348,2300,9.2,0.7146785
25090,25090,Sergei Zubov,2006-07,36.0,14,71,78,78,13,58,71,141.0,2063.0,934,136,542,678,2011.0,82,6.05,85,480,2458,10.1,0.7059995
25091,25091,Sergei Zubov,2007-08,37.0,15,54,78,78,12,42,54,156.0,2024.0,1012,148,584,732,2167.0,82,5.76,70,398,2426,9.7,0.6074203
25092,25092,Sergei Zubov,2008-09,38.0,16,35,46,46,4,31,35,84.0,1182.0,1058,152,615,767,2251.0,82,5.44,62,351,2383,9.4,0.50767297
25093,25093,Sergei Zubov,2009-10,39.0,17,4,10,10,0,4,4,15.0,243.0,1068,152,619,771,2266.0,82,5.7,65,341,2477,9.4,0.29575998
25094,25094,Sergey Gusev,1998-99,23.0,2,0,9,9,0,0,0,5.0,,9,0,0,0,5.0,82,5.28,57,380,2242,9.6,0.1736787
25095,25095,Sergey Gusev,1999-00,24.0,3,8,36,36,1,7,8,46.0,566.0,45,1,7,8,51.0,82,5.27,57,359,2285,9.4,0.20182124
25096,25096,Sergey Gusev,2000-01,25.0,4,5,28,28,2,3,5,23.0,492.0,73,3,10,13,74.0,82,5.49,53,331,2294,9.8,0.19875652
25097,25097,Sergey Gusev,2001-02,26.0,5,1,16,16,1,0,1,13.0,214.0,89,4,10,14,87.0,82,5.51,63,376,2272,9.9,0.17207652
25098,25098,Sergey Kalinin,2016-17,25.0,2,15,78,78,8,7,15,70.0,1039.0,78,8,7,15,70.0,82,5.34,48,255,2438,9.0,0.19977495
25099,25099,Sergey Kalinin,2017-18,26.0,3,4,43,43,2,2,4,38.0,550.0,121,10,9,19,108.0,82,5.45,47,245,2478,9.0,0.1618717
25100,25100,Sergey Tolchinsky,2016-17,21.0,2,1,2,2,0,1,1,1.0,24.0,2,0,1,1,1.0,82,5.34,48,255,2438,9.0,0.24490705
25101,25101,Sergey Tolchinsky,2017-18,22.0,3,1,2,2,0,1,1,2.0,23.0,4,0,2,2,3.0,82,5.45,47,245,2478,9.0,0.2132574
25102,25102,Sergio Momesso,1984-85,19.0,2,0,1,1,0,0,0,0.0,,1,0,0,0,0.0,80,7.89,74,336,2448,12.9,0.25628674
25103,25103,Sergio Momesso,1986-87,21.0,3,15,24,24,8,7,15,37.0,,25,8,7,15,37.0,80,7.94,82,370,2484,12.8,0.5478672
25104,25104,Sergio Momesso,1987-88,22.0,4,31,59,59,14,17,31,95.0,,84,22,24,46,132.0,80,7.34,72,344,2400,12.2,0.50211746
25105,25105,Sergio Momesso,1988-89,23.0,5,21,53,53,7,14,21,72.0,,137,29,38,67,204.0,80,7.43,89,437,2435,12.2,0.44461533
25106,25106,Sergio Momesso,1989-90,24.0,6,26,53,53,9,17,26,81.0,,190,38,55,93,285.0,80,7.48,85,403,2430,12.3,0.48711482
25107,25107,Sergio Momesso,1990-91,25.0,7,56,79,79,24,32,56,182.0,,269,62,87,149,467.0,80,7.37,76,367,2421,12.2,0.6915631
25108,25108,Sergio Momesso,1991-92,26.0,8,36,70,70,16,20,36,119.0,,339,78,107,185,586.0,80,6.91,71,366,2385,11.6,0.5374609
25109,25109,Sergio Momesso,1992-93,27.0,9,43,58,58,20,23,43,153.0,,397,98,130,228,739.0,80,6.96,77,402,2440,11.4,0.6308914
25110,25110,Sergio Momesso,1993-94,28.0,10,38,84,84,18,20,38,146.0,,481,116,150,266,885.0,84,7.25,87,443,2603,11.7,0.46292028
25111,25111,Sergio Momesso,1994-95,29.0,11,27,68,68,14,13,27,112.0,,549,130,163,293,997.0,84,6.48,76,407,2545,10.7,0.3710298
25112,25112,Sergio Momesso,1995-96,30.0,12,25,48,48,10,15,25,82.0,,597,140,178,318,1079.0,48,5.97,37,209,1408,10.2,0.48082548
25113,25113,Sergio Momesso,1996-97,31.0,13,23,73,73,11,12,23,126.0,,670,151,190,341,1205.0,82,6.29,74,413,2481,10.4,0.27416283
25114,25114,Sergio Momesso,1997-98,32.0,14,4,40,40,1,3,4,43.0,,710,152,193,345,1248.0,82,5.83,55,336,2444,9.8,0.19101167
25115,25115,Seth Griffith,2015-16,23.0,2,10,30,30,6,4,10,33.0,403.0,30,6,4,10,33.0,82,5.32,47,251,2453,8.9,0.29914212
25116,25116,Seth Griffith,2016-17,24.0,3,1,4,4,0,1,1,2.0,40.0,34,6,5,11,35.0,82,5.34,48,255,2438,9.0,0.19192943
25117,25117,Seth Griffith,2017-18,25.0,4,5,24,24,0,5,5,21.0,306.0,58,6,10,16,56.0,82,5.45,47,245,2478,9.0,0.16770488
25118,25118,Seth Griffith,2018-19,26.0,5,3,21,21,2,1,3,15.0,222.0,79,8,11,19,71.0,82,5.86,50,250,2620,9.2,0.17200029
25119,25119,Seth Helgeson,2015-16,25.0,2,2,22,22,0,2,2,11.0,296.0,22,0,2,2,11.0,82,5.32,47,251,2453,8.9,0.11223945
25120,25120,Seth Helgeson,2016-17,26.0,3,1,19,19,0,1,1,9.0,265.0,41,0,3,3,20.0,82,5.34,48,255,2438,9.0,0.105277896
25121,25121,Seth Helgeson,2017-18,27.0,4,1,9,9,1,0,1,3.0,121.0,50,1,3,4,23.0,82,5.45,47,245,2478,9.0,0.14258176
25122,25122,Seth Jones,2014-15,20.0,2,25,77,77,6,19,25,100.0,1511.0,77,6,19,25,100.0,82,5.34,48,269,2463,8.9,0.37573045
25123,25123,Seth Jones,2015-16,21.0,3,27,82,82,8,19,27,123.0,1630.0,159,14,38,52,223.0,82,5.32,47,251,2453,8.9,0.3796739
25124,25124,Seth Jones,2016-17,22.0,4,31,81,81,3,28,31,157.0,1788.0,240,17,66,83,380.0,82,5.34,48,255,2438,9.0,0.40833914
25125,25125,Seth Jones,2017-18,23.0,5,42,75,75,12,30,42,152.0,1755.0,315,29,96,125,532.0,82,5.45,47,245,2478,9.0,0.5466703
25126,25126,Seth Jones,2018-19,24.0,6,57,78,78,16,41,57,249.0,1919.0,393,45,137,182,781.0,82,5.86,50,250,2620,9.2,0.7192053
25127,25127,Seth Jones,2019-20,25.0,7,46,75,75,9,37,46,184.0,1937.0,468,54,174,228,965.0,82,5.96,47,239,2579,9.5,0.597693
25128,25128,Seth Jones,2020-21,26.0,8,30,56,56,6,24,30,126.0,1416.0,524,60,198,258,1091.0,70,5.96,42,208,2192,9.5,0.55562514
25129,25129,Shane Churla,1987-88,22.0,2,1,20,20,0,1,1,2.0,,20,0,1,1,2.0,80,7.34,72,344,2400,12.2,0.15917635
25130,25130,Shane Churla,1988-89,23.0,3,6,31,31,1,5,6,15.0,,51,1,6,7,17.0,80,7.43,89,437,2435,12.2,0.17408514
25131,25131,Shane Churla,1989-90,24.0,4,1,18,18,1,0,1,8.0,,69,2,6,8,25.0,80,7.48,85,403,2430,12.3,0.19763327
25132,25132,Shane Churla,1990-91,25.0,5,5,53,53,2,3,5,40.0,,122,4,9,13,65.0,80,7.37,76,367,2421,12.2,0.15462154
25133,25133,Shane Churla,1991-92,26.0,6,4,40,40,2,2,4,32.0,,162,6,11,17,97.0,80,6.91,71,366,2385,11.6,0.16714558
25134,25134,Shane Churla,1992-93,27.0,7,5,57,57,4,1,5,42.0,,219,10,12,22,139.0,80,6.96,77,402,2440,11.4,0.15311122
25135,25135,Shane Churla,1993-94,28.0,8,21,73,73,5,16,21,61.0,,292,15,28,43,200.0,84,7.25,87,443,2603,11.7,0.18481535
25136,25136,Shane Churla,1994-95,29.0,9,13,69,69,6,7,13,62.0,,361,21,35,56,262.0,84,6.48,76,407,2545,10.7,0.1688376
25137,25137,Shane Churla,1995-96,30.0,10,4,27,27,1,3,4,22.0,,388,22,38,60,284.0,48,5.97,37,209,1408,10.2,0.15077338
25138,25138,Shane Churla,1996-97,31.0,11,10,55,55,4,6,10,32.0,,443,26,44,70,316.0,82,6.29,74,413,2481,10.4,0.1335927
25139,25139,Shane Churla,1997-98,32.0,12,1,45,45,0,1,1,19.0,,488,26,45,71,335.0,82,5.83,55,336,2444,9.8,0.079024374
25140,25140,Shane Doan,1996-97,20.0,2,17,74,74,7,10,17,106.0,,74,7,10,17,106.0,82,6.29,74,413,2481,10.4,0.33187315
25141,25141,Shane Doan,1997-98,21.0,3,12,63,63,4,8,12,100.0,,137,11,18,29,206.0,82,5.83,55,336,2444,9.8,0.29187226
25142,25142,Shane Doan,1998-99,22.0,4,11,33,33,5,6,11,42.0,,170,16,24,40,248.0,82,5.28,57,380,2242,9.6,0.2969366
25143,25143,Shane Doan,1999-00,23.0,5,22,79,79,6,16,22,156.0,1003.0,249,22,40,62,404.0,82,5.27,57,359,2285,9.4,0.37168872
25144,25144,Shane Doan,2000-01,24.0,6,51,81,81,26,25,51,221.0,1365.0,330,48,65,113,625.0,82,5.49,53,331,2294,9.8,0.64633715
25145,25145,Shane Doan,2001-02,25.0,7,63,76,76,26,37,63,220.0,1485.0,406,74,102,176,845.0,82,5.51,63,376,2272,9.9,0.7189107
25146,25146,Shane Doan,2002-03,26.0,8,49,81,81,20,29,49,205.0,1471.0,487,94,131,225,1050.0,82,5.24,53,338,2262,9.5,0.6213099
25147,25147,Shane Doan,2003-04,27.0,9,58,82,82,21,37,58,225.0,1540.0,569,115,168,283,1275.0,82,5.31,60,363,2326,9.4,0.6945294
25148,25148,Shane Doan,2004-05,28.0,10,68,79,79,27,41,68,254.0,1719.0,648,142,209,351,1529.0,82,5.14,57,348,2300,9.2,0.8506626
25149,25149,Shane Doan,2006-07,30.0,11,66,82,82,30,36,66,254.0,1568.0,730,172,245,417,1783.0,82,6.05,85,480,2458,10.1,0.8002744
25150,25150,Shane Doan,2007-08,31.0,12,55,73,73,27,28,55,209.0,1493.0,803,199,273,472,1992.0,82,5.76,70,398,2426,9.7,0.67932725
25151,25151,Shane Doan,2008-09,32.0,13,78,80,80,28,50,78,243.0,1661.0,883,227,323,550,2235.0,82,5.44,62,351,2383,9.4,0.8103306
25152,25152,Shane Doan,2009-10,33.0,14,73,82,82,31,42,73,230.0,1660.0,965,258,365,623,2465.0,82,5.7,65,341,2477,9.4,0.7779895
25153,25153,Shane Doan,2010-11,34.0,15,55,82,82,18,37,55,234.0,1571.0,1047,276,402,678,2699.0,82,5.53,56,304,2486,9.1,0.6412655
25154,25154,Shane Doan,2011-12,35.0,16,60,72,72,20,40,60,221.0,1389.0,1119,296,442,738,2920.0,82,5.46,52,291,2492,9.0,0.66203296
25155,25155,Shane Doan,2012-13,36.0,17,50,79,79,22,28,50,226.0,1548.0,1198,318,470,788,3146.0,82,5.32,47,271,2439,8.9,0.5540055
25156,25156,Shane Doan,2013-14,37.0,18,27,48,48,13,14,27,129.0,867.0,1246,331,484,815,3275.0,48,5.31,29,160,1399,9.1,0.64111704
25157,25157,Shane Doan,2014-15,38.0,19,47,69,69,23,24,47,167.0,1307.0,1315,354,508,862,3442.0,82,5.34,48,269,2463,8.9,0.5480125
25158,25158,Shane Doan,2015-16,39.0,20,36,79,79,14,22,36,189.0,1492.0,1394,368,530,898,3631.0,82,5.32,47,251,2453,8.9,0.47870126
25159,25159,Shane Doan,2016-17,40.0,21,47,72,72,28,19,47,170.0,1267.0,1466,396,549,945,3801.0,82,5.34,48,255,2438,9.0,0.5654698
25160,25160,Shane Doan,2017-18,41.0,22,27,74,74,6,21,27,144.0,1114.0,1540,402,570,972,3945.0,82,5.45,47,245,2478,9.0,0.3185383
25161,25161,Shane Endicott,2002-03,21.0,2,1,4,4,0,1,1,2.0,34.0,4,0,1,1,2.0,82,5.24,53,338,2262,9.5,0.22397411
25162,25162,Shane Endicott,2006-07,25.0,3,2,41,41,1,1,2,44.0,480.0,45,1,2,3,46.0,82,6.05,85,480,2458,10.1,0.1507239
25163,25163,Shane Gersich,2018-19,22.0,2,1,3,3,0,1,1,4.0,27.0,3,0,1,1,4.0,82,5.86,50,250,2620,9.2,0.20928982
25164,25164,Shane Harper,2017-18,28.0,2,3,14,14,2,1,3,13.0,144.0,14,2,1,3,13.0,82,5.45,47,245,2478,9.0,0.2385484
25165,25165,Shane Hnidy,2001-02,26.0,2,5,52,52,3,2,5,47.0,681.0,52,3,2,5,47.0,82,5.51,63,376,2272,9.9,0.13906756
25166,25166,Shane Hnidy,2002-03,27.0,3,2,33,33,1,1,2,34.0,559.0,85,4,3,7,81.0,82,5.24,53,338,2262,9.5,0.16118607
25167,25167,Shane Hnidy,2003-04,28.0,4,8,67,67,0,8,8,58.0,932.0,152,4,11,15,139.0,82,5.31,60,363,2326,9.4,0.1306962
25168,25168,Shane Hnidy,2004-05,29.0,5,7,46,46,0,7,7,28.0,582.0,198,4,18,22,167.0,82,5.14,57,348,2300,9.2,0.13570043
25169,25169,Shane Hnidy,2006-07,31.0,6,3,66,66,0,3,3,50.0,675.0,264,4,21,25,217.0,82,6.05,85,480,2458,10.1,0.12061441
25170,25170,Shane Hnidy,2007-08,32.0,7,12,72,72,5,7,12,86.0,1126.0,336,9,28,37,303.0,82,5.76,70,398,2426,9.7,0.17104256
25171,25171,Shane Hnidy,2008-09,33.0,8,8,76,76,2,6,8,49.0,1066.0,412,11,34,45,352.0,82,5.44,62,351,2383,9.4,0.13142088
25172,25172,Shane Hnidy,2009-10,34.0,9,12,65,65,3,9,12,49.0,1016.0,477,14,43,57,401.0,82,5.7,65,341,2477,9.4,0.13724357
25173,25173,Shane Hnidy,2010-11,35.0,10,14,70,70,2,12,14,49.0,948.0,547,16,55,71,450.0,82,5.53,56,304,2486,9.1,0.13299075
25174,25174,Shane Hnidy,2011-12,36.0,11,0,3,3,0,0,0,3.0,44.0,550,16,55,71,453.0,82,5.46,52,291,2492,9.0,0.11914042
25175,25175,Shane MacEachern,1988-89,21.0,2,0,1,1,0,0,0,0.0,,1,0,0,0,0.0,80,7.43,89,437,2435,12.2,0.20433158
25176,25176,Shane O'Brien,2007-08,24.0,2,16,80,80,2,14,16,72.0,1198.0,80,2,14,16,72.0,82,5.76,70,398,2426,9.7,0.22448656
25177,25177,Shane O'Brien,2008-09,25.0,3,21,77,77,4,17,21,69.0,1634.0,157,6,31,37,141.0,82,5.44,62,351,2383,9.4,0.22766745
25178,25178,Shane O'Brien,2009-10,26.0,4,10,77,77,0,10,10,39.0,1149.0,234,6,41,47,180.0,82,5.7,65,341,2477,9.4,0.1642384
25179,25179,Shane O'Brien,2010-11,27.0,5,8,65,65,2,6,8,37.0,1106.0,299,8,47,55,217.0,82,5.53,56,304,2486,9.1,0.15056834
25180,25180,Shane O'Brien,2011-12,28.0,6,9,80,80,2,7,9,50.0,1369.0,379,10,54,64,267.0,82,5.46,52,291,2492,9.0,0.14582524
25181,25181,Shane O'Brien,2012-13,29.0,7,20,76,76,3,17,20,114.0,1461.0,455,13,71,84,381.0,82,5.32,47,271,2439,8.9,0.23503187
25182,25182,Shane O'Brien,2013-14,30.0,8,4,28,28,0,4,4,28.0,434.0,483,13,75,88,409.0,48,5.31,29,160,1399,9.1,0.17100292
25183,25183,Shane O'Brien,2014-15,31.0,9,3,45,45,0,3,3,16.0,507.0,528,13,78,91,425.0,82,5.34,48,269,2463,8.9,0.11008763
25184,25184,Shane O'Brien,2015-16,32.0,10,1,9,9,0,1,1,4.0,121.0,537,13,79,92,429.0,82,5.32,47,251,2453,8.9,0.12301308
25185,25185,Shane Prince,2015-16,23.0,2,1,2,2,0,1,1,2.0,21.0,2,0,1,1,2.0,82,5.32,47,251,2453,8.9,0.19689053
25186,25186,Shane Prince,2016-17,24.0,3,17,62,62,6,11,17,88.0,696.0,64,6,12,18,90.0,82,5.34,48,255,2438,9.0,0.2796706
25187,25187,Shane Prince,2017-18,25.0,4,18,50,50,5,13,18,71.0,649.0,114,11,25,36,161.0,82,5.45,47,245,2478,9.0,0.31608635
25188,25188,Shane Prince,2018-19,26.0,5,2,14,14,1,1,2,20.0,168.0,128,12,26,38,181.0,82,5.86,50,250,2620,9.2,0.19734037
25189,25189,Shane Sims,2011-12,23.0,2,0,1,1,0,0,0,0.0,7.0,1,0,0,0,0.0,82,5.46,52,291,2492,9.0,0.15535027
25190,25190,Shane Willis,1999-00,22.0,2,0,7,7,0,0,0,1.0,16.0,7,0,0,0,1.0,82,5.27,57,359,2285,9.4,0.15355206
25191,25191,Shane Willis,2000-01,23.0,3,0,2,2,0,0,0,1.0,12.0,9,0,0,0,2.0,82,5.49,53,331,2294,9.8,0.16271761
25192,25192,Shane Willis,2001-02,24.0,4,44,73,73,20,24,44,172.0,1166.0,82,20,24,44,174.0,82,5.51,63,376,2272,9.9,0.5614475
25193,25193,Shane Willis,2002-03,25.0,5,24,80,80,11,13,24,155.0,1004.0,162,31,37,68,329.0,82,5.24,53,338,2262,9.5,0.37462515
25194,25194,Shane Willis,2004-05,27.0,6,6,12,12,0,6,6,27.0,166.0,174,31,43,74,356.0,82,5.14,57,348,2300,9.2,0.34248653
25195,25195,Shaone Morrisonn,2003-04,21.0,2,0,11,11,0,0,0,4.0,98.0,11,0,0,0,4.0,82,5.31,60,363,2326,9.4,0.16790101
25196,25196,Shaone Morrisonn,2004-05,22.0,3,8,33,33,1,7,8,14.0,602.0,44,1,7,8,18.0,82,5.14,57,348,2300,9.2,0.19251522
25197,25197,Shaone Morrisonn,2006-07,24.0,4,14,80,80,1,13,14,56.0,1658.0,124,2,20,22,74.0,82,6.05,85,480,2458,10.1,0.14961001
25198,25198,Shaone Morrisonn,2007-08,25.0,5,13,78,78,3,10,13,46.0,1634.0,202,5,30,35,120.0,82,5.76,70,398,2426,9.7,0.16600725
25199,25199,Shaone Morrisonn,2008-09,26.0,6,10,76,76,1,9,10,47.0,1540.0,278,6,39,45,167.0,82,5.44,62,351,2383,9.4,0.16501442
25200,25200,Shaone Morrisonn,2009-10,27.0,7,13,72,72,3,10,13,50.0,1295.0,350,9,49,58,217.0,82,5.7,65,341,2477,9.4,0.158128
25201,25201,Shaone Morrisonn,2010-11,28.0,8,12,68,68,1,11,12,32.0,1195.0,418,10,60,70,249.0,82,5.53,56,304,2486,9.1,0.12792906
25202,25202,Shaone Morrisonn,2011-12,29.0,9,5,62,62,1,4,5,44.0,1003.0,480,11,64,75,293.0,82,5.46,52,291,2492,9.0,0.1478473
25203,25203,Shaun Heshka,2010-11,25.0,2,2,8,8,0,2,2,3.0,107.0,8,0,2,2,3.0,82,5.53,56,304,2486,9.1,0.18394786
25204,25204,Shaun Sabol,1990-91,24.0,2,0,2,2,0,0,0,2.0,,2,0,0,0,2.0,80,7.37,76,367,2421,12.2,0.2231631
25205,25205,Shaun Van Allen,1991-92,24.0,2,0,2,2,0,0,0,0.0,,2,0,0,0,0.0,80,6.91,71,366,2385,11.6,0.1935659
25206,25206,Shaun Van Allen,1993-94,26.0,3,5,21,21,1,4,5,19.0,,23,1,4,5,19.0,84,7.25,87,443,2603,11.7,0.19015172
25207,25207,Shaun Van Allen,1994-95,27.0,4,33,80,80,8,25,33,104.0,,103,9,29,38,123.0,84,6.48,76,407,2545,10.7,0.3850856
25208,25208,Shaun Van Allen,1995-96,28.0,5,29,45,45,8,21,29,68.0,,148,17,50,67,191.0,48,5.97,37,209,1408,10.2,0.46680477
25209,25209,Shaun Van Allen,1996-97,29.0,6,25,49,49,8,17,25,78.0,,197,25,67,92,269.0,82,6.29,74,413,2481,10.4,0.40795344
25210,25210,Shaun Van Allen,1997-98,30.0,7,25,80,80,11,14,25,123.0,,277,36,81,117,392.0,82,5.83,55,336,2444,9.8,0.30945098
25211,25211,Shaun Van Allen,1998-99,31.0,8,19,80,80,4,15,19,104.0,,357,40,96,136,496.0,82,5.28,57,380,2242,9.6,0.2627766
25212,25212,Shaun Van Allen,1999-00,32.0,9,17,79,79,6,11,17,47.0,878.0,436,46,107,153,543.0,82,5.27,57,359,2285,9.4,0.21341556
25213,25213,Shaun Van Allen,2000-01,33.0,10,28,75,75,9,19,28,75.0,886.0,511,55,126,181,618.0,82,5.49,53,331,2294,9.8,0.301854
25214,25214,Shaun Van Allen,2001-02,34.0,11,23,59,59,7,16,23,51.0,712.0,570,62,142,204,669.0,82,5.51,63,376,2272,9.9,0.28808248
25215,25215,Shaun Van Allen,2002-03,35.0,12,21,73,73,8,13,21,48.0,794.0,643,70,155,225,717.0,82,5.24,53,338,2262,9.5,0.2444213
25216,25216,Shaun Van Allen,2003-04,36.0,13,32,78,78,12,20,32,53.0,974.0,721,82,175,257,770.0,82,5.31,60,363,2326,9.4,0.30675134
25217,25217,Shaun Van Allen,2004-05,37.0,14,12,73,73,2,10,12,41.0,839.0,794,84,185,269,811.0,82,5.14,57,348,2300,9.2,0.18797639
25218,25218,Shawn Anderson,1987-88,19.0,2,13,41,41,2,11,13,26.0,,41,2,11,13,26.0,80,7.34,72,344,2400,12.2,0.31549692
25219,25219,Shawn Anderson,1988-89,20.0,3,3,23,23,1,2,3,29.0,,64,3,13,16,55.0,80,7.43,89,437,2435,12.2,0.35784373
25220,25220,Shawn Anderson,1989-90,21.0,4,12,33,33,2,10,12,26.0,,97,5,23,28,81.0,80,7.48,85,403,2430,12.3,0.34911746
25221,25221,Shawn Anderson,1990-91,22.0,5,4,16,16,1,3,4,16.0,,113,6,26,32,97.0,80,7.37,76,367,2421,12.2,0.29974967
25222,25222,Shawn Anderson,1991-92,23.0,6,13,31,31,3,10,13,44.0,,144,9,36,45,141.0,80,6.91,71,366,2385,11.6,0.3380426
25223,25223,Shawn Anderson,1993-94,25.0,7,8,60,60,2,6,8,42.0,,204,11,42,53,183.0,84,7.25,87,443,2603,11.7,0.18867907
25224,25224,Shawn Anderson,1994-95,26.0,8,9,50,50,0,9,9,31.0,,254,11,51,62,214.0,84,6.48,76,407,2545,10.7,0.13267675
25225,25225,Shawn Anderson,1995-96,27.0,9,0,1,1,0,0,0,0.0,,255,11,51,62,214.0,48,5.97,37,209,1408,10.2,0.2327039
25226,25226,Shawn Antoski,1991-92,21.0,2,0,2,2,0,0,0,2.0,,2,0,0,0,2.0,80,6.91,71,366,2385,11.6,0.22542247
25227,25227,Shawn Antoski,1992-93,22.0,3,0,4,4,0,0,0,6.0,,6,0,0,0,8.0,80,6.96,77,402,2440,11.4,0.21529666
25228,25228,Shawn Antoski,1993-94,23.0,4,0,2,2,0,0,0,0.0,,8,0,0,0,8.0,84,7.25,87,443,2603,11.7,0.18533963
25229,25229,Shawn Antoski,1994-95,24.0,5,3,55,55,1,2,3,25.0,,63,1,2,3,33.0,84,6.48,76,407,2545,10.7,0.10537773
25230,25230,Shawn Antoski,1995-96,25.0,6,0,32,32,0,0,0,16.0,,95,1,2,3,49.0,48,5.97,37,209,1408,10.2,0.1035617
25231,25231,Shawn Antoski,1996-97,26.0,7,4,64,64,1,3,4,34.0,,159,2,5,7,83.0,82,6.29,74,413,2481,10.4,0.11679456
25232,25232,Shawn Antoski,1997-98,27.0,8,0,15,15,0,0,0,3.0,,174,2,5,7,86.0,82,5.83,55,336,2444,9.8,0.105584234
25233,25233,Shawn Antoski,1998-99,28.0,9,1,9,9,1,0,1,6.0,,183,3,5,8,92.0,82,5.28,57,380,2242,9.6,0.14249614
25234,25234,Shawn Bates,1998-99,23.0,2,2,13,13,2,0,2,12.0,,13,2,0,2,12.0,82,5.28,57,380,2242,9.6,0.24551544
25235,25235,Shawn Bates,1999-00,24.0,3,9,33,33,5,4,9,30.0,283.0,46,7,4,11,42.0,82,5.27,57,359,2285,9.4,0.24870557
25236,25236,Shawn Bates,2000-01,25.0,4,12,44,44,5,7,12,65.0,478.0,90,12,11,23,107.0,82,5.49,53,331,2294,9.8,0.2513032
25237,25237,Shawn Bates,2001-02,26.0,5,5,45,45,2,3,5,59.0,419.0,135,14,14,28,166.0,82,5.51,63,376,2272,9.9,0.17520812
25238,25238,Shawn Bates,2002-03,27.0,6,52,71,71,17,35,52,150.0,1332.0,206,31,49,80,316.0,82,5.24,53,338,2262,9.5,0.60806036
25239,25239,Shawn Bates,2003-04,28.0,7,42,74,74,13,29,42,126.0,1364.0,280,44,78,122,442.0,82,5.31,60,363,2326,9.4,0.46526945
25240,25240,Shawn Bates,2004-05,29.0,8,32,69,69,9,23,32,115.0,1272.0,349,53,101,154,557.0,82,5.14,57,348,2300,9.2,0.49520743
25241,25241,Shawn Bates,2006-07,31.0,9,34,66,66,15,19,34,95.0,1135.0,415,68,120,188,652.0,82,6.05,85,480,2458,10.1,0.36133295
25242,25242,Shawn Bates,2007-08,32.0,10,10,48,48,4,6,10,50.0,601.0,463,72,126,198,702.0,82,5.76,70,398,2426,9.7,0.23875746
25243,25243,Shawn Bates,2008-09,33.0,11,0,2,2,0,0,0,0.0,14.0,465,72,126,198,702.0,82,5.44,62,351,2383,9.4,0.23361221
25244,25244,Shawn Belle,2007-08,23.0,2,1,9,9,0,1,1,3.0,89.0,9,0,1,1,3.0,82,5.76,70,398,2426,9.7,0.19367829
25245,25245,Shawn Belle,2010-11,26.0,3,0,2,2,0,0,0,1.0,21.0,11,0,1,1,4.0,82,5.53,56,304,2486,9.1,0.16163915
25246,25246,Shawn Belle,2011-12,27.0,4,0,9,9,0,0,0,8.0,154.0,20,0,1,1,12.0,82,5.46,52,291,2492,9.0,0.15570831
25247,25247,Shawn Burr,1985-86,19.0,2,0,9,9,0,0,0,4.0,,9,0,0,0,4.0,80,7.77,71,321,2447,12.7,0.25712496
25248,25248,Shawn Burr,1986-87,20.0,3,1,5,5,1,0,1,6.0,,14,1,0,1,10.0,80,7.94,82,370,2484,12.8,0.28364545
25249,25249,Shawn Burr,1987-88,21.0,4,47,80,80,22,25,47,153.0,,94,23,25,48,163.0,80,7.34,72,344,2400,12.2,0.7049204
25250,25250,Shawn Burr,1988-89,22.0,5,40,78,78,17,23,40,124.0,,172,40,48,88,287.0,80,7.43,89,437,2435,12.2,0.54532063
25251,25251,Shawn Burr,1989-90,23.0,6,46,79,79,19,27,46,149.0,,251,59,75,134,436.0,80,7.48,85,403,2430,12.3,0.58277303
25252,25252,Shawn Burr,1990-91,24.0,7,56,76,76,24,32,56,173.0,,327,83,107,190,609.0,80,7.37,76,367,2421,12.2,0.726761
25253,25253,Shawn Burr,1991-92,25.0,8,50,80,80,20,30,50,164.0,,407,103,137,240,773.0,80,6.91,71,366,2385,11.6,0.611637
25254,25254,Shawn Burr,1992-93,26.0,9,51,79,79,19,32,51,140.0,,486,122,169,291,913.0,80,6.96,77,402,2440,11.4,0.6120277
25255,25255,Shawn Burr,1993-94,27.0,10,35,80,80,10,25,35,99.0,,566,132,194,326,1012.0,84,7.25,87,443,2603,11.7,0.41984582
25256,25256,Shawn Burr,1994-95,28.0,11,22,51,51,10,12,22,64.0,,617,142,206,348,1076.0,84,6.48,76,407,2545,10.7,0.4008652
25257,25257,Shawn Burr,1995-96,29.0,12,14,42,42,6,8,14,65.0,,659,148,214,362,1141.0,48,5.97,37,209,1408,10.2,0.38700998
25258,25258,Shawn Burr,1996-97,30.0,13,28,81,81,13,15,28,122.0,,740,161,229,390,1263.0,82,6.29,74,413,2481,10.4,0.3544258
25259,25259,Shawn Burr,1997-98,31.0,14,35,74,74,14,21,35,128.0,,814,175,250,425,1391.0,82,5.83,55,336,2444,9.8,0.3767019
25260,25260,Shawn Burr,1998-99,32.0,15,12,42,42,6,6,12,63.0,,856,181,256,437,1454.0,82,5.28,57,380,2242,9.6,0.22880355
25261,25261,Shawn Burr,1999-00,33.0,16,1,18,18,0,1,1,22.0,157.0,874,181,257,438,1476.0,82,5.27,57,359,2285,9.4,0.27410853
25262,25262,Shawn Burr,2000-01,34.0,17,2,4,4,0,2,2,6.0,46.0,878,181,259,440,1482.0,82,5.49,53,331,2294,9.8,0.1963248
25263,25263,Shawn Byram,1991-92,23.0,2,0,4,4,0,0,0,2.0,,4,0,0,0,2.0,80,6.91,71,366,2385,11.6,0.20226651
25264,25264,Shawn Byram,1992-93,24.0,3,0,1,1,0,0,0,1.0,,5,0,0,0,3.0,80,6.96,77,402,2440,11.4,0.20098788
25265,25265,Shawn Chambers,1988-89,22.0,2,8,19,19,1,7,8,28.0,,19,1,7,8,28.0,80,7.43,89,437,2435,12.2,0.32155156
25266,25266,Shawn Chambers,1989-90,23.0,3,24,72,72,5,19,24,131.0,,91,6,26,32,159.0,80,7.48,85,403,2430,12.3,0.37712097
25267,25267,Shawn Chambers,1990-91,24.0,4,26,78,78,8,18,26,116.0,,169,14,44,58,275.0,80,7.37,76,367,2421,12.2,0.34439862
25268,25268,Shawn Chambers,1991-92,25.0,5,4,29,29,1,3,4,55.0,,198,15,47,62,330.0,80,6.91,71,366,2385,11.6,0.23132306
25269,25269,Shawn Chambers,1992-93,26.0,6,0,2,2,0,0,0,1.0,,200,15,47,62,331.0,80,6.96,77,402,2440,11.4,0.2621919
25270,25270,Shawn Chambers,1993-94,27.0,7,39,55,55,10,29,39,152.0,,255,25,76,101,483.0,84,7.25,87,443,2603,11.7,0.5927574
25271,25271,Shawn Chambers,1994-95,28.0,8,34,66,66,11,23,34,142.0,,321,36,99,135,625.0,84,6.48,76,407,2545,10.7,0.43266386
25272,25272,Shawn Chambers,1995-96,29.0,9,21,45,45,4,17,21,67.0,,366,40,116,156,692.0,48,5.97,37,209,1408,10.2,0.3900414
25273,25273,Shawn Chambers,1996-97,30.0,10,23,64,64,2,21,23,112.0,,430,42,137,179,804.0,82,6.29,74,413,2481,10.4,0.30031124
25274,25274,Shawn Chambers,1997-98,31.0,11,21,73,73,4,17,21,114.0,,503,46,154,200,918.0,82,5.83,55,336,2444,9.8,0.2712869
25275,25275,Shawn Chambers,1998-99,32.0,12,24,57,57,2,22,24,73.0,,560,48,176,224,991.0,82,5.28,57,380,2242,9.6,0.29563457
25276,25276,Shawn Chambers,1999-00,33.0,13,11,61,61,2,9,11,82.0,1060.0,621,50,185,235,1073.0,82,5.27,57,359,2285,9.4,0.19162187
25277,25277,Shawn Chambers,2000-01,34.0,14,0,4,4,0,0,0,2.0,92.0,625,50,185,235,1075.0,82,5.49,53,331,2294,9.8,0.17417878
25278,25278,Shawn Cronin,1989-90,26.0,2,0,1,1,0,0,0,0.0,,1,0,0,0,0.0,80,7.48,85,403,2430,12.3,0.1660105
25279,25279,Shawn Cronin,1990-91,27.0,3,4,61,61,0,4,4,30.0,,62,0,4,4,30.0,80,7.37,76,367,2421,12.2,0.11683807
25280,25280,Shawn Cronin,1991-92,28.0,4,6,67,67,1,5,6,40.0,,129,1,9,10,70.0,80,6.91,71,366,2385,11.6,0.14245862
25281,25281,Shawn Cronin,1992-93,29.0,5,4,65,65,0,4,4,25.0,,194,1,13,14,95.0,80,6.96,77,402,2440,11.4,0.09044865
25282,25282,Shawn Cronin,1993-94,30.0,6,3,35,35,2,1,3,12.0,,229,3,14,17,107.0,84,7.25,87,443,2603,11.7,0.13448074
25283,25283,Shawn Cronin,1994-95,31.0,7,2,34,34,0,2,2,14.0,,263,3,16,19,121.0,84,6.48,76,407,2545,10.7,0.07760206
25284,25284,Shawn Cronin,1995-96,32.0,8,2,29,29,0,2,2,12.0,,292,3,18,21,133.0,48,5.97,37,209,1408,10.2,0.06602585
25285,25285,Shawn Evans,1986-87,21.0,2,0,7,7,0,0,0,1.0,,7,0,0,0,1.0,80,7.94,82,370,2484,12.8,0.21449313
25286,25286,Shawn Evans,1990-91,25.0,3,1,2,2,1,0,1,4.0,,9,1,0,1,5.0,80,7.37,76,367,2421,12.2,0.22761971
25287,25287,Shawn Heaphy,1993-94,25.0,2,0,1,1,0,0,0,2.0,,1,0,0,0,2.0,84,7.25,87,443,2603,11.7,0.20954195
25288,25288,Shawn Heins,1999-00,26.0,2,0,5,5,0,0,0,4.0,68.0,5,0,0,0,4.0,82,5.27,57,359,2285,9.4,0.16484177
25289,25289,Shawn Heins,2000-01,27.0,3,0,1,1,0,0,0,1.0,11.0,6,0,0,0,5.0,82,5.49,53,331,2294,9.8,0.1526553
25290,25290,Shawn Heins,2001-02,28.0,4,7,38,38,3,4,7,45.0,389.0,44,3,4,7,50.0,82,5.51,63,376,2272,9.9,0.16032308
25291,25291,Shawn Heins,2002-03,29.0,5,2,17,17,0,2,2,20.0,166.0,61,3,6,9,70.0,82,5.24,53,338,2262,9.5,0.1525909
25292,25292,Shawn Heins,2003-04,30.0,6,3,47,47,1,2,3,38.0,689.0,108,4,8,12,108.0,82,5.31,60,363,2326,9.4,0.13458085
25293,25293,Shawn Heins,2004-05,31.0,7,4,17,17,0,4,4,17.0,236.0,125,4,12,16,125.0,82,5.14,57,348,2300,9.2,0.1689021
25294,25294,Shawn Horcoff,2001-02,23.0,2,16,49,49,9,7,16,42.0,452.0,49,9,7,16,42.0,82,5.51,63,376,2272,9.9,0.33351278
25295,25295,Shawn Horcoff,2002-03,24.0,3,22,61,61,8,14,22,57.0,691.0,110,17,21,38,99.0,82,5.24,53,338,2262,9.5,0.32262972
25296,25296,Shawn Horcoff,2003-04,25.0,4,33,78,78,12,21,33,98.0,1053.0,188,29,42,71,197.0,82,5.31,60,363,2326,9.4,0.4179151
25297,25297,Shawn Horcoff,2004-05,26.0,5,40,80,80,15,25,40,110.0,1402.0,268,44,67,111,307.0,82,5.14,57,348,2300,9.2,0.55879086
25298,25298,Shawn Horcoff,2006-07,28.0,6,73,79,79,22,51,73,167.0,1578.0,347,66,118,184,474.0,82,6.05,85,480,2458,10.1,0.7922212
25299,25299,Shawn Horcoff,2007-08,29.0,7,51,80,80,16,35,51,168.0,1666.0,427,82,153,235,642.0,82,5.76,70,398,2426,9.7,0.55533695
25300,25300,Shawn Horcoff,2008-09,30.0,8,50,53,53,21,29,50,115.0,1178.0,480,103,182,285,757.0,82,5.44,62,351,2383,9.4,0.7678114
25301,25301,Shawn Horcoff,2009-10,31.0,9,53,80,80,17,36,53,178.0,1709.0,560,120,218,338,935.0,82,5.7,65,341,2477,9.4,0.62338233
25302,25302,Shawn Horcoff,2010-11,32.0,10,36,77,77,13,23,36,123.0,1496.0,637,133,241,374,1058.0,82,5.53,56,304,2486,9.1,0.40734372
25303,25303,Shawn Horcoff,2011-12,33.0,11,27,47,47,9,18,27,78.0,878.0,684,142,259,401,1136.0,82,5.46,52,291,2492,9.0,0.47131255
25304,25304,Shawn Horcoff,2012-13,34.0,12,34,81,81,13,21,34,123.0,1586.0,765,155,280,435,1259.0,82,5.32,47,271,2439,8.9,0.38136616
25305,25305,Shawn Horcoff,2013-14,35.0,13,12,31,31,7,5,12,41.0,523.0,796,162,285,447,1300.0,48,5.31,29,160,1399,9.1,0.31792876
25306,25306,Shawn Horcoff,2014-15,36.0,14,20,77,77,7,13,20,68.0,990.0,873,169,298,467,1368.0,82,5.34,48,269,2463,8.9,0.24009815
25307,25307,Shawn Horcoff,2015-16,37.0,15,29,76,76,11,18,29,82.0,989.0,949,180,316,496,1450.0,82,5.32,47,251,2453,8.9,0.27957135
25308,25308,Shawn Horcoff,2016-17,38.0,16,15,59,59,6,9,15,73.0,784.0,1008,186,325,511,1523.0,82,5.34,48,255,2438,9.0,0.24279001
25309,25309,Shawn Lalonde,2013-14,23.0,2,0,1,1,0,0,0,0.0,15.0,1,0,0,0,0.0,48,5.31,29,160,1399,9.1,0.19164318
25310,25310,Shawn Matthias,2008-09,20.0,2,2,4,4,2,0,2,5.0,53.0,4,2,0,2,5.0,82,5.44,62,351,2383,9.4,0.28894585
25311,25311,Shawn Matthias,2009-10,21.0,3,2,16,16,0,2,2,11.0,147.0,20,2,2,4,16.0,82,5.7,65,341,2477,9.4,0.24867103
25312,25312,Shawn Matthias,2010-11,22.0,4,16,55,55,7,9,16,67.0,594.0,75,9,11,20,83.0,82,5.53,56,304,2486,9.1,0.3120263
25313,25313,Shawn Matthias,2011-12,23.0,5,16,51,51,6,10,16,90.0,604.0,126,15,21,36,173.0,82,5.46,52,291,2492,9.0,0.34394014
25314,25314,Shawn Matthias,2012-13,24.0,6,24,79,79,10,14,24,133.0,1091.0,205,25,35,60,306.0,82,5.32,47,271,2439,8.9,0.33267817
25315,25315,Shawn Matthias,2013-14,25.0,7,21,48,48,14,7,21,106.0,729.0,253,39,42,81,412.0,48,5.31,29,160,1399,9.1,0.44157305
25316,25316,Shawn Matthias,2014-15,26.0,8,23,77,77,12,11,23,127.0,1002.0,330,51,53,104,539.0,82,5.34,48,269,2463,8.9,0.29444274
25317,25317,Shawn Matthias,2015-16,27.0,9,27,78,78,18,9,27,132.0,1022.0,408,69,62,131,671.0,82,5.32,47,251,2453,8.9,0.34175533
25318,25318,Shawn Matthias,2016-17,28.0,10,28,71,71,12,16,28,101.0,959.0,479,81,78,159,772.0,82,5.34,48,255,2438,9.0,0.3413133
25319,25319,Shawn Matthias,2017-18,29.0,11,12,45,45,8,4,12,51.0,610.0,524,89,82,171,823.0,82,5.45,47,245,2478,9.0,0.24019182
25320,25320,Shawn Matthias,2018-19,30.0,12,3,27,27,1,2,3,26.0,302.0,551,90,84,174,849.0,82,5.86,50,250,2620,9.2,0.23328248
25321,25321,Shawn McCosh,1992-93,23.0,2,0,4,4,0,0,0,2.0,,4,0,0,0,2.0,80,6.96,77,402,2440,11.4,0.21579227
25322,25322,Shawn McCosh,1995-96,26.0,3,1,5,5,1,0,1,2.0,,9,1,0,1,4.0,48,5.97,37,209,1408,10.2,0.22575483
25323,25323,Shawn McEachern,1992-93,23.0,2,4,15,15,0,4,4,14.0,,15,0,4,4,14.0,80,6.96,77,402,2440,11.4,0.25030315
25324,25324,Shawn McEachern,1993-94,24.0,3,61,84,84,28,33,61,196.0,,99,28,37,65,210.0,84,7.25,87,443,2603,11.7,0.7073457
25325,25325,Shawn McEachern,1994-95,25.0,4,42,76,76,20,22,42,159.0,,175,48,59,107,369.0,84,6.48,76,407,2545,10.7,0.50387764
25326,25326,Shawn McEachern,1995-96,26.0,5,26,44,44,13,13,26,97.0,,219,61,72,133,466.0,48,5.97,37,209,1408,10.2,0.63457316
25327,25327,Shawn McEachern,1996-97,27.0,6,53,82,82,24,29,53,238.0,,301,85,101,186,704.0,82,6.29,74,413,2481,10.4,0.6251258
25328,25328,Shawn McEachern,1997-98,28.0,7,31,65,65,11,20,31,150.0,,366,96,121,217,854.0,82,5.83,55,336,2444,9.8,0.47188377
25329,25329,Shawn McEachern,1998-99,29.0,8,48,81,81,24,24,48,229.0,,447,120,145,265,1083.0,82,5.28,57,380,2242,9.6,0.59143436
25330,25330,Shawn McEachern,1999-00,30.0,9,56,77,77,31,25,56,223.0,1444.0,524,151,170,321,1306.0,82,5.27,57,359,2285,9.4,0.6635382
25331,25331,Shawn McEachern,2000-01,31.0,10,51,69,69,29,22,51,219.0,1231.0,593,180,192,372,1525.0,82,5.49,53,331,2294,9.8,0.6594206
25332,25332,Shawn McEachern,2001-02,32.0,11,72,82,82,32,40,72,231.0,1510.0,675,212,232,444,1756.0,82,5.51,63,376,2272,9.9,0.71722704
25333,25333,Shawn McEachern,2002-03,33.0,12,46,80,80,15,31,46,196.0,1413.0,755,227,263,490,1952.0,82,5.24,53,338,2262,9.5,0.5728027
25334,25334,Shawn McEachern,2003-04,34.0,13,26,46,46,10,16,26,120.0,888.0,801,237,279,516,2072.0,82,5.31,60,363,2326,9.4,0.5456306
25335,25335,Shawn McEachern,2004-05,35.0,14,55,82,82,17,38,55,176.0,1659.0,883,254,317,571,2248.0,82,5.14,57,348,2300,9.2,0.64606005
25336,25336,Shawn McEachern,2006-07,37.0,15,8,28,28,2,6,8,40.0,402.0,911,256,323,579,2288.0,82,6.05,85,480,2458,10.1,0.34664845
25337,25337,Shawn Rivers,1993-94,23.0,2,2,4,4,0,2,2,3.0,,4,0,2,2,3.0,84,7.25,87,443,2603,11.7,0.2417559
25338,25338,Shawn Thornton,2003-04,26.0,2,2,13,13,1,1,2,15.0,111.0,13,1,1,2,15.0,82,5.31,60,363,2326,9.4,0.20716852
25339,25339,Shawn Thornton,2004-05,27.0,3,1,8,8,1,0,1,14.0,90.0,21,2,1,3,29.0,82,5.14,57,348,2300,9.2,0.19795325
25340,25340,Shawn Thornton,2006-07,29.0,4,0,10,10,0,0,0,16.0,73.0,31,2,1,3,45.0,82,6.05,85,480,2458,10.1,0.16249299
25341,25341,Shawn Thornton,2007-08,30.0,5,9,48,48,2,7,9,60.0,405.0,79,4,8,12,105.0,82,5.76,70,398,2426,9.7,0.16586101
25342,25342,Shawn Thornton,2008-09,31.0,6,7,58,58,4,3,7,65.0,429.0,137,8,11,19,170.0,82,5.44,62,351,2383,9.4,0.15287477
25343,25343,Shawn Thornton,2009-10,32.0,7,11,79,79,6,5,11,136.0,793.0,216,14,16,30,306.0,82,5.7,65,341,2477,9.4,0.20937008
25344,25344,Shawn Thornton,2010-11,33.0,8,10,74,74,1,9,10,119.0,669.0,290,15,25,40,425.0,82,5.53,56,304,2486,9.1,0.15787828
25345,25345,Shawn Thornton,2011-12,34.0,9,20,79,79,10,10,20,151.0,796.0,369,25,35,60,576.0,82,5.46,52,291,2492,9.0,0.25766045
25346,25346,Shawn Thornton,2012-13,35.0,10,13,81,81,5,8,13,114.0,744.0,450,30,43,73,690.0,82,5.32,47,271,2439,8.9,0.17387679
25347,25347,Shawn Thornton,2013-14,36.0,11,7,45,45,3,4,7,55.0,365.0,495,33,47,80,745.0,48,5.31,29,160,1399,9.1,0.14366287
25348,25348,Shawn Thornton,2014-15,37.0,12,8,64,64,5,3,8,93.0,563.0,559,38,50,88,838.0,82,5.34,48,269,2463,8.9,0.139348
25349,25349,Shawn Thornton,2015-16,38.0,13,5,46,46,1,4,5,53.0,441.0,605,39,54,93,891.0,82,5.32,47,251,2453,8.9,0.13242018
25350,25350,Shawn Thornton,2016-17,39.0,14,5,50,50,1,4,5,58.0,434.0,655,40,58,98,949.0,82,5.34,48,255,2438,9.0,0.121810496
25351,25351,Shawn Thornton,2017-18,40.0,15,4,50,50,2,2,4,42.0,384.0,705,42,60,102,991.0,82,5.45,47,245,2478,9.0,0.12882403
25352,25352,Shay Stephenson,2007-08,24.0,2,0,2,2,0,0,0,0.0,15.0,2,0,0,0,0.0,82,5.76,70,398,2426,9.7,0.14225212
25353,25353,Shayne Corson,1986-87,20.0,2,0,3,3,0,0,0,1.0,,3,0,0,0,1.0,80,7.94,82,370,2484,12.8,0.2743883
25354,25354,Shayne Corson,1987-88,21.0,3,23,55,55,12,11,23,69.0,,58,12,11,23,70.0,80,7.34,72,344,2400,12.2,0.4515278
25355,25355,Shayne Corson,1988-89,22.0,4,39,71,71,12,27,39,90.0,,129,24,38,62,160.0,80,7.43,89,437,2435,12.2,0.5097054
25356,25356,Shayne Corson,1989-90,23.0,5,50,80,80,26,24,50,133.0,,209,50,62,112,293.0,80,7.48,85,403,2430,12.3,0.6888468
25357,25357,Shayne Corson,1990-91,24.0,6,75,76,76,31,44,75,192.0,,285,81,106,187,485.0,80,7.37,76,367,2421,12.2,0.8812789
25358,25358,Shayne Corson,1991-92,25.0,7,47,71,71,23,24,47,164.0,,356,104,130,234,649.0,80,6.91,71,366,2385,11.6,0.6834383
25359,25359,Shayne Corson,1992-93,26.0,8,53,64,64,17,36,53,165.0,,420,121,166,287,814.0,80,6.96,77,402,2440,11.4,0.74104387
25360,25360,Shayne Corson,1993-94,27.0,9,47,80,80,16,31,47,164.0,,500,137,197,334,978.0,84,7.25,87,443,2603,11.7,0.58973455
25361,25361,Shayne Corson,1994-95,28.0,10,54,64,64,25,29,54,171.0,,564,162,226,388,1149.0,84,6.48,76,407,2545,10.7,0.74218154
25362,25362,Shayne Corson,1995-96,29.0,11,36,48,48,12,24,36,131.0,,612,174,250,424,1280.0,48,5.97,37,209,1408,10.2,0.68464637
25363,25363,Shayne Corson,1996-97,30.0,12,46,77,77,18,28,46,150.0,,689,192,278,470,1430.0,82,6.29,74,413,2481,10.4,0.5058766
25364,25364,Shayne Corson,1997-98,31.0,13,24,58,58,8,16,24,115.0,,747,200,294,494,1545.0,82,5.83,55,336,2444,9.8,0.4201548
25365,25365,Shayne Corson,1998-99,32.0,14,55,62,62,21,34,55,142.0,,809,221,328,549,1687.0,82,5.28,57,380,2242,9.6,0.6802572
25366,25366,Shayne Corson,1999-00,33.0,15,32,63,63,12,20,32,142.0,1304.0,872,233,348,581,1829.0,82,5.27,57,359,2285,9.4,0.50410664
25367,25367,Shayne Corson,2000-01,34.0,16,28,70,70,8,20,28,121.0,1336.0,942,241,368,609,1950.0,82,5.49,53,331,2294,9.8,0.33865115
25368,25368,Shayne Corson,2001-02,35.0,17,26,77,77,8,18,26,102.0,1220.0,1019,249,386,635,2052.0,82,5.51,63,376,2272,9.9,0.29258344
25369,25369,Shayne Corson,2002-03,36.0,18,33,74,74,12,21,33,111.0,1263.0,1093,261,407,668,2163.0,82,5.24,53,338,2262,9.5,0.37976396
25370,25370,Shayne Corson,2003-04,37.0,19,15,46,46,7,8,15,69.0,692.0,1139,268,415,683,2232.0,82,5.31,60,363,2326,9.4,0.3755411
25371,25371,Shayne Corson,2004-05,38.0,20,10,17,17,5,5,10,21.0,230.0,1156,273,420,693,2253.0,82,5.14,57,348,2300,9.2,0.49863696
25372,25372,Shayne Gostisbehere,2015-16,22.0,2,0,2,2,0,0,0,2.0,25.0,2,0,0,0,2.0,82,5.32,47,251,2453,8.9,0.17298314
25373,25373,Shayne Gostisbehere,2016-17,23.0,3,46,64,64,17,29,46,152.0,1286.0,66,17,29,46,154.0,82,5.34,48,255,2438,9.0,0.6325258
25374,25374,Shayne Gostisbehere,2017-18,24.0,4,39,76,76,7,32,39,198.0,1489.0,142,24,61,85,352.0,82,5.45,47,245,2478,9.0,0.5307314
25375,25375,Shayne Gostisbehere,2018-19,25.0,5,65,78,78,13,52,65,221.0,1674.0,220,37,113,150,573.0,82,5.86,50,250,2620,9.2,0.77601933
25376,25376,Shayne Gostisbehere,2019-20,26.0,6,37,78,78,9,28,37,180.0,1533.0,298,46,141,187,753.0,82,5.96,47,239,2579,9.5,0.56102926
25377,25377,Shayne Gostisbehere,2020-21,27.0,7,12,42,42,5,7,12,73.0,768.0,340,51,148,199,826.0,70,5.96,42,208,2192,9.5,0.42000294
25378,25378,Shayne Stevenson,1991-92,21.0,2,0,14,14,0,0,0,8.0,,14,0,0,0,8.0,80,6.91,71,366,2385,11.6,0.19493046
25379,25379,Shayne Stevenson,1992-93,22.0,3,1,5,5,0,1,1,3.0,,19,0,1,1,11.0,80,6.96,77,402,2440,11.4,0.21318877
25380,25380,Shayne Stevenson,1993-94,23.0,4,1,8,8,0,1,1,4.0,,27,0,2,2,15.0,84,7.25,87,443,2603,11.7,0.19876835
25381,25381,Shayne Toporowski,1997-98,22.0,2,0,3,3,0,0,0,3.0,,3,0,0,0,3.0,82,5.83,55,336,2444,9.8,0.18394265
25382,25382,Shea Theodore,2016-17,21.0,2,8,19,19,3,5,8,28.0,363.0,19,3,5,8,28.0,82,5.34,48,255,2438,9.0,0.335383
25383,25383,Shea Theodore,2017-18,22.0,3,9,34,34,2,7,9,60.0,589.0,53,5,12,17,88.0,82,5.45,47,245,2478,9.0,0.31672364
25384,25384,Shea Theodore,2018-19,23.0,4,29,61,61,6,23,29,144.0,1241.0,114,11,35,46,232.0,82,5.86,50,250,2620,9.2,0.47300524
25385,25385,Shea Theodore,2019-20,24.0,5,37,79,79,12,25,37,202.0,1588.0,193,23,60,83,434.0,82,5.96,47,239,2579,9.5,0.524374
25386,25386,Shea Theodore,2020-21,25.0,6,46,71,71,13,33,46,219.0,1579.0,264,36,93,129,653.0,70,5.96,42,208,2192,9.5,0.6238725
25387,25387,Shea Weber,2006-07,21.0,2,10,28,28,2,8,10,46.0,476.0,28,2,8,10,46.0,82,6.05,85,480,2458,10.1,0.34236223
25388,25388,Shea Weber,2007-08,22.0,3,40,79,79,17,23,40,152.0,1532.0,107,19,31,50,198.0,82,5.76,70,398,2426,9.7,0.553986
25389,25389,Shea Weber,2008-09,23.0,4,20,54,54,6,14,20,152.0,1053.0,161,25,45,70,350.0,82,5.44,62,351,2383,9.4,0.48508146
25390,25390,Shea Weber,2009-10,24.0,5,53,81,81,23,30,53,251.0,1942.0,242,48,75,123,601.0,82,5.7,65,341,2477,9.4,0.64844024
25391,25391,Shea Weber,2010-11,25.0,6,43,78,78,16,27,43,222.0,1807.0,320,64,102,166,823.0,82,5.53,56,304,2486,9.1,0.5976747
25392,25392,Shea Weber,2011-12,26.0,7,48,82,82,16,32,48,254.0,2076.0,402,80,134,214,1077.0,82,5.46,52,291,2492,9.0,0.6508775
25393,25393,Shea Weber,2012-13,27.0,8,49,78,78,19,30,49,230.0,2041.0,480,99,164,263,1307.0,82,5.32,47,271,2439,8.9,0.5866977
25394,25394,Shea Weber,2013-14,28.0,9,28,48,48,9,19,28,124.0,1244.0,528,108,183,291,1431.0,48,5.31,29,160,1399,9.1,0.5859954
25395,25395,Shea Weber,2014-15,29.0,10,56,79,79,23,33,56,195.0,2125.0,607,131,216,347,1626.0,82,5.34,48,269,2463,8.9,0.6381691
25396,25396,Shea Weber,2015-16,30.0,11,45,78,78,15,30,45,237.0,2057.0,685,146,246,392,1863.0,82,5.32,47,251,2453,8.9,0.5680738
25397,25397,Shea Weber,2016-17,31.0,12,51,78,78,20,31,51,189.0,1979.0,763,166,277,443,2052.0,82,5.34,48,255,2438,9.0,0.5676823
25398,25398,Shea Weber,2017-18,32.0,13,42,78,78,17,25,42,183.0,1955.0,841,183,302,485,2235.0,82,5.45,47,245,2478,9.0,0.5325286
25399,25399,Shea Weber,2018-19,33.0,14,16,26,26,6,10,16,75.0,659.0,867,189,312,501,2310.0,82,5.86,50,250,2620,9.2,0.52996117
25400,25400,Shea Weber,2019-20,34.0,15,33,58,58,14,19,33,166.0,1362.0,925,203,331,534,2476.0,82,5.96,47,239,2579,9.5,0.4603533
25401,25401,Shea Weber,2020-21,35.0,16,36,65,65,15,21,36,185.0,1561.0,990,218,352,570,2661.0,70,5.96,42,208,2192,9.5,0.47457254
25402,25402,Shean Donovan,1995-96,21.0,2,0,14,14,0,0,0,13.0,,14,0,0,0,13.0,48,5.97,37,209,1408,10.2,0.1978066
25403,25403,Shean Donovan,1996-97,22.0,3,21,74,74,13,8,21,73.0,,88,13,8,21,86.0,82,6.29,74,413,2481,10.4,0.333274
25404,25404,Shean Donovan,1997-98,23.0,4,15,73,73,9,6,15,115.0,,161,22,14,36,201.0,82,5.83,55,336,2444,9.8,0.27270383
25405,25405,Shean Donovan,1998-99,24.0,5,18,67,67,8,10,18,81.0,,228,30,24,54,282.0,82,5.28,57,380,2242,9.6,0.29752326
25406,25406,Shean Donovan,1999-00,25.0,6,19,68,68,7,12,19,81.0,596.0,296,37,36,73,363.0,82,5.27,57,359,2285,9.4,0.27910012
25407,25407,Shean Donovan,2000-01,26.0,7,12,51,51,5,7,12,66.0,569.0,347,42,43,85,429.0,82,5.49,53,331,2294,9.8,0.24964607
25408,25408,Shean Donovan,2001-02,27.0,8,23,63,63,12,11,23,93.0,886.0,410,54,54,108,522.0,82,5.51,63,376,2272,9.9,0.2932508
25409,25409,Shean Donovan,2002-03,28.0,9,15,61,61,8,7,15,82.0,837.0,471,62,61,123,604.0,82,5.24,53,338,2262,9.5,0.2754507
25410,25410,Shean Donovan,2003-04,29.0,10,12,65,65,5,7,12,88.0,880.0,536,67,68,135,692.0,82,5.31,60,363,2326,9.4,0.24754375
25411,25411,Shean Donovan,2004-05,30.0,11,42,82,82,18,24,42,138.0,1224.0,618,85,92,177,830.0,82,5.14,57,348,2300,9.2,0.47322443
25412,25412,Shean Donovan,2006-07,32.0,12,20,80,80,9,11,20,132.0,943.0,698,94,103,197,962.0,82,6.05,85,480,2458,10.1,0.26161805
25413,25413,Shean Donovan,2007-08,33.0,13,17,76,76,6,11,17,108.0,1076.0,774,100,114,214,1070.0,82,5.76,70,398,2426,9.7,0.21401817
25414,25414,Shean Donovan,2008-09,34.0,14,12,82,82,5,7,12,91.0,785.0,856,105,121,226,1161.0,82,5.44,62,351,2383,9.4,0.18010399
25415,25415,Shean Donovan,2009-10,35.0,15,10,65,65,5,5,10,58.0,509.0,921,110,126,236,1219.0,82,5.7,65,341,2477,9.4,0.14279956
25416,25416,Shean Donovan,2010-11,36.0,16,5,30,30,2,3,5,24.0,223.0,951,112,129,241,1243.0,82,5.53,56,304,2486,9.1,0.19542521
25417,25417,Sheldon Brookbank,2007-08,27.0,2,1,3,3,0,1,1,3.0,25.0,3,0,1,1,3.0,82,5.76,70,398,2426,9.7,0.17329133
25418,25418,Sheldon Brookbank,2008-09,28.0,3,8,44,44,0,8,8,43.0,666.0,47,0,9,9,46.0,82,5.44,62,351,2383,9.4,0.14059773
25419,25419,Sheldon Brookbank,2009-10,29.0,4,4,44,44,1,3,4,30.0,534.0,91,1,12,13,76.0,82,5.7,65,341,2477,9.4,0.1271841
25420,25420,Sheldon Brookbank,2010-11,30.0,5,9,66,66,0,9,9,60.0,987.0,157,1,21,22,136.0,82,5.53,56,304,2486,9.1,0.119173825
25421,25421,Sheldon Brookbank,2011-12,31.0,6,0,40,40,0,0,0,29.0,533.0,197,1,21,22,165.0,82,5.46,52,291,2492,9.0,0.10061368
25422,25422,Sheldon Brookbank,2012-13,32.0,7,14,80,80,3,11,14,49.0,1248.0,277,4,32,36,214.0,82,5.32,47,271,2439,8.9,0.11829606
25423,25423,Sheldon Brookbank,2013-14,33.0,8,1,26,26,1,0,1,25.0,332.0,303,5,32,37,239.0,48,5.31,29,160,1399,9.1,0.13546151
25424,25424,Sheldon Brookbank,2014-15,34.0,9,7,48,48,2,5,7,43.0,619.0,351,7,37,44,282.0,82,5.34,48,269,2463,8.9,0.13123694
25425,25425,Sheldon Dries,2019-20,25.0,2,6,40,40,3,3,6,44.0,363.0,40,3,3,6,44.0,82,5.96,47,239,2579,9.5,0.20637193
25426,25426,Sheldon Dries,2020-21,26.0,3,0,5,5,0,0,0,2.0,34.0,45,3,3,6,46.0,70,5.96,42,208,2192,9.5,0.17334962
25427,25427,Sheldon Keefe,2001-02,21.0,2,4,49,49,4,0,4,32.0,392.0,49,4,0,4,32.0,82,5.51,63,376,2272,9.9,0.17220807
25428,25428,Sheldon Keefe,2002-03,22.0,3,13,39,39,6,7,13,52.0,507.0,88,10,7,17,84.0,82,5.24,53,338,2262,9.5,0.3139224
25429,25429,Sheldon Keefe,2003-04,23.0,4,7,37,37,2,5,7,51.0,379.0,125,12,12,24,135.0,82,5.31,60,363,2326,9.4,0.2706868
25430,25430,Sheldon Kennedy,1990-91,21.0,2,9,20,20,2,7,9,23.0,,20,2,7,9,23.0,80,7.37,76,367,2421,12.2,0.39867005
25431,25431,Sheldon Kennedy,1991-92,22.0,3,1,7,7,1,0,1,11.0,,27,3,7,10,34.0,80,6.91,71,366,2385,11.6,0.27180266
25432,25432,Sheldon Kennedy,1992-93,23.0,4,11,27,27,3,8,11,33.0,,54,6,15,21,67.0,80,6.96,77,402,2440,11.4,0.33366215
25433,25433,Sheldon Kennedy,1993-94,24.0,5,30,68,68,19,11,30,110.0,,122,25,26,51,177.0,84,7.25,87,443,2603,11.7,0.41672885
25434,25434,Sheldon Kennedy,1994-95,25.0,6,13,61,61,6,7,13,60.0,,183,31,33,64,237.0,84,6.48,76,407,2545,10.7,0.24865732
25435,25435,Sheldon Kennedy,1995-96,26.0,7,15,30,30,7,8,15,44.0,,213,38,41,79,281.0,48,5.97,37,209,1408,10.2,0.37224835
25436,25436,Sheldon Kennedy,1996-97,27.0,8,10,41,41,3,7,10,54.0,,254,41,48,89,335.0,82,6.29,74,413,2481,10.4,0.24960613
25437,25437,Sheldon Kennedy,1997-98,28.0,9,18,56,56,8,10,18,65.0,,310,49,58,107,400.0,82,5.83,55,336,2444,9.8,0.2975919
25438,25438,Sheldon Rempal,2019-20,24.0,2,0,7,7,0,0,0,3.0,61.0,7,0,0,0,3.0,82,5.96,47,239,2579,9.5,0.1744509
25439,25439,Sheldon Souray,1998-99,22.0,2,10,60,60,3,7,10,74.0,,60,3,7,10,74.0,82,5.28,57,380,2242,9.6,0.24146134
25440,25440,Sheldon Souray,1999-00,23.0,3,8,70,70,1,7,8,101.0,1045.0,130,4,14,18,175.0,82,5.27,57,359,2285,9.4,0.21281278
25441,25441,Sheldon Souray,2000-01,24.0,4,11,71,71,3,8,11,113.0,1261.0,201,7,22,29,288.0,82,5.49,53,331,2294,9.8,0.21672788
25442,25442,Sheldon Souray,2001-02,25.0,5,11,52,52,3,8,11,103.0,1072.0,253,10,30,40,391.0,82,5.51,63,376,2272,9.9,0.24687514
25443,25443,Sheldon Souray,2002-03,26.0,6,8,34,34,3,5,8,56.0,618.0,287,13,35,48,447.0,82,5.24,53,338,2262,9.5,0.2268183
25444,25444,Sheldon Souray,2004-05,28.0,7,35,63,63,15,20,35,186.0,1476.0,350,28,55,83,633.0,82,5.14,57,348,2300,9.2,0.5736716
25445,25445,Sheldon Souray,2006-07,30.0,8,39,75,75,12,27,39,202.0,1669.0,425,40,82,122,835.0,82,6.05,85,480,2458,10.1,0.4851215
25446,25446,Sheldon Souray,2007-08,31.0,9,64,81,81,26,38,64,224.0,1878.0,506,66,120,186,1059.0,82,5.76,70,398,2426,9.7,0.6583504
25447,25447,Sheldon Souray,2008-09,32.0,10,10,26,26,3,7,10,71.0,633.0,532,69,127,196,1130.0,82,5.44,62,351,2383,9.4,0.32553476
25448,25448,Sheldon Souray,2009-10,33.0,11,53,81,81,23,30,53,268.0,2012.0,613,92,157,249,1398.0,82,5.7,65,341,2477,9.4,0.56329787
25449,25449,Sheldon Souray,2010-11,34.0,12,13,37,37,4,9,13,113.0,837.0,650,96,166,262,1511.0,82,5.53,56,304,2486,9.1,0.28012824
25450,25450,Sheldon Souray,2012-13,36.0,13,21,64,64,6,15,21,179.0,1310.0,714,102,181,283,1690.0,82,5.32,47,271,2439,8.9,0.3326922
25451,25451,Sheldon Souray,2013-14,37.0,14,17,44,44,7,10,17,80.0,921.0,758,109,191,300,1770.0,48,5.31,29,160,1399,9.1,0.3447479
25452,25452,Shjon Podein,1993-94,25.0,2,19,40,40,13,6,19,64.0,,40,13,6,19,64.0,84,7.25,87,443,2603,11.7,0.42030284
25453,25453,Shjon Podein,1994-95,26.0,3,8,28,28,3,5,8,26.0,,68,16,11,27,90.0,84,6.48,76,407,2545,10.7,0.25854614
25454,25454,Shjon Podein,1995-96,27.0,4,10,44,44,3,7,10,48.0,,112,19,18,37,138.0,48,5.97,37,209,1408,10.2,0.2856946
25455,25455,Shjon Podein,1996-97,28.0,5,25,79,79,15,10,25,115.0,,191,34,28,62,253.0,82,6.29,74,413,2481,10.4,0.31723344
25456,25456,Shjon Podein,1997-98,29.0,6,32,82,82,14,18,32,153.0,,273,48,46,94,406.0,82,5.83,55,336,2444,9.8,0.4036463
25457,25457,Shjon Podein,1998-99,30.0,7,24,82,82,11,13,24,126.0,,355,59,59,118,532.0,82,5.28,57,380,2242,9.6,0.28149623
25458,25458,Shjon Podein,1999-00,31.0,8,9,55,55,3,6,9,75.0,651.0,410,62,65,127,607.0,82,5.27,57,359,2285,9.4,0.2168014
25459,25459,Shjon Podein,2000-01,32.0,9,19,75,75,11,8,19,104.0,1014.0,485,73,73,146,711.0,82,5.49,53,331,2294,9.8,0.26037514
25460,25460,Shjon Podein,2001-02,33.0,10,32,82,82,15,17,32,137.0,1180.0,567,88,90,178,848.0,82,5.51,63,376,2272,9.9,0.3463236
25461,25461,Shjon Podein,2002-03,34.0,11,18,64,64,8,10,18,67.0,881.0,631,96,100,196,915.0,82,5.24,53,338,2262,9.5,0.23701227
25462,25462,Shjon Podein,2003-04,35.0,12,10,68,68,4,6,10,52.0,741.0,699,100,106,206,967.0,82,5.31,60,363,2326,9.4,0.14967158
25463,25463,Sidney Crosby,2006-07,19.0,2,102,81,81,39,63,102,278.0,1630.0,81,39,63,102,278.0,82,6.05,85,480,2458,10.1,1.2607331
25464,25464,Sidney Crosby,2007-08,20.0,3,120,79,79,36,84,120,250.0,1640.0,160,75,147,222,528.0,82,5.76,70,398,2426,9.7,1.3450048
25465,25465,Sidney Crosby,2008-09,21.0,4,72,53,53,24,48,72,173.0,1105.0,213,99,195,294,701.0,82,5.44,62,351,2383,9.4,1.3402034
25466,25466,Sidney Crosby,2009-10,22.0,5,103,77,77,33,70,103,238.0,1690.0,290,132,265,397,939.0,82,5.7,65,341,2477,9.4,1.3819642
25467,25467,Sidney Crosby,2010-11,23.0,6,109,81,81,51,58,109,298.0,1778.0,371,183,323,506,1237.0,82,5.53,56,304,2486,9.1,1.3242512
25468,25468,Sidney Crosby,2011-12,24.0,7,66,41,41,32,34,66,161.0,899.0,412,215,357,572,1398.0,82,5.46,52,291,2492,9.0,1.4320706
25469,25469,Sidney Crosby,2012-13,25.0,8,37,22,22,8,29,37,75.0,406.0,434,223,386,609,1473.0,82,5.32,47,271,2439,8.9,1.4774554
25470,25470,Sidney Crosby,2013-14,26.0,9,56,36,36,15,41,56,124.0,760.0,470,238,427,665,1597.0,48,5.31,29,160,1399,9.1,1.2505815
25471,25471,Sidney Crosby,2014-15,27.0,10,104,80,80,36,68,104,259.0,1758.0,550,274,495,769,1856.0,82,5.34,48,269,2463,8.9,1.1351972
25472,25472,Sidney Crosby,2015-16,28.0,11,84,77,77,28,56,84,237.0,1538.0,627,302,551,853,2093.0,82,5.32,47,251,2453,8.9,1.0403881
25473,25473,Sidney Crosby,2016-17,29.0,12,85,80,80,36,49,85,248.0,1638.0,707,338,600,938,2341.0,82,5.34,48,255,2438,9.0,1.0749471
25474,25474,Sidney Crosby,2017-18,30.0,13,89,75,75,44,45,89,255.0,1491.0,782,382,645,1027,2596.0,82,5.45,47,245,2478,9.0,1.118113
25475,25475,Sidney Crosby,2018-19,31.0,14,89,82,82,29,60,89,247.0,1697.0,864,411,705,1116,2843.0,82,5.86,50,250,2620,9.2,1.056608
25476,25476,Sidney Crosby,2019-20,32.0,15,100,79,79,35,65,100,220.0,1658.0,943,446,770,1216,3063.0,82,5.96,47,239,2579,9.5,1.1346906
25477,25477,Sidney Crosby,2020-21,33.0,16,47,41,41,16,31,47,109.0,831.0,984,462,801,1263,3172.0,70,5.96,42,208,2192,9.5,1.04475
25478,25478,Simo Saarinen,1985-86,22.0,2,0,8,8,0,0,0,8.0,,8,0,0,0,8.0,80,7.77,71,321,2447,12.7,0.2264187
25479,25479,Simon Despres,2012-13,21.0,2,4,18,18,1,3,4,22.0,256.0,18,1,3,4,22.0,82,5.32,47,271,2439,8.9,0.25969929
25480,25480,Simon Despres,2013-14,22.0,3,7,33,33,2,5,7,33.0,499.0,51,3,8,11,55.0,48,5.31,29,160,1399,9.1,0.27361727
25481,25481,Simon Despres,2014-15,23.0,4,5,34,34,0,5,5,41.0,569.0,85,3,13,16,96.0,82,5.34,48,269,2463,8.9,0.20729128
25482,25482,Simon Despres,2015-16,24.0,5,23,75,75,3,20,23,103.0,1265.0,160,6,33,39,199.0,82,5.32,47,251,2453,8.9,0.26604947
25483,25483,Simon Despres,2016-17,25.0,6,4,32,32,0,4,4,32.0,628.0,192,6,37,43,231.0,82,5.34,48,255,2438,9.0,0.17238277
25484,25484,Simon Despres,2017-18,26.0,7,0,1,1,0,0,0,1.0,16.0,193,6,37,43,232.0,82,5.45,47,245,2478,9.0,0.18544835
25485,25485,Simon Gagne,2000-01,20.0,2,48,80,80,20,28,48,159.0,1198.0,80,20,28,48,159.0,82,5.49,53,331,2294,9.8,0.6616852
25486,25486,Simon Gagne,2001-02,21.0,3,59,69,69,27,32,59,191.0,1247.0,149,47,60,107,350.0,82,5.51,63,376,2272,9.9,0.83612996
25487,25487,Simon Gagne,2002-03,22.0,4,66,79,79,33,33,66,199.0,1434.0,228,80,93,173,549.0,82,5.24,53,338,2262,9.5,0.85442185
25488,25488,Simon Gagne,2003-04,23.0,5,27,46,46,9,18,27,115.0,800.0,274,89,111,200,664.0,82,5.31,60,363,2326,9.4,0.6935287
25489,25489,Simon Gagne,2004-05,24.0,6,45,80,80,24,21,45,211.0,1316.0,354,113,132,245,875.0,82,5.14,57,348,2300,9.2,0.7774316
25490,25490,Simon Gagne,2006-07,26.0,7,79,72,72,47,32,79,334.0,1495.0,426,160,164,324,1209.0,82,6.05,85,480,2458,10.1,0.9301054
25491,25491,Simon Gagne,2007-08,27.0,8,68,76,76,41,27,68,291.0,1599.0,502,201,191,392,1500.0,82,5.76,70,398,2426,9.7,0.8439535
25492,25492,Simon Gagne,2008-09,28.0,9,18,25,25,7,11,18,76.0,454.0,527,208,202,410,1576.0,82,5.44,62,351,2383,9.4,0.8151622
25493,25493,Simon Gagne,2009-10,29.0,10,74,79,79,34,40,74,221.0,1503.0,606,242,242,484,1797.0,82,5.7,65,341,2477,9.4,0.8126992
25494,25494,Simon Gagne,2010-11,30.0,11,40,58,58,17,23,40,183.0,1080.0,664,259,265,524,1980.0,82,5.53,56,304,2486,9.1,0.65849197
25495,25495,Simon Gagne,2011-12,31.0,12,40,63,63,17,23,40,154.0,1064.0,727,276,288,564,2134.0,82,5.46,52,291,2492,9.0,0.59861153
25496,25496,Simon Gagne,2012-13,32.0,13,17,34,34,7,10,17,75.0,612.0,761,283,298,581,2209.0,82,5.32,47,271,2439,8.9,0.47539812
25497,25497,Simon Gagne,2013-14,33.0,14,16,38,38,5,11,16,76.0,537.0,799,288,309,597,2285.0,48,5.31,29,160,1399,9.1,0.45225498
25498,25498,Simon Gagne,2015-16,35.0,15,4,23,23,3,1,4,27.0,260.0,822,291,310,601,2312.0,82,5.32,47,251,2453,8.9,0.32949823
25499,25499,Simon Gamache,2003-04,23.0,2,0,2,2,0,0,0,3.0,25.0,2,0,0,0,3.0,82,5.31,60,363,2326,9.4,0.18338367
25500,25500,Simon Gamache,2004-05,24.0,3,2,9,9,1,1,2,5.0,66.0,11,1,1,2,8.0,82,5.14,57,348,2300,9.2,0.20612204
25501,25501,Simon Gamache,2006-07,26.0,4,7,26,26,3,4,7,36.0,299.0,37,4,5,9,44.0,82,6.05,85,480,2458,10.1,0.21574444
25502,25502,Simon Gamache,2008-09,28.0,5,4,11,11,2,2,4,11.0,106.0,48,6,7,13,55.0,82,5.44,62,351,2383,9.4,0.20825168
25503,25503,Simon Moser,2014-15,25.0,2,2,6,6,1,1,2,7.0,61.0,6,1,1,2,7.0,82,5.34,48,269,2463,8.9,0.1925267
25504,25504,Simon Wheeldon,1988-89,22.0,2,1,5,5,0,1,1,2.0,,5,0,1,1,2.0,80,7.43,89,437,2435,12.2,0.23528725
25505,25505,Simon Wheeldon,1989-90,23.0,3,1,6,6,0,1,1,2.0,,11,0,2,2,4.0,80,7.48,85,403,2430,12.3,0.22146547
25506,25506,Simon Wheeldon,1991-92,25.0,4,0,4,4,0,0,0,4.0,,15,0,2,2,8.0,80,6.91,71,366,2385,11.6,0.17279825
25507,25507,Slater Koekkoek,2015-16,21.0,2,0,3,3,0,0,0,6.0,50.0,3,0,0,0,6.0,82,5.32,47,251,2453,8.9,0.22231701
25508,25508,Slater Koekkoek,2016-17,22.0,3,1,9,9,0,1,1,11.0,93.0,12,0,1,1,17.0,82,5.34,48,255,2438,9.0,0.20098335
25509,25509,Slater Koekkoek,2017-18,23.0,4,4,29,29,0,4,4,27.0,377.0,41,0,5,5,44.0,82,5.45,47,245,2478,9.0,0.18335757
25510,25510,Slater Koekkoek,2018-19,24.0,5,8,35,35,4,4,8,43.0,393.0,76,4,9,13,87.0,82,5.86,50,250,2620,9.2,0.22613376
25511,25511,Slater Koekkoek,2019-20,25.0,6,6,31,31,2,4,6,36.0,491.0,107,6,13,19,123.0,82,5.96,47,239,2579,9.5,0.20493633
25512,25512,Slater Koekkoek,2020-21,26.0,7,10,42,42,1,9,10,47.0,704.0,149,7,22,29,170.0,70,5.96,42,208,2192,9.5,0.20454231
25513,25513,Slava Voynov,2012-13,23.0,2,20,54,54,8,12,20,86.0,1001.0,54,8,12,20,86.0,82,5.32,47,271,2439,8.9,0.40767804
25514,25514,Slava Voynov,2013-14,24.0,3,25,48,48,6,19,25,79.0,1071.0,102,14,31,45,165.0,48,5.31,29,160,1399,9.1,0.4432807
25515,25515,Slava Voynov,2014-15,25.0,4,34,82,82,4,30,34,143.0,1829.0,184,18,61,79,308.0,82,5.34,48,269,2463,8.9,0.39590475
25516,25516,Slava Voynov,2015-16,26.0,5,2,6,6,0,2,2,5.0,139.0,190,18,63,81,313.0,82,5.32,47,251,2453,8.9,0.25680447
25517,25517,Sonny Milano,2016-17,20.0,2,1,3,3,0,1,1,2.0,40.0,3,0,1,1,2.0,82,5.34,48,255,2438,9.0,0.2688489
25518,25518,Sonny Milano,2017-18,21.0,3,0,4,4,0,0,0,2.0,47.0,7,0,1,1,4.0,82,5.45,47,245,2478,9.0,0.2610285
25519,25519,Sonny Milano,2018-19,22.0,4,22,55,55,14,8,22,69.0,641.0,62,14,9,23,73.0,82,5.86,50,250,2620,9.2,0.38340726
25520,25520,Sonny Milano,2019-20,23.0,5,1,8,8,1,0,1,5.0,67.0,70,15,9,24,78.0,82,5.96,47,239,2579,9.5,0.26706797
25521,25521,Sonny Milano,2020-21,24.0,6,23,55,55,7,16,23,75.0,720.0,125,22,25,47,153.0,70,5.96,42,208,2192,9.5,0.3779445
25522,25522,Spencer Abbott,2014-15,26.0,2,0,1,1,0,0,0,2.0,5.0,1,0,0,0,2.0,82,5.34,48,269,2463,8.9,0.16342145
25523,25523,Spencer Abbott,2017-18,29.0,3,0,1,1,0,0,0,1.0,9.0,2,0,0,0,3.0,82,5.45,47,245,2478,9.0,0.17370445
25524,25524,Spencer Foo,2018-19,24.0,2,2,4,4,2,0,2,16.0,63.0,4,2,0,2,16.0,82,5.86,50,250,2620,9.2,0.23187092
25525,25525,Spencer Machacek,2009-10,21.0,2,0,2,2,0,0,0,1.0,16.0,2,0,0,0,1.0,82,5.7,65,341,2477,9.4,0.20738643
25526,25526,Spencer Machacek,2011-12,23.0,3,0,10,10,0,0,0,7.0,77.0,12,0,0,0,8.0,82,5.46,52,291,2492,9.0,0.16162473
25527,25527,Spencer Machacek,2012-13,24.0,4,9,13,13,2,7,9,12.0,98.0,25,2,7,9,20.0,82,5.32,47,271,2439,8.9,0.23218122
25528,25528,Stacy Roest,1999-00,25.0,2,12,59,59,4,8,12,50.0,476.0,59,4,8,12,50.0,82,5.27,57,359,2285,9.4,0.18948963
25529,25529,Stacy Roest,2000-01,26.0,3,16,49,49,7,9,16,56.0,487.0,108,11,17,28,106.0,82,5.49,53,331,2294,9.8,0.30513623
25530,25530,Stacy Roest,2001-02,27.0,4,27,76,76,7,20,27,125.0,1065.0,184,18,37,55,231.0,82,5.51,63,376,2272,9.9,0.31874356
25531,25531,Stacy Roest,2002-03,28.0,5,21,58,58,10,11,21,98.0,919.0,242,28,48,76,329.0,82,5.24,53,338,2262,9.5,0.33144158
25532,25532,Stacy Roest,2003-04,29.0,6,0,2,2,0,0,0,2.0,15.0,244,28,48,76,331.0,82,5.31,60,363,2326,9.4,0.2729603
25533,25533,Staffan Kronwall,2006-07,24.0,2,1,34,34,0,1,1,18.0,440.0,34,0,1,1,18.0,82,6.05,85,480,2458,10.1,0.13648725
25534,25534,Staffan Kronwall,2008-09,26.0,3,0,18,18,0,0,0,9.0,200.0,52,0,1,1,27.0,82,5.44,62,351,2383,9.4,0.13220343
25535,25535,Staffan Kronwall,2009-10,27.0,4,0,3,3,0,0,0,4.0,40.0,55,0,1,1,31.0,82,5.7,65,341,2477,9.4,0.13268086
25536,25536,Staffan Kronwall,2010-11,28.0,5,3,11,11,1,2,3,6.0,109.0,66,1,3,4,37.0,82,5.53,56,304,2486,9.1,0.14776766
25537,25537,Stan Drulia,1993-94,26.0,2,3,24,24,2,1,3,22.0,,24,2,1,3,22.0,84,7.25,87,443,2603,11.7,0.2509399
25538,25538,Stan Drulia,2000-01,33.0,3,33,68,68,11,22,33,94.0,1130.0,92,13,23,36,116.0,82,5.49,53,331,2294,9.8,0.38181084
25539,25539,Stan Drulia,2001-02,34.0,4,6,34,34,2,4,6,20.0,363.0,126,15,27,42,136.0,82,5.51,63,376,2272,9.9,0.17300987
25540,25540,Stan Neckar,1995-96,20.0,2,4,48,48,1,3,4,34.0,,48,1,3,4,34.0,48,5.97,37,209,1408,10.2,0.22053745
25541,25541,Stan Neckar,1996-97,21.0,3,12,82,82,3,9,12,57.0,,130,4,12,16,91.0,82,6.29,74,413,2481,10.4,0.22675848
25542,25542,Stan Neckar,1997-98,22.0,4,0,5,5,0,0,0,3.0,,135,4,12,16,94.0,82,5.83,55,336,2444,9.8,0.17744589
25543,25543,Stan Neckar,1998-99,23.0,5,4,60,60,2,2,4,43.0,,195,6,14,20,137.0,82,5.28,57,380,2242,9.6,0.18569058
25544,25544,Stan Neckar,1999-00,24.0,6,3,32,32,0,3,3,16.0,462.0,227,6,17,23,153.0,82,5.27,57,359,2285,9.4,0.1475654
25545,25545,Stan Neckar,2000-01,25.0,7,10,66,66,2,8,10,34.0,954.0,293,8,25,33,187.0,82,5.49,53,331,2294,9.8,0.14126971
25546,25546,Stan Neckar,2001-02,26.0,8,6,69,69,2,4,6,26.0,1115.0,362,10,29,39,213.0,82,5.51,63,376,2272,9.9,0.11086634
25547,25547,Stan Neckar,2002-03,27.0,9,8,77,77,1,7,8,38.0,1580.0,439,11,36,47,251.0,82,5.24,53,338,2262,9.5,0.13646469
25548,25548,Stan Neckar,2003-04,28.0,10,5,70,70,1,4,5,38.0,1309.0,509,12,40,52,289.0,82,5.31,60,363,2326,9.4,0.14871296
25549,25549,Stan Neckar,2004-05,29.0,11,1,1,1,0,1,1,0.0,15.0,510,12,41,53,289.0,82,5.14,57,348,2300,9.2,0.20620361
25550,25550,Stanislav Chistov,2003-04,20.0,2,30,79,79,12,18,30,114.0,1073.0,79,12,18,30,114.0,82,5.31,60,363,2326,9.4,0.45192528
25551,25551,Stanislav Chistov,2004-05,21.0,3,18,56,56,2,16,18,70.0,690.0,135,14,34,48,184.0,82,5.14,57,348,2300,9.2,0.44310087
25552,25552,Stanislav Chistov,2007-08,24.0,4,13,61,61,5,8,13,49.0,519.0,196,19,42,61,233.0,82,5.76,70,398,2426,9.7,0.25950006
25553,25553,Stanislav Galiev,2015-16,24.0,2,1,2,2,1,0,1,2.0,19.0,2,1,0,1,2.0,82,5.32,47,251,2453,8.9,0.2048485
25554,25554,Stanislav Galiev,2016-17,25.0,3,3,24,24,0,3,3,30.0,219.0,26,1,3,4,32.0,82,5.34,48,255,2438,9.0,0.17485595
25555,25555,Stanislav Gron,2001-02,23.0,2,0,1,1,0,0,0,2.0,10.0,1,0,0,0,2.0,82,5.51,63,376,2272,9.9,0.17321542
25556,25556,Stefan Bergkvist,1996-97,21.0,2,0,2,2,0,0,0,4.0,,2,0,0,0,4.0,82,6.29,74,413,2481,10.4,0.21502173
25557,25557,Stefan Bergkvist,1997-98,22.0,3,0,5,5,0,0,0,0.0,,7,0,0,0,4.0,82,5.83,55,336,2444,9.8,0.16367212
25558,25558,Stefan Della Rovere,2011-12,21.0,2,0,7,7,0,0,0,4.0,43.0,7,0,0,0,4.0,82,5.46,52,291,2492,9.0,0.20690775
25559,25559,Stefan Elliott,2012-13,22.0,2,13,39,39,4,9,13,84.0,669.0,39,4,9,13,84.0,82,5.32,47,271,2439,8.9,0.32068092
25560,25560,Stefan Elliott,2013-14,23.0,3,4,18,18,1,3,4,35.0,315.0,57,5,12,17,119.0,48,5.31,29,160,1399,9.1,0.31600136
25561,25561,Stefan Elliott,2014-15,24.0,4,1,1,1,1,0,1,1.0,17.0,58,6,12,18,120.0,82,5.34,48,269,2463,8.9,0.22291806
25562,25562,Stefan Elliott,2015-16,25.0,5,0,5,5,0,0,0,10.0,70.0,63,6,12,18,130.0,82,5.32,47,251,2453,8.9,0.17634386
25563,25563,Stefan Elliott,2016-17,26.0,6,6,21,21,2,4,6,37.0,298.0,84,8,16,24,167.0,82,5.34,48,255,2438,9.0,0.23646343
25564,25564,Stefan Elliott,2019-20,29.0,7,1,3,3,0,1,1,3.0,27.0,87,8,17,25,170.0,82,5.96,47,239,2579,9.5,0.15700316
25565,25565,Stefan Matteau,2013-14,19.0,2,3,17,17,1,2,3,22.0,156.0,17,1,2,3,22.0,48,5.31,29,160,1399,9.1,0.29061344
25566,25566,Stefan Matteau,2015-16,21.0,3,1,7,7,1,0,1,8.0,83.0,24,2,2,4,30.0,82,5.32,47,251,2453,8.9,0.25317472
25567,25567,Stefan Matteau,2016-17,22.0,4,2,32,32,1,1,2,27.0,329.0,56,3,3,6,57.0,82,5.34,48,255,2438,9.0,0.20823184
25568,25568,Stefan Matteau,2018-19,24.0,5,1,8,8,0,1,1,8.0,66.0,64,3,4,7,65.0,82,5.86,50,250,2620,9.2,0.14854103
25569,25569,Stefan Matteau,2020-21,26.0,6,3,9,9,2,1,3,18.0,111.0,73,5,5,10,83.0,70,5.96,42,208,2192,9.5,0.24655625
25570,25570,Stefan Meyer,2008-09,23.0,2,0,4,4,0,0,0,0.0,10.0,4,0,0,0,0.0,82,5.44,62,351,2383,9.4,0.16456008
25571,25571,Stefan Meyer,2011-12,26.0,3,2,16,16,0,2,2,12.0,124.0,20,0,2,2,12.0,82,5.46,52,291,2492,9.0,0.16528672
25572,25572,Stefan Noesen,2015-16,22.0,2,0,1,1,0,0,0,0.0,7.0,1,0,0,0,0.0,82,5.32,47,251,2453,8.9,0.14922687
25573,25573,Stefan Noesen,2016-17,23.0,3,0,1,1,0,0,0,0.0,10.0,2,0,0,0,0.0,82,5.34,48,255,2438,9.0,0.15714687
25574,25574,Stefan Noesen,2017-18,24.0,4,10,44,44,8,2,10,63.0,490.0,46,8,2,10,63.0,82,5.45,47,245,2478,9.0,0.2647742
25575,25575,Stefan Noesen,2018-19,25.0,5,27,72,72,13,14,27,127.0,957.0,118,21,16,37,190.0,82,5.86,50,250,2620,9.2,0.35520378
25576,25576,Stefan Noesen,2019-20,26.0,6,8,41,41,3,5,8,64.0,522.0,159,24,21,45,254.0,82,5.96,47,239,2579,9.5,0.21544987
25577,25577,Stefan Noesen,2020-21,27.0,7,9,40,40,7,2,9,67.0,461.0,199,31,23,54,321.0,70,5.96,42,208,2192,9.5,0.244719
25578,25578,Stefan Ruzicka,2006-07,21.0,2,0,1,1,0,0,0,1.0,5.0,1,0,0,0,1.0,82,6.05,85,480,2458,10.1,0.195333
25579,25579,Stefan Ruzicka,2007-08,22.0,3,13,40,40,3,10,13,75.0,509.0,41,3,10,13,76.0,82,5.76,70,398,2426,9.7,0.29828334
25580,25580,Stefan Ruzicka,2008-09,23.0,4,4,14,14,1,3,4,10.0,121.0,55,4,13,17,86.0,82,5.44,62,351,2383,9.4,0.27950102
25581,25581,Stefan Ustorf,1996-97,23.0,2,17,48,48,7,10,17,39.0,,48,7,10,17,39.0,82,6.29,74,413,2481,10.4,0.32518902
25582,25582,Stefan Ustorf,1997-98,24.0,3,0,6,6,0,0,0,7.0,,54,7,10,17,46.0,82,5.83,55,336,2444,9.8,0.17262825
25583,25583,Stephan Lebeau,1989-90,21.0,2,1,1,1,0,1,1,1.0,,1,0,1,1,1.0,80,7.48,85,403,2430,12.3,0.28862292
25584,25584,Stephan Lebeau,1990-91,22.0,3,35,57,57,15,20,35,79.0,,58,15,21,36,80.0,80,7.37,76,367,2421,12.2,0.55449414
25585,25585,Stephan Lebeau,1991-92,23.0,4,53,73,73,22,31,53,108.0,,131,37,52,89,188.0,80,6.91,71,366,2385,11.6,0.65613306
25586,25586,Stephan Lebeau,1992-93,24.0,5,58,77,77,27,31,58,178.0,,208,64,83,147,366.0,80,6.96,77,402,2440,11.4,0.77757084
25587,25587,Stephan Lebeau,1993-94,25.0,6,80,71,71,31,49,80,150.0,,279,95,132,227,516.0,84,7.25,87,443,2603,11.7,0.8288157
25588,25588,Stephan Lebeau,1994-95,26.0,7,26,56,56,15,11,26,98.0,,335,110,143,253,614.0,84,6.48,76,407,2545,10.7,0.5714996
25589,25589,Stephan Lebeau,1995-96,27.0,8,24,38,38,8,16,24,70.0,,373,118,159,277,684.0,48,5.97,37,209,1408,10.2,0.59680194
25590,25590,Stephane Brochu,1989-90,22.0,2,0,1,1,0,0,0,1.0,,1,0,0,0,1.0,80,7.48,85,403,2430,12.3,0.21754727
25591,25591,Stephane Charbonneau,1992-93,22.0,2,0,2,2,0,0,0,4.0,,2,0,0,0,4.0,80,6.96,77,402,2440,11.4,0.23151347
25592,25592,Stephane Da Costa,2011-12,22.0,2,0,4,4,0,0,0,9.0,46.0,4,0,0,0,9.0,82,5.46,52,291,2492,9.0,0.1917767
25593,25593,Stephane Da Costa,2012-13,23.0,3,5,22,22,3,2,5,31.0,268.0,26,3,2,5,40.0,82,5.32,47,271,2439,8.9,0.2639831
25594,25594,Stephane Da Costa,2013-14,24.0,4,2,9,9,1,1,2,15.0,107.0,35,4,3,7,55.0,48,5.31,29,160,1399,9.1,0.2401213
25595,25595,Stephane Da Costa,2014-15,25.0,5,4,12,12,3,1,4,20.0,125.0,47,7,4,11,75.0,82,5.34,48,269,2463,8.9,0.2373735
25596,25596,Stephane Guerard,1988-89,20.0,2,0,30,30,0,0,0,12.0,,30,0,0,0,12.0,80,7.43,89,437,2435,12.2,0.22944081
25597,25597,Stephane Guerard,1990-91,22.0,3,0,4,4,0,0,0,9.0,,34,0,0,0,21.0,80,7.37,76,367,2421,12.2,0.19680873
25598,25598,Stephane Matteau,1991-92,22.0,2,34,78,78,15,19,34,114.0,,78,15,19,34,114.0,80,6.91,71,366,2385,11.6,0.47782162
25599,25599,Stephane Matteau,1992-93,23.0,3,14,24,24,6,8,14,38.0,,102,21,27,48,152.0,80,6.96,77,402,2440,11.4,0.5015425
25600,25600,Stephane Matteau,1993-94,24.0,4,33,79,79,15,18,33,95.0,,181,36,45,81,247.0,84,7.25,87,443,2603,11.7,0.4264248
25601,25601,Stephane Matteau,1994-95,25.0,5,38,77,77,19,19,38,135.0,,258,55,64,119,382.0,84,6.48,76,407,2545,10.7,0.45709345
25602,25602,Stephane Matteau,1995-96,26.0,6,8,41,41,3,5,8,37.0,,299,58,69,127,419.0,48,5.97,37,209,1408,10.2,0.27332026
25603,25603,Stephane Matteau,1996-97,27.0,7,26,78,78,11,15,26,109.0,,377,69,84,153,528.0,82,6.29,74,413,2481,10.4,0.33192152
25604,25604,Stephane Matteau,1997-98,28.0,8,36,74,74,16,20,36,98.0,,451,85,104,189,626.0,82,5.83,55,336,2444,9.8,0.4554548
25605,25605,Stephane Matteau,1998-99,29.0,9,29,73,73,15,14,29,79.0,,524,100,118,218,705.0,82,5.28,57,380,2242,9.6,0.35481283
25606,25606,Stephane Matteau,1999-00,30.0,10,23,68,68,8,15,23,72.0,923.0,592,108,133,241,777.0,82,5.27,57,359,2285,9.4,0.3214473
25607,25607,Stephane Matteau,2000-01,31.0,11,24,69,69,12,12,24,73.0,818.0,661,120,145,265,850.0,82,5.49,53,331,2294,9.8,0.32361704
25608,25608,Stephane Matteau,2001-02,32.0,12,32,80,80,13,19,32,81.0,873.0,741,133,164,297,931.0,82,5.51,63,376,2272,9.9,0.29774857
25609,25609,Stephane Matteau,2002-03,33.0,13,11,55,55,7,4,11,43.0,503.0,796,140,168,308,974.0,82,5.24,53,338,2262,9.5,0.21281928
25610,25610,Stephane Matteau,2003-04,34.0,14,8,52,52,4,4,8,47.0,560.0,848,144,172,316,1021.0,82,5.31,60,363,2326,9.4,0.15786704
25611,25611,Stephane Morin,1990-91,21.0,2,2,6,6,0,2,2,11.0,,6,0,2,2,11.0,80,7.37,76,367,2421,12.2,0.3159501
25612,25612,Stephane Morin,1991-92,22.0,3,40,48,48,13,27,40,63.0,,54,13,29,42,74.0,80,6.91,71,366,2385,11.6,0.6294866
25613,25613,Stephane Morin,1992-93,23.0,4,10,30,30,2,8,10,41.0,,84,15,37,52,115.0,80,6.96,77,402,2440,11.4,0.40943244
25614,25614,Stephane Morin,1993-94,24.0,5,1,1,1,0,1,1,3.0,,85,15,38,53,118.0,84,7.25,87,443,2603,11.7,0.27616847
25615,25615,Stephane Morin,1994-95,25.0,6,2,5,5,1,1,2,6.0,,90,16,39,55,124.0,84,6.48,76,407,2545,10.7,0.22735935
25616,25616,Stephane Quintal,1989-90,21.0,2,1,26,26,0,1,1,23.0,,26,0,1,1,23.0,80,7.48,85,403,2430,12.3,0.2824648
25617,25617,Stephane Quintal,1990-91,22.0,3,4,38,38,2,2,4,43.0,,64,2,3,5,66.0,80,7.37,76,367,2421,12.2,0.21421045
25618,25618,Stephane Quintal,1991-92,23.0,4,8,45,45,2,6,8,54.0,,109,4,9,13,120.0,80,6.91,71,366,2385,11.6,0.23993689
25619,25619,Stephane Quintal,1992-93,24.0,5,20,75,75,4,16,20,71.0,,184,8,25,33,191.0,80,6.96,77,402,2440,11.4,0.22857705
25620,25620,Stephane Quintal,1993-94,25.0,6,11,75,75,1,10,11,81.0,,259,9,35,44,272.0,84,7.25,87,443,2603,11.7,0.18308318
25621,25621,Stephane Quintal,1994-95,26.0,7,26,81,81,8,18,26,154.0,,340,17,53,70,426.0,84,6.48,76,407,2545,10.7,0.33225137
25622,25622,Stephane Quintal,1995-96,27.0,8,23,43,43,6,17,23,107.0,,383,23,70,93,533.0,48,5.97,37,209,1408,10.2,0.4325269
25623,25623,Stephane Quintal,1996-97,28.0,9,16,68,68,2,14,16,104.0,,451,25,84,109,637.0,82,6.29,74,413,2481,10.4,0.23943222
25624,25624,Stephane Quintal,1997-98,29.0,10,22,71,71,7,15,22,139.0,,522,32,99,131,776.0,82,5.83,55,336,2444,9.8,0.29654375
25625,25625,Stephane Quintal,1998-99,30.0,11,16,71,71,6,10,16,88.0,,593,38,109,147,864.0,82,5.28,57,380,2242,9.6,0.23685038
25626,25626,Stephane Quintal,1999-00,31.0,12,27,82,82,8,19,27,159.0,1812.0,675,46,128,174,1023.0,82,5.27,57,359,2285,9.4,0.30909222
25627,25627,Stephane Quintal,2000-01,32.0,13,16,75,75,2,14,16,102.0,1430.0,750,48,142,190,1125.0,82,5.49,53,331,2294,9.8,0.2148765
25628,25628,Stephane Quintal,2001-02,33.0,14,19,72,72,1,18,19,109.0,1620.0,822,49,160,209,1234.0,82,5.51,63,376,2272,9.9,0.22982106
25629,25629,Stephane Quintal,2002-03,34.0,15,16,75,75,6,10,16,85.0,1415.0,897,55,170,225,1319.0,82,5.24,53,338,2262,9.5,0.19524398
25630,25630,Stephane Quintal,2003-04,35.0,16,10,67,67,5,5,10,73.0,1249.0,964,60,175,235,1392.0,82,5.31,60,363,2326,9.4,0.15155888
25631,25631,Stephane Quintal,2004-05,36.0,17,8,73,73,3,5,8,86.0,1506.0,1037,63,180,243,1478.0,82,5.14,57,348,2300,9.2,0.19155452
25632,25632,Stephane Richer,1985-86,19.0,2,0,1,1,0,0,0,0.0,,1,0,0,0,0.0,80,7.77,71,321,2447,12.7,0.24393094
25633,25633,Stephane Richer,1986-87,20.0,3,37,65,65,21,16,37,112.0,,66,21,16,37,112.0,80,7.94,82,370,2484,12.8,0.5987277
25634,25634,Stephane Richer,1987-88,21.0,4,39,57,57,20,19,39,109.0,,123,41,35,76,221.0,80,7.34,72,344,2400,12.2,0.7279675
25635,25635,Stephane Richer,1988-89,22.0,5,78,72,72,50,28,78,263.0,,195,91,63,154,484.0,80,7.43,89,437,2435,12.2,0.9478779
25636,25636,Stephane Richer,1989-90,23.0,6,60,68,68,25,35,60,214.0,,263,116,98,214,698.0,80,7.48,85,403,2430,12.3,0.88205254
25637,25637,Stephane Richer,1990-91,24.0,7,91,75,75,51,40,91,269.0,,338,167,138,305,967.0,80,7.37,76,367,2421,12.2,1.0654633
25638,25638,Stephane Richer,1991-92,25.0,8,61,75,75,31,30,61,221.0,,413,198,168,366,1188.0,80,6.91,71,366,2385,11.6,0.7678108
25639,25639,Stephane Richer,1992-93,26.0,9,64,74,74,29,35,64,240.0,,487,227,203,430,1428.0,80,6.96,77,402,2440,11.4,0.90554345
25640,25640,Stephane Richer,1993-94,27.0,10,73,78,78,38,35,73,286.0,,565,265,238,503,1714.0,84,7.25,87,443,2603,11.7,0.85618496
25641,25641,Stephane Richer,1994-95,28.0,11,72,80,80,36,36,72,217.0,,645,301,274,575,1931.0,84,6.48,76,407,2545,10.7,0.7760272
25642,25642,Stephane Richer,1995-96,29.0,12,39,45,45,23,16,39,133.0,,690,324,290,614,2064.0,48,5.97,37,209,1408,10.2,0.7748149
25643,25643,Stephane Richer,1996-97,30.0,13,32,73,73,20,12,32,192.0,,763,344,302,646,2256.0,82,6.29,74,413,2481,10.4,0.5462641
25644,25644,Stephane Richer,1997-98,31.0,14,46,63,63,22,24,46,126.0,,826,366,326,692,2382.0,82,5.83,55,336,2444,9.8,0.59299475
25645,25645,Stephane Richer,1998-99,32.0,15,29,40,40,14,15,29,95.0,,866,380,341,721,2477.0,82,5.28,57,380,2242,9.6,0.55921847
25646,25646,Stephane Richer,1999-00,33.0,16,33,64,64,12,21,33,139.0,1074.0,930,392,362,754,2616.0,82,5.27,57,359,2285,9.4,0.510532
25647,25647,Stephane Richer,2000-01,34.0,17,37,56,56,15,22,37,110.0,775.0,986,407,384,791,2726.0,82,5.49,53,331,2294,9.8,0.5516513
25648,25648,Stephane Richer,2002-03,36.0,18,28,68,68,14,14,28,123.0,938.0,1054,421,398,819,2849.0,82,5.24,53,338,2262,9.5,0.3748867
25649,25649,Stephane Richer0,1993-94,27.0,2,5,24,24,1,4,5,24.0,,24,1,4,5,24.0,84,7.25,87,443,2603,11.7,0.22674745
25650,25650,Stephane Richer0,1994-95,28.0,3,1,2,2,0,1,1,3.0,,26,1,5,6,27.0,84,6.48,76,407,2545,10.7,0.16130129
25651,25651,Stephane Richer0,1995-96,29.0,4,0,1,1,0,0,0,0.0,,27,1,5,6,27.0,48,5.97,37,209,1408,10.2,0.15302393
25652,25652,Stephane Robidas,2000-01,23.0,2,0,1,1,0,0,0,0.0,16.0,1,0,0,0,0.0,82,5.49,53,331,2294,9.8,0.16184989
25653,25653,Stephane Robidas,2001-02,24.0,3,12,65,65,6,6,12,77.0,1348.0,66,6,6,12,77.0,82,5.51,63,376,2272,9.9,0.23098972
25654,25654,Stephane Robidas,2002-03,25.0,4,11,56,56,1,10,11,68.0,1063.0,122,7,16,23,145.0,82,5.24,53,338,2262,9.5,0.17273304
25655,25655,Stephane Robidas,2003-04,26.0,5,10,76,76,3,7,10,47.0,980.0,198,10,23,33,192.0,82,5.31,60,363,2326,9.4,0.1640518
25656,25656,Stephane Robidas,2004-05,27.0,6,13,59,59,3,10,13,63.0,1123.0,257,13,33,46,255.0,82,5.14,57,348,2300,9.2,0.23040825
25657,25657,Stephane Robidas,2006-07,29.0,7,20,75,75,5,15,20,95.0,1274.0,332,18,48,66,350.0,82,6.05,85,480,2458,10.1,0.23222607
25658,25658,Stephane Robidas,2007-08,30.0,8,17,75,75,0,17,17,106.0,1355.0,407,18,65,83,456.0,82,5.76,70,398,2426,9.7,0.20856684
25659,25659,Stephane Robidas,2008-09,31.0,9,26,82,82,9,17,26,153.0,1693.0,489,27,82,109,609.0,82,5.44,62,351,2383,9.4,0.32298446
25660,25660,Stephane Robidas,2009-10,32.0,10,26,72,72,3,23,26,158.0,1767.0,561,30,105,135,767.0,82,5.7,65,341,2477,9.4,0.31693745
25661,25661,Stephane Robidas,2010-11,33.0,11,41,82,82,10,31,41,199.0,2008.0,643,40,136,176,966.0,82,5.53,56,304,2486,9.1,0.4447111
25662,25662,Stephane Robidas,2011-12,34.0,12,30,81,81,5,25,30,106.0,1987.0,724,45,161,206,1072.0,82,5.46,52,291,2492,9.0,0.30439913
25663,25663,Stephane Robidas,2012-13,35.0,13,22,75,75,5,17,22,75.0,1707.0,799,50,178,228,1147.0,82,5.32,47,271,2439,8.9,0.21707648
25664,25664,Stephane Robidas,2013-14,36.0,14,13,48,48,1,12,13,46.0,1067.0,847,51,190,241,1193.0,48,5.31,29,160,1399,9.1,0.17738959
25665,25665,Stephane Robidas,2014-15,37.0,15,10,38,38,5,5,10,56.0,767.0,885,56,195,251,1249.0,82,5.34,48,269,2463,8.9,0.18435574
25666,25666,Stephane Robidas,2015-16,38.0,16,7,52,52,1,6,7,34.0,888.0,937,57,201,258,1283.0,82,5.32,47,251,2453,8.9,0.12310478
25667,25667,Stephane Roy,1988-89,21.0,2,1,12,12,1,0,1,14.0,,12,1,0,1,14.0,80,7.43,89,437,2435,12.2,0.2623139
25668,25668,Stephane Veilleux,2003-04,22.0,2,5,38,38,3,2,5,52.0,461.0,38,3,2,5,52.0,82,5.31,60,363,2326,9.4,0.24221683
25669,25669,Stephane Veilleux,2004-05,23.0,3,10,19,19,2,8,10,37.0,272.0,57,5,10,15,89.0,82,5.14,57,348,2300,9.2,0.33485162
25670,25670,Stephane Veilleux,2006-07,25.0,4,16,71,71,7,9,16,87.0,920.0,128,12,19,31,176.0,82,6.05,85,480,2458,10.1,0.23779368
25671,25671,Stephane Veilleux,2007-08,26.0,5,18,75,75,7,11,18,84.0,922.0,203,19,30,49,260.0,82,5.76,70,398,2426,9.7,0.25783566
25672,25672,Stephane Veilleux,2008-09,27.0,6,18,77,77,11,7,18,136.0,1119.0,280,30,37,67,396.0,82,5.44,62,351,2383,9.4,0.27323636
25673,25673,Stephane Veilleux,2009-10,28.0,7,23,81,81,13,10,23,146.0,1280.0,361,43,47,90,542.0,82,5.7,65,341,2477,9.4,0.29248896
25674,25674,Stephane Veilleux,2010-11,29.0,8,9,77,77,3,6,9,94.0,946.0,438,46,53,99,636.0,82,5.53,56,304,2486,9.1,0.18361014
25675,25675,Stephane Veilleux,2012-13,31.0,9,2,22,22,0,2,2,16.0,216.0,460,46,55,101,652.0,82,5.32,47,271,2439,8.9,0.13609177
25676,25676,Stephane Veilleux,2014-15,33.0,10,3,34,34,3,0,3,26.0,287.0,494,49,55,104,678.0,82,5.34,48,269,2463,8.9,0.18309909
25677,25677,Stephane Veilleux,2015-16,34.0,11,2,12,12,1,1,2,9.0,92.0,506,50,56,106,687.0,82,5.32,47,251,2453,8.9,0.15799361
25678,25678,Stephane Yelle,1996-97,22.0,2,27,71,71,13,14,27,93.0,,71,13,14,27,93.0,82,6.29,74,413,2481,10.4,0.3976834
25679,25679,Stephane Yelle,1997-98,23.0,3,26,79,79,9,17,26,89.0,,150,22,31,53,182.0,82,5.83,55,336,2444,9.8,0.36331904
25680,25680,Stephane Yelle,1998-99,24.0,4,22,81,81,7,15,22,93.0,,231,29,46,75,275.0,82,5.28,57,380,2242,9.6,0.32461435
25681,25681,Stephane Yelle,1999-00,25.0,5,15,72,72,8,7,15,99.0,1098.0,303,37,53,90,374.0,82,5.27,57,359,2285,9.4,0.2755619
25682,25682,Stephane Yelle,2000-01,26.0,6,22,79,79,8,14,22,90.0,1253.0,382,45,67,112,464.0,82,5.49,53,331,2294,9.8,0.28548074
25683,25683,Stephane Yelle,2001-02,27.0,7,14,50,50,4,10,14,54.0,723.0,432,49,77,126,518.0,82,5.51,63,376,2272,9.9,0.23892206
25684,25684,Stephane Yelle,2002-03,28.0,8,17,73,73,5,12,17,71.0,1024.0,505,54,89,143,589.0,82,5.24,53,338,2262,9.5,0.25272372
25685,25685,Stephane Yelle,2003-04,29.0,9,25,82,82,10,15,25,121.0,1484.0,587,64,104,168,710.0,82,5.31,60,363,2326,9.4,0.30048782
25686,25686,Stephane Yelle,2004-05,30.0,10,17,53,53,4,13,17,76.0,838.0,640,68,117,185,786.0,82,5.14,57,348,2300,9.2,0.3313945
25687,25687,Stephane Yelle,2006-07,32.0,11,18,74,74,4,14,18,93.0,1069.0,714,72,131,203,879.0,82,6.05,85,480,2458,10.1,0.23858261
25688,25688,Stephane Yelle,2007-08,33.0,12,24,56,56,10,14,24,55.0,819.0,770,82,145,227,934.0,82,5.76,70,398,2426,9.7,0.31976473
25689,25689,Stephane Yelle,2008-09,34.0,13,12,74,74,3,9,12,62.0,884.0,844,85,154,239,996.0,82,5.44,62,351,2383,9.4,0.15447006
25690,25690,Stephane Yelle,2009-10,35.0,14,18,77,77,7,11,18,72.0,1022.0,921,92,165,257,1068.0,82,5.7,65,341,2477,9.4,0.21153152
25691,25691,Stephane Yelle,2010-11,36.0,15,8,70,70,4,4,8,39.0,662.0,991,96,169,265,1107.0,82,5.53,56,304,2486,9.1,0.1334312
25692,25692,Stephen Gionta,2011-12,28.0,2,0,12,12,0,0,0,13.0,108.0,12,0,0,0,13.0,82,5.46,52,291,2492,9.0,0.18924105
25693,25693,Stephen Gionta,2012-13,29.0,3,1,1,1,1,0,1,2.0,11.0,13,1,0,1,15.0,82,5.32,47,271,2439,8.9,0.17481288
25694,25694,Stephen Gionta,2013-14,30.0,4,14,48,48,4,10,14,58.0,625.0,61,5,10,15,73.0,48,5.31,29,160,1399,9.1,0.27010727
25695,25695,Stephen Gionta,2014-15,31.0,5,11,66,66,4,7,11,89.0,822.0,127,9,17,26,162.0,82,5.34,48,269,2463,8.9,0.16564628
25696,25696,Stephen Gionta,2015-16,32.0,6,13,61,61,5,8,13,84.0,804.0,188,14,25,39,246.0,82,5.32,47,251,2453,8.9,0.19886386
25697,25697,Stephen Gionta,2016-17,33.0,7,11,82,82,1,10,11,62.0,1001.0,270,15,35,50,308.0,82,5.34,48,255,2438,9.0,0.13718978
25698,25698,Stephen Gionta,2017-18,34.0,8,6,26,26,1,5,6,17.0,291.0,296,16,40,56,325.0,82,5.45,47,245,2478,9.0,0.13400525
25699,25699,Stephen Gionta,2019-20,36.0,9,0,5,5,0,0,0,4.0,44.0,301,16,40,56,329.0,82,5.96,47,239,2579,9.5,0.12592298
25700,25700,Stephen Johns,2016-17,24.0,2,3,14,14,1,2,3,13.0,250.0,14,1,2,3,13.0,82,5.34,48,255,2438,9.0,0.2099163
25701,25701,Stephen Johns,2017-18,25.0,3,10,61,61,4,6,10,91.0,1114.0,75,5,8,13,104.0,82,5.45,47,245,2478,9.0,0.2233083
25702,25702,Stephen Johns,2018-19,26.0,4,15,75,75,8,7,15,121.0,1316.0,150,13,15,28,225.0,82,5.86,50,250,2620,9.2,0.22367397
25703,25703,Stephen Johns,2020-21,28.0,5,5,17,17,2,3,5,30.0,300.0,167,15,18,33,255.0,70,5.96,42,208,2192,9.5,0.2580018
25704,25704,Stephen Leach,1986-87,21.0,2,2,11,11,1,1,2,4.0,,11,1,1,2,4.0,80,7.94,82,370,2484,12.8,0.2778901
25705,25705,Stephen Leach,1987-88,22.0,3,1,15,15,1,0,1,17.0,,26,2,1,3,21.0,80,7.34,72,344,2400,12.2,0.26312482
25706,25706,Stephen Leach,1988-89,23.0,4,2,8,8,1,1,2,5.0,,34,3,2,5,26.0,80,7.43,89,437,2435,12.2,0.25798434
25707,25707,Stephen Leach,1989-90,24.0,5,30,74,74,11,19,30,145.0,,108,14,21,35,171.0,80,7.48,85,403,2430,12.3,0.41481733
25708,25708,Stephen Leach,1990-91,25.0,6,32,70,70,18,14,32,122.0,,178,32,35,67,293.0,80,7.37,76,367,2421,12.2,0.43740815
25709,25709,Stephen Leach,1991-92,26.0,7,30,68,68,11,19,30,134.0,,246,43,54,97,427.0,80,6.91,71,366,2385,11.6,0.45315647
25710,25710,Stephen Leach,1992-93,27.0,8,60,78,78,31,29,60,243.0,,324,74,83,157,670.0,80,6.96,77,402,2440,11.4,0.7086687
25711,25711,Stephen Leach,1993-94,28.0,9,51,79,79,26,25,51,256.0,,403,100,108,208,926.0,84,7.25,87,443,2603,11.7,0.5487337
25712,25712,Stephen Leach,1994-95,29.0,10,15,42,42,5,10,15,89.0,,445,105,118,223,1015.0,84,6.48,76,407,2545,10.7,0.34065014
25713,25713,Stephen Leach,1995-96,30.0,11,11,35,35,5,6,11,82.0,,480,110,124,234,1097.0,48,5.97,37,209,1408,10.2,0.3636204
25714,25714,Stephen Leach,1996-97,31.0,12,28,73,73,11,17,28,157.0,,553,121,141,262,1254.0,82,6.29,74,413,2481,10.4,0.32117653
25715,25715,Stephen Leach,1997-98,32.0,13,3,17,17,2,1,3,33.0,,570,123,142,265,1287.0,82,5.83,55,336,2444,9.8,0.2623839
25716,25716,Stephen Leach,1998-99,33.0,14,9,45,45,4,5,9,60.0,,615,127,147,274,1347.0,82,5.28,57,380,2242,9.6,0.17935395
25717,25717,Stephen Leach,1999-00,34.0,15,4,31,31,1,3,4,27.0,260.0,646,128,150,278,1374.0,82,5.27,57,359,2285,9.4,0.18064576
25718,25718,Stephen Leach,2000-01,35.0,16,5,56,56,2,3,5,41.0,372.0,702,130,153,283,1415.0,82,5.49,53,331,2294,9.8,0.14251304
25719,25719,Stephen Peat,2002-03,22.0,2,4,38,38,2,2,4,11.0,192.0,38,2,2,4,11.0,82,5.24,53,338,2262,9.5,0.17011374
25720,25720,Stephen Peat,2003-04,23.0,3,1,27,27,1,0,1,7.0,112.0,65,3,2,5,18.0,82,5.31,60,363,2326,9.4,0.15252116
25721,25721,Stephen Peat,2004-05,24.0,4,5,64,64,5,0,5,21.0,424.0,129,8,2,10,39.0,82,5.14,57,348,2300,9.2,0.14333591
25722,25722,Stephen Peat,2006-07,26.0,5,0,1,1,0,0,0,2.0,5.0,130,8,2,10,41.0,82,6.05,85,480,2458,10.1,0.1211327
25723,25723,Stephen Tepper,1993-94,24.0,2,0,1,1,0,0,0,0.0,,1,0,0,0,0.0,84,7.25,87,443,2603,11.7,0.16088495
25724,25724,Stephen Weiss,2002-03,19.0,2,2,7,7,1,1,2,15.0,114.0,7,1,1,2,15.0,82,5.24,53,338,2262,9.5,0.2582212
25725,25725,Stephen Weiss,2003-04,20.0,3,21,77,77,6,15,21,87.0,1100.0,84,7,16,23,102.0,82,5.31,60,363,2326,9.4,0.3565895
25726,25726,Stephen Weiss,2004-05,21.0,4,29,50,50,12,17,29,82.0,885.0,134,19,33,52,184.0,82,5.14,57,348,2300,9.2,0.5702168
25727,25727,Stephen Weiss,2006-07,23.0,5,21,41,41,9,12,21,74.0,625.0,175,28,45,73,258.0,82,6.05,85,480,2458,10.1,0.4743663
25728,25728,Stephen Weiss,2007-08,24.0,6,48,74,74,20,28,48,176.0,1266.0,249,48,73,121,434.0,82,5.76,70,398,2426,9.7,0.58428454
25729,25729,Stephen Weiss,2008-09,25.0,7,42,74,74,13,29,42,132.0,1301.0,323,61,102,163,566.0,82,5.44,62,351,2383,9.4,0.5605825
25730,25730,Stephen Weiss,2009-10,26.0,8,61,78,78,14,47,61,154.0,1389.0,401,75,149,224,720.0,82,5.7,65,341,2477,9.4,0.6856779
25731,25731,Stephen Weiss,2010-11,27.0,9,60,80,80,28,32,60,180.0,1600.0,481,103,181,284,900.0,82,5.53,56,304,2486,9.1,0.6706082
25732,25732,Stephen Weiss,2011-12,28.0,10,49,76,76,21,28,49,172.0,1528.0,557,124,209,333,1072.0,82,5.46,52,291,2492,9.0,0.6247368
25733,25733,Stephen Weiss,2012-13,29.0,11,57,80,80,20,37,57,149.0,1641.0,637,144,246,390,1221.0,82,5.32,47,271,2439,8.9,0.6513623
25734,25734,Stephen Weiss,2013-14,30.0,12,4,17,17,1,3,4,19.0,314.0,654,145,249,394,1240.0,48,5.31,29,160,1399,9.1,0.32674053
25735,25735,Stephen Weiss,2014-15,31.0,13,4,26,26,2,2,4,28.0,384.0,680,147,251,398,1268.0,82,5.34,48,269,2463,8.9,0.2773069
25736,25736,Stephen Weiss,2015-16,32.0,14,25,52,52,9,16,25,52.0,590.0,732,156,267,423,1320.0,82,5.32,47,251,2453,8.9,0.3939569
25737,25737,Steve Alley,1980-81,27.0,2,2,7,7,1,1,2,5.0,,7,1,1,2,5.0,80,7.03,61,280,2352,12.0,0.28679162
25738,25738,Steve Alley,1981-82,28.0,3,4,8,8,2,2,4,10.0,,15,3,3,6,15.0,80,7.69,77,340,2441,12.6,0.28097123
25739,25739,Steve Bancroft,1993-94,23.0,2,0,1,1,0,0,0,0.0,,1,0,0,0,0.0,84,7.25,87,443,2603,11.7,0.17103139
25740,25740,Steve Bancroft,2002-03,32.0,3,1,5,5,0,1,1,5.0,52.0,6,0,1,1,5.0,82,5.24,53,338,2262,9.5,0.17721167
25741,25741,Steve Begin,1998-99,20.0,2,0,5,5,0,0,0,2.0,,5,0,0,0,2.0,82,5.28,57,380,2242,9.6,0.21708345
25742,25742,Steve Begin,2000-01,22.0,3,2,13,13,1,1,2,3.0,94.0,18,1,1,2,5.0,82,5.49,53,331,2294,9.8,0.18544257
25743,25743,Steve Begin,2001-02,23.0,4,0,4,4,0,0,0,3.0,24.0,22,1,1,2,8.0,82,5.51,63,376,2272,9.9,0.15464789
25744,25744,Steve Begin,2002-03,24.0,5,12,51,51,7,5,12,65.0,480.0,73,8,6,14,73.0,82,5.24,53,338,2262,9.5,0.2565459
25745,25745,Steve Begin,2003-04,25.0,6,4,50,50,3,1,4,59.0,461.0,123,11,7,18,132.0,82,5.31,60,363,2326,9.4,0.16172102
25746,25746,Steve Begin,2004-05,26.0,7,15,52,52,10,5,15,91.0,652.0,175,21,12,33,223.0,82,5.14,57,348,2300,9.2,0.30962157
25747,25747,Steve Begin,2006-07,28.0,8,23,76,76,11,12,23,134.0,1087.0,251,32,24,56,357.0,82,6.05,85,480,2458,10.1,0.26785797
25748,25748,Steve Begin,2007-08,29.0,9,10,52,52,5,5,10,64.0,619.0,303,37,29,66,421.0,82,5.76,70,398,2426,9.7,0.19739097
25749,25749,Steve Begin,2008-09,30.0,10,8,44,44,3,5,8,67.0,512.0,347,40,34,74,488.0,82,5.44,62,351,2383,9.4,0.19196081
25750,25750,Steve Begin,2009-10,31.0,11,12,62,62,7,5,12,90.0,665.0,409,47,39,86,578.0,82,5.7,65,341,2477,9.4,0.1841664
25751,25751,Steve Begin,2010-11,32.0,12,14,77,77,5,9,14,110.0,988.0,486,52,48,100,688.0,82,5.53,56,304,2486,9.1,0.18687588
25752,25752,Steve Begin,2011-12,33.0,13,0,2,2,0,0,0,2.0,20.0,488,52,48,100,690.0,82,5.46,52,291,2492,9.0,0.20056963
25753,25753,Steve Begin,2013-14,35.0,14,8,36,36,4,4,8,31.0,288.0,524,56,52,108,721.0,48,5.31,29,160,1399,9.1,0.1725741
25754,25754,Steve Bernier,2006-07,21.0,2,27,39,39,14,13,27,75.0,551.0,39,14,13,27,75.0,82,6.05,85,480,2458,10.1,0.5751854
25755,25755,Steve Bernier,2007-08,22.0,3,31,62,62,15,16,31,104.0,842.0,101,29,29,58,179.0,82,5.76,70,398,2426,9.7,0.5058146
25756,25756,Steve Bernier,2008-09,23.0,4,32,76,76,16,16,32,131.0,1014.0,177,45,45,90,310.0,82,5.44,62,351,2383,9.4,0.5014203
25757,25757,Steve Bernier,2009-10,24.0,5,32,81,81,15,17,32,137.0,1121.0,258,60,62,122,447.0,82,5.7,65,341,2477,9.4,0.4628927
25758,25758,Steve Bernier,2010-11,25.0,6,22,59,59,11,11,22,95.0,836.0,317,71,73,144,542.0,82,5.53,56,304,2486,9.1,0.34941855
25759,25759,Steve Bernier,2011-12,26.0,7,15,68,68,5,10,15,97.0,886.0,385,76,83,159,639.0,82,5.46,52,291,2492,9.0,0.34147274
25760,25760,Steve Bernier,2012-13,27.0,8,6,32,32,1,5,6,23.0,383.0,417,77,88,165,662.0,82,5.32,47,271,2439,8.9,0.29711175
25761,25761,Steve Bernier,2013-14,28.0,9,15,47,47,8,7,15,88.0,647.0,464,85,95,180,750.0,48,5.31,29,160,1399,9.1,0.3752273
25762,25762,Steve Bernier,2014-15,29.0,10,12,78,78,3,9,12,104.0,971.0,542,88,104,192,854.0,82,5.34,48,269,2463,8.9,0.27380282
25763,25763,Steve Bernier,2015-16,30.0,11,32,67,67,16,16,32,107.0,867.0,609,104,120,224,961.0,82,5.32,47,251,2453,8.9,0.37920466
25764,25764,Steve Bernier,2016-17,31.0,12,6,24,24,1,5,6,27.0,269.0,633,105,125,230,988.0,82,5.34,48,255,2438,9.0,0.23079637
25765,25765,Steve Bernier,2018-19,33.0,13,0,4,4,0,0,0,4.0,40.0,637,105,125,230,992.0,82,5.86,50,250,2620,9.2,0.16247016
25766,25766,Steve Bozek,1982-83,22.0,2,56,71,71,33,23,56,182.0,,71,33,23,56,182.0,80,8.03,73,320,2489,12.9,0.80886436
25767,25767,Steve Bozek,1983-84,23.0,3,26,53,53,13,13,26,104.0,,124,46,36,82,286.0,80,7.73,71,310,2444,12.7,0.5545045
25768,25768,Steve Bozek,1984-85,24.0,4,20,46,46,10,10,20,76.0,,170,56,46,102,362.0,80,7.89,74,336,2448,12.9,0.5221418
25769,25769,Steve Bozek,1985-86,25.0,5,35,54,54,13,22,35,90.0,,224,69,68,137,452.0,80,7.77,71,321,2447,12.7,0.60203016
25770,25770,Steve Bozek,1986-87,26.0,6,43,64,64,21,22,43,147.0,,288,90,90,180,599.0,80,7.94,82,370,2484,12.8,0.6453984
25771,25771,Steve Bozek,1987-88,27.0,7,35,71,71,17,18,35,137.0,,359,107,108,215,736.0,80,7.34,72,344,2400,12.2,0.51851916
25772,25772,Steve Bozek,1988-89,28.0,8,10,33,33,3,7,10,43.0,,392,110,115,225,779.0,80,7.43,89,437,2435,12.2,0.37016213
25773,25773,Steve Bozek,1989-90,29.0,9,35,71,71,17,18,35,138.0,,463,127,133,260,917.0,80,7.48,85,403,2430,12.3,0.4670419
25774,25774,Steve Bozek,1990-91,30.0,10,23,58,58,14,9,23,105.0,,521,141,142,283,1022.0,80,7.37,76,367,2421,12.2,0.37593216
25775,25775,Steve Bozek,1991-92,31.0,11,32,62,62,15,17,32,126.0,,583,156,159,315,1148.0,80,6.91,71,366,2385,11.6,0.44836715
25776,25776,Steve Bozek,1992-93,32.0,12,16,58,58,8,8,16,105.0,,641,164,167,331,1253.0,80,6.96,77,402,2440,11.4,0.2945763
25777,25777,Steve Brule,2003-04,29.0,2,0,2,2,0,0,0,2.0,18.0,2,0,0,0,2.0,82,5.31,60,363,2326,9.4,0.1719929
25778,25778,Steve Carlson,1980-81,25.0,2,21,52,52,9,12,21,45.0,,52,9,12,21,45.0,80,7.03,61,280,2352,12.0,0.3699413
25779,25779,Steve Chiasson,1987-88,20.0,2,5,45,45,1,4,5,44.0,,45,1,4,5,44.0,80,7.34,72,344,2400,12.2,0.25192553
25780,25780,Steve Chiasson,1988-89,21.0,3,11,29,29,2,9,11,45.0,,74,3,13,16,89.0,80,7.43,89,437,2435,12.2,0.3583696
25781,25781,Steve Chiasson,1989-90,22.0,4,47,65,65,12,35,47,187.0,,139,15,48,63,276.0,80,7.48,85,403,2430,12.3,0.72669214
25782,25782,Steve Chiasson,1990-91,23.0,5,42,67,67,14,28,42,190.0,,206,29,76,105,466.0,80,7.37,76,367,2421,12.2,0.61658627
25783,25783,Steve Chiasson,1991-92,24.0,6,20,42,42,3,17,20,101.0,,248,32,93,125,567.0,80,6.91,71,366,2385,11.6,0.44592717
25784,25784,Steve Chiasson,1992-93,25.0,7,34,62,62,10,24,34,143.0,,310,42,117,159,710.0,80,6.96,77,402,2440,11.4,0.5614553
25785,25785,Steve Chiasson,1993-94,26.0,8,62,79,79,12,50,62,227.0,,389,54,167,221,937.0,84,7.25,87,443,2603,11.7,0.6604677
25786,25786,Steve Chiasson,1994-95,27.0,9,46,82,82,13,33,46,238.0,,471,67,200,267,1175.0,84,6.48,76,407,2545,10.7,0.53665566
25787,25787,Steve Chiasson,1995-96,28.0,10,25,45,45,2,23,25,110.0,,516,69,223,292,1285.0,48,5.97,37,209,1408,10.2,0.53194976
25788,25788,Steve Chiasson,1996-97,29.0,11,33,76,76,8,25,33,175.0,,592,77,248,325,1460.0,82,6.29,74,413,2481,10.4,0.4291934
25789,25789,Steve Chiasson,1997-98,30.0,12,30,65,65,8,22,30,168.0,,657,85,270,355,1628.0,82,5.83,55,336,2444,9.8,0.4457737
25790,25790,Steve Chiasson,1998-99,31.0,13,34,66,66,7,27,34,173.0,,723,92,297,389,1801.0,82,5.28,57,380,2242,9.6,0.4782169
25791,25791,Steve Chiasson,1999-00,32.0,14,9,28,28,1,8,9,74.0,649.0,751,93,305,398,1875.0,82,5.27,57,359,2285,9.4,0.35387173
25792,25792,Steve Christoff,1980-81,23.0,2,15,20,20,8,7,15,34.0,,20,8,7,15,34.0,80,7.03,61,280,2352,12.0,0.6012343
25793,25793,Steve Christoff,1981-82,24.0,3,39,56,56,26,13,39,132.0,,76,34,20,54,166.0,80,7.69,77,340,2441,12.6,0.72998476
25794,25794,Steve Christoff,1982-83,25.0,4,55,69,69,26,29,55,178.0,,145,60,49,109,344.0,80,8.03,73,320,2489,12.9,0.7152853
25795,25795,Steve Christoff,1983-84,26.0,5,17,45,45,9,8,17,50.0,,190,69,57,126,394.0,80,7.73,71,310,2444,12.7,0.44328088
25796,25796,Steve Christoff,1984-85,27.0,6,15,58,58,8,7,15,74.0,,248,77,64,141,468.0,80,7.89,74,336,2448,12.9,0.3254195
25797,25797,Steve Downie,2008-09,21.0,2,12,32,32,6,6,12,25.0,315.0,32,6,6,12,25.0,82,5.44,62,351,2383,9.4,0.3492009
25798,25798,Steve Downie,2009-10,22.0,3,6,29,29,3,3,6,26.0,244.0,61,9,9,18,51.0,82,5.7,65,341,2477,9.4,0.291591
25799,25799,Steve Downie,2010-11,23.0,4,46,79,79,22,24,46,116.0,1162.0,140,31,33,64,167.0,82,5.53,56,304,2486,9.1,0.53629696
25800,25800,Steve Downie,2011-12,24.0,5,32,57,57,10,22,32,83.0,828.0,197,41,55,96,250.0,82,5.46,52,291,2492,9.0,0.495777
25801,25801,Steve Downie,2012-13,25.0,6,41,75,75,14,27,41,140.0,1195.0,272,55,82,137,390.0,82,5.32,47,271,2439,8.9,0.54188746
25802,25802,Steve Downie,2013-14,26.0,7,1,2,2,0,1,1,2.0,18.0,274,55,83,138,392.0,48,5.31,29,160,1399,9.1,0.32974136
25803,25803,Steve Downie,2014-15,27.0,8,24,62,62,4,20,24,88.0,874.0,336,59,103,162,480.0,82,5.34,48,269,2463,8.9,0.3559451
25804,25804,Steve Downie,2015-16,28.0,9,28,72,72,14,14,28,104.0,895.0,408,73,117,190,584.0,82,5.32,47,251,2453,8.9,0.3801424
25805,25805,Steve Downie,2016-17,29.0,10,6,26,26,3,3,6,22.0,234.0,434,76,120,196,606.0,82,5.34,48,255,2438,9.0,0.3135544
25806,25806,Steve Dubinsky,1994-95,24.0,2,8,27,27,2,6,8,20.0,,27,2,6,8,20.0,84,6.48,76,407,2545,10.7,0.23692948
25807,25807,Steve Dubinsky,1995-96,25.0,3,0,16,16,0,0,0,16.0,,43,2,6,8,36.0,48,5.97,37,209,1408,10.2,0.17620596
25808,25808,Steve Dubinsky,1996-97,26.0,4,5,43,43,2,3,5,33.0,,86,4,9,13,69.0,82,6.29,74,413,2481,10.4,0.15118027
25809,25809,Steve Dubinsky,1997-98,27.0,5,0,5,5,0,0,0,4.0,,91,4,9,13,73.0,82,5.83,55,336,2444,9.8,0.13472316
25810,25810,Steve Dubinsky,1998-99,28.0,6,18,82,82,5,13,18,112.0,,173,9,22,31,185.0,82,5.28,57,380,2242,9.6,0.2168225
25811,25811,Steve Dubinsky,1999-00,29.0,7,14,62,62,4,10,14,70.0,898.0,235,13,32,45,255.0,82,5.27,57,359,2285,9.4,0.17786327
25812,25812,Steve Dubinsky,2000-01,30.0,8,1,23,23,0,1,1,29.0,278.0,258,13,33,46,284.0,82,5.49,53,331,2294,9.8,0.15901965
25813,25813,Steve Dubinsky,2001-02,31.0,9,10,60,60,6,4,10,70.0,660.0,318,19,37,56,354.0,82,5.51,63,376,2272,9.9,0.197884
25814,25814,Steve Dubinsky,2002-03,32.0,10,8,29,29,6,2,8,48.0,449.0,347,25,39,64,402.0,82,5.24,53,338,2262,9.5,0.23571545
25815,25815,Steve Dubinsky,2003-04,33.0,11,6,28,28,0,6,6,23.0,301.0,375,25,45,70,425.0,82,5.31,60,363,2326,9.4,0.18383259
25816,25816,Steve Duchesne,1987-88,22.0,2,38,75,75,13,25,38,113.0,,75,13,25,38,113.0,80,7.34,72,344,2400,12.2,0.5464214
25817,25817,Steve Duchesne,1988-89,23.0,3,55,71,71,16,39,55,190.0,,146,29,64,93,303.0,80,7.43,89,437,2435,12.2,0.7221091
25818,25818,Steve Duchesne,1989-90,24.0,4,75,79,79,25,50,75,215.0,,225,54,114,168,518.0,80,7.48,85,403,2430,12.3,0.88400614
25819,25819,Steve Duchesne,1990-91,25.0,5,62,79,79,20,42,62,224.0,,304,74,156,230,742.0,80,7.37,76,367,2421,12.2,0.77215785
25820,25820,Steve Duchesne,1991-92,26.0,6,62,78,78,21,41,62,171.0,,382,95,197,292,913.0,80,6.91,71,366,2385,11.6,0.7808565
25821,25821,Steve Duchesne,1992-93,27.0,7,56,78,78,18,38,56,229.0,,460,113,235,348,1142.0,80,6.96,77,402,2440,11.4,0.79187804
25822,25822,Steve Duchesne,1993-94,28.0,8,82,82,82,20,62,82,227.0,,542,133,297,430,1369.0,84,7.25,87,443,2603,11.7,0.8105142
25823,25823,Steve Duchesne,1994-95,29.0,9,31,36,36,12,19,31,115.0,,578,145,316,461,1484.0,84,6.48,76,407,2545,10.7,0.67266166
25824,25824,Steve Duchesne,1995-96,30.0,10,38,47,47,12,26,38,116.0,,625,157,342,499,1600.0,48,5.97,37,209,1408,10.2,0.7568321
25825,25825,Steve Duchesne,1996-97,31.0,11,36,62,62,12,24,36,163.0,,687,169,366,535,1763.0,82,6.29,74,413,2481,10.4,0.51664215
25826,25826,Steve Duchesne,1997-98,32.0,12,47,78,78,19,28,47,208.0,,765,188,394,582,1971.0,82,5.83,55,336,2444,9.8,0.62406003
25827,25827,Steve Duchesne,1998-99,33.0,13,56,80,80,14,42,56,153.0,,845,202,436,638,2124.0,82,5.28,57,380,2242,9.6,0.60257024
25828,25828,Steve Duchesne,1999-00,34.0,14,30,71,71,6,24,30,118.0,1518.0,916,208,460,668,2242.0,82,5.27,57,359,2285,9.4,0.40776825
25829,25829,Steve Duchesne,2000-01,35.0,15,41,79,79,10,31,41,154.0,1677.0,995,218,491,709,2396.0,82,5.49,53,331,2294,9.8,0.462134
25830,25830,Steve Duchesne,2001-02,36.0,16,25,54,54,6,19,25,76.0,990.0,1049,224,510,734,2472.0,82,5.51,63,376,2272,9.9,0.3950569
25831,25831,Steve Duchesne,2002-03,37.0,17,18,64,64,3,15,18,70.0,1017.0,1113,227,525,752,2542.0,82,5.24,53,338,2262,9.5,0.2821381
25832,25832,Steve Dykstra,1986-87,24.0,2,25,64,64,4,21,25,70.0,,64,4,21,25,70.0,80,7.94,82,370,2484,12.8,0.31994897
25833,25833,Steve Dykstra,1987-88,25.0,3,1,37,37,0,1,1,21.0,,101,4,22,26,91.0,80,7.34,72,344,2400,12.2,0.18145221
25834,25834,Steve Dykstra,1988-89,26.0,4,7,42,42,3,4,7,26.0,,143,7,26,33,117.0,80,7.43,89,437,2435,12.2,0.19030505
25835,25835,Steve Dykstra,1989-90,27.0,5,7,65,65,1,6,7,38.0,,208,8,32,40,155.0,80,7.48,85,403,2430,12.3,0.15355328
25836,25836,Steve Dykstra,1990-91,28.0,6,0,9,9,0,0,0,10.0,,217,8,32,40,165.0,80,7.37,76,367,2421,12.2,0.19201034
25837,25837,Steve Eminger,2003-04,20.0,2,2,17,17,0,2,2,6.0,172.0,17,0,2,2,6.0,82,5.31,60,363,2326,9.4,0.21454063
25838,25838,Steve Eminger,2004-05,21.0,3,4,41,41,0,4,4,12.0,719.0,58,0,6,6,18.0,82,5.14,57,348,2300,9.2,0.17353308
25839,25839,Steve Eminger,2006-07,23.0,4,18,66,66,5,13,18,50.0,1409.0,124,5,19,24,68.0,82,6.05,85,480,2458,10.1,0.23913014
25840,25840,Steve Eminger,2007-08,24.0,5,17,68,68,1,16,17,27.0,1288.0,192,6,35,41,95.0,82,5.76,70,398,2426,9.7,0.16981182
25841,25841,Steve Eminger,2008-09,25.0,6,2,20,20,0,2,2,14.0,223.0,212,6,37,43,109.0,82,5.44,62,351,2383,9.4,0.14855686
25842,25842,Steve Eminger,2009-10,26.0,7,26,71,71,5,21,26,85.0,1535.0,283,11,58,69,194.0,82,5.7,65,341,2477,9.4,0.30217355
25843,25843,Steve Eminger,2010-11,27.0,8,16,63,63,4,12,16,45.0,1227.0,346,15,70,85,239.0,82,5.53,56,304,2486,9.1,0.19056097
25844,25844,Steve Eminger,2011-12,28.0,9,6,65,65,2,4,6,23.0,1030.0,411,17,74,91,262.0,82,5.46,52,291,2492,9.0,0.1293785
25845,25845,Steve Eminger,2012-13,29.0,10,5,42,42,2,3,5,19.0,558.0,453,19,77,96,281.0,82,5.32,47,271,2439,8.9,0.13470513
25846,25846,Steve Eminger,2013-14,30.0,11,3,35,35,0,3,3,22.0,456.0,488,19,80,99,303.0,48,5.31,29,160,1399,9.1,0.12670645
25847,25847,Steve Gainey,2001-02,23.0,2,0,1,1,0,0,0,0.0,2.0,1,0,0,0,0.0,82,5.51,63,376,2272,9.9,0.16257238
25848,25848,Steve Gainey,2002-03,24.0,3,1,5,5,0,1,1,1.0,37.0,6,0,1,1,1.0,82,5.24,53,338,2262,9.5,0.18219522
25849,25849,Steve Gainey,2004-05,26.0,4,0,7,7,0,0,0,0.0,38.0,13,0,1,1,1.0,82,5.14,57,348,2300,9.2,0.1396667
25850,25850,Steve Gainey,2006-07,28.0,5,1,20,20,0,1,1,11.0,165.0,33,0,2,2,12.0,82,6.05,85,480,2458,10.1,0.11306813
25851,25851,Steve Gatzos,1982-83,21.0,2,14,16,16,6,8,14,36.0,,16,6,8,14,36.0,80,8.03,73,320,2489,12.9,0.5334534
25852,25852,Steve Gatzos,1983-84,22.0,3,13,44,44,6,7,13,70.0,,60,12,15,27,106.0,80,7.73,71,310,2444,12.7,0.36880785
25853,25853,Steve Gatzos,1984-85,23.0,4,6,23,23,3,3,6,29.0,,83,15,18,33,135.0,80,7.89,74,336,2448,12.9,0.3821125
25854,25854,Steve Gatzos,1985-86,24.0,5,2,6,6,0,2,2,6.0,,89,15,20,35,141.0,80,7.77,71,321,2447,12.7,0.26617217
25855,25855,Steve Gotaas,1988-89,21.0,2,11,36,36,5,6,11,27.0,,36,5,6,11,27.0,80,7.43,89,437,2435,12.2,0.32567823
25856,25856,Steve Gotaas,1989-90,22.0,3,4,12,12,1,3,4,18.0,,48,6,9,15,45.0,80,7.48,85,403,2430,12.3,0.29471987
25857,25857,Steve Gotaas,1991-92,24.0,4,0,1,1,0,0,0,2.0,,49,6,9,15,47.0,80,6.91,71,366,2385,11.6,0.19961745
25858,25858,Steve Graves,1984-85,20.0,2,0,2,2,0,0,0,2.0,,2,0,0,0,2.0,80,7.89,74,336,2448,12.9,0.28967196
25859,25859,Steve Graves,1987-88,23.0,3,2,12,12,2,0,2,12.0,,14,2,0,2,14.0,80,7.34,72,344,2400,12.2,0.30473572
25860,25860,Steve Graves,1988-89,24.0,4,7,21,21,3,4,7,21.0,,35,5,4,9,35.0,80,7.43,89,437,2435,12.2,0.3168307
25861,25861,Steve Guolla,1997-98,24.0,2,21,43,43,13,8,21,81.0,,43,13,8,21,81.0,82,5.83,55,336,2444,9.8,0.4192064
25862,25862,Steve Guolla,1998-99,25.0,3,2,7,7,1,1,2,9.0,,50,14,9,23,90.0,82,5.28,57,380,2242,9.6,0.23637238
25863,25863,Steve Guolla,1999-00,26.0,4,4,14,14,2,2,4,22.0,195.0,64,16,11,27,112.0,82,5.27,57,359,2285,9.4,0.26394385
25864,25864,Steve Guolla,2000-01,27.0,5,29,66,66,10,19,29,86.0,882.0,130,26,30,56,198.0,82,5.49,53,331,2294,9.8,0.31921765
25865,25865,Steve Guolla,2001-02,28.0,6,28,63,63,12,16,28,96.0,925.0,193,38,46,84,294.0,82,5.51,63,376,2272,9.9,0.38683462
25866,25866,Steve Guolla,2003-04,30.0,7,2,12,12,2,0,2,6.0,96.0,205,40,46,86,300.0,82,5.31,60,363,2326,9.4,0.24099833
25867,25867,Steve Hazlett,1980-81,23.0,2,0,1,1,0,0,0,2.0,,1,0,0,0,2.0,80,7.03,61,280,2352,12.0,0.2333568
25868,25868,Steve Heinze,1992-93,23.0,2,7,14,14,3,4,7,29.0,,14,3,4,7,29.0,80,6.96,77,402,2440,11.4,0.3937024
25869,25869,Steve Heinze,1993-94,24.0,3,31,73,73,18,13,31,146.0,,87,21,17,38,175.0,84,7.25,87,443,2603,11.7,0.45446035
25870,25870,Steve Heinze,1994-95,25.0,4,21,77,77,10,11,21,183.0,,164,31,28,59,358.0,84,6.48,76,407,2545,10.7,0.32614163
25871,25871,Steve Heinze,1995-96,26.0,5,16,36,36,7,9,16,70.0,,200,38,37,75,428.0,48,5.97,37,209,1408,10.2,0.43439662
25872,25872,Steve Heinze,1996-97,27.0,6,28,76,76,16,12,28,129.0,,276,54,49,103,557.0,82,6.29,74,413,2481,10.4,0.39668587
25873,25873,Steve Heinze,1997-98,28.0,7,25,30,30,17,8,25,96.0,,306,71,57,128,653.0,82,5.83,55,336,2444,9.8,0.64945644
25874,25874,Steve Heinze,1998-99,29.0,8,46,61,61,26,20,46,160.0,,367,97,77,174,813.0,82,5.28,57,380,2242,9.6,0.61361676
25875,25875,Steve Heinze,1999-00,30.0,9,40,73,73,22,18,40,146.0,1153.0,440,119,95,214,959.0,82,5.27,57,359,2285,9.4,0.4772773
25876,25876,Steve Heinze,2000-01,31.0,10,25,75,75,12,13,25,145.0,1121.0,515,131,108,239,1104.0,82,5.49,53,331,2294,9.8,0.33532935
25877,25877,Steve Heinze,2001-02,32.0,11,54,79,79,27,27,54,144.0,1439.0,594,158,135,293,1248.0,82,5.51,63,376,2272,9.9,0.54912114
25878,25878,Steve Heinze,2002-03,33.0,12,31,73,73,15,16,31,123.0,1152.0,667,173,151,324,1371.0,82,5.24,53,338,2262,9.5,0.3733064
25879,25879,Steve Heinze,2003-04,34.0,13,12,27,27,5,7,12,44.0,413.0,694,178,158,336,1415.0,82,5.31,60,363,2326,9.4,0.25815874
25880,25880,Steve Junker,1994-95,22.0,2,0,5,5,0,0,0,2.0,,5,0,0,0,2.0,84,6.48,76,407,2545,10.7,0.17581406
25881,25881,Steve Kariya,2000-01,23.0,2,19,45,45,8,11,19,41.0,569.0,45,8,11,19,41.0,82,5.49,53,331,2294,9.8,0.3579663
25882,25882,Steve Kariya,2001-02,24.0,3,7,17,17,1,6,7,22.0,199.0,62,9,17,26,63.0,82,5.51,63,376,2272,9.9,0.27242815
25883,25883,Steve Kariya,2002-03,25.0,4,1,3,3,0,1,1,0.0,37.0,65,9,18,27,63.0,82,5.24,53,338,2262,9.5,0.18404388
25884,25884,Steve Kasper,1981-82,20.0,2,56,76,76,21,35,56,165.0,,76,21,35,56,165.0,80,7.69,77,340,2441,12.6,0.7830198
25885,25885,Steve Kasper,1982-83,21.0,3,51,73,73,20,31,51,151.0,,149,41,66,107,316.0,80,8.03,73,320,2489,12.9,0.6882695
25886,25886,Steve Kasper,1983-84,22.0,4,8,24,24,2,6,8,26.0,,173,43,72,115,342.0,80,7.73,71,310,2444,12.7,0.5364213
25887,25887,Steve Kasper,1984-85,23.0,5,14,27,27,3,11,14,39.0,,200,46,83,129,381.0,80,7.89,74,336,2448,12.9,0.52049154
25888,25888,Steve Kasper,1985-86,24.0,6,40,77,77,16,24,40,144.0,,277,62,107,169,525.0,80,7.77,71,321,2447,12.7,0.5814416
25889,25889,Steve Kasper,1986-87,25.0,7,40,80,80,17,23,40,149.0,,357,79,130,209,674.0,80,7.94,82,370,2484,12.8,0.562817
25890,25890,Steve Kasper,1987-88,26.0,8,50,79,79,20,30,50,110.0,,436,99,160,259,784.0,80,7.34,72,344,2400,12.2,0.59717196
25891,25891,Steve Kasper,1988-89,27.0,9,70,79,79,26,44,70,166.0,,515,125,204,329,950.0,80,7.43,89,437,2435,12.2,0.7997511
25892,25892,Steve Kasper,1989-90,28.0,10,50,78,78,19,31,50,130.0,,593,144,235,379,1080.0,80,7.48,85,403,2430,12.3,0.5753516
25893,25893,Steve Kasper,1990-91,29.0,11,45,77,77,17,28,45,72.0,,670,161,263,424,1152.0,80,7.37,76,367,2421,12.2,0.47944602
25894,25894,Steve Kasper,1991-92,30.0,12,28,67,67,9,19,28,70.0,,737,170,282,452,1222.0,80,6.91,71,366,2385,11.6,0.3980891
25895,25895,Steve Kasper,1992-93,31.0,13,5,16,16,3,2,5,13.0,,753,173,284,457,1235.0,80,6.96,77,402,2440,11.4,0.35561377
25896,25896,Steve Kasper,1993-94,32.0,14,11,68,68,4,7,11,32.0,,821,177,291,468,1267.0,84,7.25,87,443,2603,11.7,0.19663548
25897,25897,Steve Kelly,1997-98,21.0,2,1,8,8,1,0,1,6.0,,8,1,0,1,6.0,82,5.83,55,336,2444,9.8,0.21992165
25898,25898,Steve Kelly,1998-99,22.0,3,5,43,43,2,3,5,22.0,,51,3,3,6,28.0,82,5.28,57,380,2242,9.6,0.16716221
25899,25899,Steve Kelly,1999-00,23.0,4,4,34,34,1,3,4,15.0,369.0,85,4,6,10,43.0,82,5.27,57,359,2285,9.4,0.19833964
25900,25900,Steve Kelly,2000-01,24.0,5,0,1,1,0,0,0,0.0,4.0,86,4,6,10,43.0,82,5.49,53,331,2294,9.8,0.1418756
25901,25901,Steve Kelly,2001-02,25.0,6,5,35,35,3,2,5,22.0,313.0,121,7,8,15,65.0,82,5.51,63,376,2272,9.9,0.1748159
25902,25902,Steve Kelly,2002-03,26.0,7,1,8,8,0,1,1,0.0,55.0,129,7,9,16,65.0,82,5.24,53,338,2262,9.5,0.14645588
25903,25903,Steve Kelly,2003-04,27.0,8,5,15,15,2,3,5,14.0,187.0,144,9,12,21,79.0,82,5.31,60,363,2326,9.4,0.20197004
25904,25904,Steve Kelly,2004-05,28.0,9,0,3,3,0,0,0,5.0,32.0,147,9,12,21,84.0,82,5.14,57,348,2300,9.2,0.16876319
25905,25905,Steve Kelly,2008-09,32.0,10,0,2,2,0,0,0,1.0,7.0,149,9,12,21,85.0,82,5.44,62,351,2383,9.4,0.1256127
25906,25906,Steve Konowalchuk,1992-93,20.0,2,0,1,1,0,0,0,1.0,,1,0,0,0,1.0,80,6.96,77,402,2440,11.4,0.2755677
25907,25907,Steve Konowalchuk,1993-94,21.0,3,11,36,36,4,7,11,34.0,,37,4,7,11,35.0,84,7.25,87,443,2603,11.7,0.30108604
25908,25908,Steve Konowalchuk,1994-95,22.0,4,26,62,62,12,14,26,63.0,,99,16,21,37,98.0,84,6.48,76,407,2545,10.7,0.3916925
25909,25909,Steve Konowalchuk,1995-96,23.0,5,25,46,46,11,14,25,88.0,,145,27,35,62,186.0,48,5.97,37,209,1408,10.2,0.52183795
25910,25910,Steve Konowalchuk,1996-97,24.0,6,45,70,70,23,22,45,197.0,,215,50,57,107,383.0,82,6.29,74,413,2481,10.4,0.6035235
25911,25911,Steve Konowalchuk,1997-98,25.0,7,42,78,78,17,25,42,155.0,,293,67,82,149,538.0,82,5.83,55,336,2444,9.8,0.5208609
25912,25912,Steve Konowalchuk,1998-99,26.0,8,34,80,80,10,24,34,131.0,,373,77,106,183,669.0,82,5.28,57,380,2242,9.6,0.46472076
25913,25913,Steve Konowalchuk,1999-00,27.0,9,24,45,45,12,12,24,98.0,803.0,418,89,118,207,767.0,82,5.27,57,359,2285,9.4,0.46159074
25914,25914,Steve Konowalchuk,2000-01,28.0,10,43,82,82,16,27,43,146.0,1444.0,500,105,145,250,913.0,82,5.49,53,331,2294,9.8,0.5134235
25915,25915,Steve Konowalchuk,2001-02,29.0,11,47,82,82,24,23,47,163.0,1400.0,582,129,168,297,1076.0,82,5.51,63,376,2272,9.9,0.55641776
25916,25916,Steve Konowalchuk,2002-03,30.0,12,14,28,28,2,12,14,36.0,461.0,610,131,180,311,1112.0,82,5.24,53,338,2262,9.5,0.33523214
25917,25917,Steve Konowalchuk,2003-04,31.0,13,30,77,77,15,15,30,119.0,1286.0,687,146,195,341,1231.0,82,5.31,60,363,2326,9.4,0.3559024
25918,25918,Steve Konowalchuk,2004-05,32.0,14,40,82,82,19,21,40,152.0,1481.0,769,165,216,381,1383.0,82,5.14,57,348,2300,9.2,0.511735
25919,25919,Steve Konowalchuk,2006-07,34.0,15,15,21,21,6,9,15,39.0,348.0,790,171,225,396,1422.0,82,6.05,85,480,2458,10.1,0.43781865
25920,25920,Steve Konroyd,1981-82,20.0,2,0,4,4,0,0,0,0.0,,4,0,0,0,0.0,80,7.69,77,340,2441,12.6,0.25207952
25921,25921,Steve Konroyd,1982-83,21.0,3,17,63,63,3,14,17,57.0,,67,3,14,17,57.0,80,8.03,73,320,2489,12.9,0.2950467
25922,25922,Steve Konroyd,1983-84,22.0,4,17,79,79,4,13,17,80.0,,146,7,27,34,137.0,80,7.73,71,310,2444,12.7,0.25054145
25923,25923,Steve Konroyd,1984-85,23.0,5,14,80,80,1,13,14,94.0,,226,8,40,48,231.0,80,7.89,74,336,2448,12.9,0.24013749
25924,25924,Steve Konroyd,1985-86,24.0,6,26,64,64,3,23,26,121.0,,290,11,63,74,352.0,80,7.77,71,321,2447,12.7,0.37253502
25925,25925,Steve Konroyd,1986-87,25.0,7,32,73,73,7,25,32,124.0,,363,18,88,106,476.0,80,7.94,82,370,2484,12.8,0.4252013
25926,25926,Steve Konroyd,1987-88,26.0,8,21,72,72,5,16,21,119.0,,435,23,104,127,595.0,80,7.34,72,344,2400,12.2,0.3298753
25927,25927,Steve Konroyd,1988-89,27.0,9,17,62,62,2,15,17,105.0,,497,25,119,144,700.0,80,7.43,89,437,2435,12.2,0.2746851
25928,25928,Steve Konroyd,1989-90,28.0,10,18,78,78,6,12,18,132.0,,575,31,131,162,832.0,80,7.48,85,403,2430,12.3,0.29826012
25929,25929,Steve Konroyd,1990-91,29.0,11,17,75,75,3,14,17,93.0,,650,34,145,179,925.0,80,7.37,76,367,2421,12.2,0.23762089
25930,25930,Steve Konroyd,1991-92,30.0,12,12,70,70,0,12,12,93.0,,720,34,157,191,1018.0,80,6.91,71,366,2385,11.6,0.18521696
25931,25931,Steve Konroyd,1992-93,31.0,13,28,82,82,4,24,28,126.0,,802,38,181,219,1144.0,80,6.96,77,402,2440,11.4,0.288767
25932,25932,Steve Konroyd,1993-94,32.0,14,15,65,65,3,12,15,66.0,,867,41,193,234,1210.0,84,7.25,87,443,2603,11.7,0.17011636
25933,25933,Steve Konroyd,1994-95,33.0,15,2,27,27,0,2,2,21.0,,894,41,195,236,1231.0,84,6.48,76,407,2545,10.7,0.10917652
25934,25934,Steve Konroyd,1995-96,34.0,16,0,1,1,0,0,0,0.0,,895,41,195,236,1231.0,48,5.97,37,209,1408,10.2,0.23356909
25935,25935,Steve Larmer,1981-82,20.0,2,1,4,4,0,1,1,3.0,,4,0,1,1,3.0,80,7.69,77,340,2441,12.6,0.3174805
25936,25936,Steve Larmer,1982-83,21.0,3,0,3,3,0,0,0,1.0,,7,0,1,1,4.0,80,8.03,73,320,2489,12.9,0.26217833
25937,25937,Steve Larmer,1983-84,22.0,4,90,80,80,43,47,90,195.0,,87,43,48,91,199.0,80,7.73,71,310,2444,12.7,1.138906
25938,25938,Steve Larmer,1984-85,23.0,5,75,80,80,35,40,75,202.0,,167,78,88,166,401.0,80,7.89,74,336,2448,12.9,0.90780354
25939,25939,Steve Larmer,1985-86,24.0,6,86,80,80,46,40,86,209.0,,247,124,128,252,610.0,80,7.77,71,321,2447,12.7,1.0687952
25940,25940,Steve Larmer,1986-87,25.0,7,76,80,80,31,45,76,184.0,,327,155,173,328,794.0,80,7.94,82,370,2484,12.8,0.8193351
25941,25941,Steve Larmer,1987-88,26.0,8,84,80,80,28,56,84,221.0,,407,183,229,412,1015.0,80,7.34,72,344,2400,12.2,1.0531268
25942,25942,Steve Larmer,1988-89,27.0,9,89,80,80,41,48,89,245.0,,487,224,277,501,1260.0,80,7.43,89,437,2435,12.2,1.0612442
25943,25943,Steve Larmer,1989-90,28.0,10,87,80,80,43,44,87,269.0,,567,267,321,588,1529.0,80,7.48,85,403,2430,12.3,1.0142986
25944,25944,Steve Larmer,1990-91,29.0,11,90,80,80,31,59,90,265.0,,647,298,380,678,1794.0,80,7.37,76,367,2421,12.2,1.0789449
25945,25945,Steve Larmer,1991-92,30.0,12,101,80,80,44,57,101,231.0,,727,342,437,779,2025.0,80,6.91,71,366,2385,11.6,1.1418805
25946,25946,Steve Larmer,1992-93,31.0,13,74,80,80,29,45,74,292.0,,807,371,482,853,2317.0,80,6.96,77,402,2440,11.4,0.94511676
25947,25947,Steve Larmer,1993-94,32.0,14,70,84,84,35,35,70,228.0,,891,406,517,923,2545.0,84,7.25,87,443,2603,11.7,0.8141028
25948,25948,Steve Larmer,1994-95,33.0,15,60,68,68,21,39,60,146.0,,959,427,556,983,2691.0,84,6.48,76,407,2545,10.7,0.71822774
25949,25949,Steve Larmer,1995-96,34.0,16,29,47,47,14,15,29,116.0,,1006,441,571,1012,2807.0,48,5.97,37,209,1408,10.2,0.61630225
25950,25950,Steve Larouche,1995-96,24.0,2,15,18,18,8,7,15,38.0,,18,8,7,15,38.0,48,5.97,37,209,1408,10.2,0.5360423
25951,25951,Steve Larouche,1996-97,25.0,3,3,8,8,1,2,3,14.0,,26,9,9,18,52.0,82,6.29,74,413,2481,10.4,0.21580371
25952,25952,Steve Ludzik,1982-83,21.0,2,3,8,8,2,1,3,9.0,,8,2,1,3,9.0,80,8.03,73,320,2489,12.9,0.38010943
25953,25953,Steve Ludzik,1983-84,22.0,3,25,66,66,6,19,25,55.0,,74,8,20,28,64.0,80,7.73,71,310,2444,12.7,0.35882413
25954,25954,Steve Ludzik,1984-85,23.0,4,29,80,80,9,20,29,101.0,,154,17,40,57,165.0,80,7.89,74,336,2448,12.9,0.39155537
25955,25955,Steve Ludzik,1985-86,24.0,5,31,79,79,11,20,31,99.0,,233,28,60,88,264.0,80,7.77,71,321,2447,12.7,0.40614927
25956,25956,Steve Ludzik,1986-87,25.0,6,11,49,49,6,5,11,41.0,,282,34,65,99,305.0,80,7.94,82,370,2484,12.8,0.2936949
25957,25957,Steve Ludzik,1987-88,26.0,7,17,52,52,5,12,17,56.0,,334,39,77,116,361.0,80,7.34,72,344,2400,12.2,0.31882274
25958,25958,Steve Ludzik,1988-89,27.0,8,21,73,73,6,15,21,55.0,,407,45,92,137,416.0,80,7.43,89,437,2435,12.2,0.2669174
25959,25959,Steve Ludzik,1989-90,28.0,9,1,6,6,1,0,1,7.0,,413,46,92,138,423.0,80,7.48,85,403,2430,12.3,0.18359658
25960,25960,Steve Ludzik,1990-91,29.0,10,1,11,11,0,1,1,15.0,,424,46,93,139,438.0,80,7.37,76,367,2421,12.2,0.19181561
25961,25961,Steve MacIntyre,2009-10,29.0,2,2,22,22,2,0,2,6.0,86.0,22,2,0,2,6.0,82,5.7,65,341,2477,9.4,0.16724342
25962,25962,Steve MacIntyre,2010-11,30.0,3,1,22,22,0,1,1,3.0,63.0,44,2,1,3,9.0,82,5.53,56,304,2486,9.1,0.07664454
25963,25963,Steve MacIntyre,2011-12,31.0,4,1,34,34,0,1,1,6.0,120.0,78,2,2,4,15.0,82,5.46,52,291,2492,9.0,0.06977931
25964,25964,Steve MacIntyre,2012-13,32.0,5,0,12,12,0,0,0,0.0,38.0,90,2,2,4,15.0,82,5.32,47,271,2439,8.9,0.09156275
25965,25965,Steve MacIntyre,2013-14,33.0,6,0,1,1,0,0,0,0.0,5.0,91,2,2,4,15.0,48,5.31,29,160,1399,9.1,0.117064
25966,25966,Steve Maltais,1990-91,22.0,2,0,8,8,0,0,0,11.0,,8,0,0,0,11.0,80,7.37,76,367,2421,12.2,0.22392944
25967,25967,Steve Maltais,1991-92,23.0,3,0,7,7,0,0,0,3.0,,15,0,0,0,14.0,80,6.91,71,366,2385,11.6,0.18362865
25968,25968,Steve Maltais,1992-93,24.0,4,3,12,12,2,1,3,6.0,,27,2,1,3,20.0,80,6.96,77,402,2440,11.4,0.27187234
25969,25969,Steve Maltais,1993-94,25.0,5,20,63,63,7,13,20,96.0,,90,9,14,23,116.0,84,7.25,87,443,2603,11.7,0.29822308
25970,25970,Steve Maltais,1994-95,26.0,6,1,4,4,0,1,1,2.0,,94,9,15,24,118.0,84,6.48,76,407,2545,10.7,0.18898156
25971,25971,Steve Maltais,2001-02,33.0,7,3,26,26,0,3,3,30.0,311.0,120,9,18,27,148.0,82,5.51,63,376,2272,9.9,0.15136701
25972,25972,Steve Martins,1996-97,24.0,2,4,23,23,1,3,4,27.0,,23,1,3,4,27.0,82,6.29,74,413,2481,10.4,0.2081663
25973,25973,Steve Martins,1997-98,25.0,3,1,2,2,0,1,1,2.0,,25,1,4,5,29.0,82,5.83,55,336,2444,9.8,0.16758114
25974,25974,Steve Martins,1998-99,26.0,4,0,3,3,0,0,0,0.0,,28,1,4,5,29.0,82,5.28,57,380,2242,9.6,0.15004686
25975,25975,Steve Martins,1999-00,27.0,5,7,36,36,4,3,7,27.0,305.0,64,5,7,12,56.0,82,5.27,57,359,2285,9.4,0.17787021
25976,25976,Steve Martins,2000-01,28.0,6,13,59,59,6,7,13,65.0,789.0,123,11,14,25,121.0,82,5.49,53,331,2294,9.8,0.19917166
25977,25977,Steve Martins,2001-02,29.0,7,6,59,59,2,4,6,46.0,569.0,182,13,18,31,167.0,82,5.51,63,376,2272,9.9,0.14413786
25978,25978,Steve Martins,2002-03,30.0,8,1,14,14,1,0,1,11.0,134.0,196,14,18,32,178.0,82,5.24,53,338,2262,9.5,0.17233446
25979,25979,Steve Martins,2003-04,31.0,9,11,42,42,5,6,11,38.0,518.0,238,19,24,43,216.0,82,5.31,60,363,2326,9.4,0.19095296
25980,25980,Steve Martins,2004-05,32.0,10,1,25,25,1,0,1,27.0,262.0,263,20,24,44,243.0,82,5.14,57,348,2300,9.2,0.18429136
25981,25981,Steve Martins,2006-07,34.0,11,2,4,4,1,1,2,6.0,31.0,267,21,25,46,249.0,82,6.05,85,480,2458,10.1,0.14419794
25982,25982,Steve Martinson,1988-89,29.0,2,2,10,10,1,1,2,3.0,,10,1,1,2,3.0,80,7.43,89,437,2435,12.2,0.20919234
25983,25983,Steve Martinson,1989-90,30.0,3,1,25,25,1,0,1,8.0,,35,2,1,3,11.0,80,7.48,85,403,2430,12.3,0.15143627
25984,25984,Steve Martinson,1990-91,31.0,4,0,13,13,0,0,0,2.0,,48,2,1,3,13.0,80,7.37,76,367,2421,12.2,0.13675973
25985,25985,Steve Martinson,1992-93,33.0,5,0,1,1,0,0,0,0.0,,49,2,1,3,13.0,80,6.96,77,402,2440,11.4,0.14232263
25986,25986,Steve McCarthy,2000-01,19.0,2,2,5,5,1,1,2,4.0,76.0,5,1,1,2,4.0,82,5.49,53,331,2294,9.8,0.25478497
25987,25987,Steve McCarthy,2001-02,20.0,3,5,44,44,0,5,5,32.0,650.0,49,1,6,7,36.0,82,5.51,63,376,2272,9.9,0.17799366
25988,25988,Steve McCarthy,2002-03,21.0,4,0,3,3,0,0,0,2.0,35.0,52,1,6,7,38.0,82,5.24,53,338,2262,9.5,0.18749082
25989,25989,Steve McCarthy,2003-04,22.0,5,5,57,57,1,4,5,55.0,935.0,109,2,10,12,93.0,82,5.31,60,363,2326,9.4,0.1806629
25990,25990,Steve McCarthy,2004-05,23.0,6,4,25,25,1,3,4,29.0,484.0,134,3,13,16,122.0,82,5.14,57,348,2300,9.2,0.23523173
25991,25991,Steve McCarthy,2006-07,25.0,7,16,67,67,9,7,16,66.0,945.0,201,12,20,32,188.0,82,6.05,85,480,2458,10.1,0.21017599
25992,25992,Steve McCarthy,2007-08,26.0,8,16,46,46,4,12,16,51.0,703.0,247,16,32,48,239.0,82,5.76,70,398,2426,9.7,0.24671909
25993,25993,Steve McCarthy,2008-09,27.0,9,7,55,55,1,6,7,41.0,869.0,302,17,38,55,280.0,82,5.44,62,351,2383,9.4,0.14752811
25994,25994,Steve McKenna,1997-98,24.0,2,0,9,9,0,0,0,6.0,,9,0,0,0,6.0,82,5.83,55,336,2444,9.8,0.16744861
25995,25995,Steve McKenna,1998-99,25.0,3,8,62,62,4,4,8,42.0,,71,4,4,8,48.0,82,5.28,57,380,2242,9.6,0.1553255
25996,25996,Steve McKenna,1999-00,26.0,4,1,20,20,1,0,1,12.0,168.0,91,5,4,9,60.0,82,5.27,57,359,2285,9.4,0.12973025
25997,25997,Steve McKenna,2000-01,27.0,5,5,46,46,0,5,5,14.0,225.0,137,5,9,14,74.0,82,5.49,53,331,2294,9.8,0.082442045
25998,25998,Steve McKenna,2001-02,28.0,6,2,54,54,1,1,2,19.0,271.0,191,6,10,16,93.0,82,5.51,63,376,2272,9.9,0.089499444
25999,25999,Steve McKenna,2002-03,29.0,7,3,54,54,2,1,3,17.0,215.0,245,8,11,19,110.0,82,5.24,53,338,2262,9.5,0.09062654
26000,26000,Steve McKenna,2003-04,30.0,8,10,79,79,9,1,10,59.0,613.0,324,17,12,29,169.0,82,5.31,60,363,2326,9.4,0.14836136
26001,26001,Steve McKenna,2004-05,31.0,9,3,49,49,1,2,3,30.0,310.0,373,18,14,32,199.0,82,5.14,57,348,2300,9.2,0.120242864
26002,26002,Steve McLaren,2004-05,29.0,2,0,6,6,0,0,0,2.0,17.0,6,0,0,0,2.0,82,5.14,57,348,2300,9.2,0.17518476
26003,26003,Steve Montador,2002-03,23.0,2,3,11,11,1,2,3,10.0,134.0,11,1,2,3,10.0,82,5.24,53,338,2262,9.5,0.23492417
26004,26004,Steve Montador,2003-04,24.0,3,2,50,50,1,1,2,64.0,759.0,61,2,3,5,74.0,82,5.31,60,363,2326,9.4,0.16040158
26005,26005,Steve Montador,2004-05,25.0,4,3,26,26,1,2,3,31.0,306.0,87,3,5,8,105.0,82,5.14,57,348,2300,9.2,0.1998254
26006,26006,Steve Montador,2006-07,27.0,5,7,58,58,2,5,7,55.0,801.0,145,5,10,15,160.0,82,6.05,85,480,2458,10.1,0.14176214
26007,26007,Steve Montador,2007-08,28.0,6,9,72,72,1,8,9,88.0,946.0,217,6,18,24,248.0,82,5.76,70,398,2426,9.7,0.15209156
26008,26008,Steve Montador,2008-09,29.0,7,23,73,73,8,15,23,96.0,850.0,290,14,33,47,344.0,82,5.44,62,351,2383,9.4,0.25693893
26009,26009,Steve Montador,2009-10,30.0,8,21,78,78,4,17,21,117.0,1260.0,368,18,50,68,461.0,82,5.7,65,341,2477,9.4,0.23435035
26010,26010,Steve Montador,2010-11,31.0,9,23,78,78,5,18,23,134.0,1333.0,446,23,68,91,595.0,82,5.53,56,304,2486,9.1,0.26218933
26011,26011,Steve Montador,2011-12,32.0,10,26,73,73,5,21,26,118.0,1440.0,519,28,89,117,713.0,82,5.46,52,291,2492,9.0,0.27290457
26012,26012,Steve Montador,2012-13,33.0,11,14,52,52,5,9,14,57.0,768.0,571,33,98,131,770.0,82,5.32,47,271,2439,8.9,0.18150169
26013,26013,Steve Moore,2002-03,24.0,2,0,8,8,0,0,0,5.0,57.0,8,0,0,0,5.0,82,5.24,53,338,2262,9.5,0.16952816
26014,26014,Steve Moore,2003-04,25.0,3,0,4,4,0,0,0,0.0,36.0,12,0,0,0,5.0,82,5.31,60,363,2326,9.4,0.14731231
26015,26015,Steve Moore,2004-05,26.0,4,12,57,57,5,7,12,52.0,747.0,69,5,7,12,57.0,82,5.14,57,348,2300,9.2,0.20965192
26016,26016,Steve Nemeth,1988-89,21.0,2,2,12,12,2,0,2,12.0,,12,2,0,2,12.0,80,7.43,89,437,2435,12.2,0.3242542
26017,26017,Steve Ott,2003-04,21.0,2,7,26,26,3,4,7,25.0,228.0,26,3,4,7,25.0,82,5.31,60,363,2326,9.4,0.31582388
26018,26018,Steve Ott,2004-05,22.0,3,12,73,73,2,10,12,74.0,747.0,99,5,14,19,99.0,82,5.14,57,348,2300,9.2,0.30152568
26019,26019,Steve Ott,2006-07,24.0,4,22,82,82,5,17,22,89.0,976.0,181,10,31,41,188.0,82,6.05,85,480,2458,10.1,0.24939525
26020,26020,Steve Ott,2007-08,25.0,5,4,19,19,0,4,4,17.0,175.0,200,10,35,45,205.0,82,5.76,70,398,2426,9.7,0.16831687
26021,26021,Steve Ott,2008-09,26.0,6,22,73,73,11,11,22,89.0,1056.0,273,21,46,67,294.0,82,5.44,62,351,2383,9.4,0.29817924
26022,26022,Steve Ott,2009-10,27.0,7,46,64,64,19,27,46,132.0,1125.0,337,40,73,113,426.0,82,5.7,65,341,2477,9.4,0.57738554
26023,26023,Steve Ott,2010-11,28.0,8,36,73,73,22,14,36,146.0,1202.0,410,62,87,149,572.0,82,5.53,56,304,2486,9.1,0.44449612
26024,26024,Steve Ott,2011-12,29.0,9,32,82,82,12,20,32,120.0,1407.0,492,74,107,181,692.0,82,5.46,52,291,2492,9.0,0.39161164
26025,26025,Steve Ott,2012-13,30.0,10,39,74,74,11,28,39,108.0,1357.0,566,85,135,220,800.0,82,5.32,47,271,2439,8.9,0.41213304
26026,26026,Steve Ott,2013-14,31.0,11,24,48,48,9,15,24,73.0,891.0,614,94,150,244,873.0,48,5.31,29,160,1399,9.1,0.415649
26027,26027,Steve Ott,2014-15,32.0,12,23,82,82,9,14,23,127.0,1495.0,696,103,164,267,1000.0,82,5.34,48,269,2463,8.9,0.2569993
26028,26028,Steve Ott,2015-16,33.0,13,12,78,78,3,9,12,49.0,907.0,774,106,173,279,1049.0,82,5.32,47,251,2453,8.9,0.15301386
26029,26029,Steve Ott,2016-17,34.0,14,2,21,21,0,2,2,21.0,229.0,795,106,175,281,1070.0,82,5.34,48,255,2438,9.0,0.14723188
26030,26030,Steve Ott,2017-18,35.0,15,7,53,53,3,4,7,45.0,570.0,848,109,179,288,1115.0,82,5.45,47,245,2478,9.0,0.13931435
26031,26031,Steve Patrick,1981-82,20.0,2,8,30,30,1,7,8,35.0,,30,1,7,8,35.0,80,7.69,77,340,2441,12.6,0.3228631
26032,26032,Steve Patrick,1982-83,21.0,3,16,41,41,8,8,16,52.0,,71,9,15,24,87.0,80,8.03,73,320,2489,12.9,0.4153666
26033,26033,Steve Patrick,1983-84,22.0,4,22,56,56,9,13,22,63.0,,127,18,28,46,150.0,80,7.73,71,310,2444,12.7,0.41266128
26034,26034,Steve Patrick,1984-85,23.0,5,5,11,11,1,4,5,11.0,,138,19,32,51,161.0,80,7.89,74,336,2448,12.9,0.36819047
26035,26035,Steve Patrick,1985-86,24.0,6,33,57,57,13,20,33,74.0,,195,32,52,84,235.0,80,7.77,71,321,2447,12.7,0.4662097
26036,26036,Steve Patrick,1986-87,25.0,7,24,55,55,8,16,24,49.0,,250,40,68,108,284.0,80,7.94,82,370,2484,12.8,0.37703466
26037,26037,Steve Peters,1980-81,21.0,2,1,2,2,0,1,1,0.0,,2,0,1,1,0.0,80,7.03,61,280,2352,12.0,0.26082617
26038,26038,Steve Pinizzotto,2013-14,29.0,2,0,12,12,0,0,0,9.0,120.0,12,0,0,0,9.0,48,5.31,29,160,1399,9.1,0.18914142
26039,26039,Steve Pinizzotto,2014-15,30.0,3,2,6,6,0,2,2,2.0,58.0,18,0,2,2,11.0,82,5.34,48,269,2463,8.9,0.1426737
26040,26040,Steve Pinizzotto,2015-16,31.0,4,4,18,18,2,2,4,15.0,143.0,36,2,4,6,26.0,82,5.32,47,251,2453,8.9,0.18070257
26041,26041,Steve Poapst,1996-97,28.0,2,1,3,3,1,0,1,2.0,,3,1,0,1,2.0,82,6.29,74,413,2481,10.4,0.18241286
26042,26042,Steve Poapst,1999-00,31.0,3,0,22,22,0,0,0,11.0,274.0,25,1,0,1,13.0,82,5.27,57,359,2285,9.4,0.104952216
26043,26043,Steve Poapst,2001-02,33.0,4,5,36,36,2,3,5,27.0,614.0,61,3,3,6,40.0,82,5.51,63,376,2272,9.9,0.13591516
26044,26044,Steve Poapst,2002-03,34.0,5,8,56,56,1,7,8,48.0,833.0,117,4,10,14,88.0,82,5.24,53,338,2262,9.5,0.1342167
26045,26045,Steve Poapst,2003-04,35.0,6,13,75,75,2,11,13,49.0,1714.0,192,6,21,27,137.0,82,5.31,60,363,2326,9.4,0.14973924
26046,26046,Steve Poapst,2004-05,36.0,7,4,53,53,2,2,4,55.0,1179.0,245,8,23,31,192.0,82,5.14,57,348,2300,9.2,0.15573537
26047,26047,Steve Poapst,2006-07,38.0,8,5,62,62,0,5,5,23.0,1011.0,307,8,28,36,215.0,82,6.05,85,480,2458,10.1,0.07813364
26048,26048,Steve Regier,2006-07,22.0,2,0,9,9,0,0,0,4.0,54.0,9,0,0,0,4.0,82,6.05,85,480,2458,10.1,0.17765906
26049,26049,Steve Regier,2007-08,23.0,3,0,1,1,0,0,0,0.0,5.0,10,0,0,0,4.0,82,5.76,70,398,2426,9.7,0.16792908
26050,26050,Steve Regier,2008-09,24.0,4,0,8,8,0,0,0,7.0,64.0,18,0,0,0,11.0,82,5.44,62,351,2383,9.4,0.15161055
26051,26051,Steve Regier,2009-10,25.0,5,4,8,8,3,1,4,11.0,88.0,26,3,1,4,22.0,82,5.7,65,341,2477,9.4,0.22590357
26052,26052,Steve Reinprecht,2000-01,24.0,2,0,1,1,0,0,0,0.0,6.0,1,0,0,0,0.0,82,5.49,53,331,2294,9.8,0.15586606
26053,26053,Steve Reinprecht,2001-02,25.0,3,36,80,80,15,21,36,100.0,1075.0,81,15,21,36,100.0,82,5.51,63,376,2272,9.9,0.42745015
26054,26054,Steve Reinprecht,2002-03,26.0,4,46,67,67,19,27,46,111.0,1107.0,148,34,48,82,211.0,82,5.24,53,338,2262,9.5,0.58112174
26055,26055,Steve Reinprecht,2003-04,27.0,5,51,77,77,18,33,51,146.0,1337.0,225,52,81,133,357.0,82,5.31,60,363,2326,9.4,0.5839396
26056,26056,Steve Reinprecht,2004-05,28.0,6,29,44,44,7,22,29,68.0,752.0,269,59,103,162,425.0,82,5.14,57,348,2300,9.2,0.6096992
26057,26057,Steve Reinprecht,2006-07,30.0,7,52,80,80,22,30,52,130.0,1305.0,349,81,133,214,555.0,82,6.05,85,480,2458,10.1,0.54671776
26058,26058,Steve Reinprecht,2007-08,31.0,8,33,49,49,9,24,33,71.0,768.0,398,90,157,247,626.0,82,5.76,70,398,2426,9.7,0.5101365
26059,26059,Steve Reinprecht,2008-09,32.0,9,46,81,81,16,30,46,105.0,1272.0,479,106,187,293,731.0,82,5.44,62,351,2383,9.4,0.51071334
26060,26060,Steve Reinprecht,2009-10,33.0,10,41,73,73,14,27,41,95.0,1161.0,552,120,214,334,826.0,82,5.7,65,341,2477,9.4,0.46730292
26061,26061,Steve Reinprecht,2010-11,34.0,11,38,82,82,16,22,38,124.0,1319.0,634,136,236,372,950.0,82,5.53,56,304,2486,9.1,0.40983716
26062,26062,Steve Reinprecht,2011-12,35.0,12,10,29,29,4,6,10,31.0,341.0,663,140,242,382,981.0,82,5.46,52,291,2492,9.0,0.26266456
26063,26063,Steve Richmond,1984-85,25.0,2,7,26,26,2,5,7,15.0,,26,2,5,7,15.0,80,7.89,74,336,2448,12.9,0.25722808
26064,26064,Steve Richmond,1985-86,26.0,3,5,34,34,0,5,5,15.0,,60,2,10,12,30.0,80,7.77,71,321,2447,12.7,0.15812922
26065,26065,Steve Richmond,1986-87,27.0,4,5,46,46,1,4,5,26.0,,106,3,14,17,56.0,80,7.94,82,370,2484,12.8,0.12722296
26066,26066,Steve Richmond,1987-88,28.0,5,8,44,44,1,7,8,31.0,,150,4,21,25,87.0,80,7.34,72,344,2400,12.2,0.16099703
26067,26067,Steve Richmond,1989-90,30.0,6,2,9,9,0,2,2,1.0,,159,4,23,27,88.0,80,7.48,85,403,2430,12.3,0.1563803
26068,26068,Steve Rooney,1985-86,23.0,2,1,3,3,1,0,1,3.0,,3,1,0,1,3.0,80,7.77,71,321,2447,12.7,0.27677673
26069,26069,Steve Rooney,1986-87,24.0,3,5,38,38,2,3,5,24.0,,41,3,3,6,27.0,80,7.94,82,370,2484,12.8,0.1702829
26070,26070,Steve Rooney,1987-88,25.0,4,5,32,32,2,3,5,25.0,,73,5,6,11,52.0,80,7.34,72,344,2400,12.2,0.23457184
26071,26071,Steve Rooney,1988-89,26.0,5,13,56,56,7,6,13,62.0,,129,12,12,24,114.0,80,7.43,89,437,2435,12.2,0.2702958
26072,26072,Steve Rooney,1989-90,27.0,6,4,25,25,3,1,4,23.0,,154,15,13,28,137.0,80,7.48,85,403,2430,12.3,0.23574325
26073,26073,Steve Rucchin,1995-96,24.0,2,17,43,43,6,11,17,59.0,,43,6,11,17,59.0,48,5.97,37,209,1408,10.2,0.37611082
26074,26074,Steve Rucchin,1996-97,25.0,3,44,64,64,19,25,44,113.0,,107,25,36,61,172.0,82,6.29,74,413,2481,10.4,0.5604078
26075,26075,Steve Rucchin,1997-98,26.0,4,67,79,79,19,48,67,153.0,,186,44,84,128,325.0,82,5.83,55,336,2444,9.8,0.77719307
26076,26076,Steve Rucchin,1998-99,27.0,5,53,72,72,17,36,53,131.0,,258,61,120,181,456.0,82,5.28,57,380,2242,9.6,0.71816486
26077,26077,Steve Rucchin,1999-00,28.0,6,62,69,69,23,39,62,145.0,1556.0,327,84,159,243,601.0,82,5.27,57,359,2285,9.4,0.806906
26078,26078,Steve Rucchin,2000-01,29.0,7,57,71,71,19,38,57,131.0,1576.0,398,103,197,300,732.0,82,5.49,53,331,2294,9.8,0.729274
26079,26079,Steve Rucchin,2001-02,30.0,8,8,16,16,3,5,8,19.0,301.0,414,106,202,308,751.0,82,5.51,63,376,2272,9.9,0.37449676
26080,26080,Steve Rucchin,2002-03,31.0,9,23,38,38,7,16,23,57.0,733.0,452,113,218,331,808.0,82,5.24,53,338,2262,9.5,0.4661258
26081,26081,Steve Rucchin,2003-04,32.0,10,58,82,82,20,38,58,194.0,1729.0,534,133,256,389,1002.0,82,5.31,60,363,2326,9.4,0.7027273
26082,26082,Steve Rucchin,2004-05,33.0,11,43,82,82,20,23,43,148.0,1621.0,616,153,279,432,1150.0,82,5.14,57,348,2300,9.2,0.530326
26083,26083,Steve Rucchin,2006-07,35.0,12,36,72,72,13,23,36,111.0,1151.0,688,166,302,468,1261.0,82,6.05,85,480,2458,10.1,0.41749614
26084,26084,Steve Rucchin,2007-08,36.0,13,21,47,47,5,16,21,56.0,862.0,735,171,318,489,1317.0,82,5.76,70,398,2426,9.7,0.3574994
26085,26085,Steve Seftel,1991-92,23.0,2,0,4,4,0,0,0,2.0,,4,0,0,0,2.0,80,6.91,71,366,2385,11.6,0.20226651
26086,26086,Steve Seguin,1985-86,21.0,2,0,5,5,0,0,0,5.0,,5,0,0,0,5.0,80,7.77,71,321,2447,12.7,0.24960724
26087,26087,Steve Smith,1982-83,19.0,2,1,8,8,0,1,1,9.0,,8,0,1,1,9.0,80,8.03,73,320,2489,12.9,0.3035711
26088,26088,Steve Smith,1985-86,22.0,3,0,2,2,0,0,0,0.0,,10,0,1,1,9.0,80,7.77,71,321,2447,12.7,0.20848933
26089,26089,Steve Smith,1986-87,23.0,4,0,2,2,0,0,0,1.0,,12,0,1,1,10.0,80,7.94,82,370,2484,12.8,0.19522405
26090,26090,Steve Smith,1987-88,24.0,5,0,2,2,0,0,0,2.0,,14,0,1,1,12.0,80,7.34,72,344,2400,12.2,0.18316963
26091,26091,Steve Smith,1989-90,26.0,6,0,3,3,0,0,0,2.0,,17,0,1,1,14.0,80,7.48,85,403,2430,12.3,0.18922684
26092,26092,Steve Smith0,1985-86,22.0,2,0,2,2,0,0,0,3.0,,2,0,0,0,3.0,80,7.77,71,321,2447,12.7,0.23961547
26093,26093,Steve Smith0,1986-87,23.0,3,24,55,55,4,20,24,74.0,,57,4,20,24,77.0,80,7.94,82,370,2484,12.8,0.39507976
26094,26094,Steve Smith0,1987-88,24.0,4,22,62,62,7,15,22,73.0,,119,11,35,46,150.0,80,7.34,72,344,2400,12.2,0.35865715
26095,26095,Steve Smith0,1988-89,25.0,5,55,79,79,12,43,55,116.0,,198,23,78,101,266.0,80,7.43,89,437,2435,12.2,0.6097796
26096,26096,Steve Smith0,1989-90,26.0,6,22,35,35,3,19,22,47.0,,233,26,97,123,313.0,80,7.48,85,403,2430,12.3,0.46466655
26097,26097,Steve Smith0,1990-91,27.0,7,41,75,75,7,34,41,125.0,,308,33,131,164,438.0,80,7.37,76,367,2421,12.2,0.52623177
26098,26098,Steve Smith0,1991-92,28.0,8,54,77,77,13,41,54,114.0,,385,46,172,218,552.0,80,6.91,71,366,2385,11.6,0.59939134
26099,26099,Steve Smith0,1992-93,29.0,9,30,76,76,9,21,30,153.0,,461,55,193,248,705.0,80,6.96,77,402,2440,11.4,0.4380406
26100,26100,Steve Smith0,1993-94,30.0,10,57,78,78,10,47,57,212.0,,539,65,240,305,917.0,84,7.25,87,443,2603,11.7,0.62226236
26101,26101,Steve Smith0,1994-95,31.0,11,27,57,57,5,22,27,89.0,,596,70,262,332,1006.0,84,6.48,76,407,2545,10.7,0.35609165
26102,26102,Steve Smith0,1995-96,32.0,12,13,48,48,1,12,13,43.0,,644,71,274,345,1049.0,48,5.97,37,209,1408,10.2,0.27009064
26103,26103,Steve Smith0,1996-97,33.0,13,9,37,37,0,9,9,17.0,,681,71,283,354,1066.0,82,6.29,74,413,2481,10.4,0.16970408
26104,26104,Steve Smith0,1997-98,34.0,14,0,21,21,0,0,0,7.0,,702,71,283,354,1073.0,82,5.83,55,336,2444,9.8,0.15119484
26105,26105,Steve Smith0,1999-00,36.0,15,15,69,69,1,14,15,42.0,1556.0,771,72,297,369,1115.0,82,5.27,57,359,2285,9.4,0.17868227
26106,26106,Steve Smith0,2000-01,37.0,16,4,20,20,0,4,4,10.0,422.0,791,72,301,373,1125.0,82,5.49,53,331,2294,9.8,0.14902836
26107,26107,Steve Smith0,2001-02,38.0,17,2,13,13,0,2,2,3.0,247.0,804,72,303,375,1128.0,82,5.51,63,376,2272,9.9,0.16545159
26108,26108,Steve Staios,1996-97,23.0,2,0,12,12,0,0,0,4.0,,12,0,0,0,4.0,82,6.29,74,413,2481,10.4,0.16688982
26109,26109,Steve Staios,1997-98,24.0,3,17,63,63,3,14,17,66.0,,75,3,14,17,70.0,82,5.83,55,336,2444,9.8,0.21720782
26110,26110,Steve Staios,1998-99,25.0,4,7,77,77,3,4,7,45.0,,152,6,18,24,115.0,82,5.28,57,380,2242,9.6,0.15032262
26111,26111,Steve Staios,1999-00,26.0,5,2,57,57,0,2,2,33.0,392.0,209,6,20,26,148.0,82,5.27,57,359,2285,9.4,0.13604894
26112,26112,Steve Staios,2000-01,27.0,6,5,27,27,2,3,5,38.0,351.0,236,8,23,31,186.0,82,5.49,53,331,2294,9.8,0.17758703
26113,26113,Steve Staios,2001-02,28.0,7,22,70,70,9,13,22,156.0,1522.0,306,17,36,53,342.0,82,5.51,63,376,2272,9.9,0.28944635
26114,26114,Steve Staios,2002-03,29.0,8,10,73,73,5,5,10,101.0,1320.0,379,22,41,63,443.0,82,5.24,53,338,2262,9.5,0.20770377
26115,26115,Steve Staios,2003-04,30.0,9,26,76,76,5,21,26,126.0,1694.0,455,27,62,89,569.0,82,5.31,60,363,2326,9.4,0.2752922
26116,26116,Steve Staios,2004-05,31.0,10,28,82,82,6,22,28,153.0,1890.0,537,33,84,117,722.0,82,5.14,57,348,2300,9.2,0.3542053
26117,26117,Steve Staios,2006-07,33.0,11,28,82,82,8,20,28,140.0,1712.0,619,41,104,145,862.0,82,6.05,85,480,2458,10.1,0.31437963
26118,26118,Steve Staios,2007-08,34.0,12,17,58,58,2,15,17,71.0,1240.0,677,43,119,162,933.0,82,5.76,70,398,2426,9.7,0.20783553
26119,26119,Steve Staios,2008-09,35.0,13,16,82,82,7,9,16,73.0,1806.0,759,50,128,178,1006.0,82,5.44,62,351,2383,9.4,0.18719822
26120,26120,Steve Staios,2009-10,36.0,14,14,80,80,2,12,14,78.0,1584.0,839,52,140,192,1084.0,82,5.7,65,341,2477,9.4,0.15515351
26121,26121,Steve Staios,2010-11,37.0,15,10,58,58,1,9,10,61.0,1085.0,897,53,149,202,1145.0,82,5.53,56,304,2486,9.1,0.13918915
26122,26122,Steve Staios,2011-12,38.0,16,10,39,39,3,7,10,23.0,574.0,936,56,156,212,1168.0,82,5.46,52,291,2492,9.0,0.15714553
26123,26123,Steve Staios,2012-13,39.0,17,8,65,65,0,8,8,67.0,1110.0,1001,56,164,220,1235.0,82,5.32,47,271,2439,8.9,0.12852713
26124,26124,Steve Stoyanovich,1984-85,27.0,2,8,23,23,3,5,8,60.0,,23,3,5,8,60.0,80,7.89,74,336,2448,12.9,0.3595294
26125,26125,Steve Sullivan,1996-97,22.0,2,9,16,16,5,4,9,23.0,,16,5,4,9,23.0,82,6.29,74,413,2481,10.4,0.35598928
26126,26126,Steve Sullivan,1997-98,23.0,3,38,54,54,13,25,38,108.0,,70,18,29,47,131.0,82,5.83,55,336,2444,9.8,0.5861363
26127,26127,Steve Sullivan,1998-99,24.0,4,28,63,63,10,18,28,112.0,,133,28,47,75,243.0,82,5.28,57,380,2242,9.6,0.47456864
26128,26128,Steve Sullivan,1999-00,25.0,5,40,63,63,20,20,40,110.0,895.0,196,48,67,115,353.0,82,5.27,57,359,2285,9.4,0.6249235
26129,26129,Steve Sullivan,2000-01,26.0,6,65,80,80,22,43,65,180.0,1403.0,276,70,110,180,533.0,82,5.49,53,331,2294,9.8,0.8183508
26130,26130,Steve Sullivan,2001-02,27.0,7,75,81,81,34,41,75,204.0,1664.0,357,104,151,255,737.0,82,5.51,63,376,2272,9.9,0.79581356
26131,26131,Steve Sullivan,2002-03,28.0,8,60,78,78,21,39,60,155.0,1495.0,435,125,190,315,892.0,82,5.24,53,338,2262,9.5,0.6991217
26132,26132,Steve Sullivan,2003-04,29.0,9,61,82,82,26,35,61,190.0,1579.0,517,151,225,376,1082.0,82,5.31,60,363,2326,9.4,0.75147694
26133,26133,Steve Sullivan,2004-05,30.0,10,73,80,80,24,49,73,218.0,1674.0,597,175,274,449,1300.0,82,5.14,57,348,2300,9.2,0.90398985
26134,26134,Steve Sullivan,2006-07,32.0,11,68,69,69,31,37,68,192.0,1317.0,666,206,311,517,1492.0,82,6.05,85,480,2458,10.1,0.82890975
26135,26135,Steve Sullivan,2007-08,33.0,12,60,57,57,22,38,60,122.0,1107.0,723,228,349,577,1614.0,82,5.76,70,398,2426,9.7,0.8047899
26136,26136,Steve Sullivan,2009-10,35.0,13,32,41,41,11,21,32,83.0,758.0,764,239,370,609,1697.0,82,5.7,65,341,2477,9.4,0.64092046
26137,26137,Steve Sullivan,2010-11,36.0,14,51,82,82,17,34,51,152.0,1470.0,846,256,404,660,1849.0,82,5.53,56,304,2486,9.1,0.5726603
26138,26138,Steve Sullivan,2011-12,37.0,15,22,44,44,10,12,22,79.0,705.0,890,266,416,682,1928.0,82,5.46,52,291,2492,9.0,0.45258117
26139,26139,Steve Sullivan,2012-13,38.0,16,48,79,79,17,31,48,140.0,1213.0,969,283,447,730,2068.0,82,5.32,47,271,2439,8.9,0.5303863
26140,26140,Steve Sullivan,2013-14,39.0,17,17,42,42,7,10,17,61.0,611.0,1011,290,457,747,2129.0,48,5.31,29,160,1399,9.1,0.39154524
26141,26141,Steve Thomas,1985-86,22.0,2,2,18,18,1,1,2,26.0,,18,1,1,2,26.0,80,7.77,71,321,2447,12.7,0.31625727
26142,26142,Steve Thomas,1986-87,23.0,3,57,65,65,20,37,57,197.0,,83,21,38,59,223.0,80,7.94,82,370,2484,12.8,0.75189984
26143,26143,Steve Thomas,1987-88,24.0,4,62,78,78,35,27,62,245.0,,161,56,65,121,468.0,80,7.34,72,344,2400,12.2,0.831139
26144,26144,Steve Thomas,1988-89,25.0,5,26,30,30,13,13,26,69.0,,191,69,78,147,537.0,80,7.43,89,437,2435,12.2,0.7977239
26145,26145,Steve Thomas,1989-90,26.0,6,40,45,45,21,19,40,124.0,,236,90,97,187,661.0,80,7.48,85,403,2430,12.3,0.78675455
26146,26146,Steve Thomas,1990-91,27.0,7,70,76,76,40,30,70,235.0,,312,130,127,257,896.0,80,7.37,76,367,2421,12.2,0.8008665
26147,26147,Steve Thomas,1991-92,28.0,8,54,69,69,19,35,54,192.0,,381,149,162,311,1088.0,80,6.91,71,366,2385,11.6,0.7326342
26148,26148,Steve Thomas,1992-93,29.0,9,78,82,82,30,48,78,245.0,,463,179,210,389,1333.0,80,6.96,77,402,2440,11.4,0.93705386
26149,26149,Steve Thomas,1993-94,30.0,10,87,79,79,37,50,87,264.0,,542,216,260,476,1597.0,84,7.25,87,443,2603,11.7,0.95304954
26150,26150,Steve Thomas,1994-95,31.0,11,75,78,78,42,33,75,249.0,,620,258,293,551,1846.0,84,6.48,76,407,2545,10.7,0.67673045
26151,26151,Steve Thomas,1995-96,32.0,12,26,47,47,11,15,26,133.0,,667,269,308,577,1979.0,48,5.97,37,209,1408,10.2,0.62012696
26152,26152,Steve Thomas,1996-97,33.0,13,61,81,81,26,35,61,192.0,,748,295,343,638,2171.0,82,6.29,74,413,2481,10.4,0.6586549
26153,26153,Steve Thomas,1997-98,34.0,14,34,57,57,15,19,34,124.0,,805,310,362,672,2295.0,82,5.83,55,336,2444,9.8,0.48836595
26154,26154,Steve Thomas,1998-99,35.0,15,24,55,55,14,10,24,111.0,,860,324,372,696,2406.0,82,5.28,57,380,2242,9.6,0.46383578
26155,26155,Steve Thomas,1999-00,36.0,16,73,78,78,28,45,73,209.0,1434.0,938,352,417,769,2615.0,82,5.27,57,359,2285,9.4,0.79346853
26156,26156,Steve Thomas,2000-01,37.0,17,63,81,81,26,37,63,151.0,1321.0,1019,378,454,832,2766.0,82,5.49,53,331,2294,9.8,0.6425115
26157,26157,Steve Thomas,2001-02,38.0,18,34,57,57,8,26,34,140.0,914.0,1076,386,480,866,2906.0,82,5.51,63,376,2272,9.9,0.5163356
26158,26158,Steve Thomas,2002-03,39.0,19,15,34,34,11,4,15,66.0,590.0,1110,397,484,881,2972.0,82,5.24,53,338,2262,9.5,0.40358287
26159,26159,Steve Thomas,2003-04,40.0,20,30,81,81,14,16,30,118.0,1044.0,1191,411,500,911,3090.0,82,5.31,60,363,2326,9.4,0.37044898
26160,26160,Steve Thomas,2004-05,41.0,21,22,44,44,10,12,22,80.0,561.0,1235,421,512,933,3170.0,82,5.14,57,348,2300,9.2,0.48224497
26161,26161,Steve Tuttle,1989-90,24.0,2,25,53,53,13,12,25,82.0,,53,13,12,25,82.0,80,7.48,85,403,2430,12.3,0.4724487
26162,26162,Steve Tuttle,1990-91,25.0,3,22,71,71,12,10,22,92.0,,124,25,22,47,174.0,80,7.37,76,367,2421,12.2,0.3354532
26163,26163,Steve Tuttle,1991-92,26.0,4,9,20,20,3,6,9,16.0,,144,28,28,56,190.0,80,6.91,71,366,2385,11.6,0.31827033
26164,26164,Steve Wagner,2008-09,24.0,2,8,24,24,2,6,8,25.0,443.0,24,2,6,8,25.0,82,5.44,62,351,2383,9.4,0.23652196
26165,26165,Steve Wagner,2009-10,25.0,3,4,22,22,2,2,4,16.0,344.0,46,4,8,12,41.0,82,5.7,65,341,2477,9.4,0.18484321
26166,26166,Steve Washburn,1996-97,21.0,2,1,1,1,0,1,1,1.0,,1,0,1,1,1.0,82,6.29,74,413,2481,10.4,0.2295582
26167,26167,Steve Washburn,1997-98,22.0,3,9,18,18,3,6,9,21.0,,19,3,7,10,22.0,82,5.83,55,336,2444,9.8,0.28501552
26168,26168,Steve Washburn,1998-99,23.0,4,19,58,58,11,8,19,61.0,,77,14,15,29,83.0,82,5.28,57,380,2242,9.6,0.30822185
26169,26169,Steve Washburn,1999-00,24.0,5,0,12,12,0,0,0,6.0,90.0,89,14,15,29,89.0,82,5.27,57,359,2285,9.4,0.18601021
26170,26170,Steve Washburn,2000-01,25.0,6,0,1,1,0,0,0,1.0,14.0,90,14,15,29,90.0,82,5.49,53,331,2294,9.8,0.16747618
26171,26171,Steve Washburn,2001-02,26.0,7,0,3,3,0,0,0,0.0,21.0,93,14,15,29,90.0,82,5.51,63,376,2272,9.9,0.16756082
26172,26172,Steve Webb,1997-98,22.0,2,5,41,41,1,4,5,21.0,,41,1,4,5,21.0,82,5.83,55,336,2444,9.8,0.13304532
26173,26173,Steve Webb,1998-99,23.0,3,0,20,20,0,0,0,6.0,,61,1,4,5,27.0,82,5.28,57,380,2242,9.6,0.1143195
26174,26174,Steve Webb,1999-00,24.0,4,0,45,45,0,0,0,18.0,190.0,106,1,4,5,45.0,82,5.27,57,359,2285,9.4,0.101077765
26175,26175,Steve Webb,2000-01,25.0,5,4,65,65,1,3,4,27.0,455.0,171,2,7,9,72.0,82,5.49,53,331,2294,9.8,0.10022065
26176,26176,Steve Webb,2001-02,26.0,6,2,31,31,0,2,2,8.0,200.0,202,2,9,11,80.0,82,5.51,63,376,2272,9.9,0.09694436
26177,26177,Steve Webb,2002-03,27.0,7,6,60,60,2,4,6,31.0,389.0,262,4,13,17,111.0,82,5.24,53,338,2262,9.5,0.10650441
26178,26178,Steve Webb,2003-04,28.0,8,1,49,49,1,0,1,27.0,296.0,311,5,13,18,138.0,82,5.31,60,363,2326,9.4,0.10228947
26179,26179,Steve Webb,2004-05,29.0,9,0,10,10,0,0,0,3.0,51.0,321,5,13,18,141.0,82,5.14,57,348,2300,9.2,0.14198235
26180,26180,Steve Yzerman,1984-85,19.0,2,87,80,80,39,48,87,177.0,,80,39,48,87,177.0,80,7.89,74,336,2448,12.9,1.132136
26181,26181,Steve Yzerman,1985-86,20.0,3,89,80,80,30,59,89,231.0,,160,69,107,176,408.0,80,7.77,71,321,2447,12.7,1.1401701
26182,26182,Steve Yzerman,1986-87,21.0,4,42,51,51,14,28,42,132.0,,211,83,135,218,540.0,80,7.94,82,370,2484,12.8,0.9157933
26183,26183,Steve Yzerman,1987-88,22.0,5,90,80,80,31,59,90,217.0,,291,114,194,308,757.0,80,7.34,72,344,2400,12.2,1.3041885
26184,26184,Steve Yzerman,1988-89,23.0,6,102,64,64,50,52,102,242.0,,355,164,246,410,999.0,80,7.43,89,437,2435,12.2,1.7688385
26185,26185,Steve Yzerman,1989-90,24.0,7,155,80,80,65,90,155,388.0,,435,229,336,565,1387.0,80,7.48,85,403,2430,12.3,1.6356765
26186,26186,Steve Yzerman,1990-91,25.0,8,127,79,79,62,65,127,332.0,,514,291,401,692,1719.0,80,7.37,76,367,2421,12.2,1.4057589
26187,26187,Steve Yzerman,1991-92,26.0,9,108,80,80,51,57,108,326.0,,594,342,458,800,2045.0,80,6.91,71,366,2385,11.6,1.2198683
26188,26188,Steve Yzerman,1992-93,27.0,10,103,79,79,45,58,103,295.0,,673,387,516,903,2340.0,80,6.96,77,402,2440,11.4,1.3353179
26189,26189,Steve Yzerman,1993-94,28.0,11,137,84,84,58,79,137,307.0,,757,445,595,1040,2647.0,84,7.25,87,443,2603,11.7,1.3338752
26190,26190,Steve Yzerman,1994-95,29.0,12,82,58,58,24,58,82,217.0,,815,469,653,1122,2864.0,84,6.48,76,407,2545,10.7,1.022093
26191,26191,Steve Yzerman,1995-96,30.0,13,38,47,47,12,26,38,134.0,,862,481,679,1160,2998.0,48,5.97,37,209,1408,10.2,0.9844798
26192,26192,Steve Yzerman,1996-97,31.0,14,95,80,80,36,59,95,220.0,,942,517,738,1255,3218.0,82,6.29,74,413,2481,10.4,0.9923303
26193,26193,Steve Yzerman,1997-98,32.0,15,85,81,81,22,63,85,232.0,,1023,539,801,1340,3450.0,82,5.83,55,336,2444,9.8,0.99144125
26194,26194,Steve Yzerman,1998-99,33.0,16,69,75,75,24,45,69,188.0,,1098,563,846,1409,3638.0,82,5.28,57,380,2242,9.6,0.7847892
26195,26195,Steve Yzerman,1999-00,34.0,17,74,80,80,29,45,74,231.0,1727.0,1178,592,891,1483,3869.0,82,5.27,57,359,2285,9.4,0.8909072
26196,26196,Steve Yzerman,2000-01,35.0,18,79,78,78,35,44,79,234.0,1647.0,1256,627,935,1562,4103.0,82,5.49,53,331,2294,9.8,0.85630393
26197,26197,Steve Yzerman,2001-02,36.0,19,52,54,54,18,34,52,155.0,1201.0,1310,645,969,1614,4258.0,82,5.51,63,376,2272,9.9,0.8756655
26198,26198,Steve Yzerman,2002-03,37.0,20,48,52,52,13,35,48,104.0,1070.0,1362,658,1004,1662,4362.0,82,5.24,53,338,2262,9.5,0.7346297
26199,26199,Steve Yzerman,2003-04,38.0,21,8,16,16,2,6,8,13.0,249.0,1378,660,1010,1670,4375.0,82,5.31,60,363,2326,9.4,0.53165406
26200,26200,Steve Yzerman,2004-05,39.0,22,51,75,75,18,33,51,141.0,1315.0,1453,678,1043,1721,4516.0,82,5.14,57,348,2300,9.2,0.60465115
26201,26201,Steve Yzerman,2006-07,41.0,23,34,61,61,14,20,34,86.0,779.0,1514,692,1063,1755,4602.0,82,6.05,85,480,2458,10.1,0.48447445
26202,26202,Steven Finn,1986-87,20.0,2,1,17,17,0,1,1,8.0,,17,0,1,1,8.0,80,7.94,82,370,2484,12.8,0.27075022
26203,26203,Steven Finn,1987-88,21.0,3,7,36,36,2,5,7,35.0,,53,2,6,8,43.0,80,7.34,72,344,2400,12.2,0.27075285
26204,26204,Steven Finn,1988-89,22.0,4,10,75,75,3,7,10,70.0,,128,5,13,18,113.0,80,7.43,89,437,2435,12.2,0.22621277
26205,26205,Steven Finn,1989-90,23.0,5,8,77,77,2,6,8,86.0,,205,7,19,26,199.0,80,7.48,85,403,2430,12.3,0.20918632
26206,26206,Steven Finn,1990-91,24.0,6,12,64,64,3,9,12,74.0,,269,10,28,38,273.0,80,7.37,76,367,2421,12.2,0.24268758
26207,26207,Steven Finn,1991-92,25.0,7,19,71,71,6,13,19,91.0,,340,16,41,57,364.0,80,6.91,71,366,2385,11.6,0.2738043
26208,26208,Steven Finn,1992-93,26.0,8,11,65,65,4,7,11,63.0,,405,20,48,68,427.0,80,6.96,77,402,2440,11.4,0.21060047
26209,26209,Steven Finn,1993-94,27.0,9,14,80,80,5,9,14,61.0,,485,25,57,82,488.0,84,7.25,87,443,2603,11.7,0.18087476
26210,26210,Steven Finn,1994-95,28.0,10,17,80,80,4,13,17,74.0,,565,29,70,99,562.0,84,6.48,76,407,2545,10.7,0.19118145
26211,26211,Steven Finn,1995-96,29.0,11,3,40,40,0,3,3,28.0,,605,29,73,102,590.0,48,5.97,37,209,1408,10.2,0.11587253
26212,26212,Steven Finn,1996-97,30.0,12,5,66,66,3,2,5,54.0,,671,32,75,107,644.0,82,6.29,74,413,2481,10.4,0.13094482
26213,26213,Steven Finn,1997-98,31.0,13,5,54,54,2,3,5,35.0,,725,34,78,112,679.0,82,5.83,55,336,2444,9.8,0.12849113
26214,26214,Steven Fletcher,1989-90,27.0,2,0,3,3,0,0,0,1.0,,3,0,0,0,1.0,80,7.48,85,403,2430,12.3,0.19774547
26215,26215,Steven Fogarty,2018-19,25.0,2,0,1,1,0,0,0,1.0,12.0,1,0,0,0,1.0,82,5.86,50,250,2620,9.2,0.15961453
26216,26216,Steven Fogarty,2019-20,26.0,3,0,10,10,0,0,0,9.0,78.0,11,0,0,0,10.0,82,5.96,47,239,2579,9.5,0.16971543
26217,26217,Steven Fogarty,2020-21,27.0,4,0,7,7,0,0,0,2.0,41.0,18,0,0,0,12.0,70,5.96,42,208,2192,9.5,0.16401556
26218,26218,Steven Goertzen,2006-07,22.0,2,0,39,39,0,0,0,23.0,333.0,39,0,0,0,23.0,82,6.05,85,480,2458,10.1,0.12918493
26219,26219,Steven Goertzen,2007-08,23.0,3,0,7,7,0,0,0,1.0,37.0,46,0,0,0,24.0,82,5.76,70,398,2426,9.7,0.15337092
26220,26220,Steven Goertzen,2009-10,25.0,4,4,16,16,2,2,4,18.0,155.0,62,2,2,4,42.0,82,5.7,65,341,2477,9.4,0.20201772
26221,26221,Steven Goertzen,2010-11,26.0,5,0,6,6,0,0,0,1.0,46.0,68,2,2,4,43.0,82,5.53,56,304,2486,9.1,0.12451345
26222,26222,Steven Halko,1998-99,24.0,2,2,18,18,0,2,2,7.0,,18,0,2,2,7.0,82,5.28,57,380,2242,9.6,0.16345638
26223,26223,Steven Halko,1999-00,25.0,3,3,20,20,0,3,3,6.0,319.0,38,0,5,5,13.0,82,5.27,57,359,2285,9.4,0.11735752
26224,26224,Steven Halko,2000-01,26.0,4,8,58,58,0,8,8,54.0,969.0,96,0,13,13,67.0,82,5.49,53,331,2294,9.8,0.13659057
26225,26225,Steven Halko,2001-02,27.0,5,1,48,48,0,1,1,24.0,645.0,144,0,14,14,91.0,82,5.51,63,376,2272,9.9,0.09276554
26226,26226,Steven Halko,2002-03,28.0,6,1,5,5,0,1,1,0.0,49.0,149,0,15,15,91.0,82,5.24,53,338,2262,9.5,0.14224222
26227,26227,Steven Halko,2003-04,29.0,7,0,6,6,0,0,0,5.0,61.0,155,0,15,15,96.0,82,5.31,60,363,2326,9.4,0.1224795
26228,26228,Steven Kampfer,2011-12,23.0,2,10,38,38,5,5,10,57.0,674.0,38,5,5,10,57.0,82,5.46,52,291,2492,9.0,0.28454992
26229,26229,Steven Kampfer,2012-13,24.0,3,5,23,23,2,3,5,20.0,343.0,61,7,8,15,77.0,82,5.32,47,271,2439,8.9,0.23406875
26230,26230,Steven Kampfer,2015-16,27.0,4,4,25,25,2,2,4,28.0,430.0,86,9,10,19,105.0,82,5.32,47,251,2453,8.9,0.19832596
26231,26231,Steven Kampfer,2016-17,28.0,5,4,47,47,0,4,4,54.0,709.0,133,9,14,23,159.0,82,5.34,48,255,2438,9.0,0.12829614
26232,26232,Steven Kampfer,2017-18,29.0,6,2,11,11,1,1,2,10.0,146.0,144,10,15,25,169.0,82,5.45,47,245,2478,9.0,0.15377751
26233,26233,Steven Kampfer,2018-19,30.0,7,1,22,22,0,1,1,31.0,380.0,166,10,16,26,200.0,82,5.86,50,250,2620,9.2,0.13640094
26234,26234,Steven Kampfer,2019-20,31.0,8,6,35,35,3,3,6,40.0,512.0,201,13,19,32,240.0,82,5.96,47,239,2579,9.5,0.16532576
26235,26235,Steven Kampfer,2020-21,32.0,9,2,10,10,0,2,2,13.0,136.0,211,13,21,34,253.0,70,5.96,42,208,2192,9.5,0.15530637
26236,26236,Steven King,1993-94,24.0,2,12,24,24,7,5,12,42.0,,24,7,5,12,42.0,84,7.25,87,443,2603,11.7,0.34771255
26237,26237,Steven King,1994-95,25.0,3,11,36,36,8,3,11,50.0,,60,15,8,23,92.0,84,6.48,76,407,2545,10.7,0.28650585
26238,26238,Steven King,1996-97,27.0,4,2,7,7,2,0,2,5.0,,67,17,8,25,97.0,82,6.29,74,413,2481,10.4,0.23192602
26239,26239,Steven Oleksy,2013-14,27.0,2,9,28,28,1,8,9,25.0,484.0,28,1,8,9,25.0,48,5.31,29,160,1399,9.1,0.21893728
26240,26240,Steven Oleksy,2014-15,28.0,3,10,33,33,2,8,10,27.0,504.0,61,3,16,19,52.0,82,5.34,48,269,2463,8.9,0.20116818
26241,26241,Steven Oleksy,2015-16,29.0,4,0,1,1,0,0,0,1.0,12.0,62,3,16,19,53.0,82,5.32,47,251,2453,8.9,0.13443413
26242,26242,Steven Oleksy,2017-18,31.0,5,1,11,11,0,1,1,11.0,151.0,73,3,17,20,64.0,82,5.45,47,245,2478,9.0,0.15259859
26243,26243,Steven Rice,1991-92,20.0,2,2,11,11,1,1,2,12.0,,11,1,1,2,12.0,80,6.91,71,366,2385,11.6,0.2993045
26244,26244,Steven Rice,1992-93,21.0,3,0,3,3,0,0,0,2.0,,14,1,1,2,14.0,80,6.96,77,402,2440,11.4,0.2532312
26245,26245,Steven Rice,1993-94,22.0,4,7,28,28,2,5,7,29.0,,42,3,6,9,43.0,84,7.25,87,443,2603,11.7,0.27594867
26246,26246,Steven Rice,1994-95,23.0,5,32,63,63,17,15,32,129.0,,105,20,21,41,172.0,84,6.48,76,407,2545,10.7,0.49364057
26247,26247,Steven Rice,1995-96,24.0,6,21,40,40,11,10,21,57.0,,145,31,31,62,229.0,48,5.97,37,209,1408,10.2,0.45682842
26248,26248,Steven Rice,1996-97,25.0,7,22,59,59,10,12,22,108.0,,204,41,43,84,337.0,82,6.29,74,413,2481,10.4,0.36149222
26249,26249,Steven Rice,1997-98,26.0,8,35,78,78,21,14,35,159.0,,282,62,57,119,496.0,82,5.83,55,336,2444,9.8,0.43104398
26250,26250,Steven Rice,1998-99,27.0,9,6,47,47,2,4,6,39.0,,329,64,61,125,535.0,82,5.28,57,380,2242,9.6,0.21273774
26251,26251,Steven Santini,2016-17,21.0,2,0,1,1,0,0,0,1.0,15.0,1,0,0,0,1.0,82,5.34,48,255,2438,9.0,0.19850874
26252,26252,Steven Santini,2017-18,22.0,3,7,38,38,2,5,7,46.0,611.0,39,2,5,7,47.0,82,5.45,47,245,2478,9.0,0.24777639
26253,26253,Steven Santini,2018-19,23.0,4,10,36,36,2,8,10,56.0,730.0,75,4,13,17,103.0,82,5.86,50,250,2620,9.2,0.27355212
26254,26254,Steven Santini,2019-20,24.0,5,4,39,39,1,3,4,41.0,650.0,114,5,16,21,144.0,82,5.96,47,239,2579,9.5,0.18417788
26255,26255,Steven Santini,2020-21,25.0,6,0,2,2,0,0,0,1.0,19.0,116,5,16,21,145.0,70,5.96,42,208,2192,9.5,0.16964835
26256,26256,Steven Stamkos,2009-10,19.0,2,46,79,79,23,23,46,181.0,1180.0,79,23,23,46,181.0,82,5.7,65,341,2477,9.4,0.6660204
26257,26257,Steven Stamkos,2010-11,20.0,3,95,82,82,51,44,95,297.0,1685.0,161,74,67,141,478.0,82,5.53,56,304,2486,9.1,1.0718737
26258,26258,Steven Stamkos,2011-12,21.0,4,91,82,82,45,46,91,272.0,1656.0,243,119,113,232,750.0,82,5.46,52,291,2492,9.0,1.1059244
26259,26259,Steven Stamkos,2012-13,22.0,5,97,82,82,60,37,97,303.0,1806.0,325,179,150,329,1053.0,82,5.32,47,271,2439,8.9,1.0823588
26260,26260,Steven Stamkos,2013-14,23.0,6,57,48,48,29,28,57,157.0,1057.0,373,208,178,386,1210.0,48,5.31,29,160,1399,9.1,1.0901121
26261,26261,Steven Stamkos,2014-15,24.0,7,40,37,37,25,15,40,124.0,749.0,410,233,193,426,1334.0,82,5.34,48,269,2463,8.9,0.8562573
26262,26262,Steven Stamkos,2015-16,25.0,8,72,82,82,43,29,72,268.0,1588.0,492,276,222,498,1602.0,82,5.32,47,251,2453,8.9,0.92861056
26263,26263,Steven Stamkos,2016-17,26.0,9,64,77,77,36,28,64,216.0,1521.0,569,312,250,562,1818.0,82,5.34,48,255,2438,9.0,0.8734511
26264,26264,Steven Stamkos,2017-18,27.0,10,20,17,17,9,11,20,58.0,304.0,586,321,261,582,1876.0,82,5.45,47,245,2478,9.0,0.98949444
26265,26265,Steven Stamkos,2018-19,28.0,11,86,78,78,27,59,86,212.0,1464.0,664,348,320,668,2088.0,82,5.86,50,250,2620,9.2,1.0592799
26266,26266,Steven Stamkos,2019-20,29.0,12,98,82,82,45,53,98,234.0,1501.0,746,393,373,766,2322.0,82,5.96,47,239,2579,9.5,1.0381844
26267,26267,Steven Stamkos,2020-21,30.0,13,66,57,57,29,37,66,176.0,1050.0,803,422,410,832,2498.0,70,5.96,42,208,2192,9.5,1.1361976
26268,26268,Steven Zalewski,2010-11,24.0,2,0,3,3,0,0,0,3.0,25.0,3,0,0,0,3.0,82,5.53,56,304,2486,9.1,0.17076418
26269,26269,Steven Zalewski,2012-13,26.0,3,0,7,7,0,0,0,6.0,74.0,10,0,0,0,9.0,82,5.32,47,271,2439,8.9,0.15891996
26270,26270,Stew Gavin,1981-82,21.0,2,3,14,14,1,2,3,13.0,,14,1,2,3,13.0,80,7.69,77,340,2441,12.6,0.32225013
26271,26271,Stew Gavin,1982-83,22.0,3,11,38,38,5,6,11,66.0,,52,6,8,14,79.0,80,8.03,73,320,2489,12.9,0.32725662
26272,26272,Stew Gavin,1983-84,23.0,4,11,63,63,6,5,11,77.0,,115,12,13,25,156.0,80,7.73,71,310,2444,12.7,0.30005282
26273,26273,Stew Gavin,1984-85,24.0,5,32,80,80,10,22,32,96.0,,195,22,35,57,252.0,80,7.89,74,336,2448,12.9,0.39608473
26274,26274,Stew Gavin,1985-86,25.0,6,25,73,73,12,13,25,149.0,,268,34,48,82,401.0,80,7.77,71,321,2447,12.7,0.40074724
26275,26275,Stew Gavin,1986-87,26.0,7,55,76,76,26,29,55,161.0,,344,60,77,137,562.0,80,7.94,82,370,2484,12.8,0.6485373
26276,26276,Stew Gavin,1987-88,27.0,8,41,79,79,20,21,41,162.0,,423,80,98,178,724.0,80,7.34,72,344,2400,12.2,0.49318922
26277,26277,Stew Gavin,1988-89,28.0,9,21,56,56,11,10,21,125.0,,479,91,108,199,849.0,80,7.43,89,437,2435,12.2,0.38858947
26278,26278,Stew Gavin,1989-90,29.0,10,26,73,73,8,18,26,129.0,,552,99,126,225,978.0,80,7.48,85,403,2430,12.3,0.33862954
26279,26279,Stew Gavin,1990-91,30.0,11,25,80,80,12,13,25,146.0,,632,111,139,250,1124.0,80,7.37,76,367,2421,12.2,0.3183067
26280,26280,Stew Gavin,1991-92,31.0,12,8,38,38,4,4,8,56.0,,670,115,143,258,1180.0,80,6.91,71,366,2385,11.6,0.24564135
26281,26281,Stew Gavin,1992-93,32.0,13,9,35,35,5,4,9,49.0,,705,120,147,267,1229.0,80,6.96,77,402,2440,11.4,0.2559012
26282,26282,Stew Gavin,1993-94,33.0,14,18,63,63,10,8,18,114.0,,768,130,155,285,1343.0,84,7.25,87,443,2603,11.7,0.28148448
26283,26283,Stewart Malgunas,1994-95,24.0,2,4,67,67,1,3,4,54.0,,67,1,3,4,54.0,84,6.48,76,407,2545,10.7,0.14915502
26284,26284,Stewart Malgunas,1995-96,25.0,3,0,4,4,0,0,0,1.0,,71,1,3,4,55.0,48,5.97,37,209,1408,10.2,0.15487081
26285,26285,Stewart Malgunas,1996-97,26.0,4,1,30,30,0,1,1,13.0,,101,1,4,5,68.0,82,6.29,74,413,2481,10.4,0.109176636
26286,26286,Stewart Malgunas,1997-98,27.0,5,0,6,6,0,0,0,3.0,,107,1,4,5,71.0,82,5.83,55,336,2444,9.8,0.11282951
26287,26287,Stewart Malgunas,1998-99,28.0,6,0,8,8,0,0,0,5.0,,115,1,4,5,76.0,82,5.28,57,380,2242,9.6,0.122518
26288,26288,Stewart Malgunas,1999-00,29.0,7,0,10,10,0,0,0,2.0,90.0,125,1,4,5,78.0,82,5.27,57,359,2285,9.4,0.10992071
26289,26289,Stewart Malgunas,2000-01,30.0,8,1,4,4,0,1,1,0.0,52.0,129,1,5,6,78.0,82,5.49,53,331,2294,9.8,0.12455419
26290,26290,Stu Barnes,1992-93,22.0,2,17,46,46,8,9,17,75.0,,46,8,9,17,75.0,80,6.96,77,402,2440,11.4,0.41218135
26291,26291,Stu Barnes,1993-94,23.0,3,22,38,38,12,10,22,73.0,,84,20,19,39,148.0,84,7.25,87,443,2603,11.7,0.539101
26292,26292,Stu Barnes,1994-95,24.0,4,47,77,77,23,24,47,172.0,,161,43,43,86,320.0,84,6.48,76,407,2545,10.7,0.5625059
26293,26293,Stu Barnes,1995-96,25.0,5,29,41,41,10,19,29,93.0,,202,53,62,115,413.0,48,5.97,37,209,1408,10.2,0.63365996
26294,26294,Stu Barnes,1996-97,26.0,6,44,72,72,19,25,44,158.0,,274,72,87,159,571.0,82,6.29,74,413,2481,10.4,0.5407032
26295,26295,Stu Barnes,1997-98,27.0,7,49,81,81,19,30,49,176.0,,355,91,117,208,747.0,82,5.83,55,336,2444,9.8,0.5693434
26296,26296,Stu Barnes,1998-99,28.0,8,65,78,78,30,35,65,196.0,,433,121,152,273,943.0,82,5.28,57,380,2242,9.6,0.7266914
26297,26297,Stu Barnes,1999-00,29.0,9,36,81,81,20,16,36,180.0,1455.0,514,141,168,309,1123.0,82,5.27,57,359,2285,9.4,0.5207347
26298,26298,Stu Barnes,2000-01,30.0,10,45,82,82,20,25,45,137.0,1426.0,596,161,193,354,1260.0,82,5.49,53,331,2294,9.8,0.52521545
26299,26299,Stu Barnes,2001-02,31.0,11,43,75,75,19,24,43,160.0,1433.0,671,180,217,397,1420.0,82,5.51,63,376,2272,9.9,0.4973145
26300,26300,Stu Barnes,2002-03,32.0,12,48,68,68,17,31,48,127.0,1263.0,739,197,248,445,1547.0,82,5.24,53,338,2262,9.5,0.5606003
26301,26301,Stu Barnes,2003-04,33.0,13,39,81,81,13,26,39,149.0,1483.0,820,210,274,484,1696.0,82,5.31,60,363,2326,9.4,0.47078454
26302,26302,Stu Barnes,2004-05,34.0,14,29,77,77,11,18,29,135.0,1392.0,897,221,292,513,1831.0,82,5.14,57,348,2300,9.2,0.4863663
26303,26303,Stu Barnes,2006-07,36.0,15,36,78,78,15,21,36,123.0,1285.0,975,236,313,549,1954.0,82,6.05,85,480,2458,10.1,0.35709357
26304,26304,Stu Barnes,2007-08,37.0,16,25,82,82,13,12,25,118.0,1320.0,1057,249,325,574,2072.0,82,5.76,70,398,2426,9.7,0.29291698
26305,26305,Stu Barnes,2008-09,38.0,17,23,79,79,12,11,23,71.0,1076.0,1136,261,336,597,2143.0,82,5.44,62,351,2383,9.4,0.2533304
26306,26306,Stu Bickel,2012-13,26.0,2,9,51,51,0,9,9,22.0,532.0,51,0,9,9,22.0,82,5.32,47,271,2439,8.9,0.10366383
26307,26307,Stu Bickel,2013-14,27.0,3,0,16,16,0,0,0,2.0,88.0,67,0,9,9,24.0,48,5.31,29,160,1399,9.1,0.14114517
26308,26308,Stu Bickel,2015-16,29.0,4,1,9,9,0,1,1,3.0,49.0,76,0,10,10,27.0,82,5.32,47,251,2453,8.9,0.12302694
26309,26309,Stu Grimson,1989-90,24.0,2,0,1,1,0,0,0,0.0,,1,0,0,0,0.0,80,7.48,85,403,2430,12.3,0.17426091
26310,26310,Stu Grimson,1990-91,25.0,3,0,3,3,0,0,0,0.0,,4,0,0,0,0.0,80,7.37,76,367,2421,12.2,0.16446191
26311,26311,Stu Grimson,1991-92,26.0,4,1,35,35,0,1,1,14.0,,39,0,1,1,14.0,80,6.91,71,366,2385,11.6,0.11781487
26312,26312,Stu Grimson,1992-93,27.0,5,4,54,54,2,2,4,23.0,,93,2,3,5,37.0,80,6.96,77,402,2440,11.4,0.11807346
26313,26313,Stu Grimson,1993-94,28.0,6,2,78,78,1,1,2,14.0,,171,3,4,7,51.0,84,7.25,87,443,2603,11.7,0.07209635
26314,26314,Stu Grimson,1994-95,29.0,7,6,77,77,1,5,6,34.0,,248,4,9,13,85.0,84,6.48,76,407,2545,10.7,0.11181307
26315,26315,Stu Grimson,1995-96,30.0,8,1,42,42,0,1,1,18.0,,290,4,10,14,103.0,48,5.97,37,209,1408,10.2,0.06636399
26316,26316,Stu Grimson,1996-97,31.0,9,1,56,56,0,1,1,19.0,,346,4,11,15,122.0,82,6.29,74,413,2481,10.4,0.049755305
26317,26317,Stu Grimson,1997-98,32.0,10,4,76,76,2,2,4,17.0,,422,6,13,19,139.0,82,5.83,55,336,2444,9.8,0.07314202
26318,26318,Stu Grimson,1998-99,33.0,11,7,82,82,3,4,7,17.0,,504,9,17,26,156.0,82,5.28,57,380,2242,9.6,0.07195678
26319,26319,Stu Grimson,1999-00,34.0,12,3,73,73,3,0,3,10.0,249.0,577,12,17,29,166.0,82,5.27,57,359,2285,9.4,0.08279535
26320,26320,Stu Grimson,2000-01,35.0,13,3,50,50,1,2,3,14.0,260.0,627,13,19,32,180.0,82,5.49,53,331,2294,9.8,0.062678546
26321,26321,Stu Grimson,2001-02,36.0,14,5,72,72,3,2,5,26.0,432.0,699,16,21,37,206.0,82,5.51,63,376,2272,9.9,0.07349169
26322,26322,Stu Grimson,2002-03,37.0,15,2,30,30,1,1,2,5.0,184.0,729,17,22,39,211.0,82,5.24,53,338,2262,9.5,0.07091236
26323,26323,Stu Kulak,1983-84,20.0,2,2,4,4,1,1,2,2.0,,4,1,1,2,2.0,80,7.73,71,310,2444,12.7,0.3544423
26324,26324,Stu Kulak,1987-88,24.0,3,6,54,54,4,2,6,56.0,,58,5,3,8,58.0,80,7.34,72,344,2400,12.2,0.20601273
26325,26325,Stu Kulak,1988-89,25.0,4,2,14,14,1,1,2,22.0,,72,6,4,10,80.0,80,7.43,89,437,2435,12.2,0.258101
26326,26326,Stu Kulak,1989-90,26.0,5,2,18,18,2,0,2,18.0,,90,8,4,12,98.0,80,7.48,85,403,2430,12.3,0.2506179
26327,26327,Stu Smith,1980-81,20.0,2,0,4,4,0,0,0,3.0,,4,0,0,0,3.0,80,7.03,61,280,2352,12.0,0.28712213
26328,26328,Stu Smith,1981-82,21.0,3,8,38,38,1,7,8,34.0,,42,1,7,8,37.0,80,7.69,77,340,2441,12.6,0.26027244
26329,26329,Stu Smith,1982-83,22.0,4,3,17,17,0,3,3,14.0,,59,1,10,11,51.0,80,8.03,73,320,2489,12.9,0.2201919
26330,26330,Stu Smith,1983-84,23.0,5,1,18,18,1,0,1,21.0,,77,2,10,12,72.0,80,7.73,71,310,2444,12.7,0.26387376
26331,26331,Stuart Percy,2015-16,22.0,2,3,9,9,0,3,3,13.0,163.0,9,0,3,3,13.0,82,5.32,47,251,2453,8.9,0.2149404
26332,26332,Stuart Percy,2016-17,23.0,3,0,3,3,0,0,0,1.0,39.0,12,0,3,3,14.0,82,5.34,48,255,2438,9.0,0.15773591
26333,26333,Sven Andrighetto,2015-16,22.0,2,3,12,12,2,1,3,12.0,113.0,12,2,1,3,12.0,82,5.32,47,251,2453,8.9,0.2559102
26334,26334,Sven Andrighetto,2016-17,23.0,3,17,44,44,7,10,17,74.0,621.0,56,9,11,20,86.0,82,5.34,48,255,2438,9.0,0.37948602
26335,26335,Sven Andrighetto,2017-18,24.0,4,24,46,46,7,17,24,68.0,643.0,102,16,28,44,154.0,82,5.45,47,245,2478,9.0,0.39449126
26336,26336,Sven Andrighetto,2018-19,25.0,5,22,50,50,8,14,22,111.0,724.0,152,24,42,66,265.0,82,5.86,50,250,2620,9.2,0.41603875
26337,26337,Sven Andrighetto,2019-20,26.0,6,17,64,64,7,10,17,95.0,708.0,216,31,52,83,360.0,82,5.96,47,239,2579,9.5,0.27173775
26338,26338,Sven Baertschi,2012-13,20.0,2,3,5,5,3,0,3,10.0,56.0,5,3,0,3,10.0,82,5.32,47,271,2439,8.9,0.32614627
26339,26339,Sven Baertschi,2013-14,21.0,3,10,20,20,3,7,10,28.0,268.0,25,6,7,13,38.0,48,5.31,29,160,1399,9.1,0.42584813
26340,26340,Sven Baertschi,2014-15,22.0,4,11,26,26,2,9,11,30.0,367.0,51,8,16,24,68.0,82,5.34,48,269,2463,8.9,0.30047002
26341,26341,Sven Baertschi,2015-16,23.0,5,6,18,18,2,4,6,15.0,174.0,69,10,20,30,83.0,82,5.32,47,251,2453,8.9,0.29015368
26342,26342,Sven Baertschi,2016-17,24.0,6,28,69,69,15,13,28,108.0,929.0,138,25,33,58,191.0,82,5.34,48,255,2438,9.0,0.38877106
26343,26343,Sven Baertschi,2017-18,25.0,7,35,68,68,18,17,35,114.0,1080.0,206,43,50,93,305.0,82,5.45,47,245,2478,9.0,0.43858576
26344,26344,Sven Baertschi,2018-19,26.0,8,29,53,53,14,15,29,82.0,827.0,259,57,65,122,387.0,82,5.86,50,250,2620,9.2,0.46746513
26345,26345,Sven Baertschi,2019-20,27.0,9,14,26,26,9,5,14,43.0,394.0,285,66,70,136,430.0,82,5.96,47,239,2579,9.5,0.3760637
26346,26346,Sven Baertschi,2020-21,28.0,10,2,6,6,0,2,2,7.0,71.0,291,66,72,138,437.0,70,5.96,42,208,2192,9.5,0.22639364
26347,26347,Sven Butenschön,1998-99,22.0,2,0,8,8,0,0,0,4.0,,8,0,0,0,4.0,82,5.28,57,380,2242,9.6,0.17716289
26348,26348,Sven Butenschön,1999-00,23.0,3,0,17,17,0,0,0,8.0,223.0,25,0,0,0,12.0,82,5.27,57,359,2285,9.4,0.15201235
26349,26349,Sven Butenschön,2000-01,24.0,4,0,3,3,0,0,0,2.0,49.0,28,0,0,0,14.0,82,5.49,53,331,2294,9.8,0.15025625
26350,26350,Sven Butenschön,2001-02,25.0,5,3,12,12,1,2,3,9.0,167.0,40,1,2,3,23.0,82,5.51,63,376,2272,9.9,0.16389465
26351,26351,Sven Butenschön,2002-03,26.0,6,0,14,14,0,0,0,8.0,135.0,54,1,2,3,31.0,82,5.24,53,338,2262,9.5,0.12353334
26352,26352,Sven Butenschön,2003-04,27.0,7,4,37,37,0,4,4,19.0,460.0,91,1,6,7,50.0,82,5.31,60,363,2326,9.4,0.11149964
26353,26353,Sven Butenschön,2004-05,28.0,8,7,41,41,1,6,7,17.0,461.0,132,2,12,14,67.0,82,5.14,57,348,2300,9.2,0.1311391
26354,26354,Sven Butenschön,2006-07,30.0,9,0,8,8,0,0,0,4.0,113.0,140,2,12,14,71.0,82,6.05,85,480,2458,10.1,0.109197974
26355,26355,Sylvain Blouin,1997-98,23.0,2,0,6,6,0,0,0,1.0,,6,0,0,0,1.0,82,5.83,55,336,2444,9.8,0.16314653
26356,26356,Sylvain Blouin,1998-99,24.0,3,0,1,1,0,0,0,0.0,,7,0,0,0,1.0,82,5.28,57,380,2242,9.6,0.14783177
26357,26357,Sylvain Blouin,1999-00,25.0,4,0,5,5,0,0,0,1.0,18.0,12,0,0,0,2.0,82,5.27,57,359,2285,9.4,0.15260223
26358,26358,Sylvain Blouin,2001-02,27.0,5,5,41,41,3,2,5,37.0,406.0,53,3,2,5,39.0,82,5.51,63,376,2272,9.9,0.11984518
26359,26359,Sylvain Blouin,2002-03,28.0,6,2,43,43,0,2,2,28.0,424.0,96,3,4,7,67.0,82,5.24,53,338,2262,9.5,0.100640446
26360,26360,Sylvain Blouin,2003-04,29.0,7,0,19,19,0,0,0,4.0,77.0,115,3,4,7,71.0,82,5.31,60,363,2326,9.4,0.08946049
26361,26361,Sylvain Cloutier,1999-00,25.0,2,0,7,7,0,0,0,3.0,38.0,7,0,0,0,3.0,82,5.27,57,359,2285,9.4,0.16484177
26362,26362,Sylvain Cote,1985-86,20.0,2,12,67,67,3,9,12,88.0,,67,3,9,12,88.0,80,7.77,71,321,2447,12.7,0.31170428
26363,26363,Sylvain Cote,1986-87,21.0,3,0,2,2,0,0,0,0.0,,69,3,9,12,88.0,80,7.94,82,370,2484,12.8,0.24277434
26364,26364,Sylvain Cote,1987-88,22.0,4,10,67,67,2,8,10,100.0,,136,5,17,22,188.0,80,7.34,72,344,2400,12.2,0.27935156
26365,26365,Sylvain Cote,1988-89,23.0,5,28,67,67,7,21,28,142.0,,203,12,38,50,330.0,80,7.43,89,437,2435,12.2,0.42872176
26366,26366,Sylvain Cote,1989-90,24.0,6,17,78,78,8,9,17,130.0,,281,20,47,67,460.0,80,7.48,85,403,2430,12.3,0.31213987
26367,26367,Sylvain Cote,1990-91,25.0,7,6,28,28,4,2,6,50.0,,309,24,49,73,510.0,80,7.37,76,367,2421,12.2,0.29460597
26368,26368,Sylvain Cote,1991-92,26.0,8,19,73,73,7,12,19,154.0,,382,31,61,92,664.0,80,6.91,71,366,2385,11.6,0.32518858
26369,26369,Sylvain Cote,1992-93,27.0,9,40,78,78,11,29,40,151.0,,460,42,90,132,815.0,80,6.96,77,402,2440,11.4,0.45368436
26370,26370,Sylvain Cote,1993-94,28.0,10,50,77,77,21,29,50,206.0,,537,63,119,182,1021.0,84,7.25,87,443,2603,11.7,0.53127366
26371,26371,Sylvain Cote,1994-95,29.0,11,51,84,84,16,35,51,212.0,,621,79,154,233,1233.0,84,6.48,76,407,2545,10.7,0.51722395
26372,26372,Sylvain Cote,1995-96,30.0,12,19,47,47,5,14,19,124.0,,668,84,168,252,1357.0,48,5.97,37,209,1408,10.2,0.4316069
26373,26373,Sylvain Cote,1996-97,31.0,13,38,81,81,5,33,38,212.0,,749,89,201,290,1569.0,82,6.29,74,413,2481,10.4,0.44124824
26374,26374,Sylvain Cote,1997-98,32.0,14,24,57,57,6,18,24,131.0,,806,95,219,314,1700.0,82,5.83,55,336,2444,9.8,0.380302
26375,26375,Sylvain Cote,1998-99,33.0,15,25,71,71,4,21,25,103.0,,877,99,240,339,1803.0,82,5.28,57,380,2242,9.6,0.26414514
26376,26376,Sylvain Cote,1999-00,34.0,16,29,79,79,5,24,29,119.0,1664.0,956,104,264,368,1922.0,82,5.27,57,359,2285,9.4,0.30902317
26377,26377,Sylvain Cote,2000-01,35.0,17,35,76,76,8,27,35,128.0,1625.0,1032,112,291,403,2050.0,82,5.49,53,331,2294,9.8,0.32520443
26378,26378,Sylvain Cote,2001-02,36.0,18,18,68,68,7,11,18,86.0,1210.0,1100,119,302,421,2136.0,82,5.51,63,376,2272,9.9,0.23708653
26379,26379,Sylvain Cote,2002-03,37.0,19,14,70,70,3,11,14,101.0,1381.0,1170,122,313,435,2237.0,82,5.24,53,338,2262,9.5,0.186777
26380,26380,Sylvain Cote,2003-04,38.0,20,0,1,1,0,0,0,0.0,4.0,1171,122,313,435,2237.0,82,5.31,60,363,2326,9.4,0.29712385
26381,26381,Sylvain Couturier,1989-90,21.0,2,4,16,16,1,3,4,15.0,,16,1,3,4,15.0,80,7.48,85,403,2430,12.3,0.31713852
26382,26382,Sylvain Couturier,1991-92,23.0,3,1,3,3,0,1,1,2.0,,19,1,4,5,17.0,80,6.91,71,366,2385,11.6,0.21290782
26383,26383,Sylvain Couturier,1992-93,24.0,4,4,14,14,3,1,4,21.0,,33,4,5,9,38.0,80,6.96,77,402,2440,11.4,0.307033
26384,26384,Sylvain Lefebvre,1990-91,23.0,2,13,68,68,3,10,13,89.0,,68,3,10,13,89.0,80,7.37,76,367,2421,12.2,0.26779768
26385,26385,Sylvain Lefebvre,1991-92,24.0,3,23,63,63,5,18,23,76.0,,131,8,28,36,165.0,80,6.91,71,366,2385,11.6,0.3084154
26386,26386,Sylvain Lefebvre,1992-93,25.0,4,17,69,69,3,14,17,85.0,,200,11,42,53,250.0,80,6.96,77,402,2440,11.4,0.27216953
26387,26387,Sylvain Lefebvre,1993-94,26.0,5,14,81,81,2,12,14,81.0,,281,13,54,67,331.0,84,7.25,87,443,2603,11.7,0.1901893
26388,26388,Sylvain Lefebvre,1994-95,27.0,6,11,84,84,2,9,11,96.0,,365,15,63,78,427.0,84,6.48,76,407,2545,10.7,0.20124552
26389,26389,Sylvain Lefebvre,1995-96,28.0,7,13,48,48,2,11,13,81.0,,413,17,74,91,508.0,48,5.97,37,209,1408,10.2,0.2648958
26390,26390,Sylvain Lefebvre,1996-97,29.0,8,16,75,75,5,11,16,115.0,,488,22,85,107,623.0,82,6.29,74,413,2481,10.4,0.24114057
26391,26391,Sylvain Lefebvre,1997-98,30.0,9,13,71,71,2,11,13,77.0,,559,24,96,120,700.0,82,5.83,55,336,2444,9.8,0.1715191
26392,26392,Sylvain Lefebvre,1998-99,31.0,10,10,81,81,0,10,10,66.0,,640,24,106,130,766.0,82,5.28,57,380,2242,9.6,0.15027538
26393,26393,Sylvain Lefebvre,1999-00,32.0,11,20,76,76,2,18,20,64.0,1591.0,716,26,124,150,830.0,82,5.27,57,359,2285,9.4,0.20196286
26394,26394,Sylvain Lefebvre,2000-01,33.0,12,12,82,82,2,10,12,67.0,1525.0,798,28,134,162,897.0,82,5.49,53,331,2294,9.8,0.14143217
26395,26395,Sylvain Lefebvre,2001-02,34.0,13,15,71,71,2,13,15,39.0,1289.0,869,30,147,177,936.0,82,5.51,63,376,2272,9.9,0.14027828
26396,26396,Sylvain Lefebvre,2002-03,35.0,14,5,41,41,0,5,5,20.0,682.0,910,30,152,182,956.0,82,5.24,53,338,2262,9.5,0.0960156
26397,26397,Sylvain Lefebvre,2003-04,36.0,15,2,35,35,0,2,2,14.0,535.0,945,30,154,184,970.0,82,5.31,60,363,2326,9.4,0.094380915
26398,26398,Sylvain Turgeon,1984-85,20.0,2,72,76,76,40,32,72,238.0,,76,40,32,72,238.0,80,7.89,74,336,2448,12.9,0.9472923
26399,26399,Sylvain Turgeon,1985-86,21.0,3,62,64,64,31,31,62,186.0,,140,71,63,134,424.0,80,7.77,71,321,2447,12.7,0.97305626
26400,26400,Sylvain Turgeon,1986-87,22.0,4,79,76,76,45,34,79,249.0,,216,116,97,213,673.0,80,7.94,82,370,2484,12.8,0.9637813
26401,26401,Sylvain Turgeon,1987-88,23.0,5,36,41,41,23,13,36,137.0,,257,139,110,249,810.0,80,7.34,72,344,2400,12.2,0.83149344
26402,26402,Sylvain Turgeon,1988-89,24.0,6,49,71,71,23,26,49,247.0,,328,162,136,298,1057.0,80,7.43,89,437,2435,12.2,0.75196934
26403,26403,Sylvain Turgeon,1989-90,25.0,7,30,42,42,16,14,30,122.0,,370,178,150,328,1179.0,80,7.48,85,403,2430,12.3,0.684047
26404,26404,Sylvain Turgeon,1990-91,26.0,8,47,72,72,30,17,47,218.0,,442,208,167,375,1397.0,80,7.37,76,367,2421,12.2,0.70898753
26405,26405,Sylvain Turgeon,1991-92,27.0,9,12,19,19,5,7,12,41.0,,461,213,174,387,1438.0,80,6.91,71,366,2385,11.6,0.4763929
26406,26406,Sylvain Turgeon,1992-93,28.0,10,20,56,56,9,11,20,99.0,,517,222,185,407,1537.0,80,6.96,77,402,2440,11.4,0.5003478
26407,26407,Sylvain Turgeon,1993-94,29.0,11,43,72,72,25,18,43,249.0,,589,247,203,450,1786.0,84,7.25,87,443,2603,11.7,0.6041628
26408,26408,Sylvain Turgeon,1994-95,30.0,12,26,47,47,11,15,26,116.0,,636,258,218,476,1902.0,84,6.48,76,407,2545,10.7,0.5295853
26409,26409,Sylvain Turgeon,1995-96,31.0,13,19,33,33,11,8,19,83.0,,669,269,226,495,1985.0,48,5.97,37,209,1408,10.2,0.5217635
26410,26410,T.J. Brennan,2012-13,23.0,2,1,11,11,1,0,1,14.0,155.0,11,1,0,1,14.0,82,5.32,47,271,2439,8.9,0.22076413
26411,26411,T.J. Brennan,2013-14,24.0,3,10,29,29,3,7,10,42.0,484.0,40,4,7,11,56.0,48,5.31,29,160,1399,9.1,0.2873373
26412,26412,T.J. Brennan,2015-16,26.0,4,1,6,6,0,1,1,11.0,101.0,46,4,8,12,67.0,82,5.32,47,251,2453,8.9,0.16984206
26413,26413,T.J. Brennan,2016-17,27.0,5,1,7,7,1,0,1,11.0,106.0,53,5,8,13,78.0,82,5.34,48,255,2438,9.0,0.17526117
26414,26414,T.J. Brodie,2011-12,21.0,2,0,3,3,0,0,0,1.0,48.0,3,0,0,0,1.0,82,5.46,52,291,2492,9.0,0.19391882
26415,26415,T.J. Brodie,2012-13,22.0,3,14,54,54,2,12,14,44.0,890.0,57,2,12,14,45.0,82,5.32,47,271,2439,8.9,0.22880313
26416,26416,T.J. Brodie,2013-14,23.0,4,14,47,47,2,12,14,44.0,950.0,104,4,24,28,89.0,48,5.31,29,160,1399,9.1,0.30278617
26417,26417,T.J. Brodie,2014-15,24.0,5,31,81,81,4,27,31,104.0,1949.0,185,8,51,59,193.0,82,5.34,48,269,2463,8.9,0.36302286
26418,26418,T.J. Brodie,2015-16,25.0,6,41,81,81,11,30,41,133.0,2042.0,266,19,81,100,326.0,82,5.32,47,251,2453,8.9,0.48823607
26419,26419,T.J. Brodie,2016-17,26.0,7,45,70,70,6,39,45,79.0,1768.0,336,25,120,145,405.0,82,5.34,48,255,2438,9.0,0.5458046
26420,26420,T.J. Brodie,2017-18,27.0,8,36,82,82,6,30,36,78.0,1934.0,418,31,150,181,483.0,82,5.45,47,245,2478,9.0,0.43014866
26421,26421,T.J. Brodie,2018-19,28.0,9,32,73,73,4,28,32,118.0,1729.0,491,35,178,213,601.0,82,5.86,50,250,2620,9.2,0.37782592
26422,26422,T.J. Brodie,2019-20,29.0,10,34,79,79,9,25,34,102.0,1696.0,570,44,203,247,703.0,82,5.96,47,239,2579,9.5,0.38843906
26423,26423,T.J. Brodie,2020-21,30.0,11,19,64,64,4,15,19,65.0,1309.0,634,48,218,266,768.0,70,5.96,42,208,2192,9.5,0.2764972
26424,26424,T.J. Galiardi,2009-10,21.0,2,4,11,11,3,1,4,14.0,180.0,11,3,1,4,14.0,82,5.7,65,341,2477,9.4,0.32821518
26425,26425,T.J. Galiardi,2010-11,22.0,3,39,70,70,15,24,39,120.0,1273.0,81,18,25,43,134.0,82,5.53,56,304,2486,9.1,0.5459696
26426,26426,T.J. Galiardi,2011-12,23.0,4,15,35,35,7,8,15,62.0,567.0,116,25,33,58,196.0,82,5.46,52,291,2492,9.0,0.39269105
26427,26427,T.J. Galiardi,2012-13,24.0,5,15,69,69,9,6,15,113.0,900.0,185,34,39,73,309.0,82,5.32,47,271,2439,8.9,0.3070255
26428,26428,T.J. Galiardi,2013-14,25.0,6,14,36,36,5,9,14,68.0,499.0,221,39,48,87,377.0,48,5.31,29,160,1399,9.1,0.3770946
26429,26429,T.J. Galiardi,2014-15,26.0,7,17,62,62,4,13,17,100.0,906.0,283,43,61,104,477.0,82,5.34,48,269,2463,8.9,0.25487155
26430,26430,T.J. Galiardi,2015-16,27.0,8,1,38,38,1,0,1,35.0,398.0,321,44,61,105,512.0,82,5.32,47,251,2453,8.9,0.17667735
26431,26431,T.J. Hensick,2008-09,23.0,2,11,31,31,6,5,11,52.0,372.0,31,6,5,11,52.0,82,5.44,62,351,2383,9.4,0.3262868
26432,26432,T.J. Hensick,2009-10,24.0,3,21,61,61,4,17,21,116.0,787.0,92,10,22,32,168.0,82,5.7,65,341,2477,9.4,0.3383517
26433,26433,T.J. Hensick,2010-11,25.0,4,3,7,7,1,2,3,13.0,66.0,99,11,24,35,181.0,82,5.53,56,304,2486,9.1,0.23041084
26434,26434,T.J. Hensick,2011-12,26.0,5,3,13,13,1,2,3,12.0,118.0,112,12,26,38,193.0,82,5.46,52,291,2492,9.0,0.22008815
26435,26435,T.J. Oshie,2009-10,23.0,2,39,57,57,14,25,39,101.0,945.0,57,14,25,39,101.0,82,5.7,65,341,2477,9.4,0.60700995
26436,26436,T.J. Oshie,2010-11,24.0,3,48,76,76,18,30,48,158.0,1392.0,133,32,55,87,259.0,82,5.53,56,304,2486,9.1,0.5760247
26437,26437,T.J. Oshie,2011-12,25.0,4,34,49,49,12,22,34,103.0,940.0,182,44,77,121,362.0,82,5.46,52,291,2492,9.0,0.55954766
26438,26438,T.J. Oshie,2012-13,26.0,5,54,80,80,19,35,54,188.0,1562.0,262,63,112,175,550.0,82,5.32,47,271,2439,8.9,0.7140002
26439,26439,T.J. Oshie,2013-14,27.0,6,20,30,30,7,13,20,65.0,573.0,292,70,125,195,615.0,48,5.31,29,160,1399,9.1,0.7082732
26440,26440,T.J. Oshie,2014-15,28.0,7,60,79,79,21,39,60,152.0,1500.0,371,91,164,255,767.0,82,5.34,48,269,2463,8.9,0.6520117
26441,26441,T.J. Oshie,2015-16,29.0,8,55,72,72,19,36,55,162.0,1356.0,443,110,200,310,929.0,82,5.32,47,251,2453,8.9,0.6941265
26442,26442,T.J. Oshie,2016-17,30.0,9,51,80,80,26,25,51,185.0,1517.0,523,136,225,361,1114.0,82,5.34,48,255,2438,9.0,0.64494973
26443,26443,T.J. Oshie,2017-18,31.0,10,56,68,68,33,23,56,143.0,1214.0,591,169,248,417,1257.0,82,5.45,47,245,2478,9.0,0.67911065
26444,26444,T.J. Oshie,2018-19,32.0,11,47,74,74,18,29,47,127.0,1362.0,665,187,277,464,1384.0,82,5.86,50,250,2620,9.2,0.546698
26445,26445,T.J. Oshie,2019-20,33.0,12,54,69,69,25,29,54,143.0,1284.0,734,212,306,518,1527.0,82,5.96,47,239,2579,9.5,0.6498643
26446,26446,T.J. Oshie,2020-21,34.0,13,49,69,69,26,23,49,133.0,1262.0,803,238,329,567,1660.0,70,5.96,42,208,2192,9.5,0.6291233
26447,26447,T.J. Tynan,2017-18,25.0,2,0,3,3,0,0,0,3.0,22.0,3,0,0,0,3.0,82,5.45,47,245,2478,9.0,0.17064324
26448,26448,T.J. Tynan,2020-21,28.0,3,1,16,16,0,1,1,7.0,136.0,19,0,1,1,10.0,70,5.96,42,208,2192,9.5,0.1709556
26449,26449,Tage Thompson,2018-19,21.0,2,9,41,41,3,6,9,55.0,489.0,41,3,6,9,55.0,82,5.86,50,250,2620,9.2,0.26350075
26450,26450,Tage Thompson,2019-20,22.0,3,12,65,65,7,5,12,108.0,788.0,106,10,11,21,163.0,82,5.96,47,239,2579,9.5,0.26583683
26451,26451,Tage Thompson,2020-21,23.0,4,0,1,1,0,0,0,0.0,7.0,107,10,11,21,163.0,70,5.96,42,208,2192,9.5,0.2281794
26452,26452,Tanner Fritz,2018-19,27.0,2,7,34,34,3,4,7,27.0,426.0,34,3,4,7,27.0,82,5.86,50,250,2620,9.2,0.20728058
26453,26453,Tanner Fritz,2019-20,28.0,3,1,8,8,0,1,1,6.0,87.0,42,3,5,8,33.0,82,5.96,47,239,2579,9.5,0.14988318
26454,26454,Tanner Glass,2008-09,25.0,2,2,41,41,1,1,2,11.0,181.0,41,1,1,2,11.0,82,5.44,62,351,2383,9.4,0.10699144
26455,26455,Tanner Glass,2009-10,26.0,3,0,3,3,0,0,0,1.0,20.0,44,1,1,2,12.0,82,5.7,65,341,2477,9.4,0.14100495
26456,26456,Tanner Glass,2010-11,27.0,4,11,67,67,4,7,11,52.0,702.0,111,5,8,13,64.0,82,5.53,56,304,2486,9.1,0.15179995
26457,26457,Tanner Glass,2011-12,28.0,5,10,73,73,3,7,10,45.0,652.0,184,8,15,23,109.0,82,5.46,52,291,2492,9.0,0.13632977
26458,26458,Tanner Glass,2012-13,29.0,6,16,78,78,5,11,16,86.0,1047.0,262,13,26,39,195.0,82,5.32,47,271,2439,8.9,0.19288298
26459,26459,Tanner Glass,2013-14,30.0,7,2,48,48,1,1,2,38.0,483.0,310,14,27,41,233.0,48,5.31,29,160,1399,9.1,0.12175223
26460,26460,Tanner Glass,2014-15,31.0,8,13,67,67,4,9,13,56.0,790.0,377,18,36,54,289.0,82,5.34,48,269,2463,8.9,0.14125603
26461,26461,Tanner Glass,2015-16,32.0,9,6,66,66,1,5,6,53.0,676.0,443,19,41,60,342.0,82,5.32,47,251,2453,8.9,0.1315268
26462,26462,Tanner Glass,2016-17,33.0,10,7,57,57,4,3,7,49.0,586.0,500,23,44,67,391.0,82,5.34,48,255,2438,9.0,0.12946427
26463,26463,Tanner Glass,2017-18,34.0,11,2,11,11,1,1,2,8.0,120.0,511,24,45,69,399.0,82,5.45,47,245,2478,9.0,0.13100952
26464,26464,Tanner Glass,2018-19,35.0,12,0,16,16,0,0,0,14.0,150.0,527,24,45,69,413.0,82,5.86,50,250,2620,9.2,0.13387987
26465,26465,Tanner Kero,2016-17,24.0,2,3,17,17,1,2,3,26.0,209.0,17,1,2,3,26.0,82,5.34,48,255,2438,9.0,0.22824627
26466,26466,Tanner Kero,2017-18,25.0,3,16,47,47,6,10,16,60.0,634.0,64,7,12,19,86.0,82,5.45,47,245,2478,9.0,0.31475618
26467,26467,Tanner Kero,2018-19,26.0,4,3,8,8,1,2,3,7.0,92.0,72,8,14,22,93.0,82,5.86,50,250,2620,9.2,0.21622184
26468,26468,Tanner Pearson,2014-15,22.0,2,7,25,25,3,4,7,31.0,270.0,25,3,4,7,31.0,82,5.34,48,269,2463,8.9,0.27091038
26469,26469,Tanner Pearson,2015-16,23.0,3,16,42,42,12,4,16,68.0,558.0,67,15,8,23,99.0,82,5.32,47,251,2453,8.9,0.38389254
26470,26470,Tanner Pearson,2016-17,24.0,4,36,79,79,15,21,36,137.0,1142.0,146,30,29,59,236.0,82,5.34,48,255,2438,9.0,0.43412217
26471,26471,Tanner Pearson,2017-18,25.0,5,44,80,80,24,20,44,187.0,1306.0,226,54,49,103,423.0,82,5.45,47,245,2478,9.0,0.57775146
26472,26472,Tanner Pearson,2018-19,26.0,6,40,82,82,15,25,40,180.0,1309.0,308,69,74,143,603.0,82,5.86,50,250,2620,9.2,0.5182066
26473,26473,Tanner Pearson,2019-20,27.0,7,27,80,80,18,9,27,147.0,1124.0,388,87,83,170,750.0,82,5.96,47,239,2579,9.5,0.41996557
26474,26474,Tanner Pearson,2020-21,28.0,8,45,69,69,21,24,45,164.0,1139.0,457,108,107,215,914.0,70,5.96,42,208,2192,9.5,0.5927548
26475,26475,Tanner Richard,2017-18,24.0,2,0,3,3,0,0,0,1.0,38.0,3,0,0,0,1.0,82,5.45,47,245,2478,9.0,0.17199877
26476,26476,Tapio Levo,1982-83,27.0,2,22,34,34,9,13,22,70.0,,34,9,13,22,70.0,80,8.03,73,320,2489,12.9,0.49001193
26477,26477,Tapio Levo,1983-84,28.0,3,47,73,73,7,40,47,187.0,,107,16,53,69,257.0,80,7.73,71,310,2444,12.7,0.5823768
26478,26478,Taro Hirose,2019-20,23.0,2,7,10,10,1,6,7,15.0,153.0,10,1,6,7,15.0,82,5.96,47,239,2579,9.5,0.25535873
26479,26479,Taro Hirose,2020-21,24.0,3,7,26,26,2,5,7,21.0,326.0,36,3,11,14,36.0,70,5.96,42,208,2192,9.5,0.26352328
26480,26480,Tavis Hansen,1995-96,20.0,2,0,1,1,0,0,0,0.0,,1,0,0,0,0.0,48,5.97,37,209,1408,10.2,0.23960996
26481,26481,Tavis Hansen,1997-98,22.0,3,0,1,1,0,0,0,0.0,,2,0,0,0,0.0,82,5.83,55,336,2444,9.8,0.15754849
26482,26482,Tavis Hansen,1999-00,24.0,4,3,20,20,2,1,3,14.0,162.0,22,2,1,3,14.0,82,5.27,57,359,2285,9.4,0.17093831
26483,26483,Tavis Hansen,2000-01,25.0,5,0,5,5,0,0,0,2.0,21.0,27,2,1,3,16.0,82,5.49,53,331,2294,9.8,0.1413146
26484,26484,Tavis Hansen,2001-02,26.0,6,0,7,7,0,0,0,2.0,36.0,34,2,1,3,18.0,82,5.51,63,376,2272,9.9,0.14932254
26485,26485,Taylor Beck,2013-14,22.0,2,7,16,16,3,4,7,39.0,258.0,16,3,4,7,39.0,48,5.31,29,160,1399,9.1,0.3571797
26486,26486,Taylor Beck,2014-15,23.0,3,0,7,7,0,0,0,9.0,90.0,23,3,4,7,48.0,82,5.34,48,269,2463,8.9,0.18762073
26487,26487,Taylor Beck,2015-16,24.0,4,16,62,62,8,8,16,78.0,740.0,85,11,12,23,126.0,82,5.32,47,251,2453,8.9,0.25955063
26488,26488,Taylor Beck,2016-17,25.0,5,0,2,2,0,0,0,0.0,17.0,87,11,12,23,126.0,82,5.34,48,255,2438,9.0,0.17419747
26489,26489,Taylor Beck,2017-18,26.0,6,0,5,5,0,0,0,5.0,44.0,92,11,12,23,131.0,82,5.45,47,245,2478,9.0,0.16909653
26490,26490,Taylor Chorney,2009-10,22.0,2,0,2,2,0,0,0,0.0,31.0,2,0,0,0,0.0,82,5.7,65,341,2477,9.4,0.17280087
26491,26491,Taylor Chorney,2010-11,23.0,3,3,42,42,0,3,3,35.0,730.0,44,0,3,3,35.0,82,5.53,56,304,2486,9.1,0.15547639
26492,26492,Taylor Chorney,2011-12,24.0,4,4,12,12,1,3,4,13.0,192.0,56,1,6,7,48.0,82,5.46,52,291,2492,9.0,0.19701928
26493,26493,Taylor Chorney,2012-13,25.0,5,0,5,5,0,0,0,2.0,71.0,61,1,6,7,50.0,82,5.32,47,271,2439,8.9,0.13709706
26494,26494,Taylor Chorney,2015-16,28.0,6,0,7,7,0,0,0,4.0,85.0,68,1,6,7,54.0,82,5.32,47,251,2453,8.9,0.12363127
26495,26495,Taylor Chorney,2016-17,29.0,7,6,55,55,1,5,6,28.0,726.0,123,2,11,13,82.0,82,5.34,48,255,2438,9.0,0.09500244
26496,26496,Taylor Chorney,2017-18,30.0,8,5,18,18,1,4,5,19.0,257.0,141,3,15,18,101.0,82,5.45,47,245,2478,9.0,0.15074956
26497,26497,Taylor Chorney,2018-19,31.0,9,4,25,25,1,3,4,14.0,328.0,166,4,18,22,115.0,82,5.86,50,250,2620,9.2,0.1008378
26498,26498,Taylor Fedun,2014-15,26.0,2,2,4,4,2,0,2,6.0,49.0,4,2,0,2,6.0,82,5.34,48,269,2463,8.9,0.21202925
26499,26499,Taylor Fedun,2015-16,27.0,3,4,7,7,0,4,4,12.0,119.0,11,2,4,6,18.0,82,5.32,47,251,2453,8.9,0.20979977
26500,26500,Taylor Fedun,2016-17,28.0,4,1,1,1,0,1,1,0.0,19.0,12,2,5,7,18.0,82,5.34,48,255,2438,9.0,0.1700533
26501,26501,Taylor Fedun,2017-18,29.0,5,7,27,27,0,7,7,24.0,361.0,39,2,12,14,42.0,82,5.45,47,245,2478,9.0,0.16610563
26502,26502,Taylor Fedun,2018-19,30.0,6,1,7,7,0,1,1,8.0,103.0,46,2,13,15,50.0,82,5.86,50,250,2620,9.2,0.13659137
26503,26503,Taylor Fedun,2019-20,31.0,7,11,54,54,4,7,11,86.0,748.0,100,6,20,26,136.0,82,5.96,47,239,2579,9.5,0.22411987
26504,26504,Taylor Fedun,2020-21,32.0,8,9,27,27,2,7,9,40.0,371.0,127,8,27,35,176.0,70,5.96,42,208,2192,9.5,0.24241853
26505,26505,Taylor Hall,1984-85,20.0,2,1,4,4,1,0,1,3.0,,4,1,0,1,3.0,80,7.89,74,336,2448,12.9,0.33002198
26506,26506,Taylor Hall,1985-86,21.0,3,5,7,7,1,4,5,14.0,,11,2,4,6,17.0,80,7.77,71,321,2447,12.7,0.3331457
26507,26507,Taylor Hall,1986-87,22.0,4,10,19,19,5,5,10,30.0,,30,7,9,16,47.0,80,7.94,82,370,2484,12.8,0.4071956
26508,26508,Taylor Hall,1987-88,23.0,5,0,4,4,0,0,0,1.0,,34,7,9,16,48.0,80,7.34,72,344,2400,12.2,0.22372806
26509,26509,Taylor Hall,1988-89,24.0,6,0,7,7,0,0,0,5.0,,41,7,9,16,53.0,80,7.43,89,437,2435,12.2,0.21680531
26510,26510,Taylor Hall0,2011-12,20.0,2,42,65,65,22,20,42,186.0,1184.0,65,22,20,42,186.0,82,5.46,52,291,2492,9.0,0.72366476
26511,26511,Taylor Hall0,2012-13,21.0,3,53,61,61,27,26,53,207.0,1111.0,126,49,46,95,393.0,82,5.32,47,271,2439,8.9,0.8785107
26512,26512,Taylor Hall0,2013-14,22.0,4,50,45,45,16,34,50,154.0,838.0,171,65,80,145,547.0,48,5.31,29,160,1399,9.1,1.086353
26513,26513,Taylor Hall0,2014-15,23.0,5,80,75,75,27,53,80,250.0,1501.0,246,92,133,225,797.0,82,5.34,48,269,2463,8.9,0.9334396
26514,26514,Taylor Hall0,2015-16,24.0,6,38,53,53,14,24,38,158.0,1019.0,299,106,157,263,955.0,82,5.32,47,251,2453,8.9,0.7950258
26515,26515,Taylor Hall0,2016-17,25.0,7,65,82,82,26,39,65,286.0,1575.0,381,132,196,328,1241.0,82,5.34,48,255,2438,9.0,0.84989214
26516,26516,Taylor Hall0,2017-18,26.0,8,53,72,72,20,33,53,238.0,1392.0,453,152,229,381,1479.0,82,5.45,47,245,2478,9.0,0.7981682
26517,26517,Taylor Hall0,2018-19,27.0,9,93,76,76,39,54,93,278.0,1455.0,529,191,283,474,1757.0,82,5.86,50,250,2620,9.2,1.0953867
26518,26518,Taylor Hall0,2019-20,28.0,10,37,33,33,11,26,37,113.0,650.0,562,202,309,511,1870.0,82,5.96,47,239,2579,9.5,0.79962265
26519,26519,Taylor Hall0,2020-21,29.0,11,52,65,65,16,36,52,232.0,1246.0,627,218,345,563,2102.0,70,5.96,42,208,2192,9.5,0.73072326
26520,26520,Taylor Leier,2016-17,22.0,2,0,6,6,0,0,0,3.0,46.0,6,0,0,0,3.0,82,5.34,48,255,2438,9.0,0.18558577
26521,26521,Taylor Leier,2017-18,23.0,3,2,10,10,1,1,2,7.0,91.0,16,1,1,2,10.0,82,5.45,47,245,2478,9.0,0.2072781
26522,26522,Taylor Leier,2018-19,24.0,4,5,39,39,1,4,5,48.0,409.0,55,2,5,7,58.0,82,5.86,50,250,2620,9.2,0.16564962
26523,26523,Taylor Pyatt,2001-02,20.0,2,18,78,78,4,14,18,86.0,954.0,78,4,14,18,86.0,82,5.51,63,376,2272,9.9,0.28344697
26524,26524,Taylor Pyatt,2002-03,21.0,3,20,48,48,10,10,20,61.0,648.0,126,14,24,38,147.0,82,5.24,53,338,2262,9.5,0.3863296
26525,26525,Taylor Pyatt,2003-04,22.0,4,28,78,78,14,14,28,110.0,1099.0,204,28,38,66,257.0,82,5.31,60,363,2326,9.4,0.41542926
26526,26526,Taylor Pyatt,2004-05,23.0,5,20,63,63,8,12,20,98.0,983.0,267,36,50,86,355.0,82,5.14,57,348,2300,9.2,0.46583053
26527,26527,Taylor Pyatt,2006-07,25.0,6,12,41,41,6,6,12,62.0,461.0,308,42,56,98,417.0,82,6.05,85,480,2458,10.1,0.2872207
26528,26528,Taylor Pyatt,2007-08,26.0,7,37,76,76,23,14,37,150.0,1061.0,384,65,70,135,567.0,82,5.76,70,398,2426,9.7,0.4899796
26529,26529,Taylor Pyatt,2008-09,27.0,8,37,79,79,16,21,37,167.0,1247.0,463,81,91,172,734.0,82,5.44,62,351,2383,9.4,0.48307273
26530,26530,Taylor Pyatt,2009-10,28.0,9,19,69,69,10,9,19,99.0,1015.0,532,91,100,191,833.0,82,5.7,65,341,2477,9.4,0.30995256
26531,26531,Taylor Pyatt,2010-11,29.0,10,23,74,74,12,11,23,121.0,996.0,606,103,111,214,954.0,82,5.53,56,304,2486,9.1,0.3096118
26532,26532,Taylor Pyatt,2011-12,30.0,11,31,76,76,18,13,31,126.0,1178.0,682,121,124,245,1080.0,82,5.46,52,291,2492,9.0,0.3571991
26533,26533,Taylor Pyatt,2012-13,31.0,12,19,73,73,9,10,19,111.0,899.0,755,130,134,264,1191.0,82,5.32,47,271,2439,8.9,0.2628212
26534,26534,Taylor Pyatt,2013-14,32.0,13,11,48,48,6,5,11,56.0,629.0,803,136,139,275,1247.0,48,5.31,29,160,1399,9.1,0.25234443
26535,26535,Taylor Pyatt,2014-15,33.0,14,5,56,56,4,1,5,52.0,648.0,859,140,140,280,1299.0,82,5.34,48,269,2463,8.9,0.15626511
26536,26536,Ted Crowley,1994-95,24.0,2,3,21,21,1,2,3,28.0,,21,1,2,3,28.0,84,6.48,76,407,2545,10.7,0.21243778
26537,26537,Ted Crowley,1999-00,29.0,3,3,13,13,1,2,3,20.0,140.0,34,2,4,6,48.0,82,5.27,57,359,2285,9.4,0.22563288
26538,26538,Ted Donato,1992-93,23.0,2,3,10,10,1,2,3,13.0,,10,1,2,3,13.0,80,6.96,77,402,2440,11.4,0.27089715
26539,26539,Ted Donato,1993-94,24.0,3,35,82,82,15,20,35,118.0,,92,16,22,38,131.0,84,7.25,87,443,2603,11.7,0.43467453
26540,26540,Ted Donato,1994-95,25.0,4,54,84,84,22,32,54,158.0,,176,38,54,92,289.0,84,6.48,76,407,2545,10.7,0.5237943
26541,26541,Ted Donato,1995-96,26.0,5,20,47,47,10,10,20,71.0,,223,48,64,112,360.0,48,5.97,37,209,1408,10.2,0.44648245
26542,26542,Ted Donato,1996-97,27.0,6,49,82,82,23,26,49,152.0,,305,71,90,161,512.0,82,6.29,74,413,2481,10.4,0.534373
26543,26543,Ted Donato,1997-98,28.0,7,51,67,67,25,26,51,172.0,,372,96,116,212,684.0,82,5.83,55,336,2444,9.8,0.62200063
26544,26544,Ted Donato,1998-99,29.0,8,39,79,79,16,23,39,129.0,,451,112,139,251,813.0,82,5.28,57,380,2242,9.6,0.47493696
26545,26545,Ted Donato,1999-00,30.0,9,27,82,82,11,16,27,106.0,1028.0,533,123,155,278,919.0,82,5.27,57,359,2285,9.4,0.3412004
26546,26546,Ted Donato,2000-01,31.0,10,30,81,81,11,19,30,138.0,1181.0,614,134,174,308,1057.0,82,5.49,53,331,2294,9.8,0.35267055
26547,26547,Ted Donato,2001-02,32.0,11,25,65,65,8,17,25,71.0,664.0,679,142,191,333,1128.0,82,5.51,63,376,2272,9.9,0.26657164
26548,26548,Ted Donato,2002-03,33.0,12,0,5,5,0,0,0,2.0,41.0,684,142,191,333,1130.0,82,5.24,53,338,2262,9.5,0.22337788
26549,26549,Ted Donato,2003-04,34.0,13,3,49,49,2,1,3,30.0,419.0,733,144,192,336,1160.0,82,5.31,60,363,2326,9.4,0.15171534
26550,26550,Ted Donato,2004-05,35.0,14,11,63,63,6,5,11,35.0,584.0,796,150,197,347,1195.0,82,5.14,57,348,2300,9.2,0.20416325
26551,26551,Ted Drury,1994-95,23.0,2,18,50,50,6,12,18,80.0,,50,6,12,18,80.0,84,6.48,76,407,2545,10.7,0.393914
26552,26552,Ted Drury,1995-96,24.0,3,9,34,34,3,6,9,31.0,,84,9,18,27,111.0,48,5.97,37,209,1408,10.2,0.273102
26553,26553,Ted Drury,1996-97,25.0,4,16,42,42,9,7,16,80.0,,126,18,25,43,191.0,82,6.29,74,413,2481,10.4,0.3448913
26554,26554,Ted Drury,1997-98,26.0,5,18,73,73,9,9,18,114.0,,199,27,34,61,305.0,82,5.83,55,336,2444,9.8,0.2784016
26555,26555,Ted Drury,1998-99,27.0,6,16,73,73,6,10,16,110.0,,272,33,44,77,415.0,82,5.28,57,380,2242,9.6,0.272286
26556,26556,Ted Drury,1999-00,28.0,7,11,75,75,5,6,11,79.0,619.0,347,38,50,88,494.0,82,5.27,57,359,2285,9.4,0.20813161
26557,26557,Ted Drury,2000-01,29.0,8,5,66,66,3,2,5,57.0,487.0,413,41,52,93,551.0,82,5.49,53,331,2294,9.8,0.15333644
26558,26558,Ted Drury,2001-02,30.0,9,0,1,1,0,0,0,3.0,15.0,414,41,52,93,554.0,82,5.51,63,376,2272,9.9,0.20014125
26559,26559,Ted Fauss,1987-88,26.0,2,1,15,15,0,1,1,4.0,,15,0,1,1,4.0,80,7.34,72,344,2400,12.2,0.21117628
26560,26560,Ted Fauss,1988-89,27.0,3,1,13,13,0,1,1,2.0,,28,0,2,2,6.0,80,7.43,89,437,2435,12.2,0.1801405
26561,26561,Ted Nolan,1982-83,24.0,2,17,41,41,4,13,17,67.0,,41,4,13,17,67.0,80,8.03,73,320,2489,12.9,0.35600677
26562,26562,Ted Nolan,1984-85,26.0,3,3,19,19,1,2,3,15.0,,60,5,15,20,82.0,80,7.89,74,336,2448,12.9,0.22514385
26563,26563,Ted Nolan,1986-87,28.0,4,2,18,18,1,1,2,17.0,,78,6,16,22,99.0,80,7.94,82,370,2484,12.8,0.23828703
26564,26564,Ted Speers,1986-87,26.0,2,2,4,4,1,1,2,6.0,,4,1,1,2,6.0,80,7.94,82,370,2484,12.8,0.2541719
26565,26565,Teddy Blueger,2019-20,25.0,2,10,28,28,6,4,10,33.0,310.0,28,6,4,10,33.0,82,5.96,47,239,2579,9.5,0.27121145
26566,26566,Teddy Blueger,2020-21,26.0,3,22,69,69,9,13,22,102.0,1091.0,97,15,17,32,135.0,70,5.96,42,208,2192,9.5,0.33060387
26567,26567,Teddy Purcell,2008-09,23.0,2,3,10,10,1,2,3,10.0,120.0,10,1,2,3,10.0,82,5.44,62,351,2383,9.4,0.24406257
26568,26568,Teddy Purcell,2009-10,24.0,3,16,40,40,4,12,16,68.0,541.0,50,5,14,19,78.0,82,5.7,65,341,2477,9.4,0.34038955
26569,26569,Teddy Purcell,2010-11,25.0,4,15,60,60,6,9,15,101.0,772.0,110,11,23,34,179.0,82,5.53,56,304,2486,9.1,0.28664386
26570,26570,Teddy Purcell,2011-12,26.0,5,51,81,81,17,34,51,196.0,1142.0,191,28,57,85,375.0,82,5.46,52,291,2492,9.0,0.58601356
26571,26571,Teddy Purcell,2012-13,27.0,6,65,81,81,24,41,65,152.0,1307.0,272,52,98,150,527.0,82,5.32,47,271,2439,8.9,0.71311647
26572,26572,Teddy Purcell,2013-14,28.0,7,36,48,48,11,25,36,94.0,804.0,320,63,123,186,621.0,48,5.31,29,160,1399,9.1,0.6163508
26573,26573,Teddy Purcell,2014-15,29.0,8,42,81,81,12,30,42,157.0,1334.0,401,75,153,228,778.0,82,5.34,48,269,2463,8.9,0.486925
26574,26574,Teddy Purcell,2015-16,30.0,9,34,82,82,12,22,34,146.0,1407.0,483,87,175,262,924.0,82,5.32,47,251,2453,8.9,0.39917108
26575,26575,Teddy Purcell,2016-17,31.0,10,43,76,76,14,29,43,149.0,1279.0,559,101,204,305,1073.0,82,5.34,48,255,2438,9.0,0.5052672
26576,26576,Teddy Purcell,2017-18,32.0,11,2,12,12,0,2,2,10.0,155.0,571,101,206,307,1083.0,82,5.45,47,245,2478,9.0,0.2377347
26577,26577,Teemu Hartikainen,2011-12,21.0,2,5,12,12,3,2,5,21.0,209.0,12,3,2,5,21.0,82,5.46,52,291,2492,9.0,0.3365469
26578,26578,Teemu Hartikainen,2012-13,22.0,3,5,17,17,2,3,5,24.0,221.0,29,5,5,10,45.0,82,5.32,47,271,2439,8.9,0.29489517
26579,26579,Teemu Hartikainen,2013-14,23.0,4,3,23,23,1,2,3,21.0,243.0,52,6,7,13,66.0,48,5.31,29,160,1399,9.1,0.22959846
26580,26580,Teemu Laakso,2010-11,23.0,2,0,7,7,0,0,0,5.0,76.0,7,0,0,0,5.0,82,5.53,56,304,2486,9.1,0.17674801
26581,26581,Teemu Laakso,2011-12,24.0,3,0,1,1,0,0,0,0.0,3.0,8,0,0,0,5.0,82,5.46,52,291,2492,9.0,0.151768
26582,26582,Teemu Laakso,2012-13,25.0,4,0,9,9,0,0,0,4.0,104.0,17,0,0,0,9.0,82,5.32,47,271,2439,8.9,0.14976585
26583,26583,Teemu Pulkkinen,2014-15,23.0,2,0,3,3,0,0,0,4.0,22.0,3,0,0,0,4.0,82,5.34,48,269,2463,8.9,0.17318648
26584,26584,Teemu Pulkkinen,2015-16,24.0,3,8,31,31,5,3,8,67.0,356.0,34,5,3,8,71.0,82,5.32,47,251,2453,8.9,0.27163148
26585,26585,Teemu Pulkkinen,2016-17,25.0,4,12,36,36,6,6,12,65.0,416.0,70,11,9,20,136.0,82,5.34,48,255,2438,9.0,0.27437785
26586,26586,Teemu Pulkkinen,2017-18,26.0,5,2,13,13,2,0,2,10.0,124.0,83,13,9,22,146.0,82,5.45,47,245,2478,9.0,0.2398071
26587,26587,Teemu Selanne,1993-94,23.0,2,132,84,84,76,56,132,387.0,,84,76,56,132,387.0,84,7.25,87,443,2603,11.7,1.1050856
26588,26588,Teemu Selanne,1994-95,24.0,3,54,51,51,25,29,54,191.0,,135,101,85,186,578.0,84,6.48,76,407,2545,10.7,0.9128307
26589,26589,Teemu Selanne,1995-96,25.0,4,48,45,45,22,26,48,167.0,,180,123,111,234,745.0,48,5.97,37,209,1408,10.2,1.1913356
26590,26590,Teemu Selanne,1996-97,26.0,5,108,79,79,40,68,108,267.0,,259,163,179,342,1012.0,82,6.29,74,413,2481,10.4,1.1617608
26591,26591,Teemu Selanne,1997-98,27.0,6,109,78,78,51,58,109,273.0,,337,214,237,451,1285.0,82,5.83,55,336,2444,9.8,1.2424107
26592,26592,Teemu Selanne,1998-99,28.0,7,86,73,73,52,34,86,268.0,,410,266,271,537,1553.0,82,5.28,57,380,2242,9.6,1.0986652
26593,26593,Teemu Selanne,1999-00,29.0,8,107,75,75,47,60,107,281.0,1709.0,485,313,331,644,1834.0,82,5.27,57,359,2285,9.4,1.1437825
26594,26594,Teemu Selanne,2000-01,30.0,9,85,79,79,33,52,85,236.0,1795.0,564,346,383,729,2070.0,82,5.49,53,331,2294,9.8,1.0381134
26595,26595,Teemu Selanne,2001-02,31.0,10,72,73,73,33,39,72,233.0,1552.0,637,379,422,801,2303.0,82,5.51,63,376,2272,9.9,0.8594291
26596,26596,Teemu Selanne,2002-03,32.0,11,54,82,82,29,25,54,202.0,1392.0,719,408,447,855,2505.0,82,5.24,53,338,2262,9.5,0.74559987
26597,26597,Teemu Selanne,2003-04,33.0,12,64,82,82,28,36,64,253.0,1577.0,801,436,483,919,2758.0,82,5.31,60,363,2326,9.4,0.81124353
26598,26598,Teemu Selanne,2004-05,34.0,13,32,78,78,16,16,32,182.0,1261.0,879,452,499,951,2940.0,82,5.14,57,348,2300,9.2,0.80252606
26599,26599,Teemu Selanne,2006-07,36.0,14,90,80,80,40,50,90,267.0,1424.0,959,492,549,1041,3207.0,82,6.05,85,480,2458,10.1,1.0226812
26600,26600,Teemu Selanne,2007-08,37.0,15,94,82,82,48,46,94,257.0,1451.0,1041,540,595,1135,3464.0,82,5.76,70,398,2426,9.7,0.95267177
26601,26601,Teemu Selanne,2008-09,38.0,16,23,26,26,12,11,23,87.0,471.0,1067,552,606,1158,3551.0,82,5.44,62,351,2383,9.4,0.8188727
26602,26602,Teemu Selanne,2009-10,39.0,17,54,65,65,27,27,54,186.0,1072.0,1132,579,633,1212,3737.0,82,5.7,65,341,2477,9.4,0.7752489
26603,26603,Teemu Selanne,2010-11,40.0,18,48,54,54,27,21,48,173.0,935.0,1186,606,654,1260,3910.0,82,5.53,56,304,2486,9.1,0.8485437
26604,26604,Teemu Selanne,2011-12,41.0,19,80,73,73,31,49,80,213.0,1310.0,1259,637,703,1340,4123.0,82,5.46,52,291,2492,9.0,0.79011506
26605,26605,Teemu Selanne,2012-13,42.0,20,66,82,82,26,40,66,210.0,1466.0,1341,663,743,1406,4333.0,82,5.32,47,271,2439,8.9,0.66305286
26606,26606,Teemu Selanne,2013-14,43.0,21,24,46,46,12,12,24,96.0,722.0,1387,675,755,1430,4429.0,48,5.31,29,160,1399,9.1,0.4768485
26607,26607,Teemu Selanne,2014-15,44.0,22,27,64,64,9,18,27,111.0,904.0,1451,684,773,1457,4540.0,82,5.34,48,269,2463,8.9,0.39025518
26608,26608,Teppo Numminen,1989-90,21.0,2,15,69,69,1,14,15,85.0,,69,1,14,15,85.0,80,7.48,85,403,2430,12.3,0.3405376
26609,26609,Teppo Numminen,1990-91,22.0,3,43,79,79,11,32,43,105.0,,148,12,46,58,190.0,80,7.37,76,367,2421,12.2,0.5070614
26610,26610,Teppo Numminen,1991-92,23.0,4,33,80,80,8,25,33,151.0,,228,20,71,91,341.0,80,6.91,71,366,2385,11.6,0.48446158
26611,26611,Teppo Numminen,1992-93,24.0,5,39,80,80,5,34,39,143.0,,308,25,105,130,484.0,80,6.96,77,402,2440,11.4,0.5132408
26612,26612,Teppo Numminen,1993-94,25.0,6,37,66,66,7,30,37,103.0,,374,32,135,167,587.0,84,7.25,87,443,2603,11.7,0.4973117
26613,26613,Teppo Numminen,1994-95,26.0,7,23,57,57,5,18,23,89.0,,431,37,153,190,676.0,84,6.48,76,407,2545,10.7,0.37480235
26614,26614,Teppo Numminen,1995-96,27.0,8,21,42,42,5,16,21,86.0,,473,42,169,211,762.0,48,5.97,37,209,1408,10.2,0.48413315
26615,26615,Teppo Numminen,1996-97,28.0,9,54,74,74,11,43,54,165.0,,547,53,212,265,927.0,82,6.29,74,413,2481,10.4,0.57692206
26616,26616,Teppo Numminen,1997-98,29.0,10,27,82,82,2,25,27,135.0,,629,55,237,292,1062.0,82,5.83,55,336,2444,9.8,0.35293126
26617,26617,Teppo Numminen,1998-99,30.0,11,51,82,82,11,40,51,126.0,,711,66,277,343,1188.0,82,5.28,57,380,2242,9.6,0.5240887
26618,26618,Teppo Numminen,1999-00,31.0,12,40,82,82,10,30,40,156.0,2004.0,793,76,307,383,1344.0,82,5.27,57,359,2285,9.4,0.46727908
26619,26619,Teppo Numminen,2000-01,32.0,13,42,79,79,8,34,42,126.0,1866.0,872,84,341,425,1470.0,82,5.49,53,331,2294,9.8,0.48480213
26620,26620,Teppo Numminen,2001-02,33.0,14,31,72,72,5,26,31,109.0,1762.0,944,89,367,456,1579.0,82,5.51,63,376,2272,9.9,0.35424268
26621,26621,Teppo Numminen,2002-03,34.0,15,48,76,76,13,35,48,117.0,1813.0,1020,102,402,504,1696.0,82,5.24,53,338,2262,9.5,0.5274932
26622,26622,Teppo Numminen,2003-04,35.0,16,30,78,78,6,24,30,108.0,1861.0,1098,108,426,534,1804.0,82,5.31,60,363,2326,9.4,0.3448757
26623,26623,Teppo Numminen,2004-05,36.0,17,17,62,62,3,14,17,83.0,1343.0,1160,111,440,551,1887.0,82,5.14,57,348,2300,9.2,0.34561604
26624,26624,Teppo Numminen,2006-07,38.0,18,40,75,75,2,38,40,60.0,1463.0,1235,113,478,591,1947.0,82,6.05,85,480,2458,10.1,0.35656685
26625,26625,Teppo Numminen,2007-08,39.0,19,29,79,79,2,27,29,69.0,1643.0,1314,115,505,620,2016.0,82,5.76,70,398,2426,9.7,0.24281958
26626,26626,Teppo Numminen,2008-09,40.0,20,0,1,1,0,0,0,1.0,16.0,1315,115,505,620,2017.0,82,5.44,62,351,2383,9.4,0.2928558
26627,26627,Teppo Numminen,2009-10,41.0,21,17,57,57,2,15,17,34.0,998.0,1372,117,520,637,2051.0,82,5.7,65,341,2477,9.4,0.23081243
26628,26628,Terran Sandwith,1998-99,26.0,2,0,8,8,0,0,0,4.0,,8,0,0,0,4.0,82,5.28,57,380,2242,9.6,0.16391367
26629,26629,Terry Carkner,1987-88,21.0,2,15,52,52,2,13,15,33.0,,52,2,13,15,33.0,80,7.34,72,344,2400,12.2,0.34197462
26630,26630,Terry Carkner,1988-89,22.0,3,27,63,63,3,24,27,54.0,,115,5,37,42,87.0,80,7.43,89,437,2435,12.2,0.4043099
26631,26631,Terry Carkner,1989-90,23.0,4,43,78,78,11,32,43,84.0,,193,16,69,85,171.0,80,7.48,85,403,2430,12.3,0.48732027
26632,26632,Terry Carkner,1990-91,24.0,5,22,63,63,4,18,22,60.0,,256,20,87,107,231.0,80,7.37,76,367,2421,12.2,0.3172586
26633,26633,Terry Carkner,1991-92,25.0,6,32,79,79,7,25,32,97.0,,335,27,112,139,328.0,80,6.91,71,366,2385,11.6,0.47428477
26634,26634,Terry Carkner,1992-93,26.0,7,16,73,73,4,12,16,70.0,,408,31,124,155,398.0,80,6.96,77,402,2440,11.4,0.247684
26635,26635,Terry Carkner,1993-94,27.0,8,19,83,83,3,16,19,45.0,,491,34,140,174,443.0,84,7.25,87,443,2603,11.7,0.22625357
26636,26636,Terry Carkner,1994-95,28.0,9,7,68,68,1,6,7,32.0,,559,35,146,181,475.0,84,6.48,76,407,2545,10.7,0.17112812
26637,26637,Terry Carkner,1995-96,29.0,10,3,20,20,1,2,3,9.0,,579,36,148,184,484.0,48,5.97,37,209,1408,10.2,0.20515695
26638,26638,Terry Carkner,1996-97,30.0,11,13,73,73,3,10,13,42.0,,652,39,158,197,526.0,82,6.29,74,413,2481,10.4,0.17039499
26639,26639,Terry Carkner,1997-98,31.0,12,14,70,70,0,14,14,38.0,,722,39,172,211,564.0,82,5.83,55,336,2444,9.8,0.147755
26640,26640,Terry Carkner,1998-99,32.0,13,8,74,74,1,7,8,34.0,,796,40,179,219,598.0,82,5.28,57,380,2242,9.6,0.12129903
26641,26641,Terry Carkner,1999-00,33.0,14,11,62,62,2,9,11,25.0,1130.0,858,42,188,230,623.0,82,5.27,57,359,2285,9.4,0.13017228
26642,26642,Terry Hollinger,1994-95,23.0,2,0,2,2,0,0,0,0.0,,2,0,0,0,0.0,84,6.48,76,407,2545,10.7,0.16312629
26643,26643,Terry Hollinger,1995-96,24.0,3,0,5,5,0,0,0,1.0,,7,0,0,0,1.0,48,5.97,37,209,1408,10.2,0.18465382
26644,26644,Terry Johnson,1980-81,22.0,2,0,3,3,0,0,0,0.0,,3,0,0,0,0.0,80,7.03,61,280,2352,12.0,0.1900217
26645,26645,Terry Johnson,1981-82,23.0,3,1,13,13,0,1,1,5.0,,16,0,1,1,5.0,80,7.69,77,340,2441,12.6,0.21074548
26646,26646,Terry Johnson,1982-83,24.0,4,1,6,6,0,1,1,0.0,,22,0,2,2,5.0,80,8.03,73,320,2489,12.9,0.19686997
26647,26647,Terry Johnson,1983-84,25.0,5,0,3,3,0,0,0,0.0,,25,0,2,2,5.0,80,7.73,71,310,2444,12.7,0.16543528
26648,26648,Terry Johnson,1984-85,26.0,6,8,65,65,2,6,8,36.0,,90,2,8,10,41.0,80,7.89,74,336,2448,12.9,0.17569306
26649,26649,Terry Johnson,1985-86,27.0,7,7,74,74,0,7,7,39.0,,164,2,15,17,80.0,80,7.77,71,321,2447,12.7,0.12749907
26650,26650,Terry Johnson,1986-87,28.0,8,9,73,73,1,8,9,32.0,,237,3,23,26,112.0,80,7.94,82,370,2484,12.8,0.11172664
26651,26651,Terry Johnson,1987-88,29.0,9,1,48,48,0,1,1,11.0,,285,3,24,27,123.0,80,7.34,72,344,2400,12.2,0.06788686
26652,26652,Terry Ruskowski,1980-81,26.0,2,70,74,74,15,55,70,88.0,,74,15,55,70,88.0,80,7.03,61,280,2352,12.0,0.8281545
26653,26653,Terry Ruskowski,1981-82,27.0,3,59,72,72,8,51,59,88.0,,146,23,106,129,176.0,80,7.69,77,340,2441,12.6,0.708549
26654,26654,Terry Ruskowski,1982-83,28.0,4,37,60,60,7,30,37,69.0,,206,30,136,166,245.0,80,8.03,73,320,2489,12.9,0.5863293
26655,26655,Terry Ruskowski,1983-84,29.0,5,46,76,76,14,32,46,74.0,,282,44,168,212,319.0,80,7.73,71,310,2444,12.7,0.52699864
26656,26656,Terry Ruskowski,1984-85,30.0,6,32,77,77,7,25,32,51.0,,359,51,193,244,370.0,80,7.89,74,336,2448,12.9,0.45149744
26657,26657,Terry Ruskowski,1985-86,31.0,7,49,78,78,16,33,49,75.0,,437,67,226,293,445.0,80,7.77,71,321,2447,12.7,0.57201654
26658,26658,Terry Ruskowski,1986-87,32.0,8,63,72,72,26,37,63,92.0,,509,93,263,356,537.0,80,7.94,82,370,2484,12.8,0.7132926
26659,26659,Terry Ruskowski,1987-88,33.0,9,51,70,70,14,37,51,71.0,,579,107,300,407,608.0,80,7.34,72,344,2400,12.2,0.58724195
26660,26660,Terry Ruskowski,1988-89,34.0,10,17,47,47,5,12,17,33.0,,626,112,312,424,641.0,80,7.43,89,437,2435,12.2,0.3748709
26661,26661,Terry Ruskowski,1989-90,35.0,11,2,3,3,1,1,2,2.0,,629,113,313,426,643.0,80,7.48,85,403,2430,12.3,0.3221617
26662,26662,Terry Ryan,1997-98,21.0,2,0,3,3,0,0,0,0.0,,3,0,0,0,0.0,82,5.83,55,336,2444,9.8,0.18399191
26663,26663,Terry Ryan,1998-99,22.0,3,0,4,4,0,0,0,0.0,,7,0,0,0,0.0,82,5.28,57,380,2242,9.6,0.15000686
26664,26664,Terry Ryan,1999-00,23.0,4,0,1,1,0,0,0,0.0,3.0,8,0,0,0,0.0,82,5.27,57,359,2285,9.4,0.16100687
26665,26665,Terry Virtue,1999-00,29.0,2,0,4,4,0,0,0,2.0,39.0,4,0,0,0,2.0,82,5.27,57,359,2285,9.4,0.16840225
26666,26666,Terry Virtue,2000-01,30.0,3,0,1,1,0,0,0,2.0,13.0,5,0,0,0,4.0,82,5.49,53,331,2294,9.8,0.13522857
26667,26667,Terry Yake,1989-90,21.0,2,0,2,2,0,0,0,0.0,,2,0,0,0,0.0,80,7.48,85,403,2430,12.3,0.20433158
26668,26668,Terry Yake,1990-91,22.0,3,1,2,2,0,1,1,2.0,,4,0,1,1,2.0,80,7.37,76,367,2421,12.2,0.23196071
26669,26669,Terry Yake,1991-92,23.0,4,5,19,19,1,4,5,19.0,,23,1,5,6,21.0,80,6.91,71,366,2385,11.6,0.22340298
26670,26670,Terry Yake,1992-93,24.0,5,2,15,15,1,1,2,12.0,,38,2,6,8,33.0,80,6.96,77,402,2440,11.4,0.238962
26671,26671,Terry Yake,1993-94,25.0,6,53,66,66,22,31,53,98.0,,104,24,37,61,131.0,84,7.25,87,443,2603,11.7,0.5915537
26672,26672,Terry Yake,1994-95,26.0,7,52,82,82,21,31,52,188.0,,186,45,68,113,319.0,84,6.48,76,407,2545,10.7,0.5294519
26673,26673,Terry Yake,1995-96,27.0,8,5,19,19,3,2,5,26.0,,205,48,70,118,345.0,48,5.97,37,209,1408,10.2,0.35779127
26674,26674,Terry Yake,1998-99,30.0,9,25,65,65,10,15,25,60.0,,270,58,85,143,405.0,82,5.28,57,380,2242,9.6,0.3053996
26675,26675,Terry Yake,1999-00,31.0,10,27,60,60,9,18,27,59.0,890.0,330,67,103,170,464.0,82,5.27,57,359,2285,9.4,0.34786776
26676,26676,Terry Yake,2000-01,32.0,11,24,61,61,10,14,24,55.0,801.0,391,77,117,194,519.0,82,5.49,53,331,2294,9.8,0.3155091
26677,26677,Terry Yake,2001-02,33.0,12,3,12,12,0,3,3,13.0,146.0,403,77,120,197,532.0,82,5.51,63,376,2272,9.9,0.24117473
26678,26678,Teuvo Teravainen,2014-15,20.0,2,0,3,3,0,0,0,4.0,42.0,3,0,0,0,4.0,82,5.34,48,269,2463,8.9,0.25039017
26679,26679,Teuvo Teravainen,2015-16,21.0,3,9,34,34,4,5,9,66.0,435.0,37,4,5,9,70.0,82,5.32,47,251,2453,8.9,0.31660414
26680,26680,Teuvo Teravainen,2016-17,22.0,4,35,78,78,13,22,35,136.0,1197.0,115,17,27,44,206.0,82,5.34,48,255,2438,9.0,0.48078158
26681,26681,Teuvo Teravainen,2017-18,23.0,5,42,81,81,15,27,42,169.0,1315.0,196,32,54,86,375.0,82,5.45,47,245,2478,9.0,0.5580127
26682,26682,Teuvo Teravainen,2018-19,24.0,6,64,82,82,23,41,64,185.0,1385.0,278,55,95,150,560.0,82,5.86,50,250,2620,9.2,0.753336
26683,26683,Teuvo Teravainen,2019-20,25.0,7,76,82,82,21,55,76,167.0,1469.0,360,76,150,226,727.0,82,5.96,47,239,2579,9.5,0.819865
26684,26684,Teuvo Teravainen,2020-21,26.0,8,63,68,68,15,48,63,182.0,1305.0,428,91,198,289,909.0,70,5.96,42,208,2192,9.5,0.8830137
26685,26685,Theo Peckham,2008-09,21.0,2,0,1,1,0,0,0,0.0,13.0,1,0,0,0,0.0,82,5.44,62,351,2383,9.4,0.20099464
26686,26686,Theo Peckham,2009-10,22.0,3,0,15,15,0,0,0,8.0,174.0,16,0,0,0,8.0,82,5.7,65,341,2477,9.4,0.14806238
26687,26687,Theo Peckham,2010-11,23.0,4,1,15,15,0,1,1,9.0,241.0,31,0,1,1,17.0,82,5.53,56,304,2486,9.1,0.16846651
26688,26688,Theo Peckham,2011-12,24.0,5,13,71,71,3,10,13,41.0,1320.0,102,3,11,14,58.0,82,5.46,52,291,2492,9.0,0.16610366
26689,26689,Theo Peckham,2012-13,25.0,6,3,54,54,1,2,3,25.0,911.0,156,4,13,17,83.0,82,5.32,47,271,2439,8.9,0.10261023
26690,26690,Theo Peckham,2013-14,26.0,7,0,4,4,0,0,0,2.0,71.0,160,4,13,17,85.0,48,5.31,29,160,1399,9.1,0.14584172
26691,26691,Theoren Fleury,1989-90,21.0,2,34,36,36,14,20,34,89.0,,36,14,20,34,89.0,80,7.48,85,403,2430,12.3,0.7477322
26692,26692,Theoren Fleury,1990-91,22.0,3,66,80,80,31,35,66,200.0,,116,45,55,100,289.0,80,7.37,76,367,2421,12.2,0.94131345
26693,26693,Theoren Fleury,1991-92,23.0,4,104,79,79,51,53,104,249.0,,195,96,108,204,538.0,80,6.91,71,366,2385,11.6,1.2352469
26694,26694,Theoren Fleury,1992-93,24.0,5,73,80,80,33,40,73,225.0,,275,129,148,277,763.0,80,6.96,77,402,2440,11.4,0.9623755
26695,26695,Theoren Fleury,1993-94,25.0,6,100,83,83,34,66,100,250.0,,358,163,214,377,1013.0,84,7.25,87,443,2603,11.7,1.0540116
26696,26696,Theoren Fleury,1994-95,26.0,7,85,83,83,40,45,85,278.0,,441,203,259,462,1291.0,84,6.48,76,407,2545,10.7,0.96654975
26697,26697,Theoren Fleury,1995-96,27.0,8,58,47,47,29,29,58,173.0,,488,232,288,520,1464.0,48,5.97,37,209,1408,10.2,1.1127639
26698,26698,Theoren Fleury,1996-97,28.0,9,96,80,80,46,50,96,353.0,,568,278,338,616,1817.0,82,6.29,74,413,2481,10.4,1.0061245
26699,26699,Theoren Fleury,1997-98,29.0,10,67,81,81,29,38,67,336.0,,649,307,376,683,2153.0,82,5.83,55,336,2444,9.8,0.8655342
26700,26700,Theoren Fleury,1998-99,30.0,11,78,82,82,27,51,78,282.0,,731,334,427,761,2435.0,82,5.28,57,380,2242,9.6,0.9174176
26701,26701,Theoren Fleury,1999-00,31.0,12,93,75,75,40,53,93,301.0,1751.0,806,374,480,854,2736.0,82,5.27,57,359,2285,9.4,1.0755641
26702,26702,Theoren Fleury,2000-01,32.0,13,64,80,80,15,49,64,246.0,1575.0,886,389,529,918,2982.0,82,5.49,53,331,2294,9.8,0.8347037
26703,26703,Theoren Fleury,2001-02,33.0,14,74,62,62,30,44,74,238.0,1351.0,948,419,573,992,3220.0,82,5.51,63,376,2272,9.9,0.9910735
26704,26704,Theoren Fleury,2002-03,34.0,15,63,82,82,24,39,63,267.0,1706.0,1030,443,612,1055,3487.0,82,5.24,53,338,2262,9.5,0.7389414
26705,26705,Theoren Fleury,2003-04,35.0,16,33,54,54,12,21,33,124.0,904.0,1084,455,633,1088,3611.0,82,5.31,60,363,2326,9.4,0.627793
26706,26706,Thomas Chabot,2017-18,21.0,2,0,1,1,0,0,0,1.0,7.0,1,0,0,0,1.0,82,5.45,47,245,2478,9.0,0.23246074
26707,26707,Thomas Chabot,2018-19,22.0,3,25,63,63,9,16,25,94.0,1103.0,64,9,16,25,95.0,82,5.86,50,250,2620,9.2,0.4001355
26708,26708,Thomas Chabot,2019-20,23.0,4,55,70,70,14,41,55,185.0,1700.0,134,23,57,80,280.0,82,5.96,47,239,2579,9.5,0.6933433
26709,26709,Thomas Chabot,2020-21,24.0,5,39,71,71,6,33,39,186.0,1846.0,205,29,90,119,466.0,70,5.96,42,208,2192,9.5,0.57886237
26710,26710,Thomas Di Pauli,2020-21,26.0,2,0,2,2,0,0,0,2.0,12.0,2,0,0,0,2.0,70,5.96,42,208,2192,9.5,0.19076866
26711,26711,Thomas Eriksson,1981-82,22.0,2,11,24,24,1,10,11,49.0,,24,1,10,11,49.0,80,7.69,77,340,2441,12.6,0.30752772
26712,26712,Thomas Eriksson,1982-83,23.0,3,0,1,1,0,0,0,0.0,,25,1,10,11,49.0,80,8.03,73,320,2489,12.9,0.2314623
26713,26713,Thomas Eriksson,1984-85,25.0,4,44,68,68,11,33,44,108.0,,93,12,43,55,157.0,80,7.89,74,336,2448,12.9,0.51819515
26714,26714,Thomas Eriksson,1985-86,26.0,5,39,72,72,10,29,39,127.0,,165,22,72,94,284.0,80,7.77,71,321,2447,12.7,0.47367376
26715,26715,Thomas Eriksson,1986-87,27.0,6,4,43,43,0,4,4,33.0,,208,22,76,98,317.0,80,7.94,82,370,2484,12.8,0.20809981
26716,26716,Thomas Hickey,2013-14,24.0,2,4,39,39,1,3,4,40.0,658.0,39,1,3,4,40.0,48,5.31,29,160,1399,9.1,0.18119717
26717,26717,Thomas Hickey,2014-15,25.0,3,22,82,82,4,18,22,96.0,1547.0,121,5,21,26,136.0,82,5.34,48,269,2463,8.9,0.25519866
26718,26718,Thomas Hickey,2015-16,26.0,4,22,81,81,2,20,22,82.0,1533.0,202,7,41,48,218.0,82,5.32,47,251,2453,8.9,0.23901358
26719,26719,Thomas Hickey,2016-17,27.0,5,18,62,62,6,12,18,55.0,1079.0,264,13,53,66,273.0,82,5.34,48,255,2438,9.0,0.2504537
26720,26720,Thomas Hickey,2017-18,28.0,6,20,76,76,4,16,20,87.0,1331.0,340,17,69,86,360.0,82,5.45,47,245,2478,9.0,0.23809001
26721,26721,Thomas Hickey,2018-19,29.0,7,25,69,69,5,20,25,87.0,1247.0,409,22,89,111,447.0,82,5.86,50,250,2620,9.2,0.30278128
26722,26722,Thomas Hickey,2019-20,30.0,8,4,40,40,0,4,4,47.0,740.0,449,22,93,115,494.0,82,5.96,47,239,2579,9.5,0.19600922
26723,26723,Thomas Pock,2004-05,23.0,2,4,6,6,2,2,4,8.0,112.0,6,2,2,4,8.0,82,5.14,57,348,2300,9.2,0.28230214
26724,26724,Thomas Pock,2006-07,25.0,3,2,8,8,1,1,2,15.0,121.0,14,3,3,6,23.0,82,6.05,85,480,2458,10.1,0.19632575
26725,26725,Thomas Pock,2007-08,26.0,4,8,44,44,4,4,8,76.0,714.0,58,7,7,14,99.0,82,5.76,70,398,2426,9.7,0.21224448
26726,26726,Thomas Pock,2008-09,27.0,5,0,1,1,0,0,0,2.0,19.0,59,7,7,14,101.0,82,5.44,62,351,2383,9.4,0.15239197
26727,26727,Thomas Pock,2009-10,28.0,6,3,59,59,1,2,3,51.0,750.0,118,8,9,17,152.0,82,5.7,65,341,2477,9.4,0.15575734
26728,26728,Thomas Rundqvist,1985-86,25.0,2,1,2,2,0,1,1,1.0,,2,0,1,1,1.0,80,7.77,71,321,2447,12.7,0.23240393
26729,26729,Thomas Steen,1982-83,22.0,2,44,73,73,15,29,44,133.0,,73,15,29,44,133.0,80,8.03,73,320,2489,12.9,0.6543036
26730,26730,Thomas Steen,1983-84,23.0,3,59,75,75,26,33,59,157.0,,148,41,62,103,290.0,80,7.73,71,310,2444,12.7,0.7236519
26731,26731,Thomas Steen,1984-85,24.0,4,65,78,78,20,45,65,181.0,,226,61,107,168,471.0,80,7.89,74,336,2448,12.9,0.81523013
26732,26732,Thomas Steen,1985-86,25.0,5,84,79,79,30,54,84,239.0,,305,91,161,252,710.0,80,7.77,71,321,2447,12.7,1.0250952
26733,26733,Thomas Steen,1986-87,26.0,6,64,78,78,17,47,64,195.0,,383,108,208,316,905.0,80,7.94,82,370,2484,12.8,0.79258907
26734,26734,Thomas Steen,1987-88,27.0,7,50,75,75,17,33,50,143.0,,458,125,241,366,1048.0,80,7.34,72,344,2400,12.2,0.6680547
26735,26735,Thomas Steen,1988-89,28.0,8,54,76,76,16,38,54,167.0,,534,141,279,420,1215.0,80,7.43,89,437,2435,12.2,0.74069494
26736,26736,Thomas Steen,1989-90,29.0,9,88,80,80,27,61,88,173.0,,614,168,340,508,1388.0,80,7.48,85,403,2430,12.3,1.004864
26737,26737,Thomas Steen,1990-91,30.0,10,66,53,53,18,48,66,129.0,,667,186,388,574,1517.0,80,7.37,76,367,2421,12.2,1.063658
26738,26738,Thomas Steen,1991-92,31.0,11,67,58,58,19,48,67,125.0,,725,205,436,641,1642.0,80,6.91,71,366,2385,11.6,0.978158
26739,26739,Thomas Steen,1992-93,32.0,12,38,38,38,13,25,38,75.0,,763,218,461,679,1717.0,80,6.96,77,402,2440,11.4,0.74402535
26740,26740,Thomas Steen,1993-94,33.0,13,72,80,80,22,50,72,150.0,,843,240,511,751,1867.0,84,7.25,87,443,2603,11.7,0.77165663
26741,26741,Thomas Steen,1994-95,34.0,14,51,76,76,19,32,51,137.0,,919,259,543,802,2004.0,84,6.48,76,407,2545,10.7,0.5557201
26742,26742,Thomas Steen,1995-96,35.0,15,15,31,31,5,10,15,32.0,,950,264,553,817,2036.0,48,5.97,37,209,1408,10.2,0.4605025
26743,26743,Thomas Vanek,2006-07,23.0,2,48,81,81,25,23,48,204.0,1193.0,81,25,23,48,204.0,82,6.05,85,480,2458,10.1,0.66124463
26744,26744,Thomas Vanek,2007-08,24.0,3,84,82,82,43,41,84,237.0,1376.0,163,68,64,132,441.0,82,5.76,70,398,2426,9.7,0.9333707
26745,26745,Thomas Vanek,2008-09,25.0,4,64,82,82,36,28,64,240.0,1382.0,245,104,92,196,681.0,82,5.44,62,351,2383,9.4,0.77012074
26746,26746,Thomas Vanek,2009-10,26.0,5,64,73,73,40,24,64,211.0,1255.0,318,144,116,260,892.0,82,5.7,65,341,2477,9.4,0.8076365
26747,26747,Thomas Vanek,2010-11,27.0,6,53,71,71,28,25,53,182.0,1190.0,389,172,141,313,1074.0,82,5.53,56,304,2486,9.1,0.7142167
26748,26748,Thomas Vanek,2011-12,28.0,7,73,80,80,32,41,73,238.0,1388.0,469,204,182,386,1312.0,82,5.46,52,291,2492,9.0,0.8055306
26749,26749,Thomas Vanek,2012-13,29.0,8,61,78,78,26,35,61,204.0,1321.0,547,230,217,447,1516.0,82,5.32,47,271,2439,8.9,0.7843015
26750,26750,Thomas Vanek,2013-14,30.0,9,41,38,38,20,21,41,119.0,699.0,585,250,238,488,1635.0,48,5.31,29,160,1399,9.1,0.7811165
26751,26751,Thomas Vanek,2014-15,31.0,10,68,78,78,27,41,68,248.0,1509.0,663,277,279,556,1883.0,82,5.34,48,269,2463,8.9,0.7626749
26752,26752,Thomas Vanek,2015-16,32.0,11,52,80,80,21,31,52,171.0,1297.0,743,298,310,608,2054.0,82,5.32,47,251,2453,8.9,0.58830416
26753,26753,Thomas Vanek,2016-17,33.0,12,41,74,74,18,23,41,146.0,1155.0,817,316,333,649,2200.0,82,5.34,48,255,2438,9.0,0.5302929
26754,26754,Thomas Vanek,2017-18,34.0,13,48,68,68,17,31,48,133.0,979.0,885,333,364,697,2333.0,82,5.45,47,245,2478,9.0,0.6102308
26755,26755,Thomas Vanek,2018-19,35.0,14,56,80,80,24,32,56,168.0,1127.0,965,357,396,753,2501.0,82,5.86,50,250,2620,9.2,0.59324396
26756,26756,Thomas Vanek,2019-20,36.0,15,36,64,64,16,20,36,108.0,903.0,1029,373,416,789,2609.0,82,5.96,47,239,2579,9.5,0.47281
26757,26757,Thomas Ziegler,2001-02,23.0,2,0,5,5,0,0,0,2.0,25.0,5,0,0,0,2.0,82,5.51,63,376,2272,9.9,0.16797936
26758,26758,Thommy Abrahamsson,1981-82,34.0,2,17,32,32,6,11,17,66.0,,32,6,11,17,66.0,80,7.69,77,340,2441,12.6,0.44381708
26759,26759,Tie Domi,1990-91,21.0,2,0,2,2,0,0,0,0.0,,2,0,0,0,0.0,80,7.37,76,367,2421,12.2,0.21253276
26760,26760,Tie Domi,1991-92,22.0,3,1,28,28,1,0,1,5.0,,30,1,0,1,5.0,80,6.91,71,366,2385,11.6,0.15434825
26761,26761,Tie Domi,1992-93,23.0,4,6,42,42,2,4,6,20.0,,72,3,4,7,25.0,80,6.96,77,402,2440,11.4,0.17730558
26762,26762,Tie Domi,1993-94,24.0,5,15,61,61,5,10,15,40.0,,133,8,14,22,65.0,84,7.25,87,443,2603,11.7,0.20036784
26763,26763,Tie Domi,1994-95,25.0,6,19,81,81,8,11,19,98.0,,214,16,25,41,163.0,84,6.48,76,407,2545,10.7,0.2427488
26764,26764,Tie Domi,1995-96,26.0,7,9,40,40,4,5,9,46.0,,254,20,30,50,209.0,48,5.97,37,209,1408,10.2,0.22815824
26765,26765,Tie Domi,1996-97,27.0,8,13,72,72,7,6,13,61.0,,326,27,36,63,270.0,82,6.29,74,413,2481,10.4,0.18055081
26766,26766,Tie Domi,1997-98,28.0,9,28,80,80,11,17,28,98.0,,406,38,53,91,368.0,82,5.83,55,336,2444,9.8,0.29482418
26767,26767,Tie Domi,1998-99,29.0,10,14,80,80,4,10,14,72.0,,486,42,63,105,440.0,82,5.28,57,380,2242,9.6,0.19137362
26768,26768,Tie Domi,1999-00,30.0,11,22,72,72,8,14,22,65.0,698.0,558,50,77,127,505.0,82,5.27,57,359,2285,9.4,0.25455177
26769,26769,Tie Domi,2000-01,31.0,12,14,70,70,5,9,14,64.0,698.0,628,55,86,141,569.0,82,5.49,53,331,2294,9.8,0.16933328
26770,26770,Tie Domi,2001-02,32.0,13,20,82,82,13,7,20,60.0,687.0,710,68,93,161,629.0,82,5.51,63,376,2272,9.9,0.2326006
26771,26771,Tie Domi,2002-03,33.0,14,19,74,74,9,10,19,93.0,764.0,784,77,103,180,722.0,82,5.24,53,338,2262,9.5,0.26731217
26772,26772,Tie Domi,2003-04,34.0,15,29,79,79,15,14,29,91.0,864.0,863,92,117,209,813.0,82,5.31,60,363,2326,9.4,0.27971685
26773,26773,Tie Domi,2004-05,35.0,16,20,80,80,7,13,20,84.0,896.0,943,99,130,229,897.0,82,5.14,57,348,2300,9.2,0.23100919
26774,26774,Tie Domi,2006-07,37.0,17,16,77,77,5,11,16,67.0,749.0,1020,104,141,245,964.0,82,6.05,85,480,2458,10.1,0.15262023
26775,26775,Tim Armstrong,1989-90,22.0,2,1,11,11,1,0,1,5.0,,11,1,0,1,5.0,80,7.48,85,403,2430,12.3,0.23726487
26776,26776,Tim Bergland,1990-91,26.0,2,7,32,32,2,5,7,20.0,,32,2,5,7,20.0,80,7.37,76,367,2421,12.2,0.25128382
26777,26777,Tim Bergland,1991-92,27.0,3,14,47,47,5,9,14,41.0,,79,7,14,21,61.0,80,6.91,71,366,2385,11.6,0.25870848
26778,26778,Tim Bergland,1992-93,28.0,4,5,22,22,1,4,5,18.0,,101,8,18,26,79.0,80,6.96,77,402,2440,11.4,0.23033577
26779,26779,Tim Bergland,1993-94,29.0,5,6,27,27,3,3,6,44.0,,128,11,21,32,123.0,84,7.25,87,443,2603,11.7,0.22661081
26780,26780,Tim Bergland,1994-95,30.0,6,11,54,54,6,5,11,65.0,,182,17,26,43,188.0,84,6.48,76,407,2545,10.7,0.22426325
26781,26781,Tim Brent,2007-08,23.0,2,1,15,15,1,0,1,14.0,104.0,15,1,0,1,14.0,82,5.76,70,398,2426,9.7,0.20926479
26782,26782,Tim Brent,2008-09,24.0,3,0,1,1,0,0,0,0.0,5.0,16,1,0,1,14.0,82,5.44,62,351,2383,9.4,0.15481615
26783,26783,Tim Brent,2009-10,25.0,4,0,2,2,0,0,0,0.0,17.0,18,1,0,1,14.0,82,5.7,65,341,2477,9.4,0.15273309
26784,26784,Tim Brent,2010-11,26.0,5,0,1,1,0,0,0,3.0,13.0,19,1,0,1,17.0,82,5.53,56,304,2486,9.1,0.14735559
26785,26785,Tim Brent,2011-12,27.0,6,20,79,79,8,12,20,60.0,920.0,98,9,12,21,77.0,82,5.46,52,291,2492,9.0,0.21830109
26786,26786,Tim Brent,2012-13,28.0,7,24,79,79,12,12,24,71.0,860.0,177,21,24,45,148.0,82,5.32,47,271,2439,8.9,0.24015802
26787,26787,Tim Brent,2013-14,29.0,8,3,30,30,0,3,3,23.0,294.0,207,21,27,48,171.0,48,5.31,29,160,1399,9.1,0.17015386
26788,26788,Tim Conboy,2008-09,26.0,2,5,19,19,0,5,5,16.0,132.0,19,0,5,5,16.0,82,5.44,62,351,2383,9.4,0.16076392
26789,26789,Tim Conboy,2009-10,27.0,3,1,28,28,0,1,1,13.0,150.0,47,0,6,6,29.0,82,5.7,65,341,2477,9.4,0.10971087
26790,26790,Tim Conboy,2010-11,28.0,4,0,12,12,0,0,0,5.0,52.0,59,0,6,6,34.0,82,5.53,56,304,2486,9.1,0.13036951
26791,26791,Tim Connolly,2000-01,19.0,2,34,81,81,14,20,34,114.0,1321.0,81,14,20,34,114.0,82,5.49,53,331,2294,9.8,0.48050952
26792,26792,Tim Connolly,2001-02,20.0,3,41,82,82,10,31,41,171.0,1642.0,163,24,51,75,285.0,82,5.51,63,376,2272,9.9,0.5166457
26793,26793,Tim Connolly,2002-03,21.0,4,45,82,82,10,35,45,126.0,1391.0,245,34,86,120,411.0,82,5.24,53,338,2262,9.5,0.57719976
26794,26794,Tim Connolly,2003-04,22.0,5,25,80,80,12,13,25,159.0,1279.0,325,46,99,145,570.0,82,5.31,60,363,2326,9.4,0.5049709
26795,26795,Tim Connolly,2006-07,25.0,6,55,63,63,16,39,55,99.0,1134.0,388,62,138,200,669.0,82,6.05,85,480,2458,10.1,0.74358904
26796,26796,Tim Connolly,2007-08,26.0,7,1,2,2,1,0,1,2.0,26.0,390,63,138,201,671.0,82,5.76,70,398,2426,9.7,0.34004062
26797,26797,Tim Connolly,2008-09,27.0,8,40,48,48,7,33,40,111.0,896.0,438,70,171,241,782.0,82,5.44,62,351,2383,9.4,0.696628
26798,26798,Tim Connolly,2009-10,28.0,9,47,48,48,18,29,47,126.0,918.0,486,88,200,288,908.0,82,5.7,65,341,2477,9.4,0.8317947
26799,26799,Tim Connolly,2010-11,29.0,10,65,73,73,17,48,65,206.0,1359.0,559,105,248,353,1114.0,82,5.53,56,304,2486,9.1,0.7807194
26800,26800,Tim Connolly,2011-12,30.0,11,42,68,68,13,29,42,151.0,1150.0,627,118,277,395,1265.0,82,5.46,52,291,2492,9.0,0.55242044
26801,26801,Tim Connolly,2012-13,31.0,12,36,70,70,13,23,36,104.0,1190.0,697,131,300,431,1369.0,82,5.32,47,271,2439,8.9,0.43375796
26802,26802,Tim Coulis,1980-81,22.0,2,3,19,19,1,2,3,13.0,,19,1,2,3,13.0,80,7.03,61,280,2352,12.0,0.21267208
26803,26803,Tim Coulis,1984-85,26.0,3,0,2,2,0,0,0,0.0,,21,1,2,3,13.0,80,7.89,74,336,2448,12.9,0.18819678
26804,26804,Tim Coulis,1985-86,27.0,4,2,7,7,1,1,2,10.0,,28,2,3,5,23.0,80,7.77,71,321,2447,12.7,0.22438183
26805,26805,Tim Coulis,1986-87,28.0,5,4,19,19,2,2,4,13.0,,47,4,5,9,36.0,80,7.94,82,370,2484,12.8,0.1945158
26806,26806,Tim Erixon,2012-13,21.0,2,2,18,18,0,2,2,9.0,234.0,18,0,2,2,9.0,82,5.32,47,271,2439,8.9,0.23060814
26807,26807,Tim Erixon,2013-14,22.0,3,5,31,31,0,5,5,21.0,487.0,49,0,7,7,30.0,48,5.31,29,160,1399,9.1,0.17593372
26808,26808,Tim Erixon,2014-15,23.0,4,0,2,2,0,0,0,1.0,29.0,51,0,7,7,31.0,82,5.34,48,269,2463,8.9,0.14332086
26809,26809,Tim Erixon,2015-16,24.0,5,7,42,42,2,5,7,36.0,639.0,93,2,12,14,67.0,82,5.32,47,251,2453,8.9,0.16356367
26810,26810,Tim Friday,1986-87,25.0,2,3,23,23,0,3,3,13.0,,23,0,3,3,13.0,80,7.94,82,370,2484,12.8,0.17210537
26811,26811,Tim Gleason,2004-05,22.0,2,7,47,47,0,7,7,45.0,704.0,47,0,7,7,45.0,82,5.14,57,348,2300,9.2,0.19551584
26812,26812,Tim Gleason,2006-07,24.0,3,21,78,78,2,19,21,72.0,1380.0,125,2,26,28,117.0,82,6.05,85,480,2458,10.1,0.23795664
26813,26813,Tim Gleason,2007-08,25.0,4,6,57,57,2,4,6,72.0,1076.0,182,4,30,34,189.0,82,5.76,70,398,2426,9.7,0.19071195
26814,26814,Tim Gleason,2008-09,26.0,5,19,80,80,3,16,19,98.0,1491.0,262,7,46,53,287.0,82,5.44,62,351,2383,9.4,0.25788307
26815,26815,Tim Gleason,2009-10,27.0,6,12,70,70,0,12,12,61.0,1447.0,332,7,58,65,348.0,82,5.7,65,341,2477,9.4,0.15565968
26816,26816,Tim Gleason,2010-11,28.0,7,19,61,61,5,14,19,76.0,1293.0,393,12,72,84,424.0,82,5.53,56,304,2486,9.1,0.2572371
26817,26817,Tim Gleason,2011-12,29.0,8,16,82,82,2,14,16,84.0,1719.0,475,14,86,100,508.0,82,5.46,52,291,2492,9.0,0.22017202
26818,26818,Tim Gleason,2012-13,30.0,9,18,82,82,1,17,18,65.0,1698.0,557,15,103,118,573.0,82,5.32,47,271,2439,8.9,0.19715416
26819,26819,Tim Gleason,2013-14,31.0,10,9,42,42,0,9,9,36.0,822.0,599,15,112,127,609.0,48,5.31,29,160,1399,9.1,0.16416064
26820,26820,Tim Gleason,2014-15,32.0,11,6,56,56,1,5,6,43.0,931.0,655,16,117,133,652.0,82,5.34,48,269,2463,8.9,0.12531814
26821,26821,Tim Gleason,2015-16,33.0,12,9,72,72,1,8,9,54.0,1176.0,727,17,125,142,706.0,82,5.32,47,251,2453,8.9,0.11865491
26822,26822,Tim Harrer,1983-84,26.0,2,0,3,3,0,0,0,3.0,,3,0,0,0,3.0,80,7.73,71,310,2444,12.7,0.22462675
26823,26823,Tim Heed,2017-18,27.0,2,0,1,1,0,0,0,1.0,16.0,1,0,0,0,1.0,82,5.45,47,245,2478,9.0,0.16303438
26824,26824,Tim Heed,2018-19,28.0,3,11,29,29,3,8,11,51.0,465.0,30,3,8,11,52.0,82,5.86,50,250,2620,9.2,0.23268297
26825,26825,Tim Heed,2019-20,29.0,4,13,37,37,2,11,13,41.0,532.0,67,5,19,24,93.0,82,5.96,47,239,2579,9.5,0.22379106
26826,26826,Tim Heed,2020-21,30.0,5,5,38,38,1,4,5,44.0,494.0,105,6,23,29,137.0,70,5.96,42,208,2192,9.5,0.17699045
26827,26827,Tim Hrynewich,1983-84,20.0,2,5,30,30,2,3,5,22.0,,30,2,3,5,22.0,80,7.73,71,310,2444,12.7,0.31635076
26828,26828,Tim Hrynewich,1984-85,21.0,3,9,25,25,4,5,9,24.0,,55,6,8,14,46.0,80,7.89,74,336,2448,12.9,0.34841013
26829,26829,Tim Hunter,1982-83,22.0,2,0,2,2,0,0,0,0.0,,2,0,0,0,0.0,80,8.03,73,320,2489,12.9,0.20696738
26830,26830,Tim Hunter,1983-84,23.0,3,1,16,16,1,0,1,7.0,,18,1,0,1,7.0,80,7.73,71,310,2444,12.7,0.23392814
26831,26831,Tim Hunter,1984-85,24.0,4,8,43,43,4,4,8,22.0,,61,5,4,9,29.0,80,7.89,74,336,2448,12.9,0.18147102
26832,26832,Tim Hunter,1985-86,25.0,5,22,71,71,11,11,22,68.0,,132,16,15,31,97.0,80,7.77,71,321,2447,12.7,0.26644713
26833,26833,Tim Hunter,1986-87,26.0,6,15,66,66,8,7,15,65.0,,198,24,22,46,162.0,80,7.94,82,370,2484,12.8,0.24021316
26834,26834,Tim Hunter,1987-88,27.0,7,21,73,73,6,15,21,65.0,,271,30,37,67,227.0,80,7.34,72,344,2400,12.2,0.27928466
26835,26835,Tim Hunter,1988-89,28.0,8,13,68,68,8,5,13,60.0,,339,38,42,80,287.0,80,7.43,89,437,2435,12.2,0.21269283
26836,26836,Tim Hunter,1989-90,29.0,9,12,75,75,3,9,12,67.0,,414,41,51,92,354.0,80,7.48,85,403,2430,12.3,0.19441915
26837,26837,Tim Hunter,1990-91,30.0,10,5,67,67,2,3,5,69.0,,481,43,54,97,423.0,80,7.37,76,367,2421,12.2,0.17807198
26838,26838,Tim Hunter,1991-92,31.0,11,7,34,34,5,2,7,29.0,,515,48,56,104,452.0,80,6.91,71,366,2385,11.6,0.18958303
26839,26839,Tim Hunter,1992-93,32.0,12,4,30,30,1,3,4,19.0,,545,49,59,108,471.0,80,6.96,77,402,2440,11.4,0.13806254
26840,26840,Tim Hunter,1993-94,33.0,13,12,74,74,5,7,12,40.0,,619,54,66,120,511.0,84,7.25,87,443,2603,11.7,0.12275061
26841,26841,Tim Hunter,1994-95,34.0,14,7,56,56,3,4,7,41.0,,675,57,70,127,552.0,84,6.48,76,407,2545,10.7,0.13195175
26842,26842,Tim Hunter,1995-96,35.0,15,5,34,34,3,2,5,17.0,,709,60,72,132,569.0,48,5.97,37,209,1408,10.2,0.1441142
26843,26843,Tim Hunter,1996-97,36.0,16,2,60,60,2,0,2,26.0,,769,62,72,134,595.0,82,6.29,74,413,2481,10.4,0.10199973
26844,26844,Tim Hunter,1997-98,37.0,17,4,46,46,0,4,4,13.0,,815,62,76,138,608.0,82,5.83,55,336,2444,9.8,0.09818661
26845,26845,Tim Jackman,2004-05,23.0,2,3,19,19,1,2,3,18.0,189.0,19,1,2,3,18.0,82,5.14,57,348,2300,9.2,0.21404421
26846,26846,Tim Jackman,2006-07,25.0,3,0,8,8,0,0,0,4.0,58.0,27,1,2,3,22.0,82,6.05,85,480,2458,10.1,0.15738809
26847,26847,Tim Jackman,2007-08,26.0,4,0,5,5,0,0,0,3.0,33.0,32,1,2,3,25.0,82,5.76,70,398,2426,9.7,0.16096085
26848,26848,Tim Jackman,2008-09,27.0,5,4,36,36,1,3,4,36.0,238.0,68,2,5,7,61.0,82,5.44,62,351,2383,9.4,0.14689669
26849,26849,Tim Jackman,2009-10,28.0,6,12,69,69,5,7,12,99.0,811.0,137,7,12,19,160.0,82,5.7,65,341,2477,9.4,0.19404072
26850,26850,Tim Jackman,2010-11,29.0,7,9,54,54,4,5,9,51.0,521.0,191,11,17,28,211.0,82,5.53,56,304,2486,9.1,0.13548782
26851,26851,Tim Jackman,2011-12,30.0,8,23,82,82,10,13,23,131.0,806.0,273,21,30,51,342.0,82,5.46,52,291,2492,9.0,0.2623027
26852,26852,Tim Jackman,2012-13,31.0,9,7,75,75,1,6,7,103.0,684.0,348,22,36,58,445.0,82,5.32,47,271,2439,8.9,0.15278226
26853,26853,Tim Jackman,2013-14,32.0,10,5,42,42,1,4,5,42.0,319.0,390,23,40,63,487.0,48,5.31,29,160,1399,9.1,0.14025718
26854,26854,Tim Jackman,2014-15,33.0,11,5,36,36,4,1,5,46.0,256.0,426,27,41,68,533.0,82,5.34,48,269,2463,8.9,0.1582483
26855,26855,Tim Jackman,2015-16,34.0,12,7,55,55,5,2,7,55.0,461.0,481,32,43,75,588.0,82,5.32,47,251,2453,8.9,0.12183055
26856,26856,Tim Jackman,2016-17,35.0,13,0,2,2,0,0,0,1.0,11.0,483,32,43,75,589.0,82,5.34,48,255,2438,9.0,0.1664333
26857,26857,Tim Kennedy,2009-10,23.0,2,0,1,1,0,0,0,1.0,11.0,1,0,0,0,1.0,82,5.7,65,341,2477,9.4,0.18027261
26858,26858,Tim Kennedy,2010-11,24.0,3,26,78,78,10,16,26,98.0,1010.0,79,10,16,26,99.0,82,5.53,56,304,2486,9.1,0.34468597
26859,26859,Tim Kennedy,2011-12,25.0,4,1,6,6,0,1,1,2.0,62.0,85,10,17,27,101.0,82,5.46,52,291,2492,9.0,0.18804294
26860,26860,Tim Kennedy,2012-13,26.0,5,2,27,27,1,1,2,22.0,301.0,112,11,18,29,123.0,82,5.32,47,271,2439,8.9,0.17501518
26861,26861,Tim Kennedy,2013-14,27.0,6,2,13,13,2,0,2,24.0,177.0,125,13,18,31,147.0,48,5.31,29,160,1399,9.1,0.25208697
26862,26862,Tim Kennedy,2014-15,28.0,7,8,37,37,2,6,8,42.0,435.0,162,15,24,39,189.0,82,5.34,48,269,2463,8.9,0.17800173
26863,26863,Tim Kerr,1981-82,22.0,2,45,68,68,22,23,45,95.0,,68,22,23,45,95.0,80,7.69,77,340,2441,12.6,0.7206042
26864,26864,Tim Kerr,1982-83,23.0,3,51,61,61,21,30,51,118.0,,129,43,53,96,213.0,80,8.03,73,320,2489,12.9,0.68513143
26865,26865,Tim Kerr,1983-84,24.0,4,19,24,24,11,8,19,50.0,,153,54,61,115,263.0,80,7.73,71,310,2444,12.7,0.7451497
26866,26866,Tim Kerr,1984-85,25.0,5,93,79,79,54,39,93,288.0,,232,108,100,208,551.0,80,7.89,74,336,2448,12.9,1.0971969
26867,26867,Tim Kerr,1985-86,26.0,6,98,74,74,54,44,98,278.0,,306,162,144,306,829.0,80,7.77,71,321,2447,12.7,1.1207194
26868,26868,Tim Kerr,1986-87,27.0,7,84,76,76,58,26,84,285.0,,382,220,170,390,1114.0,80,7.94,82,370,2484,12.8,1.0995644
26869,26869,Tim Kerr,1987-88,28.0,8,95,75,75,58,37,95,261.0,,457,278,207,485,1375.0,80,7.34,72,344,2400,12.2,1.0385675
26870,26870,Tim Kerr,1988-89,29.0,9,5,8,8,3,2,5,34.0,,465,281,209,490,1409.0,80,7.43,89,437,2435,12.2,0.9964645
26871,26871,Tim Kerr,1989-90,30.0,10,88,69,69,48,40,88,236.0,,534,329,249,578,1645.0,80,7.48,85,403,2430,12.3,1.0983536
26872,26872,Tim Kerr,1990-91,31.0,11,48,40,40,24,24,48,162.0,,574,353,273,626,1807.0,80,7.37,76,367,2421,12.2,0.942863
26873,26873,Tim Kerr,1991-92,32.0,12,24,27,27,10,14,24,74.0,,601,363,287,650,1881.0,80,6.91,71,366,2385,11.6,0.71507937
26874,26874,Tim Kerr,1992-93,33.0,13,18,32,32,7,11,18,56.0,,633,370,298,668,1937.0,80,6.96,77,402,2440,11.4,0.49740776
26875,26875,Tim Kerr,1993-94,34.0,14,6,22,22,0,6,6,48.0,,655,370,304,674,1985.0,84,7.25,87,443,2603,11.7,0.39531428
26876,26876,Tim Lenardon,1987-88,25.0,2,2,7,7,1,1,2,13.0,,7,1,1,2,13.0,80,7.34,72,344,2400,12.2,0.27312666
26877,26877,Tim Lenardon,1990-91,28.0,3,1,8,8,1,0,1,9.0,,15,2,1,3,22.0,80,7.37,76,367,2421,12.2,0.21164754
26878,26878,Tim Ramholt,2008-09,24.0,2,0,1,1,0,0,0,0.0,1.0,1,0,0,0,0.0,82,5.44,62,351,2383,9.4,0.16840222
26879,26879,Tim Schaller,2015-16,25.0,2,2,18,18,1,1,2,19.0,204.0,18,1,1,2,19.0,82,5.32,47,251,2453,8.9,0.18575025
26880,26880,Tim Schaller,2016-17,26.0,3,3,17,17,1,2,3,18.0,142.0,35,2,3,5,37.0,82,5.34,48,255,2438,9.0,0.19393006
26881,26881,Tim Schaller,2017-18,27.0,4,14,59,59,7,7,14,89.0,724.0,94,9,10,19,126.0,82,5.45,47,245,2478,9.0,0.24173176
26882,26882,Tim Schaller,2018-19,28.0,5,22,82,82,12,10,22,133.0,1089.0,176,21,20,41,259.0,82,5.86,50,250,2620,9.2,0.28454095
26883,26883,Tim Schaller,2019-20,29.0,6,10,47,47,3,7,10,44.0,501.0,223,24,27,51,303.0,82,5.96,47,239,2579,9.5,0.19803426
26884,26884,Tim Schaller,2020-21,30.0,7,6,53,53,5,1,6,49.0,613.0,276,29,28,57,352.0,70,5.96,42,208,2192,9.5,0.19666144
26885,26885,Tim Sestito,2009-10,25.0,2,0,1,1,0,0,0,1.0,6.0,1,0,0,0,1.0,82,5.7,65,341,2477,9.4,0.17050758
26886,26886,Tim Sestito,2010-11,26.0,3,1,9,9,0,1,1,7.0,110.0,10,0,1,1,8.0,82,5.53,56,304,2486,9.1,0.17407775
26887,26887,Tim Sestito,2011-12,27.0,4,2,36,36,0,2,2,22.0,390.0,46,0,3,3,30.0,82,5.46,52,291,2492,9.0,0.10579395
26888,26888,Tim Sestito,2012-13,28.0,5,0,18,18,0,0,0,6.0,149.0,64,0,3,3,36.0,82,5.32,47,271,2439,8.9,0.10685581
26889,26889,Tim Sestito,2013-14,29.0,6,0,6,6,0,0,0,4.0,47.0,70,0,3,3,40.0,48,5.31,29,160,1399,9.1,0.114305824
26890,26890,Tim Sestito,2014-15,30.0,7,3,16,16,0,3,3,13.0,146.0,86,0,6,6,53.0,82,5.34,48,269,2463,8.9,0.14033148
26891,26891,Tim Sestito,2015-16,31.0,8,2,15,15,0,2,2,10.0,148.0,101,0,8,8,63.0,82,5.32,47,251,2453,8.9,0.12860972
26892,26892,Tim Stapleton,2009-10,27.0,2,1,4,4,1,0,1,9.0,60.0,4,1,0,1,9.0,82,5.7,65,341,2477,9.4,0.22558776
26893,26893,Tim Stapleton,2010-11,28.0,3,2,6,6,2,0,2,6.0,71.0,10,3,0,3,15.0,82,5.53,56,304,2486,9.1,0.20817617
26894,26894,Tim Stapleton,2011-12,29.0,4,7,45,45,5,2,7,44.0,500.0,55,8,2,10,59.0,82,5.46,52,291,2492,9.0,0.15308645
26895,26895,Tim Stapleton,2012-13,30.0,5,27,63,63,11,16,27,74.0,639.0,118,19,18,37,133.0,82,5.32,47,271,2439,8.9,0.29476133
26896,26896,Tim Sweeney,1991-92,24.0,2,16,42,42,7,9,16,40.0,,42,7,9,16,40.0,80,6.91,71,366,2385,11.6,0.35740304
26897,26897,Tim Sweeney,1992-93,25.0,3,3,11,11,1,2,3,16.0,,53,8,11,19,56.0,80,6.96,77,402,2440,11.4,0.24839431
26898,26898,Tim Sweeney,1993-94,26.0,4,8,14,14,1,7,8,15.0,,67,9,18,27,71.0,84,7.25,87,443,2603,11.7,0.25713956
26899,26899,Tim Sweeney,1994-95,27.0,5,43,78,78,16,27,43,114.0,,145,25,45,70,185.0,84,6.48,76,407,2545,10.7,0.42080393
26900,26900,Tim Sweeney,1995-96,28.0,6,2,13,13,1,1,2,11.0,,158,26,46,72,196.0,48,5.97,37,209,1408,10.2,0.2634002
26901,26901,Tim Sweeney,1996-97,29.0,7,16,41,41,8,8,16,47.0,,199,34,54,88,243.0,82,6.29,74,413,2481,10.4,0.32099164
26902,26902,Tim Sweeney,1997-98,30.0,8,21,36,36,10,11,21,65.0,,235,44,65,109,308.0,82,5.83,55,336,2444,9.8,0.41074598
26903,26903,Tim Sweeney,1998-99,31.0,9,29,56,56,11,18,29,75.0,,291,55,83,138,383.0,82,5.28,57,380,2242,9.6,0.39811504
26904,26904,Tim Taylor,1994-95,25.0,2,1,1,1,1,0,1,4.0,,1,1,0,1,4.0,84,6.48,76,407,2545,10.7,0.21328682
26905,26905,Tim Taylor,1995-96,26.0,3,4,22,22,0,4,4,21.0,,23,1,4,5,25.0,48,5.97,37,209,1408,10.2,0.18980244
26906,26906,Tim Taylor,1996-97,27.0,4,25,72,72,11,14,25,81.0,,95,12,18,30,106.0,82,6.29,74,413,2481,10.4,0.29869574
26907,26907,Tim Taylor,1997-98,28.0,5,7,44,44,3,4,7,44.0,,139,15,22,37,150.0,82,5.83,55,336,2444,9.8,0.14954358
26908,26908,Tim Taylor,1998-99,29.0,6,31,79,79,20,11,31,127.0,,218,35,33,68,277.0,82,5.28,57,380,2242,9.6,0.38793504
26909,26909,Tim Taylor,1999-00,30.0,7,11,49,49,4,7,11,76.0,781.0,267,39,40,79,353.0,82,5.27,57,359,2285,9.4,0.24329051
26910,26910,Tim Taylor,2000-01,31.0,8,20,76,76,9,11,20,79.0,1075.0,343,48,51,99,432.0,82,5.49,53,331,2294,9.8,0.24265632
26911,26911,Tim Taylor,2001-02,32.0,9,7,38,38,2,5,7,34.0,340.0,381,50,56,106,466.0,82,5.51,63,376,2272,9.9,0.18072563
26912,26912,Tim Taylor,2002-03,33.0,10,8,48,48,4,4,8,50.0,647.0,429,54,60,114,516.0,82,5.24,53,338,2262,9.5,0.170282
26913,26913,Tim Taylor,2003-04,34.0,11,12,82,82,4,8,12,95.0,1124.0,511,58,68,126,611.0,82,5.31,60,363,2326,9.4,0.18502113
26914,26914,Tim Taylor,2004-05,35.0,12,22,82,82,7,15,22,95.0,1057.0,593,65,83,148,706.0,82,5.14,57,348,2300,9.2,0.22773966
26915,26915,Tim Taylor,2006-07,37.0,13,13,82,82,7,6,13,109.0,1021.0,675,72,89,161,815.0,82,6.05,85,480,2458,10.1,0.18213674
26916,26916,Tim Taylor,2007-08,38.0,14,6,71,71,1,5,6,59.0,562.0,746,73,94,167,874.0,82,5.76,70,398,2426,9.7,0.14447263
26917,26917,Tim Tookey,1981-82,21.0,2,23,29,29,10,13,23,33.0,,29,10,13,23,33.0,80,7.69,77,340,2441,12.6,0.50237685
26918,26918,Tim Tookey,1982-83,22.0,3,16,28,28,8,8,16,52.0,,57,18,21,39,85.0,80,8.03,73,320,2489,12.9,0.51822865
26919,26919,Tim Tookey,1983-84,23.0,4,7,12,12,1,6,7,8.0,,69,19,27,46,93.0,80,7.73,71,310,2444,12.7,0.38378948
26920,26920,Tim Tookey,1984-85,24.0,5,2,8,8,0,2,2,7.0,,77,19,29,48,100.0,80,7.89,74,336,2448,12.9,0.29044515
26921,26921,Tim Tookey,1987-88,27.0,6,0,2,2,0,0,0,1.0,,79,19,29,48,101.0,80,7.34,72,344,2400,12.2,0.23363006
26922,26922,Tim Tookey,1988-89,28.0,7,7,20,20,1,6,7,28.0,,99,20,35,55,129.0,80,7.43,89,437,2435,12.2,0.30914414
26923,26923,Tim Tookey,1989-90,29.0,8,3,7,7,2,1,3,8.0,,106,22,36,58,137.0,80,7.48,85,403,2430,12.3,0.31554738
26924,26924,Tim Trimper,1980-81,21.0,2,16,30,30,6,10,16,65.0,,30,6,10,16,65.0,80,7.03,61,280,2352,12.0,0.460738
26925,26925,Tim Trimper,1981-82,22.0,3,29,56,56,15,14,29,95.0,,86,21,24,45,160.0,80,7.69,77,340,2441,12.6,0.5155006
26926,26926,Tim Trimper,1982-83,23.0,4,16,74,74,8,8,16,68.0,,160,29,32,61,228.0,80,8.03,73,320,2489,12.9,0.301596
26927,26927,Tim Trimper,1983-84,24.0,5,0,5,5,0,0,0,2.0,,165,29,32,61,230.0,80,7.73,71,310,2444,12.7,0.27238595
26928,26928,Tim Trimper,1984-85,25.0,6,0,5,5,0,0,0,1.0,,170,29,32,61,231.0,80,7.89,74,336,2448,12.9,0.24062443
26929,26929,Tim Trimper,1985-86,26.0,7,5,20,20,1,4,5,28.0,,190,30,36,66,259.0,80,7.77,71,321,2447,12.7,0.28567296
26930,26930,Tim Wallace,2009-10,25.0,2,2,16,16,0,2,2,17.0,130.0,16,0,2,2,17.0,82,5.7,65,341,2477,9.4,0.17402539
26931,26931,Tim Wallace,2010-11,26.0,3,0,1,1,0,0,0,0.0,6.0,17,0,2,2,17.0,82,5.53,56,304,2486,9.1,0.14884055
26932,26932,Tim Wallace,2011-12,27.0,4,0,7,7,0,0,0,1.0,56.0,24,0,2,2,18.0,82,5.46,52,291,2492,9.0,0.13173747
26933,26933,Tim Wallace,2012-13,28.0,5,9,49,49,3,6,9,26.0,421.0,73,3,8,11,44.0,82,5.32,47,271,2439,8.9,0.119252115
26934,26934,Tim Wallace,2013-14,29.0,6,2,28,28,1,1,2,20.0,281.0,101,4,9,13,64.0,48,5.31,29,160,1399,9.1,0.13488063
26935,26935,Tim Watters,1982-83,23.0,2,24,69,69,2,22,24,66.0,,69,2,22,24,66.0,80,8.03,73,320,2489,12.9,0.3210668
26936,26936,Tim Watters,1983-84,24.0,3,23,77,77,5,18,23,57.0,,146,7,40,47,123.0,80,7.73,71,310,2444,12.7,0.27492362
26937,26937,Tim Watters,1984-85,25.0,4,23,74,74,3,20,23,65.0,,220,10,60,70,188.0,80,7.89,74,336,2448,12.9,0.2848487
26938,26938,Tim Watters,1985-86,26.0,5,22,63,63,2,20,22,53.0,,283,12,80,92,241.0,80,7.77,71,321,2447,12.7,0.30751753
26939,26939,Tim Watters,1986-87,27.0,6,14,56,56,6,8,14,37.0,,339,18,88,106,278.0,80,7.94,82,370,2484,12.8,0.29910254
26940,26940,Tim Watters,1987-88,28.0,7,16,63,63,3,13,16,44.0,,402,21,101,122,322.0,80,7.34,72,344,2400,12.2,0.27158773
26941,26941,Tim Watters,1988-89,29.0,8,0,36,36,0,0,0,21.0,,438,21,101,122,343.0,80,7.43,89,437,2435,12.2,0.17214185
26942,26942,Tim Watters,1989-90,30.0,9,21,76,76,3,18,21,62.0,,514,24,119,143,405.0,80,7.48,85,403,2430,12.3,0.23079869
26943,26943,Tim Watters,1990-91,31.0,10,11,62,62,1,10,11,50.0,,576,25,129,154,455.0,80,7.37,76,367,2421,12.2,0.17802107
26944,26944,Tim Watters,1991-92,32.0,11,4,45,45,0,4,4,29.0,,621,25,133,158,484.0,80,6.91,71,366,2385,11.6,0.12306458
26945,26945,Tim Watters,1992-93,33.0,12,7,37,37,0,7,7,29.0,,658,25,140,165,513.0,80,6.96,77,402,2440,11.4,0.13882685
26946,26946,Tim Watters,1993-94,34.0,13,2,22,22,0,2,2,8.0,,680,25,142,167,521.0,84,7.25,87,443,2603,11.7,0.11624369
26947,26947,Tim Watters,1994-95,35.0,14,10,60,60,1,9,10,38.0,,740,26,151,177,559.0,84,6.48,76,407,2545,10.7,0.12536389
26948,26948,Tim Watters,1995-96,36.0,15,0,1,1,0,0,0,1.0,,741,26,151,177,560.0,48,5.97,37,209,1408,10.2,0.20467007
26949,26949,Timo Blomqvist,1982-83,22.0,2,12,44,44,1,11,12,53.0,,44,1,11,12,53.0,80,8.03,73,320,2489,12.9,0.24029109
26950,26950,Timo Blomqvist,1983-84,23.0,3,18,61,61,1,17,18,71.0,,105,2,28,30,124.0,80,7.73,71,310,2444,12.7,0.30533755
26951,26951,Timo Blomqvist,1984-85,24.0,4,20,65,65,1,19,20,69.0,,170,3,47,50,193.0,80,7.89,74,336,2448,12.9,0.26874334
26952,26952,Timo Blomqvist,1985-86,25.0,5,5,53,53,1,4,5,59.0,,223,4,51,55,252.0,80,7.77,71,321,2447,12.7,0.19413844
26953,26953,Timo Blomqvist,1987-88,27.0,6,2,20,20,0,2,2,16.0,,243,4,53,57,268.0,80,7.34,72,344,2400,12.2,0.18796307
26954,26954,Timo Helbling,2006-07,25.0,2,1,9,9,0,1,1,2.0,93.0,9,0,1,1,2.0,82,6.05,85,480,2458,10.1,0.17211702
26955,26955,Timo Helbling,2007-08,26.0,3,0,2,2,0,0,0,0.0,24.0,11,0,1,1,2.0,82,5.76,70,398,2426,9.7,0.14503509
26956,26956,Timo Jutila,1985-86,22.0,2,6,10,10,1,5,6,28.0,,10,1,5,6,28.0,80,7.77,71,321,2447,12.7,0.384518
26957,26957,Timo Meier,2017-18,21.0,2,6,34,34,3,3,6,85.0,424.0,34,3,3,6,85.0,82,5.45,47,245,2478,9.0,0.3504275
26958,26958,Timo Meier,2018-19,22.0,3,36,81,81,21,15,36,210.0,1204.0,115,24,18,42,295.0,82,5.86,50,250,2620,9.2,0.5628869
26959,26959,Timo Meier,2019-20,23.0,4,66,78,78,30,36,66,250.0,1324.0,193,54,54,108,545.0,82,5.96,47,239,2579,9.5,0.81813705
26960,26960,Timo Meier,2020-21,24.0,5,49,70,70,22,27,49,199.0,1210.0,263,76,81,157,744.0,70,5.96,42,208,2192,9.5,0.71699274
26961,26961,Timo Parssinen,2002-03,26.0,2,3,17,17,0,3,3,16.0,200.0,17,0,3,3,16.0,82,5.24,53,338,2262,9.5,0.1791063
26962,26962,Timofei Shishkanov,2004-05,21.0,2,0,2,2,0,0,0,0.0,13.0,2,0,0,0,0.0,82,5.14,57,348,2300,9.2,0.24485323
26963,26963,Timofei Shishkanov,2006-07,23.0,3,5,22,22,3,2,5,26.0,186.0,24,3,2,5,26.0,82,6.05,85,480,2458,10.1,0.2737445
26964,26964,Timothy Gettinger,2019-20,21.0,2,0,4,4,0,0,0,2.0,30.0,4,0,0,0,2.0,82,5.96,47,239,2579,9.5,0.23299214
26965,26965,Timothy Gettinger,2020-21,22.0,3,1,2,2,0,1,1,3.0,17.0,6,0,1,1,5.0,70,5.96,42,208,2192,9.5,0.22968417
26966,26966,Timothy Liljegren,2020-21,21.0,2,1,11,11,0,1,1,2.0,113.0,11,0,1,1,2.0,70,5.96,42,208,2192,9.5,0.21194598
26967,26967,Tobias Bjornfot,2020-21,19.0,2,0,3,3,0,0,0,0.0,39.0,3,0,0,0,0.0,70,5.96,42,208,2192,9.5,0.21982303
26968,26968,Tobias Lindberg,2016-17,21.0,2,2,6,6,0,2,2,12.0,95.0,6,0,2,2,12.0,82,5.34,48,255,2438,9.0,0.26114184
26969,26969,Tobias Rieder,2015-16,23.0,2,21,72,72,13,8,21,189.0,1217.0,72,13,8,21,189.0,82,5.32,47,251,2453,8.9,0.390898
26970,26970,Tobias Rieder,2016-17,24.0,3,37,82,82,14,23,37,189.0,1419.0,154,27,31,58,378.0,82,5.34,48,255,2438,9.0,0.5031854
26971,26971,Tobias Rieder,2017-18,25.0,4,34,80,80,16,18,34,155.0,1385.0,234,43,49,92,533.0,82,5.45,47,245,2478,9.0,0.46182874
26972,26972,Tobias Rieder,2018-19,26.0,5,25,78,78,12,13,25,114.0,1143.0,312,55,62,117,647.0,82,5.86,50,250,2620,9.2,0.3593107
26973,26973,Tobias Rieder,2019-20,27.0,6,11,67,67,0,11,11,92.0,847.0,379,55,73,128,739.0,82,5.96,47,239,2579,9.5,0.23577201
26974,26974,Tobias Rieder,2020-21,28.0,7,10,55,55,4,6,10,77.0,610.0,434,59,79,138,816.0,70,5.96,42,208,2192,9.5,0.2708422
26975,26975,Toby Enstrom,2008-09,24.0,2,38,82,82,5,33,38,105.0,2007.0,82,5,33,38,105.0,82,5.44,62,351,2383,9.4,0.44718182
26976,26976,Toby Enstrom,2009-10,25.0,3,32,82,82,5,27,32,86.0,1929.0,164,10,60,70,191.0,82,5.7,65,341,2477,9.4,0.38523418
26977,26977,Toby Enstrom,2010-11,26.0,4,50,82,82,6,44,50,109.0,1826.0,246,16,104,120,300.0,82,5.53,56,304,2486,9.1,0.5870716
26978,26978,Toby Enstrom,2011-12,27.0,5,51,72,72,10,41,51,113.0,1705.0,318,26,145,171,413.0,82,5.46,52,291,2492,9.0,0.5913355
26979,26979,Toby Enstrom,2012-13,28.0,6,33,62,62,6,27,33,94.0,1478.0,380,32,172,204,507.0,82,5.32,47,271,2439,8.9,0.48102242
26980,26980,Toby Enstrom,2013-14,29.0,7,15,22,22,4,11,15,21.0,496.0,402,36,183,219,528.0,48,5.31,29,160,1399,9.1,0.43664086
26981,26981,Toby Enstrom,2014-15,30.0,8,30,82,82,10,20,30,106.0,1960.0,484,46,203,249,634.0,82,5.34,48,269,2463,8.9,0.3923411
26982,26982,Toby Enstrom,2015-16,31.0,9,23,60,60,4,19,23,58.0,1414.0,544,50,222,272,692.0,82,5.32,47,251,2453,8.9,0.29772365
26983,26983,Toby Enstrom,2016-17,32.0,10,16,72,72,2,14,16,50.0,1502.0,616,52,236,288,742.0,82,5.34,48,255,2438,9.0,0.22918168
26984,26984,Toby Enstrom,2017-18,33.0,11,14,60,60,1,13,14,46.0,1314.0,676,53,249,302,788.0,82,5.45,47,245,2478,9.0,0.18004918
26985,26985,Toby Enstrom,2018-19,34.0,12,6,43,43,1,5,6,31.0,732.0,719,54,254,308,819.0,82,5.86,50,250,2620,9.2,0.14020544
26986,26986,Toby Petersen,2001-02,23.0,2,8,12,12,2,6,8,25.0,160.0,12,2,6,8,25.0,82,5.51,63,376,2272,9.9,0.28925267
26987,26987,Toby Petersen,2002-03,24.0,3,18,79,79,8,10,18,116.0,969.0,91,10,16,26,141.0,82,5.24,53,338,2262,9.5,0.3024209
26988,26988,Toby Petersen,2007-08,29.0,4,15,64,64,6,9,15,92.0,875.0,155,16,25,41,233.0,82,5.76,70,398,2426,9.7,0.21203929
26989,26989,Toby Petersen,2008-09,30.0,5,3,8,8,0,3,3,6.0,63.0,163,16,28,44,239.0,82,5.44,62,351,2383,9.4,0.18975726
26990,26990,Toby Petersen,2009-10,31.0,6,11,57,57,4,7,11,80.0,651.0,220,20,35,55,319.0,82,5.7,65,341,2477,9.4,0.21674025
26991,26991,Toby Petersen,2010-11,32.0,7,15,78,78,9,6,15,110.0,852.0,298,29,41,70,429.0,82,5.53,56,304,2486,9.1,0.20242321
26992,26992,Toby Petersen,2011-12,33.0,8,6,60,60,2,4,6,58.0,602.0,358,31,45,76,487.0,82,5.46,52,291,2492,9.0,0.14226621
26993,26993,Toby Petersen,2012-13,34.0,9,5,39,39,2,3,5,44.0,299.0,397,33,48,81,531.0,82,5.32,47,271,2439,8.9,0.14863226
26994,26994,Toby Petersen,2013-14,35.0,10,0,1,1,0,0,0,0.0,7.0,398,33,48,81,531.0,48,5.31,29,160,1399,9.1,0.21639132
26995,26995,Todd Bergen,1985-86,22.0,2,16,14,14,11,5,16,39.0,,14,11,5,16,39.0,80,7.77,71,321,2447,12.7,0.73060197
26996,26996,Todd Bertuzzi,1996-97,21.0,2,39,76,76,18,21,39,127.0,,76,18,21,39,127.0,82,6.29,74,413,2481,10.4,0.51477665
26997,26997,Todd Bertuzzi,1997-98,22.0,3,23,64,64,10,13,23,79.0,,140,28,34,62,206.0,82,5.83,55,336,2444,9.8,0.3761233
26998,26998,Todd Bertuzzi,1998-99,23.0,4,33,74,74,13,20,33,102.0,,214,41,54,95,308.0,82,5.28,57,380,2242,9.6,0.51705337
26999,26999,Todd Bertuzzi,1999-00,24.0,5,16,32,32,8,8,16,72.0,591.0,246,49,62,111,380.0,82,5.27,57,359,2285,9.4,0.48652765
27000,27000,Todd Bertuzzi,2000-01,25.0,6,50,80,80,25,25,50,173.0,1232.0,326,74,87,161,553.0,82,5.49,53,331,2294,9.8,0.61868465
27001,27001,Todd Bertuzzi,2001-02,26.0,7,55,79,79,25,30,55,203.0,1360.0,405,99,117,216,756.0,82,5.51,63,376,2272,9.9,0.6717097
27002,27002,Todd Bertuzzi,2002-03,27.0,8,85,72,72,36,49,85,203.0,1416.0,477,135,166,301,959.0,82,5.24,53,338,2262,9.5,1.0373697
27003,27003,Todd Bertuzzi,2003-04,28.0,9,97,82,82,46,51,97,243.0,1687.0,559,181,217,398,1202.0,82,5.31,60,363,2326,9.4,0.9563692
27004,27004,Todd Bertuzzi,2004-05,29.0,10,60,69,69,17,43,60,156.0,1450.0,628,198,260,458,1358.0,82,5.14,57,348,2300,9.2,0.8406838
27005,27005,Todd Bertuzzi,2006-07,31.0,11,71,82,82,25,46,71,200.0,1568.0,710,223,306,529,1558.0,82,6.05,85,480,2458,10.1,0.79611146
27006,27006,Todd Bertuzzi,2007-08,32.0,12,11,15,15,3,8,11,23.0,240.0,725,226,314,540,1581.0,82,5.76,70,398,2426,9.7,0.43458974
27007,27007,Todd Bertuzzi,2008-09,33.0,13,40,68,68,14,26,40,121.0,1119.0,793,240,340,580,1702.0,82,5.44,62,351,2383,9.4,0.53189486
27008,27008,Todd Bertuzzi,2009-10,34.0,14,44,66,66,15,29,44,127.0,1228.0,859,255,369,624,1829.0,82,5.7,65,341,2477,9.4,0.53220016
27009,27009,Todd Bertuzzi,2010-11,35.0,15,44,82,82,18,26,44,216.0,1375.0,941,273,395,668,2045.0,82,5.53,56,304,2486,9.1,0.5375247
27010,27010,Todd Bertuzzi,2011-12,36.0,16,45,81,81,16,29,45,138.0,1293.0,1022,289,424,713,2183.0,82,5.46,52,291,2492,9.0,0.49023798
27011,27011,Todd Bertuzzi,2012-13,37.0,17,38,71,71,14,24,38,118.0,1104.0,1093,303,448,751,2301.0,82,5.32,47,271,2439,8.9,0.43838125
27012,27012,Todd Bertuzzi,2013-14,38.0,18,3,7,7,2,1,3,10.0,109.0,1100,305,449,754,2311.0,48,5.31,29,160,1399,9.1,0.42856488
27013,27013,Todd Bertuzzi,2014-15,39.0,19,16,59,59,9,7,16,100.0,865.0,1159,314,456,770,2411.0,82,5.34,48,269,2463,8.9,0.32641795
27014,27014,Todd Bidner,1982-83,21.0,2,3,12,12,2,1,3,5.0,,12,2,1,3,5.0,80,8.03,73,320,2489,12.9,0.3675292
27015,27015,Todd Charlesworth,1984-85,19.0,2,0,10,10,0,0,0,6.0,,10,0,0,0,6.0,80,7.89,74,336,2448,12.9,0.26106137
27016,27016,Todd Charlesworth,1985-86,20.0,3,9,67,67,1,8,9,68.0,,77,1,8,9,74.0,80,7.77,71,321,2447,12.7,0.27981544
27017,27017,Todd Charlesworth,1986-87,21.0,4,1,2,2,0,1,1,1.0,,79,1,9,10,75.0,80,7.94,82,370,2484,12.8,0.24712783
27018,27018,Todd Charlesworth,1987-88,22.0,5,0,1,1,0,0,0,0.0,,80,1,9,10,75.0,80,7.34,72,344,2400,12.2,0.19795
27019,27019,Todd Charlesworth,1988-89,23.0,6,2,6,6,2,0,2,4.0,,86,3,9,12,79.0,80,7.43,89,437,2435,12.2,0.2880785
27020,27020,Todd Charlesworth,1990-91,25.0,7,0,7,7,0,0,0,4.0,,93,3,9,12,83.0,80,7.37,76,367,2421,12.2,0.18524343
27021,27021,Todd Elik,1990-91,24.0,2,33,48,48,10,23,33,86.0,,48,10,23,33,86.0,80,7.37,76,367,2421,12.2,0.5388935
27022,27022,Todd Elik,1991-92,25.0,3,58,74,74,21,37,58,153.0,,122,31,60,91,239.0,80,6.91,71,366,2385,11.6,0.71605426
27023,27023,Todd Elik,1992-93,26.0,4,46,62,62,14,32,46,118.0,,184,45,92,137,357.0,80,6.96,77,402,2440,11.4,0.6606101
27024,27024,Todd Elik,1993-94,27.0,5,41,60,60,14,27,41,104.0,,244,59,119,178,461.0,84,7.25,87,443,2603,11.7,0.63543904
27025,27025,Todd Elik,1994-95,28.0,6,66,79,79,25,41,66,185.0,,323,84,160,244,646.0,84,6.48,76,407,2545,10.7,0.68654835
27026,27026,Todd Elik,1995-96,29.0,7,23,35,35,9,14,23,76.0,,358,93,174,267,722.0,48,5.97,37,209,1408,10.2,0.6273612
27027,27027,Todd Elik,1996-97,30.0,8,46,59,59,13,33,46,108.0,,417,106,207,313,830.0,82,6.29,74,413,2481,10.4,0.56467664
27028,27028,Todd Elik,1997-98,31.0,9,16,31,31,4,12,16,72.0,,448,110,219,329,902.0,82,5.83,55,336,2444,9.8,0.44810307
27029,27029,Todd Ewen,1987-88,21.0,2,2,23,23,2,0,2,11.0,,23,2,0,2,11.0,80,7.34,72,344,2400,12.2,0.27217108
27030,27030,Todd Ewen,1988-89,22.0,3,6,64,64,4,2,6,38.0,,87,6,2,8,49.0,80,7.43,89,437,2435,12.2,0.20121118
27031,27031,Todd Ewen,1989-90,23.0,4,9,34,34,4,5,9,22.0,,121,10,7,17,71.0,80,7.48,85,403,2430,12.3,0.2315216
27032,27032,Todd Ewen,1990-91,24.0,5,10,44,44,4,6,10,29.0,,165,14,13,27,100.0,80,7.37,76,367,2421,12.2,0.2332451
27033,27033,Todd Ewen,1991-92,25.0,6,5,28,28,3,2,5,13.0,,193,17,15,32,113.0,80,6.91,71,366,2385,11.6,0.20868635
27034,27034,Todd Ewen,1992-93,26.0,7,3,46,46,1,2,3,19.0,,239,18,17,35,132.0,80,6.96,77,402,2440,11.4,0.13238347
27035,27035,Todd Ewen,1993-94,27.0,8,14,75,75,5,9,14,59.0,,314,23,26,49,191.0,84,7.25,87,443,2603,11.7,0.16935429
27036,27036,Todd Ewen,1994-95,28.0,9,18,76,76,9,9,18,59.0,,390,32,35,67,250.0,84,6.48,76,407,2545,10.7,0.18989086
27037,27037,Todd Ewen,1995-96,29.0,10,0,24,24,0,0,0,14.0,,414,32,35,67,264.0,48,5.97,37,209,1408,10.2,0.10316804
27038,27038,Todd Ewen,1996-97,30.0,11,7,53,53,4,3,7,52.0,,467,36,38,74,316.0,82,6.29,74,413,2481,10.4,0.13363978
27039,27039,Todd Ewen,1997-98,31.0,12,2,51,51,0,2,2,22.0,,518,36,40,76,338.0,82,5.83,55,336,2444,9.8,0.07137185
27040,27040,Todd Fedoruk,2001-02,22.0,2,10,53,53,5,5,10,28.0,373.0,53,5,5,10,28.0,82,5.51,63,376,2272,9.9,0.23925743
27041,27041,Todd Fedoruk,2002-03,23.0,3,7,55,55,3,4,7,21.0,349.0,108,8,9,17,49.0,82,5.24,53,338,2262,9.5,0.17005256
27042,27042,Todd Fedoruk,2003-04,24.0,4,6,63,63,1,5,6,33.0,409.0,171,9,14,23,82.0,82,5.31,60,363,2326,9.4,0.15942565
27043,27043,Todd Fedoruk,2004-05,25.0,5,5,49,49,1,4,5,33.0,332.0,220,10,18,28,115.0,82,5.14,57,348,2300,9.2,0.16358364
27044,27044,Todd Fedoruk,2006-07,27.0,6,23,76,76,4,19,23,69.0,639.0,296,14,37,51,184.0,82,6.05,85,480,2458,10.1,0.21324271
27045,27045,Todd Fedoruk,2007-08,28.0,7,14,58,58,3,11,14,30.0,509.0,354,17,48,65,214.0,82,5.76,70,398,2426,9.7,0.16347367
27046,27046,Todd Fedoruk,2008-09,29.0,8,13,69,69,6,7,13,57.0,712.0,423,23,55,78,271.0,82,5.44,62,351,2383,9.4,0.17558324
27047,27047,Todd Fedoruk,2009-10,30.0,9,13,72,72,6,7,13,56.0,763.0,495,29,62,91,327.0,82,5.7,65,341,2477,9.4,0.17322457
27048,27048,Todd Fedoruk,2010-11,31.0,10,6,50,50,3,3,6,22.0,376.0,545,32,65,97,349.0,82,5.53,56,304,2486,9.1,0.12026796
27049,27049,Todd Flichel,1988-89,24.0,2,0,2,2,0,0,0,1.0,,2,0,0,0,1.0,80,7.43,89,437,2435,12.2,0.21445698
27050,27050,Todd Flichel,1989-90,25.0,3,0,1,1,0,0,0,1.0,,3,0,0,0,2.0,80,7.48,85,403,2430,12.3,0.18998975
27051,27051,Todd Flichel,1990-91,26.0,4,1,3,3,0,1,1,1.0,,6,0,1,1,3.0,80,7.37,76,367,2421,12.2,0.21123278
27052,27052,Todd Gill,1985-86,20.0,2,1,10,10,1,0,1,9.0,,10,1,0,1,9.0,80,7.77,71,321,2447,12.7,0.30666637
27053,27053,Todd Gill,1986-87,21.0,3,3,15,15,1,2,3,9.0,,25,2,2,4,18.0,80,7.94,82,370,2484,12.8,0.30405647
27054,27054,Todd Gill,1987-88,22.0,4,31,61,61,4,27,31,51.0,,86,6,29,35,69.0,80,7.34,72,344,2400,12.2,0.4400129
27055,27055,Todd Gill,1988-89,23.0,5,25,65,65,8,17,25,109.0,,151,14,46,60,178.0,80,7.43,89,437,2435,12.2,0.38560587
27056,27056,Todd Gill,1989-90,24.0,6,25,59,59,11,14,25,92.0,,210,25,60,85,270.0,80,7.48,85,403,2430,12.3,0.3964514
27057,27057,Todd Gill,1990-91,25.0,7,15,48,48,1,14,15,44.0,,258,26,74,100,314.0,80,7.37,76,367,2421,12.2,0.2865628
27058,27058,Todd Gill,1991-92,26.0,8,24,72,72,2,22,24,90.0,,330,28,96,124,404.0,80,6.91,71,366,2385,11.6,0.30495268
27059,27059,Todd Gill,1992-93,27.0,9,17,74,74,2,15,17,82.0,,404,30,111,141,486.0,80,6.96,77,402,2440,11.4,0.25562054
27060,27060,Todd Gill,1993-94,28.0,10,43,69,69,11,32,43,113.0,,473,41,143,184,599.0,84,7.25,87,443,2603,11.7,0.46736977
27061,27061,Todd Gill,1994-95,29.0,11,28,45,45,4,24,28,74.0,,518,45,167,212,673.0,84,6.48,76,407,2545,10.7,0.43788493
27062,27062,Todd Gill,1995-96,30.0,12,32,47,47,7,25,32,82.0,,565,52,192,244,755.0,48,5.97,37,209,1408,10.2,0.55148584
27063,27063,Todd Gill,1996-97,31.0,13,25,74,74,7,18,25,109.0,,639,59,210,269,864.0,82,6.29,74,413,2481,10.4,0.28316188
27064,27064,Todd Gill,1997-98,32.0,14,21,79,79,0,21,21,101.0,,718,59,231,290,965.0,82,5.83,55,336,2444,9.8,0.25108147
27065,27065,Todd Gill,1998-99,33.0,15,30,75,75,13,17,30,122.0,,793,72,248,320,1087.0,82,5.28,57,380,2242,9.6,0.34300762
27066,27066,Todd Gill,1999-00,34.0,16,9,51,51,4,5,9,61.0,924.0,844,76,253,329,1148.0,82,5.27,57,359,2285,9.4,0.15737188
27067,27067,Todd Gill,2000-01,35.0,17,9,54,54,3,6,9,61.0,862.0,898,79,259,338,1209.0,82,5.49,53,331,2294,9.8,0.14965424
27068,27068,Todd Gill,2001-02,36.0,18,11,68,68,3,8,11,66.0,1265.0,966,82,267,349,1275.0,82,5.51,63,376,2272,9.9,0.14403045
27069,27069,Todd Gill,2002-03,37.0,19,4,36,36,0,4,4,26.0,458.0,1002,82,271,353,1301.0,82,5.24,53,338,2262,9.5,0.14162546
27070,27070,Todd Gill,2003-04,38.0,20,1,5,5,0,1,1,9.0,98.0,1007,82,272,354,1310.0,82,5.31,60,363,2326,9.4,0.18339944
27071,27071,Todd Harkins,1992-93,24.0,2,0,5,5,0,0,0,4.0,,5,0,0,0,4.0,80,6.96,77,402,2440,11.4,0.21770963
27072,27072,Todd Harkins,1993-94,25.0,3,5,15,15,2,3,5,17.0,,20,2,3,5,21.0,84,7.25,87,443,2603,11.7,0.25444204
27073,27073,Todd Harkins,1994-95,26.0,4,1,28,28,1,0,1,15.0,,48,3,3,6,36.0,84,6.48,76,407,2545,10.7,0.13904688
27074,27074,Todd Harvey,1995-96,20.0,2,20,40,40,11,9,20,64.0,,40,11,9,20,64.0,48,5.97,37,209,1408,10.2,0.48223513
27075,27075,Todd Harvey,1996-97,21.0,3,29,69,69,9,20,29,101.0,,109,20,29,49,165.0,82,6.29,74,413,2481,10.4,0.42784104
27076,27076,Todd Harvey,1997-98,22.0,4,31,71,71,9,22,31,99.0,,180,29,51,80,264.0,82,5.83,55,336,2444,9.8,0.43390736
27077,27077,Todd Harvey,1998-99,23.0,5,19,59,59,9,10,19,88.0,,239,38,61,99,352.0,82,5.28,57,380,2242,9.6,0.43653712
27078,27078,Todd Harvey,1999-00,24.0,6,28,37,37,11,17,28,58.0,641.0,276,49,78,127,410.0,82,5.27,57,359,2285,9.4,0.5286913
27079,27079,Todd Harvey,2000-01,25.0,7,18,71,71,11,7,18,90.0,900.0,347,60,85,145,500.0,82,5.49,53,331,2294,9.8,0.36253226
27080,27080,Todd Harvey,2001-02,26.0,8,21,69,69,10,11,21,66.0,765.0,416,70,96,166,566.0,82,5.51,63,376,2272,9.9,0.3041718
27081,27081,Todd Harvey,2002-03,27.0,9,22,69,69,9,13,22,66.0,675.0,485,79,109,188,632.0,82,5.24,53,338,2262,9.5,0.31344596
27082,27082,Todd Harvey,2003-04,28.0,10,19,76,76,3,16,19,64.0,756.0,561,82,125,207,696.0,82,5.31,60,363,2326,9.4,0.23154825
27083,27083,Todd Harvey,2004-05,29.0,11,9,47,47,4,5,9,51.0,459.0,608,86,130,216,747.0,82,5.14,57,348,2300,9.2,0.20092806
27084,27084,Todd Harvey,2006-07,31.0,12,7,63,63,5,2,7,45.0,476.0,671,91,132,223,792.0,82,6.05,85,480,2458,10.1,0.17479229
27085,27085,Todd Hawkins,1989-90,23.0,2,0,4,4,0,0,0,2.0,,4,0,0,0,2.0,80,7.48,85,403,2430,12.3,0.21825555
27086,27086,Todd Hawkins,1990-91,24.0,3,0,4,4,0,0,0,3.0,,8,0,0,0,5.0,80,7.37,76,367,2421,12.2,0.19885212
27087,27087,Todd Hawkins,1992-93,26.0,4,0,2,2,0,0,0,0.0,,10,0,0,0,5.0,80,6.96,77,402,2440,11.4,0.18448135
27088,27088,Todd Hlushko,1994-95,24.0,2,1,2,2,1,0,1,2.0,,2,1,0,1,2.0,84,6.48,76,407,2545,10.7,0.21673268
27089,27089,Todd Hlushko,1995-96,25.0,3,1,2,2,0,1,1,3.0,,4,1,1,2,5.0,48,5.97,37,209,1408,10.2,0.20244029
27090,27090,Todd Hlushko,1996-97,26.0,4,0,4,4,0,0,0,6.0,,8,1,1,2,11.0,82,6.29,74,413,2481,10.4,0.16518983
27091,27091,Todd Hlushko,1997-98,27.0,5,18,58,58,7,11,18,76.0,,66,8,12,20,87.0,82,5.83,55,336,2444,9.8,0.27632457
27092,27092,Todd Hlushko,1998-99,28.0,6,1,13,13,0,1,1,7.0,,79,8,13,21,94.0,82,5.28,57,380,2242,9.6,0.15508792
27093,27093,Todd Krygier,1990-91,25.0,2,30,58,58,18,12,30,103.0,,58,18,12,30,103.0,80,7.37,76,367,2421,12.2,0.4936144
27094,27094,Todd Krygier,1991-92,26.0,3,30,72,72,13,17,30,113.0,,130,31,29,60,216.0,80,6.91,71,366,2385,11.6,0.42181495
27095,27095,Todd Krygier,1992-93,27.0,4,30,67,67,13,17,30,127.0,,197,44,46,90,343.0,80,6.96,77,402,2440,11.4,0.46321312
27096,27096,Todd Krygier,1993-94,28.0,5,23,77,77,11,12,23,133.0,,274,55,58,113,476.0,84,7.25,87,443,2603,11.7,0.3151367
27097,27097,Todd Krygier,1994-95,29.0,6,30,66,66,12,18,30,146.0,,340,67,76,143,622.0,84,6.48,76,407,2545,10.7,0.41162735
27098,27098,Todd Krygier,1995-96,30.0,7,22,35,35,11,11,22,90.0,,375,78,87,165,712.0,48,5.97,37,209,1408,10.2,0.5516236
27099,27099,Todd Krygier,1996-97,31.0,8,48,76,76,15,33,48,181.0,,451,93,120,213,893.0,82,6.29,74,413,2481,10.4,0.51221186
27100,27100,Todd Krygier,1997-98,32.0,9,16,47,47,5,11,16,121.0,,498,98,131,229,1014.0,82,5.83,55,336,2444,9.8,0.35504597
27101,27101,Todd Krygier,1998-99,33.0,10,14,45,45,2,12,14,71.0,,543,100,143,243,1085.0,82,5.28,57,380,2242,9.6,0.24708635
27102,27102,Todd Marchant,1994-95,21.0,2,1,4,4,0,1,1,6.0,,4,0,1,1,6.0,84,6.48,76,407,2545,10.7,0.2576723
27103,27103,Todd Marchant,1995-96,22.0,3,27,45,45,13,14,27,95.0,,49,13,15,28,101.0,48,5.97,37,209,1408,10.2,0.5343311
27104,27104,Todd Marchant,1996-97,23.0,4,38,81,81,19,19,38,221.0,,130,32,34,66,322.0,82,6.29,74,413,2481,10.4,0.50372094
27105,27105,Todd Marchant,1997-98,24.0,5,33,79,79,14,19,33,202.0,,209,46,53,99,524.0,82,5.83,55,336,2444,9.8,0.4929056
27106,27106,Todd Marchant,1998-99,25.0,6,35,76,76,14,21,35,194.0,,285,60,74,134,718.0,82,5.28,57,380,2242,9.6,0.49807552
27107,27107,Todd Marchant,1999-00,26.0,7,36,82,82,14,22,36,183.0,1376.0,367,74,96,170,901.0,82,5.27,57,359,2285,9.4,0.5321806
27108,27108,Todd Marchant,2000-01,27.0,8,40,82,82,17,23,40,170.0,1405.0,449,91,119,210,1071.0,82,5.49,53,331,2294,9.8,0.5421387
27109,27109,Todd Marchant,2001-02,28.0,9,39,71,71,13,26,39,113.0,1271.0,520,104,145,249,1184.0,82,5.51,63,376,2272,9.9,0.4600427
27110,27110,Todd Marchant,2002-03,29.0,10,34,82,82,12,22,34,124.0,1392.0,602,116,167,283,1308.0,82,5.24,53,338,2262,9.5,0.41528356
27111,27111,Todd Marchant,2003-04,30.0,11,60,77,77,20,40,60,146.0,1532.0,679,136,207,343,1454.0,82,5.31,60,363,2326,9.4,0.63761055
27112,27112,Todd Marchant,2004-05,31.0,12,34,77,77,9,25,34,163.0,1590.0,756,145,232,377,1617.0,82,5.14,57,348,2300,9.2,0.51360375
27113,27113,Todd Marchant,2006-07,33.0,13,34,79,79,9,25,34,132.0,1363.0,835,154,257,411,1749.0,82,6.05,85,480,2458,10.1,0.36024448
27114,27114,Todd Marchant,2007-08,34.0,14,23,56,56,8,15,23,115.0,850.0,891,162,272,434,1864.0,82,5.76,70,398,2426,9.7,0.37834767
27115,27115,Todd Marchant,2008-09,35.0,15,16,75,75,9,7,16,93.0,1112.0,966,171,279,450,1957.0,82,5.44,62,351,2383,9.4,0.24632248
27116,27116,Todd Marchant,2009-10,36.0,16,18,72,72,5,13,18,101.0,1046.0,1038,176,292,468,2058.0,82,5.7,65,341,2477,9.4,0.23970637
27117,27117,Todd Marchant,2010-11,37.0,17,22,78,78,9,13,22,83.0,1233.0,1116,185,305,490,2141.0,82,5.53,56,304,2486,9.1,0.24031371
27118,27118,Todd Marchant,2011-12,38.0,18,8,79,79,1,7,8,63.0,1050.0,1195,186,312,498,2204.0,82,5.46,52,291,2492,9.0,0.17455685
27119,27119,Todd McLellan,1988-89,21.0,2,2,5,5,1,1,2,4.0,,5,1,1,2,4.0,80,7.43,89,437,2435,12.2,0.32395917
27120,27120,Todd Nelson,1992-93,23.0,2,0,1,1,0,0,0,0.0,,1,0,0,0,0.0,80,6.96,77,402,2440,11.4,0.18171716
27121,27121,Todd Nelson,1994-95,25.0,3,1,2,2,1,0,1,1.0,,3,1,0,1,1.0,84,6.48,76,407,2545,10.7,0.19112334
27122,27122,Todd Okerlund,1988-89,24.0,2,0,4,4,0,0,0,3.0,,4,0,0,0,3.0,80,7.43,89,437,2435,12.2,0.23191011
27123,27123,Todd Reirden,1999-00,28.0,2,5,17,17,2,3,5,26.0,294.0,17,2,3,5,26.0,82,5.27,57,359,2285,9.4,0.248568
27124,27124,Todd Reirden,2000-01,29.0,3,25,56,56,4,21,25,77.0,1025.0,73,6,24,30,103.0,82,5.49,53,331,2294,9.8,0.3400873
27125,27125,Todd Reirden,2001-02,30.0,4,6,38,38,2,4,6,58.0,640.0,111,8,28,36,161.0,82,5.51,63,376,2272,9.9,0.2054151
27126,27126,Todd Reirden,2002-03,31.0,5,8,65,65,3,5,8,85.0,1172.0,176,11,33,44,246.0,82,5.24,53,338,2262,9.5,0.17270124
27127,27127,Todd Reirden,2004-05,33.0,6,2,7,7,0,2,2,9.0,108.0,183,11,35,46,255.0,82,5.14,57,348,2300,9.2,0.21957383
27128,27128,Todd Richards,1991-92,25.0,2,4,2,2,0,4,4,4.0,,2,0,4,4,4.0,80,6.91,71,366,2385,11.6,0.21855265
27129,27129,Todd Richards,1992-93,26.0,3,0,6,6,0,0,0,3.0,,8,0,4,4,7.0,80,6.96,77,402,2440,11.4,0.1932424
27130,27130,Todd Rohloff,2002-03,29.0,2,1,16,16,0,1,1,6.0,227.0,16,0,1,1,6.0,82,5.24,53,338,2262,9.5,0.16975543
27131,27131,Todd Rohloff,2004-05,31.0,3,5,59,59,0,5,5,35.0,956.0,75,0,6,6,41.0,82,5.14,57,348,2300,9.2,0.14087018
27132,27132,Todd Simon,1994-95,22.0,2,1,15,15,0,1,1,14.0,,15,0,1,1,14.0,84,6.48,76,407,2545,10.7,0.1836681
27133,27133,Todd Simpson,1996-97,23.0,2,0,6,6,0,0,0,3.0,,6,0,0,0,3.0,82,6.29,74,413,2481,10.4,0.17841864
27134,27134,Todd Simpson,1997-98,24.0,3,14,82,82,1,13,14,85.0,,88,1,13,14,88.0,82,5.83,55,336,2444,9.8,0.19185352
27135,27135,Todd Simpson,1998-99,25.0,4,6,53,53,1,5,6,51.0,,141,2,18,20,139.0,82,5.28,57,380,2242,9.6,0.15300402
27136,27136,Todd Simpson,1999-00,26.0,5,10,73,73,2,8,10,52.0,1264.0,214,4,26,30,191.0,82,5.27,57,359,2285,9.4,0.17077515
27137,27137,Todd Simpson,2000-01,27.0,6,7,82,82,1,6,7,50.0,1360.0,296,5,32,37,241.0,82,5.49,53,331,2294,9.8,0.12491834
27138,27138,Todd Simpson,2001-02,28.0,7,5,38,38,1,4,5,35.0,593.0,334,6,36,42,276.0,82,5.51,63,376,2272,9.9,0.1371293
27139,27139,Todd Simpson,2002-03,29.0,8,15,67,67,2,13,15,51.0,1161.0,401,8,49,57,327.0,82,5.24,53,338,2262,9.5,0.1641117
27140,27140,Todd Simpson,2003-04,30.0,9,9,66,66,2,7,9,67.0,1121.0,467,10,56,66,394.0,82,5.31,60,363,2326,9.4,0.15891987
27141,27141,Todd Simpson,2004-05,31.0,10,8,62,62,4,4,8,52.0,887.0,529,14,60,74,446.0,82,5.14,57,348,2300,9.2,0.15361604
27142,27142,Todd Simpson,2006-07,33.0,11,3,51,51,0,3,3,31.0,685.0,580,14,63,77,477.0,82,6.05,85,480,2458,10.1,0.0862402
27143,27143,Todd Strueby,1982-83,19.0,2,0,3,3,0,0,0,1.0,,3,0,0,0,1.0,80,8.03,73,320,2489,12.9,0.26938012
27144,27144,Todd Strueby,1983-84,20.0,3,0,1,1,0,0,0,1.0,,4,0,0,0,2.0,80,7.73,71,310,2444,12.7,0.2721457
27145,27145,Todd Strueby,1984-85,21.0,4,1,1,1,0,1,1,1.0,,5,0,1,1,3.0,80,7.89,74,336,2448,12.9,0.29163522
27146,27146,Todd Warriner,1995-96,22.0,2,0,5,5,0,0,0,1.0,,5,0,0,0,1.0,48,5.97,37,209,1408,10.2,0.19276294
27147,27147,Todd Warriner,1996-97,23.0,3,15,57,57,7,8,15,79.0,,62,7,8,15,80.0,82,6.29,74,413,2481,10.4,0.28888112
27148,27148,Todd Warriner,1997-98,24.0,4,33,75,75,12,21,33,146.0,,137,19,29,48,226.0,82,5.83,55,336,2444,9.8,0.41849625
27149,27149,Todd Warriner,1998-99,25.0,5,13,45,45,5,8,13,73.0,,182,24,37,61,299.0,82,5.28,57,380,2242,9.6,0.29755366
27150,27150,Todd Warriner,1999-00,26.0,6,19,53,53,9,10,19,96.0,747.0,235,33,47,80,395.0,82,5.27,57,359,2285,9.4,0.3780455
27151,27151,Todd Warriner,2000-01,27.0,7,28,73,73,14,14,28,133.0,1132.0,308,47,61,108,528.0,82,5.49,53,331,2294,9.8,0.37534338
27152,27152,Todd Warriner,2001-02,28.0,8,21,64,64,10,11,21,99.0,942.0,372,57,72,129,627.0,82,5.51,63,376,2272,9.9,0.3049603
27153,27153,Todd Warriner,2002-03,29.0,9,9,32,32,2,7,9,28.0,322.0,404,59,79,138,655.0,82,5.24,53,338,2262,9.5,0.2816708
27154,27154,Todd Warriner,2003-04,30.0,10,16,49,49,6,10,16,72.0,528.0,453,65,89,154,727.0,82,5.31,60,363,2326,9.4,0.32501665
27155,27155,Todd White,1998-99,23.0,2,1,7,7,1,0,1,3.0,,7,1,0,1,3.0,82,5.28,57,380,2242,9.6,0.22183159
27156,27156,Todd White,1999-00,24.0,3,13,35,35,5,8,13,43.0,478.0,42,6,8,14,46.0,82,5.27,57,359,2285,9.4,0.25921232
27157,27157,Todd White,2000-01,25.0,4,1,4,4,1,0,1,4.0,44.0,46,7,8,15,50.0,82,5.49,53,331,2294,9.8,0.18473029
27158,27158,Todd White,2001-02,26.0,5,5,16,16,4,1,5,12.0,137.0,62,11,9,20,62.0,82,5.51,63,376,2272,9.9,0.24485877
27159,27159,Todd White,2002-03,27.0,6,50,81,81,20,30,50,147.0,1487.0,143,31,39,70,209.0,82,5.24,53,338,2262,9.5,0.5427275
27160,27160,Todd White,2003-04,28.0,7,60,80,80,25,35,60,144.0,1437.0,223,56,74,130,353.0,82,5.31,60,363,2326,9.4,0.65386194
27161,27161,Todd White,2004-05,29.0,8,29,53,53,9,20,29,98.0,929.0,276,65,94,159,451.0,82,5.14,57,348,2300,9.2,0.57753396
27162,27162,Todd White,2006-07,31.0,9,40,61,61,19,21,40,109.0,1049.0,337,84,115,199,560.0,82,6.05,85,480,2458,10.1,0.56788963
27163,27163,Todd White,2007-08,32.0,10,44,77,77,13,31,44,162.0,1326.0,414,97,146,243,722.0,82,5.76,70,398,2426,9.7,0.46470588
27164,27164,Todd White,2008-09,33.0,11,37,74,74,14,23,37,111.0,1364.0,488,111,169,280,833.0,82,5.44,62,351,2383,9.4,0.42565504
27165,27165,Todd White,2009-10,34.0,12,73,82,82,22,51,73,150.0,1481.0,570,133,220,353,983.0,82,5.7,65,341,2477,9.4,0.74161625
27166,27166,Todd White,2010-11,35.0,13,26,65,65,7,19,26,92.0,991.0,635,140,239,379,1075.0,82,5.53,56,304,2486,9.1,0.31222683
27167,27167,Todd White,2011-12,36.0,14,2,18,18,1,1,2,11.0,138.0,653,141,240,381,1086.0,82,5.46,52,291,2492,9.0,0.19867387
27168,27168,Tom Bissett,1991-92,25.0,2,0,5,5,0,0,0,2.0,,5,0,0,0,2.0,80,6.91,71,366,2385,11.6,0.18553627
27169,27169,Tom Cavanagh,2008-09,26.0,2,1,1,1,0,1,1,0.0,14.0,1,0,1,1,0.0,82,5.44,62,351,2383,9.4,0.18881413
27170,27170,Tom Cavanagh,2009-10,27.0,3,2,17,17,1,1,2,9.0,131.0,18,1,2,3,9.0,82,5.7,65,341,2477,9.4,0.17931154
27171,27171,Tom Chorske,1990-91,24.0,2,4,14,14,3,1,4,19.0,,14,3,1,4,19.0,80,7.37,76,367,2421,12.2,0.31412223
27172,27172,Tom Chorske,1991-92,25.0,3,20,57,57,9,11,20,82.0,,71,12,12,24,101.0,80,6.91,71,366,2385,11.6,0.33007255
27173,27173,Tom Chorske,1992-93,26.0,4,36,76,76,19,17,36,143.0,,147,31,29,60,244.0,80,6.96,77,402,2440,11.4,0.4403485
27174,27174,Tom Chorske,1993-94,27.0,5,19,50,50,7,12,19,63.0,,197,38,41,79,307.0,84,7.25,87,443,2603,11.7,0.38216153
27175,27175,Tom Chorske,1994-95,28.0,6,41,76,76,21,20,41,131.0,,273,59,61,120,438.0,84,6.48,76,407,2545,10.7,0.45583406
27176,27176,Tom Chorske,1995-96,29.0,7,18,42,42,10,8,18,59.0,,315,69,69,138,497.0,48,5.97,37,209,1408,10.2,0.4189436
27177,27177,Tom Chorske,1996-97,30.0,8,29,72,72,15,14,29,118.0,,387,84,83,167,615.0,82,6.29,74,413,2481,10.4,0.35853568
27178,27178,Tom Chorske,1997-98,31.0,9,26,68,68,18,8,26,116.0,,455,102,91,193,731.0,82,5.83,55,336,2444,9.8,0.3511799
27179,27179,Tom Chorske,1998-99,32.0,10,35,82,82,12,23,35,132.0,,537,114,114,228,863.0,82,5.28,57,380,2242,9.6,0.36641383
27180,27180,Tom Chorske,1999-00,33.0,11,3,26,26,0,3,3,44.0,317.0,563,114,117,231,907.0,82,5.27,57,359,2285,9.4,0.20124128
27181,27181,Tom Chorske,2000-01,34.0,12,6,33,33,1,5,6,14.0,259.0,596,115,122,237,921.0,82,5.49,53,331,2294,9.8,0.17000523
27182,27182,Tom Fergus,1982-83,20.0,2,39,61,61,15,24,39,116.0,,61,15,24,39,116.0,80,8.03,73,320,2489,12.9,0.6610669
27183,27183,Tom Fergus,1983-84,21.0,3,63,80,80,28,35,63,169.0,,141,43,59,102,285.0,80,7.73,71,310,2444,12.7,0.8307618
27184,27184,Tom Fergus,1984-85,22.0,4,61,69,69,25,36,61,123.0,,210,68,95,163,408.0,80,7.89,74,336,2448,12.9,0.83846116
27185,27185,Tom Fergus,1985-86,23.0,5,73,79,79,30,43,73,188.0,,289,98,138,236,596.0,80,7.77,71,321,2447,12.7,0.919073
27186,27186,Tom Fergus,1986-87,24.0,6,73,78,78,31,42,73,168.0,,367,129,180,309,764.0,80,7.94,82,370,2484,12.8,0.8449714
27187,27187,Tom Fergus,1987-88,25.0,7,49,57,57,21,28,49,119.0,,424,150,208,358,883.0,80,7.34,72,344,2400,12.2,0.82228065
27188,27188,Tom Fergus,1988-89,26.0,8,50,63,63,19,31,50,124.0,,487,169,239,408,1007.0,80,7.43,89,437,2435,12.2,0.7876085
27189,27189,Tom Fergus,1989-90,27.0,9,67,80,80,22,45,67,151.0,,567,191,284,475,1158.0,80,7.48,85,403,2430,12.3,0.8005645
27190,27190,Tom Fergus,1990-91,28.0,10,45,54,54,19,26,45,120.0,,621,210,310,520,1278.0,80,7.37,76,367,2421,12.2,0.68352544
27191,27191,Tom Fergus,1991-92,29.0,11,9,14,14,5,4,9,17.0,,635,215,314,529,1295.0,80,6.91,71,366,2385,11.6,0.6313363
27192,27192,Tom Fergus,1992-93,30.0,12,38,55,55,15,23,38,103.0,,690,230,337,567,1398.0,80,6.96,77,402,2440,11.4,0.58069706
27193,27193,Tom Fergus,1993-94,31.0,13,14,36,36,5,9,14,29.0,,726,235,346,581,1427.0,84,7.25,87,443,2603,11.7,0.35974792
27194,27194,Tom Fitzgerald,1989-90,21.0,2,8,23,23,3,5,8,24.0,,23,3,5,8,24.0,80,7.48,85,403,2430,12.3,0.43569332
27195,27195,Tom Fitzgerald,1990-91,22.0,3,7,19,19,2,5,7,24.0,,42,5,10,15,48.0,80,7.37,76,367,2421,12.2,0.35384622
27196,27196,Tom Fitzgerald,1991-92,23.0,4,10,41,41,5,5,10,60.0,,83,10,15,25,108.0,80,6.91,71,366,2385,11.6,0.32905716
27197,27197,Tom Fitzgerald,1992-93,24.0,5,17,45,45,6,11,17,71.0,,128,16,26,42,179.0,80,6.96,77,402,2440,11.4,0.34518135
27198,27198,Tom Fitzgerald,1993-94,25.0,6,27,77,77,9,18,27,83.0,,205,25,44,69,262.0,84,7.25,87,443,2603,11.7,0.30630827
27199,27199,Tom Fitzgerald,1994-95,26.0,7,32,83,83,18,14,32,144.0,,288,43,58,101,406.0,84,6.48,76,407,2545,10.7,0.40162915
27200,27200,Tom Fitzgerald,1995-96,27.0,8,16,48,48,3,13,16,78.0,,336,46,71,117,484.0,48,5.97,37,209,1408,10.2,0.30261368
27201,27201,Tom Fitzgerald,1996-97,28.0,9,34,82,82,13,21,34,141.0,,418,59,92,151,625.0,82,6.29,74,413,2481,10.4,0.39034283
27202,27202,Tom Fitzgerald,1997-98,29.0,10,24,71,71,10,14,24,135.0,,489,69,106,175,760.0,82,5.83,55,336,2444,9.8,0.33358896
27203,27203,Tom Fitzgerald,1998-99,30.0,11,18,80,80,12,6,18,119.0,,569,81,112,193,879.0,82,5.28,57,380,2242,9.6,0.2582304
27204,27204,Tom Fitzgerald,1999-00,31.0,12,32,80,80,13,19,32,180.0,1383.0,649,94,131,225,1059.0,82,5.27,57,359,2285,9.4,0.40944132
27205,27205,Tom Fitzgerald,2000-01,32.0,13,22,82,82,13,9,22,119.0,1144.0,731,107,140,247,1178.0,82,5.49,53,331,2294,9.8,0.2756777
27206,27206,Tom Fitzgerald,2001-02,33.0,14,18,82,82,9,9,18,135.0,1227.0,813,116,149,265,1313.0,82,5.51,63,376,2272,9.9,0.24795121
27207,27207,Tom Fitzgerald,2002-03,34.0,15,20,78,78,8,12,20,125.0,1142.0,891,124,161,285,1438.0,82,5.24,53,338,2262,9.5,0.24810827
27208,27208,Tom Fitzgerald,2003-04,35.0,16,17,66,66,4,13,17,89.0,799.0,957,128,174,302,1527.0,82,5.31,60,363,2326,9.4,0.20556337
27209,27209,Tom Fitzgerald,2004-05,36.0,17,17,69,69,7,10,17,81.0,854.0,1026,135,184,319,1608.0,82,5.14,57,348,2300,9.2,0.2677384
27210,27210,Tom Fitzgerald,2006-07,38.0,18,10,71,71,4,6,10,50.0,671.0,1097,139,190,329,1658.0,82,6.05,85,480,2458,10.1,0.12990537
27211,27211,Tom Gilbert,2007-08,25.0,2,6,12,12,1,5,6,13.0,241.0,12,1,5,6,13.0,82,5.76,70,398,2426,9.7,0.21678418
27212,27212,Tom Gilbert,2008-09,26.0,3,33,82,82,13,20,33,98.0,1820.0,94,14,25,39,111.0,82,5.44,62,351,2383,9.4,0.4205314
27213,27213,Tom Gilbert,2009-10,27.0,4,45,82,82,5,40,45,107.0,1802.0,176,19,65,84,218.0,82,5.7,65,341,2477,9.4,0.46632758
27214,27214,Tom Gilbert,2010-11,28.0,5,31,82,82,5,26,31,98.0,1839.0,258,24,91,115,316.0,82,5.53,56,304,2486,9.1,0.41595092
27215,27215,Tom Gilbert,2011-12,29.0,6,26,79,79,6,20,26,106.0,1936.0,337,30,111,141,422.0,82,5.46,52,291,2492,9.0,0.35981622
27216,27216,Tom Gilbert,2012-13,30.0,7,22,67,67,3,19,22,72.0,1612.0,404,33,130,163,494.0,82,5.32,47,271,2439,8.9,0.29389217
27217,27217,Tom Gilbert,2013-14,31.0,8,13,43,43,3,10,13,36.0,831.0,447,36,140,176,530.0,48,5.31,29,160,1399,9.1,0.28028542
27218,27218,Tom Gilbert,2014-15,32.0,9,28,73,73,3,25,28,93.0,1558.0,520,39,165,204,623.0,82,5.34,48,269,2463,8.9,0.3224338
27219,27219,Tom Gilbert,2015-16,33.0,10,12,72,72,4,8,12,70.0,1392.0,592,43,173,216,693.0,82,5.32,47,251,2453,8.9,0.19355917
27220,27220,Tom Gilbert,2016-17,34.0,11,2,45,45,1,1,2,36.0,759.0,637,44,174,218,729.0,82,5.34,48,255,2438,9.0,0.1290521
27221,27221,Tom Gilbert,2017-18,35.0,12,5,18,18,1,4,5,12.0,278.0,655,45,178,223,741.0,82,5.45,47,245,2478,9.0,0.19125372
27222,27222,Tom Hirsch,1984-85,22.0,2,4,15,15,1,3,4,24.0,,15,1,3,4,24.0,80,7.89,74,336,2448,12.9,0.31464374
27223,27223,Tom Hirsch,1985-86,23.0,3,4,15,15,0,4,4,14.0,,30,1,7,8,38.0,80,7.77,71,321,2447,12.7,0.24772266
27224,27224,Tom Hirsch,1988-89,26.0,4,0,1,1,0,0,0,0.0,,31,1,7,8,38.0,80,7.43,89,437,2435,12.2,0.18593454
27225,27225,Tom Koivisto,2003-04,29.0,2,6,22,22,2,4,6,26.0,368.0,22,2,4,6,26.0,82,5.31,60,363,2326,9.4,0.22934991
27226,27226,Tom Kostopoulos,2002-03,24.0,2,3,11,11,1,2,3,8.0,132.0,11,1,2,3,8.0,82,5.24,53,338,2262,9.5,0.20129901
27227,27227,Tom Kostopoulos,2003-04,25.0,3,1,8,8,0,1,1,6.0,36.0,19,1,3,4,14.0,82,5.31,60,363,2326,9.4,0.1649057
27228,27228,Tom Kostopoulos,2004-05,26.0,4,22,60,60,9,13,22,101.0,866.0,79,10,16,26,115.0,82,5.14,57,348,2300,9.2,0.3558668
27229,27229,Tom Kostopoulos,2006-07,28.0,5,22,76,76,8,14,22,74.0,983.0,155,18,30,48,189.0,82,6.05,85,480,2458,10.1,0.23599786
27230,27230,Tom Kostopoulos,2007-08,29.0,6,22,76,76,7,15,22,90.0,879.0,231,25,45,70,279.0,82,5.76,70,398,2426,9.7,0.26495335
27231,27231,Tom Kostopoulos,2008-09,30.0,7,13,67,67,7,6,13,98.0,755.0,298,32,51,83,377.0,82,5.44,62,351,2383,9.4,0.20810774
27232,27232,Tom Kostopoulos,2009-10,31.0,8,22,78,78,8,14,22,121.0,1103.0,376,40,65,105,498.0,82,5.7,65,341,2477,9.4,0.26090312
27233,27233,Tom Kostopoulos,2010-11,32.0,9,21,82,82,8,13,21,103.0,1027.0,458,48,78,126,601.0,82,5.53,56,304,2486,9.1,0.25386512
27234,27234,Tom Kostopoulos,2011-12,33.0,10,18,76,76,8,10,18,79.0,938.0,534,56,88,144,680.0,82,5.46,52,291,2492,9.0,0.24748617
27235,27235,Tom Kostopoulos,2012-13,34.0,11,12,81,81,4,8,12,91.0,998.0,615,60,96,156,771.0,82,5.32,47,271,2439,8.9,0.1657187
27236,27236,Tom Kostopoulos,2013-14,35.0,12,1,15,15,1,0,1,13.0,136.0,630,61,96,157,784.0,48,5.31,29,160,1399,9.1,0.17743668
27237,27237,Tom Kuhnhackl,2016-17,25.0,2,15,42,42,5,10,15,52.0,512.0,42,5,10,15,52.0,82,5.34,48,255,2438,9.0,0.26589358
27238,27238,Tom Kuhnhackl,2017-18,26.0,3,16,57,57,4,12,16,49.0,607.0,99,9,22,31,101.0,82,5.45,47,245,2478,9.0,0.25392
27239,27239,Tom Kuhnhackl,2018-19,27.0,4,8,69,69,2,6,8,63.0,691.0,168,11,28,39,164.0,82,5.86,50,250,2620,9.2,0.15448517
27240,27240,Tom Kuhnhackl,2019-20,28.0,5,9,36,36,4,5,9,30.0,457.0,204,15,33,48,194.0,82,5.96,47,239,2579,9.5,0.20032525
27241,27241,Tom Kuhnhackl,2020-21,29.0,6,6,28,28,3,3,6,28.0,316.0,232,18,36,54,222.0,70,5.96,42,208,2192,9.5,0.24892211
27242,27242,Tom Kurvers,1985-86,23.0,2,45,75,75,10,35,45,136.0,,75,10,35,45,136.0,80,7.77,71,321,2447,12.7,0.6200371
27243,27243,Tom Kurvers,1986-87,24.0,3,30,62,62,7,23,30,69.0,,137,17,58,75,205.0,80,7.94,82,370,2484,12.8,0.4485524
27244,27244,Tom Kurvers,1987-88,25.0,4,23,56,56,6,17,23,73.0,,193,23,75,98,278.0,80,7.34,72,344,2400,12.2,0.45031762
27245,27245,Tom Kurvers,1988-89,26.0,5,34,56,56,5,29,34,88.0,,249,28,104,132,366.0,80,7.43,89,437,2435,12.2,0.5838115
27246,27246,Tom Kurvers,1989-90,27.0,6,66,74,74,16,50,66,190.0,,323,44,154,198,556.0,80,7.48,85,403,2430,12.3,0.7913067
27247,27247,Tom Kurvers,1990-91,28.0,7,52,71,71,15,37,52,156.0,,394,59,191,250,712.0,80,7.37,76,367,2421,12.2,0.6371188
27248,27248,Tom Kurvers,1991-92,29.0,8,30,51,51,4,26,30,99.0,,445,63,217,280,811.0,80,6.91,71,366,2385,11.6,0.52767676
27249,27249,Tom Kurvers,1992-93,30.0,9,56,74,74,9,47,56,132.0,,519,72,264,336,943.0,80,6.96,77,402,2440,11.4,0.7096142
27250,27250,Tom Kurvers,1993-94,31.0,10,38,52,52,8,30,38,128.0,,571,80,294,374,1071.0,84,7.25,87,443,2603,11.7,0.6195977
27251,27251,Tom Kurvers,1994-95,32.0,11,40,66,66,9,31,40,141.0,,637,89,325,414,1212.0,84,6.48,76,407,2545,10.7,0.4951017
27252,27252,Tom Kurvers,1995-96,33.0,12,7,22,22,4,3,7,44.0,,659,93,328,421,1256.0,48,5.97,37,209,1408,10.2,0.42260852
27253,27253,Tom Laidlaw,1981-82,23.0,2,29,80,80,6,23,29,101.0,,80,6,23,29,101.0,80,7.69,77,340,2441,12.6,0.4205802
27254,27254,Tom Laidlaw,1982-83,24.0,3,21,79,79,3,18,21,62.0,,159,9,41,50,163.0,80,8.03,73,320,2489,12.9,0.25866607
27255,27255,Tom Laidlaw,1983-84,25.0,4,10,80,80,0,10,10,44.0,,239,9,51,60,207.0,80,7.73,71,310,2444,12.7,0.19394508
27256,27256,Tom Laidlaw,1984-85,26.0,5,18,79,79,3,15,18,64.0,,318,12,66,78,271.0,80,7.89,74,336,2448,12.9,0.23693228
27257,27257,Tom Laidlaw,1985-86,27.0,6,12,61,61,1,11,12,37.0,,379,13,77,90,308.0,80,7.77,71,321,2447,12.7,0.2197527
27258,27258,Tom Laidlaw,1986-87,28.0,7,18,68,68,6,12,18,49.0,,447,19,89,108,357.0,80,7.94,82,370,2484,12.8,0.26817548
27259,27259,Tom Laidlaw,1987-88,29.0,8,14,74,74,1,13,14,42.0,,521,20,102,122,399.0,80,7.34,72,344,2400,12.2,0.19308078
27260,27260,Tom Laidlaw,1988-89,30.0,9,13,57,57,1,12,13,30.0,,578,21,114,135,429.0,80,7.43,89,437,2435,12.2,0.17609316
27261,27261,Tom Laidlaw,1989-90,31.0,10,20,70,70,3,17,20,31.0,,648,24,131,155,460.0,80,7.48,85,403,2430,12.3,0.21078369
27262,27262,Tom Laidlaw,1990-91,32.0,11,9,57,57,1,8,9,27.0,,705,25,139,164,487.0,80,7.37,76,367,2421,12.2,0.1537804
27263,27263,Tom Martin,1985-86,21.0,2,1,8,8,1,0,1,4.0,,8,1,0,1,4.0,80,7.77,71,321,2447,12.7,0.2722531
27264,27264,Tom Martin,1986-87,22.0,3,0,5,5,0,0,0,1.0,,13,1,0,1,5.0,80,7.94,82,370,2484,12.8,0.20351544
27265,27265,Tom Martin,1987-88,23.0,4,1,11,11,1,0,1,3.0,,24,2,0,2,8.0,80,7.34,72,344,2400,12.2,0.24077383
27266,27266,Tom Martin,1988-89,24.0,5,3,5,5,1,2,3,8.0,,29,3,2,5,16.0,80,7.43,89,437,2435,12.2,0.24057835
27267,27267,Tom Martin,1989-90,25.0,6,15,42,42,8,7,15,46.0,,71,11,9,20,62.0,80,7.48,85,403,2430,12.3,0.326568
27268,27268,Tom Martin,1990-91,26.0,7,3,21,21,1,2,3,13.0,,92,12,11,23,75.0,80,7.37,76,367,2421,12.2,0.20820907
27269,27269,Tom McCarthy,1980-81,20.0,2,36,68,68,16,20,36,101.0,,68,16,20,36,101.0,80,7.03,61,280,2352,12.0,0.5706465
27270,27270,Tom McCarthy,1981-82,21.0,3,48,62,62,23,25,48,147.0,,130,39,45,84,248.0,80,7.69,77,340,2441,12.6,0.89634407
27271,27271,Tom McCarthy,1982-83,22.0,4,42,40,40,12,30,42,89.0,,170,51,75,126,337.0,80,8.03,73,320,2489,12.9,0.7914749
27272,27272,Tom McCarthy,1983-84,23.0,5,76,80,80,28,48,76,171.0,,250,79,123,202,508.0,80,7.73,71,310,2444,12.7,0.91040295
27273,27273,Tom McCarthy,1984-85,24.0,6,70,66,66,39,31,70,165.0,,316,118,154,272,673.0,80,7.89,74,336,2448,12.9,0.95501614
27274,27274,Tom McCarthy,1985-86,25.0,7,37,44,44,16,21,37,80.0,,360,134,175,309,753.0,80,7.77,71,321,2447,12.7,0.748513
27275,27275,Tom McCarthy,1986-87,26.0,8,24,25,25,12,12,24,45.0,,385,146,187,333,798.0,80,7.94,82,370,2484,12.8,0.79970354
27276,27276,Tom McCarthy,1987-88,27.0,9,59,68,68,30,29,59,121.0,,453,176,216,392,919.0,80,7.34,72,344,2400,12.2,0.79258335
27277,27277,Tom McCarthy,1988-89,28.0,10,7,7,7,2,5,7,10.0,,460,178,221,399,929.0,80,7.43,89,437,2435,12.2,0.55057853
27278,27278,Tom McMurchy,1984-85,21.0,2,4,27,27,3,1,4,21.0,,27,3,1,4,21.0,80,7.89,74,336,2448,12.9,0.3393433
27279,27279,Tom McMurchy,1985-86,22.0,3,3,15,15,1,2,3,8.0,,42,4,3,7,29.0,80,7.77,71,321,2447,12.7,0.26278463
27280,27280,Tom McMurchy,1986-87,23.0,4,0,4,4,0,0,0,2.0,,46,4,3,7,31.0,80,7.94,82,370,2484,12.8,0.20534644
27281,27281,Tom McMurchy,1988-89,25.0,5,5,9,9,4,1,5,11.0,,55,8,4,12,42.0,80,7.43,89,437,2435,12.2,0.27665558
27282,27282,Tom O'Regan,1984-85,23.0,2,14,51,51,4,10,14,44.0,,51,4,10,14,44.0,80,7.89,74,336,2448,12.9,0.3036747
27283,27283,Tom O'Regan,1985-86,24.0,3,0,1,1,0,0,0,1.0,,52,4,10,14,45.0,80,7.77,71,321,2447,12.7,0.20427996
27284,27284,Tom O'Regan,1986-87,25.0,4,3,9,9,1,2,3,7.0,,61,5,12,17,52.0,80,7.94,82,370,2484,12.8,0.23326033
27285,27285,Tom Pederson,1993-94,24.0,2,20,44,44,7,13,20,102.0,,44,7,13,20,102.0,84,7.25,87,443,2603,11.7,0.4185662
27286,27286,Tom Pederson,1994-95,25.0,3,25,74,74,6,19,25,185.0,,118,13,32,45,287.0,84,6.48,76,407,2545,10.7,0.38582137
27287,27287,Tom Pederson,1995-96,26.0,4,16,47,47,5,11,16,59.0,,165,18,43,61,346.0,48,5.97,37,209,1408,10.2,0.33741885
27288,27288,Tom Pederson,1996-97,27.0,5,5,60,60,1,4,5,59.0,,225,19,47,66,405.0,82,6.29,74,413,2481,10.4,0.1785548
27289,27289,Tom Pederson,1997-98,28.0,6,3,15,15,1,2,3,23.0,,240,20,49,69,428.0,82,5.83,55,336,2444,9.8,0.2578012
27290,27290,Tom Poti,1999-00,22.0,2,21,73,73,5,16,21,94.0,1427.0,73,5,16,21,94.0,82,5.27,57,359,2285,9.4,0.36051193
27291,27291,Tom Poti,2000-01,23.0,3,35,76,76,9,26,35,125.0,1836.0,149,14,42,56,219.0,82,5.49,53,331,2294,9.8,0.44058102
27292,27292,Tom Poti,2001-02,24.0,4,32,81,81,12,20,32,161.0,1842.0,230,26,62,88,380.0,82,5.51,63,376,2272,9.9,0.4607821
27293,27293,Tom Poti,2002-03,25.0,5,25,66,66,2,23,25,109.0,1589.0,296,28,85,113,489.0,82,5.24,53,338,2262,9.5,0.40966427
27294,27294,Tom Poti,2003-04,26.0,6,48,80,80,11,37,48,148.0,1977.0,376,39,122,161,637.0,82,5.31,60,363,2326,9.4,0.591183
27295,27295,Tom Poti,2004-05,27.0,7,24,67,67,10,14,24,124.0,1506.0,443,49,136,185,761.0,82,5.14,57,348,2300,9.2,0.4077238
27296,27296,Tom Poti,2006-07,29.0,8,23,73,73,3,20,23,122.0,1517.0,516,52,156,208,883.0,82,6.05,85,480,2458,10.1,0.30864367
27297,27297,Tom Poti,2007-08,30.0,9,44,78,78,6,38,44,134.0,2006.0,594,58,194,252,1017.0,82,5.76,70,398,2426,9.7,0.48841166
27298,27298,Tom Poti,2008-09,31.0,10,29,71,71,2,27,29,99.0,1667.0,665,60,221,281,1116.0,82,5.44,62,351,2383,9.4,0.35757297
27299,27299,Tom Poti,2009-10,32.0,11,13,52,52,3,10,13,48.0,1100.0,717,63,231,294,1164.0,82,5.7,65,341,2477,9.4,0.22266039
27300,27300,Tom Poti,2010-11,33.0,12,24,70,70,4,20,24,69.0,1498.0,787,67,251,318,1233.0,82,5.53,56,304,2486,9.1,0.2703429
27301,27301,Tom Poti,2011-12,34.0,13,7,21,21,2,5,7,20.0,386.0,808,69,256,325,1253.0,82,5.46,52,291,2492,9.0,0.24229789
27302,27302,Tom Poti,2013-14,36.0,14,2,16,16,0,2,2,8.0,244.0,824,69,258,327,1261.0,48,5.31,29,160,1399,9.1,0.18321738
27303,27303,Tom Preissing,2004-05,26.0,2,19,69,69,2,17,19,89.0,1255.0,69,2,17,19,89.0,82,5.14,57,348,2300,9.2,0.32197872
27304,27304,Tom Preissing,2006-07,28.0,3,43,74,74,11,32,43,131.0,1517.0,143,13,49,62,220.0,82,6.05,85,480,2458,10.1,0.4522908
27305,27305,Tom Preissing,2007-08,29.0,4,38,80,80,7,31,38,94.0,1220.0,223,20,80,100,314.0,82,5.76,70,398,2426,9.7,0.4115056
27306,27306,Tom Preissing,2008-09,30.0,5,24,77,77,8,16,24,93.0,1377.0,300,28,96,124,407.0,82,5.44,62,351,2383,9.4,0.31053412
27307,27307,Tom Preissing,2009-10,31.0,6,7,22,22,3,4,7,40.0,368.0,322,31,100,131,447.0,82,5.7,65,341,2477,9.4,0.2962718
27308,27308,Tom Preissing,2010-11,32.0,7,1,4,4,0,1,1,6.0,52.0,326,31,101,132,453.0,82,5.53,56,304,2486,9.1,0.2290492
27309,27309,Tom Pyatt,2010-11,23.0,2,5,40,40,2,3,5,48.0,443.0,40,2,3,5,48.0,82,5.53,56,304,2486,9.1,0.22202235
27310,27310,Tom Pyatt,2011-12,24.0,3,7,61,61,2,5,7,65.0,649.0,101,4,8,12,113.0,82,5.46,52,291,2492,9.0,0.18904477
27311,27311,Tom Pyatt,2012-13,25.0,4,19,74,74,12,7,19,95.0,1095.0,175,16,15,31,208.0,82,5.32,47,271,2439,8.9,0.27125385
27312,27312,Tom Pyatt,2013-14,26.0,5,16,43,43,8,8,16,60.0,584.0,218,24,23,47,268.0,48,5.31,29,160,1399,9.1,0.34971446
27313,27313,Tom Pyatt,2014-15,27.0,6,7,27,27,3,4,7,27.0,309.0,245,27,27,54,295.0,82,5.34,48,269,2463,8.9,0.21884957
27314,27314,Tom Pyatt,2017-18,30.0,7,23,82,82,9,14,23,95.0,1281.0,327,36,41,77,390.0,82,5.45,47,245,2478,9.0,0.24967721
27315,27315,Tom Pyatt,2018-19,31.0,8,22,81,81,7,15,22,103.0,1138.0,408,43,56,99,493.0,82,5.86,50,250,2620,9.2,0.24704838
27316,27316,Tom Pyatt,2019-20,32.0,9,2,37,37,0,2,2,29.0,433.0,445,43,58,101,522.0,82,5.96,47,239,2579,9.5,0.14673868
27317,27317,Tom Roulston,1981-82,24.0,2,2,11,11,1,1,2,9.0,,11,1,1,2,9.0,80,7.69,77,340,2441,12.6,0.26463324
27318,27318,Tom Roulston,1982-83,25.0,3,14,35,35,11,3,14,54.0,,46,12,4,16,63.0,80,8.03,73,320,2489,12.9,0.3869436
27319,27319,Tom Roulston,1983-84,26.0,4,40,67,67,19,21,40,107.0,,113,31,25,56,170.0,80,7.73,71,310,2444,12.7,0.5239488
27320,27320,Tom Roulston,1984-85,27.0,5,40,77,77,16,24,40,148.0,,190,47,49,96,318.0,80,7.89,74,336,2448,12.9,0.48171026
27321,27321,Tom Roulston,1986-87,29.0,6,0,5,5,0,0,0,6.0,,195,47,49,96,324.0,80,7.94,82,370,2484,12.8,0.26138386
27322,27322,Tom Sestito,2008-09,21.0,2,0,1,1,0,0,0,0.0,5.0,1,0,0,0,0.0,82,5.44,62,351,2383,9.4,0.20099464
27323,27323,Tom Sestito,2010-11,23.0,3,0,3,3,0,0,0,0.0,17.0,4,0,0,0,0.0,82,5.53,56,304,2486,9.1,0.15861589
27324,27324,Tom Sestito,2011-12,24.0,4,4,9,9,2,2,4,7.0,86.0,13,2,2,4,7.0,82,5.46,52,291,2492,9.0,0.2124469
27325,27325,Tom Sestito,2012-13,25.0,5,1,14,14,0,1,1,4.0,97.0,27,2,3,5,11.0,82,5.32,47,271,2439,8.9,0.1428735
27326,27326,Tom Sestito,2013-14,26.0,6,3,30,30,3,0,3,14.0,193.0,57,5,3,8,25.0,48,5.31,29,160,1399,9.1,0.17691618
27327,27327,Tom Sestito,2014-15,27.0,7,9,77,77,5,4,9,31.0,497.0,134,10,7,17,56.0,82,5.34,48,269,2463,8.9,0.11344519
27328,27328,Tom Sestito,2015-16,28.0,8,1,3,3,0,1,1,1.0,19.0,137,10,8,18,57.0,82,5.32,47,251,2453,8.9,0.1286551
27329,27329,Tom Sestito,2016-17,29.0,9,1,4,4,0,1,1,1.0,23.0,141,10,9,19,58.0,82,5.34,48,255,2438,9.0,0.12357327
27330,27330,Tom Sestito,2017-18,30.0,10,2,13,13,0,2,2,3.0,72.0,154,10,11,21,61.0,82,5.45,47,245,2478,9.0,0.104415745
27331,27331,Tom Thornbury,1984-85,21.0,2,9,14,14,1,8,9,44.0,,14,1,8,9,44.0,80,7.89,74,336,2448,12.9,0.394629
27332,27332,Tom Tilley,1989-90,24.0,2,23,70,70,1,22,23,77.0,,70,1,22,23,77.0,80,7.48,85,403,2430,12.3,0.31831527
27333,27333,Tom Tilley,1990-91,25.0,3,5,34,34,0,5,5,19.0,,104,1,27,28,96.0,80,7.37,76,367,2421,12.2,0.19733813
27334,27334,Tom Tilley,1991-92,26.0,4,6,22,22,2,4,6,28.0,,126,3,31,34,124.0,80,6.91,71,366,2385,11.6,0.2727797
27335,27335,Tom Tilley,1994-95,29.0,5,8,48,48,1,7,8,41.0,,174,4,38,42,165.0,84,6.48,76,407,2545,10.7,0.14841217
27336,27336,Tom Wandell,2009-10,23.0,2,3,14,14,1,2,3,23.0,156.0,14,1,2,3,23.0,82,5.7,65,341,2477,9.4,0.26440772
27337,27337,Tom Wandell,2010-11,24.0,3,15,50,50,5,10,15,85.0,694.0,64,6,12,18,108.0,82,5.53,56,304,2486,9.1,0.31248394
27338,27338,Tom Wandell,2011-12,25.0,4,9,75,75,7,2,9,94.0,882.0,139,13,14,27,202.0,82,5.46,52,291,2492,9.0,0.19253004
27339,27339,Tom Wandell,2012-13,26.0,5,15,72,72,6,9,15,103.0,701.0,211,19,23,42,305.0,82,5.32,47,271,2439,8.9,0.23155195
27340,27340,Tom Wandell,2013-14,27.0,6,1,18,18,1,0,1,14.0,152.0,229,20,23,43,319.0,48,5.31,29,160,1399,9.1,0.19479203
27341,27341,Tom Wilson,2014-15,20.0,2,10,82,82,3,7,10,63.0,651.0,82,3,7,10,63.0,82,5.34,48,269,2463,8.9,0.2142593
27342,27342,Tom Wilson,2015-16,21.0,3,17,67,67,4,13,17,79.0,733.0,149,7,20,27,142.0,82,5.32,47,251,2453,8.9,0.28828198
27343,27343,Tom Wilson,2016-17,22.0,4,23,82,82,7,16,23,99.0,1059.0,231,14,36,50,241.0,82,5.34,48,255,2438,9.0,0.33107373
27344,27344,Tom Wilson,2017-18,23.0,5,19,82,82,7,12,19,95.0,1060.0,313,21,48,69,336.0,82,5.45,47,245,2478,9.0,0.32496613
27345,27345,Tom Wilson,2018-19,24.0,6,35,78,78,14,21,35,123.0,1247.0,391,35,69,104,459.0,82,5.86,50,250,2620,9.2,0.43286443
27346,27346,Tom Wilson,2019-20,25.0,7,40,63,63,22,18,40,130.0,1143.0,454,57,87,144,589.0,82,5.96,47,239,2579,9.5,0.6045435
27347,27347,Tom Wilson,2020-21,26.0,8,44,68,68,21,23,44,154.0,1242.0,522,78,110,188,743.0,70,5.96,42,208,2192,9.5,0.65353763
27348,27348,Tomas Divisek,2001-02,22.0,2,0,2,2,0,0,0,2.0,23.0,2,0,0,0,2.0,82,5.51,63,376,2272,9.9,0.16876054
27349,27349,Tomas Divisek,2002-03,23.0,3,1,3,3,1,0,1,3.0,25.0,5,1,0,1,5.0,82,5.24,53,338,2262,9.5,0.22056413
27350,27350,Tomas Fleischmann,2006-07,22.0,2,2,14,14,0,2,2,11.0,95.0,14,0,2,2,11.0,82,6.05,85,480,2458,10.1,0.1909971
27351,27351,Tomas Fleischmann,2007-08,23.0,3,8,29,29,4,4,8,52.0,337.0,43,4,6,10,63.0,82,5.76,70,398,2426,9.7,0.27543724
27352,27352,Tomas Fleischmann,2008-09,24.0,4,30,75,75,10,20,30,107.0,947.0,118,14,26,40,170.0,82,5.44,62,351,2383,9.4,0.38974687
27353,27353,Tomas Fleischmann,2009-10,25.0,5,37,73,73,19,18,37,131.0,1101.0,191,33,44,77,301.0,82,5.7,65,341,2477,9.4,0.46904787
27354,27354,Tomas Fleischmann,2010-11,26.0,6,51,69,69,23,28,51,121.0,1106.0,260,56,72,128,422.0,82,5.53,56,304,2486,9.1,0.6007267
27355,27355,Tomas Fleischmann,2011-12,27.0,7,31,45,45,12,19,31,98.0,736.0,305,68,91,159,520.0,82,5.46,52,291,2492,9.0,0.5813568
27356,27356,Tomas Fleischmann,2012-13,28.0,8,61,82,82,27,34,61,217.0,1566.0,387,95,125,220,737.0,82,5.32,47,271,2439,8.9,0.6931901
27357,27357,Tomas Fleischmann,2013-14,29.0,9,35,48,48,12,23,35,121.0,899.0,435,107,148,255,858.0,48,5.31,29,160,1399,9.1,0.6268984
27358,27358,Tomas Fleischmann,2014-15,30.0,10,28,80,80,8,20,28,188.0,1370.0,515,115,168,283,1046.0,82,5.34,48,269,2463,8.9,0.43859634
27359,27359,Tomas Fleischmann,2015-16,31.0,11,27,66,66,8,19,27,131.0,970.0,581,123,187,310,1177.0,82,5.32,47,251,2453,8.9,0.3433066
27360,27360,Tomas Fleischmann,2016-17,32.0,12,25,76,76,14,11,25,123.0,1156.0,657,137,198,335,1300.0,82,5.34,48,255,2438,9.0,0.32581818
27361,27361,Tomas Forslund,1992-93,24.0,2,14,38,38,5,9,14,48.0,,38,5,9,14,48.0,80,6.96,77,402,2440,11.4,0.33459163
27362,27362,Tomas Forslund,1993-94,25.0,3,2,6,6,0,2,2,3.0,,44,5,11,16,51.0,84,7.25,87,443,2603,11.7,0.1986154
27363,27363,Tomas Hertl,2014-15,21.0,2,25,37,37,15,10,25,98.0,567.0,37,15,10,25,98.0,82,5.34,48,269,2463,8.9,0.58716255
27364,27364,Tomas Hertl,2015-16,22.0,3,31,82,82,13,18,31,145.0,1193.0,119,28,28,56,243.0,82,5.32,47,251,2453,8.9,0.4494506
27365,27365,Tomas Hertl,2016-17,23.0,4,46,81,81,21,25,46,202.0,1294.0,200,49,53,102,445.0,82,5.34,48,255,2438,9.0,0.5957693
27366,27366,Tomas Hertl,2017-18,24.0,5,22,49,49,10,12,22,100.0,844.0,249,59,65,124,545.0,82,5.45,47,245,2478,9.0,0.48862395
27367,27367,Tomas Hertl,2018-19,25.0,6,46,79,79,22,24,46,175.0,1430.0,328,81,89,170,720.0,82,5.86,50,250,2620,9.2,0.5887408
27368,27368,Tomas Hertl,2019-20,26.0,7,74,77,77,35,39,74,176.0,1465.0,405,116,128,244,896.0,82,5.96,47,239,2579,9.5,0.80209136
27369,27369,Tomas Hertl,2020-21,27.0,8,36,48,48,16,20,36,117.0,885.0,453,132,148,280,1013.0,70,5.96,42,208,2192,9.5,0.64447975
27370,27370,Tomas Holmstrom,1997-98,25.0,2,9,47,47,6,3,9,53.0,,47,6,3,9,53.0,82,5.83,55,336,2444,9.8,0.20370868
27371,27371,Tomas Holmstrom,1998-99,26.0,3,22,57,57,5,17,22,48.0,,104,11,20,31,101.0,82,5.28,57,380,2242,9.6,0.31062764
27372,27372,Tomas Holmstrom,1999-00,27.0,4,34,82,82,13,21,34,100.0,1014.0,186,24,41,65,201.0,82,5.27,57,359,2285,9.4,0.41436636
27373,27373,Tomas Holmstrom,2000-01,28.0,5,35,72,72,13,22,35,71.0,871.0,258,37,63,100,272.0,82,5.49,53,331,2294,9.8,0.4363474
27374,27374,Tomas Holmstrom,2001-02,29.0,6,40,73,73,16,24,40,74.0,852.0,331,53,87,140,346.0,82,5.51,63,376,2272,9.9,0.46038368
27375,27375,Tomas Holmstrom,2002-03,30.0,7,26,69,69,8,18,26,79.0,855.0,400,61,105,166,425.0,82,5.24,53,338,2262,9.5,0.37282962
27376,27376,Tomas Holmstrom,2003-04,31.0,8,40,74,74,20,20,40,109.0,922.0,474,81,125,206,534.0,82,5.31,60,363,2326,9.4,0.4513064
27377,27377,Tomas Holmstrom,2004-05,32.0,9,30,67,67,15,15,30,74.0,830.0,541,96,140,236,608.0,82,5.14,57,348,2300,9.2,0.44715273
27378,27378,Tomas Holmstrom,2006-07,34.0,10,59,81,81,29,30,59,140.0,1132.0,622,125,170,295,748.0,82,6.05,85,480,2458,10.1,0.59543896
27379,27379,Tomas Holmstrom,2007-08,35.0,11,52,77,77,30,22,52,176.0,1171.0,699,155,192,347,924.0,82,5.76,70,398,2426,9.7,0.5397186
27380,27380,Tomas Holmstrom,2008-09,36.0,12,40,59,59,20,20,40,137.0,1035.0,758,175,212,387,1061.0,82,5.44,62,351,2383,9.4,0.5536851
27381,27381,Tomas Holmstrom,2009-10,37.0,13,37,53,53,14,23,37,75.0,809.0,811,189,235,424,1136.0,82,5.7,65,341,2477,9.4,0.57111466
27382,27382,Tomas Holmstrom,2010-11,38.0,14,45,68,68,25,20,45,131.0,1075.0,879,214,255,469,1267.0,82,5.53,56,304,2486,9.1,0.49692276
27383,27383,Tomas Holmstrom,2011-12,39.0,15,37,73,73,18,19,37,125.0,1081.0,952,232,274,506,1392.0,82,5.46,52,291,2492,9.0,0.37114644
27384,27384,Tomas Holmstrom,2012-13,40.0,16,24,74,74,11,13,24,97.0,879.0,1026,243,287,530,1489.0,82,5.32,47,271,2439,8.9,0.27899668
27385,27385,Tomas Hyka,2018-19,25.0,2,3,10,10,1,2,3,15.0,121.0,10,1,2,3,15.0,82,5.86,50,250,2620,9.2,0.20996422
27386,27386,Tomas Hyka,2019-20,26.0,3,4,17,17,1,3,4,22.0,200.0,27,2,5,7,37.0,82,5.96,47,239,2579,9.5,0.21813607
27387,27387,Tomas Jelinek,1993-94,31.0,2,13,49,49,7,6,13,60.0,,49,7,6,13,60.0,84,7.25,87,443,2603,11.7,0.24940449
27388,27388,Tomas Jonsson,1982-83,22.0,2,34,70,70,9,25,34,89.0,,70,9,25,34,89.0,80,8.03,73,320,2489,12.9,0.4899365
27389,27389,Tomas Jonsson,1983-84,23.0,3,48,72,72,13,35,48,99.0,,142,22,60,82,188.0,80,7.73,71,310,2444,12.7,0.63057184
27390,27390,Tomas Jonsson,1984-85,24.0,4,47,72,72,11,36,47,122.0,,214,33,96,129,310.0,80,7.89,74,336,2448,12.9,0.63325024
27391,27391,Tomas Jonsson,1985-86,25.0,5,50,69,69,16,34,50,128.0,,283,49,130,179,438.0,80,7.77,71,321,2447,12.7,0.7019119
27392,27392,Tomas Jonsson,1986-87,26.0,6,44,77,77,14,30,44,119.0,,360,63,160,223,557.0,80,7.94,82,370,2484,12.8,0.5453107
27393,27393,Tomas Jonsson,1987-88,27.0,7,31,47,47,6,25,31,99.0,,407,69,185,254,656.0,80,7.34,72,344,2400,12.2,0.5668544
27394,27394,Tomas Jonsson,1988-89,28.0,8,47,72,72,6,41,47,121.0,,479,75,226,301,777.0,80,7.43,89,437,2435,12.2,0.58835226
27395,27395,Tomas Jonsson,1989-90,29.0,9,43,73,73,10,33,43,149.0,,552,85,259,344,926.0,80,7.48,85,403,2430,12.3,0.5389274
27396,27396,Tomas Jurco,2014-15,22.0,2,15,36,36,8,7,15,77.0,485.0,36,8,7,15,77.0,82,5.34,48,269,2463,8.9,0.38672617
27397,27397,Tomas Jurco,2015-16,23.0,3,18,63,63,3,15,18,92.0,725.0,99,11,22,33,169.0,82,5.32,47,251,2453,8.9,0.30807483
27398,27398,Tomas Jurco,2016-17,24.0,4,6,44,44,4,2,6,43.0,404.0,143,15,24,39,212.0,82,5.34,48,255,2438,9.0,0.19187537
27399,27399,Tomas Jurco,2017-18,25.0,5,1,29,29,1,0,1,35.0,308.0,172,16,24,40,247.0,82,5.45,47,245,2478,9.0,0.17111829
27400,27400,Tomas Jurco,2018-19,26.0,6,10,29,29,6,4,10,44.0,366.0,201,22,28,50,291.0,82,5.86,50,250,2620,9.2,0.27910003
27401,27401,Tomas Jurco,2020-21,28.0,7,2,12,12,0,2,2,7.0,120.0,213,22,30,52,298.0,70,5.96,42,208,2192,9.5,0.19410124
27402,27402,Tomas Kaberle,1999-00,21.0,2,22,57,57,4,18,22,71.0,1066.0,57,4,18,22,71.0,82,5.27,57,359,2285,9.4,0.36883175
27403,27403,Tomas Kaberle,2000-01,22.0,3,40,82,82,7,33,40,82.0,1879.0,139,11,51,62,153.0,82,5.49,53,331,2294,9.8,0.4835467
27404,27404,Tomas Kaberle,2001-02,23.0,4,45,82,82,6,39,45,96.0,1860.0,221,17,90,107,249.0,82,5.51,63,376,2272,9.9,0.5320563
27405,27405,Tomas Kaberle,2002-03,24.0,5,39,69,69,10,29,39,85.0,1725.0,290,27,119,146,334.0,82,5.24,53,338,2262,9.5,0.5338297
27406,27406,Tomas Kaberle,2003-04,25.0,6,47,82,82,11,36,47,119.0,2037.0,372,38,155,193,453.0,82,5.31,60,363,2326,9.4,0.587947
27407,27407,Tomas Kaberle,2004-05,26.0,7,31,71,71,3,28,31,88.0,1647.0,443,41,183,224,541.0,82,5.14,57,348,2300,9.2,0.5182251
27408,27408,Tomas Kaberle,2006-07,28.0,8,67,82,82,9,58,67,163.0,2310.0,525,50,241,291,704.0,82,6.05,85,480,2458,10.1,0.7315999
27409,27409,Tomas Kaberle,2007-08,29.0,9,58,74,74,11,47,58,128.0,1915.0,599,61,288,349,832.0,82,5.76,70,398,2426,9.7,0.6328146
27410,27410,Tomas Kaberle,2008-09,30.0,10,53,82,82,8,45,53,155.0,2039.0,681,69,333,402,987.0,82,5.44,62,351,2383,9.4,0.6388281
27411,27411,Tomas Kaberle,2009-10,31.0,11,31,57,57,4,27,31,93.0,1337.0,738,73,360,433,1080.0,82,5.7,65,341,2477,9.4,0.44215754
27412,27412,Tomas Kaberle,2010-11,32.0,12,49,82,82,7,42,49,158.0,1833.0,820,80,402,482,1238.0,82,5.53,56,304,2486,9.1,0.59150445
27413,27413,Tomas Kaberle,2011-12,33.0,13,47,82,82,4,43,47,130.0,1813.0,902,84,445,529,1368.0,82,5.46,52,291,2492,9.0,0.53925544
27414,27414,Tomas Kaberle,2012-13,34.0,14,31,72,72,3,28,31,87.0,1276.0,974,87,473,560,1455.0,82,5.32,47,271,2439,8.9,0.3424009
27415,27415,Tomas Kaberle,2013-14,35.0,15,3,10,10,0,3,3,11.0,135.0,984,87,476,563,1466.0,48,5.31,29,160,1399,9.1,0.24130967
27416,27416,Tomas Kana,2010-11,23.0,2,2,6,6,0,2,2,4.0,52.0,6,0,2,2,4.0,82,5.53,56,304,2486,9.1,0.20079431
27417,27417,Tomas Kloucek,2001-02,21.0,2,5,43,43,1,4,5,22.0,719.0,43,1,4,5,22.0,82,5.51,63,376,2272,9.9,0.15339547
27418,27418,Tomas Kloucek,2002-03,22.0,3,4,52,52,1,3,4,21.0,623.0,95,2,7,9,43.0,82,5.24,53,338,2262,9.5,0.1381399
27419,27419,Tomas Kloucek,2003-04,23.0,4,0,3,3,0,0,0,1.0,29.0,98,2,7,9,44.0,82,5.31,60,363,2326,9.4,0.15333769
27420,27420,Tomas Kloucek,2004-05,24.0,5,1,42,42,0,1,1,12.0,354.0,140,2,8,10,56.0,82,5.14,57,348,2300,9.2,0.11189133
27421,27421,Tomas Kloucek,2006-07,26.0,6,0,1,1,0,0,0,0.0,3.0,141,2,8,10,56.0,82,6.05,85,480,2458,10.1,0.13007024
27422,27422,Tomas Kopecky,2006-07,24.0,2,0,1,1,0,0,0,1.0,10.0,1,0,0,0,1.0,82,6.05,85,480,2458,10.1,0.16345963
27423,27423,Tomas Kopecky,2007-08,25.0,3,1,26,26,1,0,1,27.0,189.0,27,1,0,1,28.0,82,5.76,70,398,2426,9.7,0.18196821
27424,27424,Tomas Kopecky,2008-09,26.0,4,12,77,77,5,7,12,87.0,740.0,104,6,7,13,115.0,82,5.44,62,351,2383,9.4,0.20893377
27425,27425,Tomas Kopecky,2009-10,27.0,5,19,79,79,6,13,19,110.0,823.0,183,12,20,32,225.0,82,5.7,65,341,2477,9.4,0.23855352
27426,27426,Tomas Kopecky,2010-11,28.0,6,21,74,74,10,11,21,95.0,701.0,257,22,31,53,320.0,82,5.53,56,304,2486,9.1,0.25442088
27427,27427,Tomas Kopecky,2011-12,29.0,7,42,81,81,15,27,42,178.0,1241.0,338,37,58,95,498.0,82,5.46,52,291,2492,9.0,0.4521056
27428,27428,Tomas Kopecky,2012-13,30.0,8,32,80,80,10,22,32,143.0,1382.0,418,47,80,127,641.0,82,5.32,47,271,2439,8.9,0.35505202
27429,27429,Tomas Kopecky,2013-14,31.0,9,27,47,47,15,12,27,92.0,831.0,465,62,92,154,733.0,48,5.31,29,160,1399,9.1,0.44208005
27430,27430,Tomas Kopecky,2014-15,32.0,10,12,49,49,4,8,12,95.0,778.0,514,66,100,166,828.0,82,5.34,48,269,2463,8.9,0.2606076
27431,27431,Tomas Kopecky,2015-16,33.0,11,8,64,64,2,6,8,106.0,826.0,578,68,106,174,934.0,82,5.32,47,251,2453,8.9,0.1853582
27432,27432,Tomas Kubalik,2011-12,21.0,2,2,4,4,0,2,2,5.0,59.0,4,0,2,2,5.0,82,5.46,52,291,2492,9.0,0.26051602
27433,27433,Tomas Kubalik,2012-13,22.0,3,2,8,8,1,1,2,8.0,106.0,12,1,3,4,13.0,82,5.32,47,271,2439,8.9,0.21004537
27434,27434,Tomas Kundratek,2012-13,23.0,2,0,5,5,0,0,0,2.0,49.0,5,0,0,0,2.0,82,5.32,47,271,2439,8.9,0.17154336
27435,27435,Tomas Kundratek,2013-14,24.0,3,7,25,25,1,6,7,23.0,404.0,30,1,6,7,25.0,48,5.31,29,160,1399,9.1,0.21562594
27436,27436,Tomas Kurka,2003-04,22.0,2,5,14,14,3,2,5,22.0,210.0,14,3,2,5,22.0,82,5.31,60,363,2326,9.4,0.30271217
27437,27437,Tomas Kurka,2004-05,23.0,3,0,3,3,0,0,0,3.0,26.0,17,3,2,5,25.0,82,5.14,57,348,2300,9.2,0.24317926
27438,27438,Tomas Malec,2003-04,21.0,2,2,41,41,0,2,2,30.0,460.0,41,0,2,2,30.0,82,5.31,60,363,2326,9.4,0.17323112
27439,27439,Tomas Malec,2004-05,22.0,3,0,2,2,0,0,0,1.0,19.0,43,0,2,2,31.0,82,5.14,57,348,2300,9.2,0.1775243
27440,27440,Tomas Malec,2006-07,24.0,4,0,2,2,0,0,0,1.0,23.0,45,0,2,2,32.0,82,6.05,85,480,2458,10.1,0.14641193
27441,27441,Tomas Malec,2007-08,25.0,5,0,1,1,0,0,0,1.0,15.0,46,0,2,2,33.0,82,5.76,70,398,2426,9.7,0.13643467
27442,27442,Tomas Mojzis,2006-07,24.0,2,1,7,7,0,1,1,7.0,98.0,7,0,1,1,7.0,82,6.05,85,480,2458,10.1,0.18355358
27443,27443,Tomas Mojzis,2007-08,25.0,3,1,6,6,1,0,1,7.0,60.0,13,1,1,2,14.0,82,5.76,70,398,2426,9.7,0.18763477
27444,27444,Tomas Mojzis,2009-10,27.0,4,1,4,4,0,1,1,2.0,29.0,17,1,2,3,16.0,82,5.7,65,341,2477,9.4,0.16237012
27445,27445,Tomas Nosek,2016-17,24.0,2,0,6,6,0,0,0,2.0,61.0,6,0,0,0,2.0,82,5.34,48,255,2438,9.0,0.16909173
27446,27446,Tomas Nosek,2017-18,25.0,3,1,11,11,1,0,1,19.0,111.0,17,1,0,1,21.0,82,5.45,47,245,2478,9.0,0.19392407
27447,27447,Tomas Nosek,2018-19,26.0,4,15,67,67,7,8,15,92.0,743.0,84,8,8,16,113.0,82,5.86,50,250,2620,9.2,0.23319367
27448,27448,Tomas Nosek,2019-20,27.0,5,17,68,68,8,9,17,116.0,848.0,152,16,17,33,229.0,82,5.96,47,239,2579,9.5,0.23194972
27449,27449,Tomas Nosek,2020-21,28.0,6,15,67,67,8,7,15,93.0,778.0,219,24,24,48,322.0,70,5.96,42,208,2192,9.5,0.2615677
27450,27450,Tomas Plekanec,2004-05,22.0,2,0,2,2,0,0,0,0.0,18.0,2,0,0,0,0.0,82,5.14,57,348,2300,9.2,0.21665946
27451,27451,Tomas Plekanec,2006-07,24.0,3,29,67,67,9,20,29,99.0,888.0,69,9,20,29,99.0,82,6.05,85,480,2458,10.1,0.39662153
27452,27452,Tomas Plekanec,2007-08,25.0,4,47,81,81,20,27,47,150.0,1294.0,150,29,47,76,249.0,82,5.76,70,398,2426,9.7,0.55722934
27453,27453,Tomas Plekanec,2008-09,26.0,5,69,81,81,29,40,69,186.0,1464.0,231,58,87,145,435.0,82,5.44,62,351,2383,9.4,0.8242923
27454,27454,Tomas Plekanec,2009-10,27.0,6,39,80,80,20,19,39,202.0,1380.0,311,78,106,184,637.0,82,5.7,65,341,2477,9.4,0.56595385
27455,27455,Tomas Plekanec,2010-11,28.0,7,70,82,82,25,45,70,216.0,1637.0,393,103,151,254,853.0,82,5.53,56,304,2486,9.1,0.75671804
27456,27456,Tomas Plekanec,2011-12,29.0,8,57,77,77,22,35,57,227.0,1559.0,470,125,186,311,1080.0,82,5.46,52,291,2492,9.0,0.6696933
27457,27457,Tomas Plekanec,2012-13,30.0,9,52,81,81,17,35,52,220.0,1681.0,551,142,221,363,1300.0,82,5.32,47,271,2439,8.9,0.6494304
27458,27458,Tomas Plekanec,2013-14,31.0,10,33,47,47,14,19,33,133.0,903.0,598,156,240,396,1433.0,48,5.31,29,160,1399,9.1,0.6413143
27459,27459,Tomas Plekanec,2014-15,32.0,11,43,81,81,20,23,43,199.0,1602.0,679,176,263,439,1632.0,82,5.34,48,269,2463,8.9,0.5475293
27460,27460,Tomas Plekanec,2015-16,33.0,12,60,82,82,26,34,60,248.0,1571.0,761,202,297,499,1880.0,82,5.32,47,251,2453,8.9,0.68830246
27461,27461,Tomas Plekanec,2016-17,34.0,13,54,82,82,14,40,54,189.0,1520.0,843,216,337,553,2069.0,82,5.34,48,255,2438,9.0,0.5965856
27462,27462,Tomas Plekanec,2017-18,35.0,14,28,78,78,10,18,28,139.0,1312.0,921,226,355,581,2208.0,82,5.45,47,245,2478,9.0,0.3102255
27463,27463,Tomas Plekanec,2018-19,36.0,15,26,77,77,6,20,26,144.0,1165.0,998,232,375,607,2352.0,82,5.86,50,250,2620,9.2,0.30155674
27464,27464,Tomas Plekanec,2019-20,37.0,16,1,3,3,1,0,1,8.0,33.0,1001,233,375,608,2360.0,82,5.96,47,239,2579,9.5,0.18867496
27465,27465,Tomas Plihal,2007-08,24.0,2,0,3,3,0,0,0,10.0,29.0,3,0,0,0,10.0,82,5.76,70,398,2426,9.7,0.18388155
27466,27466,Tomas Plihal,2008-09,25.0,3,3,22,22,2,1,3,34.0,238.0,25,2,1,3,44.0,82,5.44,62,351,2383,9.4,0.21569893
27467,27467,Tomas Plihal,2009-10,26.0,4,13,64,64,5,8,13,79.0,649.0,89,7,9,16,123.0,82,5.7,65,341,2477,9.4,0.2287178
27468,27468,Tomas Sandstrom,1985-86,21.0,2,58,74,74,29,29,58,188.0,,74,29,29,58,188.0,80,7.77,71,321,2447,12.7,0.8213585
27469,27469,Tomas Sandstrom,1986-87,22.0,3,54,73,73,25,29,54,238.0,,147,54,58,112,426.0,80,7.94,82,370,2484,12.8,0.7999392
27470,27470,Tomas Sandstrom,1987-88,23.0,4,74,64,64,40,34,74,241.0,,211,94,92,186,667.0,80,7.34,72,344,2400,12.2,1.1424503
27471,27471,Tomas Sandstrom,1988-89,24.0,5,68,69,69,28,40,68,204.0,,280,122,132,254,871.0,80,7.43,89,437,2435,12.2,0.97278917
27472,27472,Tomas Sandstrom,1989-90,25.0,6,88,79,79,32,56,88,240.0,,359,154,188,342,1111.0,80,7.48,85,403,2430,12.3,1.0024322
27473,27473,Tomas Sandstrom,1990-91,26.0,7,71,76,76,32,39,71,249.0,,435,186,227,413,1360.0,80,7.37,76,367,2421,12.2,0.97298527
27474,27474,Tomas Sandstrom,1991-92,27.0,8,89,68,68,45,44,89,221.0,,503,231,271,502,1581.0,80,6.91,71,366,2385,11.6,1.0920634
27475,27475,Tomas Sandstrom,1992-93,28.0,9,39,49,49,17,22,39,147.0,,552,248,293,541,1728.0,80,6.96,77,402,2440,11.4,0.85939544
27476,27476,Tomas Sandstrom,1993-94,29.0,10,52,39,39,25,27,52,134.0,,591,273,320,593,1862.0,84,7.25,87,443,2603,11.7,0.9050268
27477,27477,Tomas Sandstrom,1994-95,30.0,11,58,78,78,23,35,58,193.0,,669,296,355,651,2055.0,84,6.48,76,407,2545,10.7,0.66660047
27478,27478,Tomas Sandstrom,1995-96,31.0,12,44,47,47,21,23,44,116.0,,716,317,378,695,2171.0,48,5.97,37,209,1408,10.2,0.9097997
27479,27479,Tomas Sandstrom,1996-97,32.0,13,70,58,58,35,35,70,187.0,,774,352,413,765,2358.0,82,6.29,74,413,2481,10.4,0.8707824
27480,27480,Tomas Sandstrom,1997-98,33.0,14,42,74,74,18,24,42,139.0,,848,370,437,807,2497.0,82,5.83,55,336,2444,9.8,0.5110875
27481,27481,Tomas Sandstrom,1998-99,34.0,15,17,77,77,9,8,17,136.0,,925,379,445,824,2633.0,82,5.28,57,380,2242,9.6,0.33588296
27482,27482,Tomas Sandstrom,1999-00,35.0,16,32,58,58,15,17,32,107.0,1007.0,983,394,462,856,2740.0,82,5.27,57,359,2285,9.4,0.52456224
27483,27483,Tomas Srsen,1991-92,25.0,2,0,2,2,0,0,0,2.0,,2,0,0,0,2.0,80,6.91,71,366,2385,11.6,0.19595855
27484,27484,Tomas Surovy,2003-04,22.0,2,11,26,26,4,7,11,47.0,372.0,26,4,7,11,47.0,82,5.31,60,363,2326,9.4,0.33009216
27485,27485,Tomas Surovy,2004-05,23.0,3,23,47,47,11,12,23,112.0,586.0,73,15,19,34,159.0,82,5.14,57,348,2300,9.2,0.56114864
27486,27486,Tomas Surovy,2006-07,25.0,4,25,53,53,12,13,25,107.0,720.0,126,27,32,59,266.0,82,6.05,85,480,2458,10.1,0.4396834
27487,27487,Tomas Tatar,2011-12,21.0,2,1,9,9,1,0,1,6.0,86.0,9,1,0,1,6.0,82,5.46,52,291,2492,9.0,0.22345677
27488,27488,Tomas Tatar,2013-14,23.0,3,7,18,18,4,3,7,32.0,205.0,27,5,3,8,38.0,48,5.31,29,160,1399,9.1,0.32904938
27489,27489,Tomas Tatar,2014-15,24.0,4,39,73,73,19,20,39,158.0,1048.0,100,24,23,47,196.0,82,5.34,48,269,2463,8.9,0.5057814
27490,27490,Tomas Tatar,2015-16,25.0,5,56,82,82,29,27,56,211.0,1330.0,182,53,50,103,407.0,82,5.32,47,251,2453,8.9,0.6497424
27491,27491,Tomas Tatar,2016-17,26.0,6,45,81,81,21,24,45,165.0,1162.0,263,74,74,148,572.0,82,5.34,48,255,2438,9.0,0.5490073
27492,27492,Tomas Tatar,2017-18,27.0,7,46,82,82,25,21,46,166.0,1417.0,345,99,95,194,738.0,82,5.45,47,245,2478,9.0,0.53776145
27493,27493,Tomas Tatar,2018-19,28.0,8,34,82,82,20,14,34,174.0,1334.0,427,119,109,228,912.0,82,5.86,50,250,2620,9.2,0.48395377
27494,27494,Tomas Tatar,2019-20,29.0,9,58,80,80,25,33,58,195.0,1313.0,507,144,142,286,1107.0,82,5.96,47,239,2579,9.5,0.65331984
27495,27495,Tomas Tatar,2020-21,30.0,10,61,68,68,22,39,61,162.0,1108.0,575,166,181,347,1269.0,70,5.96,42,208,2192,9.5,0.74701345
27496,27496,Tomas Vincour,2011-12,21.0,2,2,24,24,1,1,2,26.0,226.0,24,1,1,2,26.0,82,5.46,52,291,2492,9.0,0.24250644
27497,27497,Tomas Vincour,2012-13,22.0,3,10,47,47,4,6,10,65.0,485.0,71,5,7,12,91.0,82,5.32,47,271,2439,8.9,0.2619818
27498,27498,Tomas Vincour,2013-14,23.0,4,4,17,17,2,2,4,12.0,151.0,88,7,9,16,103.0,48,5.31,29,160,1399,9.1,0.29774016
27499,27499,Tomas Vincour,2015-16,25.0,5,1,7,7,0,1,1,2.0,50.0,95,7,10,17,105.0,82,5.32,47,251,2453,8.9,0.16849479
27500,27500,Tomas Vlasak,2001-02,26.0,2,4,10,10,1,3,4,15.0,115.0,10,1,3,4,15.0,82,5.51,63,376,2272,9.9,0.20137218
27501,27501,Tomas Zizka,2003-04,24.0,2,3,10,10,0,3,3,12.0,154.0,10,0,3,3,12.0,82,5.31,60,363,2326,9.4,0.20553923
27502,27502,Tomas Zizka,2004-05,25.0,3,5,15,15,2,3,5,24.0,254.0,25,2,6,8,36.0,82,5.14,57,348,2300,9.2,0.26244742
27503,27503,Tomi Kallio,2001-02,25.0,2,27,56,56,14,13,27,115.0,912.0,56,14,13,27,115.0,82,5.51,63,376,2272,9.9,0.4548766
27504,27504,Tomi Kallio,2002-03,26.0,3,22,60,60,8,14,22,102.0,885.0,116,22,27,49,217.0,82,5.24,53,338,2262,9.5,0.34772786
27505,27505,Tomi Kallio,2003-04,27.0,4,6,24,24,2,4,6,28.0,309.0,140,24,31,55,245.0,82,5.31,60,363,2326,9.4,0.23655444
27506,27506,Tomi Maki,2007-08,24.0,2,0,1,1,0,0,0,0.0,11.0,1,0,0,0,0.0,82,5.76,70,398,2426,9.7,0.14225212
27507,27507,Tomi Pettinen,2003-04,26.0,2,0,2,2,0,0,0,0.0,23.0,2,0,0,0,0.0,82,5.31,60,363,2326,9.4,0.17004114
27508,27508,Tomi Pettinen,2004-05,27.0,3,0,4,4,0,0,0,2.0,42.0,6,0,0,0,2.0,82,5.14,57,348,2300,9.2,0.17427504
27509,27509,Tomi Pettinen,2006-07,29.0,4,0,18,18,0,0,0,7.0,264.0,24,0,0,0,9.0,82,6.05,85,480,2458,10.1,0.14177063
27510,27510,Tommi Santala,2004-05,25.0,2,3,33,33,1,2,3,23.0,334.0,33,1,2,3,23.0,82,5.14,57,348,2300,9.2,0.19524801
27511,27511,Tommi Santala,2007-08,28.0,3,6,30,30,1,5,6,20.0,221.0,63,2,7,9,43.0,82,5.76,70,398,2426,9.7,0.16124845
27512,27512,Tommy Albelin,1988-89,24.0,2,26,60,60,3,23,26,98.0,,60,3,23,26,98.0,80,7.43,89,437,2435,12.2,0.41078413
27513,27513,Tommy Albelin,1989-90,25.0,3,37,60,60,9,28,37,98.0,,120,12,51,63,196.0,80,7.48,85,403,2430,12.3,0.5095899
27514,27514,Tommy Albelin,1990-91,26.0,4,29,68,68,6,23,29,125.0,,188,18,74,92,321.0,80,7.37,76,367,2421,12.2,0.42086872
27515,27515,Tommy Albelin,1991-92,27.0,5,14,47,47,2,12,14,66.0,,235,20,86,106,387.0,80,6.91,71,366,2385,11.6,0.32558137
27516,27516,Tommy Albelin,1992-93,28.0,6,4,19,19,0,4,4,18.0,,254,20,90,110,405.0,80,6.96,77,402,2440,11.4,0.24805984
27517,27517,Tommy Albelin,1993-94,29.0,7,6,36,36,1,5,6,33.0,,290,21,95,116,438.0,84,7.25,87,443,2603,11.7,0.1936203
27518,27518,Tommy Albelin,1994-95,30.0,8,19,62,62,2,17,19,62.0,,352,23,112,135,500.0,84,6.48,76,407,2545,10.7,0.28624183
27519,27519,Tommy Albelin,1995-96,31.0,9,15,48,48,5,10,15,60.0,,400,28,122,150,560.0,48,5.97,37,209,1408,10.2,0.29542273
27520,27520,Tommy Albelin,1996-97,32.0,10,14,73,73,1,13,14,121.0,,473,29,135,164,681.0,82,6.29,74,413,2481,10.4,0.19204837
27521,27521,Tommy Albelin,1997-98,33.0,11,15,72,72,4,11,15,103.0,,545,33,146,179,784.0,82,5.83,55,336,2444,9.8,0.21592379
27522,27522,Tommy Albelin,1998-99,34.0,12,19,69,69,2,17,19,88.0,,614,35,163,198,872.0,82,5.28,57,380,2242,9.6,0.23890036
27523,27523,Tommy Albelin,1999-00,35.0,13,6,60,60,1,5,6,54.0,1148.0,674,36,168,204,926.0,82,5.27,57,359,2285,9.4,0.13105994
27524,27524,Tommy Albelin,2000-01,36.0,14,10,41,41,4,6,10,37.0,885.0,715,40,174,214,963.0,82,5.49,53,331,2294,9.8,0.17395839
27525,27525,Tommy Albelin,2001-02,37.0,15,20,77,77,1,19,20,69.0,1608.0,792,41,193,234,1032.0,82,5.51,63,376,2272,9.9,0.18090788
27526,27526,Tommy Albelin,2002-03,38.0,16,4,42,42,1,3,4,33.0,560.0,834,42,196,238,1065.0,82,5.24,53,338,2262,9.5,0.10966498
27527,27527,Tommy Albelin,2003-04,39.0,17,7,37,37,1,6,7,30.0,563.0,871,43,202,245,1095.0,82,5.31,60,363,2326,9.4,0.13701907
27528,27528,Tommy Albelin,2004-05,40.0,18,4,45,45,1,3,4,27.0,666.0,916,44,205,249,1122.0,82,5.14,57,348,2300,9.2,0.14219218
27529,27529,Tommy Albelin,2006-07,42.0,19,6,36,36,0,6,6,15.0,503.0,952,44,211,255,1137.0,82,6.05,85,480,2458,10.1,0.10145944
27530,27530,Tommy Cross,2016-17,27.0,2,1,3,3,0,1,1,0.0,39.0,3,0,1,1,0.0,82,5.34,48,255,2438,9.0,0.15848237
27531,27531,Tommy Lehman,1988-89,24.0,2,4,9,9,1,3,4,5.0,,9,1,3,4,5.0,80,7.43,89,437,2435,12.2,0.26851523
27532,27532,Tommy Lehman,1989-90,25.0,3,6,26,26,4,2,6,26.0,,35,5,5,10,31.0,80,7.48,85,403,2430,12.3,0.28304037
27533,27533,Tommy Lehman,1990-91,26.0,4,0,1,1,0,0,0,0.0,,36,5,5,10,31.0,80,7.37,76,367,2421,12.2,0.17738628
27534,27534,Tommy Sjodin,1993-94,28.0,2,36,77,77,7,29,36,175.0,,77,7,29,36,175.0,84,7.25,87,443,2603,11.7,0.42181712
27535,27535,Tommy Sjodin,1994-95,29.0,3,12,29,29,1,11,12,54.0,,106,8,40,48,229.0,84,6.48,76,407,2545,10.7,0.25306338
27536,27536,Tommy Westlund,2000-01,26.0,2,12,81,81,4,8,12,67.0,841.0,81,4,8,12,67.0,82,5.49,53,331,2294,9.8,0.16974953
27537,27537,Tommy Westlund,2001-02,27.0,3,8,79,79,5,3,8,47.0,740.0,160,9,11,20,114.0,82,5.51,63,376,2272,9.9,0.14344797
27538,27538,Tommy Westlund,2002-03,28.0,4,2,40,40,0,2,2,29.0,425.0,200,9,13,22,143.0,82,5.24,53,338,2262,9.5,0.109037995
27539,27539,Tommy Westlund,2003-04,29.0,5,0,3,3,0,0,0,0.0,19.0,203,9,13,22,143.0,82,5.31,60,363,2326,9.4,0.13789865
27540,27540,Tommy Wingels,2011-12,23.0,2,0,5,5,0,0,0,1.0,26.0,5,0,0,0,1.0,82,5.46,52,291,2492,9.0,0.16314653
27541,27541,Tommy Wingels,2012-13,24.0,3,9,33,33,3,6,9,71.0,454.0,38,3,6,9,72.0,82,5.32,47,271,2439,8.9,0.24916813
27542,27542,Tommy Wingels,2013-14,25.0,4,13,42,42,5,8,13,69.0,598.0,80,8,14,22,141.0,48,5.31,29,160,1399,9.1,0.32420933
27543,27543,Tommy Wingels,2014-15,26.0,5,38,77,77,16,22,38,163.0,1241.0,157,24,36,60,304.0,82,5.34,48,269,2463,8.9,0.4787366
27544,27544,Tommy Wingels,2015-16,27.0,6,36,75,75,15,21,36,158.0,1235.0,232,39,57,96,462.0,82,5.32,47,251,2453,8.9,0.4583435
27545,27545,Tommy Wingels,2016-17,28.0,7,18,68,68,7,11,18,111.0,927.0,300,46,68,114,573.0,82,5.34,48,255,2438,9.0,0.27658135
27546,27546,Tommy Wingels,2017-18,29.0,8,12,73,73,7,5,12,81.0,767.0,373,53,73,126,654.0,82,5.45,47,245,2478,9.0,0.23666802
27547,27547,Tommy Wingels,2018-19,30.0,9,17,75,75,9,8,17,86.0,861.0,448,62,81,143,740.0,82,5.86,50,250,2620,9.2,0.23734358
27548,27548,Toni Dahlman,2002-03,23.0,2,1,10,10,0,1,1,5.0,71.0,10,0,1,1,5.0,82,5.24,53,338,2262,9.5,0.18977308
27549,27549,Toni Dahlman,2003-04,24.0,3,1,12,12,1,0,1,5.0,74.0,22,1,1,2,10.0,82,5.31,60,363,2326,9.4,0.1810497
27550,27550,Toni Lydman,2001-02,24.0,2,19,62,62,3,16,19,80.0,1278.0,62,3,16,19,80.0,82,5.51,63,376,2272,9.9,0.2735923
27551,27551,Toni Lydman,2002-03,25.0,3,28,79,79,6,22,28,126.0,1672.0,141,9,38,47,206.0,82,5.24,53,338,2262,9.5,0.35527453
27552,27552,Toni Lydman,2003-04,26.0,4,26,81,81,6,20,26,143.0,2088.0,222,15,58,73,349.0,82,5.31,60,363,2326,9.4,0.36663538
27553,27553,Toni Lydman,2004-05,27.0,5,20,67,67,4,16,20,93.0,1421.0,289,19,74,93,442.0,82,5.14,57,348,2300,9.2,0.31527376
27554,27554,Toni Lydman,2006-07,29.0,6,17,75,75,1,16,17,68.0,1623.0,364,20,90,110,510.0,82,6.05,85,480,2458,10.1,0.22687677
27555,27555,Toni Lydman,2007-08,30.0,7,19,67,67,2,17,19,44.0,1380.0,431,22,107,129,554.0,82,5.76,70,398,2426,9.7,0.24123532
27556,27556,Toni Lydman,2008-09,31.0,8,26,82,82,4,22,26,86.0,1776.0,513,26,129,155,640.0,82,5.44,62,351,2383,9.4,0.26354873
27557,27557,Toni Lydman,2009-10,32.0,9,23,80,80,3,20,23,99.0,1742.0,593,29,149,178,739.0,82,5.7,65,341,2477,9.4,0.26220924
27558,27558,Toni Lydman,2010-11,33.0,10,20,67,67,4,16,20,77.0,1264.0,660,33,165,198,816.0,82,5.53,56,304,2486,9.1,0.25412363
27559,27559,Toni Lydman,2011-12,34.0,11,25,78,78,3,22,25,99.0,1729.0,738,36,187,223,915.0,82,5.46,52,291,2492,9.0,0.25852135
27560,27560,Toni Lydman,2012-13,35.0,12,13,74,74,0,13,13,46.0,1399.0,812,36,200,236,961.0,82,5.32,47,271,2439,8.9,0.13082057
27561,27561,Toni Lydman,2013-14,36.0,13,6,35,35,0,6,6,28.0,679.0,847,36,206,242,989.0,48,5.31,29,160,1399,9.1,0.14481667
27562,27562,Tony Amonte,1992-93,22.0,2,69,79,79,35,34,69,234.0,,79,35,34,69,234.0,80,6.96,77,402,2440,11.4,0.9301629
27563,27563,Tony Amonte,1993-94,23.0,3,76,83,83,33,43,76,270.0,,162,68,77,145,504.0,84,7.25,87,443,2603,11.7,0.84179544
27564,27564,Tony Amonte,1994-95,24.0,4,42,79,79,17,25,42,195.0,,241,85,102,187,699.0,84,6.48,76,407,2545,10.7,0.62787277
27565,27565,Tony Amonte,1995-96,25.0,5,35,48,48,15,20,35,105.0,,289,100,122,222,804.0,48,5.97,37,209,1408,10.2,0.77540576
27566,27566,Tony Amonte,1996-97,26.0,6,63,81,81,31,32,63,216.0,,370,131,154,285,1020.0,82,6.29,74,413,2481,10.4,0.7051183
27567,27567,Tony Amonte,1997-98,27.0,7,77,81,81,41,36,77,266.0,,451,172,190,362,1286.0,82,5.83,55,336,2444,9.8,0.9006916
27568,27568,Tony Amonte,1998-99,28.0,8,73,82,82,31,42,73,296.0,,533,203,232,435,1582.0,82,5.28,57,380,2242,9.6,0.90250283
27569,27569,Tony Amonte,1999-00,29.0,9,75,82,82,44,31,75,256.0,1820.0,615,247,263,510,1838.0,82,5.27,57,359,2285,9.4,0.82899266
27570,27570,Tony Amonte,2000-01,30.0,10,84,82,82,43,41,84,260.0,1795.0,697,290,304,594,2098.0,82,5.49,53,331,2294,9.8,0.95654166
27571,27571,Tony Amonte,2001-02,31.0,11,64,82,82,35,29,64,256.0,1816.0,779,325,333,658,2354.0,82,5.51,63,376,2272,9.9,0.7117416
27572,27572,Tony Amonte,2002-03,32.0,12,66,82,82,27,39,66,232.0,1746.0,861,352,372,724,2586.0,82,5.24,53,338,2262,9.5,0.7598772
27573,27573,Tony Amonte,2003-04,33.0,13,51,72,72,20,31,51,207.0,1377.0,933,372,403,775,2793.0,82,5.31,60,363,2326,9.4,0.64113706
27574,27574,Tony Amonte,2004-05,34.0,14,53,80,80,20,33,53,173.0,1219.0,1013,392,436,828,2966.0,82,5.14,57,348,2300,9.2,0.6621134
27575,27575,Tony Amonte,2006-07,36.0,15,42,80,80,14,28,42,155.0,1369.0,1093,406,464,870,3121.0,82,6.05,85,480,2458,10.1,0.46451643
27576,27576,Tony Amonte,2007-08,37.0,16,30,81,81,10,20,30,139.0,1146.0,1174,416,484,900,3260.0,82,5.76,70,398,2426,9.7,0.36547402
27577,27577,Tony Camazzola,1982-83,20.0,2,0,3,3,0,0,0,0.0,,3,0,0,0,0.0,80,8.03,73,320,2489,12.9,0.2668938
27578,27578,Tony Cassolato,1980-81,24.0,2,2,9,9,0,2,2,6.0,,9,0,2,2,6.0,80,7.03,61,280,2352,12.0,0.24366584
27579,27579,Tony Cassolato,1981-82,25.0,3,0,2,2,0,0,0,1.0,,11,0,2,2,7.0,80,7.69,77,340,2441,12.6,0.1948281
27580,27580,Tony Cassolato,1982-83,26.0,4,5,12,12,1,4,5,15.0,,23,1,6,7,22.0,80,8.03,73,320,2489,12.9,0.24534303
27581,27581,Tony Cimellaro,1993-94,22.0,2,0,2,2,0,0,0,4.0,,2,0,0,0,4.0,84,7.25,87,443,2603,11.7,0.23502818
27582,27582,Tony Curtale,1981-82,20.0,2,0,2,2,0,0,0,4.0,,2,0,0,0,4.0,80,7.69,77,340,2441,12.6,0.28836784
27583,27583,Tony Feltrin,1981-82,20.0,2,0,2,2,0,0,0,0.0,,2,0,0,0,0.0,80,7.69,77,340,2441,12.6,0.2619771
27584,27584,Tony Feltrin,1982-83,21.0,3,0,4,4,0,0,0,3.0,,6,0,0,0,3.0,80,8.03,73,320,2489,12.9,0.24127617
27585,27585,Tony Feltrin,1983-84,22.0,4,6,32,32,3,3,6,36.0,,38,3,3,6,39.0,80,7.73,71,310,2444,12.7,0.2922153
27586,27586,Tony Feltrin,1986-87,25.0,5,0,10,10,0,0,0,8.0,,48,3,3,6,47.0,80,7.94,82,370,2484,12.8,0.15904063
27587,27587,Tony Granato,1989-90,25.0,2,63,78,78,36,27,63,234.0,,78,36,27,63,234.0,80,7.48,85,403,2430,12.3,0.7120418
27588,27588,Tony Granato,1990-91,26.0,3,36,56,56,12,24,36,120.0,,134,48,51,99,354.0,80,7.37,76,367,2421,12.2,0.60971177
27589,27589,Tony Granato,1991-92,27.0,4,64,68,68,30,34,64,197.0,,202,78,85,163,551.0,80,6.91,71,366,2385,11.6,0.8267409
27590,27590,Tony Granato,1992-93,28.0,5,68,80,80,39,29,68,223.0,,282,117,114,231,774.0,80,6.96,77,402,2440,11.4,0.8414458
27591,27591,Tony Granato,1993-94,29.0,6,82,81,81,37,45,82,247.0,,363,154,159,313,1021.0,84,7.25,87,443,2603,11.7,0.7746298
27592,27592,Tony Granato,1994-95,30.0,7,21,50,50,7,14,21,117.0,,413,161,173,334,1138.0,84,6.48,76,407,2545,10.7,0.4742244
27593,27593,Tony Granato,1995-96,31.0,8,24,33,33,13,11,24,106.0,,446,174,184,358,1244.0,48,5.97,37,209,1408,10.2,0.59449893
27594,27594,Tony Granato,1996-97,32.0,9,35,49,49,17,18,35,156.0,,495,191,202,393,1400.0,82,6.29,74,413,2481,10.4,0.61555773
27595,27595,Tony Granato,1997-98,33.0,10,40,76,76,25,15,40,231.0,,571,216,217,433,1631.0,82,5.83,55,336,2444,9.8,0.5567319
27596,27596,Tony Granato,1998-99,34.0,11,25,59,59,16,9,25,119.0,,630,232,226,458,1750.0,82,5.28,57,380,2242,9.6,0.45255578
27597,27597,Tony Granato,1999-00,35.0,12,12,35,35,6,6,12,65.0,367.0,665,238,232,470,1815.0,82,5.27,57,359,2285,9.4,0.34137374
27598,27598,Tony Granato,2000-01,36.0,13,13,48,48,6,7,13,67.0,436.0,713,244,239,483,1882.0,82,5.49,53,331,2294,9.8,0.323537
27599,27599,Tony Granato,2001-02,37.0,14,9,60,60,4,5,9,85.0,505.0,773,248,244,492,1967.0,82,5.51,63,376,2272,9.9,0.23430768
27600,27600,Tony Horacek,1990-91,23.0,2,10,48,48,5,5,10,31.0,,48,5,5,10,31.0,80,7.37,76,367,2421,12.2,0.2642805
27601,27601,Tony Horacek,1991-92,24.0,3,9,34,34,3,6,9,35.0,,82,8,11,19,66.0,80,6.91,71,366,2385,11.6,0.2514491
27602,27602,Tony Horacek,1992-93,25.0,4,9,46,46,2,7,9,32.0,,128,10,18,28,98.0,80,6.96,77,402,2440,11.4,0.1770975
27603,27603,Tony Horacek,1994-95,27.0,5,0,7,7,0,0,0,2.0,,135,10,18,28,100.0,84,6.48,76,407,2545,10.7,0.12853706
27604,27604,Tony Horacek,1995-96,28.0,6,1,19,19,0,1,1,6.0,,154,10,19,29,106.0,48,5.97,37,209,1408,10.2,0.10275519
27605,27605,Tony Hrkac,1988-89,22.0,2,48,67,67,11,37,48,86.0,,67,11,37,48,86.0,80,7.43,89,437,2435,12.2,0.66729426
27606,27606,Tony Hrkac,1989-90,23.0,3,45,70,70,17,28,45,133.0,,137,28,65,93,219.0,80,7.48,85,403,2430,12.3,0.62769526
27607,27607,Tony Hrkac,1990-91,24.0,4,29,50,50,9,20,29,70.0,,187,37,85,122,289.0,80,7.37,76,367,2421,12.2,0.5148857
27608,27608,Tony Hrkac,1991-92,25.0,5,48,70,70,16,32,48,122.0,,257,53,117,170,411.0,80,6.91,71,366,2385,11.6,0.6635668
27609,27609,Tony Hrkac,1992-93,26.0,6,15,40,40,3,12,15,53.0,,297,56,129,185,464.0,80,6.96,77,402,2440,11.4,0.4089265
27610,27610,Tony Hrkac,1994-95,28.0,7,11,36,36,6,5,11,43.0,,333,62,134,196,507.0,84,6.48,76,407,2545,10.7,0.39002162
27611,27611,Tony Hrkac,1998-99,32.0,8,27,49,49,13,14,27,57.0,,382,75,148,223,564.0,82,5.28,57,380,2242,9.6,0.45060694
27612,27612,Tony Hrkac,1999-00,33.0,9,27,69,69,13,14,27,67.0,830.0,451,88,162,250,631.0,82,5.27,57,359,2285,9.4,0.3222281
27613,27613,Tony Hrkac,2000-01,34.0,10,13,67,67,4,9,13,39.0,624.0,518,92,171,263,670.0,82,5.49,53,331,2294,9.8,0.20388624
27614,27614,Tony Hrkac,2001-02,35.0,11,38,80,80,13,25,38,88.0,1102.0,598,105,196,301,758.0,82,5.51,63,376,2272,9.9,0.4002897
27615,27615,Tony Hrkac,2002-03,36.0,12,44,80,80,18,26,44,101.0,1398.0,678,123,222,345,859.0,82,5.24,53,338,2262,9.5,0.4519448
27616,27616,Tony Hrkac,2003-04,37.0,13,26,80,80,9,17,26,86.0,1288.0,758,132,239,371,945.0,82,5.31,60,363,2326,9.4,0.27149236
27617,27617,Tony Joseph,1989-90,20.0,2,1,2,2,1,0,1,4.0,,2,1,0,1,4.0,80,7.48,85,403,2430,12.3,0.3137662
27618,27618,Tony Martensson,2004-05,24.0,2,2,6,6,1,1,2,4.0,42.0,6,1,1,2,4.0,82,5.14,57,348,2300,9.2,0.22247344
27619,27619,Tony Salmelainen,2004-05,23.0,2,1,13,13,0,1,1,17.0,125.0,13,0,1,1,17.0,82,5.14,57,348,2300,9.2,0.21681651
27620,27620,Tony Salmelainen,2007-08,26.0,3,17,57,57,6,11,17,54.0,563.0,70,6,12,18,71.0,82,5.76,70,398,2426,9.7,0.25630283
27621,27621,Tony Stiles,1984-85,25.0,2,9,30,30,2,7,9,19.0,,30,2,7,9,19.0,80,7.89,74,336,2448,12.9,0.25191015
27622,27622,Tony Tanti,1982-83,19.0,2,0,2,2,0,0,0,0.0,,2,0,0,0,0.0,80,8.03,73,320,2489,12.9,0.25628674
27623,27623,Tony Tanti,1983-84,20.0,3,17,40,40,9,8,17,85.0,,42,9,8,17,85.0,80,7.73,71,310,2444,12.7,0.51098424
27624,27624,Tony Tanti,1984-85,21.0,4,86,79,79,45,41,86,247.0,,121,54,49,103,332.0,80,7.89,74,336,2448,12.9,1.0421273
27625,27625,Tony Tanti,1985-86,22.0,5,59,68,68,39,20,59,217.0,,189,93,69,162,549.0,80,7.77,71,321,2447,12.7,0.8863598
27626,27626,Tony Tanti,1986-87,23.0,6,72,77,77,39,33,72,213.0,,266,132,102,234,762.0,80,7.94,82,370,2484,12.8,0.83200157
27627,27627,Tony Tanti,1987-88,24.0,7,79,77,77,41,38,79,242.0,,343,173,140,313,1004.0,80,7.34,72,344,2400,12.2,0.96743274
27628,27628,Tony Tanti,1988-89,25.0,8,77,73,73,40,37,77,202.0,,416,213,177,390,1206.0,80,7.43,89,437,2435,12.2,0.92654026
27629,27629,Tony Tanti,1989-90,26.0,9,49,77,77,24,25,49,211.0,,493,237,202,439,1417.0,80,7.48,85,403,2430,12.3,0.7828585
27630,27630,Tony Tanti,1990-91,27.0,10,64,78,78,28,36,64,192.0,,571,265,238,503,1609.0,80,7.37,76,367,2421,12.2,0.74680233
27631,27631,Tony Tanti,1991-92,28.0,11,26,56,56,7,19,26,93.0,,627,272,257,529,1702.0,80,6.91,71,366,2385,11.6,0.50106686
27632,27632,Tony Tanti,1992-93,29.0,12,31,70,70,15,16,31,133.0,,697,287,273,560,1835.0,80,6.96,77,402,2440,11.4,0.4751897
27633,27633,Tony Tuzzolino,1998-99,23.0,2,0,1,1,0,0,0,0.0,,1,0,0,0,0.0,82,5.28,57,380,2242,9.6,0.15889817
27634,27634,Tony Tuzzolino,2001-02,26.0,3,0,6,6,0,0,0,3.0,22.0,7,0,0,0,3.0,82,5.51,63,376,2272,9.9,0.15418002
27635,27635,Tony Tuzzolino,2002-03,27.0,4,0,2,2,0,0,0,1.0,11.0,9,0,0,0,4.0,82,5.24,53,338,2262,9.5,0.14659512
27636,27636,Tony Twist,1990-91,22.0,2,0,28,28,0,0,0,2.0,,28,0,0,0,2.0,80,7.37,76,367,2421,12.2,0.12780982
27637,27637,Tony Twist,1991-92,23.0,3,0,24,24,0,0,0,2.0,,52,0,0,0,4.0,80,6.91,71,366,2385,11.6,0.11773458
27638,27638,Tony Twist,1992-93,24.0,4,1,44,44,0,1,1,9.0,,96,0,1,1,13.0,80,6.96,77,402,2440,11.4,0.11718273
27639,27639,Tony Twist,1993-94,25.0,5,2,34,34,0,2,2,14.0,,130,0,3,3,27.0,84,7.25,87,443,2603,11.7,0.10732767
27640,27640,Tony Twist,1994-95,26.0,6,4,49,49,0,4,4,15.0,,179,0,7,7,42.0,84,6.48,76,407,2545,10.7,0.08492309
27641,27641,Tony Twist,1995-96,27.0,7,3,28,28,3,0,3,8.0,,207,3,7,10,50.0,48,5.97,37,209,1408,10.2,0.17195272
27642,27642,Tony Twist,1996-97,28.0,8,5,51,51,3,2,5,12.0,,258,6,9,15,62.0,82,6.29,74,413,2481,10.4,0.091148764
27643,27643,Tony Twist,1997-98,29.0,9,3,64,64,1,2,3,21.0,,322,7,11,18,83.0,82,5.83,55,336,2444,9.8,0.07360241
27644,27644,Tony Twist,1998-99,30.0,10,2,60,60,1,1,2,17.0,,382,8,12,20,100.0,82,5.28,57,380,2242,9.6,0.06800124
27645,27645,Tony Twist,1999-00,31.0,11,8,63,63,2,6,8,23.0,326.0,445,10,18,28,123.0,82,5.27,57,359,2285,9.4,0.08319953
27646,27646,Tony Virta,2002-03,30.0,2,5,8,8,2,3,5,15.0,107.0,8,2,3,5,15.0,82,5.24,53,338,2262,9.5,0.24972478
27647,27647,Torey Krug,2012-13,21.0,2,1,2,2,0,1,1,3.0,34.0,2,0,1,1,3.0,82,5.32,47,271,2439,8.9,0.2606961
27648,27648,Torey Krug,2013-14,22.0,3,1,1,1,0,1,1,0.0,16.0,3,0,2,2,3.0,48,5.31,29,160,1399,9.1,0.2263766
27649,27649,Torey Krug,2014-15,23.0,4,40,79,79,14,26,40,183.0,1383.0,82,14,28,42,186.0,82,5.34,48,269,2463,8.9,0.5343012
27650,27650,Torey Krug,2015-16,24.0,5,39,78,78,12,27,39,205.0,1529.0,160,26,55,81,391.0,82,5.32,47,251,2453,8.9,0.52391714
27651,27651,Torey Krug,2016-17,25.0,6,44,81,81,4,40,44,244.0,1751.0,241,30,95,125,635.0,82,5.34,48,255,2438,9.0,0.5409898
27652,27652,Torey Krug,2017-18,26.0,7,51,81,81,8,43,51,208.0,1750.0,322,38,138,176,843.0,82,5.45,47,245,2478,9.0,0.6528562
27653,27653,Torey Krug,2018-19,27.0,8,59,76,76,14,45,59,197.0,1551.0,398,52,183,235,1040.0,82,5.86,50,250,2620,9.2,0.6758511
27654,27654,Torey Krug,2019-20,28.0,9,53,64,64,6,47,53,151.0,1363.0,462,58,230,288,1191.0,82,5.96,47,239,2579,9.5,0.6856332
27655,27655,Torey Krug,2020-21,29.0,10,49,61,61,9,40,49,144.0,1250.0,523,67,270,337,1335.0,70,5.96,42,208,2192,9.5,0.6776344
27656,27656,Torrey Mitchell,2008-09,24.0,2,20,82,82,10,10,20,110.0,1174.0,82,10,10,20,110.0,82,5.44,62,351,2383,9.4,0.30475074
27657,27657,Torrey Mitchell,2010-11,26.0,3,11,56,56,2,9,11,59.0,640.0,138,12,19,31,169.0,82,5.53,56,304,2486,9.1,0.2056194
27658,27658,Torrey Mitchell,2011-12,27.0,4,23,66,66,9,14,23,116.0,881.0,204,21,33,54,285.0,82,5.46,52,291,2492,9.0,0.30123305
27659,27659,Torrey Mitchell,2012-13,28.0,5,19,76,76,9,10,19,100.0,945.0,280,30,43,73,385.0,82,5.32,47,271,2439,8.9,0.2503057
27660,27660,Torrey Mitchell,2013-14,29.0,6,8,45,45,4,4,8,39.0,472.0,325,34,47,81,424.0,48,5.31,29,160,1399,9.1,0.18403873
27661,27661,Torrey Mitchell,2014-15,30.0,7,10,67,67,2,8,10,56.0,729.0,392,36,55,91,480.0,82,5.34,48,269,2463,8.9,0.1639947
27662,27662,Torrey Mitchell,2015-16,31.0,8,14,65,65,6,8,14,55.0,923.0,457,42,63,105,535.0,82,5.32,47,251,2453,8.9,0.17923155
27663,27663,Torrey Mitchell,2016-17,32.0,9,19,71,71,11,8,19,69.0,901.0,528,53,71,124,604.0,82,5.34,48,255,2438,9.0,0.23944092
27664,27664,Torrey Mitchell,2017-18,33.0,10,17,78,78,8,9,17,68.0,983.0,606,61,80,141,672.0,82,5.45,47,245,2478,9.0,0.20669863
27665,27665,Torrey Mitchell,2018-19,34.0,11,11,60,60,6,5,11,55.0,684.0,666,67,85,152,727.0,82,5.86,50,250,2620,9.2,0.17058548
27666,27666,Torrie Robertson,1981-82,20.0,2,0,3,3,0,0,0,3.0,,3,0,0,0,3.0,80,7.69,77,340,2441,12.6,0.28836784
27667,27667,Torrie Robertson,1982-83,21.0,3,21,54,54,8,13,21,46.0,,57,8,13,21,49.0,80,8.03,73,320,2489,12.9,0.40659457
27668,27668,Torrie Robertson,1983-84,22.0,4,2,5,5,2,0,2,5.0,,62,10,13,23,54.0,80,7.73,71,310,2444,12.7,0.35011166
27669,27669,Torrie Robertson,1984-85,23.0,5,20,66,66,7,13,20,62.0,,128,17,26,43,116.0,80,7.89,74,336,2448,12.9,0.33704382
27670,27670,Torrie Robertson,1985-86,24.0,6,41,74,74,11,30,41,74.0,,202,28,56,84,190.0,80,7.77,71,321,2447,12.7,0.4597359
27671,27671,Torrie Robertson,1986-87,25.0,7,37,76,76,13,24,37,87.0,,278,41,80,121,277.0,80,7.94,82,370,2484,12.8,0.44820005
27672,27672,Torrie Robertson,1987-88,26.0,8,1,20,20,1,0,1,19.0,,298,42,80,122,296.0,80,7.34,72,344,2400,12.2,0.22614747
27673,27673,Torrie Robertson,1988-89,27.0,9,10,63,63,2,8,10,46.0,,361,44,88,132,342.0,80,7.43,89,437,2435,12.2,0.22299096
27674,27674,Torrie Robertson,1989-90,28.0,10,10,39,39,4,6,10,26.0,,400,48,94,142,368.0,80,7.48,85,403,2430,12.3,0.24114743
27675,27675,Torrie Robertson,1990-91,29.0,11,6,42,42,1,5,6,20.0,,442,49,99,148,388.0,80,7.37,76,367,2421,12.2,0.14243606
27676,27676,Travis Boyd,2018-19,25.0,2,1,8,8,0,1,1,2.0,71.0,8,0,1,1,2.0,82,5.86,50,250,2620,9.2,0.17724419
27677,27677,Travis Boyd,2019-20,26.0,3,20,53,53,5,15,20,35.0,521.0,61,5,16,21,37.0,82,5.96,47,239,2579,9.5,0.30369034
27678,27678,Travis Boyd,2020-21,27.0,4,10,24,24,3,7,10,26.0,282.0,85,8,23,31,63.0,70,5.96,42,208,2192,9.5,0.28783306
27679,27679,Travis Brigley,1998-99,21.0,2,0,2,2,0,0,0,1.0,,2,0,0,0,1.0,82,5.28,57,380,2242,9.6,0.17559981
27680,27680,Travis Brigley,2000-01,23.0,3,2,17,17,0,2,2,17.0,242.0,19,0,2,2,18.0,82,5.49,53,331,2294,9.8,0.17812926
27681,27681,Travis Brigley,2004-05,27.0,4,7,36,36,3,4,7,39.0,427.0,55,3,6,9,57.0,82,5.14,57,348,2300,9.2,0.201114
27682,27682,Travis Dermott,2018-19,22.0,2,13,37,37,1,12,13,54.0,592.0,37,1,12,13,54.0,82,5.86,50,250,2620,9.2,0.2383664
27683,27683,Travis Dermott,2019-20,23.0,3,17,64,64,4,13,17,98.0,1108.0,101,5,25,30,152.0,82,5.96,47,239,2579,9.5,0.28372073
27684,27684,Travis Dermott,2020-21,24.0,4,11,56,56,4,7,11,65.0,969.0,157,9,32,41,217.0,70,5.96,42,208,2192,9.5,0.2733096
27685,27685,Travis Green,1993-94,23.0,2,25,61,61,7,18,25,115.0,,61,7,18,25,115.0,84,7.25,87,443,2603,11.7,0.434868
27686,27686,Travis Green,1994-95,24.0,3,40,83,83,18,22,40,164.0,,144,25,40,65,279.0,84,6.48,76,407,2545,10.7,0.48250777
27687,27687,Travis Green,1995-96,25.0,4,12,42,42,5,7,12,59.0,,186,30,47,77,338.0,48,5.97,37,209,1408,10.2,0.35771194
27688,27688,Travis Green,1996-97,26.0,5,70,69,69,25,45,70,186.0,,255,55,92,147,524.0,82,6.29,74,413,2481,10.4,0.8091407
27689,27689,Travis Green,1997-98,27.0,6,64,79,79,23,41,64,177.0,,334,78,133,211,701.0,82,5.83,55,336,2444,9.8,0.6864376
27690,27690,Travis Green,1998-99,28.0,7,42,76,76,19,23,42,141.0,,410,97,156,253,842.0,82,5.28,57,380,2242,9.6,0.50250286
27691,27691,Travis Green,1999-00,29.0,8,30,79,79,13,17,30,165.0,1365.0,489,110,173,283,1007.0,82,5.27,57,359,2285,9.4,0.4497693
27692,27692,Travis Green,2000-01,30.0,9,46,78,78,25,21,46,157.0,1294.0,567,135,194,329,1164.0,82,5.49,53,331,2294,9.8,0.546435
27693,27693,Travis Green,2001-02,31.0,10,28,69,69,13,15,28,113.0,1110.0,636,148,209,357,1277.0,82,5.51,63,376,2272,9.9,0.37250605
27694,27694,Travis Green,2002-03,32.0,11,34,82,82,11,23,34,119.0,1191.0,718,159,232,391,1396.0,82,5.24,53,338,2262,9.5,0.39724535
27695,27695,Travis Green,2003-04,33.0,12,24,75,75,12,12,24,86.0,971.0,793,171,244,415,1482.0,82,5.31,60,363,2326,9.4,0.30948377
27696,27696,Travis Green,2004-05,34.0,13,16,64,64,11,5,16,104.0,978.0,857,182,249,431,1586.0,82,5.14,57,348,2300,9.2,0.37651289
27697,27697,Travis Green,2006-07,36.0,14,22,82,82,10,12,22,118.0,1235.0,939,192,261,453,1704.0,82,6.05,85,480,2458,10.1,0.2517367
27698,27698,Travis Green,2007-08,37.0,15,2,31,31,1,1,2,22.0,276.0,970,193,262,455,1726.0,82,5.76,70,398,2426,9.7,0.17905977
27699,27699,Travis Hamonic,2011-12,21.0,2,26,62,62,5,21,26,118.0,1338.0,62,5,21,26,118.0,82,5.46,52,291,2492,9.0,0.43836096
27700,27700,Travis Hamonic,2012-13,22.0,3,24,73,73,2,22,24,124.0,1637.0,135,7,43,50,242.0,82,5.32,47,271,2439,8.9,0.3266548
27701,27701,Travis Hamonic,2013-14,23.0,4,10,48,48,3,7,10,83.0,1095.0,183,10,50,60,325.0,48,5.31,29,160,1399,9.1,0.3396086
27702,27702,Travis Hamonic,2014-15,24.0,5,18,69,69,3,15,18,134.0,1726.0,252,13,65,78,459.0,82,5.34,48,269,2463,8.9,0.2921903
27703,27703,Travis Hamonic,2015-16,25.0,6,33,71,71,5,28,33,132.0,1547.0,323,18,93,111,591.0,82,5.32,47,251,2453,8.9,0.44718942
27704,27704,Travis Hamonic,2016-17,26.0,7,21,72,72,5,16,21,147.0,1715.0,395,23,109,132,738.0,82,5.34,48,255,2438,9.0,0.3339492
27705,27705,Travis Hamonic,2017-18,27.0,8,14,49,49,3,11,14,74.0,1002.0,444,26,120,146,812.0,82,5.45,47,245,2478,9.0,0.26050103
27706,27706,Travis Hamonic,2018-19,28.0,9,11,74,74,1,10,11,107.0,1532.0,518,27,130,157,919.0,82,5.86,50,250,2620,9.2,0.21051511
27707,27707,Travis Hamonic,2019-20,29.0,10,19,69,69,7,12,19,128.0,1440.0,587,34,142,176,1047.0,82,5.96,47,239,2579,9.5,0.2894848
27708,27708,Travis Hamonic,2020-21,30.0,11,12,50,50,3,9,12,83.0,1060.0,637,37,151,188,1130.0,70,5.96,42,208,2192,9.5,0.2791986
27709,27709,Travis Konecny,2017-18,20.0,2,28,70,70,11,17,28,133.0,986.0,70,11,17,28,133.0,82,5.45,47,245,2478,9.0,0.48201412
27710,27710,Travis Konecny,2018-19,21.0,3,47,81,81,24,23,47,177.0,1207.0,151,35,40,75,310.0,82,5.86,50,250,2620,9.2,0.69395703
27711,27711,Travis Konecny,2019-20,22.0,4,49,82,82,24,25,49,182.0,1251.0,233,59,65,124,492.0,82,5.96,47,239,2579,9.5,0.70784026
27712,27712,Travis Konecny,2020-21,23.0,5,61,66,66,24,37,61,141.0,1109.0,299,83,102,185,633.0,70,5.96,42,208,2192,9.5,0.8542633
27713,27713,Travis Moen,2004-05,22.0,2,6,82,82,4,2,6,51.0,898.0,82,4,2,6,51.0,82,5.14,57,348,2300,9.2,0.17654786
27714,27714,Travis Moen,2006-07,24.0,3,5,39,39,4,1,5,28.0,431.0,121,8,3,11,79.0,82,6.05,85,480,2458,10.1,0.16555646
27715,27715,Travis Moen,2007-08,25.0,4,21,82,82,11,10,21,124.0,1214.0,203,19,13,32,203.0,82,5.76,70,398,2426,9.7,0.27304173
27716,27716,Travis Moen,2008-09,26.0,5,8,77,77,3,5,8,98.0,1219.0,280,22,18,40,301.0,82,5.44,62,351,2383,9.4,0.18801314
27717,27717,Travis Moen,2009-10,27.0,6,16,82,82,7,9,16,101.0,1229.0,362,29,27,56,402.0,82,5.7,65,341,2477,9.4,0.21794406
27718,27718,Travis Moen,2010-11,28.0,7,19,81,81,8,11,19,107.0,1214.0,443,37,38,75,509.0,82,5.53,56,304,2486,9.1,0.22465634
27719,27719,Travis Moen,2011-12,29.0,8,16,79,79,6,10,16,99.0,1042.0,522,43,48,91,608.0,82,5.46,52,291,2492,9.0,0.23249808
27720,27720,Travis Moen,2012-13,30.0,9,16,48,48,9,7,16,45.0,754.0,570,52,55,107,653.0,82,5.32,47,271,2439,8.9,0.2687443
27721,27721,Travis Moen,2013-14,31.0,10,6,45,45,2,4,6,32.0,524.0,615,54,59,113,685.0,48,5.31,29,160,1399,9.1,0.1395576
27722,27722,Travis Moen,2014-15,32.0,11,12,65,65,2,10,12,56.0,749.0,680,56,69,125,741.0,82,5.34,48,269,2463,8.9,0.13674909
27723,27723,Travis Moen,2015-16,33.0,12,9,44,44,3,6,9,34.0,413.0,724,59,75,134,775.0,82,5.32,47,251,2453,8.9,0.12064302
27724,27724,Travis Moen,2016-17,34.0,13,2,23,23,0,2,2,12.0,188.0,747,59,77,136,787.0,82,5.34,48,255,2438,9.0,0.10647476
27725,27725,Travis Morin,2011-12,28.0,2,0,3,3,0,0,0,2.0,27.0,3,0,0,0,2.0,82,5.46,52,291,2492,9.0,0.15595362
27726,27726,Travis Morin,2014-15,31.0,3,1,4,4,0,1,1,4.0,41.0,7,0,1,1,6.0,82,5.34,48,269,2463,8.9,0.15789053
27727,27727,Travis Morin,2015-16,32.0,4,0,6,6,0,0,0,10.0,73.0,13,0,1,1,16.0,82,5.32,47,251,2453,8.9,0.16370472
27728,27728,Travis Richards,1995-96,25.0,2,0,2,2,0,0,0,1.0,,2,0,0,0,1.0,48,5.97,37,209,1408,10.2,0.19026372
27729,27729,Travis Richards,1996-97,26.0,3,0,1,1,0,0,0,0.0,,3,0,0,0,1.0,82,6.29,74,413,2481,10.4,0.14503509
27730,27730,Travis Roche,2001-02,23.0,2,0,1,1,0,0,0,0.0,15.0,1,0,0,0,0.0,82,5.51,63,376,2272,9.9,0.16257238
27731,27731,Travis Roche,2002-03,24.0,3,0,4,4,0,0,0,1.0,50.0,5,0,0,0,1.0,82,5.24,53,338,2262,9.5,0.15520793
27732,27732,Travis Roche,2004-05,26.0,4,1,5,5,0,1,1,5.0,81.0,10,0,1,1,6.0,82,5.14,57,348,2300,9.2,0.16921127
27733,27733,Travis Roche,2007-08,29.0,5,19,50,50,6,13,19,32.0,851.0,60,6,14,20,38.0,82,5.76,70,398,2426,9.7,0.27803606
27734,27734,Travis Sanheim,2018-19,22.0,2,10,49,49,2,8,10,72.0,764.0,49,2,8,10,72.0,82,5.86,50,250,2620,9.2,0.26606703
27735,27735,Travis Sanheim,2019-20,23.0,3,35,82,82,9,26,35,121.0,1604.0,131,11,34,45,193.0,82,5.96,47,239,2579,9.5,0.42667562
27736,27736,Travis Sanheim,2020-21,24.0,4,25,69,69,8,17,25,110.0,1391.0,200,19,51,70,303.0,70,5.96,42,208,2192,9.5,0.412197
27737,27737,Travis Turnbull,2012-13,26.0,2,1,3,3,1,0,1,3.0,15.0,3,1,0,1,3.0,82,5.32,47,271,2439,8.9,0.1930868
27738,27738,Travis Zajac,2007-08,22.0,2,42,80,80,17,25,42,134.0,1283.0,80,17,25,42,134.0,82,5.76,70,398,2426,9.7,0.55919
27739,27739,Travis Zajac,2008-09,23.0,3,34,82,82,14,20,34,155.0,1372.0,162,31,45,76,289.0,82,5.44,62,351,2383,9.4,0.51121855
27740,27740,Travis Zajac,2009-10,24.0,4,62,82,82,20,42,62,185.0,1529.0,244,51,87,138,474.0,82,5.7,65,341,2477,9.4,0.73549587
27741,27741,Travis Zajac,2010-11,25.0,5,67,82,82,25,42,67,210.0,1658.0,326,76,129,205,684.0,82,5.53,56,304,2486,9.1,0.78236747
27742,27742,Travis Zajac,2011-12,26.0,6,44,82,82,13,31,44,173.0,1622.0,408,89,160,249,857.0,82,5.46,52,291,2492,9.0,0.5574626
27743,27743,Travis Zajac,2012-13,27.0,7,6,15,15,2,4,6,25.0,261.0,423,91,164,255,882.0,82,5.32,47,271,2439,8.9,0.3767055
27744,27744,Travis Zajac,2013-14,28.0,8,20,48,48,7,13,20,82.0,938.0,471,98,177,275,964.0,48,5.31,29,160,1399,9.1,0.48053
27745,27745,Travis Zajac,2014-15,29.0,9,48,80,80,18,30,48,165.0,1625.0,551,116,207,323,1129.0,82,5.34,48,269,2463,8.9,0.58048266
27746,27746,Travis Zajac,2015-16,30.0,10,25,74,74,11,14,25,112.0,1411.0,625,127,221,348,1241.0,82,5.32,47,251,2453,8.9,0.33828485
27747,27747,Travis Zajac,2016-17,31.0,11,42,74,74,14,28,42,111.0,1469.0,699,141,249,390,1352.0,82,5.34,48,255,2438,9.0,0.47729135
27748,27748,Travis Zajac,2017-18,32.0,12,45,80,80,14,31,45,126.0,1578.0,779,155,280,435,1478.0,82,5.45,47,245,2478,9.0,0.4962458
27749,27749,Travis Zajac,2018-19,33.0,13,26,63,63,12,14,26,91.0,1128.0,842,167,294,461,1569.0,82,5.86,50,250,2620,9.2,0.37080723
27750,27750,Travis Zajac,2019-20,34.0,14,46,80,80,19,27,46,120.0,1542.0,922,186,321,507,1689.0,82,5.96,47,239,2579,9.5,0.4532614
27751,27751,Travis Zajac,2020-21,35.0,15,25,69,69,9,16,25,72.0,1180.0,991,195,337,532,1761.0,70,5.96,42,208,2192,9.5,0.29291132
27752,27752,Trent Frederic,2019-20,21.0,2,0,15,15,0,0,0,19.0,141.0,15,0,0,0,19.0,82,5.96,47,239,2579,9.5,0.22013369
27753,27753,Trent Frederic,2020-21,22.0,3,0,2,2,0,0,0,1.0,13.0,17,0,0,0,20.0,70,5.96,42,208,2192,9.5,0.1941644
27754,27754,Trent Hunter,2003-04,23.0,2,4,8,8,0,4,4,19.0,98.0,8,0,4,4,19.0,82,5.31,60,363,2326,9.4,0.2266002
27755,27755,Trent Hunter,2004-05,24.0,3,51,77,77,25,26,51,187.0,1205.0,85,25,30,55,206.0,82,5.14,57,348,2300,9.2,0.627282
27756,27756,Trent Hunter,2006-07,26.0,4,35,82,82,16,19,35,221.0,1462.0,167,41,49,90,427.0,82,6.05,85,480,2458,10.1,0.45813695
27757,27757,Trent Hunter,2007-08,27.0,5,35,77,77,20,15,35,168.0,1232.0,244,61,64,125,595.0,82,5.76,70,398,2426,9.7,0.4562851
27758,27758,Trent Hunter,2008-09,28.0,6,41,82,82,12,29,41,222.0,1493.0,326,73,93,166,817.0,82,5.44,62,351,2383,9.4,0.5539726
27759,27759,Trent Hunter,2009-10,29.0,7,31,55,55,14,17,31,154.0,901.0,381,87,110,197,971.0,82,5.7,65,341,2477,9.4,0.551766
27760,27760,Trent Hunter,2010-11,30.0,8,28,61,61,11,17,28,159.0,926.0,442,98,127,225,1130.0,82,5.53,56,304,2486,9.1,0.44317698
27761,27761,Trent Hunter,2011-12,31.0,9,4,17,17,1,3,4,30.0,215.0,459,99,130,229,1160.0,82,5.46,52,291,2492,9.0,0.3023835
27762,27762,Trent Hunter,2012-13,32.0,10,7,38,38,2,5,7,51.0,384.0,497,101,135,236,1211.0,82,5.32,47,271,2439,8.9,0.24492234
27763,27763,Trent Kaese,1989-90,22.0,2,0,1,1,0,0,0,5.0,,1,0,0,0,5.0,80,7.48,85,403,2430,12.3,0.23397675
27764,27764,Trent Klatt,1992-93,22.0,2,0,1,1,0,0,0,1.0,,1,0,0,0,1.0,80,6.96,77,402,2440,11.4,0.21508399
27765,27765,Trent Klatt,1993-94,23.0,3,23,47,47,4,19,23,69.0,,48,4,19,23,70.0,84,7.25,87,443,2603,11.7,0.3754307
27766,27766,Trent Klatt,1994-95,24.0,4,38,61,61,14,24,38,86.0,,109,18,43,61,156.0,84,6.48,76,407,2545,10.7,0.47847855
27767,27767,Trent Klatt,1995-96,25.0,5,22,47,47,12,10,22,91.0,,156,30,53,83,247.0,48,5.97,37,209,1408,10.2,0.46143442
27768,27768,Trent Klatt,1996-97,26.0,6,19,71,71,7,12,19,101.0,,227,37,65,102,348.0,82,6.29,74,413,2481,10.4,0.29411012
27769,27769,Trent Klatt,1997-98,27.0,7,45,76,76,24,21,45,131.0,,303,61,86,147,479.0,82,5.83,55,336,2444,9.8,0.5178922
27770,27770,Trent Klatt,1998-99,28.0,8,42,82,82,14,28,42,143.0,,385,75,114,189,622.0,82,5.28,57,380,2242,9.6,0.4794647
27771,27771,Trent Klatt,1999-00,29.0,9,14,75,75,4,10,14,60.0,851.0,460,79,124,203,682.0,82,5.27,57,359,2285,9.4,0.24030188
27772,27772,Trent Klatt,2000-01,30.0,10,20,47,47,10,10,20,100.0,755.0,507,89,134,223,782.0,82,5.49,53,331,2294,9.8,0.4075518
27773,27773,Trent Klatt,2001-02,31.0,11,33,77,77,13,20,33,140.0,1044.0,584,102,154,256,922.0,82,5.51,63,376,2272,9.9,0.36816263
27774,27774,Trent Klatt,2002-03,32.0,12,15,34,34,8,7,15,67.0,525.0,618,110,161,271,989.0,82,5.24,53,338,2262,9.5,0.3180282
27775,27775,Trent Klatt,2003-04,33.0,13,29,82,82,16,13,29,127.0,1019.0,700,126,174,300,1116.0,82,5.31,60,363,2326,9.4,0.34402832
27776,27776,Trent Klatt,2004-05,34.0,14,43,82,82,17,26,43,160.0,1332.0,782,143,200,343,1276.0,82,5.14,57,348,2300,9.2,0.53254056
27777,27777,Trent McCleary,1996-97,24.0,2,14,75,75,4,10,14,58.0,,75,4,10,14,58.0,82,6.29,74,413,2481,10.4,0.1892705
27778,27778,Trent McCleary,1997-98,25.0,3,8,59,59,3,5,8,41.0,,134,7,15,22,99.0,82,5.83,55,336,2444,9.8,0.1504845
27779,27779,Trent McCleary,1999-00,27.0,4,0,46,46,0,0,0,18.0,268.0,180,7,15,22,117.0,82,5.27,57,359,2285,9.4,0.101634264
27780,27780,Trent McCleary,2000-01,28.0,5,1,12,12,1,0,1,4.0,75.0,192,8,15,23,121.0,82,5.49,53,331,2294,9.8,0.13825974
27781,27781,Trent Whitfield,2001-02,24.0,2,6,61,61,2,4,6,47.0,589.0,61,2,4,6,47.0,82,5.51,63,376,2272,9.9,0.15659413
27782,27782,Trent Whitfield,2002-03,25.0,3,1,25,25,0,1,1,15.0,183.0,86,2,5,7,62.0,82,5.24,53,338,2262,9.5,0.12295604
27783,27783,Trent Whitfield,2003-04,26.0,4,2,14,14,1,1,2,4.0,119.0,100,3,6,9,66.0,82,5.31,60,363,2326,9.4,0.1657801
27784,27784,Trent Whitfield,2004-05,27.0,5,11,44,44,6,5,11,38.0,563.0,144,9,11,20,104.0,82,5.14,57,348,2300,9.2,0.21548536
27785,27785,Trent Whitfield,2006-07,29.0,6,7,30,30,2,5,7,41.0,358.0,174,11,16,27,145.0,82,6.05,85,480,2458,10.1,0.18278077
27786,27786,Trent Whitfield,2009-10,32.0,7,1,3,3,0,1,1,4.0,33.0,177,11,17,28,149.0,82,5.7,65,341,2477,9.4,0.124755055
27787,27787,Trent Whitfield,2010-11,33.0,8,1,16,16,0,1,1,15.0,177.0,193,11,18,29,164.0,82,5.53,56,304,2486,9.1,0.13112772
27788,27788,Trent Whitfield,2012-13,35.0,9,0,1,1,0,0,0,1.0,14.0,194,11,18,29,165.0,82,5.32,47,271,2439,8.9,0.1247212
27789,27789,Trent Yawney,1988-89,23.0,2,10,15,15,2,8,10,26.0,,15,2,8,10,26.0,80,7.43,89,437,2435,12.2,0.42583746
27790,27790,Trent Yawney,1989-90,24.0,3,24,69,69,5,19,24,75.0,,84,7,27,34,101.0,80,7.48,85,403,2430,12.3,0.3383928
27791,27791,Trent Yawney,1990-91,25.0,4,20,70,70,5,15,20,58.0,,154,12,42,54,159.0,80,7.37,76,367,2421,12.2,0.26747638
27792,27792,Trent Yawney,1991-92,26.0,5,16,61,61,3,13,16,52.0,,215,15,55,70,211.0,80,6.91,71,366,2385,11.6,0.28379354
27793,27793,Trent Yawney,1992-93,27.0,6,13,47,47,4,9,13,33.0,,262,19,64,83,244.0,80,6.96,77,402,2440,11.4,0.27484602
27794,27794,Trent Yawney,1993-94,28.0,7,17,63,63,1,16,17,61.0,,325,20,80,100,305.0,84,7.25,87,443,2603,11.7,0.22711402
27795,27795,Trent Yawney,1994-95,29.0,8,21,58,58,6,15,21,62.0,,383,26,95,121,367.0,84,6.48,76,407,2545,10.7,0.29721063
27796,27796,Trent Yawney,1995-96,30.0,9,2,37,37,0,2,2,20.0,,420,26,97,123,387.0,48,5.97,37,209,1408,10.2,0.13923189
27797,27797,Trent Yawney,1996-97,31.0,10,3,69,69,0,3,3,51.0,,489,26,100,126,438.0,82,6.29,74,413,2481,10.4,0.14125988
27798,27798,Trent Yawney,1997-98,32.0,11,2,39,39,0,2,2,8.0,,528,26,102,128,446.0,82,5.83,55,336,2444,9.8,0.08089292
27799,27799,Trent Yawney,1998-99,33.0,12,1,45,45,1,0,1,19.0,,573,27,102,129,465.0,82,5.28,57,380,2242,9.6,0.103441685
27800,27800,Trent Yawney,1999-00,34.0,13,0,20,20,0,0,0,11.0,269.0,593,27,102,129,476.0,82,5.27,57,359,2285,9.4,0.09638819
27801,27801,Trevor Carrick,2016-17,22.0,2,0,2,2,0,0,0,3.0,33.0,2,0,0,0,3.0,82,5.34,48,255,2438,9.0,0.18558577
27802,27802,Trevor Carrick,2018-19,24.0,3,0,1,1,0,0,0,1.0,8.0,3,0,0,0,4.0,82,5.86,50,250,2620,9.2,0.15936142
27803,27803,Trevor Carrick,2019-20,25.0,4,0,1,1,0,0,0,0.0,11.0,4,0,0,0,4.0,82,5.96,47,239,2579,9.5,0.16054353
27804,27804,Trevor Carrick,2020-21,26.0,5,0,3,3,0,0,0,1.0,17.0,7,0,0,0,5.0,70,5.96,42,208,2192,9.5,0.23090115
27805,27805,Trevor Daley,2004-05,21.0,2,6,27,27,1,5,6,34.0,433.0,27,1,5,6,34.0,82,5.14,57,348,2300,9.2,0.30170584
27806,27806,Trevor Daley,2006-07,23.0,3,14,81,81,3,11,14,91.0,1512.0,108,4,16,20,125.0,82,6.05,85,480,2458,10.1,0.2414434
27807,27807,Trevor Daley,2007-08,24.0,4,12,74,74,4,8,12,68.0,1434.0,182,8,24,32,193.0,82,5.76,70,398,2426,9.7,0.19298995
27808,27808,Trevor Daley,2008-09,25.0,5,24,82,82,5,19,24,87.0,1624.0,264,13,43,56,280.0,82,5.44,62,351,2383,9.4,0.28487986
27809,27809,Trevor Daley,2009-10,26.0,6,25,75,75,7,18,25,104.0,1650.0,339,20,61,81,384.0,82,5.7,65,341,2477,9.4,0.3105629
27810,27810,Trevor Daley,2010-11,27.0,7,22,77,77,6,16,22,107.0,1708.0,416,26,77,103,491.0,82,5.53,56,304,2486,9.1,0.27546424
27811,27811,Trevor Daley,2011-12,28.0,8,27,82,82,8,19,27,131.0,1844.0,498,34,96,130,622.0,82,5.46,52,291,2492,9.0,0.32243955
27812,27812,Trevor Daley,2012-13,29.0,9,25,79,79,4,21,25,134.0,1710.0,577,38,117,155,756.0,82,5.32,47,271,2439,8.9,0.28004658
27813,27813,Trevor Daley,2013-14,30.0,10,13,44,44,4,9,13,58.0,942.0,621,42,126,168,814.0,48,5.31,29,160,1399,9.1,0.26634225
27814,27814,Trevor Daley,2014-15,31.0,11,25,67,67,9,16,25,107.0,1417.0,688,51,142,193,921.0,82,5.34,48,269,2463,8.9,0.3058669
27815,27815,Trevor Daley,2015-16,32.0,12,38,68,68,16,22,38,113.0,1556.0,756,67,164,231,1034.0,82,5.32,47,251,2453,8.9,0.41184682
27816,27816,Trevor Daley,2016-17,33.0,13,28,82,82,6,22,28,130.0,1512.0,838,73,186,259,1164.0,82,5.34,48,255,2438,9.0,0.3224119
27817,27817,Trevor Daley,2017-18,34.0,14,19,56,56,5,14,19,84.0,1141.0,894,78,200,278,1248.0,82,5.45,47,245,2478,9.0,0.29149514
27818,27818,Trevor Daley,2018-19,35.0,15,16,77,77,9,7,16,103.0,1594.0,971,87,207,294,1351.0,82,5.86,50,250,2620,9.2,0.20174941
27819,27819,Trevor Daley,2019-20,36.0,16,8,44,44,2,6,8,47.0,817.0,1015,89,213,302,1398.0,82,5.96,47,239,2579,9.5,0.14376819
27820,27820,Trevor Daley,2020-21,37.0,17,7,43,43,0,7,7,37.0,673.0,1058,89,220,309,1435.0,70,5.96,42,208,2192,9.5,0.16417682
27821,27821,Trevor Frischmon,2010-11,29.0,2,0,3,3,0,0,0,1.0,18.0,3,0,0,0,1.0,82,5.53,56,304,2486,9.1,0.17495474
27822,27822,Trevor Gillies,2006-07,28.0,2,0,1,1,0,0,0,1.0,3.0,1,0,0,0,1.0,82,6.05,85,480,2458,10.1,0.15345633
27823,27823,Trevor Gillies,2010-11,32.0,3,1,14,14,0,1,1,6.0,53.0,15,0,1,1,7.0,82,5.53,56,304,2486,9.1,0.14899543
27824,27824,Trevor Gillies,2011-12,33.0,4,2,39,39,2,0,2,9.0,120.0,54,2,1,3,16.0,82,5.46,52,291,2492,9.0,0.106666476
27825,27825,Trevor Gillies,2012-13,34.0,5,0,3,3,0,0,0,1.0,9.0,57,2,1,3,17.0,82,5.32,47,271,2439,8.9,0.109101236
27826,27826,Trevor Halverson,1999-00,28.0,2,4,17,17,0,4,4,16.0,203.0,17,0,4,4,16.0,82,5.27,57,359,2285,9.4,0.20648706
27827,27827,Trevor Letowski,1999-00,22.0,2,4,14,14,2,2,4,8.0,84.0,14,2,2,4,8.0,82,5.27,57,359,2285,9.4,0.25506717
27828,27828,Trevor Letowski,2000-01,23.0,3,39,82,82,19,20,39,125.0,1316.0,96,21,22,43,133.0,82,5.49,53,331,2294,9.8,0.49843064
27829,27829,Trevor Letowski,2001-02,24.0,4,22,77,77,7,15,22,110.0,1258.0,173,28,37,65,243.0,82,5.51,63,376,2272,9.9,0.32478768
27830,27830,Trevor Letowski,2002-03,25.0,5,25,75,75,9,16,25,108.0,1014.0,248,37,53,90,351.0,82,5.24,53,338,2262,9.5,0.3767601
27831,27831,Trevor Letowski,2003-04,26.0,6,25,78,78,11,14,25,136.0,970.0,326,48,67,115,487.0,82,5.31,60,363,2326,9.4,0.35086647
27832,27832,Trevor Letowski,2004-05,27.0,7,32,73,73,15,17,32,126.0,1191.0,399,63,84,147,613.0,82,5.14,57,348,2300,9.2,0.48869902
27833,27833,Trevor Letowski,2006-07,29.0,8,28,81,81,10,18,28,135.0,1339.0,480,73,102,175,748.0,82,6.05,85,480,2458,10.1,0.34335375
27834,27834,Trevor Letowski,2007-08,30.0,9,8,61,61,2,6,8,69.0,591.0,541,75,108,183,817.0,82,5.76,70,398,2426,9.7,0.23617008
27835,27835,Trevor Letowski,2008-09,31.0,10,18,75,75,9,9,18,67.0,770.0,616,84,117,201,884.0,82,5.44,62,351,2383,9.4,0.23905665
27836,27836,Trevor Lewis,2009-10,23.0,2,3,6,6,1,2,3,10.0,70.0,6,1,2,3,10.0,82,5.7,65,341,2477,9.4,0.25471613
27837,27837,Trevor Lewis,2010-11,24.0,3,0,5,5,0,0,0,4.0,46.0,11,1,2,3,14.0,82,5.53,56,304,2486,9.1,0.16578221
27838,27838,Trevor Lewis,2011-12,25.0,4,13,72,72,3,10,13,105.0,827.0,83,4,12,16,119.0,82,5.46,52,291,2492,9.0,0.22007683
27839,27839,Trevor Lewis,2012-13,26.0,5,7,72,72,3,4,7,103.0,953.0,155,7,16,23,222.0,82,5.32,47,271,2439,8.9,0.18050244
27840,27840,Trevor Lewis,2013-14,27.0,6,14,48,48,5,9,14,92.0,730.0,203,12,25,37,314.0,48,5.31,29,160,1399,9.1,0.2708581
27841,27841,Trevor Lewis,2014-15,28.0,7,11,73,73,6,5,11,111.0,968.0,276,18,30,48,425.0,82,5.34,48,269,2463,8.9,0.21743989
27842,27842,Trevor Lewis,2015-16,29.0,8,25,73,73,9,16,25,143.0,1030.0,349,27,46,73,568.0,82,5.32,47,251,2453,8.9,0.29097977
27843,27843,Trevor Lewis,2016-17,30.0,9,16,75,75,8,8,16,167.0,1092.0,424,35,54,89,735.0,82,5.34,48,255,2438,9.0,0.22932366
27844,27844,Trevor Lewis,2017-18,31.0,10,24,82,82,12,12,24,145.0,1170.0,506,47,66,113,880.0,82,5.45,47,245,2478,9.0,0.28946704
27845,27845,Trevor Lewis,2018-19,32.0,11,26,68,68,14,12,26,134.0,1036.0,574,61,78,139,1014.0,82,5.86,50,250,2620,9.2,0.32227105
27846,27846,Trevor Lewis,2019-20,33.0,12,12,44,44,3,9,12,87.0,617.0,618,64,87,151,1101.0,82,5.96,47,239,2579,9.5,0.21290195
27847,27847,Trevor Lewis,2020-21,34.0,13,12,56,56,6,6,12,92.0,666.0,674,70,93,163,1193.0,70,5.96,42,208,2192,9.5,0.24928212
27848,27848,Trevor Linden,1989-90,19.0,2,59,80,80,30,29,59,186.0,,80,30,29,59,186.0,80,7.48,85,403,2430,12.3,0.81959814
27849,27849,Trevor Linden,1990-91,20.0,3,51,73,73,21,30,51,171.0,,153,51,59,110,357.0,80,7.37,76,367,2421,12.2,0.7464391
27850,27850,Trevor Linden,1991-92,21.0,4,70,80,80,33,37,70,229.0,,233,84,96,180,586.0,80,6.91,71,366,2385,11.6,0.92254597
27851,27851,Trevor Linden,1992-93,22.0,5,75,80,80,31,44,75,201.0,,313,115,140,255,787.0,80,6.96,77,402,2440,11.4,0.9876642
27852,27852,Trevor Linden,1993-94,23.0,6,72,84,84,33,39,72,209.0,,397,148,179,327,996.0,84,7.25,87,443,2603,11.7,0.817732
27853,27853,Trevor Linden,1994-95,24.0,7,61,84,84,32,29,61,234.0,,481,180,208,388,1230.0,84,6.48,76,407,2545,10.7,0.73593557
27854,27854,Trevor Linden,1995-96,25.0,8,40,48,48,18,22,40,129.0,,529,198,230,428,1359.0,48,5.97,37,209,1408,10.2,0.9347743
27855,27855,Trevor Linden,1996-97,26.0,9,80,82,82,33,47,80,202.0,,611,231,277,508,1561.0,82,6.29,74,413,2481,10.4,0.8247449
27856,27856,Trevor Linden,1997-98,27.0,10,40,49,49,9,31,40,84.0,,660,240,308,548,1645.0,82,5.83,55,336,2444,9.8,0.70673
27857,27857,Trevor Linden,1998-99,28.0,11,38,67,67,17,21,38,133.0,,727,257,329,586,1778.0,82,5.28,57,380,2242,9.6,0.556677
27858,27858,Trevor Linden,1999-00,29.0,12,47,82,82,18,29,47,167.0,1762.0,809,275,358,633,1945.0,82,5.27,57,359,2285,9.4,0.610597
27859,27859,Trevor Linden,2000-01,30.0,13,30,50,50,13,17,30,87.0,892.0,859,288,375,663,2032.0,82,5.49,53,331,2294,9.8,0.62529504
27860,27860,Trevor Linden,2001-02,31.0,14,37,69,69,15,22,37,126.0,1402.0,928,303,397,700,2158.0,82,5.51,63,376,2272,9.9,0.45124277
27861,27861,Trevor Linden,2002-03,32.0,15,37,80,80,13,24,37,141.0,1498.0,1008,316,421,737,2299.0,82,5.24,53,338,2262,9.5,0.4626467
27862,27862,Trevor Linden,2003-04,33.0,16,41,71,71,19,22,41,116.0,1126.0,1079,335,443,778,2415.0,82,5.31,60,363,2326,9.4,0.47403234
27863,27863,Trevor Linden,2004-05,34.0,17,36,82,82,14,22,36,97.0,1336.0,1161,349,465,814,2512.0,82,5.14,57,348,2300,9.2,0.41556227
27864,27864,Trevor Linden,2006-07,36.0,18,16,82,82,7,9,16,55.0,929.0,1243,356,474,830,2567.0,82,6.05,85,480,2458,10.1,0.27568868
27865,27865,Trevor Linden,2007-08,37.0,19,25,80,80,12,13,25,92.0,987.0,1323,368,487,855,2659.0,82,5.76,70,398,2426,9.7,0.29451102
27866,27866,Trevor Linden,2008-09,38.0,20,12,59,59,7,5,12,45.0,667.0,1382,375,492,867,2704.0,82,5.44,62,351,2383,9.4,0.29661584
27867,27867,Trevor Moore,2019-20,24.0,2,8,25,25,2,6,8,26.0,227.0,25,2,6,8,26.0,82,5.96,47,239,2579,9.5,0.2319797
27868,27868,Trevor Moore,2020-21,25.0,3,10,42,42,6,4,10,60.0,542.0,67,8,10,18,86.0,70,5.96,42,208,2192,9.5,0.30027947
27869,27869,Trevor Murphy,2018-19,23.0,2,3,8,8,1,2,3,5.0,114.0,8,1,2,3,5.0,82,5.86,50,250,2620,9.2,0.22966447
27870,27870,Trevor Sim,1990-91,20.0,2,1,3,3,0,1,1,0.0,,3,0,1,1,0.0,80,7.37,76,367,2421,12.2,0.29298463
27871,27871,Trevor Smith,2009-10,24.0,2,1,7,7,1,0,1,7.0,83.0,7,1,0,1,7.0,82,5.7,65,341,2477,9.4,0.21310806
27872,27872,Trevor Smith,2012-13,27.0,3,5,16,16,2,3,5,17.0,199.0,23,3,3,6,24.0,82,5.32,47,271,2439,8.9,0.20242214
27873,27873,Trevor Smith,2013-14,28.0,4,0,1,1,0,0,0,0.0,10.0,24,3,3,6,24.0,48,5.31,29,160,1399,9.1,0.15397495
27874,27874,Trevor Smith,2014-15,29.0,5,9,28,28,4,5,9,24.0,290.0,52,7,8,15,48.0,82,5.34,48,269,2463,8.9,0.20560637
27875,27875,Trevor Smith,2015-16,30.0,6,5,54,54,2,3,5,46.0,597.0,106,9,11,20,94.0,82,5.32,47,251,2453,8.9,0.146157
27876,27876,Trevor Smith,2017-18,32.0,7,0,1,1,0,0,0,0.0,7.0,107,9,11,20,94.0,82,5.45,47,245,2478,9.0,0.14643347
27877,27877,Trevor Stienburg,1986-87,20.0,2,1,2,2,1,0,1,6.0,,2,1,0,1,6.0,80,7.94,82,370,2484,12.8,0.30757067
27878,27878,Trevor Stienburg,1987-88,21.0,3,1,6,6,1,0,1,6.0,,8,2,0,2,12.0,80,7.34,72,344,2400,12.2,0.26505536
27879,27879,Trevor Stienburg,1988-89,22.0,4,1,8,8,0,1,1,3.0,,16,2,1,3,15.0,80,7.43,89,437,2435,12.2,0.23672193
27880,27880,Trevor Stienburg,1989-90,23.0,5,9,55,55,6,3,9,65.0,,71,8,4,12,80.0,80,7.48,85,403,2430,12.3,0.2617175
27881,27881,Trevor van Riemsdyk,2015-16,24.0,2,1,18,18,0,1,1,21.0,244.0,18,0,1,1,21.0,82,5.32,47,251,2453,8.9,0.18972895
27882,27882,Trevor van Riemsdyk,2016-17,25.0,3,14,82,82,3,11,14,85.0,1639.0,100,3,12,15,106.0,82,5.34,48,255,2438,9.0,0.21105337
27883,27883,Trevor van Riemsdyk,2017-18,26.0,4,16,58,58,5,11,16,73.0,1068.0,158,8,23,31,179.0,82,5.45,47,245,2478,9.0,0.26030824
27884,27884,Trevor van Riemsdyk,2018-19,27.0,5,16,79,79,3,13,16,111.0,1347.0,237,11,36,47,290.0,82,5.86,50,250,2620,9.2,0.21089825
27885,27885,Trevor van Riemsdyk,2019-20,28.0,6,14,78,78,3,11,14,102.0,1175.0,315,14,47,61,392.0,82,5.96,47,239,2579,9.5,0.19642648
27886,27886,Trevor van Riemsdyk,2020-21,29.0,7,8,49,49,1,7,8,58.0,728.0,364,15,54,69,450.0,70,5.96,42,208,2192,9.5,0.18619183
27887,27887,Triston Grant,2007-08,23.0,2,1,8,8,0,1,1,3.0,36.0,8,0,1,1,3.0,82,5.76,70,398,2426,9.7,0.19367829
27888,27888,Triston Grant,2010-11,26.0,3,0,3,3,0,0,0,2.0,22.0,11,0,1,1,5.0,82,5.53,56,304,2486,9.1,0.1621441
27889,27889,Troy Bodie,2009-10,25.0,2,0,4,4,0,0,0,5.0,33.0,4,0,0,0,5.0,82,5.7,65,341,2477,9.4,0.17101252
27890,27890,Troy Bodie,2010-11,26.0,3,7,44,44,5,2,7,58.0,495.0,48,5,2,7,63.0,82,5.53,56,304,2486,9.1,0.18760806
27891,27891,Troy Bodie,2011-12,27.0,4,4,59,59,1,3,4,44.0,403.0,107,6,5,11,107.0,82,5.46,52,291,2492,9.0,0.13976997
27892,27892,Troy Bodie,2014-15,30.0,5,10,47,47,3,7,10,50.0,405.0,154,9,12,21,157.0,82,5.34,48,269,2463,8.9,0.16447487
27893,27893,Troy Bodie,2015-16,31.0,6,0,5,5,0,0,0,1.0,23.0,159,9,12,21,158.0,82,5.32,47,251,2453,8.9,0.10707015
27894,27894,Troy Brouwer,2007-08,22.0,2,0,10,10,0,0,0,7.0,99.0,10,0,0,0,7.0,82,5.76,70,398,2426,9.7,0.17240891
27895,27895,Troy Brouwer,2008-09,23.0,3,1,2,2,0,1,1,0.0,24.0,12,0,1,1,7.0,82,5.44,62,351,2383,9.4,0.18450224
27896,27896,Troy Brouwer,2009-10,24.0,4,26,69,69,10,16,26,126.0,1041.0,81,10,17,27,133.0,82,5.7,65,341,2477,9.4,0.36812675
27897,27897,Troy Brouwer,2010-11,25.0,5,40,78,78,22,18,40,116.0,1277.0,159,32,35,67,249.0,82,5.53,56,304,2486,9.1,0.44283807
27898,27898,Troy Brouwer,2011-12,26.0,6,36,79,79,17,19,36,122.0,1193.0,238,49,54,103,371.0,82,5.46,52,291,2492,9.0,0.4270188
27899,27899,Troy Brouwer,2012-13,27.0,7,33,82,82,18,15,33,133.0,1408.0,320,67,69,136,504.0,82,5.32,47,271,2439,8.9,0.43343234
27900,27900,Troy Brouwer,2013-14,28.0,8,33,47,47,19,14,33,111.0,871.0,367,86,83,169,615.0,48,5.31,29,160,1399,9.1,0.57353956
27901,27901,Troy Brouwer,2014-15,29.0,9,43,82,82,25,18,43,161.0,1546.0,449,111,101,212,776.0,82,5.34,48,269,2463,8.9,0.50064325
27902,27902,Troy Brouwer,2015-16,30.0,10,43,82,82,21,22,43,145.0,1437.0,531,132,123,255,921.0,82,5.32,47,251,2453,8.9,0.4735158
27903,27903,Troy Brouwer,2016-17,31.0,11,39,82,82,18,21,39,142.0,1394.0,613,150,144,294,1063.0,82,5.34,48,255,2438,9.0,0.42493406
27904,27904,Troy Brouwer,2017-18,32.0,12,25,74,74,13,12,25,86.0,1200.0,687,163,156,319,1149.0,82,5.45,47,245,2478,9.0,0.29651135
27905,27905,Troy Brouwer,2018-19,33.0,13,22,76,76,6,16,22,79.0,1059.0,763,169,172,341,1228.0,82,5.86,50,250,2620,9.2,0.24821383
27906,27906,Troy Brouwer,2019-20,34.0,14,21,75,75,12,9,21,86.0,952.0,838,181,181,362,1314.0,82,5.96,47,239,2579,9.5,0.23514599
27907,27907,Troy Brouwer,2020-21,35.0,15,1,13,13,1,0,1,12.0,123.0,851,182,181,363,1326.0,70,5.96,42,208,2192,9.5,0.25439325
27908,27908,Troy Crowder,1990-91,22.0,2,0,10,10,0,0,0,4.0,,10,0,0,0,4.0,80,7.37,76,367,2421,12.2,0.21206692
27909,27909,Troy Crowder,1991-92,23.0,3,9,59,59,6,3,9,46.0,,69,6,3,9,50.0,80,6.91,71,366,2385,11.6,0.20397964
27910,27910,Troy Crowder,1992-93,24.0,4,0,7,7,0,0,0,2.0,,76,6,3,9,52.0,80,6.96,77,402,2440,11.4,0.18829045
27911,27911,Troy Crowder,1995-96,27.0,5,3,29,29,1,2,3,4.0,,105,7,5,12,56.0,48,5.97,37,209,1408,10.2,0.12674391
27912,27912,Troy Crowder,1996-97,28.0,6,1,15,15,1,0,1,11.0,,120,8,5,13,67.0,82,6.29,74,413,2481,10.4,0.16125575
27913,27913,Troy Crowder,1997-98,29.0,7,3,30,30,1,2,3,11.0,,150,9,7,16,78.0,82,5.83,55,336,2444,9.8,0.10654789
27914,27914,Troy Loney,1984-85,21.0,2,0,13,13,0,0,0,5.0,,13,0,0,0,5.0,80,7.89,74,336,2448,12.9,0.20658615
27915,27915,Troy Loney,1985-86,22.0,3,18,46,46,10,8,18,79.0,,59,10,8,18,84.0,80,7.77,71,321,2447,12.7,0.43232566
27916,27916,Troy Loney,1986-87,23.0,4,12,47,47,3,9,12,50.0,,106,13,17,30,134.0,80,7.94,82,370,2484,12.8,0.31211847
27917,27917,Troy Loney,1987-88,24.0,5,15,23,23,8,7,15,48.0,,129,21,24,45,182.0,80,7.34,72,344,2400,12.2,0.51274896
27918,27918,Troy Loney,1988-89,25.0,6,18,65,65,5,13,18,87.0,,194,26,37,63,269.0,80,7.43,89,437,2435,12.2,0.29471844
27919,27919,Troy Loney,1989-90,26.0,7,16,69,69,10,6,16,90.0,,263,36,43,79,359.0,80,7.48,85,403,2430,12.3,0.28984097
27920,27920,Troy Loney,1990-91,27.0,8,27,67,67,11,16,27,78.0,,330,47,59,106,437.0,80,7.37,76,367,2421,12.2,0.30404502
27921,27921,Troy Loney,1991-92,28.0,9,16,44,44,7,9,16,51.0,,374,54,68,122,488.0,80,6.91,71,366,2385,11.6,0.32218307
27922,27922,Troy Loney,1992-93,29.0,10,26,76,76,10,16,26,94.0,,450,64,84,148,582.0,80,6.96,77,402,2440,11.4,0.29405665
27923,27923,Troy Loney,1993-94,30.0,11,21,82,82,5,16,21,83.0,,532,69,100,169,665.0,84,7.25,87,443,2603,11.7,0.24314374
27924,27924,Troy Loney,1994-95,31.0,12,19,62,62,13,6,19,93.0,,594,82,106,188,758.0,84,6.48,76,407,2545,10.7,0.28053385
27925,27925,Troy Loney,1995-96,32.0,13,9,30,30,5,4,9,47.0,,624,87,110,197,805.0,48,5.97,37,209,1408,10.2,0.2986518
27926,27926,Troy Mallette,1990-91,20.0,2,29,79,79,13,16,29,107.0,,79,13,16,29,107.0,80,7.37,76,367,2421,12.2,0.45526204
27927,27927,Troy Mallette,1991-92,21.0,3,22,71,71,12,10,22,91.0,,150,25,26,51,198.0,80,6.91,71,366,2385,11.6,0.40944844
27928,27928,Troy Mallette,1992-93,22.0,4,11,32,32,4,7,11,28.0,,182,29,33,62,226.0,80,6.96,77,402,2440,11.4,0.39811254
27929,27929,Troy Mallette,1993-94,23.0,5,7,34,34,4,3,7,19.0,,216,33,36,69,245.0,84,7.25,87,443,2603,11.7,0.3189707
27930,27930,Troy Mallette,1994-95,24.0,6,23,82,82,7,16,23,100.0,,298,40,52,92,345.0,84,6.48,76,407,2545,10.7,0.32279265
27931,27931,Troy Mallette,1995-96,25.0,7,8,23,23,3,5,8,21.0,,321,43,57,100,366.0,48,5.97,37,209,1408,10.2,0.32366017
27932,27932,Troy Mallette,1996-97,26.0,8,5,64,64,2,3,5,51.0,,385,45,60,105,417.0,82,6.29,74,413,2481,10.4,0.17809707
27933,27933,Troy Mallette,1997-98,27.0,9,14,68,68,6,8,14,61.0,,453,51,68,119,478.0,82,5.83,55,336,2444,9.8,0.21634793
27934,27934,Troy Mallette,1998-99,28.0,10,0,3,3,0,0,0,0.0,,456,51,68,119,478.0,82,5.28,57,380,2242,9.6,0.2437275
27935,27935,Troy Murray,1982-83,20.0,2,0,1,1,0,0,0,2.0,,1,0,0,0,2.0,80,8.03,73,320,2489,12.9,0.28967196
27936,27936,Troy Murray,1983-84,21.0,3,16,54,54,8,8,16,53.0,,55,8,8,16,55.0,80,7.73,71,310,2444,12.7,0.3705414
27937,27937,Troy Murray,1984-85,22.0,4,30,61,61,15,15,30,118.0,,116,23,23,46,173.0,80,7.89,74,336,2448,12.9,0.5017999
27938,27938,Troy Murray,1985-86,23.0,5,66,80,80,26,40,66,159.0,,196,49,63,112,332.0,80,7.77,71,321,2447,12.7,0.81081843
27939,27939,Troy Murray,1986-87,24.0,6,99,80,80,45,54,99,196.0,,276,94,117,211,528.0,80,7.94,82,370,2484,12.8,1.0602696
27940,27940,Troy Murray,1987-88,25.0,7,71,77,77,28,43,71,128.0,,353,122,160,282,656.0,80,7.34,72,344,2400,12.2,0.839962
27941,27941,Troy Murray,1988-89,26.0,8,58,79,79,22,36,58,148.0,,432,144,196,340,804.0,80,7.43,89,437,2435,12.2,0.72403455
27942,27942,Troy Murray,1989-90,27.0,9,51,79,79,21,30,51,156.0,,511,165,226,391,960.0,80,7.48,85,403,2430,12.3,0.6556667
27943,27943,Troy Murray,1990-91,28.0,10,55,68,68,17,38,55,111.0,,579,182,264,446,1071.0,80,7.37,76,367,2421,12.2,0.6415235
27944,27944,Troy Murray,1991-92,29.0,11,37,75,75,14,23,37,130.0,,654,196,287,483,1201.0,80,6.91,71,366,2385,11.6,0.47637352
27945,27945,Troy Murray,1992-93,30.0,12,47,74,74,17,30,47,156.0,,728,213,317,530,1357.0,80,6.96,77,402,2440,11.4,0.5772474
27946,27946,Troy Murray,1993-94,31.0,13,11,51,51,4,7,11,77.0,,779,217,324,541,1434.0,84,7.25,87,443,2603,11.7,0.31851852
27947,27947,Troy Murray,1994-95,32.0,14,6,27,27,2,4,6,21.0,,806,219,328,547,1455.0,84,6.48,76,407,2545,10.7,0.3747017
27948,27948,Troy Murray,1995-96,33.0,15,16,46,46,4,12,16,45.0,,852,223,340,563,1500.0,48,5.97,37,209,1408,10.2,0.31634933
27949,27949,Troy Murray,1996-97,34.0,16,21,63,63,7,14,21,36.0,,915,230,354,584,1536.0,82,6.29,74,413,2481,10.4,0.26090926
27950,27950,Troy Stecher,2017-18,23.0,2,24,71,71,3,21,24,125.0,1419.0,71,3,21,24,125.0,82,5.45,47,245,2478,9.0,0.32929665
27951,27951,Troy Stecher,2018-19,24.0,3,11,68,68,1,10,11,94.0,1279.0,139,4,31,35,219.0,82,5.86,50,250,2620,9.2,0.21906304
27952,27952,Troy Stecher,2019-20,25.0,4,23,78,78,2,21,23,105.0,1554.0,217,6,52,58,324.0,82,5.96,47,239,2579,9.5,0.2742143
27953,27953,Troy Stecher,2020-21,26.0,5,17,69,69,5,12,17,86.0,1059.0,286,11,64,75,410.0,70,5.96,42,208,2192,9.5,0.27651072
27954,27954,Troy Terry,2018-19,21.0,2,0,2,2,0,0,0,3.0,20.0,2,0,0,0,3.0,82,5.86,50,250,2620,9.2,0.21491829
27955,27955,Troy Terry,2019-20,22.0,3,13,32,32,4,9,13,25.0,446.0,34,4,9,13,28.0,82,5.96,47,239,2579,9.5,0.30929065
27956,27956,Troy Terry,2020-21,23.0,4,15,47,47,4,11,15,73.0,682.0,81,8,20,28,101.0,70,5.96,42,208,2192,9.5,0.34612858
27957,27957,Tucker Poolman,2018-19,25.0,2,2,24,24,1,1,2,27.0,302.0,24,1,1,2,27.0,82,5.86,50,250,2620,9.2,0.18049261
27958,27958,Tucker Poolman,2020-21,27.0,3,16,57,57,4,12,16,64.0,995.0,81,5,13,18,91.0,70,5.96,42,208,2192,9.5,0.27529
27959,27959,Tuomas Gronman,1997-98,23.0,2,1,16,16,0,1,1,9.0,,16,0,1,1,9.0,82,5.83,55,336,2444,9.8,0.17229563
27960,27960,Tuomas Gronman,1998-99,24.0,3,3,22,22,1,2,3,33.0,,38,1,3,4,42.0,82,5.28,57,380,2242,9.6,0.19377738
27961,27961,Tuomas Pihlman,2004-05,22.0,2,0,2,2,0,0,0,1.0,14.0,2,0,0,0,1.0,82,5.14,57,348,2300,9.2,0.22404626
27962,27962,Tuomas Pihlman,2006-07,24.0,3,2,11,11,1,1,2,14.0,111.0,13,1,1,2,15.0,82,6.05,85,480,2458,10.1,0.20795268
27963,27963,Tuomas Pihlman,2007-08,25.0,4,0,2,2,0,0,0,0.0,13.0,15,1,1,2,15.0,82,5.76,70,398,2426,9.7,0.15188628
27964,27964,Tuomo Ruutu,2004-05,21.0,2,44,82,82,23,21,44,174.0,1345.0,82,23,21,44,174.0,82,5.14,57,348,2300,9.2,0.6442471
27965,27965,Tuomo Ruutu,2006-07,23.0,3,5,15,15,2,3,5,30.0,221.0,97,25,24,49,204.0,82,6.05,85,480,2458,10.1,0.35513714
27966,27966,Tuomo Ruutu,2007-08,24.0,4,38,71,71,17,21,38,115.0,1232.0,168,42,45,87,319.0,82,5.76,70,398,2426,9.7,0.5012176
27967,27967,Tuomo Ruutu,2008-09,25.0,5,32,77,77,10,22,32,100.0,1224.0,245,52,67,119,419.0,82,5.44,62,351,2383,9.4,0.4426541
27968,27968,Tuomo Ruutu,2009-10,26.0,6,54,79,79,26,28,54,190.0,1447.0,324,78,95,173,609.0,82,5.7,65,341,2477,9.4,0.6555572
27969,27969,Tuomo Ruutu,2010-11,27.0,7,35,54,54,14,21,35,122.0,885.0,378,92,116,208,731.0,82,5.53,56,304,2486,9.1,0.6082272
27970,27970,Tuomo Ruutu,2011-12,28.0,8,57,82,82,19,38,57,148.0,1380.0,460,111,154,265,879.0,82,5.46,52,291,2492,9.0,0.6288
27971,27971,Tuomo Ruutu,2012-13,29.0,9,34,72,72,18,16,34,156.0,1185.0,532,129,170,299,1035.0,82,5.32,47,271,2439,8.9,0.48432532
27972,27972,Tuomo Ruutu,2013-14,30.0,10,9,17,17,4,5,9,30.0,259.0,549,133,175,308,1065.0,48,5.31,29,160,1399,9.1,0.40198576
27973,27973,Tuomo Ruutu,2014-15,31.0,11,24,76,76,8,16,24,105.0,1107.0,625,141,191,332,1170.0,82,5.34,48,269,2463,8.9,0.28886542
27974,27974,Tuomo Ruutu,2015-16,32.0,12,13,77,77,7,6,13,74.0,837.0,702,148,197,345,1244.0,82,5.32,47,251,2453,8.9,0.21137881
27975,27975,Tuomo Ruutu,2016-17,33.0,13,1,33,33,0,1,1,34.0,380.0,735,148,198,346,1278.0,82,5.34,48,255,2438,9.0,0.18668088
27976,27976,Turner Elson,2016-17,24.0,2,1,1,1,0,1,1,0.0,15.0,1,0,1,1,0.0,82,5.34,48,255,2438,9.0,0.1739333
27977,27977,Turner Stevenson,1993-94,21.0,2,0,1,1,0,0,0,1.0,,1,0,0,0,1.0,84,7.25,87,443,2603,11.7,0.22834101
27978,27978,Turner Stevenson,1994-95,22.0,3,0,2,2,0,0,0,0.0,,3,0,0,0,1.0,84,6.48,76,407,2545,10.7,0.16532451
27979,27979,Turner Stevenson,1995-96,23.0,4,7,41,41,6,1,7,35.0,,44,6,1,7,36.0,48,5.97,37,209,1408,10.2,0.2601998
27980,27980,Turner Stevenson,1996-97,24.0,5,25,80,80,9,16,25,101.0,,124,15,17,32,137.0,82,6.29,74,413,2481,10.4,0.30737484
27981,27981,Turner Stevenson,1997-98,25.0,6,21,65,65,8,13,21,76.0,,189,23,30,53,213.0,82,5.83,55,336,2444,9.8,0.2685722
27982,27982,Turner Stevenson,1998-99,26.0,7,10,63,63,4,6,10,43.0,,252,27,36,63,256.0,82,5.28,57,380,2242,9.6,0.18150747
27983,27983,Turner Stevenson,1999-00,27.0,8,27,69,69,10,17,27,102.0,894.0,321,37,53,90,358.0,82,5.27,57,359,2285,9.4,0.31492513
27984,27984,Turner Stevenson,2000-01,28.0,9,21,64,64,8,13,21,94.0,843.0,385,45,66,111,452.0,82,5.49,53,331,2294,9.8,0.2822057
27985,27985,Turner Stevenson,2001-02,29.0,10,26,69,69,8,18,26,92.0,759.0,454,53,84,137,544.0,82,5.51,63,376,2272,9.9,0.31266916
27986,27986,Turner Stevenson,2002-03,30.0,11,2,21,21,0,2,2,33.0,244.0,475,53,86,139,577.0,82,5.24,53,338,2262,9.5,0.196278
27987,27987,Turner Stevenson,2003-04,31.0,12,20,77,77,7,13,20,85.0,915.0,552,60,99,159,662.0,82,5.31,60,363,2326,9.4,0.25327927
27988,27988,Turner Stevenson,2004-05,32.0,13,27,61,61,14,13,27,76.0,775.0,613,74,112,186,738.0,82,5.14,57,348,2300,9.2,0.33699936
27989,27989,Turner Stevenson,2006-07,34.0,14,4,31,31,1,3,4,26.0,258.0,644,75,115,190,764.0,82,6.05,85,480,2458,10.1,0.18272552
27990,27990,Ty Jones,1999-00,20.0,2,0,8,8,0,0,0,3.0,63.0,8,0,0,0,3.0,82,5.27,57,359,2285,9.4,0.21113789
27991,27991,Ty Jones,2004-05,25.0,3,0,6,6,0,0,0,1.0,19.0,14,0,0,0,4.0,82,5.14,57,348,2300,9.2,0.15235162
27992,27992,Ty Rattie,2014-15,21.0,2,0,2,2,0,0,0,4.0,22.0,2,0,0,0,4.0,82,5.34,48,269,2463,8.9,0.2130292
27993,27993,Ty Rattie,2015-16,22.0,3,2,11,11,0,2,2,8.0,100.0,13,0,2,2,12.0,82,5.32,47,251,2453,8.9,0.17734897
27994,27994,Ty Rattie,2016-17,23.0,4,6,13,13,4,2,6,16.0,121.0,26,4,4,8,28.0,82,5.34,48,255,2438,9.0,0.2871514
27995,27995,Ty Rattie,2017-18,24.0,5,2,9,9,0,2,2,10.0,97.0,35,4,6,10,38.0,82,5.45,47,245,2478,9.0,0.20579019
27996,27996,Ty Rattie,2018-19,25.0,6,9,14,14,5,4,9,32.0,217.0,49,9,10,19,70.0,82,5.86,50,250,2620,9.2,0.28497854
27997,27997,Ty Rattie,2019-20,26.0,7,11,50,50,4,7,11,84.0,567.0,99,13,17,30,154.0,82,5.96,47,239,2579,9.5,0.24439016
27998,27998,Ty Wishart,2009-10,21.0,2,1,5,5,0,1,1,2.0,51.0,5,0,1,1,2.0,82,5.7,65,341,2477,9.4,0.23108745
27999,27999,Ty Wishart,2011-12,23.0,3,5,20,20,1,4,5,23.0,336.0,25,1,5,6,25.0,82,5.46,52,291,2492,9.0,0.23027754
28000,28000,Ty Wishart,2012-13,24.0,4,0,1,1,0,0,0,0.0,17.0,26,1,5,6,25.0,82,5.32,47,271,2439,8.9,0.14549267
28001,28001,Tye McGinn,2013-14,23.0,2,5,18,18,3,2,5,33.0,229.0,18,3,2,5,33.0,48,5.31,29,160,1399,9.1,0.3181869
28002,28002,Tye McGinn,2014-15,24.0,3,5,18,18,4,1,5,16.0,201.0,36,7,3,10,49.0,82,5.34,48,269,2463,8.9,0.23460475
28003,28003,Tye McGinn,2015-16,25.0,4,7,51,51,2,5,7,60.0,515.0,87,9,8,17,109.0,82,5.32,47,251,2453,8.9,0.18799087
28004,28004,Tye McGinn,2016-17,26.0,5,0,2,2,0,0,0,1.0,17.0,89,9,8,17,110.0,82,5.34,48,255,2438,9.0,0.16001591
28005,28005,Tyler Arnason,2002-03,23.0,2,4,21,21,3,1,4,19.0,199.0,21,3,1,4,19.0,82,5.24,53,338,2262,9.5,0.22946158
28006,28006,Tyler Arnason,2003-04,24.0,3,39,82,82,19,20,39,178.0,1190.0,103,22,21,43,197.0,82,5.31,60,363,2326,9.4,0.5301864
28007,28007,Tyler Arnason,2004-05,25.0,4,55,82,82,22,33,55,222.0,1358.0,185,44,54,98,419.0,82,5.14,57,348,2300,9.2,0.7287669
28008,28008,Tyler Arnason,2006-07,27.0,5,45,79,79,13,32,45,203.0,1132.0,264,57,86,143,622.0,82,6.05,85,480,2458,10.1,0.56744677
28009,28009,Tyler Arnason,2007-08,28.0,6,49,82,82,16,33,49,211.0,1176.0,346,73,119,192,833.0,82,5.76,70,398,2426,9.7,0.57888734
28010,28010,Tyler Arnason,2008-09,29.0,7,31,70,70,10,21,31,179.0,1068.0,416,83,140,223,1012.0,82,5.44,62,351,2383,9.4,0.51759815
28011,28011,Tyler Arnason,2009-10,30.0,8,22,71,71,5,17,22,108.0,945.0,487,88,157,245,1120.0,82,5.7,65,341,2477,9.4,0.32880202
28012,28012,Tyler Benson,2020-21,22.0,2,1,7,7,0,1,1,5.0,73.0,7,0,1,1,5.0,70,5.96,42,208,2192,9.5,0.22101897
28013,28013,Tyler Bertuzzi,2017-18,22.0,2,0,7,7,0,0,0,3.0,64.0,7,0,0,0,3.0,82,5.45,47,245,2478,9.0,0.18290794
28014,28014,Tyler Bertuzzi,2018-19,23.0,3,24,48,48,7,17,24,83.0,691.0,55,7,17,24,86.0,82,5.86,50,250,2620,9.2,0.44055712
28015,28015,Tyler Bertuzzi,2019-20,24.0,4,47,73,73,21,26,47,131.0,1206.0,128,28,43,71,217.0,82,5.96,47,239,2579,9.5,0.5845729
28016,28016,Tyler Bertuzzi,2020-21,25.0,5,48,71,71,21,27,48,129.0,1371.0,199,49,70,119,346.0,70,5.96,42,208,2192,9.5,0.64607996
28017,28017,Tyler Bouck,2001-02,22.0,2,7,48,48,2,5,7,41.0,431.0,48,2,5,7,41.0,82,5.51,63,376,2272,9.9,0.1913372
28018,28018,Tyler Bouck,2002-03,23.0,3,0,7,7,0,0,0,3.0,48.0,55,2,5,7,44.0,82,5.24,53,338,2262,9.5,0.16563284
28019,28019,Tyler Bouck,2004-05,25.0,4,3,18,18,1,2,3,12.0,167.0,73,3,7,10,56.0,82,5.14,57,348,2300,9.2,0.20702201
28020,28020,Tyler Bouck,2006-07,27.0,5,2,12,12,1,1,2,6.0,76.0,85,4,8,12,62.0,82,6.05,85,480,2458,10.1,0.15453151
28021,28021,Tyler Bouck,2007-08,28.0,6,0,6,6,0,0,0,7.0,48.0,91,4,8,12,69.0,82,5.76,70,398,2426,9.7,0.13637948
28022,28022,Tyler Bozak,2010-11,24.0,2,27,37,37,8,19,27,51.0,712.0,37,8,19,27,51.0,82,5.53,56,304,2486,9.1,0.46398133
28023,28023,Tyler Bozak,2011-12,25.0,3,32,82,82,15,17,32,120.0,1581.0,119,23,36,59,171.0,82,5.46,52,291,2492,9.0,0.41571307
28024,28024,Tyler Bozak,2012-13,26.0,4,47,73,73,18,29,47,109.0,1375.0,192,41,65,106,280.0,82,5.32,47,271,2439,8.9,0.5781038
28025,28025,Tyler Bozak,2013-14,27.0,5,28,46,46,12,16,28,61.0,934.0,238,53,81,134,341.0,48,5.31,29,160,1399,9.1,0.57565147
28026,28026,Tyler Bozak,2014-15,28.0,6,49,58,58,19,30,49,90.0,1215.0,296,72,111,183,431.0,82,5.34,48,269,2463,8.9,0.62457764
28027,28027,Tyler Bozak,2015-16,29.0,7,49,82,82,23,26,49,154.0,1570.0,378,95,137,232,585.0,82,5.32,47,251,2453,8.9,0.5538515
28028,28028,Tyler Bozak,2016-17,30.0,8,35,57,57,12,23,35,99.0,988.0,435,107,160,267,684.0,82,5.34,48,255,2438,9.0,0.47452423
28029,28029,Tyler Bozak,2017-18,31.0,9,55,78,78,18,37,55,145.0,1282.0,513,125,197,322,829.0,82,5.45,47,245,2478,9.0,0.6462134
28030,28030,Tyler Bozak,2018-19,32.0,10,43,81,81,11,32,43,154.0,1267.0,594,136,229,365,983.0,82,5.86,50,250,2620,9.2,0.4933848
28031,28031,Tyler Bozak,2019-20,33.0,11,38,72,72,13,25,38,141.0,1177.0,666,149,254,403,1124.0,82,5.96,47,239,2579,9.5,0.46360806
28032,28032,Tyler Bozak,2020-21,34.0,12,29,67,67,13,16,29,109.0,1026.0,733,162,270,432,1233.0,70,5.96,42,208,2192,9.5,0.37937108
28033,28033,Tyler Cuma,2012-13,23.0,2,0,1,1,0,0,0,0.0,11.0,1,0,0,0,0.0,82,5.32,47,271,2439,8.9,0.14553902
28034,28034,Tyler Eckford,2010-11,25.0,2,1,3,3,0,1,1,1.0,22.0,3,0,1,1,1.0,82,5.53,56,304,2486,9.1,0.18360561
28035,28035,Tyler Eckford,2011-12,26.0,3,0,4,4,0,0,0,1.0,35.0,7,0,1,1,2.0,82,5.46,52,291,2492,9.0,0.14934719
28036,28036,Tyler Ennis,2010-11,21.0,2,9,10,10,3,6,9,23.0,153.0,10,3,6,9,23.0,82,5.53,56,304,2486,9.1,0.3689168
28037,28037,Tyler Ennis,2011-12,22.0,3,49,82,82,20,29,49,210.0,1285.0,92,23,35,58,233.0,82,5.46,52,291,2492,9.0,0.6375102
28038,28038,Tyler Ennis,2012-13,23.0,4,34,48,48,15,19,34,82.0,776.0,140,38,54,92,315.0,82,5.32,47,271,2439,8.9,0.59725916
28039,28039,Tyler Ennis,2013-14,24.0,5,31,47,47,10,21,31,108.0,840.0,187,48,75,123,423.0,48,5.31,29,160,1399,9.1,0.5949829
28040,28040,Tyler Ennis,2014-15,25.0,6,43,80,80,21,22,43,210.0,1508.0,267,69,97,166,633.0,82,5.34,48,269,2463,8.9,0.58366793
28041,28041,Tyler Ennis,2015-16,26.0,7,46,78,78,20,26,46,185.0,1491.0,345,89,123,212,818.0,82,5.32,47,251,2453,8.9,0.5871166
28042,28042,Tyler Ennis,2016-17,27.0,8,11,23,23,3,8,11,57.0,416.0,368,92,131,223,875.0,82,5.34,48,255,2438,9.0,0.417213
28043,28043,Tyler Ennis,2017-18,28.0,9,13,51,51,5,8,13,89.0,655.0,419,97,139,236,964.0,82,5.45,47,245,2478,9.0,0.3654716
28044,28044,Tyler Ennis,2018-19,29.0,10,22,73,73,8,14,22,115.0,874.0,492,105,153,258,1079.0,82,5.86,50,250,2620,9.2,0.31574893
28045,28045,Tyler Ennis,2019-20,30.0,11,18,51,51,12,6,18,81.0,507.0,543,117,159,276,1160.0,82,5.96,47,239,2579,9.5,0.40297246
28046,28046,Tyler Ennis,2020-21,31.0,12,37,70,70,16,21,37,159.0,1030.0,613,133,180,313,1319.0,70,5.96,42,208,2192,9.5,0.49391913
28047,28047,Tyler Gaudet,2015-16,22.0,2,0,2,2,0,0,0,1.0,19.0,2,0,0,0,1.0,82,5.32,47,251,2453,8.9,0.16728714
28048,28048,Tyler Gaudet,2016-17,23.0,3,3,14,14,1,2,3,6.0,148.0,16,1,2,3,7.0,82,5.34,48,255,2438,9.0,0.2071056
28049,28049,Tyler Gaudet,2017-18,24.0,4,1,4,4,0,1,1,3.0,52.0,20,1,3,4,10.0,82,5.45,47,245,2478,9.0,0.17426777
28050,28050,Tyler Graovac,2015-16,22.0,2,0,3,3,0,0,0,4.0,28.0,3,0,0,0,4.0,82,5.32,47,251,2453,8.9,0.18369669
28051,28051,Tyler Graovac,2016-17,23.0,3,0,2,2,0,0,0,2.0,23.0,5,0,0,0,6.0,82,5.34,48,255,2438,9.0,0.17104125
28052,28052,Tyler Graovac,2017-18,24.0,4,9,52,52,7,2,9,48.0,512.0,57,7,2,9,54.0,82,5.45,47,245,2478,9.0,0.21852738
28053,28053,Tyler Graovac,2018-19,25.0,5,0,5,5,0,0,0,1.0,34.0,62,7,2,9,55.0,82,5.86,50,250,2620,9.2,0.12738124
28054,28054,Tyler Graovac,2020-21,27.0,6,2,8,8,2,0,2,5.0,50.0,70,9,2,11,60.0,70,5.96,42,208,2192,9.5,0.2086707
28055,28055,Tyler Johnson,2013-14,23.0,2,6,14,14,3,3,6,11.0,183.0,14,3,3,6,11.0,48,5.31,29,160,1399,9.1,0.30488545
28056,28056,Tyler Johnson,2014-15,24.0,3,50,82,82,24,26,50,181.0,1540.0,96,27,29,56,192.0,82,5.34,48,269,2463,8.9,0.61125815
28057,28057,Tyler Johnson,2015-16,25.0,4,72,77,77,29,43,72,203.0,1327.0,173,56,72,128,395.0,82,5.32,47,251,2453,8.9,0.8391584
28058,28058,Tyler Johnson,2016-17,26.0,5,38,69,69,14,24,38,167.0,1183.0,242,70,96,166,562.0,82,5.34,48,255,2438,9.0,0.59396505
28059,28059,Tyler Johnson,2017-18,27.0,6,45,66,66,19,26,45,130.0,1242.0,308,89,122,211,692.0,82,5.45,47,245,2478,9.0,0.62378955
28060,28060,Tyler Johnson,2018-19,28.0,7,50,81,81,21,29,50,186.0,1376.0,389,110,151,261,878.0,82,5.86,50,250,2620,9.2,0.58840114
28061,28061,Tyler Johnson,2019-20,29.0,8,47,80,80,29,18,47,163.0,1276.0,469,139,169,308,1041.0,82,5.96,47,239,2579,9.5,0.5912877
28062,28062,Tyler Johnson,2020-21,30.0,9,31,65,65,14,17,31,113.0,945.0,534,153,186,339,1154.0,70,5.96,42,208,2192,9.5,0.4392409
28063,28063,Tyler Kennedy,2008-09,22.0,2,19,55,55,10,9,19,104.0,672.0,55,10,9,19,104.0,82,5.44,62,351,2383,9.4,0.41125724
28064,28064,Tyler Kennedy,2009-10,23.0,3,35,67,67,15,20,35,171.0,923.0,122,25,29,54,275.0,82,5.7,65,341,2477,9.4,0.5135523
28065,28065,Tyler Kennedy,2010-11,24.0,4,25,64,64,13,12,25,175.0,805.0,186,38,41,79,450.0,82,5.53,56,304,2486,9.1,0.48650956
28066,28066,Tyler Kennedy,2011-12,25.0,5,45,80,80,21,24,45,234.0,1162.0,266,59,65,124,684.0,82,5.46,52,291,2492,9.0,0.5910929
28067,28067,Tyler Kennedy,2012-13,26.0,6,33,60,60,11,22,33,195.0,862.0,326,70,87,157,879.0,82,5.32,47,271,2439,8.9,0.54056996
28068,28068,Tyler Kennedy,2013-14,27.0,7,11,46,46,6,5,11,100.0,573.0,372,76,92,168,979.0,48,5.31,29,160,1399,9.1,0.37617764
28069,28069,Tyler Kennedy,2014-15,28.0,8,17,67,67,4,13,17,143.0,852.0,439,80,105,185,1122.0,82,5.34,48,269,2463,8.9,0.31315404
28070,28070,Tyler Kennedy,2015-16,29.0,9,14,38,38,6,8,14,79.0,424.0,477,86,113,199,1201.0,82,5.32,47,251,2453,8.9,0.369486
28071,28071,Tyler Kennedy,2016-17,30.0,10,16,50,50,3,13,16,72.0,671.0,527,89,126,215,1273.0,82,5.34,48,255,2438,9.0,0.34050268
28072,28072,Tyler Larter,1990-91,22.0,2,0,1,1,0,0,0,2.0,,1,0,0,0,2.0,80,7.37,76,367,2421,12.2,0.22625339
28073,28073,Tyler Lewington,2019-20,25.0,2,2,2,2,1,1,2,3.0,28.0,2,1,1,2,3.0,82,5.96,47,239,2579,9.5,0.2070094
28074,28074,Tyler Lewington,2020-21,26.0,3,0,6,6,0,0,0,2.0,61.0,8,1,1,2,5.0,70,5.96,42,208,2192,9.5,0.18437463
28075,28075,Tyler Motte,2017-18,22.0,2,7,33,33,4,3,7,46.0,376.0,33,4,3,7,46.0,82,5.45,47,245,2478,9.0,0.2987035
28076,28076,Tyler Motte,2018-19,23.0,3,7,46,46,5,2,7,64.0,516.0,79,9,5,14,110.0,82,5.86,50,250,2620,9.2,0.24843398
28077,28077,Tyler Motte,2019-20,24.0,4,16,74,74,9,7,16,114.0,945.0,153,18,12,30,224.0,82,5.96,47,239,2579,9.5,0.25103784
28078,28078,Tyler Motte,2020-21,25.0,5,8,34,34,4,4,8,38.0,446.0,187,22,16,38,262.0,70,5.96,42,208,2192,9.5,0.24377412
28079,28079,Tyler Myers,2010-11,20.0,2,48,82,82,11,37,48,104.0,1947.0,82,11,37,48,104.0,82,5.53,56,304,2486,9.1,0.60236025
28080,28080,Tyler Myers,2011-12,21.0,3,37,80,80,10,27,37,122.0,1797.0,162,21,64,85,226.0,82,5.46,52,291,2492,9.0,0.45543873
28081,28081,Tyler Myers,2012-13,22.0,4,23,55,55,8,15,23,84.0,1237.0,217,29,79,108,310.0,82,5.32,47,271,2439,8.9,0.45800912
28082,28082,Tyler Myers,2013-14,23.0,5,8,39,39,3,5,8,48.0,831.0,256,32,84,116,358.0,48,5.31,29,160,1399,9.1,0.34787884
28083,28083,Tyler Myers,2014-15,24.0,6,22,62,62,9,13,22,99.0,1358.0,318,41,97,138,457.0,82,5.34,48,269,2463,8.9,0.40268525
28084,28084,Tyler Myers,2015-16,25.0,7,28,71,71,7,21,28,124.0,1749.0,389,48,118,166,581.0,82,5.32,47,251,2453,8.9,0.43616813
28085,28085,Tyler Myers,2016-17,26.0,8,27,73,73,9,18,27,140.0,1651.0,462,57,136,193,721.0,82,5.34,48,255,2438,9.0,0.39420485
28086,28086,Tyler Myers,2017-18,27.0,9,5,11,11,2,3,5,16.0,244.0,473,59,139,198,737.0,82,5.45,47,245,2478,9.0,0.32795483
28087,28087,Tyler Myers,2018-19,28.0,10,36,82,82,6,30,36,150.0,1757.0,555,65,169,234,887.0,82,5.86,50,250,2620,9.2,0.42218906
28088,28088,Tyler Myers,2019-20,29.0,11,31,80,80,9,22,31,156.0,1628.0,635,74,191,265,1043.0,82,5.96,47,239,2579,9.5,0.4125517
28089,28089,Tyler Myers,2020-21,30.0,12,21,68,68,6,15,21,134.0,1463.0,703,80,206,286,1177.0,70,5.96,42,208,2192,9.5,0.35601848
28090,28090,Tyler Pitlick,2014-15,23.0,2,1,10,10,1,0,1,9.0,90.0,10,1,0,1,9.0,82,5.34,48,269,2463,8.9,0.21705997
28091,28091,Tyler Pitlick,2015-16,24.0,3,2,17,17,2,0,2,18.0,212.0,27,3,0,3,27.0,82,5.32,47,251,2453,8.9,0.21606207
28092,28092,Tyler Pitlick,2017-18,26.0,4,11,31,31,8,3,11,54.0,308.0,58,11,3,14,81.0,82,5.45,47,245,2478,9.0,0.2788801
28093,28093,Tyler Pitlick,2018-19,27.0,5,27,80,80,14,13,27,129.0,1094.0,138,25,16,41,210.0,82,5.86,50,250,2620,9.2,0.3240149
28094,28094,Tyler Pitlick,2019-20,28.0,6,12,47,47,8,4,12,75.0,629.0,185,33,20,53,285.0,82,5.96,47,239,2579,9.5,0.26306126
28095,28095,Tyler Pitlick,2020-21,29.0,7,20,63,63,8,12,20,76.0,759.0,248,41,32,73,361.0,70,5.96,42,208,2192,9.5,0.2974702
28096,28096,Tyler Randell,2016-17,25.0,2,6,27,27,6,0,6,18.0,189.0,27,6,0,6,18.0,82,5.34,48,255,2438,9.0,0.2207768
28097,28097,Tyler Seguin,2011-12,20.0,2,22,74,74,11,11,22,131.0,904.0,74,11,11,22,131.0,82,5.46,52,291,2492,9.0,0.4024857
28098,28098,Tyler Seguin,2012-13,21.0,3,67,81,81,29,38,67,242.0,1372.0,155,40,49,89,373.0,82,5.32,47,271,2439,8.9,0.8708998
28099,28099,Tyler Seguin,2013-14,22.0,4,32,48,48,16,16,32,161.0,817.0,203,56,65,121,534.0,48,5.31,29,160,1399,9.1,0.7553698
28100,28100,Tyler Seguin,2014-15,23.0,5,84,80,80,37,47,84,294.0,1548.0,283,93,112,205,828.0,82,5.34,48,269,2463,8.9,1.0296125
28101,28101,Tyler Seguin,2015-16,24.0,6,77,71,71,37,40,77,280.0,1388.0,354,130,152,282,1108.0,82,5.32,47,251,2453,8.9,0.9387624
28102,28102,Tyler Seguin,2016-17,25.0,7,73,72,72,33,40,73,278.0,1400.0,426,163,192,355,1386.0,82,5.34,48,255,2438,9.0,0.9144037
28103,28103,Tyler Seguin,2017-18,26.0,8,72,82,82,26,46,72,301.0,1514.0,508,189,238,427,1687.0,82,5.45,47,245,2478,9.0,0.9524175
28104,28104,Tyler Seguin,2018-19,27.0,9,78,82,82,40,38,78,335.0,1715.0,590,229,276,505,2022.0,82,5.86,50,250,2620,9.2,0.9088757
28105,28105,Tyler Seguin,2019-20,28.0,10,80,82,82,33,47,80,334.0,1701.0,672,262,323,585,2356.0,82,5.96,47,239,2579,9.5,0.8865307
28106,28106,Tyler Seguin,2020-21,29.0,11,50,69,69,17,33,50,245.0,1321.0,741,279,356,635,2601.0,70,5.96,42,208,2192,9.5,0.69648683
28107,28107,Tyler Sloan,2009-10,28.0,2,5,26,26,1,4,5,8.0,433.0,26,1,4,5,8.0,82,5.7,65,341,2477,9.4,0.15340883
28108,28108,Tyler Sloan,2010-11,29.0,3,6,40,40,2,4,6,34.0,570.0,66,3,8,11,42.0,82,5.53,56,304,2486,9.1,0.15702453
28109,28109,Tyler Sloan,2011-12,30.0,4,6,33,33,1,5,6,12.0,413.0,99,4,13,17,54.0,82,5.46,52,291,2492,9.0,0.12733808
28110,28110,Tyler Toffoli,2013-14,21.0,2,5,10,10,2,3,5,20.0,120.0,10,2,3,5,20.0,48,5.31,29,160,1399,9.1,0.34777647
28111,28111,Tyler Toffoli,2014-15,22.0,3,29,62,62,12,17,29,124.0,802.0,72,14,20,34,144.0,82,5.34,48,269,2463,8.9,0.45840055
28112,28112,Tyler Toffoli,2015-16,23.0,4,49,76,76,23,26,49,200.0,1109.0,148,37,46,83,344.0,82,5.32,47,251,2453,8.9,0.6273223
28113,28113,Tyler Toffoli,2016-17,24.0,5,58,82,82,31,27,58,213.0,1420.0,230,68,73,141,557.0,82,5.34,48,255,2438,9.0,0.71554697
28114,28114,Tyler Toffoli,2017-18,25.0,6,34,63,63,16,18,34,165.0,1045.0,293,84,91,175,722.0,82,5.45,47,245,2478,9.0,0.5614699
28115,28115,Tyler Toffoli,2018-19,26.0,7,47,82,82,24,23,47,251.0,1322.0,375,108,114,222,973.0,82,5.86,50,250,2620,9.2,0.6611184
28116,28116,Tyler Toffoli,2019-20,27.0,8,34,82,82,13,21,34,226.0,1411.0,457,121,135,256,1199.0,82,5.96,47,239,2579,9.5,0.51531315
28117,28117,Tyler Toffoli,2020-21,28.0,9,44,68,68,24,20,44,203.0,1146.0,525,145,155,300,1402.0,70,5.96,42,208,2192,9.5,0.6697247
28118,28118,Tyler Wotherspoon,2014-15,21.0,2,4,14,14,0,4,4,3.0,188.0,14,0,4,4,3.0,82,5.34,48,269,2463,8.9,0.23084545
28119,28119,Tyler Wotherspoon,2015-16,22.0,3,0,1,1,0,0,0,1.0,20.0,15,0,4,4,4.0,82,5.32,47,251,2453,8.9,0.1663903
28120,28120,Tyler Wotherspoon,2016-17,23.0,4,1,11,11,0,1,1,9.0,156.0,26,0,5,5,13.0,82,5.34,48,255,2438,9.0,0.17364094
28121,28121,Tyler Wotherspoon,2017-18,24.0,5,0,4,4,0,0,0,4.0,44.0,30,0,5,5,17.0,82,5.45,47,245,2478,9.0,0.15504909
28122,28122,Tyler Wright,1993-94,20.0,2,2,7,7,1,1,2,7.0,,7,1,1,2,7.0,84,7.25,87,443,2603,11.7,0.2907487
28123,28123,Tyler Wright,1994-95,21.0,3,0,5,5,0,0,0,2.0,,12,1,1,2,9.0,84,6.48,76,407,2545,10.7,0.23649934
28124,28124,Tyler Wright,1995-96,22.0,4,1,6,6,1,0,1,6.0,,18,2,1,3,15.0,48,5.97,37,209,1408,10.2,0.24001345
28125,28125,Tyler Wright,1996-97,23.0,5,1,23,23,1,0,1,18.0,,41,3,1,4,33.0,82,6.29,74,413,2481,10.4,0.1770024
28126,28126,Tyler Wright,1997-98,24.0,6,4,45,45,2,2,4,30.0,,86,5,3,8,63.0,82,5.83,55,336,2444,9.8,0.1325047
28127,28127,Tyler Wright,1998-99,25.0,7,7,82,82,3,4,7,46.0,,168,8,7,15,109.0,82,5.28,57,380,2242,9.6,0.14048043
28128,28128,Tyler Wright,1999-00,26.0,8,0,61,61,0,0,0,16.0,230.0,229,8,7,15,125.0,82,5.27,57,359,2285,9.4,0.09150669
28129,28129,Tyler Wright,2000-01,27.0,9,22,50,50,12,10,22,68.0,670.0,279,20,17,37,193.0,82,5.49,53,331,2294,9.8,0.30840135
28130,28130,Tyler Wright,2001-02,28.0,10,32,76,76,16,16,32,141.0,1344.0,355,36,33,69,334.0,82,5.51,63,376,2272,9.9,0.3759758
28131,28131,Tyler Wright,2002-03,29.0,11,24,77,77,13,11,24,120.0,1325.0,432,49,44,93,454.0,82,5.24,53,338,2262,9.5,0.291047
28132,28132,Tyler Wright,2003-04,30.0,12,30,70,70,19,11,30,108.0,1129.0,502,68,55,123,562.0,82,5.31,60,363,2326,9.4,0.37656164
28133,28133,Tyler Wright,2004-05,31.0,13,18,68,68,9,9,18,109.0,991.0,570,77,64,141,671.0,82,5.14,57,348,2300,9.2,0.25328517
28134,28134,Tyler Wright,2006-07,33.0,14,8,43,43,2,6,8,43.0,479.0,613,79,70,149,714.0,82,6.05,85,480,2458,10.1,0.15404412
28135,28135,Tyrell Goulbourne,2018-19,25.0,2,0,9,9,0,0,0,2.0,50.0,9,0,0,0,2.0,82,5.86,50,250,2620,9.2,0.16531053
28136,28136,Tyrell Goulbourne,2019-20,26.0,3,0,2,2,0,0,0,3.0,15.0,11,0,0,0,5.0,82,5.96,47,239,2579,9.5,0.1666354
28137,28137,Tyson Barrie,2012-13,21.0,2,0,10,10,0,0,0,15.0,176.0,10,0,0,0,15.0,82,5.32,47,271,2439,8.9,0.21474206
28138,28138,Tyson Barrie,2013-14,22.0,3,13,32,32,2,11,13,58.0,691.0,42,2,11,13,73.0,48,5.31,29,160,1399,9.1,0.32417843
28139,28139,Tyson Barrie,2014-15,23.0,4,38,64,64,13,25,38,101.0,1187.0,106,15,36,51,174.0,82,5.34,48,269,2463,8.9,0.53097725
28140,28140,Tyson Barrie,2015-16,24.0,5,53,80,80,12,41,53,139.0,1709.0,186,27,77,104,313.0,82,5.32,47,251,2453,8.9,0.59537387
28141,28141,Tyson Barrie,2016-17,25.0,6,49,78,78,13,36,49,172.0,1810.0,264,40,113,153,485.0,82,5.34,48,255,2438,9.0,0.6235571
28142,28142,Tyson Barrie,2017-18,26.0,7,38,74,74,7,31,38,182.0,1725.0,338,47,144,191,667.0,82,5.45,47,245,2478,9.0,0.5839251
28143,28143,Tyson Barrie,2018-19,27.0,8,57,68,68,14,43,57,178.0,1543.0,406,61,187,248,845.0,82,5.86,50,250,2620,9.2,0.71333504
28144,28144,Tyson Barrie,2019-20,28.0,9,59,78,78,14,45,59,218.0,1699.0,484,75,232,307,1063.0,82,5.96,47,239,2579,9.5,0.6882154
28145,28145,Tyson Barrie,2020-21,29.0,10,39,70,70,5,34,39,169.0,1531.0,554,80,266,346,1232.0,70,5.96,42,208,2192,9.5,0.54938203
28146,28146,Tyson Jost,2017-18,19.0,2,1,6,6,1,0,1,9.0,94.0,6,1,0,1,9.0,82,5.45,47,245,2478,9.0,0.2892803
28147,28147,Tyson Jost,2018-19,20.0,3,22,65,65,12,10,22,113.0,951.0,71,13,10,23,122.0,82,5.86,50,250,2620,9.2,0.38286528
28148,28148,Tyson Jost,2019-20,21.0,4,26,70,70,11,15,26,114.0,910.0,141,24,25,49,236.0,82,5.96,47,239,2579,9.5,0.40164655
28149,28149,Tyson Jost,2020-21,22.0,5,23,67,67,8,15,23,115.0,855.0,208,32,40,72,351.0,70,5.96,42,208,2192,9.5,0.41327304
28150,28150,Tyson Nash,1999-00,24.0,2,0,2,2,0,0,0,1.0,15.0,2,0,0,0,1.0,82,5.27,57,359,2285,9.4,0.17854032
28151,28151,Tyson Nash,2000-01,25.0,3,13,66,66,4,9,13,68.0,567.0,68,4,9,13,69.0,82,5.49,53,331,2294,9.8,0.1742444
28152,28152,Tyson Nash,2001-02,26.0,4,15,57,57,8,7,15,113.0,711.0,125,12,16,28,182.0,82,5.51,63,376,2272,9.9,0.25907093
28153,28153,Tyson Nash,2002-03,27.0,5,13,64,64,6,7,13,66.0,643.0,189,18,23,41,248.0,82,5.24,53,338,2262,9.5,0.18955079
28154,28154,Tyson Nash,2003-04,28.0,6,9,66,66,6,3,9,77.0,652.0,255,24,26,50,325.0,82,5.31,60,363,2326,9.4,0.20236793
28155,28155,Tyson Nash,2004-05,29.0,7,8,69,69,3,5,8,83.0,820.0,324,27,31,58,408.0,82,5.14,57,348,2300,9.2,0.18717906
28156,28156,Tyson Nash,2006-07,31.0,8,6,50,50,0,6,6,44.0,502.0,374,27,37,64,452.0,82,6.05,85,480,2458,10.1,0.1502043
28157,28157,Tyson Strachan,2009-10,25.0,2,3,30,30,0,3,3,21.0,403.0,30,0,3,3,21.0,82,5.7,65,341,2477,9.4,0.17298883
28158,28158,Tyson Strachan,2010-11,26.0,3,2,8,8,0,2,2,7.0,112.0,38,0,5,5,28.0,82,5.53,56,304,2486,9.1,0.16332573
28159,28159,Tyson Strachan,2011-12,27.0,4,1,29,29,0,1,1,28.0,352.0,67,0,6,6,56.0,82,5.46,52,291,2492,9.0,0.13624874
28160,28160,Tyson Strachan,2012-13,28.0,5,3,15,15,1,2,3,14.0,215.0,82,1,8,9,70.0,82,5.32,47,271,2439,8.9,0.16799584
28161,28161,Tyson Strachan,2013-14,29.0,6,4,38,38,0,4,4,42.0,720.0,120,1,12,13,112.0,48,5.31,29,160,1399,9.1,0.1321902
28162,28162,Tyson Strachan,2014-15,30.0,7,2,18,18,0,2,2,7.0,312.0,138,1,14,15,119.0,82,5.34,48,269,2463,8.9,0.1091598
28163,28163,Tyson Strachan,2015-16,31.0,8,5,46,46,0,5,5,38.0,873.0,184,1,19,20,157.0,82,5.32,47,251,2453,8.9,0.101486266
28164,28164,Tyson Strachan,2016-17,32.0,9,0,2,2,0,0,0,0.0,15.0,186,1,19,20,157.0,82,5.34,48,255,2438,9.0,0.117257744
28165,28165,Udo Kiessling,1982-83,27.0,2,0,1,1,0,0,0,1.0,,1,0,0,0,1.0,80,8.03,73,320,2489,12.9,0.24047908
28166,28166,Ulf Dahlen,1988-89,22.0,2,52,70,70,29,23,52,159.0,,70,29,23,52,159.0,80,7.43,89,437,2435,12.2,0.828236
28167,28167,Ulf Dahlen,1989-90,23.0,3,43,56,56,24,19,43,147.0,,126,53,42,95,306.0,80,7.48,85,403,2430,12.3,0.73199975
28168,28168,Ulf Dahlen,1990-91,24.0,4,42,76,76,20,22,42,135.0,,202,73,64,137,441.0,80,7.37,76,367,2421,12.2,0.5361473
28169,28169,Ulf Dahlen,1991-92,25.0,5,39,66,66,21,18,39,133.0,,268,94,82,176,574.0,80,6.91,71,366,2385,11.6,0.63766086
28170,28170,Ulf Dahlen,1992-93,26.0,6,66,79,79,36,30,66,216.0,,347,130,112,242,790.0,80,6.96,77,402,2440,11.4,0.8655462
28171,28171,Ulf Dahlen,1993-94,27.0,7,74,83,83,35,39,74,223.0,,430,165,151,316,1013.0,84,7.25,87,443,2603,11.7,0.7288751
28172,28172,Ulf Dahlen,1994-95,28.0,8,69,78,78,25,44,69,190.0,,508,190,195,385,1203.0,84,6.48,76,407,2545,10.7,0.7150817
28173,28173,Ulf Dahlen,1995-96,29.0,9,34,46,46,11,23,34,85.0,,554,201,218,419,1288.0,48,5.97,37,209,1408,10.2,0.66846365
28174,28174,Ulf Dahlen,1996-97,30.0,10,28,59,59,16,12,28,103.0,,613,217,230,447,1391.0,82,6.29,74,413,2481,10.4,0.44827244
28175,28175,Ulf Dahlen,1997-98,31.0,11,33,73,73,14,19,33,131.0,,686,231,249,480,1522.0,82,5.83,55,336,2444,9.8,0.39697236
28176,28176,Ulf Dahlen,2000-01,34.0,12,38,75,75,15,23,38,106.0,949.0,761,246,272,518,1628.0,82,5.49,53,331,2294,9.8,0.4627098
28177,28177,Ulf Dahlen,2001-02,35.0,13,48,73,73,15,33,48,145.0,1081.0,834,261,305,566,1773.0,82,5.51,63,376,2272,9.9,0.55740863
28178,28178,Ulf Dahlen,2002-03,36.0,14,52,69,69,23,29,52,141.0,1114.0,903,284,334,618,1914.0,82,5.24,53,338,2262,9.5,0.5568226
28179,28179,Ulf Dahlen,2003-04,37.0,15,37,63,63,17,20,37,100.0,871.0,966,301,354,655,2014.0,82,5.31,60,363,2326,9.4,0.489839
28180,28180,Ulf Isaksson,1983-84,29.0,2,22,50,50,7,15,22,71.0,,50,7,15,22,71.0,80,7.73,71,310,2444,12.7,0.38252246
28181,28181,Ulf Samuelsson,1985-86,21.0,2,8,41,41,2,6,8,33.0,,41,2,6,8,33.0,80,7.77,71,321,2447,12.7,0.2657505
28182,28182,Ulf Samuelsson,1986-87,22.0,3,24,80,80,5,19,24,72.0,,121,7,25,32,105.0,80,7.94,82,370,2484,12.8,0.33444196
28183,28183,Ulf Samuelsson,1987-88,23.0,4,33,78,78,2,31,33,104.0,,199,9,56,65,209.0,80,7.34,72,344,2400,12.2,0.40542704
28184,28184,Ulf Samuelsson,1988-89,24.0,5,41,76,76,8,33,41,156.0,,275,17,89,106,365.0,80,7.43,89,437,2435,12.2,0.533748
28185,28185,Ulf Samuelsson,1989-90,25.0,6,35,71,71,9,26,35,122.0,,346,26,115,141,487.0,80,7.48,85,403,2430,12.3,0.47706825
28186,28186,Ulf Samuelsson,1990-91,26.0,7,13,55,55,2,11,13,57.0,,401,28,126,154,544.0,80,7.37,76,367,2421,12.2,0.2774578
28187,28187,Ulf Samuelsson,1991-92,27.0,8,26,76,76,4,22,26,125.0,,477,32,148,180,669.0,80,6.91,71,366,2385,11.6,0.31932795
28188,28188,Ulf Samuelsson,1992-93,28.0,9,15,62,62,1,14,15,75.0,,539,33,162,195,744.0,80,6.96,77,402,2440,11.4,0.25856876
28189,28189,Ulf Samuelsson,1993-94,29.0,10,29,77,77,3,26,29,96.0,,616,36,188,224,840.0,84,7.25,87,443,2603,11.7,0.33107907
28190,28190,Ulf Samuelsson,1994-95,30.0,11,29,80,80,5,24,29,106.0,,696,41,212,253,946.0,84,6.48,76,407,2545,10.7,0.32221654
28191,28191,Ulf Samuelsson,1995-96,31.0,12,16,44,44,1,15,16,47.0,,740,42,227,269,993.0,48,5.97,37,209,1408,10.2,0.27866986
28192,28192,Ulf Samuelsson,1996-97,32.0,13,19,74,74,1,18,19,66.0,,814,43,245,288,1059.0,82,6.29,74,413,2481,10.4,0.21618727
28193,28193,Ulf Samuelsson,1997-98,33.0,14,17,73,73,6,11,17,77.0,,887,49,256,305,1136.0,82,5.83,55,336,2444,9.8,0.23705417
28194,28194,Ulf Samuelsson,1998-99,34.0,15,12,73,73,3,9,12,59.0,,960,52,265,317,1195.0,82,5.28,57,380,2242,9.6,0.12292045
28195,28195,Ulf Samuelsson,1999-00,35.0,16,12,71,71,4,8,12,39.0,1443.0,1031,56,273,329,1234.0,82,5.27,57,359,2285,9.4,0.1273424
28196,28196,Ulf Samuelsson,2000-01,36.0,17,3,49,49,1,2,3,17.0,768.0,1080,57,275,332,1251.0,82,5.49,53,331,2294,9.8,0.11065906
28197,28197,Uli Hiemer,1985-86,23.0,2,29,53,53,5,24,29,86.0,,53,5,24,29,86.0,80,7.77,71,321,2447,12.7,0.51656777
28198,28198,Uli Hiemer,1986-87,24.0,3,24,50,50,8,16,24,100.0,,103,13,40,53,186.0,80,7.94,82,370,2484,12.8,0.43780836
28199,28199,Uli Hiemer,1987-88,25.0,4,20,40,40,6,14,20,80.0,,143,19,54,73,266.0,80,7.34,72,344,2400,12.2,0.51302147
28200,28200,Urho Vaakanainen,2019-20,21.0,2,0,2,2,0,0,0,2.0,18.0,2,0,0,0,2.0,82,5.96,47,239,2579,9.5,0.23299214
28201,28201,Urho Vaakanainen,2020-21,22.0,3,0,5,5,0,0,0,2.0,84.0,7,0,0,0,4.0,70,5.96,42,208,2192,9.5,0.20453703
28202,28202,Uwe Krupp,1987-88,22.0,2,5,26,26,1,4,5,34.0,,26,1,4,5,34.0,80,7.34,72,344,2400,12.2,0.26452982
28203,28203,Uwe Krupp,1988-89,23.0,3,11,75,75,2,9,11,84.0,,101,3,13,16,118.0,80,7.43,89,437,2435,12.2,0.2641424
28204,28204,Uwe Krupp,1989-90,24.0,4,18,70,70,5,13,18,51.0,,171,8,26,34,169.0,80,7.48,85,403,2430,12.3,0.23929447
28205,28205,Uwe Krupp,1990-91,25.0,5,23,74,74,3,20,23,69.0,,245,11,46,57,238.0,80,7.37,76,367,2421,12.2,0.26630837
28206,28206,Uwe Krupp,1991-92,26.0,6,44,74,74,12,32,44,138.0,,319,23,78,101,376.0,80,6.91,71,366,2385,11.6,0.5335539
28207,28207,Uwe Krupp,1992-93,27.0,7,37,67,67,8,29,37,128.0,,386,31,107,138,504.0,80,6.96,77,402,2440,11.4,0.4711583
28208,28208,Uwe Krupp,1993-94,28.0,8,38,80,80,9,29,38,116.0,,466,40,136,176,620.0,84,7.25,87,443,2603,11.7,0.4312764
28209,28209,Uwe Krupp,1994-95,29.0,9,21,41,41,7,14,21,82.0,,507,47,150,197,702.0,84,6.48,76,407,2545,10.7,0.44756088
28210,28210,Uwe Krupp,1995-96,30.0,10,23,44,44,6,17,23,102.0,,551,53,167,220,804.0,48,5.97,37,209,1408,10.2,0.4735916
28211,28211,Uwe Krupp,1996-97,31.0,11,3,6,6,0,3,3,9.0,,557,53,170,223,813.0,82,6.29,74,413,2481,10.4,0.19725615
28212,28212,Uwe Krupp,1997-98,32.0,12,21,60,60,4,17,21,107.0,,617,57,187,244,920.0,82,5.83,55,336,2444,9.8,0.3032689
28213,28213,Uwe Krupp,1998-99,33.0,13,31,78,78,9,22,31,149.0,,695,66,209,275,1069.0,82,5.28,57,380,2242,9.6,0.37161517
28214,28214,Uwe Krupp,1999-00,34.0,14,5,22,22,3,2,5,32.0,470.0,717,69,211,280,1101.0,82,5.27,57,359,2285,9.4,0.23900995
28215,28215,Uwe Krupp,2002-03,37.0,15,1,8,8,0,1,1,9.0,136.0,725,69,212,281,1110.0,82,5.24,53,338,2262,9.5,0.16575456
28216,28216,Uwe Krupp,2003-04,38.0,16,0,4,4,0,0,0,1.0,61.0,729,69,212,281,1111.0,82,5.31,60,363,2326,9.4,0.18341672
28217,28217,Vaclav Nedorost,2002-03,20.0,2,4,25,25,2,2,4,22.0,256.0,25,2,2,4,22.0,82,5.24,53,338,2262,9.5,0.26078612
28218,28218,Vaclav Nedorost,2003-04,21.0,3,9,42,42,4,5,9,35.0,440.0,67,6,7,13,57.0,82,5.31,60,363,2326,9.4,0.25078285
28219,28219,Vaclav Nedorost,2004-05,22.0,4,7,32,32,4,3,7,38.0,369.0,99,10,10,20,95.0,82,5.14,57,348,2300,9.2,0.33557272
28220,28220,Vaclav Pletka,2002-03,23.0,2,0,1,1,0,0,0,2.0,12.0,1,0,0,0,2.0,82,5.24,53,338,2262,9.5,0.17768398
28221,28221,Vaclav Varada,1996-97,20.0,2,0,1,1,0,0,0,2.0,,1,0,0,0,2.0,82,6.29,74,413,2481,10.4,0.23215792
28222,28222,Vaclav Varada,1997-98,21.0,3,0,5,5,0,0,0,2.0,,6,0,0,0,4.0,82,5.83,55,336,2444,9.8,0.20734885
28223,28223,Vaclav Varada,1998-99,22.0,4,11,27,27,5,6,11,27.0,,33,5,6,11,31.0,82,5.28,57,380,2242,9.6,0.3204397
28224,28224,Vaclav Varada,1999-00,23.0,5,31,72,72,7,24,31,123.0,1044.0,105,12,30,42,154.0,82,5.27,57,359,2285,9.4,0.46004272
28225,28225,Vaclav Varada,2000-01,24.0,6,37,76,76,10,27,37,140.0,1137.0,181,22,57,79,294.0,82,5.49,53,331,2294,9.8,0.4687217
28226,28226,Vaclav Varada,2001-02,25.0,7,31,75,75,10,21,31,112.0,1196.0,256,32,78,110,406.0,82,5.51,63,376,2272,9.9,0.41435486
28227,28227,Vaclav Varada,2002-03,26.0,8,23,76,76,7,16,23,138.0,1257.0,332,39,94,133,544.0,82,5.24,53,338,2262,9.5,0.35926044
28228,28228,Vaclav Varada,2003-04,27.0,9,19,55,55,9,10,19,81.0,873.0,387,48,104,152,625.0,82,5.31,60,363,2326,9.4,0.3578115
28229,28229,Vaclav Varada,2004-05,28.0,10,10,30,30,5,5,10,47.0,430.0,417,53,109,162,672.0,82,5.14,57,348,2300,9.2,0.34478658
28230,28230,Vaclav Varada,2006-07,30.0,11,21,76,76,5,16,21,114.0,738.0,493,58,125,183,786.0,82,6.05,85,480,2458,10.1,0.26467478
28231,28231,Vadim Sharifijanov,1997-98,22.0,2,0,2,2,0,0,0,4.0,,2,0,0,0,4.0,82,5.83,55,336,2444,9.8,0.18394265
28232,28232,Vadim Sharifijanov,1999-00,24.0,3,27,53,53,11,16,27,71.0,723.0,55,11,16,27,75.0,82,5.27,57,359,2285,9.4,0.40688357
28233,28233,Vadim Sharifijanov,2000-01,25.0,4,10,37,37,5,5,10,46.0,444.0,92,16,21,37,121.0,82,5.49,53,331,2294,9.8,0.27012712
28234,28234,Vadim Shipachyov,2018-19,31.0,2,1,3,3,1,0,1,3.0,32.0,3,1,0,1,3.0,82,5.86,50,250,2620,9.2,0.1900791
28235,28235,Val James,1982-83,25.0,2,0,7,7,0,0,0,5.0,,7,0,0,0,5.0,80,8.03,73,320,2489,12.9,0.21237499
28236,28236,Val James,1987-88,30.0,3,0,4,4,0,0,0,0.0,,11,0,0,0,5.0,80,7.34,72,344,2400,12.2,0.17830178
28237,28237,Valentin Zykov,2017-18,22.0,2,1,2,2,1,0,1,3.0,13.0,2,1,0,1,3.0,82,5.45,47,245,2478,9.0,0.24000493
28238,28238,Valentin Zykov,2018-19,23.0,3,7,10,10,3,4,7,18.0,137.0,12,4,4,8,21.0,82,5.86,50,250,2620,9.2,0.2955487
28239,28239,Valentin Zykov,2019-20,24.0,4,5,28,28,2,3,5,29.0,279.0,40,6,7,13,50.0,82,5.96,47,239,2579,9.5,0.21828082
28240,28240,Valentin Zykov,2020-21,25.0,5,4,15,15,1,3,4,19.0,183.0,55,7,10,17,69.0,70,5.96,42,208,2192,9.5,0.22977582
28241,28241,Valeri Bure,1995-96,21.0,2,4,24,24,3,1,4,39.0,,24,3,1,4,39.0,48,5.97,37,209,1408,10.2,0.36748633
28242,28242,Valeri Bure,1996-97,22.0,3,42,77,77,22,20,42,143.0,,101,25,21,46,182.0,82,6.29,74,413,2481,10.4,0.5522951
28243,28243,Valeri Bure,1997-98,23.0,4,35,64,64,14,21,35,131.0,,165,39,42,81,313.0,82,5.83,55,336,2444,9.8,0.5373728
28244,28244,Valeri Bure,1998-99,24.0,5,38,66,66,12,26,38,179.0,,231,51,68,119,492.0,82,5.28,57,380,2242,9.6,0.5792066
28245,28245,Valeri Bure,1999-00,25.0,6,53,80,80,26,27,53,260.0,1295.0,311,77,95,172,752.0,82,5.27,57,359,2285,9.4,0.7026082
28246,28246,Valeri Bure,2000-01,26.0,7,75,82,82,35,40,75,308.0,1720.0,393,112,135,247,1060.0,82,5.49,53,331,2294,9.8,0.8930452
28247,28247,Valeri Bure,2001-02,27.0,8,55,78,78,27,28,55,276.0,1483.0,471,139,163,302,1336.0,82,5.51,63,376,2272,9.9,0.68533707
28248,28248,Valeri Bure,2002-03,28.0,9,18,31,31,8,10,18,100.0,576.0,502,147,173,320,1436.0,82,5.24,53,338,2262,9.5,0.58648765
28249,28249,Valeri Bure,2003-04,29.0,10,28,51,51,5,23,28,161.0,933.0,553,152,196,348,1597.0,82,5.31,60,363,2326,9.4,0.58313066
28250,28250,Valeri Bure,2004-05,30.0,11,52,68,68,22,30,52,209.0,1289.0,621,174,226,400,1806.0,82,5.14,57,348,2300,9.2,0.7066281
28251,28251,Valeri Kamensky,1992-93,26.0,2,21,23,23,7,14,21,42.0,,23,7,14,21,42.0,80,6.96,77,402,2440,11.4,0.8016143
28252,28252,Valeri Kamensky,1993-94,27.0,3,37,32,32,15,22,37,94.0,,55,22,36,58,136.0,84,7.25,87,443,2603,11.7,0.76017296
28253,28253,Valeri Kamensky,1994-95,28.0,4,65,76,76,28,37,65,170.0,,131,50,73,123,306.0,84,6.48,76,407,2545,10.7,0.66987616
28254,28254,Valeri Kamensky,1995-96,29.0,5,30,40,40,10,20,30,70.0,,171,60,93,153,376.0,48,5.97,37,209,1408,10.2,0.6676054
28255,28255,Valeri Kamensky,1996-97,30.0,6,85,81,81,38,47,85,220.0,,252,98,140,238,596.0,82,6.29,74,413,2481,10.4,0.91100097
28256,28256,Valeri Kamensky,1997-98,31.0,7,66,68,68,28,38,66,165.0,,320,126,178,304,761.0,82,5.83,55,336,2444,9.8,0.7786709
28257,28257,Valeri Kamensky,1998-99,32.0,8,66,75,75,26,40,66,173.0,,395,152,218,370,934.0,82,5.28,57,380,2242,9.6,0.7727176
28258,28258,Valeri Kamensky,1999-00,33.0,9,44,65,65,14,30,44,123.0,1143.0,460,166,248,414,1057.0,82,5.27,57,359,2285,9.4,0.5801234
28259,28259,Valeri Kamensky,2000-01,34.0,10,32,58,58,13,19,32,88.0,868.0,518,179,267,446,1145.0,82,5.49,53,331,2294,9.8,0.4575415
28260,28260,Valeri Kamensky,2001-02,35.0,11,34,65,65,14,20,34,129.0,995.0,583,193,287,480,1274.0,82,5.51,63,376,2272,9.9,0.41696325
28261,28261,Valeri Kamensky,2002-03,36.0,12,21,54,54,7,14,21,72.0,618.0,637,200,301,501,1346.0,82,5.24,53,338,2262,9.5,0.42989764
28262,28262,Valeri Karpov,1995-96,24.0,2,11,30,30,4,7,11,48.0,,30,4,7,11,48.0,48,5.97,37,209,1408,10.2,0.30555034
28263,28263,Valeri Karpov,1996-97,25.0,3,17,37,37,9,8,17,42.0,,67,13,15,28,90.0,82,6.29,74,413,2481,10.4,0.34851092
28264,28264,Valeri Karpov,1997-98,26.0,4,1,9,9,1,0,1,4.0,,76,14,15,29,94.0,82,5.83,55,336,2444,9.8,0.20184177
28265,28265,Valeri Nichushkin,2014-15,19.0,2,34,79,79,14,20,34,128.0,1183.0,79,14,20,34,128.0,82,5.34,48,269,2463,8.9,0.46949807
28266,28266,Valeri Nichushkin,2015-16,20.0,3,1,8,8,0,1,1,6.0,110.0,87,14,21,35,134.0,82,5.32,47,251,2453,8.9,0.33169672
28267,28267,Valeri Nichushkin,2016-17,21.0,4,29,79,79,9,20,29,139.0,1101.0,166,23,41,64,273.0,82,5.34,48,255,2438,9.0,0.42080742
28268,28268,Valeri Nichushkin,2019-20,24.0,5,10,57,57,0,10,10,65.0,679.0,223,23,51,74,338.0,82,5.96,47,239,2579,9.5,0.2595851
28269,28269,Valeri Nichushkin,2020-21,25.0,6,27,65,65,13,14,27,113.0,915.0,288,36,65,101,451.0,70,5.96,42,208,2192,9.5,0.3894855
28270,28270,Valeri Zelepukin,1992-93,24.0,2,31,44,44,13,18,31,94.0,,44,13,18,31,94.0,80,6.96,77,402,2440,11.4,0.58264846
28271,28271,Valeri Zelepukin,1993-94,25.0,3,64,78,78,23,41,64,174.0,,122,36,59,95,268.0,84,7.25,87,443,2603,11.7,0.63806635
28272,28272,Valeri Zelepukin,1994-95,26.0,4,57,82,82,26,31,57,155.0,,204,62,90,152,423.0,84,6.48,76,407,2545,10.7,0.63601995
28273,28273,Valeri Zelepukin,1995-96,27.0,5,3,4,4,1,2,3,6.0,,208,63,92,155,429.0,48,5.97,37,209,1408,10.2,0.36807054
28274,28274,Valeri Zelepukin,1996-97,28.0,6,15,61,61,6,9,15,86.0,,269,69,101,170,515.0,82,6.29,74,413,2481,10.4,0.4155549
28275,28275,Valeri Zelepukin,1997-98,29.0,7,38,71,71,14,24,38,111.0,,340,83,125,208,626.0,82,5.83,55,336,2444,9.8,0.47389525
28276,28276,Valeri Zelepukin,1998-99,30.0,8,22,68,68,4,18,22,101.0,,408,87,143,230,727.0,82,5.28,57,380,2242,9.6,0.32649177
28277,28277,Valeri Zelepukin,1999-00,31.0,9,25,74,74,16,9,25,129.0,1077.0,482,103,152,255,856.0,82,5.27,57,359,2285,9.4,0.3718112
28278,28278,Valeri Zelepukin,2000-01,32.0,10,32,77,77,11,21,32,125.0,1126.0,559,114,173,287,981.0,82,5.49,53,331,2294,9.8,0.3429124
28279,28279,Valeri Zelepukin,2001-02,33.0,11,7,36,36,3,4,7,38.0,436.0,595,117,177,294,1019.0,82,5.51,63,376,2272,9.9,0.21809456
28280,28280,Valtteri Filppula,2006-07,22.0,2,1,4,4,0,1,1,1.0,29.0,4,0,1,1,1.0,82,6.05,85,480,2458,10.1,0.19344911
28281,28281,Valtteri Filppula,2007-08,23.0,3,17,73,73,10,7,17,76.0,822.0,77,10,8,18,77.0,82,5.76,70,398,2426,9.7,0.27406073
28282,28282,Valtteri Filppula,2008-09,24.0,4,36,78,78,19,17,36,122.0,1323.0,155,29,25,54,199.0,82,5.44,62,351,2383,9.4,0.42532936
28283,28283,Valtteri Filppula,2009-10,25.0,5,40,80,80,12,28,40,129.0,1288.0,235,41,53,94,328.0,82,5.7,65,341,2477,9.4,0.4616561
28284,28284,Valtteri Filppula,2010-11,26.0,6,35,55,55,11,24,35,114.0,1003.0,290,52,77,129,442.0,82,5.53,56,304,2486,9.1,0.50636077
28285,28285,Valtteri Filppula,2011-12,27.0,7,39,71,71,16,23,39,115.0,1187.0,361,68,100,168,557.0,82,5.46,52,291,2492,9.0,0.5004273
28286,28286,Valtteri Filppula,2012-13,28.0,8,66,81,81,23,43,66,144.0,1479.0,442,91,143,234,701.0,82,5.32,47,271,2439,8.9,0.7097897
28287,28287,Valtteri Filppula,2013-14,29.0,9,17,41,41,9,8,17,78.0,729.0,483,100,151,251,779.0,48,5.31,29,160,1399,9.1,0.44671378
28288,28288,Valtteri Filppula,2014-15,30.0,10,58,75,75,25,33,58,131.0,1499.0,558,125,184,309,910.0,82,5.34,48,269,2463,8.9,0.64566684
28289,28289,Valtteri Filppula,2015-16,31.0,11,48,82,82,12,36,48,91.0,1559.0,640,137,220,357,1001.0,82,5.32,47,251,2453,8.9,0.52448684
28290,28290,Valtteri Filppula,2016-17,32.0,12,31,76,76,8,23,31,101.0,1388.0,716,145,243,388,1102.0,82,5.34,48,255,2438,9.0,0.375158
28291,28291,Valtteri Filppula,2017-18,33.0,13,42,79,79,12,30,42,97.0,1375.0,795,157,273,430,1199.0,82,5.45,47,245,2478,9.0,0.45593297
28292,28292,Valtteri Filppula,2018-19,34.0,14,33,81,81,11,22,33,70.0,1335.0,876,168,295,463,1269.0,82,5.86,50,250,2620,9.2,0.31519657
28293,28293,Valtteri Filppula,2019-20,35.0,15,31,72,72,17,14,31,78.0,1028.0,948,185,309,494,1347.0,82,5.96,47,239,2579,9.5,0.33156812
28294,28294,Valtteri Filppula,2020-21,36.0,16,21,70,70,6,15,21,63.0,1163.0,1018,191,324,515,1410.0,70,5.96,42,208,2192,9.5,0.262348
28295,28295,Veli-Pekka Ketola,1982-83,34.0,2,14,44,44,9,5,14,42.0,,44,9,5,14,42.0,80,8.03,73,320,2489,12.9,0.30798784
28296,28296,Vern Smith,1985-86,21.0,2,0,1,1,0,0,0,0.0,,1,0,0,0,0.0,80,7.77,71,321,2447,12.7,0.21353588
28297,28297,Vernon Fiddler,2003-04,23.0,2,6,19,19,4,2,6,20.0,184.0,19,4,2,6,20.0,82,5.31,60,363,2326,9.4,0.29335666
28298,28298,Vernon Fiddler,2004-05,24.0,3,0,17,17,0,0,0,8.0,138.0,36,4,2,6,28.0,82,5.14,57,348,2300,9.2,0.16543087
28299,28299,Vernon Fiddler,2006-07,26.0,4,12,40,40,8,4,12,46.0,553.0,76,12,6,18,74.0,82,6.05,85,480,2458,10.1,0.25886554
28300,28300,Vernon Fiddler,2007-08,27.0,5,26,72,72,11,15,26,90.0,981.0,148,23,21,44,164.0,82,5.76,70,398,2426,9.7,0.29334372
28301,28301,Vernon Fiddler,2008-09,28.0,6,32,79,79,11,21,32,97.0,1101.0,227,34,42,76,261.0,82,5.44,62,351,2383,9.4,0.3721555
28302,28302,Vernon Fiddler,2009-10,29.0,7,17,78,78,11,6,17,114.0,1089.0,305,45,48,93,375.0,82,5.7,65,341,2477,9.4,0.23296767
28303,28303,Vernon Fiddler,2010-11,30.0,8,30,76,76,8,22,30,119.0,1090.0,381,53,70,123,494.0,82,5.53,56,304,2486,9.1,0.33875096
28304,28304,Vernon Fiddler,2011-12,31.0,9,22,71,71,6,16,22,97.0,1104.0,452,59,86,145,591.0,82,5.46,52,291,2492,9.0,0.2766484
28305,28305,Vernon Fiddler,2012-13,32.0,10,21,82,82,8,13,21,123.0,1147.0,534,67,99,166,714.0,82,5.32,47,271,2439,8.9,0.263964
28306,28306,Vernon Fiddler,2013-14,33.0,11,17,46,46,4,13,17,56.0,591.0,580,71,112,183,770.0,48,5.31,29,160,1399,9.1,0.28511006
28307,28307,Vernon Fiddler,2014-15,34.0,12,23,76,76,6,17,23,109.0,1010.0,656,77,129,206,879.0,82,5.34,48,269,2463,8.9,0.2475686
28308,28308,Vernon Fiddler,2015-16,35.0,13,29,80,80,13,16,29,132.0,1050.0,736,90,145,235,1011.0,82,5.32,47,251,2453,8.9,0.3064686
28309,28309,Vernon Fiddler,2016-17,36.0,14,22,82,82,12,10,22,98.0,954.0,818,102,155,257,1109.0,82,5.34,48,255,2438,9.0,0.24337429
28310,28310,Vernon Fiddler,2017-18,37.0,15,4,59,59,2,2,4,48.0,687.0,877,104,157,261,1157.0,82,5.45,47,245,2478,9.0,0.13051483
28311,28311,Vesa Viitakoski,1994-95,23.0,2,3,8,8,1,2,3,15.0,,8,1,2,3,15.0,84,6.48,76,407,2545,10.7,0.2565691
28312,28312,Vesa Viitakoski,1995-96,24.0,3,3,10,10,1,2,3,6.0,,18,2,4,6,21.0,48,5.97,37,209,1408,10.2,0.22211167
28313,28313,Vesa Viitakoski,1996-97,25.0,4,0,5,5,0,0,0,7.0,,23,2,4,6,28.0,82,6.29,74,413,2481,10.4,0.16207653
28314,28314,Viacheslav Butsayev,1993-94,23.0,2,16,52,52,2,14,16,58.0,,52,2,14,16,58.0,84,7.25,87,443,2603,11.7,0.30149114
28315,28315,Viacheslav Butsayev,1994-95,24.0,3,23,59,59,12,11,23,85.0,,111,14,25,39,143.0,84,6.48,76,407,2545,10.7,0.38355243
28316,28316,Viacheslav Butsayev,1995-96,25.0,4,2,6,6,2,0,2,6.0,,117,16,25,41,149.0,48,5.97,37,209,1408,10.2,0.28311533
28317,28317,Viacheslav Butsayev,1996-97,26.0,5,1,7,7,1,0,1,9.0,,124,17,25,42,158.0,82,6.29,74,413,2481,10.4,0.18636128
28318,28318,Viacheslav Butsayev,1999-00,29.0,6,1,3,3,0,1,1,5.0,39.0,127,17,26,43,163.0,82,5.27,57,359,2285,9.4,0.15621161
28319,28319,Viacheslav Butsayev,2000-01,30.0,7,0,5,5,0,0,0,2.0,45.0,132,17,26,43,165.0,82,5.49,53,331,2294,9.8,0.13695315
28320,28320,Viacheslav Fetisov,1990-91,32.0,2,42,72,72,8,34,42,108.0,,72,8,34,42,108.0,80,7.37,76,367,2421,12.2,0.47912842
28321,28321,Viacheslav Fetisov,1991-92,33.0,3,19,67,67,3,16,19,71.0,,139,11,50,61,179.0,80,6.91,71,366,2385,11.6,0.26254964
28322,28322,Viacheslav Fetisov,1992-93,34.0,4,26,70,70,3,23,26,70.0,,209,14,73,87,249.0,80,6.96,77,402,2440,11.4,0.31848437
28323,28323,Viacheslav Fetisov,1993-94,35.0,5,27,76,76,4,23,27,63.0,,285,18,96,114,312.0,84,7.25,87,443,2603,11.7,0.30501932
28324,28324,Viacheslav Fetisov,1994-95,36.0,6,15,52,52,1,14,15,36.0,,337,19,110,129,348.0,84,6.48,76,407,2545,10.7,0.28947926
28325,28325,Viacheslav Fetisov,1995-96,37.0,7,15,18,18,3,12,15,37.0,,355,22,122,144,385.0,48,5.97,37,209,1408,10.2,0.52414304
28326,28326,Viacheslav Fetisov,1996-97,38.0,8,42,69,69,7,35,42,127.0,,424,29,157,186,512.0,82,6.29,74,413,2481,10.4,0.46758392
28327,28327,Viacheslav Fetisov,1997-98,39.0,9,28,64,64,5,23,28,95.0,,488,34,180,214,607.0,82,5.83,55,336,2444,9.8,0.3644544
28328,28328,Viacheslav Fetisov,1998-99,40.0,10,14,58,58,2,12,14,55.0,,546,36,192,228,662.0,82,5.28,57,380,2242,9.6,0.19184667
28329,28329,Victor Antipin,2018-19,26.0,2,10,47,47,0,10,10,40.0,718.0,47,0,10,10,40.0,82,5.86,50,250,2620,9.2,0.16732967
28330,28330,Victor Bartley,2013-14,25.0,2,7,24,24,0,7,7,19.0,469.0,24,0,7,7,19.0,48,5.31,29,160,1399,9.1,0.17626333
28331,28331,Victor Bartley,2014-15,26.0,3,6,50,50,1,5,6,21.0,768.0,74,1,12,13,40.0,82,5.34,48,269,2463,8.9,0.11920035
28332,28332,Victor Bartley,2015-16,27.0,4,10,37,37,0,10,10,28.0,497.0,111,1,22,23,68.0,82,5.32,47,251,2453,8.9,0.16118738
28333,28333,Victor Bartley,2016-17,28.0,5,0,10,10,0,0,0,8.0,133.0,121,1,22,23,76.0,82,5.34,48,255,2438,9.0,0.12710541
28334,28334,Victor Ejdsell,2018-19,23.0,2,1,6,6,0,1,1,7.0,80.0,6,0,1,1,7.0,82,5.86,50,250,2620,9.2,0.19409063
28335,28335,Victor Hedman,2010-11,20.0,2,20,74,74,4,16,20,90.0,1543.0,74,4,16,20,90.0,82,5.53,56,304,2486,9.1,0.3391173
28336,28336,Victor Hedman,2011-12,21.0,3,26,79,79,3,23,26,101.0,1660.0,153,7,39,46,191.0,82,5.46,52,291,2492,9.0,0.36588332
28337,28337,Victor Hedman,2012-13,22.0,4,23,61,61,5,18,23,82.0,1409.0,214,12,57,69,273.0,82,5.32,47,271,2439,8.9,0.35202184
28338,28338,Victor Hedman,2013-14,23.0,5,20,44,44,4,16,20,76.0,997.0,258,16,73,89,349.0,48,5.31,29,160,1399,9.1,0.4348504
28339,28339,Victor Hedman,2014-15,24.0,6,55,75,75,13,42,55,170.0,1683.0,333,29,115,144,519.0,82,5.34,48,269,2463,8.9,0.6648892
28340,28340,Victor Hedman,2015-16,25.0,7,38,59,59,10,28,38,115.0,1338.0,392,39,143,182,634.0,82,5.32,47,251,2453,8.9,0.55630434
28341,28341,Victor Hedman,2016-17,26.0,8,47,78,78,10,37,47,180.0,1799.0,470,49,180,229,814.0,82,5.34,48,255,2438,9.0,0.62697804
28342,28342,Victor Hedman,2017-18,27.0,9,72,79,79,16,56,72,166.0,1936.0,549,65,236,301,980.0,82,5.45,47,245,2478,9.0,0.8466955
28343,28343,Victor Hedman,2018-19,28.0,10,63,77,77,17,46,63,216.0,1991.0,626,82,282,364,1196.0,82,5.86,50,250,2620,9.2,0.7579833
28344,28344,Victor Hedman,2019-20,29.0,11,54,70,70,12,42,54,182.0,1594.0,696,94,324,418,1378.0,82,5.96,47,239,2579,9.5,0.7160713
28345,28345,Victor Hedman,2020-21,30.0,12,55,66,66,11,44,55,155.0,1588.0,762,105,368,473,1533.0,70,5.96,42,208,2192,9.5,0.72397
28346,28346,Victor Ignatjev,1999-00,29.0,2,1,11,11,0,1,1,15.0,135.0,11,0,1,1,15.0,82,5.27,57,359,2285,9.4,0.19975677
28347,28347,Victor Mete,2018-19,20.0,2,7,49,49,0,7,7,43.0,764.0,49,0,7,7,43.0,82,5.86,50,250,2620,9.2,0.20153448
28348,28348,Victor Mete,2019-20,21.0,3,13,71,71,0,13,13,65.0,1262.0,120,0,20,20,108.0,82,5.96,47,239,2579,9.5,0.24026257
28349,28349,Victor Mete,2020-21,22.0,4,11,51,51,4,7,11,57.0,816.0,171,4,27,31,165.0,70,5.96,42,208,2192,9.5,0.2766657
28350,28350,Victor Olofsson,2019-20,24.0,2,4,6,6,2,2,4,21.0,108.0,6,2,2,4,21.0,82,5.96,47,239,2579,9.5,0.25678957
28351,28351,Victor Olofsson,2020-21,25.0,3,42,54,54,20,22,42,127.0,993.0,60,22,24,46,148.0,70,5.96,42,208,2192,9.5,0.6807436
28352,28352,Victor Oreskovich,2010-11,24.0,2,6,50,50,2,4,6,55.0,444.0,50,2,4,6,55.0,82,5.53,56,304,2486,9.1,0.1837016
28353,28353,Victor Oreskovich,2011-12,25.0,3,3,16,16,0,3,3,19.0,126.0,66,2,7,9,74.0,82,5.46,52,291,2492,9.0,0.18687451
28354,28354,Victor Oreskovich,2012-13,26.0,4,0,1,1,0,0,0,0.0,6.0,67,2,7,9,74.0,82,5.32,47,271,2439,8.9,0.16075516
28355,28355,Victor Posa,1986-87,20.0,2,0,2,2,0,0,0,1.0,,2,0,0,0,1.0,80,7.94,82,370,2484,12.8,0.27897823
28356,28356,Victor Rask,2015-16,22.0,2,33,80,80,11,22,33,172.0,1307.0,80,11,22,33,172.0,82,5.32,47,251,2453,8.9,0.47154397
28357,28357,Victor Rask,2016-17,23.0,3,48,80,80,21,27,48,160.0,1359.0,160,32,49,81,332.0,82,5.34,48,255,2438,9.0,0.5975559
28358,28358,Victor Rask,2017-18,24.0,4,45,82,82,16,29,45,186.0,1418.0,242,48,78,126,518.0,82,5.45,47,245,2478,9.0,0.60408914
28359,28359,Victor Rask,2018-19,25.0,5,31,71,71,14,17,31,126.0,1092.0,313,62,95,157,644.0,82,5.86,50,250,2620,9.2,0.4664456
28360,28360,Victor Rask,2019-20,26.0,6,9,49,49,3,6,9,55.0,593.0,362,65,101,166,699.0,82,5.96,47,239,2579,9.5,0.31537837
28361,28361,Victor Rask,2020-21,27.0,7,13,43,43,5,8,13,38.0,451.0,405,70,109,179,737.0,70,5.96,42,208,2192,9.5,0.36560267
28362,28362,Viktor Arvidsson,2015-16,22.0,2,0,6,6,0,0,0,9.0,62.0,6,0,0,0,9.0,82,5.32,47,251,2453,8.9,0.19153073
28363,28363,Viktor Arvidsson,2016-17,23.0,3,16,56,56,8,8,16,139.0,694.0,62,8,8,16,148.0,82,5.34,48,255,2438,9.0,0.3637035
28364,28364,Viktor Arvidsson,2017-18,24.0,4,61,80,80,31,30,61,246.0,1372.0,142,39,38,77,394.0,82,5.45,47,245,2478,9.0,0.72436744
28365,28365,Viktor Arvidsson,2018-19,25.0,5,61,78,78,29,32,61,247.0,1384.0,220,68,70,138,641.0,82,5.86,50,250,2620,9.2,0.70592034
28366,28366,Viktor Arvidsson,2019-20,26.0,6,48,58,58,34,14,48,195.0,1110.0,278,102,84,186,836.0,82,5.96,47,239,2579,9.5,0.7515371
28367,28367,Viktor Arvidsson,2020-21,27.0,7,28,57,57,15,13,28,127.0,924.0,335,117,97,214,963.0,70,5.96,42,208,2192,9.5,0.5020907
28368,28368,Viktor Gordiouk,1993-94,23.0,2,9,16,16,3,6,9,24.0,,16,3,6,9,24.0,84,7.25,87,443,2603,11.7,0.34075034
28369,28369,Viktor Gordiouk,1995-96,25.0,3,2,10,10,0,2,2,10.0,,26,3,8,11,34.0,48,5.97,37,209,1408,10.2,0.21205476
28370,28370,Viktor Kozlov,1995-96,20.0,2,2,16,16,2,0,2,23.0,,16,2,0,2,23.0,48,5.97,37,209,1408,10.2,0.35149753
28371,28371,Viktor Kozlov,1996-97,21.0,3,19,62,62,6,13,19,107.0,,78,8,13,21,130.0,82,6.29,74,413,2481,10.4,0.36350048
28372,28372,Viktor Kozlov,1997-98,22.0,4,41,78,78,16,25,41,184.0,,156,24,38,62,314.0,82,5.83,55,336,2444,9.8,0.5601331
28373,28373,Viktor Kozlov,1998-99,23.0,5,30,64,64,17,13,30,165.0,,220,41,51,92,479.0,82,5.28,57,380,2242,9.6,0.5539652
28374,28374,Viktor Kozlov,1999-00,24.0,6,51,65,65,16,35,51,209.0,1238.0,285,57,86,143,688.0,82,5.27,57,359,2285,9.4,0.7327492
28375,28375,Viktor Kozlov,2000-01,25.0,7,70,80,80,17,53,70,223.0,1556.0,365,74,139,213,911.0,82,5.49,53,331,2294,9.8,0.85821795
28376,28376,Viktor Kozlov,2001-02,26.0,8,37,51,51,14,23,37,139.0,938.0,416,88,162,250,1050.0,82,5.51,63,376,2272,9.9,0.68428373
28377,28377,Viktor Kozlov,2002-03,27.0,9,27,50,50,9,18,27,143.0,995.0,466,97,180,277,1193.0,82,5.24,53,338,2262,9.5,0.60038143
28378,28378,Viktor Kozlov,2003-04,28.0,10,56,74,74,22,34,56,232.0,1671.0,540,119,214,333,1425.0,82,5.31,60,363,2326,9.4,0.714715
28379,28379,Viktor Kozlov,2004-05,29.0,11,33,59,59,13,20,33,143.0,1084.0,599,132,234,366,1568.0,82,5.14,57,348,2300,9.2,0.605866
28380,28380,Viktor Kozlov,2006-07,31.0,12,25,69,69,12,13,25,122.0,934.0,668,144,247,391,1690.0,82,6.05,85,480,2458,10.1,0.3556602
28381,28381,Viktor Kozlov,2007-08,32.0,13,51,81,81,25,26,51,165.0,1330.0,749,169,273,442,1855.0,82,5.76,70,398,2426,9.7,0.55387694
28382,28382,Viktor Kozlov,2008-09,33.0,14,54,81,81,16,38,54,219.0,1424.0,830,185,311,496,2074.0,82,5.44,62,351,2383,9.4,0.63110703
28383,28383,Viktor Kozlov,2009-10,34.0,15,41,67,67,13,28,41,153.0,1050.0,897,198,339,537,2227.0,82,5.7,65,341,2477,9.4,0.49250165
28384,28384,Viktor Loov,2016-17,24.0,2,2,4,4,0,2,2,1.0,42.0,4,0,2,2,1.0,82,5.34,48,255,2438,9.0,0.20164526
28385,28385,Viktor Nechayev,1983-84,29.0,2,1,3,3,1,0,1,7.0,,3,1,0,1,7.0,80,7.73,71,310,2444,12.7,0.26806897
28386,28386,Viktor Stalberg,2010-11,25.0,2,14,40,40,9,5,14,117.0,584.0,40,9,5,14,117.0,82,5.53,56,304,2486,9.1,0.33332276
28387,28387,Viktor Stalberg,2011-12,26.0,3,24,77,77,12,12,24,135.0,824.0,117,21,17,38,252.0,82,5.46,52,291,2492,9.0,0.33365074
28388,28388,Viktor Stalberg,2012-13,27.0,4,43,79,79,22,21,43,215.0,1112.0,196,43,38,81,467.0,82,5.32,47,271,2439,8.9,0.52742106
28389,28389,Viktor Stalberg,2013-14,28.0,5,23,47,47,9,14,23,113.0,664.0,243,52,52,104,580.0,48,5.31,29,160,1399,9.1,0.49227622
28390,28390,Viktor Stalberg,2014-15,29.0,6,18,70,70,8,10,18,114.0,881.0,313,60,62,122,694.0,82,5.34,48,269,2463,8.9,0.28725398
28391,28391,Viktor Stalberg,2015-16,30.0,7,10,25,25,2,8,10,27.0,297.0,338,62,70,132,721.0,82,5.32,47,251,2453,8.9,0.2727861
28392,28392,Viktor Stalberg,2016-17,31.0,8,20,75,75,9,11,20,125.0,915.0,413,71,81,152,846.0,82,5.34,48,255,2438,9.0,0.2608444
28393,28393,Viktor Stalberg,2017-18,32.0,9,16,75,75,11,5,16,101.0,915.0,488,82,86,168,947.0,82,5.45,47,245,2478,9.0,0.2544242
28394,28394,Viktor Svedberg,2016-17,25.0,2,4,27,27,2,2,4,40.0,425.0,27,2,2,4,40.0,82,5.34,48,255,2438,9.0,0.20324668
28395,28395,Viktor Tikhonov,2009-10,21.0,2,16,61,61,8,8,16,71.0,740.0,61,8,8,16,71.0,82,5.7,65,341,2477,9.4,0.31399775
28396,28396,Viktor Tikhonov,2016-17,28.0,3,6,50,50,3,3,6,41.0,572.0,111,11,11,22,112.0,82,5.34,48,255,2438,9.0,0.16553864
28397,28397,Ville Heinola,2020-21,19.0,2,5,8,8,1,4,5,10.0,145.0,8,1,4,5,10.0,70,5.96,42,208,2192,9.5,0.31633097
28398,28398,Ville Koistinen,2008-09,26.0,2,17,48,48,4,13,17,60.0,806.0,48,4,13,17,60.0,82,5.44,62,351,2383,9.4,0.28489012
28399,28399,Ville Koistinen,2009-10,27.0,3,11,38,38,3,8,11,42.0,559.0,86,7,21,28,102.0,82,5.7,65,341,2477,9.4,0.22050908
28400,28400,Ville Koistinen,2010-11,28.0,4,4,17,17,1,3,4,12.0,133.0,103,8,24,32,114.0,82,5.53,56,304,2486,9.1,0.20411539
28401,28401,Ville Leino,2009-10,26.0,2,9,13,13,5,4,9,17.0,165.0,13,5,4,9,17.0,82,5.7,65,341,2477,9.4,0.2656355
28402,28402,Ville Leino,2010-11,27.0,3,11,55,55,6,5,11,77.0,720.0,68,11,9,20,94.0,82,5.53,56,304,2486,9.1,0.25459197
28403,28403,Ville Leino,2011-12,28.0,4,53,81,81,19,34,53,117.0,1297.0,149,30,43,73,211.0,82,5.46,52,291,2492,9.0,0.54784536
28404,28404,Ville Leino,2012-13,29.0,5,25,71,71,8,17,25,78.0,1131.0,220,38,60,98,289.0,82,5.32,47,271,2439,8.9,0.33825642
28405,28405,Ville Leino,2013-14,30.0,6,6,8,8,2,4,6,11.0,126.0,228,40,64,104,300.0,48,5.31,29,160,1399,9.1,0.32340842
28406,28406,Ville Leino,2014-15,31.0,7,15,58,58,0,15,15,38.0,837.0,286,40,79,119,338.0,82,5.34,48,269,2463,8.9,0.21721667
28407,28407,Ville Nieminen,2000-01,23.0,2,0,1,1,0,0,0,2.0,10.0,1,0,0,0,2.0,82,5.49,53,331,2294,9.8,0.17768398
28408,28408,Ville Nieminen,2001-02,24.0,3,22,50,50,14,8,22,68.0,622.0,51,14,8,22,70.0,82,5.51,63,376,2272,9.9,0.3710127
28409,28409,Ville Nieminen,2002-03,25.0,4,27,66,66,11,16,27,83.0,882.0,117,25,24,49,153.0,82,5.24,53,338,2262,9.5,0.34673882
28410,28410,Ville Nieminen,2003-04,26.0,5,21,75,75,9,12,21,86.0,1061.0,192,34,36,70,239.0,82,5.31,60,363,2326,9.4,0.29391956
28411,28411,Ville Nieminen,2004-05,27.0,6,21,79,79,5,16,21,83.0,983.0,271,39,52,91,322.0,82,5.14,57,348,2300,9.2,0.29880866
28412,28412,Ville Nieminen,2006-07,29.0,7,24,70,70,8,16,24,114.0,897.0,341,47,68,115,436.0,82,6.05,85,480,2458,10.1,0.29284248
28413,28413,Ville Nieminen,2007-08,30.0,8,2,44,44,1,1,2,43.0,387.0,385,48,69,117,479.0,82,5.76,70,398,2426,9.7,0.1792244
28414,28414,Ville Peltonen,1996-97,23.0,2,13,31,31,2,11,13,58.0,,31,2,11,13,58.0,82,6.29,74,413,2481,10.4,0.29296452
28415,28415,Ville Peltonen,1997-98,24.0,3,5,28,28,2,3,5,35.0,,59,4,14,18,93.0,82,5.83,55,336,2444,9.8,0.23561856
28416,28416,Ville Peltonen,1999-00,26.0,4,10,14,14,5,5,10,31.0,223.0,73,9,19,28,124.0,82,5.27,57,359,2285,9.4,0.3189837
28417,28417,Ville Peltonen,2000-01,27.0,5,28,79,79,6,22,28,125.0,1159.0,152,15,41,56,249.0,82,5.49,53,331,2294,9.8,0.3280452
28418,28418,Ville Peltonen,2001-02,28.0,6,4,23,23,3,1,4,38.0,268.0,175,18,42,60,287.0,82,5.51,63,376,2272,9.9,0.23936549
28419,28419,Ville Peltonen,2007-08,34.0,7,37,72,72,17,20,37,145.0,1182.0,247,35,62,97,432.0,82,5.76,70,398,2426,9.7,0.45891434
28420,28420,Ville Peltonen,2008-09,35.0,8,20,56,56,5,15,20,108.0,886.0,303,40,77,117,540.0,82,5.44,62,351,2383,9.4,0.3462732
28421,28421,Ville Peltonen,2009-10,36.0,9,31,79,79,12,19,31,121.0,1205.0,382,52,96,148,661.0,82,5.7,65,341,2477,9.4,0.33366713
28422,28422,Ville Siren,1986-87,22.0,2,12,60,60,4,8,12,58.0,,60,4,8,12,58.0,80,7.94,82,370,2484,12.8,0.24867204
28423,28423,Ville Siren,1987-88,23.0,3,22,69,69,5,17,22,84.0,,129,9,25,34,142.0,80,7.34,72,344,2400,12.2,0.32786867
28424,28424,Ville Siren,1988-89,24.0,4,21,58,58,1,20,21,53.0,,187,10,45,55,195.0,80,7.43,89,437,2435,12.2,0.29632407
28425,28425,Ville Siren,1989-90,25.0,5,13,50,50,3,10,13,50.0,,237,13,55,68,245.0,80,7.48,85,403,2430,12.3,0.28871894
28426,28426,Ville Siren,1990-91,26.0,6,14,53,53,1,13,14,53.0,,290,14,68,82,298.0,80,7.37,76,367,2421,12.2,0.23902392
28427,28427,Vince Dunn,2018-19,22.0,2,24,75,75,5,19,24,138.0,1292.0,75,5,19,24,138.0,82,5.86,50,250,2620,9.2,0.36734784
28428,28428,Vince Dunn,2019-20,23.0,3,35,78,78,12,23,35,150.0,1368.0,153,17,42,59,288.0,82,5.96,47,239,2579,9.5,0.4580444
28429,28429,Vince Dunn,2020-21,24.0,4,23,71,71,9,14,23,138.0,1155.0,224,26,56,82,426.0,70,5.96,42,208,2192,9.5,0.42195135
28430,28430,Vincent Damphousse,1987-88,20.0,2,46,80,80,21,25,46,142.0,,80,21,25,46,142.0,80,7.34,72,344,2400,12.2,0.66116554
28431,28431,Vincent Damphousse,1988-89,21.0,3,48,75,75,12,36,48,111.0,,155,33,61,94,253.0,80,7.43,89,437,2435,12.2,0.70859194
28432,28432,Vincent Damphousse,1989-90,22.0,4,68,80,80,26,42,68,190.0,,235,59,103,162,443.0,80,7.48,85,403,2430,12.3,0.90055126
28433,28433,Vincent Damphousse,1990-91,23.0,5,94,80,80,33,61,94,229.0,,315,92,164,256,672.0,80,7.37,76,367,2421,12.2,1.1089005
28434,28434,Vincent Damphousse,1991-92,24.0,6,73,79,79,26,47,73,247.0,,394,118,211,329,919.0,80,6.91,71,366,2385,11.6,0.9603071
28435,28435,Vincent Damphousse,1992-93,25.0,7,89,80,80,38,51,89,247.0,,474,156,262,418,1166.0,80,6.96,77,402,2440,11.4,1.1309795
28436,28436,Vincent Damphousse,1993-94,26.0,8,97,84,84,39,58,97,287.0,,558,195,320,515,1453.0,84,7.25,87,443,2603,11.7,1.0211216
28437,28437,Vincent Damphousse,1994-95,27.0,9,91,84,84,40,51,91,274.0,,642,235,371,606,1727.0,84,6.48,76,407,2545,10.7,0.9689848
28438,28438,Vincent Damphousse,1995-96,28.0,10,40,48,48,10,30,40,123.0,,690,245,401,646,1850.0,48,5.97,37,209,1408,10.2,0.9284221
28439,28439,Vincent Damphousse,1996-97,29.0,11,94,80,80,38,56,94,254.0,,770,283,457,740,2104.0,82,6.29,74,413,2481,10.4,1.0378935
28440,28440,Vincent Damphousse,1997-98,30.0,12,81,82,82,27,54,81,244.0,,852,310,511,821,2348.0,82,5.83,55,336,2444,9.8,0.94338393
28441,28441,Vincent Damphousse,1998-99,31.0,13,59,76,76,18,41,59,164.0,,928,328,552,880,2512.0,82,5.28,57,380,2242,9.6,0.68359196
28442,28442,Vincent Damphousse,1999-00,32.0,14,49,77,77,19,30,49,190.0,1561.0,1005,347,582,929,2702.0,82,5.27,57,359,2285,9.4,0.63772
28443,28443,Vincent Damphousse,2000-01,33.0,15,70,82,82,21,49,70,204.0,1676.0,1087,368,631,999,2906.0,82,5.49,53,331,2294,9.8,0.9030454
28444,28444,Vincent Damphousse,2001-02,34.0,16,46,45,45,9,37,46,101.0,937.0,1132,377,668,1045,3007.0,82,5.51,63,376,2272,9.9,0.7481247
28445,28445,Vincent Damphousse,2002-03,35.0,17,58,82,82,20,38,58,172.0,1609.0,1214,397,706,1103,3179.0,82,5.24,53,338,2262,9.5,0.6532467
28446,28446,Vincent Damphousse,2003-04,36.0,18,61,82,82,23,38,61,176.0,1571.0,1296,420,744,1164,3355.0,82,5.31,60,363,2326,9.4,0.610943
28447,28447,Vincent Damphousse,2004-05,37.0,19,41,82,82,12,29,41,156.0,1406.0,1378,432,773,1205,3511.0,82,5.14,57,348,2300,9.2,0.5563771
28448,28448,Vincent Lecavalier,1999-00,19.0,2,28,82,82,13,15,28,125.0,1121.0,82,13,15,28,125.0,82,5.27,57,359,2285,9.4,0.46250948
28449,28449,Vincent Lecavalier,2000-01,20.0,3,67,80,80,25,42,67,166.0,1544.0,162,38,57,95,291.0,82,5.49,53,331,2294,9.8,0.85307896
28450,28450,Vincent Lecavalier,2001-02,21.0,4,51,68,68,23,28,51,165.0,1356.0,230,61,85,146,456.0,82,5.51,63,376,2272,9.9,0.71895957
28451,28451,Vincent Lecavalier,2002-03,22.0,5,37,76,76,20,17,37,164.0,1303.0,306,81,102,183,620.0,82,5.24,53,338,2262,9.5,0.639943
28452,28452,Vincent Lecavalier,2003-04,23.0,6,78,80,80,33,45,78,274.0,1563.0,386,114,147,261,894.0,82,5.31,60,363,2326,9.4,0.9370938
28453,28453,Vincent Lecavalier,2004-05,24.0,7,66,81,81,32,34,66,242.0,1463.0,467,146,181,327,1136.0,82,5.14,57,348,2300,9.2,0.9422983
28454,28454,Vincent Lecavalier,2006-07,26.0,8,75,80,80,35,40,75,309.0,1610.0,547,181,221,402,1445.0,82,6.05,85,480,2458,10.1,0.957797
28455,28455,Vincent Lecavalier,2007-08,27.0,9,108,82,82,52,56,108,339.0,1854.0,629,233,277,510,1784.0,82,5.76,70,398,2426,9.7,1.1096609
28456,28456,Vincent Lecavalier,2008-09,28.0,10,92,81,81,40,52,92,318.0,1859.0,710,273,329,602,2102.0,82,5.44,62,351,2383,9.4,1.0046474
28457,28457,Vincent Lecavalier,2009-10,29.0,11,67,77,77,29,38,67,291.0,1559.0,787,302,367,669,2393.0,82,5.7,65,341,2477,9.4,0.8433614
28458,28458,Vincent Lecavalier,2010-11,30.0,12,70,82,82,24,46,70,295.0,1623.0,869,326,413,739,2688.0,82,5.53,56,304,2486,9.1,0.8267553
28459,28459,Vincent Lecavalier,2011-12,31.0,13,54,65,65,25,29,54,210.0,1200.0,934,351,442,793,2898.0,82,5.46,52,291,2492,9.0,0.7674856
28460,28460,Vincent Lecavalier,2012-13,32.0,14,49,64,64,22,27,49,182.0,1212.0,998,373,469,842,3080.0,82,5.32,47,271,2439,8.9,0.7415939
28461,28461,Vincent Lecavalier,2013-14,33.0,15,32,39,39,10,22,32,86.0,697.0,1037,383,491,874,3166.0,48,5.31,29,160,1399,9.1,0.6548946
28462,28462,Vincent Lecavalier,2014-15,34.0,16,37,69,69,20,17,37,132.0,1048.0,1106,403,508,911,3298.0,82,5.34,48,269,2463,8.9,0.48041573
28463,28463,Vincent Lecavalier,2015-16,35.0,17,20,57,57,8,12,20,103.0,721.0,1163,411,520,931,3401.0,82,5.32,47,251,2453,8.9,0.34677038
28464,28464,Vincent Lecavalier,2016-17,36.0,18,18,49,49,10,8,18,67.0,649.0,1212,421,528,949,3468.0,82,5.34,48,255,2438,9.0,0.42557162
28465,28465,Vincent Trocheck,2014-15,21.0,2,8,20,20,5,3,8,38.0,378.0,20,5,3,8,38.0,82,5.34,48,269,2463,8.9,0.37488168
28466,28466,Vincent Trocheck,2015-16,22.0,3,22,50,50,7,15,22,89.0,700.0,70,12,18,30,127.0,82,5.32,47,251,2453,8.9,0.43326128
28467,28467,Vincent Trocheck,2016-17,23.0,4,53,76,76,25,28,53,174.0,1351.0,146,37,46,83,301.0,82,5.34,48,255,2438,9.0,0.6828481
28468,28468,Vincent Trocheck,2017-18,24.0,5,54,82,82,23,31,54,230.0,1708.0,228,60,77,137,531.0,82,5.45,47,245,2478,9.0,0.6938956
28469,28469,Vincent Trocheck,2018-19,25.0,6,75,82,82,31,44,75,287.0,1752.0,310,91,121,212,818.0,82,5.86,50,250,2620,9.2,0.85933334
28470,28470,Vincent Trocheck,2019-20,26.0,7,34,55,55,10,24,34,158.0,1081.0,365,101,145,246,976.0,82,5.96,47,239,2579,9.5,0.60789055
28471,28471,Vincent Trocheck,2020-21,27.0,8,38,62,62,11,27,38,141.0,1037.0,427,112,172,284,1117.0,70,5.96,42,208,2192,9.5,0.572518
28472,28472,Vinni Lettieri,2018-19,23.0,2,5,19,19,1,4,5,28.0,229.0,19,1,4,5,28.0,82,5.86,50,250,2620,9.2,0.23595497
28473,28473,Vinni Lettieri,2019-20,24.0,3,3,27,27,1,2,3,40.0,274.0,46,2,6,8,68.0,82,5.96,47,239,2579,9.5,0.19322538
28474,28474,Vinnie Hinostroza,2016-17,22.0,2,0,7,7,0,0,0,6.0,61.0,7,0,0,0,6.0,82,5.34,48,255,2438,9.0,0.17757523
28475,28475,Vinnie Hinostroza,2017-18,23.0,3,14,49,49,6,8,14,76.0,587.0,56,6,8,14,82.0,82,5.45,47,245,2478,9.0,0.32938236
28476,28476,Vinnie Hinostroza,2018-19,24.0,4,25,50,50,7,18,25,86.0,691.0,106,13,26,39,168.0,82,5.86,50,250,2620,9.2,0.4123721
28477,28477,Vinnie Hinostroza,2019-20,25.0,5,39,72,72,16,23,39,152.0,1099.0,178,29,49,78,320.0,82,5.96,47,239,2579,9.5,0.5168765
28478,28478,Vinnie Hinostroza,2020-21,26.0,6,22,68,68,5,17,22,132.0,891.0,246,34,66,100,452.0,70,5.96,42,208,2192,9.5,0.36647266
28479,28479,Vinny Prospal,1997-98,22.0,2,15,18,18,5,10,15,35.0,,18,5,10,15,35.0,82,5.83,55,336,2444,9.8,0.4622946
28480,28480,Vinny Prospal,1998-99,23.0,3,25,56,56,6,19,25,88.0,,74,11,29,40,123.0,82,5.28,57,380,2242,9.6,0.42729285
28481,28481,Vinny Prospal,1999-00,24.0,4,36,79,79,10,26,36,114.0,1031.0,153,21,55,76,237.0,82,5.27,57,359,2285,9.4,0.42552567
28482,28482,Vinny Prospal,2000-01,25.0,5,55,79,79,22,33,55,204.0,1299.0,232,43,88,131,441.0,82,5.49,53,331,2294,9.8,0.68296087
28483,28483,Vinny Prospal,2001-02,26.0,6,29,74,74,5,24,29,136.0,1082.0,306,48,112,160,577.0,82,5.51,63,376,2272,9.9,0.46546015
28484,28484,Vinny Prospal,2002-03,27.0,7,55,81,81,18,37,55,166.0,1419.0,387,66,149,215,743.0,82,5.24,53,338,2262,9.5,0.6821159
28485,28485,Vinny Prospal,2003-04,28.0,8,79,80,80,22,57,79,134.0,1493.0,467,88,206,294,877.0,82,5.31,60,363,2326,9.4,0.82656205
28486,28486,Vinny Prospal,2004-05,29.0,9,54,82,82,19,35,54,185.0,1527.0,549,107,241,348,1062.0,82,5.14,57,348,2300,9.2,0.7526362
28487,28487,Vinny Prospal,2006-07,31.0,10,80,81,81,25,55,80,236.0,1553.0,630,132,296,428,1298.0,82,6.05,85,480,2458,10.1,0.80934614
28488,28488,Vinny Prospal,2007-08,32.0,11,55,82,82,14,41,55,219.0,1563.0,712,146,337,483,1517.0,82,5.76,70,398,2426,9.7,0.6524042
28489,28489,Vinny Prospal,2008-09,33.0,12,71,80,80,33,38,71,215.0,1550.0,792,179,375,554,1732.0,82,5.44,62,351,2383,9.4,0.7829708
28490,28490,Vinny Prospal,2009-10,34.0,13,45,82,82,19,26,45,194.0,1450.0,874,198,401,599,1926.0,82,5.7,65,341,2477,9.4,0.59615827
28491,28491,Vinny Prospal,2010-11,35.0,14,58,75,75,20,38,58,180.0,1508.0,949,218,439,657,2106.0,82,5.53,56,304,2486,9.1,0.63008773
28492,28492,Vinny Prospal,2011-12,36.0,15,23,29,29,9,14,23,61.0,445.0,978,227,453,680,2167.0,82,5.46,52,291,2492,9.0,0.5281839
28493,28493,Vinny Prospal,2012-13,37.0,16,55,82,82,16,39,55,165.0,1467.0,1060,243,492,735,2332.0,82,5.32,47,271,2439,8.9,0.58922905
28494,28494,Vinny Prospal,2013-14,38.0,17,30,48,48,12,18,30,85.0,793.0,1108,255,510,765,2417.0,48,5.31,29,160,1399,9.1,0.51785314
28495,28495,Vitali Karamnov,1993-94,25.0,2,1,7,7,0,1,1,7.0,,7,0,1,1,7.0,84,7.25,87,443,2603,11.7,0.20905724
28496,28496,Vitali Karamnov,1994-95,26.0,3,21,59,59,9,12,21,66.0,,66,9,13,22,73.0,84,6.48,76,407,2545,10.7,0.29526332
28497,28497,Vitali Karamnov,1995-96,27.0,4,10,26,26,3,7,10,22.0,,92,12,20,32,95.0,48,5.97,37,209,1408,10.2,0.31353402
28498,28498,Vitali Prokhorov,1993-94,27.0,2,5,26,26,4,1,5,21.0,,26,4,1,5,21.0,84,7.25,87,443,2603,11.7,0.25515836
28499,28499,Vitali Prokhorov,1994-95,28.0,3,25,55,55,15,10,25,85.0,,81,19,11,30,106.0,84,6.48,76,407,2545,10.7,0.384906
28500,28500,Vitali Prokhorov,1995-96,29.0,4,0,2,2,0,0,0,0.0,,83,19,11,30,106.0,48,5.97,37,209,1408,10.2,0.19191062
28501,28501,Vitali Yachmenev,1996-97,22.0,2,53,80,80,19,34,53,133.0,,80,19,34,53,133.0,82,6.29,74,413,2481,10.4,0.62755895
28502,28502,Vitali Yachmenev,1997-98,23.0,3,32,65,65,10,22,32,97.0,,145,29,56,85,230.0,82,5.83,55,336,2444,9.8,0.43525606
28503,28503,Vitali Yachmenev,1998-99,24.0,4,1,4,4,0,1,1,4.0,,149,29,57,86,234.0,82,5.28,57,380,2242,9.6,0.34318662
28504,28504,Vitali Yachmenev,1999-00,25.0,5,17,55,55,7,10,17,83.0,831.0,204,36,67,103,317.0,82,5.27,57,359,2285,9.4,0.3555671
28505,28505,Vitali Yachmenev,2000-01,26.0,6,32,68,68,16,16,32,120.0,1049.0,272,52,83,135,437.0,82,5.49,53,331,2294,9.8,0.4722542
28506,28506,Vitali Yachmenev,2001-02,27.0,7,34,78,78,15,19,34,123.0,1393.0,350,67,102,169,560.0,82,5.51,63,376,2272,9.9,0.45917282
28507,28507,Vitali Yachmenev,2002-03,28.0,8,27,75,75,11,16,27,103.0,1316.0,425,78,118,196,663.0,82,5.24,53,338,2262,9.5,0.3585589
28508,28508,Vitali Yachmenev,2003-04,29.0,9,20,62,62,5,15,20,68.0,1032.0,487,83,133,216,731.0,82,5.31,60,363,2326,9.4,0.2866922
28509,28509,Vitaly Abramov,2019-20,21.0,2,0,1,1,0,0,0,0.0,14.0,1,0,0,0,0.0,82,5.96,47,239,2579,9.5,0.22609541
28510,28510,Vitaly Abramov,2020-21,22.0,3,1,2,2,1,0,1,3.0,12.0,3,1,0,1,3.0,70,5.96,42,208,2192,9.5,0.25457546
28511,28511,Vitaly Vishnevski,2000-01,20.0,2,2,31,31,1,1,2,17.0,516.0,31,1,1,2,17.0,82,5.49,53,331,2294,9.8,0.19972888
28512,28512,Vitaly Vishnevski,2001-02,21.0,3,11,76,76,1,10,11,49.0,1462.0,107,2,11,13,66.0,82,5.51,63,376,2272,9.9,0.19570997
28513,28513,Vitaly Vishnevski,2002-03,22.0,4,3,74,74,0,3,3,54.0,1302.0,181,2,14,16,120.0,82,5.24,53,338,2262,9.5,0.1488384
28514,28514,Vitaly Vishnevski,2003-04,23.0,5,8,80,80,2,6,8,65.0,1134.0,261,4,20,24,185.0,82,5.31,60,363,2326,9.4,0.20390725
28515,28515,Vitaly Vishnevski,2004-05,24.0,6,16,73,73,6,10,16,86.0,1253.0,334,10,30,40,271.0,82,5.14,57,348,2300,9.2,0.2568975
28516,28516,Vitaly Vishnevski,2006-07,26.0,7,8,82,82,1,7,8,90.0,1347.0,416,11,37,48,361.0,82,6.05,85,480,2458,10.1,0.16605192
28517,28517,Vitaly Vishnevski,2007-08,27.0,8,13,67,67,3,10,13,47.0,1154.0,483,14,47,61,408.0,82,5.76,70,398,2426,9.7,0.15096259
28518,28518,Vitaly Vishnevski,2008-09,28.0,9,7,69,69,2,5,7,48.0,1072.0,552,16,52,68,456.0,82,5.44,62,351,2383,9.4,0.15575284
28519,28519,Vitezslav Duris,1981-82,28.0,2,13,57,57,1,12,13,70.0,,57,1,12,13,70.0,80,7.69,77,340,2441,12.6,0.23318547
28520,28520,Vitezslav Duris,1983-84,30.0,3,10,32,32,2,8,10,49.0,,89,3,20,23,119.0,80,7.73,71,310,2444,12.7,0.28930092
28521,28521,Vladimir Chebaturkin,1998-99,23.0,2,2,2,2,0,2,2,0.0,,2,0,2,2,0.0,82,5.28,57,380,2242,9.6,0.17675713
28522,28522,Vladimir Chebaturkin,1999-00,24.0,3,0,8,8,0,0,0,4.0,138.0,10,0,2,2,4.0,82,5.27,57,359,2285,9.4,0.16378409
28523,28523,Vladimir Chebaturkin,2000-01,25.0,4,2,17,17,1,1,2,9.0,288.0,27,1,3,4,13.0,82,5.49,53,331,2294,9.8,0.17030486
28524,28524,Vladimir Chebaturkin,2001-02,26.0,5,3,22,22,1,2,3,5.0,289.0,49,2,5,7,18.0,82,5.51,63,376,2272,9.9,0.122915626
28525,28525,Vladimir Chebaturkin,2002-03,27.0,6,2,13,13,0,2,2,8.0,165.0,62,2,7,9,26.0,82,5.24,53,338,2262,9.5,0.14405894
28526,28526,Vladimir Konstantinov,1992-93,25.0,2,34,79,79,8,26,34,108.0,,79,8,26,34,108.0,80,6.96,77,402,2440,11.4,0.42074576
28527,28527,Vladimir Konstantinov,1993-94,26.0,3,22,82,82,5,17,22,85.0,,161,13,43,56,193.0,84,7.25,87,443,2603,11.7,0.26962525
28528,28528,Vladimir Konstantinov,1994-95,27.0,4,33,80,80,12,21,33,97.0,,241,25,64,89,290.0,84,6.48,76,407,2545,10.7,0.39128098
28529,28529,Vladimir Konstantinov,1995-96,28.0,5,14,47,47,3,11,14,57.0,,288,28,75,103,347.0,48,5.97,37,209,1408,10.2,0.30011663
28530,28530,Vladimir Konstantinov,1996-97,29.0,6,34,81,81,14,20,34,168.0,,369,42,95,137,515.0,82,6.29,74,413,2481,10.4,0.4263042
28531,28531,Vladimir Konstantinov,1997-98,30.0,7,38,77,77,5,33,38,141.0,,446,47,128,175,656.0,82,5.83,55,336,2444,9.8,0.42552572
28532,28532,Vladimir Krutov,1990-91,30.0,2,34,61,61,11,23,34,81.0,,61,11,23,34,81.0,80,7.37,76,367,2421,12.2,0.44977808
28533,28533,Vladimir Malakhov,1993-94,25.0,2,52,64,64,14,38,52,178.0,,64,14,38,52,178.0,84,7.25,87,443,2603,11.7,0.66199344
28534,28534,Vladimir Malakhov,1994-95,26.0,3,57,76,76,10,47,57,235.0,,140,24,85,109,413.0,84,6.48,76,407,2545,10.7,0.6337087
28535,28535,Vladimir Malakhov,1995-96,27.0,4,21,40,40,4,17,21,91.0,,180,28,102,130,504.0,48,5.97,37,209,1408,10.2,0.5422782
28536,28536,Vladimir Malakhov,1996-97,28.0,5,28,61,61,5,23,28,122.0,,241,33,125,158,626.0,82,6.29,74,413,2481,10.4,0.47567934
28537,28537,Vladimir Malakhov,1997-98,29.0,6,30,65,65,10,20,30,177.0,,306,43,145,188,803.0,82,5.83,55,336,2444,9.8,0.53316694
28538,28538,Vladimir Malakhov,1998-99,30.0,7,44,74,74,13,31,44,166.0,,380,56,176,232,969.0,82,5.28,57,380,2242,9.6,0.49853277
28539,28539,Vladimir Malakhov,1999-00,31.0,8,34,62,62,13,21,34,143.0,1456.0,442,69,197,266,1112.0,82,5.27,57,359,2285,9.4,0.52096236
28540,28540,Vladimir Malakhov,2000-01,32.0,9,5,24,24,1,4,5,18.0,494.0,466,70,201,271,1130.0,82,5.49,53,331,2294,9.8,0.3297839
28541,28541,Vladimir Malakhov,2001-02,33.0,10,2,3,3,0,2,2,6.0,57.0,469,70,203,273,1136.0,82,5.51,63,376,2272,9.9,0.29836196
28542,28542,Vladimir Malakhov,2002-03,34.0,11,28,81,81,6,22,28,145.0,1847.0,550,76,225,301,1281.0,82,5.24,53,338,2262,9.5,0.35292813
28543,28543,Vladimir Malakhov,2003-04,35.0,12,17,71,71,3,14,17,131.0,1519.0,621,79,239,318,1412.0,82,5.31,60,363,2326,9.4,0.26947987
28544,28544,Vladimir Malakhov,2004-05,36.0,13,19,62,62,3,16,19,95.0,1236.0,683,82,255,337,1507.0,82,5.14,57,348,2300,9.2,0.3055213
28545,28545,Vladimir Malakhov,2006-07,38.0,14,9,29,29,4,5,9,43.0,601.0,712,86,260,346,1550.0,82,6.05,85,480,2458,10.1,0.23746157
28546,28546,Vladimir Mihalik,2009-10,23.0,2,3,11,11,0,3,3,7.0,147.0,11,0,3,3,7.0,82,5.7,65,341,2477,9.4,0.19956991
28547,28547,Vladimir Mihalik,2010-11,24.0,3,0,4,4,0,0,0,1.0,46.0,15,0,3,3,8.0,82,5.53,56,304,2486,9.1,0.15096271
28548,28548,Vladimir Orszagh,1998-99,21.0,2,1,11,11,0,1,1,9.0,,11,0,1,1,9.0,82,5.28,57,380,2242,9.6,0.22082648
28549,28549,Vladimir Orszagh,1999-00,22.0,3,1,12,12,1,0,1,5.0,79.0,23,1,1,2,14.0,82,5.27,57,359,2285,9.4,0.19616956
28550,28550,Vladimir Orszagh,2000-01,23.0,4,3,11,11,2,1,3,16.0,131.0,34,3,2,5,30.0,82,5.49,53,331,2294,9.8,0.25082797
28551,28551,Vladimir Orszagh,2002-03,25.0,5,36,79,79,15,21,36,113.0,1269.0,113,18,23,41,143.0,82,5.24,53,338,2262,9.5,0.4185773
28552,28552,Vladimir Orszagh,2003-04,26.0,6,32,78,78,16,16,32,152.0,1370.0,191,34,39,73,295.0,82,5.31,60,363,2326,9.4,0.44602445
28553,28553,Vladimir Orszagh,2004-05,27.0,7,37,82,82,16,21,37,124.0,1394.0,273,50,60,110,419.0,82,5.14,57,348,2300,9.2,0.49582782
28554,28554,Vladimir Orszagh,2006-07,29.0,8,9,16,16,4,5,9,23.0,270.0,289,54,65,119,442.0,82,6.05,85,480,2458,10.1,0.27230817
28555,28555,Vladimir Ruzicka,1990-91,27.0,2,17,25,25,11,6,17,52.0,,25,11,6,17,52.0,80,7.37,76,367,2421,12.2,0.5034998
28556,28556,Vladimir Ruzicka,1991-92,28.0,3,16,29,29,8,8,16,51.0,,54,19,14,33,103.0,80,6.91,71,366,2385,11.6,0.43118078
28557,28557,Vladimir Ruzicka,1992-93,29.0,4,75,77,77,39,36,75,228.0,,131,58,50,108,331.0,80,6.96,77,402,2440,11.4,0.8468747
28558,28558,Vladimir Ruzicka,1993-94,30.0,5,41,60,60,19,22,41,146.0,,191,77,72,149,477.0,84,7.25,87,443,2603,11.7,0.5939462
28559,28559,Vladimir Ruzicka,1994-95,31.0,6,18,42,42,5,13,18,64.0,,233,82,85,167,541.0,84,6.48,76,407,2545,10.7,0.43023247
28560,28560,Vladimir Sobotka,2008-09,21.0,2,7,48,48,1,6,7,40.0,424.0,48,1,6,7,40.0,82,5.44,62,351,2383,9.4,0.21600568
28561,28561,Vladimir Sobotka,2009-10,22.0,3,5,25,25,1,4,5,19.0,264.0,73,2,10,12,59.0,82,5.7,65,341,2477,9.4,0.19725251
28562,28562,Vladimir Sobotka,2010-11,23.0,4,10,61,61,4,6,10,67.0,677.0,134,6,16,22,126.0,82,5.53,56,304,2486,9.1,0.2317748
28563,28563,Vladimir Sobotka,2011-12,24.0,5,29,65,65,7,22,29,75.0,1052.0,199,13,38,51,201.0,82,5.46,52,291,2492,9.0,0.35216874
28564,28564,Vladimir Sobotka,2012-13,25.0,6,20,73,73,5,15,20,117.0,1157.0,272,18,53,71,318.0,82,5.32,47,271,2439,8.9,0.27886543
28565,28565,Vladimir Sobotka,2013-14,26.0,7,19,48,48,8,11,19,69.0,742.0,320,26,64,90,387.0,48,5.31,29,160,1399,9.1,0.37825257
28566,28566,Vladimir Sobotka,2014-15,27.0,8,33,61,61,9,24,33,102.0,1021.0,381,35,88,123,489.0,82,5.34,48,269,2463,8.9,0.47025862
28567,28567,Vladimir Sobotka,2017-18,30.0,9,1,1,1,1,0,1,2.0,17.0,382,36,88,124,491.0,82,5.45,47,245,2478,9.0,0.20503232
28568,28568,Vladimir Sobotka,2018-19,31.0,10,31,81,81,11,20,31,136.0,1387.0,463,47,108,155,627.0,82,5.86,50,250,2620,9.2,0.34180427
28569,28569,Vladimir Sobotka,2019-20,32.0,11,13,69,69,5,8,13,71.0,979.0,532,52,116,168,698.0,82,5.96,47,239,2579,9.5,0.18190774
28570,28570,Vladimir Sobotka,2020-21,33.0,12,3,16,16,1,2,3,23.0,228.0,548,53,118,171,721.0,70,5.96,42,208,2192,9.5,0.2360163
28571,28571,Vladimir Tarasenko,2013-14,22.0,2,19,38,38,8,11,19,75.0,510.0,38,8,11,19,75.0,48,5.31,29,160,1399,9.1,0.5085817
28572,28572,Vladimir Tarasenko,2014-15,23.0,3,43,64,64,21,22,43,136.0,971.0,102,29,33,62,211.0,82,5.34,48,269,2463,8.9,0.63118875
28573,28573,Vladimir Tarasenko,2015-16,24.0,4,73,77,77,37,36,73,264.0,1357.0,179,66,69,135,475.0,82,5.32,47,251,2453,8.9,0.8899393
28574,28574,Vladimir Tarasenko,2016-17,25.0,5,74,80,80,40,34,74,292.0,1491.0,259,106,103,209,767.0,82,5.34,48,255,2438,9.0,0.91836804
28575,28575,Vladimir Tarasenko,2017-18,26.0,6,75,82,82,39,36,75,286.0,1515.0,341,145,139,284,1053.0,82,5.45,47,245,2478,9.0,0.9486879
28576,28576,Vladimir Tarasenko,2018-19,27.0,7,66,80,80,33,33,66,306.0,1525.0,421,178,172,350,1359.0,82,5.86,50,250,2620,9.2,0.80654967
28577,28577,Vladimir Tarasenko,2019-20,28.0,8,68,76,76,33,35,68,275.0,1398.0,497,211,207,418,1634.0,82,5.96,47,239,2579,9.5,0.86330956
28578,28578,Vladimir Tarasenko,2020-21,29.0,9,10,10,10,3,7,10,26.0,162.0,507,214,214,428,1660.0,70,5.96,42,208,2192,9.5,0.60633314
28579,28579,Vladimir Tsyplakov,1996-97,27.0,2,10,23,23,5,5,10,40.0,,23,5,5,10,40.0,82,6.29,74,413,2481,10.4,0.29449338
28580,28580,Vladimir Tsyplakov,1997-98,28.0,3,39,67,67,16,23,39,118.0,,90,21,28,49,158.0,82,5.83,55,336,2444,9.8,0.48558617
28581,28581,Vladimir Tsyplakov,1998-99,29.0,4,52,73,73,18,34,52,113.0,,163,39,62,101,271.0,82,5.28,57,380,2242,9.6,0.5801023
28582,28582,Vladimir Tsyplakov,1999-00,30.0,5,23,69,69,11,12,23,111.0,1130.0,232,50,74,124,382.0,82,5.27,57,359,2285,9.4,0.37062776
28583,28583,Vladimir Tsyplakov,2000-01,31.0,6,32,63,63,12,20,32,76.0,774.0,295,62,94,156,458.0,82,5.49,53,331,2294,9.8,0.4287755
28584,28584,Vladimir Tsyplakov,2001-02,32.0,7,14,36,36,7,7,14,39.0,407.0,331,69,101,170,497.0,82,5.51,63,376,2272,9.9,0.37664214
28585,28585,Vladimir Vorobiev,1997-98,25.0,2,10,16,16,5,5,10,42.0,,16,5,5,10,42.0,82,5.83,55,336,2444,9.8,0.2797817
28586,28586,Vladimir Vorobiev,1998-99,26.0,3,4,15,15,2,2,4,27.0,,31,7,7,14,69.0,82,5.28,57,380,2242,9.6,0.23836422
28587,28587,Vladimir Vorobiev,1999-00,27.0,4,2,2,2,2,0,2,5.0,23.0,33,9,7,16,74.0,82,5.27,57,359,2285,9.4,0.22073895
28588,28588,Vladimir Vujtek,1992-93,20.0,2,0,2,2,0,0,0,1.0,,2,0,0,0,1.0,80,6.96,77,402,2440,11.4,0.2755677
28589,28589,Vladimir Vujtek,1993-94,21.0,3,11,30,30,1,10,11,49.0,,32,1,10,11,50.0,84,7.25,87,443,2603,11.7,0.29072866
28590,28590,Vladimir Vujtek,1994-95,22.0,4,19,40,40,4,15,19,66.0,,72,5,25,30,116.0,84,6.48,76,407,2545,10.7,0.40780807
28591,28591,Vladimir Vujtek,1998-99,26.0,5,6,30,30,2,4,6,44.0,,102,7,29,36,160.0,82,5.28,57,380,2242,9.6,0.24094546
28592,28592,Vladimir Vujtek,2000-01,28.0,6,0,3,3,0,0,0,2.0,33.0,105,7,29,36,162.0,82,5.49,53,331,2294,9.8,0.16882765
28593,28593,Vladimir Vujtek,2003-04,31.0,7,1,5,5,0,1,1,3.0,38.0,110,7,30,37,165.0,82,5.31,60,363,2326,9.4,0.1677778
28594,28594,Vladimir Zharkov,2010-11,23.0,2,10,40,40,0,10,10,54.0,458.0,40,0,10,10,54.0,82,5.53,56,304,2486,9.1,0.21300909
28595,28595,Vladimir Zharkov,2011-12,24.0,3,4,38,38,2,2,4,40.0,431.0,78,2,12,14,94.0,82,5.46,52,291,2492,9.0,0.18167248
28596,28596,Vladimir Zharkov,2012-13,25.0,4,0,4,4,0,0,0,0.0,20.0,82,2,12,14,94.0,82,5.32,47,271,2439,8.9,0.1490424
28597,28597,Vladislav Gavrikov,2020-21,25.0,2,18,69,69,5,13,18,81.0,1310.0,69,5,13,18,81.0,70,5.96,42,208,2192,9.5,0.29297495
28598,28598,Vladislav Kamenev,2017-18,21.0,2,0,2,2,0,0,0,1.0,20.0,2,0,0,0,1.0,82,5.45,47,245,2478,9.0,0.23246074
28599,28599,Vladislav Kamenev,2018-19,22.0,3,0,3,3,0,0,0,1.0,26.0,5,0,0,0,2.0,82,5.86,50,250,2620,9.2,0.160552
28600,28600,Vladislav Kamenev,2019-20,23.0,4,5,23,23,2,3,5,22.0,208.0,28,2,3,5,24.0,82,5.96,47,239,2579,9.5,0.24539357
28601,28601,Vladislav Kamenev,2020-21,24.0,5,8,38,38,1,7,8,32.0,341.0,66,3,10,13,56.0,70,5.96,42,208,2192,9.5,0.18426076
28602,28602,Vladislav Namestnikov,2014-15,22.0,2,0,4,4,0,0,0,4.0,38.0,4,0,0,0,4.0,82,5.34,48,269,2463,8.9,0.18369669
28603,28603,Vladislav Namestnikov,2015-16,23.0,3,16,43,43,9,7,16,46.0,516.0,47,9,7,16,50.0,82,5.32,47,251,2453,8.9,0.33721888
28604,28604,Vladislav Namestnikov,2016-17,24.0,4,35,80,80,14,21,35,106.0,1129.0,127,23,28,51,156.0,82,5.34,48,255,2438,9.0,0.40111458
28605,28605,Vladislav Namestnikov,2017-18,25.0,5,28,74,74,10,18,28,114.0,1094.0,201,33,46,79,270.0,82,5.45,47,245,2478,9.0,0.35536158
28606,28606,Vladislav Namestnikov,2018-19,26.0,6,48,81,81,22,26,48,155.0,1384.0,282,55,72,127,425.0,82,5.86,50,250,2620,9.2,0.5716211
28607,28607,Vladislav Namestnikov,2019-20,27.0,7,31,78,78,11,20,31,119.0,1232.0,360,66,92,158,544.0,82,5.96,47,239,2579,9.5,0.41837016
28608,28608,Vladislav Namestnikov,2020-21,28.0,8,31,65,65,17,14,31,98.0,979.0,425,83,106,189,642.0,70,5.96,42,208,2192,9.5,0.4610691
28609,28609,Vlastimil Kroupa,1994-95,19.0,2,4,27,27,1,3,4,16.0,,27,1,3,4,16.0,84,6.48,76,407,2545,10.7,0.24055511
28610,28610,Vlastimil Kroupa,1995-96,20.0,3,2,14,14,0,2,2,4.0,,41,1,5,6,20.0,48,5.97,37,209,1408,10.2,0.23751596
28611,28611,Vlastimil Kroupa,1996-97,21.0,4,8,27,27,1,7,8,11.0,,68,2,12,14,31.0,82,6.29,74,413,2481,10.4,0.22507313
28612,28612,Vlastimil Kroupa,1997-98,22.0,5,8,35,35,2,6,8,24.0,,103,4,18,22,55.0,82,5.83,55,336,2444,9.8,0.2677393
28613,28613,Vlastimil Kroupa,1998-99,23.0,6,1,2,2,0,1,1,1.0,,105,4,19,23,56.0,82,5.28,57,380,2242,9.6,0.22131944
28614,28614,Vojtech Mozik,2016-17,24.0,2,0,7,7,0,0,0,6.0,93.0,7,0,0,0,6.0,82,5.34,48,255,2438,9.0,0.16909173
28615,28615,Vojtech Polak,2006-07,21.0,2,0,3,3,0,0,0,3.0,20.0,3,0,0,0,3.0,82,6.05,85,480,2458,10.1,0.21176249
28616,28616,Vojtech Polak,2007-08,22.0,3,0,2,2,0,0,0,2.0,15.0,5,0,0,0,5.0,82,5.76,70,398,2426,9.7,0.18489453
28617,28617,Vyacheslav Kozlov,1992-93,20.0,2,2,7,7,0,2,2,9.0,,7,0,2,2,9.0,80,6.96,77,402,2440,11.4,0.3038751
28618,28618,Vyacheslav Kozlov,1993-94,21.0,3,5,17,17,4,1,5,26.0,,24,4,3,7,35.0,84,7.25,87,443,2603,11.7,0.42039508
28619,28619,Vyacheslav Kozlov,1994-95,22.0,4,73,77,77,34,39,73,202.0,,101,38,42,80,237.0,84,6.48,76,407,2545,10.7,0.8264444
28620,28620,Vyacheslav Kozlov,1995-96,23.0,5,33,46,46,13,20,33,97.0,,147,51,62,113,334.0,48,5.97,37,209,1408,10.2,0.66862357
28621,28621,Vyacheslav Kozlov,1996-97,24.0,6,73,82,82,36,37,73,237.0,,229,87,99,186,571.0,82,6.29,74,413,2481,10.4,0.8327211
28622,28622,Vyacheslav Kozlov,1997-98,25.0,7,45,75,75,23,22,45,211.0,,304,110,121,231,782.0,82,5.83,55,336,2444,9.8,0.63998616
28623,28623,Vyacheslav Kozlov,1998-99,26.0,8,52,80,80,25,27,52,221.0,,384,135,148,283,1003.0,82,5.28,57,380,2242,9.6,0.6739034
28624,28624,Vyacheslav Kozlov,1999-00,27.0,9,58,79,79,29,29,58,209.0,1267.0,463,164,177,341,1212.0,82,5.27,57,359,2285,9.4,0.685106
28625,28625,Vyacheslav Kozlov,2000-01,28.0,10,36,72,72,18,18,36,165.0,1116.0,535,182,195,377,1377.0,82,5.49,53,331,2294,9.8,0.51880217
28626,28626,Vyacheslav Kozlov,2001-02,29.0,11,38,72,72,20,18,38,187.0,1060.0,607,202,213,415,1564.0,82,5.51,63,376,2272,9.9,0.52584344
28627,28627,Vyacheslav Kozlov,2002-03,30.0,12,22,38,38,9,13,22,68.0,628.0,645,211,226,437,1632.0,82,5.24,53,338,2262,9.5,0.59372646
28628,28628,Vyacheslav Kozlov,2003-04,31.0,13,70,79,79,21,49,70,185.0,1581.0,724,232,275,507,1817.0,82,5.31,60,363,2326,9.4,0.7624282
28629,28629,Vyacheslav Kozlov,2004-05,32.0,14,52,76,76,20,32,52,191.0,1546.0,800,252,307,559,2008.0,82,5.14,57,348,2300,9.2,0.7364503
28630,28630,Vyacheslav Kozlov,2006-07,34.0,15,71,82,82,25,46,71,206.0,1458.0,882,277,353,630,2214.0,82,6.05,85,480,2458,10.1,0.7757474
28631,28631,Vyacheslav Kozlov,2007-08,35.0,16,80,81,81,28,52,80,190.0,1660.0,963,305,405,710,2404.0,82,5.76,70,398,2426,9.7,0.733579
28632,28632,Vyacheslav Kozlov,2008-09,36.0,17,41,82,82,17,24,41,161.0,1307.0,1045,322,429,751,2565.0,82,5.44,62,351,2383,9.4,0.5368526
28633,28633,Vyacheslav Kozlov,2009-10,37.0,18,76,82,82,26,50,76,165.0,1413.0,1127,348,479,827,2730.0,82,5.7,65,341,2477,9.4,0.70614403
28634,28634,Vyacheslav Kozlov,2010-11,38.0,19,26,55,55,8,18,26,113.0,840.0,1182,356,497,853,2843.0,82,5.53,56,304,2486,9.1,0.47189873
28635,28635,Wade Belak,1997-98,21.0,2,0,5,5,0,0,0,1.0,,5,0,0,0,1.0,82,5.83,55,336,2444,9.8,0.1903837
28636,28636,Wade Belak,1998-99,22.0,3,2,8,8,1,1,2,2.0,,13,1,1,2,3.0,82,5.28,57,380,2242,9.6,0.20163581
28637,28637,Wade Belak,1999-00,23.0,4,1,31,31,0,1,1,7.0,247.0,44,1,2,3,10.0,82,5.27,57,359,2285,9.4,0.12417871
28638,28638,Wade Belak,2000-01,24.0,5,2,40,40,0,2,2,11.0,302.0,84,1,4,5,21.0,82,5.49,53,331,2294,9.8,0.07631007
28639,28639,Wade Belak,2001-02,25.0,6,2,39,39,1,1,2,16.0,377.0,123,2,5,7,37.0,82,5.51,63,376,2272,9.9,0.08748308
28640,28640,Wade Belak,2002-03,26.0,7,4,63,63,1,3,4,47.0,582.0,186,3,8,11,84.0,82,5.24,53,338,2262,9.5,0.12885103
28641,28641,Wade Belak,2003-04,27.0,8,9,55,55,3,6,9,33.0,596.0,241,6,14,20,117.0,82,5.31,60,363,2326,9.4,0.12741211
28642,28642,Wade Belak,2004-05,28.0,9,2,34,34,1,1,2,15.0,238.0,275,7,15,22,132.0,82,5.14,57,348,2300,9.2,0.13624296
28643,28643,Wade Belak,2006-07,30.0,10,3,55,55,0,3,3,16.0,549.0,330,7,18,25,148.0,82,6.05,85,480,2458,10.1,0.0625869
28644,28644,Wade Belak,2007-08,31.0,11,3,65,65,0,3,3,16.0,327.0,395,7,21,28,164.0,82,5.76,70,398,2426,9.7,0.057811707
28645,28645,Wade Belak,2008-09,32.0,12,1,47,47,1,0,1,17.0,192.0,442,8,21,29,181.0,82,5.44,62,351,2383,9.4,0.07520679
28646,28646,Wade Belak,2009-10,33.0,13,2,53,53,0,2,2,19.0,278.0,495,8,23,31,200.0,82,5.7,65,341,2477,9.4,0.06045291
28647,28647,Wade Belak,2010-11,34.0,14,2,39,39,0,2,2,8.0,170.0,534,8,25,33,208.0,82,5.53,56,304,2486,9.1,0.04884997
28648,28648,Wade Belak,2011-12,35.0,15,0,15,15,0,0,0,4.0,57.0,549,8,25,33,212.0,82,5.46,52,291,2492,9.0,0.07160622
28649,28649,Wade Brookbank,2004-05,27.0,2,2,29,29,2,0,2,7.0,108.0,29,2,0,2,7.0,82,5.14,57,348,2300,9.2,0.16621873
28650,28650,Wade Brookbank,2006-07,29.0,3,3,32,32,1,2,3,10.0,158.0,61,3,2,5,17.0,82,6.05,85,480,2458,10.1,0.115134954
28651,28651,Wade Brookbank,2007-08,30.0,4,1,7,7,1,0,1,1.0,31.0,68,4,2,6,18.0,82,5.76,70,398,2426,9.7,0.13355023
28652,28652,Wade Brookbank,2008-09,31.0,5,2,32,32,1,1,2,12.0,122.0,100,5,3,8,30.0,82,5.44,62,351,2383,9.4,0.1059092
28653,28653,Wade Brookbank,2009-10,32.0,6,1,27,27,1,0,1,8.0,67.0,127,6,3,9,38.0,82,5.7,65,341,2477,9.4,0.086042136
28654,28654,Wade Campbell,1983-84,23.0,2,3,42,42,1,2,3,37.0,,42,1,2,3,37.0,80,7.73,71,310,2444,12.7,0.20479968
28655,28655,Wade Campbell,1984-85,24.0,3,21,79,79,7,14,21,92.0,,121,8,16,24,129.0,80,7.89,74,336,2448,12.9,0.30724147
28656,28656,Wade Campbell,1985-86,25.0,4,7,40,40,1,6,7,28.0,,161,9,22,31,157.0,80,7.77,71,321,2447,12.7,0.16407287
28657,28657,Wade Campbell,1986-87,26.0,5,1,32,32,0,1,1,13.0,,193,9,23,32,170.0,80,7.94,82,370,2484,12.8,0.14511001
28658,28658,Wade Campbell,1987-88,27.0,6,3,14,14,0,3,3,20.0,,207,9,26,35,190.0,80,7.34,72,344,2400,12.2,0.21127039
28659,28659,Wade Campbell,1988-89,28.0,7,1,6,6,0,1,1,3.0,,213,9,27,36,193.0,80,7.43,89,437,2435,12.2,0.15919802
28660,28660,Wade Megan,2017-18,27.0,2,1,3,3,1,0,1,6.0,26.0,3,1,0,1,6.0,82,5.45,47,245,2478,9.0,0.20676789
28661,28661,Wade Megan,2018-19,28.0,3,0,1,1,0,0,0,1.0,8.0,4,1,0,1,7.0,82,5.86,50,250,2620,9.2,0.15568393
28662,28662,Wade Megan,2019-20,29.0,4,1,11,11,0,1,1,16.0,87.0,15,1,1,2,23.0,82,5.96,47,239,2579,9.5,0.17364526
28663,28663,Wade Redden,1997-98,20.0,2,30,82,82,6,24,30,102.0,,82,6,24,30,102.0,82,5.83,55,336,2444,9.8,0.4281455
28664,28664,Wade Redden,1998-99,21.0,3,22,80,80,8,14,22,103.0,,162,14,38,52,205.0,82,5.28,57,380,2242,9.6,0.362384
28665,28665,Wade Redden,1999-00,22.0,4,29,72,72,8,21,29,127.0,1688.0,234,22,59,81,332.0,82,5.27,57,359,2285,9.4,0.4354031
28666,28666,Wade Redden,2000-01,23.0,5,36,81,81,10,26,36,163.0,1921.0,315,32,85,117,495.0,82,5.49,53,331,2294,9.8,0.5127231
28667,28667,Wade Redden,2001-02,24.0,6,47,78,78,10,37,47,159.0,1972.0,393,42,122,164,654.0,82,5.51,63,376,2272,9.9,0.596117
28668,28668,Wade Redden,2002-03,25.0,7,34,79,79,9,25,34,156.0,1983.0,472,51,147,198,810.0,82,5.24,53,338,2262,9.5,0.49926275
28669,28669,Wade Redden,2003-04,26.0,8,45,76,76,10,35,45,154.0,1930.0,548,61,182,243,964.0,82,5.31,60,363,2326,9.4,0.5582636
28670,28670,Wade Redden,2004-05,27.0,9,43,81,81,17,26,43,175.0,2017.0,629,78,208,286,1139.0,82,5.14,57,348,2300,9.2,0.6301702
28671,28671,Wade Redden,2006-07,29.0,10,50,65,65,10,40,50,153.0,1526.0,694,88,248,336,1292.0,82,6.05,85,480,2458,10.1,0.5955751
28672,28672,Wade Redden,2007-08,30.0,11,36,64,64,7,29,36,122.0,1466.0,758,95,277,372,1414.0,82,5.76,70,398,2426,9.7,0.46238497
28673,28673,Wade Redden,2008-09,31.0,12,38,80,80,6,32,38,136.0,1777.0,838,101,309,410,1550.0,82,5.44,62,351,2383,9.4,0.424938
28674,28674,Wade Redden,2009-10,32.0,13,26,81,81,3,23,26,161.0,1809.0,919,104,332,436,1711.0,82,5.7,65,341,2477,9.4,0.33755678
28675,28675,Wade Redden,2010-11,33.0,14,14,75,75,2,12,14,66.0,1314.0,994,106,344,450,1777.0,82,5.53,56,304,2486,9.1,0.18652412
28676,28676,Wade Redden,2013-14,36.0,15,7,29,29,3,4,7,28.0,437.0,1023,109,348,457,1805.0,48,5.31,29,160,1399,9.1,0.22639444
28677,28677,Wade Skolney,2006-07,25.0,2,0,1,1,0,0,0,0.0,7.0,1,0,0,0,0.0,82,6.05,85,480,2458,10.1,0.14312965
28678,28678,Wally Schreiber,1988-89,26.0,2,11,16,16,6,5,11,29.0,,16,6,5,11,29.0,80,7.43,89,437,2435,12.2,0.40773213
28679,28679,Wally Schreiber,1989-90,27.0,3,7,25,25,2,5,7,41.0,,41,8,10,18,70.0,80,7.48,85,403,2430,12.3,0.27833527
28680,28680,Wally Weir,1980-81,26.0,2,15,73,73,3,12,15,91.0,,73,3,12,15,91.0,80,7.03,61,280,2352,12.0,0.27450532
28681,28681,Wally Weir,1981-82,27.0,3,14,54,54,6,8,14,50.0,,127,9,20,29,141.0,80,7.69,77,340,2441,12.6,0.2778628
28682,28682,Wally Weir,1982-83,28.0,4,8,62,62,3,5,8,46.0,,189,12,25,37,187.0,80,8.03,73,320,2489,12.9,0.19406322
28683,28683,Wally Weir,1983-84,29.0,5,16,58,58,5,11,16,50.0,,247,17,36,53,237.0,80,7.73,71,310,2444,12.7,0.25944847
28684,28684,Wally Weir,1984-85,30.0,6,5,25,25,2,3,5,16.0,,272,19,39,58,253.0,80,7.89,74,336,2448,12.9,0.24950913
28685,28685,Wally Weir,1985-86,31.0,7,8,48,48,2,6,8,32.0,,320,21,45,66,285.0,80,7.77,71,321,2447,12.7,0.17305064
28686,28686,Walt Poddubny,1982-83,22.0,2,7,15,15,3,4,7,24.0,,15,3,4,7,24.0,80,8.03,73,320,2489,12.9,0.40521693
28687,28687,Walt Poddubny,1983-84,23.0,3,59,72,72,28,31,59,163.0,,87,31,35,66,187.0,80,7.73,71,310,2444,12.7,0.7270206
28688,28688,Walt Poddubny,1984-85,24.0,4,25,38,38,11,14,25,77.0,,125,42,49,91,264.0,80,7.89,74,336,2448,12.9,0.6385115
28689,28689,Walt Poddubny,1985-86,25.0,5,20,32,32,5,15,20,51.0,,157,47,64,111,315.0,80,7.77,71,321,2447,12.7,0.5757807
28690,28690,Walt Poddubny,1986-87,26.0,6,34,33,33,12,22,34,76.0,,190,59,86,145,391.0,80,7.94,82,370,2484,12.8,0.9049169
28691,28691,Walt Poddubny,1987-88,27.0,7,87,75,75,40,47,87,253.0,,265,99,133,232,644.0,80,7.34,72,344,2400,12.2,1.0804225
28692,28692,Walt Poddubny,1988-89,28.0,8,88,77,77,38,50,88,202.0,,342,137,183,320,846.0,80,7.43,89,437,2435,12.2,0.98925745
28693,28693,Walt Poddubny,1989-90,29.0,9,75,72,72,38,37,75,197.0,,414,175,220,395,1043.0,80,7.48,85,403,2430,12.3,0.8652545
28694,28694,Walt Poddubny,1990-91,30.0,10,14,33,33,4,10,14,50.0,,447,179,230,409,1093.0,80,7.37,76,367,2421,12.2,0.46267894
28695,28695,Walt Poddubny,1991-92,31.0,11,10,14,14,4,6,10,22.0,,461,183,236,419,1115.0,80,6.91,71,366,2385,11.6,0.4740389
28696,28696,Walt Poddubny,1992-93,32.0,12,3,7,7,1,2,3,9.0,,468,184,238,422,1124.0,80,6.96,77,402,2440,11.4,0.47608703
28697,28697,Warren Babe,1988-89,20.0,2,1,6,6,0,1,1,2.0,,6,0,1,1,2.0,80,7.43,89,437,2435,12.2,0.310199
28698,28698,Warren Babe,1989-90,21.0,3,5,14,14,2,3,5,15.0,,20,2,4,6,17.0,80,7.48,85,403,2430,12.3,0.35784036
28699,28699,Warren Babe,1991-92,23.0,4,1,1,1,0,1,1,0.0,,21,2,5,7,17.0,80,6.91,71,366,2385,11.6,0.21480834
28700,28700,Warren Foegele,2018-19,22.0,2,3,2,2,2,1,3,6.0,24.0,2,2,1,3,6.0,82,5.86,50,250,2620,9.2,0.26393244
28701,28701,Warren Foegele,2019-20,23.0,3,15,77,77,10,5,15,106.0,962.0,79,12,6,18,112.0,82,5.96,47,239,2579,9.5,0.29943815
28702,28702,Warren Foegele,2020-21,24.0,4,30,68,68,13,17,30,129.0,932.0,147,25,23,48,241.0,70,5.96,42,208,2192,9.5,0.46029872
28703,28703,Warren Holmes,1982-83,25.0,2,2,3,3,0,2,2,6.0,,3,0,2,2,6.0,80,8.03,73,320,2489,12.9,0.24996278
28704,28704,Warren Holmes,1983-84,26.0,3,24,39,39,8,16,24,66.0,,42,8,18,26,72.0,80,7.73,71,310,2444,12.7,0.42031336
28705,28705,Warren Holmes,1984-85,27.0,4,0,3,3,0,0,0,3.0,,45,8,18,26,75.0,80,7.89,74,336,2448,12.9,0.21532792
28706,28706,Warren Luhning,1998-99,23.0,2,0,8,8,0,0,0,6.0,,8,0,0,0,6.0,82,5.28,57,380,2242,9.6,0.1736787
28707,28707,Warren Luhning,1999-00,24.0,3,0,11,11,0,0,0,11.0,102.0,19,0,0,0,17.0,82,5.27,57,359,2285,9.4,0.16536313
28708,28708,Warren Luhning,2000-01,25.0,4,1,10,10,0,1,1,7.0,103.0,29,0,1,1,24.0,82,5.49,53,331,2294,9.8,0.15340132
28709,28709,Warren Miller,1980-81,26.0,2,13,55,55,7,6,13,51.0,,55,7,6,13,51.0,80,7.03,61,280,2352,12.0,0.29594183
28710,28710,Warren Miller,1981-82,27.0,3,44,77,77,22,22,44,160.0,,132,29,28,57,211.0,80,7.69,77,340,2441,12.6,0.49353877
28711,28711,Warren Miller,1982-83,28.0,4,22,74,74,10,12,22,152.0,,206,39,40,79,363.0,80,8.03,73,320,2489,12.9,0.3633172
28712,28712,Warren Miller,1983-84,29.0,5,11,56,56,1,10,11,75.0,,262,40,50,90,438.0,80,7.73,71,310,2444,12.7,0.26010898
28713,28713,Warren Peters,2009-10,27.0,2,1,16,16,1,0,1,13.0,113.0,16,1,0,1,13.0,82,5.7,65,341,2477,9.4,0.20320418
28714,28714,Warren Peters,2010-11,28.0,3,1,11,11,1,0,1,8.0,79.0,27,2,0,2,21.0,82,5.53,56,304,2486,9.1,0.169631
28715,28715,Warren Peters,2011-12,29.0,4,1,11,11,1,0,1,11.0,96.0,38,3,0,3,32.0,82,5.46,52,291,2492,9.0,0.17189193
28716,28716,Warren Peters,2012-13,30.0,5,5,58,58,1,4,5,54.0,614.0,96,4,4,8,86.0,82,5.32,47,271,2439,8.9,0.13875031
28717,28717,Warren Rychel,1989-90,22.0,2,0,2,2,0,0,0,3.0,,2,0,0,0,3.0,80,7.48,85,403,2430,12.3,0.23397675
28718,28718,Warren Rychel,1993-94,26.0,3,13,70,70,6,7,13,67.0,,72,6,7,13,70.0,84,7.25,87,443,2603,11.7,0.19334468
28719,28719,Warren Rychel,1994-95,27.0,4,19,80,80,10,9,19,105.0,,152,16,16,32,175.0,84,6.48,76,407,2545,10.7,0.23181874
28720,28720,Warren Rychel,1995-96,28.0,5,7,33,33,1,6,7,41.0,,185,17,22,39,216.0,48,5.97,37,209,1408,10.2,0.19143936
28721,28721,Warren Rychel,1996-97,29.0,6,8,52,52,6,2,8,45.0,,237,23,24,47,261.0,82,6.29,74,413,2481,10.4,0.19163635
28722,28722,Warren Rychel,1997-98,30.0,7,17,70,70,10,7,17,59.0,,307,33,31,64,320.0,82,5.83,55,336,2444,9.8,0.18931979
28723,28723,Warren Rychel,1998-99,31.0,8,11,71,71,5,6,11,66.0,,378,38,37,75,386.0,82,5.28,57,380,2242,9.6,0.1767044
28724,28724,Warren Rychel,1999-00,32.0,9,2,28,28,0,2,2,15.0,133.0,406,38,39,77,401.0,82,5.27,57,359,2285,9.4,0.13137323
28725,28725,Warren Young,1982-83,27.0,2,0,1,1,0,0,0,0.0,,1,0,0,0,0.0,80,8.03,73,320,2489,12.9,0.23809254
28726,28726,Warren Young,1983-84,28.0,3,2,4,4,1,1,2,2.0,,5,1,1,2,2.0,80,7.73,71,310,2444,12.7,0.24063864
28727,28727,Warren Young,1984-85,29.0,4,8,15,15,1,7,8,12.0,,20,2,8,10,14.0,80,7.89,74,336,2448,12.9,0.31076548
28728,28728,Warren Young,1985-86,30.0,5,72,80,80,40,32,72,131.0,,100,42,40,82,145.0,80,7.77,71,321,2447,12.7,0.7449799
28729,28729,Warren Young,1986-87,31.0,6,46,79,79,22,24,46,92.0,,179,64,64,128,237.0,80,7.94,82,370,2484,12.8,0.45706338
28730,28730,Warren Young,1987-88,32.0,7,21,50,50,8,13,21,52.0,,229,72,77,149,289.0,80,7.34,72,344,2400,12.2,0.38192713
28731,28731,Warren Young,1988-89,33.0,8,0,7,7,0,0,0,3.0,,236,72,77,149,292.0,80,7.43,89,437,2435,12.2,0.3896125
28732,28732,Wayne Gretzky,1980-81,20.0,2,137,79,79,51,86,137,284.0,,79,51,86,137,284.0,80,7.03,61,280,2352,12.0,1.78437
28733,28733,Wayne Gretzky,1981-82,21.0,3,164,80,80,55,109,164,261.0,,159,106,195,301,545.0,80,7.69,77,340,2441,12.6,2.415019
28734,28734,Wayne Gretzky,1982-83,22.0,4,212,80,80,92,120,212,370.0,,239,198,315,513,915.0,80,8.03,73,320,2489,12.9,2.4182682
28735,28735,Wayne Gretzky,1983-84,23.0,5,196,80,80,71,125,196,348.0,,319,269,440,709,1263.0,80,7.73,71,310,2444,12.7,2.5814772
28736,28736,Wayne Gretzky,1984-85,24.0,6,205,74,74,87,118,205,326.0,,393,356,558,914,1589.0,80,7.89,74,336,2448,12.9,2.602382
28737,28737,Wayne Gretzky,1985-86,25.0,7,208,80,80,73,135,208,354.0,,473,429,693,1122,1943.0,80,7.77,71,321,2447,12.7,2.6119838
28738,28738,Wayne Gretzky,1986-87,26.0,8,215,80,80,52,163,215,350.0,,553,481,856,1337,2293.0,80,7.94,82,370,2484,12.8,2.2755535
28739,28739,Wayne Gretzky,1987-88,27.0,9,183,79,79,62,121,183,288.0,,632,543,977,1520,2581.0,80,7.34,72,344,2400,12.2,2.303872
28740,28740,Wayne Gretzky,1988-89,28.0,10,149,64,64,40,109,149,211.0,,696,583,1086,1669,2792.0,80,7.43,89,437,2435,12.2,2.1199894
28741,28741,Wayne Gretzky,1989-90,29.0,11,168,78,78,54,114,168,303.0,,774,637,1200,1837,3095.0,80,7.48,85,403,2430,12.3,2.0288138
28742,28742,Wayne Gretzky,1990-91,30.0,12,142,73,73,40,102,142,236.0,,847,677,1302,1979,3331.0,80,7.37,76,367,2421,12.2,1.9687028
28743,28743,Wayne Gretzky,1991-92,31.0,13,163,78,78,41,122,163,212.0,,925,718,1424,2142,3543.0,80,6.91,71,366,2385,11.6,1.6370919
28744,28744,Wayne Gretzky,1992-93,32.0,14,121,74,74,31,90,121,215.0,,999,749,1514,2263,3758.0,80,6.96,77,402,2440,11.4,1.4138265
28745,28745,Wayne Gretzky,1993-94,33.0,15,65,45,45,16,49,65,141.0,,1044,765,1563,2328,3899.0,84,7.25,87,443,2603,11.7,1.3520944
28746,28746,Wayne Gretzky,1994-95,34.0,16,130,81,81,38,92,130,233.0,,1125,803,1655,2458,4132.0,84,6.48,76,407,2545,10.7,1.099865
28747,28747,Wayne Gretzky,1995-96,35.0,17,48,48,48,11,37,48,142.0,,1173,814,1692,2506,4274.0,48,5.97,37,209,1408,10.2,1.121325
28748,28748,Wayne Gretzky,1996-97,36.0,18,102,80,80,23,79,102,195.0,,1253,837,1771,2608,4469.0,82,6.29,74,413,2481,10.4,1.0881367
28749,28749,Wayne Gretzky,1997-98,37.0,19,97,82,82,25,72,97,286.0,,1335,862,1843,2705,4755.0,82,5.83,55,336,2444,9.8,0.96618164
28750,28750,Wayne Gretzky,1998-99,38.0,20,90,82,82,23,67,90,201.0,,1417,885,1910,2795,4956.0,82,5.28,57,380,2242,9.6,0.94692004
28751,28751,Wayne Gretzky,1999-00,39.0,21,62,70,70,9,53,62,132.0,1475.0,1487,894,1963,2857,5088.0,82,5.27,57,359,2285,9.4,0.74045
28752,28752,Wayne Groulx,1985-86,20.0,2,0,1,1,0,0,0,0.0,,1,0,0,0,0.0,80,7.77,71,321,2447,12.7,0.25912797
28753,28753,Wayne McBean,1988-89,19.0,2,1,27,27,0,1,1,21.0,,27,0,1,1,21.0,80,7.43,89,437,2435,12.2,0.2907663
28754,28754,Wayne McBean,1989-90,20.0,3,6,52,52,0,6,6,36.0,,79,0,7,7,57.0,80,7.48,85,403,2430,12.3,0.2310346
28755,28755,Wayne McBean,1990-91,21.0,4,1,5,5,0,1,1,3.0,,84,0,8,8,60.0,80,7.37,76,367,2421,12.2,0.22901064
28756,28756,Wayne McBean,1991-92,22.0,5,19,52,52,5,14,19,93.0,,136,5,22,27,153.0,80,6.91,71,366,2385,11.6,0.37020442
28757,28757,Wayne McBean,1992-93,23.0,6,6,25,25,2,4,6,51.0,,161,7,26,33,204.0,80,6.96,77,402,2440,11.4,0.30815548
28758,28758,Wayne McBean,1994-95,25.0,7,16,50,50,3,13,16,114.0,,211,10,39,49,318.0,84,6.48,76,407,2545,10.7,0.30660492
28759,28759,Wayne Presley,1985-86,20.0,2,1,3,3,0,1,1,0.0,,3,0,1,1,0.0,80,7.77,71,321,2447,12.7,0.29398775
28760,28760,Wayne Presley,1986-87,21.0,3,15,38,38,7,8,15,56.0,,41,7,9,16,56.0,80,7.94,82,370,2484,12.8,0.42748016
28761,28761,Wayne Presley,1987-88,22.0,4,61,80,80,32,29,61,167.0,,121,39,38,77,223.0,80,7.34,72,344,2400,12.2,0.8020042
28762,28762,Wayne Presley,1988-89,23.0,5,22,42,42,12,10,22,89.0,,163,51,48,99,312.0,80,7.43,89,437,2435,12.2,0.55736387
28763,28763,Wayne Presley,1989-90,24.0,6,40,72,72,21,19,40,132.0,,235,72,67,139,444.0,80,7.48,85,403,2430,12.3,0.5150183
28764,28764,Wayne Presley,1990-91,25.0,7,13,49,49,6,7,13,75.0,,284,78,74,152,519.0,80,7.37,76,367,2421,12.2,0.37490988
28765,28765,Wayne Presley,1991-92,26.0,8,34,71,71,15,19,34,141.0,,355,93,93,186,660.0,80,6.91,71,366,2385,11.6,0.4820281
28766,28766,Wayne Presley,1992-93,27.0,9,26,59,59,10,16,26,135.0,,414,103,109,212,795.0,80,6.96,77,402,2440,11.4,0.4061708
28767,28767,Wayne Presley,1993-94,28.0,10,32,79,79,15,17,32,97.0,,493,118,126,244,892.0,84,7.25,87,443,2603,11.7,0.38997427
28768,28768,Wayne Presley,1994-95,29.0,11,25,65,65,17,8,25,93.0,,558,135,134,269,985.0,84,6.48,76,407,2545,10.7,0.34635714
28769,28769,Wayne Presley,1995-96,30.0,12,19,46,46,14,5,19,90.0,,604,149,139,288,1075.0,48,5.97,37,209,1408,10.2,0.44583324
28770,28770,Wayne Presley,1996-97,31.0,13,14,80,80,6,8,14,113.0,,684,155,147,302,1188.0,82,6.29,74,413,2481,10.4,0.20783958
28771,28771,Wayne Primeau,1995-96,19.0,2,1,1,1,1,0,1,2.0,,1,1,0,1,2.0,48,5.97,37,209,1408,10.2,0.27547798
28772,28772,Wayne Primeau,1996-97,20.0,3,0,2,2,0,0,0,0.0,,3,1,0,1,2.0,82,6.29,74,413,2481,10.4,0.228291
28773,28773,Wayne Primeau,1997-98,21.0,4,6,45,45,2,4,6,25.0,,48,3,4,7,27.0,82,5.83,55,336,2444,9.8,0.20912966
28774,28774,Wayne Primeau,1998-99,22.0,5,12,69,69,6,6,12,51.0,,117,9,10,19,78.0,82,5.28,57,380,2242,9.6,0.22369781
28775,28775,Wayne Primeau,1999-00,23.0,6,13,67,67,5,8,13,55.0,691.0,184,14,18,32,133.0,82,5.27,57,359,2285,9.4,0.22662058
28776,28776,Wayne Primeau,2000-01,24.0,7,17,58,58,7,10,17,75.0,697.0,242,21,28,49,208.0,82,5.49,53,331,2294,9.8,0.29508132
28777,28777,Wayne Primeau,2001-02,25.0,8,22,75,75,3,19,22,77.0,1024.0,317,24,47,71,285.0,82,5.51,63,376,2272,9.9,0.24339879
28778,28778,Wayne Primeau,2002-03,26.0,9,10,33,33,3,7,10,28.0,417.0,350,27,54,81,313.0,82,5.24,53,338,2262,9.5,0.2301352
28779,28779,Wayne Primeau,2003-04,27.0,10,18,77,77,6,12,18,114.0,1251.0,427,33,66,99,427.0,82,5.31,60,363,2326,9.4,0.25159365
28780,28780,Wayne Primeau,2004-05,28.0,11,29,72,72,9,20,29,142.0,1114.0,499,42,86,128,569.0,82,5.14,57,348,2300,9.2,0.44425735
28781,28781,Wayne Primeau,2006-07,30.0,12,22,71,71,11,11,22,101.0,1156.0,570,53,97,150,670.0,82,6.05,85,480,2458,10.1,0.2782529
28782,28782,Wayne Primeau,2007-08,31.0,13,22,78,78,10,12,22,107.0,1056.0,648,63,109,172,777.0,82,5.76,70,398,2426,9.7,0.2523326
28783,28783,Wayne Primeau,2008-09,32.0,14,10,43,43,3,7,10,39.0,475.0,691,66,116,182,816.0,82,5.44,62,351,2383,9.4,0.1790384
28784,28784,Wayne Primeau,2009-10,33.0,15,4,24,24,0,4,4,22.0,249.0,715,66,120,186,838.0,82,5.7,65,341,2477,9.4,0.16658664
28785,28785,Wayne Primeau,2010-11,34.0,16,8,59,59,3,5,8,47.0,652.0,774,69,125,194,885.0,82,5.53,56,304,2486,9.1,0.13612017
28786,28786,Wayne Simmonds,2009-10,21.0,2,23,82,82,9,14,23,127.0,1135.0,82,9,14,23,127.0,82,5.7,65,341,2477,9.4,0.36349002
28787,28787,Wayne Simmonds,2010-11,22.0,3,40,78,78,16,24,40,127.0,1129.0,160,25,38,63,254.0,82,5.53,56,304,2486,9.1,0.5022031
28788,28788,Wayne Simmonds,2011-12,23.0,4,30,80,80,14,16,30,117.0,1076.0,240,39,54,93,371.0,82,5.46,52,291,2492,9.0,0.4751828
28789,28789,Wayne Simmonds,2012-13,24.0,5,49,82,82,28,21,49,197.0,1305.0,322,67,75,142,568.0,82,5.32,47,271,2439,8.9,0.65485585
28790,28790,Wayne Simmonds,2013-14,25.0,6,32,45,45,15,17,32,110.0,704.0,367,82,92,174,678.0,48,5.31,29,160,1399,9.1,0.68501884
28791,28791,Wayne Simmonds,2014-15,26.0,7,60,82,82,29,31,60,209.0,1375.0,449,111,123,234,887.0,82,5.34,48,269,2463,8.9,0.67153716
28792,28792,Wayne Simmonds,2015-16,27.0,8,50,75,75,28,22,50,188.0,1261.0,524,139,145,284,1075.0,82,5.32,47,251,2453,8.9,0.63150823
28793,28793,Wayne Simmonds,2016-17,28.0,9,60,81,81,32,28,60,229.0,1396.0,605,171,173,344,1304.0,82,5.34,48,255,2438,9.0,0.6835194
28794,28794,Wayne Simmonds,2017-18,29.0,10,54,82,82,31,23,54,224.0,1556.0,687,202,196,398,1528.0,82,5.45,47,245,2478,9.0,0.6698616
28795,28795,Wayne Simmonds,2018-19,30.0,11,46,75,75,24,22,46,176.0,1357.0,762,226,218,444,1704.0,82,5.86,50,250,2620,9.2,0.5852817
28796,28796,Wayne Simmonds,2019-20,31.0,12,30,79,79,17,13,30,157.0,1238.0,841,243,231,474,1861.0,82,5.96,47,239,2579,9.5,0.40500706
28797,28797,Wayne Simmonds,2020-21,32.0,13,25,68,68,8,17,25,119.0,1015.0,909,251,248,499,1980.0,70,5.96,42,208,2192,9.5,0.36254334
28798,28798,Wayne Van Dorp,1987-88,26.0,2,0,3,3,0,0,0,3.0,,3,0,0,0,3.0,80,7.34,72,344,2400,12.2,0.22362167
28799,28799,Wayne Van Dorp,1988-89,27.0,3,4,25,25,1,3,4,15.0,,28,1,3,4,18.0,80,7.43,89,437,2435,12.2,0.16308588
28800,28800,Wayne Van Dorp,1989-90,28.0,4,0,8,8,0,0,0,4.0,,36,1,3,4,22.0,80,7.48,85,403,2430,12.3,0.15739635
28801,28801,Wayne Van Dorp,1990-91,29.0,5,11,61,61,7,4,11,38.0,,97,8,7,15,60.0,80,7.37,76,367,2421,12.2,0.21918344
28802,28802,Wayne Van Dorp,1991-92,30.0,6,1,4,4,1,0,1,2.0,,101,9,7,16,62.0,80,6.91,71,366,2385,11.6,0.18985629
28803,28803,Wayne Van Dorp,1992-93,31.0,7,8,24,24,3,5,8,19.0,,125,12,12,24,81.0,80,6.96,77,402,2440,11.4,0.24447241
28804,28804,Wendel Clark,1986-87,20.0,2,45,66,66,34,11,45,164.0,,66,34,11,45,164.0,80,7.94,82,370,2484,12.8,0.8386832
28805,28805,Wendel Clark,1987-88,21.0,3,60,80,80,37,23,60,246.0,,146,71,34,105,410.0,80,7.34,72,344,2400,12.2,0.83379537
28806,28806,Wendel Clark,1988-89,22.0,4,23,28,28,12,11,23,93.0,,174,83,45,128,503.0,80,7.43,89,437,2435,12.2,0.793893
28807,28807,Wendel Clark,1989-90,23.0,5,11,15,15,7,4,11,30.0,,189,90,49,139,533.0,80,7.48,85,403,2430,12.3,0.6646038
28808,28808,Wendel Clark,1990-91,24.0,6,26,38,38,18,8,26,85.0,,227,108,57,165,618.0,80,7.37,76,367,2421,12.2,0.64343023
28809,28809,Wendel Clark,1991-92,25.0,7,34,63,63,18,16,34,181.0,,290,126,73,199,799.0,80,6.91,71,366,2385,11.6,0.61390036
28810,28810,Wendel Clark,1992-93,26.0,8,40,43,43,19,21,40,158.0,,333,145,94,239,957.0,80,6.96,77,402,2440,11.4,0.74307984
28811,28811,Wendel Clark,1993-94,27.0,9,39,66,66,17,22,39,146.0,,399,162,116,278,1103.0,84,7.25,87,443,2603,11.7,0.5853965
28812,28812,Wendel Clark,1994-95,28.0,10,76,64,64,46,30,76,275.0,,463,208,146,354,1378.0,84,6.48,76,407,2545,10.7,0.9471384
28813,28813,Wendel Clark,1995-96,29.0,11,30,37,37,12,18,30,95.0,,500,220,164,384,1473.0,48,5.97,37,209,1408,10.2,0.7011194
28814,28814,Wendel Clark,1996-97,30.0,12,58,71,71,32,26,58,237.0,,571,252,190,442,1710.0,82,6.29,74,413,2481,10.4,0.7265933
28815,28815,Wendel Clark,1997-98,31.0,13,49,65,65,30,19,49,212.0,,636,282,209,491,1922.0,82,5.83,55,336,2444,9.8,0.6595138
28816,28816,Wendel Clark,1998-99,32.0,14,19,47,47,12,7,19,140.0,,683,294,216,510,2062.0,82,5.28,57,380,2242,9.6,0.46043167
28817,28817,Wendel Clark,1999-00,33.0,15,48,77,77,32,16,48,215.0,1220.0,760,326,232,558,2277.0,82,5.27,57,359,2285,9.4,0.539826
28818,28818,Wendel Clark,2000-01,34.0,16,6,33,33,4,2,6,63.0,401.0,793,330,234,564,2340.0,82,5.49,53,331,2294,9.8,0.34707433
28819,28819,Wes Jarvis,1980-81,22.0,2,26,63,63,11,15,26,42.0,,63,11,15,26,42.0,80,7.03,61,280,2352,12.0,0.41713637
28820,28820,Wes Jarvis,1981-82,23.0,3,23,55,55,9,14,23,61.0,,118,20,29,49,103.0,80,7.69,77,340,2441,12.6,0.4597121
28821,28821,Wes Jarvis,1982-83,24.0,4,13,26,26,1,12,13,22.0,,144,21,41,62,125.0,80,8.03,73,320,2489,12.9,0.31137
28822,28822,Wes Jarvis,1983-84,25.0,5,0,3,3,0,0,0,2.0,,147,21,41,62,127.0,80,7.73,71,310,2444,12.7,0.28765893
28823,28823,Wes Jarvis,1984-85,26.0,6,22,61,61,9,13,22,63.0,,208,30,54,84,190.0,80,7.89,74,336,2448,12.9,0.32695493
28824,28824,Wes Jarvis,1985-86,27.0,7,1,26,26,0,1,1,12.0,,234,30,55,85,202.0,80,7.77,71,321,2447,12.7,0.21793997
28825,28825,Wes Jarvis,1986-87,28.0,8,1,2,2,1,0,1,2.0,,236,31,55,86,204.0,80,7.94,82,370,2484,12.8,0.24936375
28826,28826,Wes Jarvis,1988-89,30.0,9,0,1,1,0,0,0,0.0,,237,31,55,86,204.0,80,7.43,89,437,2435,12.2,0.30943748
28827,28827,Wes O'Neill,2009-10,23.0,2,0,3,3,0,0,0,1.0,33.0,3,0,0,0,1.0,82,5.7,65,341,2477,9.4,0.1756827
28828,28828,Wes O'Neill,2010-11,24.0,3,0,2,2,0,0,0,1.0,19.0,5,0,0,0,2.0,82,5.53,56,304,2486,9.1,0.16542035
28829,28829,Wes Walz,1990-91,20.0,2,2,2,2,1,1,2,1.0,,2,1,1,2,1.0,80,7.37,76,367,2421,12.2,0.34315488
28830,28830,Wes Walz,1991-92,21.0,3,16,56,56,8,8,16,57.0,,58,9,9,18,58.0,80,6.91,71,366,2385,11.6,0.31989366
28831,28831,Wes Walz,1992-93,22.0,4,4,17,17,1,3,4,19.0,,75,10,12,22,77.0,80,6.96,77,402,2440,11.4,0.34591633
28832,28832,Wes Walz,1994-95,24.0,5,38,53,53,11,27,38,79.0,,128,21,39,60,156.0,84,6.48,76,407,2545,10.7,0.5300884
28833,28833,Wes Walz,1995-96,25.0,6,18,39,39,6,12,18,73.0,,167,27,51,78,229.0,48,5.97,37,209,1408,10.2,0.47212967
28834,28834,Wes Walz,1996-97,26.0,7,0,2,2,0,0,0,2.0,,169,27,51,78,231.0,82,6.29,74,413,2481,10.4,0.2690279
28835,28835,Wes Walz,2001-02,31.0,8,30,82,82,18,12,30,152.0,1373.0,251,45,63,108,383.0,82,5.51,63,376,2272,9.9,0.40362486
28836,28836,Wes Walz,2002-03,32.0,9,30,64,64,10,20,30,97.0,1069.0,315,55,83,138,480.0,82,5.24,53,338,2262,9.5,0.4267292
28837,28837,Wes Walz,2003-04,33.0,10,32,80,80,13,19,32,115.0,1275.0,395,68,102,170,595.0,82,5.31,60,363,2326,9.4,0.35160097
28838,28838,Wes Walz,2004-05,34.0,11,25,57,57,12,13,25,70.0,929.0,452,80,115,195,665.0,82,5.14,57,348,2300,9.2,0.36911398
28839,28839,Wes Walz,2006-07,36.0,12,37,82,82,19,18,37,127.0,1304.0,534,99,133,232,792.0,82,6.05,85,480,2458,10.1,0.38485625
28840,28840,Wes Walz,2007-08,37.0,13,24,62,62,9,15,24,77.0,923.0,596,108,148,256,869.0,82,5.76,70,398,2426,9.7,0.28992733
28841,28841,Wes Walz,2008-09,38.0,14,4,11,11,1,3,4,9.0,152.0,607,109,151,260,878.0,82,5.44,62,351,2383,9.4,0.20877779
28842,28842,Will Acton,2014-15,27.0,2,5,30,30,3,2,5,18.0,244.0,30,3,2,5,18.0,82,5.34,48,269,2463,8.9,0.18692198
28843,28843,Will Acton,2015-16,28.0,3,0,3,3,0,0,0,2.0,32.0,33,3,2,5,20.0,82,5.32,47,251,2453,8.9,0.14396876
28844,28844,Will Butcher,2018-19,24.0,2,44,81,81,5,39,44,88.0,1301.0,81,5,39,44,88.0,82,5.86,50,250,2620,9.2,0.49529544
28845,28845,Will Butcher,2019-20,25.0,3,30,78,78,4,26,30,108.0,1503.0,159,9,65,74,196.0,82,5.96,47,239,2579,9.5,0.37440482
28846,28846,Will Butcher,2020-21,26.0,4,21,56,56,4,17,21,62.0,1003.0,215,13,82,95,258.0,70,5.96,42,208,2192,9.5,0.3955342
28847,28847,Will O'Neill,2018-19,30.0,2,0,1,1,0,0,0,3.0,9.0,1,0,0,0,3.0,82,5.86,50,250,2620,9.2,0.16682893
28848,28848,William Borgen,2019-20,23.0,2,0,4,4,0,0,0,2.0,66.0,4,0,0,0,2.0,82,5.96,47,239,2579,9.5,0.18310392
28849,28849,William Carrier,2017-18,23.0,2,8,41,41,5,3,8,50.0,369.0,41,5,3,8,50.0,82,5.45,47,245,2478,9.0,0.27181327
28850,28850,William Carrier,2018-19,24.0,3,3,37,37,1,2,3,52.0,327.0,78,6,5,11,102.0,82,5.86,50,250,2620,9.2,0.2007722
28851,28851,William Carrier,2019-20,25.0,4,9,54,54,8,1,9,85.0,537.0,132,14,6,20,187.0,82,5.96,47,239,2579,9.5,0.250448
28852,28852,William Carrier,2020-21,26.0,5,19,71,71,7,12,19,99.0,701.0,203,21,18,39,286.0,70,5.96,42,208,2192,9.5,0.30472812
28853,28853,William Karlsson,2015-16,23.0,2,5,21,21,3,2,5,29.0,257.0,21,3,2,5,29.0,82,5.32,47,251,2453,8.9,0.2684846
28854,28854,William Karlsson,2016-17,24.0,3,20,81,81,9,11,20,108.0,1172.0,102,12,13,25,137.0,82,5.34,48,255,2438,9.0,0.3021062
28855,28855,William Karlsson,2017-18,25.0,4,25,81,81,6,19,25,96.0,1084.0,183,18,32,50,233.0,82,5.45,47,245,2478,9.0,0.3202166
28856,28856,William Karlsson,2018-19,26.0,5,78,82,82,43,35,78,184.0,1535.0,265,61,67,128,417.0,82,5.86,50,250,2620,9.2,0.8353965
28857,28857,William Karlsson,2019-20,27.0,6,56,82,82,24,32,56,169.0,1545.0,347,85,99,184,586.0,82,5.96,47,239,2579,9.5,0.64461845
28858,28858,William Karlsson,2020-21,28.0,7,46,63,63,15,31,46,138.0,1189.0,410,100,130,230,724.0,70,5.96,42,208,2192,9.5,0.57319885
28859,28859,William Lagesson,2020-21,24.0,2,0,8,8,0,0,0,8.0,95.0,8,0,0,0,8.0,70,5.96,42,208,2192,9.5,0.1911138
28860,28860,William Nylander,2016-17,20.0,2,13,22,22,6,7,13,43.0,359.0,22,6,7,13,43.0,82,5.34,48,255,2438,9.0,0.4345088
28861,28861,William Nylander,2017-18,21.0,3,61,81,81,22,39,61,205.0,1297.0,103,28,46,74,248.0,82,5.45,47,245,2478,9.0,0.7562428
28862,28862,William Nylander,2018-19,22.0,4,61,82,82,20,41,61,184.0,1368.0,185,48,87,135,432.0,82,5.86,50,250,2620,9.2,0.74632573
28863,28863,William Nylander,2019-20,23.0,5,27,54,54,7,20,27,130.0,838.0,239,55,107,162,562.0,82,5.96,47,239,2579,9.5,0.6896721
28864,28864,William Nylander,2020-21,24.0,6,59,68,68,31,28,59,197.0,1238.0,307,86,135,221,759.0,70,5.96,42,208,2192,9.5,0.8782084
28865,28865,Willie Mitchell,2000-01,23.0,2,0,2,2,0,0,0,2.0,32.0,2,0,0,0,2.0,82,5.49,53,331,2294,9.8,0.17768398
28866,28866,Willie Mitchell,2001-02,24.0,3,10,33,33,1,9,10,30.0,592.0,35,1,9,10,32.0,82,5.51,63,376,2272,9.9,0.19695836
28867,28867,Willie Mitchell,2002-03,25.0,4,13,68,68,3,10,13,67.0,1457.0,103,4,19,23,99.0,82,5.24,53,338,2262,9.5,0.19856092
28868,28868,Willie Mitchell,2003-04,26.0,5,14,69,69,2,12,14,67.0,1482.0,172,6,31,37,166.0,82,5.31,60,363,2326,9.4,0.18368241
28869,28869,Willie Mitchell,2004-05,27.0,6,14,70,70,1,13,14,58.0,1582.0,242,7,44,51,224.0,82,5.14,57,348,2300,9.2,0.19268075
28870,28870,Willie Mitchell,2006-07,29.0,7,10,80,80,2,8,10,58.0,1668.0,322,9,52,61,282.0,82,6.05,85,480,2458,10.1,0.15640464
28871,28871,Willie Mitchell,2007-08,30.0,8,11,62,62,1,10,11,54.0,1377.0,384,10,62,72,336.0,82,5.76,70,398,2426,9.7,0.15237436
28872,28872,Willie Mitchell,2008-09,31.0,9,12,72,72,2,10,12,65.0,1670.0,456,12,72,84,401.0,82,5.44,62,351,2383,9.4,0.17530006
28873,28873,Willie Mitchell,2009-10,32.0,10,23,82,82,3,20,23,88.0,1879.0,538,15,92,107,489.0,82,5.7,65,341,2477,9.4,0.22697455
28874,28874,Willie Mitchell,2010-11,33.0,11,12,48,48,4,8,12,47.0,1085.0,586,19,100,119,536.0,82,5.53,56,304,2486,9.1,0.16860679
28875,28875,Willie Mitchell,2011-12,34.0,12,10,57,57,5,5,10,59.0,1243.0,643,24,105,129,595.0,82,5.46,52,291,2492,9.0,0.17508525
28876,28876,Willie Mitchell,2012-13,35.0,13,24,76,76,5,19,24,104.0,1689.0,719,29,124,153,699.0,82,5.32,47,271,2439,8.9,0.22149968
28877,28877,Willie Mitchell,2014-15,37.0,14,12,76,76,1,11,12,73.0,1545.0,795,30,135,165,772.0,82,5.34,48,269,2463,8.9,0.1220552
28878,28878,Willie Mitchell,2015-16,38.0,15,8,66,66,3,5,8,78.0,1431.0,861,33,140,173,850.0,82,5.32,47,251,2453,8.9,0.1363965
28879,28879,Willie Mitchell,2016-17,39.0,16,7,46,46,1,6,7,33.0,917.0,907,34,146,180,883.0,82,5.34,48,255,2438,9.0,0.10873535
28880,28880,Willy Lindstrom,1980-81,29.0,2,49,79,79,23,26,49,243.0,,79,23,26,49,243.0,80,7.03,61,280,2352,12.0,0.5945838
28881,28881,Willy Lindstrom,1981-82,30.0,3,35,72,72,22,13,35,163.0,,151,45,39,84,406.0,80,7.69,77,340,2441,12.6,0.5041236
28882,28882,Willy Lindstrom,1982-83,31.0,4,59,74,74,32,27,59,236.0,,225,77,66,143,642.0,80,8.03,73,320,2489,12.9,0.6919133
28883,28883,Willy Lindstrom,1983-84,32.0,5,56,73,73,26,30,56,225.0,,298,103,96,199,867.0,80,7.73,71,310,2444,12.7,0.6590078
28884,28884,Willy Lindstrom,1984-85,33.0,6,38,73,73,22,16,38,116.0,,371,125,112,237,983.0,80,7.89,74,336,2448,12.9,0.44989613
28885,28885,Willy Lindstrom,1985-86,34.0,7,32,80,80,12,20,32,98.0,,451,137,132,269,1081.0,80,7.77,71,321,2447,12.7,0.38071164
28886,28886,Willy Lindstrom,1986-87,35.0,8,31,71,71,14,17,31,87.0,,522,151,149,300,1168.0,80,7.94,82,370,2484,12.8,0.36620778
28887,28887,Willy Lindstrom,1987-88,36.0,9,23,60,60,10,13,23,93.0,,582,161,162,323,1261.0,80,7.34,72,344,2400,12.2,0.33066136
28888,28888,Wojtek Wolski,2006-07,20.0,2,6,9,9,2,4,6,9.0,88.0,9,2,4,6,9.0,82,6.05,85,480,2458,10.1,0.33769703
28889,28889,Wojtek Wolski,2007-08,21.0,3,50,76,76,22,28,50,165.0,1180.0,85,24,32,56,174.0,82,5.76,70,398,2426,9.7,0.653487
28890,28890,Wojtek Wolski,2008-09,22.0,4,48,77,77,18,30,48,158.0,1227.0,162,42,62,104,332.0,82,5.44,62,351,2383,9.4,0.6541394
28891,28891,Wojtek Wolski,2009-10,23.0,5,42,78,78,14,28,42,169.0,1434.0,240,56,90,146,501.0,82,5.7,65,341,2477,9.4,0.5705883
28892,28892,Wojtek Wolski,2010-11,24.0,6,65,80,80,23,42,65,195.0,1499.0,320,79,132,211,696.0,82,5.53,56,304,2486,9.1,0.7950822
28893,28893,Wojtek Wolski,2011-12,25.0,7,35,73,73,12,23,35,135.0,1064.0,393,91,155,246,831.0,82,5.46,52,291,2492,9.0,0.4868613
28894,28894,Wojtek Wolski,2012-13,26.0,8,12,31,31,4,8,12,50.0,427.0,424,95,163,258,881.0,82,5.32,47,271,2439,8.9,0.3845299
28895,28895,Wojtek Wolski,2013-14,27.0,9,9,27,27,4,5,9,49.0,360.0,451,99,168,267,930.0,48,5.31,29,160,1399,9.1,0.39480513
28896,28896,Wyatt Smith,2000-01,23.0,2,0,2,2,0,0,0,0.0,23.0,2,0,0,0,0.0,82,5.49,53,331,2294,9.8,0.16184989
28897,28897,Wyatt Smith,2001-02,24.0,3,10,42,42,3,7,10,40.0,518.0,44,3,7,10,40.0,82,5.51,63,376,2272,9.9,0.1967431
28898,28898,Wyatt Smith,2002-03,25.0,4,0,10,10,0,0,0,4.0,106.0,54,3,7,10,44.0,82,5.24,53,338,2262,9.5,0.14322165
28899,28899,Wyatt Smith,2003-04,26.0,5,1,11,11,1,0,1,8.0,131.0,65,4,7,11,52.0,82,5.31,60,363,2326,9.4,0.1615181
28900,28900,Wyatt Smith,2004-05,27.0,6,4,18,18,3,1,4,21.0,186.0,83,7,8,15,73.0,82,5.14,57,348,2300,9.2,0.2423225
28901,28901,Wyatt Smith,2006-07,29.0,7,8,42,42,0,8,8,37.0,472.0,125,7,16,23,110.0,82,6.05,85,480,2458,10.1,0.11460081
28902,28902,Wyatt Smith,2007-08,30.0,8,6,61,61,3,3,6,44.0,580.0,186,10,19,29,154.0,82,5.76,70,398,2426,9.7,0.121955544
28903,28903,Wyatt Smith,2008-09,31.0,9,3,25,25,0,3,3,25.0,291.0,211,10,22,32,179.0,82,5.44,62,351,2383,9.4,0.14880374
28904,28904,Xavier Delisle,1999-00,22.0,2,0,2,2,0,0,0,1.0,12.0,2,0,0,0,1.0,82,5.27,57,359,2285,9.4,0.18293896
28905,28905,Xavier Delisle,2001-02,24.0,3,5,14,14,3,2,5,15.0,143.0,16,3,2,5,16.0,82,5.51,63,376,2272,9.9,0.23916349
28906,28906,Xavier Ouellet,2014-15,21.0,2,0,4,4,0,0,0,4.0,58.0,4,0,0,0,4.0,82,5.34,48,269,2463,8.9,0.2130292
28907,28907,Xavier Ouellet,2015-16,22.0,3,3,21,21,2,1,3,27.0,344.0,25,2,1,3,31.0,82,5.32,47,251,2453,8.9,0.24374756
28908,28908,Xavier Ouellet,2016-17,23.0,4,1,5,5,0,1,1,4.0,81.0,30,2,2,4,35.0,82,5.34,48,255,2438,9.0,0.18509749
28909,28909,Xavier Ouellet,2017-18,24.0,5,12,66,66,3,9,12,89.0,1186.0,96,5,11,16,124.0,82,5.45,47,245,2478,9.0,0.22706267
28910,28910,Xavier Ouellet,2018-19,25.0,6,7,45,45,0,7,7,57.0,624.0,141,5,18,23,181.0,82,5.86,50,250,2620,9.2,0.15689227
28911,28911,Xavier Ouellet,2019-20,26.0,7,3,19,19,0,3,3,32.0,323.0,160,5,21,26,213.0,82,5.96,47,239,2579,9.5,0.16672993
28912,28912,Xavier Ouellet,2020-21,27.0,8,2,12,12,0,2,2,8.0,167.0,172,5,23,28,221.0,70,5.96,42,208,2192,9.5,0.1608414
28913,28913,Yakov Trenin,2020-21,24.0,2,6,21,21,2,4,6,25.0,204.0,21,2,4,6,25.0,70,5.96,42,208,2192,9.5,0.28212184
28914,28914,Yan Golubovsky,1998-99,22.0,2,2,12,12,0,2,2,9.0,,12,0,2,2,9.0,82,5.28,57,380,2242,9.6,0.19487464
28915,28915,Yan Golubovsky,1999-00,23.0,3,1,17,17,0,1,1,10.0,164.0,29,0,3,3,19.0,82,5.27,57,359,2285,9.4,0.17699781
28916,28916,Yan Golubovsky,2000-01,24.0,4,3,21,21,1,2,3,7.0,187.0,50,1,5,6,26.0,82,5.49,53,331,2294,9.8,0.14106604
28917,28917,Yan Golubovsky,2001-02,25.0,5,2,6,6,0,2,2,4.0,100.0,56,1,7,8,30.0,82,5.51,63,376,2272,9.9,0.14736968
28918,28918,Yan Kaminsky,1994-95,23.0,2,3,24,24,2,1,3,23.0,,24,2,1,3,23.0,84,6.48,76,407,2545,10.7,0.26830167
28919,28919,Yan Kaminsky,1995-96,24.0,3,2,2,2,1,1,2,4.0,,26,3,2,5,27.0,48,5.97,37,209,1408,10.2,0.23157206
28920,28920,Yan Stastny,2006-07,24.0,2,4,20,20,1,3,4,14.0,195.0,20,1,3,4,14.0,82,6.05,85,480,2458,10.1,0.1497004
28921,28921,Yan Stastny,2007-08,25.0,3,2,21,21,0,2,2,7.0,157.0,41,1,5,6,21.0,82,5.76,70,398,2426,9.7,0.11755693
28922,28922,Yan Stastny,2008-09,26.0,4,2,12,12,1,1,2,10.0,132.0,53,2,6,8,31.0,82,5.44,62,351,2383,9.4,0.1853844
28923,28923,Yan Stastny,2009-10,27.0,5,7,34,34,3,4,7,30.0,433.0,87,5,10,15,61.0,82,5.7,65,341,2477,9.4,0.20266384
28924,28924,Yan Stastny,2010-11,28.0,6,1,4,4,1,0,1,7.0,38.0,91,6,10,16,68.0,82,5.53,56,304,2486,9.1,0.16241059
28925,28925,Yanic Perreault,1994-95,23.0,2,6,13,13,3,3,6,24.0,,13,3,3,6,24.0,84,6.48,76,407,2545,10.7,0.33171773
28926,28926,Yanic Perreault,1995-96,24.0,3,7,26,26,2,5,7,43.0,,39,5,8,13,67.0,48,5.97,37,209,1408,10.2,0.2819361
28927,28927,Yanic Perreault,1996-97,25.0,4,49,78,78,25,24,49,175.0,,117,30,32,62,242.0,82,6.29,74,413,2481,10.4,0.57233334
28928,28928,Yanic Perreault,1997-98,26.0,5,25,41,41,11,14,25,98.0,,158,41,46,87,340.0,82,5.83,55,336,2444,9.8,0.53612727
28929,28929,Yanic Perreault,1998-99,27.0,6,48,79,79,28,20,48,206.0,,237,69,66,135,546.0,82,5.28,57,380,2242,9.6,0.6020872
28930,28930,Yanic Perreault,1999-00,28.0,7,42,76,76,17,25,42,141.0,1146.0,313,86,91,177,687.0,82,5.27,57,359,2285,9.4,0.5242416
28931,28931,Yanic Perreault,2000-01,29.0,8,45,58,58,18,27,45,114.0,887.0,371,104,118,222,801.0,82,5.49,53,331,2294,9.8,0.575214
28932,28932,Yanic Perreault,2001-02,30.0,9,52,76,76,24,28,52,134.0,1066.0,447,128,146,274,935.0,82,5.51,63,376,2272,9.9,0.55164665
28933,28933,Yanic Perreault,2002-03,31.0,10,56,82,82,27,29,56,156.0,1377.0,529,155,175,330,1091.0,82,5.24,53,338,2262,9.5,0.6165809
28934,28934,Yanic Perreault,2003-04,32.0,11,46,73,73,24,22,46,145.0,1174.0,602,179,197,376,1236.0,82,5.31,60,363,2326,9.4,0.50935096
28935,28935,Yanic Perreault,2004-05,33.0,12,31,69,69,16,15,31,114.0,950.0,671,195,212,407,1350.0,82,5.14,57,348,2300,9.2,0.52529585
28936,28936,Yanic Perreault,2006-07,35.0,13,57,69,69,22,35,57,145.0,1031.0,740,217,247,464,1495.0,82,6.05,85,480,2458,10.1,0.6573033
28937,28937,Yanic Perreault,2007-08,36.0,14,38,66,66,21,17,38,125.0,1026.0,806,238,264,502,1620.0,82,5.76,70,398,2426,9.7,0.445756
28938,28938,Yanic Perreault,2008-09,37.0,15,14,53,53,9,5,14,58.0,610.0,859,247,269,516,1678.0,82,5.44,62,351,2383,9.4,0.28728965
28939,28939,Yanick Dupre,1992-93,20.0,2,0,1,1,0,0,0,0.0,,1,0,0,0,0.0,80,6.96,77,402,2440,11.4,0.24799195
28940,28940,Yanick Dupre,1995-96,23.0,3,0,22,22,0,0,0,21.0,,23,0,0,0,21.0,48,5.97,37,209,1408,10.2,0.17661154
28941,28941,Yanick Dupre,1996-97,24.0,4,2,12,12,2,0,2,10.0,,35,2,0,2,31.0,82,6.29,74,413,2481,10.4,0.22524524
28942,28942,Yanick Lehoux,2006-07,24.0,2,1,3,3,1,0,1,5.0,29.0,3,1,0,1,5.0,82,6.05,85,480,2458,10.1,0.21587467
28943,28943,Yanick Lehoux,2007-08,25.0,3,3,7,7,1,2,3,10.0,88.0,10,2,2,4,15.0,82,5.76,70,398,2426,9.7,0.21181846
28944,28944,Yann Sauve,2011-12,21.0,2,0,5,5,0,0,0,6.0,65.0,5,0,0,0,6.0,82,5.46,52,291,2492,9.0,0.21491829
28945,28945,Yann Sauve,2014-15,24.0,3,0,3,3,0,0,0,1.0,37.0,8,0,0,0,7.0,82,5.34,48,269,2463,8.9,0.15405837
28946,28946,Yanni Gourde,2016-17,25.0,2,1,2,2,0,1,1,0.0,15.0,2,0,1,1,0.0,82,5.34,48,255,2438,9.0,0.16770774
28947,28947,Yanni Gourde,2017-18,26.0,3,8,20,20,6,2,8,30.0,307.0,22,6,3,9,30.0,82,5.45,47,245,2478,9.0,0.27880704
28948,28948,Yanni Gourde,2018-19,27.0,4,64,82,82,25,39,64,136.0,1325.0,104,31,42,73,166.0,82,5.86,50,250,2620,9.2,0.65577626
28949,28949,Yanni Gourde,2019-20,28.0,5,48,80,80,22,26,48,130.0,1267.0,184,53,68,121,296.0,82,5.96,47,239,2579,9.5,0.5555873
28950,28950,Yanni Gourde,2020-21,29.0,6,30,70,70,10,20,30,110.0,985.0,254,63,88,151,406.0,70,5.96,42,208,2192,9.5,0.45985824
28951,28951,Yannick Tremblay,1997-98,22.0,2,0,5,5,0,0,0,2.0,,5,0,0,0,2.0,82,5.83,55,336,2444,9.8,0.1732291
28952,28952,Yannick Tremblay,1998-99,23.0,3,6,38,38,2,4,6,45.0,,43,2,4,6,47.0,82,5.28,57,380,2242,9.6,0.21632919
28953,28953,Yannick Tremblay,1999-00,24.0,4,9,35,35,2,7,9,37.0,618.0,78,4,11,15,84.0,82,5.27,57,359,2285,9.4,0.23481408
28954,28954,Yannick Tremblay,2000-01,25.0,5,31,75,75,10,21,31,139.0,1459.0,153,14,32,46,223.0,82,5.49,53,331,2294,9.8,0.40188468
28955,28955,Yannick Tremblay,2001-02,26.0,6,12,46,46,4,8,12,102.0,940.0,199,18,40,58,325.0,82,5.51,63,376,2272,9.9,0.2708128
28956,28956,Yannick Tremblay,2002-03,27.0,7,24,66,66,9,15,24,115.0,1441.0,265,27,55,82,440.0,82,5.24,53,338,2262,9.5,0.33141738
28957,28957,Yannick Tremblay,2003-04,28.0,8,30,75,75,8,22,30,151.0,1631.0,340,35,77,112,591.0,82,5.31,60,363,2326,9.4,0.40446502
28958,28958,Yannick Tremblay,2004-05,29.0,9,10,38,38,2,8,10,47.0,821.0,378,37,85,122,638.0,82,5.14,57,348,2300,9.2,0.2633791
28959,28959,Yannick Tremblay,2007-08,32.0,10,3,12,12,1,2,3,30.0,153.0,390,38,87,125,668.0,82,5.76,70,398,2426,9.7,0.2706439
28960,28960,Yannick Weber,2009-10,21.0,2,1,3,3,0,1,1,6.0,45.0,3,0,1,1,6.0,82,5.7,65,341,2477,9.4,0.25698397
28961,28961,Yannick Weber,2010-11,22.0,3,0,5,5,0,0,0,2.0,69.0,8,0,1,1,8.0,82,5.53,56,304,2486,9.1,0.18241933
28962,28962,Yannick Weber,2011-12,23.0,4,11,41,41,1,10,11,63.0,679.0,49,1,11,12,71.0,82,5.46,52,291,2492,9.0,0.22041756
28963,28963,Yannick Weber,2012-13,24.0,5,18,60,60,4,14,18,88.0,937.0,109,5,25,30,159.0,82,5.32,47,271,2439,8.9,0.2735691
28964,28964,Yannick Weber,2013-14,25.0,6,2,6,6,0,2,2,3.0,83.0,115,5,27,32,162.0,48,5.31,29,160,1399,9.1,0.2184324
28965,28965,Yannick Weber,2014-15,26.0,7,10,49,49,6,4,10,70.0,584.0,164,11,31,42,232.0,82,5.34,48,269,2463,8.9,0.24627835
28966,28966,Yannick Weber,2015-16,27.0,8,21,65,65,11,10,21,117.0,1117.0,229,22,41,63,349.0,82,5.32,47,251,2453,8.9,0.27236488
28967,28967,Yannick Weber,2016-17,28.0,9,7,45,45,0,7,7,65.0,847.0,274,22,48,70,414.0,82,5.34,48,255,2438,9.0,0.19768289
28968,28968,Yannick Weber,2017-18,29.0,10,8,73,73,1,7,8,72.0,870.0,347,23,55,78,486.0,82,5.45,47,245,2478,9.0,0.1597799
28969,28969,Yannick Weber,2018-19,30.0,11,5,47,47,2,3,5,40.0,567.0,394,25,58,83,526.0,82,5.86,50,250,2620,9.2,0.13741934
28970,28970,Yannick Weber,2019-20,31.0,12,8,62,62,2,6,8,67.0,739.0,456,27,64,91,593.0,82,5.96,47,239,2579,9.5,0.14330718
28971,28971,Yannick Weber,2020-21,32.0,13,3,41,41,1,2,3,45.0,574.0,497,28,66,94,638.0,70,5.96,42,208,2192,9.5,0.1449871
28972,28972,Yevgeny Shaldybin,1997-98,22.0,2,1,3,3,1,0,1,5.0,,3,1,0,1,5.0,82,5.83,55,336,2444,9.8,0.2330291
28973,28973,Yohann Auvitu,2017-18,28.0,2,4,25,25,2,2,4,54.0,390.0,25,2,2,4,54.0,82,5.45,47,245,2478,9.0,0.21544197
28974,28974,Yohann Auvitu,2018-19,29.0,3,9,33,33,3,6,9,69.0,447.0,58,5,8,13,123.0,82,5.86,50,250,2620,9.2,0.23748231
28975,28975,Yuri Babenko,2001-02,24.0,2,0,3,3,0,0,0,2.0,32.0,3,0,0,0,2.0,82,5.51,63,376,2272,9.9,0.16199553
28976,28976,Yuri Butsayev,2000-01,22.0,2,8,57,57,5,3,8,46.0,547.0,57,5,3,8,46.0,82,5.49,53,331,2294,9.8,0.2123371
28977,28977,Yuri Butsayev,2001-02,23.0,3,2,15,15,1,1,2,18.0,137.0,72,6,4,10,64.0,82,5.51,63,376,2272,9.9,0.22216362
28978,28978,Yuri Butsayev,2002-03,24.0,4,2,11,11,2,0,2,10.0,137.0,83,8,4,12,74.0,82,5.24,53,338,2262,9.5,0.23162651
28979,28979,Yuri Butsayev,2003-04,25.0,5,2,16,16,2,0,2,21.0,193.0,99,10,4,14,95.0,82,5.31,60,363,2326,9.4,0.20388728
28980,28980,Yuri Khmylev,1993-94,29.0,2,39,68,68,20,19,39,122.0,,68,20,19,39,122.0,84,7.25,87,443,2603,11.7,0.5011794
28981,28981,Yuri Khmylev,1994-95,30.0,3,58,72,72,27,31,58,171.0,,140,47,50,97,293.0,84,6.48,76,407,2545,10.7,0.61997944
28982,28982,Yuri Khmylev,1995-96,31.0,4,25,48,48,8,17,25,71.0,,188,55,67,122,364.0,48,5.97,37,209,1408,10.2,0.48992848
28983,28983,Yuri Khmylev,1996-97,32.0,5,29,73,73,8,21,29,136.0,,261,63,88,151,500.0,82,6.29,74,413,2481,10.4,0.3835107
28984,28984,Yuri Khmylev,1997-98,33.0,6,1,2,2,1,0,1,3.0,,263,64,88,152,503.0,82,5.83,55,336,2444,9.8,0.29011428
28985,28985,Yvan Joly,1981-82,21.0,2,0,1,1,0,0,0,0.0,,1,0,0,0,0.0,80,7.69,77,340,2441,12.6,0.216385
28986,28986,Yvan Joly,1983-84,23.0,3,0,1,1,0,0,0,1.0,,2,0,0,0,1.0,80,7.73,71,310,2444,12.7,0.21157894
28987,28987,Yves Beaudoin,1986-87,22.0,2,0,4,4,0,0,0,7.0,,4,0,0,0,7.0,80,7.94,82,370,2484,12.8,0.22778124
28988,28988,Yves Beaudoin,1987-88,23.0,3,0,6,6,0,0,0,4.0,,10,0,0,0,11.0,80,7.34,72,344,2400,12.2,0.20589256
28989,28989,Yves Beaudoin,1988-89,24.0,4,0,1,1,0,0,0,0.0,,11,0,0,0,11.0,80,7.43,89,437,2435,12.2,0.18971235
28990,28990,Yves Courteau,1985-86,21.0,2,5,14,14,1,4,5,18.0,,14,1,4,5,18.0,80,7.77,71,321,2447,12.7,0.32857668
28991,28991,Yves Courteau,1986-87,22.0,3,2,4,4,1,1,2,7.0,,18,2,5,7,25.0,80,7.94,82,370,2484,12.8,0.25472724
28992,28992,Yves Courteau,1987-88,23.0,4,0,4,4,0,0,0,4.0,,22,2,5,7,29.0,80,7.34,72,344,2400,12.2,0.215105
28993,28993,Yves Heroux,1987-88,22.0,2,0,1,1,0,0,0,0.0,,1,0,0,0,0.0,80,7.34,72,344,2400,12.2,0.19746074
28994,28994,Yves Racine,1990-91,21.0,2,13,28,28,4,9,13,49.0,,28,4,9,13,49.0,80,7.37,76,367,2421,12.2,0.438331
28995,28995,Yves Racine,1991-92,22.0,3,47,62,62,7,40,47,131.0,,90,11,49,60,180.0,80,6.91,71,366,2385,11.6,0.71288955
28996,28996,Yves Racine,1992-93,23.0,4,24,61,61,2,22,24,103.0,,151,13,71,84,283.0,80,6.96,77,402,2440,11.4,0.3811949
28997,28997,Yves Racine,1993-94,24.0,5,40,80,80,9,31,40,163.0,,231,22,102,124,446.0,84,7.25,87,443,2603,11.7,0.5546344
28998,28998,Yves Racine,1994-95,25.0,6,52,67,67,9,43,52,142.0,,298,31,145,176,588.0,84,6.48,76,407,2545,10.7,0.562095
28999,28999,Yves Racine,1995-96,26.0,7,11,47,47,4,7,11,63.0,,345,35,152,187,651.0,48,5.97,37,209,1408,10.2,0.36143172
29000,29000,Yves Racine,1996-97,27.0,8,20,57,57,1,19,20,51.0,,402,36,171,207,702.0,82,6.29,74,413,2481,10.4,0.31012666
29001,29001,Yves Racine,1997-98,28.0,9,16,46,46,1,15,16,82.0,,448,37,186,223,784.0,82,5.83,55,336,2444,9.8,0.33075893
29002,29002,Yves Racine,1998-99,29.0,10,8,60,60,0,8,8,76.0,,508,37,194,231,860.0,82,5.28,57,380,2242,9.6,0.20591098
29003,29003,Yves Sarault,1995-96,23.0,2,1,8,8,0,1,1,9.0,,8,0,1,1,9.0,48,5.97,37,209,1408,10.2,0.22536883
29004,29004,Yves Sarault,1996-97,24.0,3,3,25,25,2,1,3,26.0,,33,2,2,4,35.0,82,6.29,74,413,2481,10.4,0.21949491
29005,29005,Yves Sarault,1997-98,25.0,4,3,28,28,2,1,3,41.0,,61,4,3,7,76.0,82,5.83,55,336,2444,9.8,0.20241028
29006,29006,Yves Sarault,1998-99,26.0,5,1,2,2,1,0,1,1.0,,63,5,3,8,77.0,82,5.28,57,380,2242,9.6,0.17084524
29007,29007,Yves Sarault,1999-00,27.0,6,1,11,11,0,1,1,7.0,80.0,74,5,4,9,84.0,82,5.27,57,359,2285,9.4,0.14405775
29008,29008,Yves Sarault,2000-01,28.0,7,2,11,11,0,2,2,13.0,100.0,85,5,6,11,97.0,82,5.49,53,331,2294,9.8,0.17518684
29009,29009,Yves Sarault,2001-02,29.0,8,9,20,20,5,4,9,44.0,263.0,105,10,10,20,141.0,82,5.51,63,376,2272,9.9,0.24002522
29010,29010,Yves Sarault,2002-03,30.0,9,0,1,1,0,0,0,0.0,5.0,106,10,10,20,141.0,82,5.24,53,338,2262,9.5,0.15420353
29011,29011,Yvon Corriveau,1986-87,19.0,2,0,2,2,0,0,0,3.0,,2,0,0,0,3.0,80,7.94,82,370,2484,12.8,0.2601329
29012,29012,Yvon Corriveau,1987-88,20.0,3,2,17,17,1,1,2,7.0,,19,1,1,2,10.0,80,7.34,72,344,2400,12.2,0.30104405
29013,29013,Yvon Corriveau,1988-89,21.0,4,19,44,44,10,9,19,52.0,,63,11,10,21,62.0,80,7.43,89,437,2435,12.2,0.4185136
29014,29014,Yvon Corriveau,1989-90,22.0,5,5,33,33,3,2,5,39.0,,96,14,12,26,101.0,80,7.48,85,403,2430,12.3,0.32921398
29015,29015,Yvon Corriveau,1990-91,23.0,6,20,63,63,13,7,20,90.0,,159,27,19,46,191.0,80,7.37,76,367,2421,12.2,0.35251614
29016,29016,Yvon Corriveau,1991-92,24.0,7,2,23,23,1,1,2,21.0,,182,28,20,48,212.0,80,6.91,71,366,2385,11.6,0.22071967
29017,29017,Yvon Corriveau,1992-93,25.0,8,20,38,38,12,8,20,69.0,,220,40,28,68,281.0,80,6.96,77,402,2440,11.4,0.4166531
29018,29018,Yvon Corriveau,1993-94,26.0,9,20,57,57,8,12,20,77.0,,277,48,40,88,358.0,84,7.25,87,443,2603,11.7,0.28046393
29019,29019,Yvon Corriveau,1994-95,27.0,10,0,3,3,0,0,0,0.0,,280,48,40,88,358.0,84,6.48,76,407,2545,10.7,0.2520635
29020,29020,Yvon Vautour,1980-81,24.0,2,4,17,17,3,1,4,16.0,,17,3,1,4,16.0,80,7.03,61,280,2352,12.0,0.32362694
29021,29021,Yvon Vautour,1981-82,25.0,3,34,74,74,15,19,34,97.0,,91,18,20,38,113.0,80,7.69,77,340,2441,12.6,0.44609317
29022,29022,Yvon Vautour,1982-83,26.0,4,3,14,14,1,2,3,21.0,,105,19,22,41,134.0,80,8.03,73,320,2489,12.9,0.31865638
29023,29023,Yvon Vautour,1983-84,27.0,5,11,52,52,4,7,11,54.0,,157,23,29,52,188.0,80,7.73,71,310,2444,12.7,0.27635187
29024,29024,Yvon Vautour,1984-85,28.0,6,7,42,42,3,4,7,44.0,,199,26,33,59,232.0,80,7.89,74,336,2448,12.9,0.2188142
29025,29025,Yvon Vautour,1985-86,29.0,7,0,5,5,0,0,0,1.0,,204,26,33,59,233.0,80,7.77,71,321,2447,12.7,0.21363091
29026,29026,Zac Boyer,1995-96,24.0,2,0,1,1,0,0,0,1.0,,1,0,0,0,1.0,48,5.97,37,209,1408,10.2,0.1985141
29027,29027,Zac Boyer,1996-97,25.0,3,0,2,2,0,0,0,3.0,,3,0,0,0,4.0,82,6.29,74,413,2481,10.4,0.1646193
29028,29028,Zac Dalpe,2011-12,22.0,2,4,15,15,3,1,4,16.0,119.0,15,3,1,4,16.0,82,5.46,52,291,2492,9.0,0.2627861
29029,29029,Zac Dalpe,2012-13,23.0,3,3,16,16,1,2,3,20.0,153.0,31,4,3,7,36.0,82,5.32,47,271,2439,8.9,0.25856265
29030,29030,Zac Dalpe,2013-14,24.0,4,3,10,10,1,2,3,18.0,123.0,41,5,5,10,54.0,48,5.31,29,160,1399,9.1,0.24103096
29031,29031,Zac Dalpe,2014-15,25.0,5,7,55,55,4,3,7,52.0,392.0,96,9,8,17,106.0,82,5.34,48,269,2463,8.9,0.17396215
29032,29032,Zac Dalpe,2015-16,26.0,6,3,21,21,1,2,3,29.0,195.0,117,10,10,20,135.0,82,5.32,47,251,2453,8.9,0.1887128
29033,29033,Zac Dalpe,2016-17,27.0,7,1,2,2,1,0,1,3.0,21.0,119,11,10,21,138.0,82,5.34,48,255,2438,9.0,0.15593126
29034,29034,Zac Dalpe,2017-18,28.0,8,3,9,9,1,2,3,8.0,77.0,128,12,12,24,146.0,82,5.45,47,245,2478,9.0,0.15167409
29035,29035,Zac Dalpe,2018-19,29.0,9,0,12,12,0,0,0,18.0,89.0,140,12,12,24,164.0,82,5.86,50,250,2620,9.2,0.18361905
29036,29036,Zac Dalpe,2019-20,30.0,10,1,1,1,0,1,1,1.0,9.0,141,12,13,25,165.0,82,5.96,47,239,2579,9.5,0.12737271
29037,29037,Zac Rinaldo,2012-13,22.0,2,9,66,66,2,7,9,54.0,494.0,66,2,7,9,54.0,82,5.32,47,271,2439,8.9,0.18456739
29038,29038,Zac Rinaldo,2013-14,23.0,3,5,32,32,3,2,5,15.0,268.0,98,5,9,14,69.0,48,5.31,29,160,1399,9.1,0.23061922
29039,29039,Zac Rinaldo,2014-15,24.0,4,4,67,67,2,2,4,54.0,516.0,165,7,11,18,123.0,82,5.34,48,269,2463,8.9,0.15878323
29040,29040,Zac Rinaldo,2015-16,25.0,5,6,58,58,1,5,6,45.0,517.0,223,8,16,24,168.0,82,5.32,47,251,2453,8.9,0.1487236
29041,29041,Zac Rinaldo,2016-17,26.0,6,3,52,52,1,2,3,38.0,431.0,275,9,18,27,206.0,82,5.34,48,255,2438,9.0,0.14341268
29042,29042,Zac Rinaldo,2018-19,28.0,7,7,53,53,5,2,7,56.0,598.0,328,14,20,34,262.0,82,5.86,50,250,2620,9.2,0.1309464
29043,29043,Zac Rinaldo,2019-20,29.0,8,3,23,23,1,2,3,11.0,164.0,351,15,22,37,273.0,82,5.96,47,239,2579,9.5,0.10207766
29044,29044,Zac Rinaldo,2020-21,30.0,9,5,19,19,3,2,5,19.0,157.0,370,18,24,42,292.0,70,5.96,42,208,2192,9.5,0.1967699
29045,29045,Zach Aston-Reese,2018-19,24.0,2,6,16,16,4,2,6,20.0,182.0,16,4,2,6,20.0,82,5.86,50,250,2620,9.2,0.2682792
29046,29046,Zach Aston-Reese,2019-20,25.0,3,17,43,43,8,9,17,76.0,587.0,59,12,11,23,96.0,82,5.96,47,239,2579,9.5,0.34497035
29047,29047,Zach Aston-Reese,2020-21,26.0,4,13,57,57,6,7,13,98.0,822.0,116,18,18,36,194.0,70,5.96,42,208,2192,9.5,0.3290925
29048,29048,Zach Bogosian,2009-10,19.0,2,19,47,47,9,10,19,90.0,851.0,47,9,10,19,90.0,82,5.7,65,341,2477,9.4,0.42780805
29049,29049,Zach Bogosian,2010-11,20.0,3,23,81,81,10,13,23,155.0,1734.0,128,19,23,42,245.0,82,5.53,56,304,2486,9.1,0.37050605
29050,29050,Zach Bogosian,2011-12,21.0,4,17,71,71,5,12,17,155.0,1591.0,199,24,35,59,400.0,82,5.46,52,291,2492,9.0,0.3427061
29051,29051,Zach Bogosian,2012-13,22.0,5,30,65,65,5,25,30,150.0,1516.0,264,29,60,89,550.0,82,5.32,47,271,2439,8.9,0.44534096
29052,29052,Zach Bogosian,2013-14,23.0,6,14,33,33,5,9,14,85.0,763.0,297,34,69,103,635.0,48,5.31,29,160,1399,9.1,0.42051563
29053,29053,Zach Bogosian,2014-15,24.0,7,11,55,55,3,8,11,134.0,1260.0,352,37,77,114,769.0,82,5.34,48,269,2463,8.9,0.31792992
29054,29054,Zach Bogosian,2015-16,25.0,8,20,62,62,3,17,20,125.0,1469.0,414,40,94,134,894.0,82,5.32,47,251,2453,8.9,0.31409577
29055,29055,Zach Bogosian,2016-17,26.0,9,24,64,64,7,17,24,121.0,1430.0,478,47,111,158,1015.0,82,5.34,48,255,2438,9.0,0.3458972
29056,29056,Zach Bogosian,2017-18,27.0,10,11,56,56,2,9,11,73.0,1125.0,534,49,120,169,1088.0,82,5.45,47,245,2478,9.0,0.24766353
29057,29057,Zach Bogosian,2018-19,28.0,11,1,18,18,0,1,1,29.0,345.0,552,49,121,170,1117.0,82,5.86,50,250,2620,9.2,0.24289608
29058,29058,Zach Bogosian,2019-20,29.0,12,19,65,65,3,16,19,93.0,1406.0,617,52,137,189,1210.0,82,5.96,47,239,2579,9.5,0.27039713
29059,29059,Zach Bogosian,2020-21,30.0,13,7,27,27,1,6,7,29.0,449.0,644,53,143,196,1239.0,70,5.96,42,208,2192,9.5,0.22905838
29060,29060,Zach Boychuk,2009-10,20.0,2,0,2,2,0,0,0,0.0,24.0,2,0,0,0,0.0,82,5.7,65,341,2477,9.4,0.24197334
29061,29061,Zach Boychuk,2010-11,21.0,3,9,31,31,3,6,9,37.0,333.0,33,3,6,9,37.0,82,5.53,56,304,2486,9.1,0.3011369
29062,29062,Zach Boychuk,2011-12,22.0,4,7,23,23,4,3,7,44.0,247.0,56,7,9,16,81.0,82,5.46,52,291,2492,9.0,0.29771408
29063,29063,Zach Boychuk,2012-13,23.0,5,2,16,16,0,2,2,10.0,143.0,72,7,11,18,91.0,82,5.32,47,271,2439,8.9,0.21579543
29064,29064,Zach Boychuk,2013-14,24.0,6,2,13,13,1,1,2,14.0,160.0,85,8,12,20,105.0,48,5.31,29,160,1399,9.1,0.2348625
29065,29065,Zach Boychuk,2014-15,25.0,7,4,11,11,1,3,4,15.0,112.0,96,9,15,24,120.0,82,5.34,48,269,2463,8.9,0.21478012
29066,29066,Zach Boychuk,2015-16,26.0,8,6,31,31,3,3,6,35.0,329.0,127,12,18,30,155.0,82,5.32,47,251,2453,8.9,0.19510141
29067,29067,Zach Hamill,2010-11,22.0,2,1,1,1,0,1,1,1.0,12.0,1,0,1,1,1.0,82,5.53,56,304,2486,9.1,0.20024872
29068,29068,Zach Hamill,2011-12,23.0,3,1,3,3,0,1,1,1.0,31.0,4,0,2,2,2.0,82,5.46,52,291,2492,9.0,0.19542554
29069,29069,Zach Hamill,2012-13,24.0,4,2,16,16,0,2,2,13.0,176.0,20,0,4,4,15.0,82,5.32,47,271,2439,8.9,0.16658959
29070,29070,Zach Hyman,2016-17,24.0,2,6,16,16,4,2,6,37.0,251.0,16,4,2,6,37.0,82,5.34,48,255,2438,9.0,0.27439404
29071,29071,Zach Hyman,2017-18,25.0,3,28,82,82,10,18,28,156.0,1369.0,98,14,20,34,193.0,82,5.45,47,245,2478,9.0,0.3784098
29072,29072,Zach Hyman,2018-19,26.0,4,40,82,82,15,25,40,148.0,1423.0,180,29,45,74,341.0,82,5.86,50,250,2620,9.2,0.49845526
29073,29073,Zach Hyman,2019-20,27.0,5,41,71,71,21,20,41,144.0,1227.0,251,50,65,115,485.0,82,5.96,47,239,2579,9.5,0.50433445
29074,29074,Zach Hyman,2020-21,28.0,6,37,51,51,21,16,37,106.0,974.0,302,71,81,152,591.0,70,5.96,42,208,2192,9.5,0.6049537
29075,29075,Zach Parise,2006-07,22.0,2,32,81,81,14,18,32,133.0,1064.0,81,14,18,32,133.0,82,6.05,85,480,2458,10.1,0.46612
29076,29076,Zach Parise,2007-08,23.0,3,62,82,82,31,31,62,247.0,1438.0,163,45,49,94,380.0,82,5.76,70,398,2426,9.7,0.7278914
29077,29077,Zach Parise,2008-09,24.0,4,65,81,81,32,33,65,266.0,1463.0,244,77,82,159,646.0,82,5.44,62,351,2383,9.4,0.8490325
29078,29078,Zach Parise,2009-10,25.0,5,94,82,82,45,49,94,364.0,1538.0,326,122,131,253,1010.0,82,5.7,65,341,2477,9.4,1.0321009
29079,29079,Zach Parise,2010-11,26.0,6,82,81,81,38,44,82,347.0,1602.0,407,160,175,335,1357.0,82,5.53,56,304,2486,9.1,0.90932494
29080,29080,Zach Parise,2011-12,27.0,7,6,13,13,3,3,6,49.0,258.0,420,163,178,341,1406.0,82,5.46,52,291,2492,9.0,0.5567166
29081,29081,Zach Parise,2012-13,28.0,8,69,82,82,31,38,69,293.0,1762.0,502,194,216,410,1699.0,82,5.32,47,271,2439,8.9,0.8777092
29082,29082,Zach Parise,2013-14,29.0,9,38,48,48,18,20,38,182.0,992.0,550,212,236,448,1881.0,48,5.31,29,160,1399,9.1,0.784335
29083,29083,Zach Parise,2014-15,30.0,10,56,67,67,29,27,56,245.0,1369.0,617,241,263,504,2126.0,82,5.34,48,269,2463,8.9,0.7475972
29084,29084,Zach Parise,2015-16,31.0,11,62,74,74,33,29,62,259.0,1420.0,691,274,292,566,2385.0,82,5.32,47,251,2453,8.9,0.71623355
29085,29085,Zach Parise,2016-17,32.0,12,53,70,70,25,28,53,234.0,1350.0,761,299,320,619,2619.0,82,5.34,48,255,2438,9.0,0.6919857
29086,29086,Zach Parise,2017-18,33.0,13,42,69,69,19,23,42,194.0,1203.0,830,318,343,661,2813.0,82,5.45,47,245,2478,9.0,0.64524066
29087,29087,Zach Parise,2018-19,34.0,14,24,42,42,15,9,24,119.0,717.0,872,333,352,685,2932.0,82,5.86,50,250,2620,9.2,0.53496224
29088,29088,Zach Parise,2019-20,35.0,15,61,74,74,28,33,61,229.0,1381.0,946,361,385,746,3161.0,82,5.96,47,239,2579,9.5,0.6508751
29089,29089,Zach Parise,2020-21,36.0,16,46,69,69,25,21,46,155.0,1187.0,1015,386,406,792,3316.0,70,5.96,42,208,2192,9.5,0.5726512
29090,29090,Zach Redmond,2013-14,25.0,2,4,8,8,1,3,4,13.0,157.0,8,1,3,4,13.0,48,5.31,29,160,1399,9.1,0.24539602
29091,29091,Zach Redmond,2014-15,26.0,3,3,10,10,1,2,3,10.0,153.0,18,2,5,7,23.0,82,5.34,48,269,2463,8.9,0.2018047
29092,29092,Zach Redmond,2015-16,27.0,4,20,59,59,5,15,20,93.0,1012.0,77,7,20,27,116.0,82,5.32,47,251,2453,8.9,0.27991772
29093,29093,Zach Redmond,2016-17,28.0,5,6,37,37,2,4,6,22.0,436.0,114,9,24,33,138.0,82,5.34,48,255,2438,9.0,0.17762485
29094,29094,Zach Redmond,2017-18,29.0,6,5,16,16,0,5,5,12.0,197.0,130,9,29,38,150.0,82,5.45,47,245,2478,9.0,0.15239164
29095,29095,Zach Redmond,2018-19,30.0,7,0,3,3,0,0,0,7.0,43.0,133,9,29,38,157.0,82,5.86,50,250,2620,9.2,0.13004139
29096,29096,Zach Sanford,2017-18,23.0,2,8,39,39,4,4,8,36.0,423.0,39,4,4,8,36.0,82,5.45,47,245,2478,9.0,0.25150394
29097,29097,Zach Sanford,2019-20,25.0,3,20,60,60,8,12,20,77.0,755.0,99,12,16,28,113.0,82,5.96,47,239,2579,9.5,0.31649268
29098,29098,Zach Sanford,2020-21,26.0,4,30,58,58,16,14,30,90.0,797.0,157,28,30,58,203.0,70,5.96,42,208,2192,9.5,0.45084953
29099,29099,Zach Sill,2014-15,26.0,2,0,20,20,0,0,0,14.0,216.0,20,0,0,0,14.0,82,5.34,48,269,2463,8.9,0.11150515
29100,29100,Zach Sill,2015-16,27.0,3,4,63,63,1,3,4,43.0,528.0,83,1,3,4,57.0,82,5.32,47,251,2453,8.9,0.11613026
29101,29101,Zach Sill,2016-17,28.0,4,1,10,10,1,0,1,13.0,99.0,93,2,3,5,70.0,82,5.34,48,255,2438,9.0,0.15876117
29102,29102,Zach Trotman,2014-15,24.0,2,0,2,2,0,0,0,4.0,30.0,2,0,0,0,4.0,82,5.34,48,269,2463,8.9,0.16720265
29103,29103,Zach Trotman,2015-16,25.0,3,5,27,27,1,4,5,46.0,443.0,29,1,4,5,50.0,82,5.32,47,251,2453,8.9,0.19540682
29104,29104,Zach Trotman,2016-17,26.0,4,7,38,38,2,5,7,60.0,705.0,67,3,9,12,110.0,82,5.34,48,255,2438,9.0,0.19581354
29105,29105,Zach Trotman,2018-19,28.0,5,0,3,3,0,0,0,6.0,38.0,70,3,9,12,116.0,82,5.86,50,250,2620,9.2,0.14298308
29106,29106,Zach Trotman,2019-20,29.0,6,1,13,13,0,1,1,16.0,198.0,83,3,10,13,132.0,82,5.96,47,239,2579,9.5,0.14890397
29107,29107,Zach Trotman,2020-21,30.0,7,0,8,8,0,0,0,11.0,118.0,91,3,10,13,143.0,70,5.96,42,208,2192,9.5,0.15183216
29108,29108,Zach Werenski,2017-18,20.0,2,47,78,78,11,36,47,188.0,1631.0,78,11,36,47,188.0,82,5.45,47,245,2478,9.0,0.63854957
29109,29109,Zach Werenski,2018-19,21.0,3,37,77,77,16,21,37,207.0,1738.0,155,27,57,84,395.0,82,5.86,50,250,2620,9.2,0.57274735
29110,29110,Zach Werenski,2019-20,22.0,4,44,82,82,11,33,44,168.0,1878.0,237,38,90,128,563.0,82,5.96,47,239,2579,9.5,0.5800001
29111,29111,Zach Werenski,2020-21,23.0,5,41,63,63,20,21,41,187.0,1511.0,300,58,111,169,750.0,70,5.96,42,208,2192,9.5,0.7489763
29112,29112,Zach Whitecloud,2018-19,22.0,2,0,1,1,0,0,0,0.0,17.0,1,0,0,0,0.0,82,5.86,50,250,2620,9.2,0.15903813
29113,29113,Zach Whitecloud,2020-21,24.0,3,1,16,16,0,1,1,9.0,229.0,17,0,1,1,9.0,70,5.96,42,208,2192,9.5,0.18541783
29114,29114,Zachary Senyshyn,2019-20,22.0,2,1,2,2,1,0,1,4.0,23.0,2,1,0,1,4.0,82,5.96,47,239,2579,9.5,0.24003139
29115,29115,Zachary Senyshyn,2020-21,23.0,3,2,4,4,0,2,2,1.0,34.0,6,1,2,3,5.0,70,5.96,42,208,2192,9.5,0.24129385
29116,29116,Zack Fitzgerald,2008-09,23.0,2,0,1,1,0,0,0,1.0,13.0,1,0,0,0,1.0,82,5.44,62,351,2383,9.4,0.18452415
29117,29117,Zack Kassian,2012-13,22.0,2,10,44,44,4,6,10,54.0,497.0,44,4,6,10,54.0,82,5.32,47,271,2439,8.9,0.2432945
29118,29118,Zack Kassian,2013-14,23.0,3,11,39,39,7,4,11,49.0,526.0,83,11,10,21,103.0,48,5.31,29,160,1399,9.1,0.33435693
29119,29119,Zack Kassian,2014-15,24.0,4,29,73,73,14,15,29,91.0,944.0,156,25,25,50,194.0,82,5.34,48,269,2463,8.9,0.37626997
29120,29120,Zack Kassian,2015-16,25.0,5,16,42,42,10,6,16,55.0,530.0,198,35,31,66,249.0,82,5.32,47,251,2453,8.9,0.3358875
29121,29121,Zack Kassian,2016-17,26.0,6,8,36,36,3,5,8,42.0,448.0,234,38,36,74,291.0,82,5.34,48,255,2438,9.0,0.24193662
29122,29122,Zack Kassian,2017-18,27.0,7,24,79,79,7,17,24,110.0,972.0,313,45,53,98,401.0,82,5.45,47,245,2478,9.0,0.2838877
29123,29123,Zack Kassian,2018-19,28.0,8,19,74,74,7,12,19,86.0,864.0,387,52,65,117,487.0,82,5.86,50,250,2620,9.2,0.27518046
29124,29124,Zack Kassian,2019-20,29.0,9,26,79,79,15,11,26,111.0,1169.0,466,67,76,143,598.0,82,5.96,47,239,2579,9.5,0.32745412
29125,29125,Zack Kassian,2020-21,30.0,10,34,59,59,15,19,34,99.0,924.0,525,82,95,177,697.0,70,5.96,42,208,2192,9.5,0.44009715
29126,29126,Zack MacEwen,2019-20,23.0,2,1,4,4,0,1,1,2.0,29.0,4,0,1,1,2.0,82,5.96,47,239,2579,9.5,0.20680797
29127,29127,Zack MacEwen,2020-21,24.0,3,6,17,17,5,1,6,17.0,163.0,21,5,2,7,19.0,70,5.96,42,208,2192,9.5,0.3202538
29128,29128,Zack Mitchell,2017-18,25.0,2,0,11,11,0,0,0,10.0,93.0,11,0,0,0,10.0,82,5.45,47,245,2478,9.0,0.18208998
29129,29129,Zack Mitchell,2018-19,26.0,3,5,23,23,3,2,5,17.0,242.0,34,3,2,5,27.0,82,5.86,50,250,2620,9.2,0.2040036
29130,29130,Zack Smith,2009-10,21.0,2,0,1,1,0,0,0,0.0,7.0,1,0,0,0,0.0,82,5.7,65,341,2477,9.4,0.20099464
29131,29131,Zack Smith,2010-11,22.0,3,3,15,15,2,1,3,11.0,136.0,16,2,1,3,11.0,82,5.53,56,304,2486,9.1,0.24970624
29132,29132,Zack Smith,2011-12,23.0,4,9,55,55,4,5,9,78.0,693.0,71,6,6,12,89.0,82,5.46,52,291,2492,9.0,0.23804095
29133,29133,Zack Smith,2012-13,24.0,5,26,81,81,14,12,26,134.0,1140.0,152,20,18,38,223.0,82,5.32,47,271,2439,8.9,0.36797664
29134,29134,Zack Smith,2013-14,25.0,6,15,48,48,4,11,15,94.0,727.0,200,24,29,53,317.0,48,5.31,29,160,1399,9.1,0.30907908
29135,29135,Zack Smith,2014-15,26.0,7,22,82,82,13,9,22,154.0,1274.0,282,37,38,75,471.0,82,5.34,48,269,2463,8.9,0.30289268
29136,29136,Zack Smith,2015-16,27.0,8,3,37,37,2,1,3,38.0,445.0,319,39,39,78,509.0,82,5.32,47,251,2453,8.9,0.19047087
29137,29137,Zack Smith,2016-17,28.0,9,36,81,81,25,11,36,121.0,1247.0,400,64,50,114,630.0,82,5.34,48,255,2438,9.0,0.41437036
29138,29138,Zack Smith,2017-18,29.0,10,32,74,74,16,16,32,137.0,1212.0,474,80,66,146,767.0,82,5.45,47,245,2478,9.0,0.38070276
29139,29139,Zack Smith,2018-19,30.0,11,19,68,68,5,14,19,124.0,1137.0,542,85,80,165,891.0,82,5.86,50,250,2620,9.2,0.26490405
29140,29140,Zack Smith,2019-20,31.0,12,28,70,70,9,19,28,101.0,1145.0,612,94,99,193,992.0,82,5.96,47,239,2579,9.5,0.3208406
29141,29141,Zack Smith,2020-21,32.0,13,11,50,50,4,7,11,43.0,589.0,662,98,106,204,1035.0,70,5.96,42,208,2192,9.5,0.259288
29142,29142,Zack Stortini,2007-08,22.0,2,1,29,29,1,0,1,17.0,207.0,29,1,0,1,17.0,82,5.76,70,398,2426,9.7,0.17293826
29143,29143,Zack Stortini,2008-09,23.0,3,12,66,66,3,9,12,38.0,539.0,95,4,9,13,55.0,82,5.44,62,351,2383,9.4,0.19485605
29144,29144,Zack Stortini,2009-10,24.0,4,11,52,52,6,5,11,23.0,379.0,147,10,14,24,78.0,82,5.7,65,341,2477,9.4,0.20429528
29145,29145,Zack Stortini,2010-11,25.0,5,13,77,77,4,9,13,46.0,715.0,224,14,23,37,124.0,82,5.53,56,304,2486,9.1,0.16557622
29146,29146,Zack Stortini,2011-12,26.0,6,4,32,32,0,4,4,16.0,227.0,256,14,27,41,140.0,82,5.46,52,291,2492,9.0,0.12719738
29147,29147,Zack Stortini,2012-13,27.0,7,0,1,1,0,0,0,1.0,5.0,257,14,27,41,141.0,82,5.32,47,271,2439,8.9,0.13335148
29148,29148,Zarley Zalapski,1988-89,20.0,2,11,15,15,3,8,11,31.0,,15,3,8,11,31.0,80,7.43,89,437,2435,12.2,0.502861
29149,29149,Zarley Zalapski,1989-90,21.0,3,45,58,58,12,33,45,95.0,,73,15,41,56,126.0,80,7.48,85,403,2430,12.3,0.65190715
29150,29150,Zarley Zalapski,1990-91,22.0,4,31,51,51,6,25,31,85.0,,124,21,66,87,211.0,80,7.37,76,367,2421,12.2,0.57450527
29151,29151,Zarley Zalapski,1991-92,23.0,5,54,77,77,15,39,54,156.0,,201,36,105,141,367.0,80,6.91,71,366,2385,11.6,0.74885577
29152,29152,Zarley Zalapski,1992-93,24.0,6,57,79,79,20,37,57,230.0,,280,56,142,198,597.0,80,6.96,77,402,2440,11.4,0.7816789
29153,29153,Zarley Zalapski,1993-94,25.0,7,65,83,83,14,51,65,192.0,,363,70,193,263,789.0,84,7.25,87,443,2603,11.7,0.7520658
29154,29154,Zarley Zalapski,1994-95,26.0,8,47,69,69,10,37,47,156.0,,432,80,230,310,945.0,84,6.48,76,407,2545,10.7,0.63925016
29155,29155,Zarley Zalapski,1995-96,27.0,9,28,48,48,4,24,28,76.0,,480,84,254,338,1021.0,48,5.97,37,209,1408,10.2,0.53423315
29156,29156,Zarley Zalapski,1996-97,28.0,10,29,80,80,12,17,29,145.0,,560,96,271,367,1166.0,82,6.29,74,413,2481,10.4,0.36738133
29157,29157,Zarley Zalapski,1997-98,29.0,11,0,2,2,0,0,0,7.0,,562,96,271,367,1173.0,82,5.83,55,336,2444,9.8,0.31601256
29158,29158,Zarley Zalapski,1998-99,30.0,12,15,63,63,3,12,15,73.0,,625,99,283,382,1246.0,82,5.28,57,380,2242,9.6,0.26396388
29159,29159,Zarley Zalapski,2000-01,32.0,13,2,12,12,0,2,2,6.0,170.0,637,99,285,384,1252.0,82,5.49,53,331,2294,9.8,0.22973394
29160,29160,Zbynek Michalek,2004-05,22.0,2,2,22,22,1,1,2,17.0,313.0,22,1,1,2,17.0,82,5.14,57,348,2300,9.2,0.19559035
29161,29161,Zbynek Michalek,2006-07,24.0,3,24,82,82,9,15,24,105.0,1872.0,104,10,16,26,122.0,82,6.05,85,480,2458,10.1,0.3238623
29162,29162,Zbynek Michalek,2007-08,25.0,4,28,82,82,4,24,28,144.0,1941.0,186,14,40,54,266.0,82,5.76,70,398,2426,9.7,0.35904127
29163,29163,Zbynek Michalek,2008-09,26.0,5,17,75,75,4,13,17,92.0,1620.0,261,18,53,71,358.0,82,5.44,62,351,2383,9.4,0.26498118
29164,29164,Zbynek Michalek,2009-10,27.0,6,27,82,82,6,21,27,106.0,1863.0,343,24,74,98,464.0,82,5.7,65,341,2477,9.4,0.3214981
29165,29165,Zbynek Michalek,2010-11,28.0,7,17,72,72,3,14,17,104.0,1631.0,415,27,88,115,568.0,82,5.53,56,304,2486,9.1,0.2563945
29166,29166,Zbynek Michalek,2011-12,29.0,8,19,73,73,5,14,19,104.0,1594.0,488,32,102,134,672.0,82,5.46,52,291,2492,9.0,0.2695045
29167,29167,Zbynek Michalek,2012-13,30.0,9,13,62,62,2,11,13,77.0,1342.0,550,34,113,147,749.0,82,5.32,47,271,2439,8.9,0.177181
29168,29168,Zbynek Michalek,2013-14,31.0,10,2,34,34,0,2,2,42.0,724.0,584,34,115,149,791.0,48,5.31,29,160,1399,9.1,0.16121694
29169,29169,Zbynek Michalek,2014-15,32.0,11,10,59,59,2,8,10,78.0,1238.0,643,36,123,159,869.0,82,5.34,48,269,2463,8.9,0.17402118
29170,29170,Zbynek Michalek,2015-16,33.0,12,12,68,68,4,8,12,86.0,1412.0,711,40,131,171,955.0,82,5.32,47,251,2453,8.9,0.1581313
29171,29171,Zbynek Michalek,2016-17,34.0,13,7,70,70,2,5,7,69.0,1191.0,781,42,136,178,1024.0,82,5.34,48,255,2438,9.0,0.13832456
29172,29172,Zbynek Michalek,2017-18,35.0,14,0,3,3,0,0,0,3.0,53.0,784,42,136,178,1027.0,82,5.45,47,245,2478,9.0,0.1119695
29173,29173,Zdenek Blatny,2003-04,23.0,2,0,4,4,0,0,0,2.0,42.0,4,0,0,0,2.0,82,5.31,60,363,2326,9.4,0.17814761
29174,29174,Zdenek Blatny,2004-05,24.0,3,3,16,16,3,0,3,17.0,167.0,20,3,0,3,19.0,82,5.14,57,348,2300,9.2,0.246961
29175,29175,Zdenek Blatny,2006-07,26.0,4,0,5,5,0,0,0,3.0,26.0,25,3,0,3,22.0,82,6.05,85,480,2458,10.1,0.15508229
29176,29176,Zdenek Kutlak,2001-02,21.0,2,2,10,10,0,2,2,7.0,161.0,10,0,2,2,7.0,82,5.51,63,376,2272,9.9,0.21100885
29177,29177,Zdenek Kutlak,2003-04,23.0,3,1,4,4,1,0,1,1.0,21.0,14,1,2,3,8.0,82,5.31,60,363,2326,9.4,0.20791706
29178,29178,Zdenek Kutlak,2004-05,24.0,4,0,2,2,0,0,0,0.0,23.0,16,1,2,3,8.0,82,5.14,57,348,2300,9.2,0.1757989
29179,29179,Zdenek Nedved,1995-96,20.0,2,0,1,1,0,0,0,0.0,,1,0,0,0,0.0,48,5.97,37,209,1408,10.2,0.23960996
29180,29180,Zdenek Nedved,1996-97,21.0,3,2,7,7,1,1,2,7.0,,8,1,1,2,7.0,82,6.29,74,413,2481,10.4,0.25555286
29181,29181,Zdenek Nedved,1997-98,22.0,4,8,23,23,3,5,8,22.0,,31,4,6,10,29.0,82,5.83,55,336,2444,9.8,0.29715928
29182,29182,Zdeno Chara,1998-99,21.0,2,1,25,25,0,1,1,10.0,,25,0,1,1,10.0,82,5.28,57,380,2242,9.6,0.16663036
29183,29183,Zdeno Chara,1999-00,22.0,3,8,59,59,2,6,8,56.0,1115.0,84,2,7,9,66.0,82,5.27,57,359,2285,9.4,0.18611234
29184,29184,Zdeno Chara,2000-01,23.0,4,11,65,65,2,9,11,47.0,1486.0,149,4,16,20,113.0,82,5.49,53,331,2294,9.8,0.19050011
29185,29185,Zdeno Chara,2001-02,24.0,5,9,82,82,2,7,9,83.0,1832.0,231,6,23,29,196.0,82,5.51,63,376,2272,9.9,0.19649905
29186,29186,Zdeno Chara,2002-03,25.0,6,23,75,75,10,13,23,105.0,1670.0,306,16,36,52,301.0,82,5.24,53,338,2262,9.5,0.28539282
29187,29187,Zdeno Chara,2003-04,26.0,7,39,74,74,9,30,39,168.0,1847.0,380,25,66,91,469.0,82,5.31,60,363,2326,9.4,0.47011557
29188,29188,Zdeno Chara,2004-05,27.0,8,41,79,79,16,25,41,185.0,1946.0,459,41,91,132,654.0,82,5.14,57,348,2300,9.2,0.61575866
29189,29189,Zdeno Chara,2006-07,29.0,9,43,71,71,16,27,43,212.0,1930.0,530,57,118,175,866.0,82,6.05,85,480,2458,10.1,0.5065345
29190,29190,Zdeno Chara,2007-08,30.0,10,43,80,80,11,32,43,204.0,2237.0,610,68,150,218,1070.0,82,5.76,70,398,2426,9.7,0.49104512
29191,29191,Zdeno Chara,2008-09,31.0,11,51,77,77,17,34,51,207.0,2067.0,687,85,184,269,1277.0,82,5.44,62,351,2383,9.4,0.55817884
29192,29192,Zdeno Chara,2009-10,32.0,12,50,80,80,19,31,50,216.0,2085.0,767,104,215,319,1493.0,82,5.7,65,341,2477,9.4,0.560896
29193,29193,Zdeno Chara,2010-11,33.0,13,44,80,80,7,37,44,242.0,2030.0,847,111,252,363,1735.0,82,5.53,56,304,2486,9.1,0.55958563
29194,29194,Zdeno Chara,2011-12,34.0,14,44,81,81,14,30,44,264.0,2060.0,928,125,282,407,1999.0,82,5.46,52,291,2492,9.0,0.51955265
29195,29195,Zdeno Chara,2012-13,35.0,15,52,79,79,12,40,52,224.0,1975.0,1007,137,322,459,2223.0,82,5.32,47,271,2439,8.9,0.5493803
29196,29196,Zdeno Chara,2013-14,36.0,16,19,48,48,7,12,19,119.0,1197.0,1055,144,334,478,2342.0,48,5.31,29,160,1399,9.1,0.4406396
29197,29197,Zdeno Chara,2014-15,37.0,17,40,77,77,17,23,40,168.0,1898.0,1132,161,357,518,2510.0,82,5.34,48,269,2463,8.9,0.42702237
29198,29198,Zdeno Chara,2015-16,38.0,18,20,63,63,8,12,20,138.0,1471.0,1195,169,369,538,2648.0,82,5.32,47,251,2453,8.9,0.32070774
29199,29199,Zdeno Chara,2016-17,39.0,19,37,80,80,9,28,37,158.0,1928.0,1275,178,397,575,2806.0,82,5.34,48,255,2438,9.0,0.3929774
29200,29200,Zdeno Chara,2017-18,40.0,20,29,75,75,10,19,29,136.0,1750.0,1350,188,416,604,2942.0,82,5.45,47,245,2478,9.0,0.29651552
29201,29201,Zdeno Chara,2018-19,41.0,21,24,73,73,7,17,24,144.0,1672.0,1423,195,433,628,3086.0,82,5.86,50,250,2620,9.2,0.28886425
29202,29202,Zdeno Chara,2019-20,42.0,22,14,62,62,5,9,14,99.0,1307.0,1485,200,442,642,3185.0,82,5.96,47,239,2579,9.5,0.22198206
29203,29203,Zdeno Chara,2020-21,43.0,23,14,68,68,5,9,14,86.0,1429.0,1553,205,451,656,3271.0,70,5.96,42,208,2192,9.5,0.24480402
29204,29204,Zdeno Ciger,1991-92,22.0,2,25,45,45,8,17,25,82.0,,45,8,17,25,82.0,80,6.91,71,366,2385,11.6,0.50601447
29205,29205,Zdeno Ciger,1992-93,23.0,3,11,20,20,6,5,11,33.0,,65,14,22,36,115.0,80,6.96,77,402,2440,11.4,0.4520869
29206,29206,Zdeno Ciger,1993-94,24.0,4,36,64,64,13,23,36,106.0,,129,27,45,72,221.0,84,7.25,87,443,2603,11.7,0.48524907
29207,29207,Zdeno Ciger,1994-95,25.0,5,57,84,84,22,35,57,158.0,,213,49,80,129,379.0,84,6.48,76,407,2545,10.7,0.5809052
29208,29208,Zdeno Ciger,1995-96,26.0,6,4,5,5,2,2,4,10.0,,218,51,82,133,389.0,48,5.97,37,209,1408,10.2,0.46712723
29209,29209,Zdeno Ciger,1996-97,27.0,7,70,78,78,31,39,70,184.0,,296,82,121,203,573.0,82,6.29,74,413,2481,10.4,0.7311672
29210,29210,Zdeno Ciger,2002-03,33.0,8,25,56,56,12,13,25,92.0,856.0,352,94,134,228,665.0,82,5.24,53,338,2262,9.5,0.44873485
29211,29211,Zemgus Girgensons,2014-15,21.0,2,22,70,70,8,14,22,115.0,1072.0,70,8,14,22,115.0,82,5.34,48,269,2463,8.9,0.36762214
29212,29212,Zemgus Girgensons,2015-16,22.0,3,30,61,61,15,15,30,115.0,1164.0,131,23,29,52,230.0,82,5.32,47,251,2453,8.9,0.47311407
29213,29213,Zemgus Girgensons,2016-17,23.0,4,18,71,71,7,11,18,110.0,1068.0,202,30,40,70,340.0,82,5.34,48,255,2438,9.0,0.36165166
29214,29214,Zemgus Girgensons,2017-18,24.0,5,16,75,75,7,9,16,112.0,987.0,277,37,49,86,452.0,82,5.45,47,245,2478,9.0,0.29455912
29215,29215,Zemgus Girgensons,2018-19,25.0,6,15,71,71,7,8,15,113.0,973.0,348,44,57,101,565.0,82,5.86,50,250,2620,9.2,0.24598145
29216,29216,Zemgus Girgensons,2019-20,26.0,7,18,72,72,5,13,18,78.0,980.0,420,49,70,119,643.0,82,5.96,47,239,2579,9.5,0.27016854
29217,29217,Zemgus Girgensons,2020-21,27.0,8,19,69,69,12,7,19,85.0,952.0,489,61,77,138,728.0,70,5.96,42,208,2192,9.5,0.28548387
29218,29218,Zenith Komarniski,2000-01,22.0,2,2,18,18,1,1,2,21.0,291.0,18,1,1,2,21.0,82,5.49,53,331,2294,9.8,0.22526067
29219,29219,Zenith Komarniski,2003-04,25.0,3,0,1,1,0,0,0,0.0,6.0,19,1,1,2,21.0,82,5.31,60,363,2326,9.4,0.15240896
29220,29220,Zenith Komarniski,2004-05,26.0,4,0,2,2,0,0,0,1.0,30.0,21,1,1,2,22.0,82,5.14,57,348,2300,9.2,0.1453157
29221,29221,Zenon Konopka,2006-07,26.0,2,7,23,23,4,3,7,18.0,168.0,23,4,3,7,18.0,82,6.05,85,480,2458,10.1,0.22438976
29222,29222,Zenon Konopka,2007-08,27.0,3,0,6,6,0,0,0,2.0,30.0,29,4,3,7,20.0,82,5.76,70,398,2426,9.7,0.14659503
29223,29223,Zenon Konopka,2008-09,28.0,4,0,3,3,0,0,0,4.0,24.0,32,4,3,7,24.0,82,5.44,62,351,2383,9.4,0.15198669
29224,29224,Zenon Konopka,2009-10,29.0,5,1,7,7,0,1,1,6.0,49.0,39,4,4,8,30.0,82,5.7,65,341,2477,9.4,0.1401397
29225,29225,Zenon Konopka,2010-11,30.0,6,5,74,74,2,3,5,41.0,602.0,113,6,7,13,71.0,82,5.53,56,304,2486,9.1,0.1307427
29226,29226,Zenon Konopka,2011-12,31.0,7,9,82,82,2,7,9,56.0,836.0,195,8,14,22,127.0,82,5.46,52,291,2492,9.0,0.11857921
29227,29227,Zenon Konopka,2012-13,32.0,8,5,55,55,3,2,5,34.0,431.0,250,11,16,27,161.0,82,5.32,47,271,2439,8.9,0.10685313
29228,29228,Zenon Konopka,2013-14,33.0,9,0,37,37,0,0,0,18.0,312.0,287,11,16,27,179.0,48,5.31,29,160,1399,9.1,0.06669089
29229,29229,Zenon Konopka,2014-15,34.0,10,3,59,59,1,2,3,21.0,466.0,346,12,18,30,200.0,82,5.34,48,269,2463,8.9,0.07289639
29230,29230,Ziggy Palffy,1994-95,22.0,2,0,5,5,0,0,0,5.0,,5,0,0,0,5.0,84,6.48,76,407,2545,10.7,0.19320032
29231,29231,Ziggy Palffy,1995-96,23.0,3,17,33,33,10,7,17,75.0,,38,10,7,17,80.0,48,5.97,37,209,1408,10.2,0.4596913
29232,29232,Ziggy Palffy,1996-97,24.0,4,87,81,81,43,44,87,257.0,,119,53,51,104,337.0,82,6.29,74,413,2481,10.4,0.9390446
29233,29233,Ziggy Palffy,1997-98,25.0,5,90,80,80,48,42,90,292.0,,199,101,93,194,629.0,82,5.83,55,336,2444,9.8,1.0639882
29234,29234,Ziggy Palffy,1998-99,26.0,6,87,82,82,45,42,87,277.0,,281,146,135,281,906.0,82,5.28,57,380,2242,9.6,1.0187055
29235,29235,Ziggy Palffy,1999-00,27.0,7,50,50,50,22,28,50,168.0,1103.0,331,168,163,331,1074.0,82,5.27,57,359,2285,9.4,0.94891167
29236,29236,Ziggy Palffy,2000-01,28.0,8,66,64,64,27,39,66,186.0,1258.0,395,195,202,397,1260.0,82,5.49,53,331,2294,9.8,1.1137726
29237,29237,Ziggy Palffy,2001-02,29.0,9,89,73,73,38,51,89,217.0,1443.0,468,233,253,486,1477.0,82,5.51,63,376,2272,9.9,1.0257866
29238,29238,Ziggy Palffy,2002-03,30.0,10,59,63,63,32,27,59,161.0,1279.0,531,265,280,545,1638.0,82,5.24,53,338,2262,9.5,0.87451863
29239,29239,Ziggy Palffy,2003-04,31.0,11,85,76,76,37,48,85,277.0,1706.0,607,302,328,630,1915.0,82,5.31,60,363,2326,9.4,1.005847
29240,29240,Ziggy Palffy,2004-05,32.0,12,41,35,35,16,25,41,109.0,754.0,642,318,353,671,2024.0,82,5.14,57,348,2300,9.2,0.90106857
29241,29241,Ziggy Palffy,2006-07,34.0,13,42,42,42,11,31,42,112.0,812.0,684,329,384,713,2136.0,82,6.05,85,480,2458,10.1,0.72788036
