,Player,Season,Age,Player_Season_Num,PTS,GP,prev_GP,prev_G,prev_A,prev_PTS,prev_S,prev_TOI,career_GP,career_G,career_A,career_PTS,career_S,games,total_goals_per_game,goals_pp,chances_pp,shots,shot_pct
0,A.J. Greer,2019-20,23.0,4,1,5,5,0,1,1,8.0,68.0,5,0,1,1,8.0,82,5.45,47,245,2478,9.0
1,A.J. Greer,2020-21,24.0,5,3,17,17,0,3,3,13.0,126.0,22,0,4,4,21.0,82,5.86,50,250,2620,9.2
2,A.J. Greer,2021-22,25.0,6,2,15,15,1,1,2,9.0,94.0,37,1,5,6,30.0,82,5.96,47,239,2579,9.5
3,Aaron Broten,1983-84,23.0,4,0,2,2,0,0,0,1.0,,2,0,0,0,1.0,80,7.69,77,340,2441,12.6
4,Aaron Broten,1984-85,24.0,5,39,58,58,15,24,39,67.0,,60,15,24,39,68.0,80,8.03,73,320,2489,12.9
5,Aaron Broten,1985-86,25.0,6,55,73,73,16,39,55,126.0,,133,31,63,94,194.0,80,7.73,71,310,2444,12.7
6,Aaron Broten,1986-87,26.0,7,36,80,80,13,23,36,103.0,,213,44,86,130,297.0,80,7.89,74,336,2448,12.9
7,Aaron Broten,1987-88,27.0,8,57,80,80,22,35,57,169.0,,293,66,121,187,466.0,80,7.77,71,321,2447,12.7
8,Aaron Broten,1988-89,28.0,9,43,66,66,18,25,43,157.0,,359,84,146,230,623.0,80,7.94,82,370,2484,12.8
9,Aaron Broten,1989-90,29.0,10,79,80,80,26,53,79,179.0,,439,110,199,309,802.0,80,7.34,72,344,2400,12.2
10,Aaron Broten,1990-91,30.0,11,83,80,80,26,57,83,180.0,,519,136,256,392,982.0,80,7.43,89,437,2435,12.2
11,Aaron Broten,1991-92,31.0,12,59,80,80,16,43,59,178.0,,599,152,299,451,1160.0,80,7.48,85,403,2430,12.3
12,Aaron Broten,1992-93,32.0,13,36,77,77,19,17,36,148.0,,676,171,316,487,1308.0,80,7.37,76,367,2421,12.2
13,Aaron Broten,1993-94,33.0,14,19,47,47,11,8,19,85.0,,723,182,324,506,1393.0,80,6.91,71,366,2385,11.6
14,Aaron Broten,1994-95,34.0,15,9,25,25,4,5,9,29.0,,748,186,329,515,1422.0,80,6.96,77,402,2440,11.4
15,Aaron Downey,2002-03,28.0,4,0,1,1,0,0,0,0.0,9.0,1,0,0,0,0.0,82,5.49,53,331,2294,9.8
16,Aaron Downey,2003-04,29.0,5,0,3,3,0,0,0,2.0,17.0,4,0,0,0,2.0,82,5.51,63,376,2272,9.9
17,Aaron Downey,2004-05,30.0,6,1,36,36,1,0,1,10.0,184.0,40,1,0,1,12.0,82,5.24,53,338,2262,9.5
18,Aaron Downey,2005-06,31.0,7,2,43,43,1,1,2,14.0,205.0,83,2,1,3,26.0,82,5.31,60,363,2326,9.4
19,Aaron Downey,2006-07,32.0,8,2,37,37,1,1,2,11.0,167.0,120,3,2,5,37.0,82,5.14,57,348,2300,9.2
20,Aaron Downey,2008-09,34.0,9,7,42,42,3,4,7,21.0,235.0,162,6,6,12,58.0,82,6.05,85,480,2458,10.1
21,Aaron Downey,2009-10,35.0,10,1,21,21,1,0,1,10.0,105.0,183,7,6,13,68.0,82,5.76,70,398,2426,9.7
22,Aaron Downey,2010-11,36.0,11,3,56,56,0,3,3,15.0,257.0,239,7,9,16,83.0,82,5.44,62,351,2383,9.4
23,Aaron Downey,2011-12,37.0,12,2,4,4,1,1,2,2.0,21.0,243,8,10,18,85.0,82,5.7,65,341,2477,9.4
24,Aaron Ekblad,2017-18,21.0,4,39,81,81,12,27,39,170.0,1767.0,81,12,27,39,170.0,82,5.32,47,251,2453,8.9
25,Aaron Ekblad,2018-19,22.0,5,36,78,78,15,21,36,182.0,1691.0,159,27,48,75,352.0,82,5.34,48,255,2438,9.0
26,Aaron Ekblad,2019-20,23.0,6,21,68,68,10,11,21,225.0,1459.0,227,37,59,96,577.0,82,5.45,47,245,2478,9.0
27,Aaron Ekblad,2020-21,24.0,7,38,82,82,16,22,38,189.0,1918.0,309,53,81,134,766.0,82,5.86,50,250,2620,9.2
28,Aaron Ekblad,2021-22,25.0,8,37,82,82,13,24,37,180.0,1939.0,391,66,105,171,946.0,82,5.96,47,239,2579,9.5
29,Aaron Ekblad,2022-23,26.0,9,41,67,67,5,36,41,147.0,1539.0,458,71,141,212,1093.0,70,5.96,42,208,2192,9.5
30,Aaron Gagnon,2012-13,26.0,4,0,2,2,0,0,0,2.0,18.0,2,0,0,0,2.0,82,5.53,56,304,2486,9.1
31,Aaron Gagnon,2013-14,27.0,5,2,19,19,0,2,2,9.0,153.0,21,0,2,2,11.0,82,5.46,52,291,2492,9.0
32,Aaron Gagnon,2014-15,28.0,6,0,7,7,0,0,0,6.0,66.0,28,0,2,2,17.0,82,5.32,47,271,2439,8.9
33,Aaron Gagnon,2015-16,29.0,7,3,10,10,3,0,3,11.0,82.0,38,3,2,5,28.0,48,5.31,29,160,1399,9.1
34,Aaron Gavey,1998-99,24.0,4,12,73,73,8,4,12,65.0,,73,8,4,12,65.0,82,6.29,74,413,2481,10.4
35,Aaron Gavey,1999-00,25.0,5,19,57,57,8,11,19,62.0,,130,16,15,31,127.0,82,5.83,55,336,2444,9.8
36,Aaron Gavey,2000-01,26.0,6,5,26,26,2,3,5,27.0,,156,18,18,36,154.0,82,5.28,57,380,2242,9.6
37,Aaron Gavey,2001-02,27.0,7,0,7,7,0,0,0,4.0,57.0,163,18,18,36,158.0,82,5.27,57,359,2285,9.4
38,Aaron Gavey,2002-03,28.0,8,13,41,41,7,6,13,39.0,406.0,204,25,24,49,197.0,82,5.49,53,331,2294,9.8
39,Aaron Gavey,2003-04,29.0,9,24,75,75,10,14,24,100.0,1050.0,279,35,38,73,297.0,82,5.51,63,376,2272,9.9
40,Aaron Gavey,2004-05,30.0,10,17,71,71,6,11,17,75.0,846.0,350,41,49,90,372.0,82,5.24,53,338,2262,9.5
41,Aaron Gavey,2005-06,31.0,11,1,5,5,0,1,1,8.0,57.0,355,41,50,91,380.0,82,5.31,60,363,2326,9.4
42,Aaron Gavey,2008-09,34.0,12,0,5,5,0,0,0,2.0,20.0,360,41,50,91,382.0,82,6.05,85,480,2458,10.1
43,Aaron Johnson,2006-07,23.0,4,8,29,29,2,6,8,33.0,436.0,29,2,6,8,33.0,82,5.14,57,348,2300,9.2
44,Aaron Johnson,2008-09,25.0,5,8,26,26,2,6,8,28.0,369.0,55,4,12,16,61.0,82,6.05,85,480,2458,10.1
45,Aaron Johnson,2009-10,26.0,6,10,61,61,3,7,10,52.0,776.0,116,7,19,26,113.0,82,5.76,70,398,2426,9.7
46,Aaron Johnson,2010-11,27.0,7,2,30,30,0,2,2,16.0,416.0,146,7,21,28,129.0,82,5.44,62,351,2383,9.4
47,Aaron Johnson,2011-12,28.0,8,8,38,38,3,5,8,27.0,537.0,184,10,26,36,156.0,82,5.7,65,341,2477,9.4
48,Aaron Johnson,2012-13,29.0,9,10,41,41,4,6,10,36.0,642.0,225,14,32,46,192.0,82,5.53,56,304,2486,9.1
49,Aaron Johnson,2014-15,31.0,10,16,56,56,3,13,16,63.0,924.0,281,17,45,62,255.0,82,5.32,47,271,2439,8.9
50,Aaron Johnson,2015-16,32.0,11,0,10,10,0,0,0,8.0,149.0,291,17,45,62,263.0,48,5.31,29,160,1399,9.1
51,Aaron MacKenzie,2011-12,30.0,4,0,5,5,0,0,0,3.0,73.0,5,0,0,0,3.0,82,5.7,65,341,2477,9.4
52,Aaron Miller,1996-97,25.0,4,0,1,1,0,0,0,0.0,,1,0,0,0,0.0,84,6.48,76,407,2545,10.7
53,Aaron Miller,1997-98,26.0,5,3,9,9,0,3,3,12.0,,10,0,3,3,12.0,48,5.97,37,209,1408,10.2
54,Aaron Miller,1998-99,27.0,6,0,5,5,0,0,0,2.0,,15,0,3,3,14.0,82,6.29,74,413,2481,10.4
55,Aaron Miller,1999-00,28.0,7,17,56,56,5,12,17,47.0,,71,5,15,20,61.0,82,5.83,55,336,2444,9.8
56,Aaron Miller,2000-01,29.0,8,4,55,55,2,2,4,29.0,,126,7,17,24,90.0,82,5.28,57,380,2242,9.6
57,Aaron Miller,2001-02,30.0,9,18,76,76,5,13,18,87.0,1658.0,202,12,30,42,177.0,82,5.27,57,359,2285,9.4
58,Aaron Miller,2002-03,31.0,10,8,53,53,1,7,8,44.0,1012.0,255,13,37,50,221.0,82,5.49,53,331,2294,9.8
59,Aaron Miller,2003-04,32.0,11,18,69,69,4,14,18,59.0,1327.0,324,17,51,68,280.0,82,5.51,63,376,2272,9.9
60,Aaron Miller,2004-05,33.0,12,17,74,74,5,12,17,75.0,1654.0,398,22,63,85,355.0,82,5.24,53,338,2262,9.5
61,Aaron Miller,2005-06,34.0,13,6,49,49,1,5,6,34.0,1053.0,447,23,68,91,389.0,82,5.31,60,363,2326,9.4
62,Aaron Miller,2006-07,35.0,14,3,35,35,1,2,3,26.0,665.0,482,24,70,94,415.0,82,5.14,57,348,2300,9.2
63,Aaron Miller,2008-09,37.0,15,8,56,56,0,8,8,32.0,1033.0,538,24,78,102,447.0,82,6.05,85,480,2458,10.1
64,Aaron Miller,2009-10,38.0,16,8,82,82,0,8,8,56.0,1607.0,620,24,86,110,503.0,82,5.76,70,398,2426,9.7
65,Aaron Miller,2010-11,39.0,17,9,57,57,1,8,9,27.0,988.0,677,25,94,119,530.0,82,5.44,62,351,2383,9.4
66,Aaron Ness,2014-15,24.0,4,0,9,9,0,0,0,6.0,152.0,9,0,0,0,6.0,82,5.32,47,271,2439,8.9
67,Aaron Ness,2016-17,26.0,5,3,20,20,1,2,3,23.0,296.0,29,1,2,3,29.0,82,5.34,48,269,2463,8.9
68,Aaron Ness,2018-19,28.0,6,2,8,8,0,2,2,8.0,99.0,37,1,4,5,37.0,82,5.34,48,255,2438,9.0
69,Aaron Ness,2019-20,29.0,7,0,2,2,0,0,0,0.0,26.0,39,1,4,5,37.0,82,5.45,47,245,2478,9.0
70,Aaron Ness,2020-21,30.0,8,1,8,8,0,1,1,2.0,102.0,47,1,5,6,39.0,82,5.86,50,250,2620,9.2
71,Aaron Ness,2022-23,32.0,9,1,24,24,0,1,1,11.0,301.0,71,1,6,7,50.0,70,5.96,42,208,2192,9.5
72,Aaron Palushaj,2013-14,24.0,4,0,3,3,0,0,0,3.0,26.0,3,0,0,0,3.0,82,5.46,52,291,2492,9.0
73,Aaron Palushaj,2014-15,25.0,5,5,38,38,1,4,5,37.0,288.0,41,1,4,5,40.0,82,5.32,47,271,2439,8.9
74,Aaron Palushaj,2015-16,26.0,6,9,25,25,2,7,9,29.0,283.0,66,3,11,14,69.0,48,5.31,29,160,1399,9.1
75,Aaron Palushaj,2016-17,27.0,7,0,2,2,0,0,0,2.0,19.0,68,3,11,14,71.0,82,5.34,48,269,2463,8.9
76,Aaron Rome,2009-10,26.0,4,0,1,1,0,0,0,1.0,15.0,1,0,0,0,1.0,82,5.76,70,398,2426,9.7
77,Aaron Rome,2010-11,27.0,5,2,17,17,1,1,2,15.0,309.0,18,1,1,2,16.0,82,5.44,62,351,2383,9.4
78,Aaron Rome,2011-12,28.0,6,1,8,8,0,1,1,7.0,124.0,26,1,2,3,23.0,82,5.7,65,341,2477,9.4
79,Aaron Rome,2012-13,29.0,7,4,49,49,0,4,4,49.0,744.0,75,1,6,7,72.0,82,5.53,56,304,2486,9.1
80,Aaron Rome,2013-14,30.0,8,5,56,56,1,4,5,50.0,975.0,131,2,10,12,122.0,82,5.46,52,291,2492,9.0
81,Aaron Rome,2014-15,31.0,9,10,43,43,4,6,10,42.0,655.0,174,6,16,22,164.0,82,5.32,47,271,2439,8.9
82,Aaron Rome,2015-16,32.0,10,5,27,27,0,5,5,15.0,414.0,201,6,21,27,179.0,48,5.31,29,160,1399,9.1
83,Aaron Rome,2016-17,33.0,11,1,25,25,0,1,1,15.0,327.0,226,6,22,28,194.0,82,5.34,48,269,2463,8.9
84,Aaron Volpatti,2013-14,28.0,4,2,15,15,1,1,2,6.0,102.0,15,1,1,2,6.0,82,5.46,52,291,2492,9.0
85,Aaron Volpatti,2014-15,29.0,5,1,23,23,1,0,1,17.0,206.0,38,2,1,3,23.0,82,5.32,47,271,2439,8.9
86,Aaron Volpatti,2015-16,30.0,6,2,33,33,1,1,2,21.0,275.0,71,3,2,5,44.0,48,5.31,29,160,1399,9.1
87,Aaron Volpatti,2016-17,31.0,7,2,41,41,2,0,2,18.0,302.0,112,5,2,7,62.0,82,5.34,48,269,2463,8.9
88,Aaron Volpatti,2017-18,32.0,8,0,2,2,0,0,0,1.0,19.0,114,5,2,7,63.0,82,5.32,47,251,2453,8.9
89,Aaron Voros,2010-11,29.0,4,14,55,55,7,7,14,52.0,505.0,55,7,7,14,52.0,82,5.44,62,351,2383,9.4
90,Aaron Voros,2011-12,30.0,5,16,54,54,8,8,16,66.0,604.0,109,15,15,30,118.0,82,5.7,65,341,2477,9.4
91,Aaron Voros,2012-13,31.0,6,7,41,41,3,4,7,22.0,252.0,150,18,19,37,140.0,82,5.53,56,304,2486,9.1
92,Aaron Voros,2013-14,32.0,7,0,12,12,0,0,0,8.0,67.0,162,18,19,37,148.0,82,5.46,52,291,2492,9.0
93,Aaron Ward,1996-97,24.0,4,1,5,5,1,0,1,3.0,,5,1,0,1,3.0,84,6.48,76,407,2545,10.7
94,Aaron Ward,1997-98,25.0,5,1,1,1,0,1,1,0.0,,6,1,1,2,3.0,48,5.97,37,209,1408,10.2
95,Aaron Ward,1999-00,27.0,6,7,49,49,2,5,7,40.0,,55,3,6,9,43.0,82,5.83,55,336,2444,9.8
96,Aaron Ward,2000-01,28.0,7,10,52,52,5,5,10,47.0,,107,8,11,19,90.0,82,5.28,57,380,2242,9.6
97,Aaron Ward,2001-02,29.0,8,11,60,60,3,8,11,46.0,835.0,167,11,19,30,136.0,82,5.27,57,359,2285,9.4
98,Aaron Ward,2002-03,30.0,9,4,36,36,1,3,4,25.0,453.0,203,12,22,34,161.0,82,5.49,53,331,2294,9.8
99,Aaron Ward,2003-04,31.0,10,9,73,73,4,5,9,48.0,1241.0,276,16,27,43,209.0,82,5.51,63,376,2272,9.9
100,Aaron Ward,2004-05,32.0,11,14,79,79,3,11,14,69.0,1554.0,355,19,38,57,278.0,82,5.24,53,338,2262,9.5
101,Aaron Ward,2005-06,33.0,12,9,77,77,3,6,9,66.0,1441.0,432,22,44,66,344.0,82,5.31,60,363,2326,9.4
102,Aaron Ward,2006-07,34.0,13,8,49,49,3,5,8,51.0,875.0,481,25,49,74,395.0,82,5.14,57,348,2300,9.2
103,Aaron Ward,2008-09,36.0,14,25,71,71,6,19,25,60.0,1358.0,552,31,68,99,455.0,82,6.05,85,480,2458,10.1
104,Aaron Ward,2009-10,37.0,15,16,80,80,4,12,16,62.0,1614.0,632,35,80,115,517.0,82,5.76,70,398,2426,9.7
105,Aaron Ward,2010-11,38.0,16,13,65,65,5,8,13,68.0,1348.0,697,40,88,128,585.0,82,5.44,62,351,2383,9.4
106,Aaron Ward,2011-12,39.0,17,10,65,65,3,7,10,53.0,1236.0,762,43,95,138,638.0,82,5.7,65,341,2477,9.4
107,Aaron Ward,2012-13,40.0,18,13,77,77,1,12,13,41.0,1332.0,839,44,107,151,679.0,82,5.53,56,304,2486,9.1
108,Adam Almqvist,2016-17,25.0,4,1,2,2,1,0,1,2.0,34.0,2,1,0,1,2.0,82,5.34,48,269,2463,8.9
109,Adam Bennett,1994-95,23.0,4,0,5,5,0,0,0,6.0,,5,0,0,0,6.0,80,6.96,77,402,2440,11.4
110,Adam Bennett,1995-96,24.0,5,2,16,16,0,2,2,15.0,,21,0,2,2,21.0,84,7.25,87,443,2603,11.7
111,Adam Bennett,1996-97,25.0,6,9,48,48,3,6,9,57.0,,69,3,8,11,78.0,84,6.48,76,407,2545,10.7
112,Adam Berti,2010-11,24.0,4,0,2,2,0,0,0,1.0,20.0,2,0,0,0,1.0,82,5.44,62,351,2383,9.4
113,Adam Boqvist,2022-23,22.0,4,13,41,41,4,9,13,50.0,665.0,41,4,9,13,50.0,70,5.96,42,208,2192,9.5
114,Adam Brooks,2022-23,26.0,4,3,7,7,0,3,3,2.0,55.0,7,0,3,3,2.0,70,5.96,42,208,2192,9.5
115,Adam Burish,2009-10,27.0,4,0,9,9,0,0,0,12.0,100.0,9,0,0,0,12.0,82,5.76,70,398,2426,9.7
116,Adam Burish,2010-11,28.0,5,8,81,81,4,4,8,69.0,952.0,90,4,4,8,81.0,82,5.44,62,351,2383,9.4
117,Adam Burish,2011-12,29.0,6,9,66,66,6,3,9,83.0,608.0,156,10,7,17,164.0,82,5.7,65,341,2477,9.4
118,Adam Burish,2012-13,30.0,7,4,13,13,1,3,4,9.0,114.0,169,11,10,21,173.0,82,5.53,56,304,2486,9.1
119,Adam Burish,2013-14,31.0,8,14,63,63,8,6,14,89.0,904.0,232,19,16,35,262.0,82,5.46,52,291,2492,9.0
120,Adam Burish,2014-15,32.0,9,19,65,65,6,13,19,82.0,831.0,297,25,29,54,344.0,82,5.32,47,271,2439,8.9
121,Adam Burish,2015-16,33.0,10,3,46,46,1,2,3,39.0,486.0,343,26,31,57,383.0,48,5.31,29,160,1399,9.1
122,Adam Burish,2016-17,34.0,11,0,15,15,0,0,0,9.0,144.0,358,26,31,57,392.0,82,5.34,48,269,2463,8.9
123,Adam Burish,2017-18,35.0,12,3,20,20,1,2,3,22.0,223.0,378,27,33,60,414.0,82,5.32,47,251,2453,8.9
124,Adam Burt,1991-92,23.0,4,0,5,5,0,0,0,1.0,,5,0,0,0,1.0,80,7.48,85,403,2430,12.3
125,Adam Burt,1992-93,24.0,5,12,63,63,4,8,12,83.0,,68,4,8,12,84.0,80,7.37,76,367,2421,12.2
126,Adam Burt,1993-94,25.0,6,9,42,42,2,7,9,43.0,,110,6,15,21,127.0,80,6.91,71,366,2385,11.6
127,Adam Burt,1994-95,26.0,7,24,66,66,9,15,24,89.0,,176,15,30,45,216.0,80,6.96,77,402,2440,11.4
128,Adam Burt,1995-96,27.0,8,20,65,65,6,14,20,81.0,,241,21,44,65,297.0,84,7.25,87,443,2603,11.7
129,Adam Burt,1996-97,28.0,9,18,63,63,1,17,18,91.0,,304,22,61,83,388.0,84,6.48,76,407,2545,10.7
130,Adam Burt,1997-98,29.0,10,18,46,46,7,11,18,73.0,,350,29,72,101,461.0,48,5.97,37,209,1408,10.2
131,Adam Burt,1998-99,30.0,11,13,78,78,4,9,13,90.0,,428,33,81,114,551.0,82,6.29,74,413,2481,10.4
132,Adam Burt,1999-00,31.0,12,13,71,71,2,11,13,85.0,,499,35,92,127,636.0,82,5.83,55,336,2444,9.8
133,Adam Burt,2000-01,32.0,13,12,76,76,1,11,12,51.0,,575,36,103,139,687.0,82,5.28,57,380,2242,9.6
134,Adam Burt,2001-02,33.0,14,4,68,68,0,4,4,61.0,1247.0,643,36,107,143,748.0,82,5.27,57,359,2285,9.4
135,Adam Burt,2002-03,34.0,15,7,67,67,1,6,7,49.0,1093.0,710,37,113,150,797.0,82,5.49,53,331,2294,9.8
136,Adam Burt,2003-04,35.0,16,2,27,27,0,2,2,18.0,515.0,737,37,115,152,815.0,82,5.51,63,376,2272,9.9
137,Adam Clendening,2017-18,25.0,4,4,21,21,1,3,4,17.0,349.0,21,1,3,4,17.0,82,5.32,47,251,2453,8.9
138,Adam Clendening,2018-19,26.0,5,7,29,29,1,6,7,43.0,429.0,50,2,9,11,60.0,82,5.34,48,255,2438,9.0
139,Adam Clendening,2019-20,27.0,6,11,31,31,2,9,11,38.0,490.0,81,4,18,22,98.0,82,5.45,47,245,2478,9.0
140,Adam Clendening,2020-21,28.0,7,2,5,5,0,2,2,4.0,80.0,86,4,20,24,102.0,82,5.86,50,250,2620,9.2
141,Adam Clendening,2021-22,29.0,8,0,4,4,0,0,0,3.0,43.0,90,4,20,24,105.0,82,5.96,47,239,2579,9.5
142,Adam Cracknell,2013-14,28.0,4,7,24,24,3,4,7,26.0,214.0,24,3,4,7,26.0,82,5.46,52,291,2492,9.0
143,Adam Cracknell,2014-15,29.0,5,1,2,2,1,0,1,1.0,15.0,26,4,4,8,27.0,82,5.32,47,271,2439,8.9
144,Adam Cracknell,2015-16,30.0,6,6,20,20,2,4,6,21.0,172.0,46,6,8,14,48.0,48,5.31,29,160,1399,9.1
145,Adam Cracknell,2016-17,31.0,7,2,19,19,0,2,2,16.0,155.0,65,6,10,16,64.0,82,5.34,48,269,2463,8.9
146,Adam Cracknell,2017-18,32.0,8,1,17,17,0,1,1,17.0,169.0,82,6,11,17,81.0,82,5.32,47,251,2453,8.9
147,Adam Cracknell,2018-19,33.0,9,10,52,52,5,5,10,68.0,636.0,134,11,16,27,149.0,82,5.34,48,255,2438,9.0
148,Adam Cracknell,2019-20,34.0,10,16,69,69,10,6,16,87.0,722.0,203,21,22,43,236.0,82,5.45,47,245,2478,9.0
149,Adam Cracknell,2020-21,35.0,11,0,5,5,0,0,0,6.0,39.0,208,21,22,43,242.0,82,5.86,50,250,2620,9.2
150,Adam Cracknell,2021-22,36.0,12,0,2,2,0,0,0,3.0,21.0,210,21,22,43,245.0,82,5.96,47,239,2579,9.5
151,Adam Creighton,1986-87,21.0,4,4,7,7,2,2,4,8.0,,7,2,2,4,8.0,80,7.89,74,336,2448,12.9
152,Adam Creighton,1987-88,22.0,5,10,30,30,2,8,10,20.0,,37,4,10,14,28.0,80,7.77,71,321,2447,12.7
153,Adam Creighton,1988-89,23.0,6,2,19,19,1,1,2,9.0,,56,5,11,16,37.0,80,7.94,82,370,2484,12.8
154,Adam Creighton,1989-90,24.0,7,40,56,56,18,22,40,109.0,,112,23,33,56,146.0,80,7.34,72,344,2400,12.2
155,Adam Creighton,1990-91,25.0,8,27,36,36,10,17,27,61.0,,148,33,50,83,207.0,80,7.43,89,437,2435,12.2
156,Adam Creighton,1991-92,26.0,9,46,67,67,22,24,46,155.0,,215,55,74,129,362.0,80,7.48,85,403,2430,12.3
157,Adam Creighton,1992-93,27.0,10,70,80,80,34,36,70,156.0,,295,89,110,199,518.0,80,7.37,76,367,2421,12.2
158,Adam Creighton,1993-94,28.0,11,51,72,72,22,29,51,127.0,,367,111,139,250,645.0,80,6.91,71,366,2385,11.6
159,Adam Creighton,1994-95,29.0,12,36,77,77,21,15,36,140.0,,444,132,154,286,785.0,80,6.96,77,402,2440,11.4
160,Adam Creighton,1995-96,30.0,13,39,83,83,19,20,39,168.0,,527,151,174,325,953.0,84,7.25,87,443,2603,11.7
161,Adam Creighton,1996-97,31.0,14,20,53,53,10,10,20,77.0,,580,161,184,345,1030.0,84,6.48,76,407,2545,10.7
162,Adam Creighton,1997-98,32.0,15,34,48,48,14,20,34,81.0,,628,175,204,379,1111.0,48,5.97,37,209,1408,10.2
163,Adam Creighton,1998-99,33.0,16,21,61,61,11,10,21,98.0,,689,186,214,400,1209.0,82,6.29,74,413,2481,10.4
164,Adam Creighton,1999-00,34.0,17,3,19,19,1,2,3,20.0,,708,187,216,403,1229.0,82,5.83,55,336,2444,9.8
165,Adam Deadmarsh,1997-98,22.0,4,17,48,48,9,8,17,48.0,,48,9,8,17,48.0,48,5.97,37,209,1408,10.2
166,Adam Deadmarsh,1998-99,23.0,5,48,78,78,21,27,48,151.0,,126,30,35,65,199.0,82,6.29,74,413,2481,10.4
167,Adam Deadmarsh,1999-00,24.0,6,60,78,78,33,27,60,198.0,,204,63,62,125,397.0,82,5.83,55,336,2444,9.8
168,Adam Deadmarsh,2000-01,25.0,7,43,73,73,22,21,43,187.0,,277,85,83,168,584.0,82,5.28,57,380,2242,9.6
169,Adam Deadmarsh,2001-02,26.0,8,49,66,66,22,27,49,152.0,1371.0,343,107,110,217,736.0,82,5.27,57,359,2285,9.4
170,Adam Deadmarsh,2002-03,27.0,9,45,71,71,18,27,45,153.0,1452.0,414,125,137,262,889.0,82,5.49,53,331,2294,9.8
171,Adam Deadmarsh,2003-04,28.0,10,32,57,57,17,15,32,126.0,1026.0,471,142,152,294,1015.0,82,5.51,63,376,2272,9.9
172,Adam Deadmarsh,2004-05,29.0,11,62,76,76,29,33,62,139.0,1465.0,547,171,185,356,1154.0,82,5.24,53,338,2262,9.5
173,Adam Deadmarsh,2005-06,30.0,12,17,20,20,13,4,17,55.0,386.0,567,184,189,373,1209.0,82,5.31,60,363,2326,9.4
174,Adam Erne,2019-20,24.0,4,3,26,26,3,0,3,40.0,307.0,26,3,0,3,40.0,82,5.45,47,245,2478,9.0
175,Adam Erne,2020-21,25.0,5,4,23,23,3,1,4,29.0,233.0,49,6,1,7,69.0,82,5.86,50,250,2620,9.2
176,Adam Erne,2021-22,26.0,6,20,65,65,7,13,20,70.0,686.0,114,13,14,27,139.0,82,5.96,47,239,2579,9.5
177,Adam Erne,2022-23,27.0,7,5,56,56,2,3,5,63.0,662.0,170,15,17,32,202.0,70,5.96,42,208,2192,9.5
178,Adam Foote,1994-95,23.0,4,7,46,46,2,5,7,55.0,,46,2,5,7,55.0,80,6.96,77,402,2440,11.4
179,Adam Foote,1995-96,24.0,5,16,81,81,4,12,16,54.0,,127,6,17,23,109.0,84,7.25,87,443,2603,11.7
180,Adam Foote,1996-97,25.0,6,8,45,45,2,6,8,42.0,,172,8,23,31,151.0,84,6.48,76,407,2545,10.7
181,Adam Foote,1997-98,26.0,7,7,35,35,0,7,7,24.0,,207,8,30,38,175.0,48,5.97,37,209,1408,10.2
182,Adam Foote,1998-99,27.0,8,16,73,73,5,11,16,49.0,,280,13,41,54,224.0,82,6.29,74,413,2481,10.4
183,Adam Foote,1999-00,28.0,9,21,78,78,2,19,21,60.0,,358,15,60,75,284.0,82,5.83,55,336,2444,9.8
184,Adam Foote,2000-01,29.0,10,17,77,77,3,14,17,64.0,,435,18,74,92,348.0,82,5.28,57,380,2242,9.6
185,Adam Foote,2001-02,30.0,11,21,64,64,5,16,21,83.0,1589.0,499,23,90,113,431.0,82,5.27,57,359,2285,9.4
186,Adam Foote,2002-03,31.0,12,18,59,59,5,13,18,63.0,1526.0,558,28,103,131,494.0,82,5.49,53,331,2294,9.8
187,Adam Foote,2003-04,32.0,13,15,35,35,3,12,15,59.0,888.0,593,31,115,146,553.0,82,5.51,63,376,2272,9.9
188,Adam Foote,2004-05,33.0,14,27,55,55,5,22,27,85.0,1429.0,648,36,137,173,638.0,82,5.24,53,338,2262,9.5
189,Adam Foote,2005-06,34.0,15,31,78,78,11,20,31,106.0,2005.0,726,47,157,204,744.0,82,5.31,60,363,2326,9.4
190,Adam Foote,2006-07,35.0,16,30,73,73,8,22,30,105.0,1756.0,799,55,179,234,849.0,82,5.14,57,348,2300,9.2
191,Adam Foote,2008-09,37.0,17,22,65,65,6,16,22,67.0,1597.0,864,61,195,256,916.0,82,6.05,85,480,2458,10.1
192,Adam Foote,2009-10,38.0,18,12,59,59,3,9,12,78.0,1459.0,923,64,204,268,994.0,82,5.76,70,398,2426,9.7
193,Adam Foote,2010-11,39.0,19,16,75,75,1,15,16,66.0,1754.0,998,65,219,284,1060.0,82,5.44,62,351,2383,9.4
194,Adam Foote,2011-12,40.0,20,7,42,42,1,6,7,19.0,826.0,1040,66,225,291,1079.0,82,5.7,65,341,2477,9.4
195,Adam Foote,2012-13,41.0,21,9,67,67,0,9,9,26.0,1297.0,1107,66,234,300,1105.0,82,5.53,56,304,2486,9.1
196,Adam Foote,2013-14,42.0,22,8,47,47,0,8,8,23.0,842.0,1154,66,242,308,1128.0,82,5.46,52,291,2492,9.0
197,Adam Fox,2022-23,24.0,4,42,70,70,8,34,42,125.0,1323.0,70,8,34,42,125.0,70,5.96,42,208,2192,9.5
198,Adam Gaudette,2020-21,24.0,4,0,5,5,0,0,0,9.0,64.0,5,0,0,0,9.0,82,5.86,50,250,2620,9.2
199,Adam Gaudette,2021-22,25.0,5,12,56,56,5,7,12,55.0,613.0,61,5,7,12,64.0,82,5.96,47,239,2579,9.5
200,Adam Gaudette,2022-23,26.0,6,33,59,59,12,21,33,75.0,731.0,120,17,28,45,139.0,70,5.96,42,208,2192,9.5
201,Adam Graves,1990-91,22.0,4,1,9,9,0,1,1,9.0,,9,0,1,1,9.0,80,7.43,89,437,2435,12.2
202,Adam Graves,1991-92,23.0,5,12,56,56,7,5,12,60.0,,65,7,6,13,69.0,80,7.48,85,403,2430,12.3
203,Adam Graves,1992-93,24.0,6,22,76,76,9,13,22,94.0,,141,16,19,35,163.0,80,7.37,76,367,2421,12.2
204,Adam Graves,1993-94,25.0,7,25,76,76,7,18,25,126.0,,217,23,37,60,289.0,80,6.91,71,366,2385,11.6
205,Adam Graves,1994-95,26.0,8,59,80,80,26,33,59,228.0,,297,49,70,119,517.0,80,6.96,77,402,2440,11.4
206,Adam Graves,1995-96,27.0,9,65,84,84,36,29,65,275.0,,381,85,99,184,792.0,84,7.25,87,443,2603,11.7
207,Adam Graves,1996-97,28.0,10,79,84,84,52,27,79,291.0,,465,137,126,263,1083.0,84,6.48,76,407,2545,10.7
208,Adam Graves,1997-98,29.0,11,31,47,47,17,14,31,185.0,,512,154,140,294,1268.0,48,5.97,37,209,1408,10.2
209,Adam Graves,1998-99,30.0,12,58,82,82,22,36,58,266.0,,594,176,176,352,1534.0,82,6.29,74,413,2481,10.4
210,Adam Graves,1999-00,31.0,13,61,82,82,33,28,61,269.0,,676,209,204,413,1803.0,82,5.83,55,336,2444,9.8
211,Adam Graves,2000-01,32.0,14,35,72,72,23,12,35,226.0,,748,232,216,448,2029.0,82,5.28,57,380,2242,9.6
212,Adam Graves,2001-02,33.0,15,53,82,82,38,15,53,239.0,1685.0,830,270,231,501,2268.0,82,5.27,57,359,2285,9.4
213,Adam Graves,2002-03,34.0,16,40,77,77,23,17,40,194.0,1445.0,907,293,248,541,2462.0,82,5.49,53,331,2294,9.8
214,Adam Graves,2003-04,35.0,17,26,82,82,10,16,26,136.0,1290.0,989,303,264,567,2598.0,82,5.51,63,376,2272,9.9
215,Adam Graves,2004-05,36.0,18,31,81,81,17,14,31,139.0,1279.0,1070,320,278,598,2737.0,82,5.24,53,338,2262,9.5
216,Adam Graves,2005-06,37.0,19,18,82,82,9,9,18,118.0,1070.0,1152,329,287,616,2855.0,82,5.31,60,363,2326,9.4
217,Adam Hall,2004-05,24.0,4,1,1,1,0,1,1,2.0,14.0,1,0,1,1,2.0,82,5.24,53,338,2262,9.5
218,Adam Hall,2005-06,25.0,5,28,79,79,16,12,28,146.0,1117.0,80,16,13,29,148.0,82,5.31,60,363,2326,9.4
219,Adam Hall,2006-07,26.0,6,27,79,79,13,14,27,151.0,1283.0,159,29,27,56,299.0,82,5.14,57,348,2300,9.2
220,Adam Hall,2008-09,28.0,7,29,75,75,14,15,29,122.0,1258.0,234,43,42,85,421.0,82,6.05,85,480,2458,10.1
221,Adam Hall,2009-10,29.0,8,17,72,72,6,11,17,103.0,891.0,306,49,53,102,524.0,82,5.76,70,398,2426,9.7
222,Adam Hall,2010-11,30.0,9,6,46,46,2,4,6,39.0,546.0,352,51,57,108,563.0,82,5.44,62,351,2383,9.4
223,Adam Hall,2011-12,31.0,10,10,74,74,5,5,10,90.0,829.0,426,56,62,118,653.0,82,5.7,65,341,2477,9.4
224,Adam Hall,2013-14,33.0,11,18,82,82,7,11,18,167.0,1218.0,508,63,73,136,820.0,82,5.46,52,291,2492,9.0
225,Adam Hall,2014-15,34.0,12,7,57,57,2,5,7,63.0,676.0,565,65,78,143,883.0,82,5.32,47,271,2439,8.9
226,Adam Hall,2015-16,35.0,13,4,37,37,0,4,4,34.0,390.0,602,65,82,147,917.0,48,5.31,29,160,1399,9.1
227,Adam Hall,2016-17,36.0,14,9,80,80,4,5,9,61.0,787.0,682,69,87,156,978.0,82,5.34,48,269,2463,8.9
228,Adam Henrique,2013-14,23.0,4,0,1,1,0,0,0,3.0,13.0,1,0,0,0,3.0,82,5.46,52,291,2492,9.0
229,Adam Henrique,2014-15,24.0,5,51,74,74,16,35,51,130.0,1344.0,75,16,35,51,133.0,82,5.32,47,271,2439,8.9
230,Adam Henrique,2015-16,25.0,6,16,42,42,11,5,16,78.0,769.0,117,27,40,67,211.0,48,5.31,29,160,1399,9.1
231,Adam Henrique,2016-17,26.0,7,43,77,77,25,18,43,137.0,1390.0,194,52,58,110,348.0,82,5.34,48,269,2463,8.9
232,Adam Henrique,2017-18,27.0,8,43,75,75,16,27,43,127.0,1331.0,269,68,85,153,475.0,82,5.32,47,251,2453,8.9
233,Adam Henrique,2018-19,28.0,9,50,80,80,30,20,50,149.0,1586.0,349,98,105,203,624.0,82,5.34,48,255,2438,9.0
234,Adam Henrique,2019-20,29.0,10,40,82,82,20,20,40,142.0,1490.0,431,118,125,243,766.0,82,5.45,47,245,2478,9.0
235,Adam Henrique,2020-21,30.0,11,50,81,81,24,26,50,151.0,1441.0,512,142,151,293,917.0,82,5.86,50,250,2620,9.2
236,Adam Henrique,2021-22,31.0,12,42,82,82,18,24,42,122.0,1349.0,594,160,175,335,1039.0,82,5.96,47,239,2579,9.5
237,Adam Henrique,2022-23,32.0,13,43,71,71,26,17,43,169.0,1198.0,665,186,192,378,1208.0,70,5.96,42,208,2192,9.5
238,Adam Johnson,2021-22,27.0,4,2,6,6,0,2,2,3.0,32.0,6,0,2,2,3.0,82,5.96,47,239,2579,9.5
239,Adam Johnson,2022-23,28.0,5,2,7,7,1,1,2,5.0,47.0,13,1,3,4,8.0,70,5.96,42,208,2192,9.5
240,Adam Larsson,2014-15,22.0,4,18,65,65,2,16,18,68.0,1340.0,65,2,16,18,68.0,82,5.32,47,271,2439,8.9
241,Adam Larsson,2015-16,23.0,5,6,37,37,0,6,6,30.0,670.0,102,2,22,24,98.0,48,5.31,29,160,1399,9.1
242,Adam Larsson,2016-17,24.0,6,3,26,26,1,2,3,20.0,462.0,128,3,24,27,118.0,82,5.34,48,269,2463,8.9
243,Adam Larsson,2017-18,25.0,7,24,64,64,3,21,24,91.0,1342.0,192,6,45,51,209.0,82,5.32,47,251,2453,8.9
244,Adam Larsson,2018-19,26.0,8,18,82,82,3,15,18,65.0,1846.0,274,9,60,69,274.0,82,5.34,48,255,2438,9.0
245,Adam Larsson,2019-20,27.0,9,19,79,79,4,15,19,85.0,1592.0,353,13,75,88,359.0,82,5.45,47,245,2478,9.0
246,Adam Larsson,2020-21,28.0,10,13,63,63,4,9,13,92.0,1382.0,416,17,84,101,451.0,82,5.86,50,250,2620,9.2
247,Adam Larsson,2021-22,29.0,11,20,82,82,3,17,20,117.0,1773.0,498,20,101,121,568.0,82,5.96,47,239,2579,9.5
248,Adam Larsson,2022-23,30.0,12,6,49,49,1,5,6,61.0,972.0,547,21,106,127,629.0,70,5.96,42,208,2192,9.5
249,Adam Lowry,2017-18,24.0,4,23,80,80,11,12,23,104.0,1100.0,80,11,12,23,104.0,82,5.32,47,251,2453,8.9
250,Adam Lowry,2018-19,25.0,5,17,74,74,7,10,17,73.0,1037.0,154,18,22,40,177.0,82,5.34,48,255,2438,9.0
251,Adam Lowry,2019-20,26.0,6,29,82,82,15,14,29,122.0,1316.0,236,33,36,69,299.0,82,5.45,47,245,2478,9.0
252,Adam Lowry,2020-21,27.0,7,21,45,45,8,13,21,70.0,670.0,281,41,49,90,369.0,82,5.86,50,250,2620,9.2
253,Adam Lowry,2021-22,28.0,8,23,78,78,12,11,23,105.0,1142.0,359,53,60,113,474.0,82,5.96,47,239,2579,9.5
254,Adam Lowry,2022-23,29.0,9,10,49,49,4,6,10,68.0,733.0,408,57,66,123,542.0,70,5.96,42,208,2192,9.5
255,Adam Mair,2002-03,23.0,4,1,8,8,1,0,1,7.0,92.0,8,1,0,1,7.0,82,5.49,53,331,2294,9.8
256,Adam Mair,2003-04,24.0,5,2,26,26,0,2,2,22.0,207.0,34,1,2,3,29.0,82,5.51,63,376,2272,9.9
257,Adam Mair,2004-05,25.0,6,2,18,18,1,1,2,10.0,129.0,52,2,3,5,39.0,82,5.24,53,338,2262,9.5
258,Adam Mair,2005-06,26.0,7,17,79,79,6,11,17,83.0,839.0,131,8,14,22,122.0,82,5.31,60,363,2326,9.4
259,Adam Mair,2006-07,27.0,8,20,81,81,6,14,20,82.0,780.0,212,14,28,42,204.0,82,5.14,57,348,2300,9.2
260,Adam Mair,2008-09,29.0,9,7,40,40,2,5,7,40.0,320.0,252,16,33,49,244.0,82,6.05,85,480,2458,10.1
261,Adam Mair,2009-10,30.0,10,11,82,82,2,9,11,73.0,619.0,334,18,42,60,317.0,82,5.76,70,398,2426,9.7
262,Adam Mair,2010-11,31.0,11,17,72,72,5,12,17,62.0,638.0,406,23,54,77,379.0,82,5.44,62,351,2383,9.4
263,Adam Mair,2011-12,32.0,12,19,75,75,8,11,19,75.0,793.0,481,31,65,96,454.0,82,5.7,65,341,2477,9.4
264,Adam Mair,2012-13,33.0,13,14,69,69,6,8,14,67.0,637.0,550,37,73,110,521.0,82,5.53,56,304,2486,9.1
265,Adam Mair,2013-14,34.0,14,4,65,65,1,3,4,58.0,591.0,615,38,76,114,579.0,82,5.46,52,291,2492,9.0
266,Adam McQuaid,2012-13,26.0,4,1,19,19,1,0,1,10.0,204.0,19,1,0,1,10.0,82,5.53,56,304,2486,9.1
267,Adam McQuaid,2013-14,27.0,5,15,67,67,3,12,15,46.0,996.0,86,4,12,16,56.0,82,5.46,52,291,2492,9.0
268,Adam McQuaid,2014-15,28.0,6,10,72,72,2,8,10,63.0,1077.0,158,6,20,26,119.0,82,5.32,47,271,2439,8.9
269,Adam McQuaid,2015-16,29.0,7,4,32,32,1,3,4,26.0,457.0,190,7,23,30,145.0,48,5.31,29,160,1399,9.1
270,Adam McQuaid,2016-17,30.0,8,6,30,30,1,5,6,25.0,481.0,220,8,28,36,170.0,82,5.34,48,269,2463,8.9
271,Adam McQuaid,2017-18,31.0,9,7,63,63,1,6,7,60.0,1161.0,283,9,34,43,230.0,82,5.32,47,251,2453,8.9
272,Adam McQuaid,2018-19,32.0,10,9,64,64,1,8,9,42.0,1155.0,347,10,42,52,272.0,82,5.34,48,255,2438,9.0
273,Adam McQuaid,2019-20,33.0,11,10,77,77,2,8,10,64.0,1405.0,424,12,50,62,336.0,82,5.45,47,245,2478,9.0
274,Adam McQuaid,2020-21,34.0,12,4,38,38,1,3,4,39.0,597.0,462,13,53,66,375.0,82,5.86,50,250,2620,9.2
275,Adam McQuaid,2021-22,35.0,13,7,50,50,3,4,7,28.0,789.0,512,16,57,73,403.0,82,5.96,47,239,2579,9.5
276,Adam Oates,1988-89,26.0,4,20,38,38,9,11,20,49.0,,38,9,11,20,49.0,80,7.94,82,370,2484,12.8
277,Adam Oates,1989-90,27.0,5,47,76,76,15,32,47,138.0,,114,24,43,67,187.0,80,7.34,72,344,2400,12.2
278,Adam Oates,1990-91,28.0,6,54,63,63,14,40,54,111.0,,177,38,83,121,298.0,80,7.43,89,437,2435,12.2
279,Adam Oates,1991-92,29.0,7,78,69,69,16,62,78,127.0,,246,54,145,199,425.0,80,7.48,85,403,2430,12.3
280,Adam Oates,1992-93,30.0,8,102,80,80,23,79,102,168.0,,326,77,224,301,593.0,80,7.37,76,367,2421,12.2
281,Adam Oates,1993-94,31.0,9,115,61,61,25,90,115,139.0,,387,102,314,416,732.0,80,6.91,71,366,2385,11.6
282,Adam Oates,1994-95,32.0,10,99,80,80,20,79,99,191.0,,467,122,393,515,923.0,80,6.96,77,402,2440,11.4
283,Adam Oates,1995-96,33.0,11,142,84,84,45,97,142,254.0,,551,167,490,657,1177.0,84,7.25,87,443,2603,11.7
284,Adam Oates,1996-97,34.0,12,112,77,77,32,80,112,197.0,,628,199,570,769,1374.0,84,6.48,76,407,2545,10.7
285,Adam Oates,1997-98,35.0,13,53,48,48,12,41,53,109.0,,676,211,611,822,1483.0,48,5.97,37,209,1408,10.2
286,Adam Oates,1998-99,36.0,14,92,70,70,25,67,92,183.0,,746,236,678,914,1666.0,82,6.29,74,413,2481,10.4
287,Adam Oates,1999-00,37.0,15,82,80,80,22,60,82,160.0,,826,258,738,996,1826.0,82,5.83,55,336,2444,9.8
288,Adam Oates,2000-01,38.0,16,76,82,82,18,58,76,121.0,,908,276,796,1072,1947.0,82,5.28,57,380,2242,9.6
289,Adam Oates,2001-02,39.0,17,54,59,59,12,42,54,79.0,1213.0,967,288,838,1126,2026.0,82,5.27,57,359,2285,9.4
290,Adam Oates,2002-03,40.0,18,71,82,82,15,56,71,93.0,1832.0,1049,303,894,1197,2119.0,82,5.49,53,331,2294,9.8
291,Adam Oates,2003-04,41.0,19,82,81,81,13,69,82,72.0,1701.0,1130,316,963,1279,2191.0,82,5.51,63,376,2272,9.9
292,Adam Oates,2004-05,42.0,20,78,80,80,14,64,78,102.0,1750.0,1210,330,1027,1357,2293.0,82,5.24,53,338,2262,9.5
293,Adam Oates,2005-06,43.0,21,45,67,67,9,36,45,67.0,1249.0,1277,339,1063,1402,2360.0,82,5.31,60,363,2326,9.4
294,Adam Oates,2006-07,44.0,22,18,60,60,2,16,18,32.0,870.0,1337,341,1079,1420,2392.0,82,5.14,57,348,2300,9.2
295,Adam Pardy,2011-12,27.0,4,10,60,60,1,9,10,38.0,900.0,60,1,9,10,38.0,82,5.7,65,341,2477,9.4
296,Adam Pardy,2012-13,28.0,5,9,57,57,2,7,9,40.0,904.0,117,3,16,19,78.0,82,5.53,56,304,2486,9.1
297,Adam Pardy,2013-14,29.0,6,7,30,30,1,6,7,36.0,441.0,147,4,22,26,114.0,82,5.46,52,291,2492,9.0
298,Adam Pardy,2014-15,30.0,7,3,36,36,0,3,3,29.0,593.0,183,4,25,29,143.0,82,5.32,47,271,2439,8.9
299,Adam Pardy,2015-16,31.0,8,4,17,17,0,4,4,6.0,281.0,200,4,29,33,149.0,48,5.31,29,160,1399,9.1
300,Adam Pardy,2016-17,32.0,9,6,60,60,0,6,6,47.0,865.0,260,4,35,39,196.0,82,5.34,48,269,2463,8.9
301,Adam Pardy,2017-18,33.0,10,9,55,55,0,9,9,29.0,826.0,315,4,44,48,225.0,82,5.32,47,251,2453,8.9
302,Adam Pardy,2018-19,34.0,11,4,23,23,0,4,4,22.0,365.0,338,4,48,52,247.0,82,5.34,48,255,2438,9.0
303,Adam Pardy,2019-20,35.0,12,0,4,4,0,0,0,4.0,44.0,342,4,48,52,251.0,82,5.45,47,245,2478,9.0
304,Adam Payerl,2016-17,25.0,4,0,2,2,0,0,0,4.0,18.0,2,0,0,0,4.0,82,5.34,48,269,2463,8.9
305,Adam Pelech,2018-19,24.0,4,2,9,9,0,2,2,8.0,158.0,9,0,2,2,8.0,82,5.34,48,255,2438,9.0
306,Adam Pelech,2019-20,25.0,5,10,44,44,3,7,10,40.0,741.0,53,3,9,12,48.0,82,5.45,47,245,2478,9.0
307,Adam Pelech,2020-21,26.0,6,19,78,78,3,16,19,106.0,1503.0,131,6,25,31,154.0,82,5.86,50,250,2620,9.2
308,Adam Pelech,2021-22,27.0,7,21,78,78,5,16,21,110.0,1453.0,209,11,41,52,264.0,82,5.96,47,239,2579,9.5
309,Adam Pelech,2022-23,28.0,8,9,38,38,1,8,9,49.0,803.0,247,12,49,61,313.0,70,5.96,42,208,2192,9.5
310,Adam Pineault,2010-11,24.0,4,0,3,3,0,0,0,5.0,33.0,3,0,0,0,5.0,82,5.44,62,351,2383,9.4
311,Adrian Aucoin,1997-98,24.0,4,1,1,1,1,0,1,2.0,,1,1,0,1,2.0,48,5.97,37,209,1408,10.2
312,Adrian Aucoin,1998-99,25.0,5,18,49,49,4,14,18,85.0,,50,5,14,19,87.0,82,6.29,74,413,2481,10.4
313,Adrian Aucoin,1999-00,26.0,6,21,70,70,5,16,21,116.0,,120,10,30,40,203.0,82,5.83,55,336,2444,9.8
314,Adrian Aucoin,2000-01,27.0,7,6,35,35,3,3,6,44.0,,155,13,33,46,247.0,82,5.28,57,380,2242,9.6
315,Adrian Aucoin,2001-02,28.0,8,34,82,82,23,11,34,174.0,1957.0,237,36,44,80,421.0,82,5.27,57,359,2285,9.4
316,Adrian Aucoin,2002-03,29.0,9,24,57,57,10,14,24,126.0,1317.0,294,46,58,104,547.0,82,5.49,53,331,2294,9.8
317,Adrian Aucoin,2003-04,30.0,10,28,73,73,4,24,28,159.0,1475.0,367,50,82,132,706.0,82,5.51,63,376,2272,9.9
318,Adrian Aucoin,2004-05,31.0,11,34,81,81,12,22,34,232.0,2340.0,448,62,104,166,938.0,82,5.24,53,338,2262,9.5
319,Adrian Aucoin,2005-06,32.0,12,35,73,73,8,27,35,175.0,2118.0,521,70,131,201,1113.0,82,5.31,60,363,2326,9.4
320,Adrian Aucoin,2006-07,33.0,13,44,81,81,13,31,44,213.0,2157.0,602,83,162,245,1326.0,82,5.14,57,348,2300,9.2
321,Adrian Aucoin,2008-09,35.0,14,6,33,33,1,5,6,59.0,758.0,635,84,167,251,1385.0,82,6.05,85,480,2458,10.1
322,Adrian Aucoin,2009-10,36.0,15,16,59,59,4,12,16,96.0,1229.0,694,88,179,267,1481.0,82,5.76,70,398,2426,9.7
323,Adrian Aucoin,2010-11,37.0,16,35,76,76,10,25,35,121.0,1593.0,770,98,204,302,1602.0,82,5.44,62,351,2383,9.4
324,Adrian Aucoin,2011-12,38.0,17,34,81,81,10,24,34,126.0,1806.0,851,108,228,336,1728.0,82,5.7,65,341,2477,9.4
325,Adrian Aucoin,2012-13,39.0,18,28,82,82,8,20,28,144.0,1849.0,933,116,248,364,1872.0,82,5.53,56,304,2486,9.1
326,Adrian Aucoin,2013-14,40.0,19,22,75,75,3,19,22,99.0,1625.0,1008,119,267,386,1971.0,82,5.46,52,291,2492,9.0
327,Adrian Aucoin,2014-15,41.0,20,9,64,64,2,7,9,92.0,1296.0,1072,121,274,395,2063.0,82,5.32,47,271,2439,8.9
328,Adrian Aucoin,2015-16,42.0,21,4,36,36,0,4,4,26.0,588.0,1108,121,278,399,2089.0,48,5.31,29,160,1399,9.1
329,Adrian Kempe,2019-20,23.0,4,6,25,25,2,4,6,32.0,306.0,25,2,4,6,32.0,82,5.45,47,245,2478,9.0
330,Adrian Kempe,2020-21,24.0,5,37,81,81,16,21,37,119.0,1080.0,106,18,25,43,151.0,82,5.86,50,250,2620,9.2
331,Adrian Kempe,2021-22,25.0,6,28,81,81,12,16,28,118.0,1175.0,187,30,41,71,269.0,82,5.96,47,239,2579,9.5
332,Adrian Kempe,2022-23,26.0,7,32,69,69,11,21,32,148.0,1105.0,256,41,62,103,417.0,70,5.96,42,208,2192,9.5
333,Adrien Plavsic,1992-93,23.0,4,6,15,15,3,3,6,14.0,,15,3,3,6,14.0,80,7.37,76,367,2421,12.2
334,Adrien Plavsic,1993-94,24.0,5,12,48,48,2,10,12,69.0,,63,5,13,18,83.0,80,6.91,71,366,2385,11.6
335,Adrien Plavsic,1994-95,25.0,6,10,16,16,1,9,10,21.0,,79,6,22,28,104.0,80,6.96,77,402,2440,11.4
336,Adrien Plavsic,1995-96,26.0,7,27,57,57,6,21,27,62.0,,136,12,43,55,166.0,84,7.25,87,443,2603,11.7
337,Adrien Plavsic,1996-97,27.0,8,10,47,47,1,9,10,41.0,,183,13,52,65,207.0,84,6.48,76,407,2545,10.7
338,Adrien Plavsic,1997-98,28.0,9,4,18,18,2,2,4,35.0,,201,15,54,69,242.0,48,5.97,37,209,1408,10.2
339,Adrien Plavsic,1998-99,29.0,10,3,7,7,1,2,3,4.0,,208,16,56,72,246.0,82,6.29,74,413,2481,10.4
340,Adrien Plavsic,1999-00,30.0,11,0,6,6,0,0,0,3.0,,214,16,56,72,249.0,82,5.83,55,336,2444,9.8
341,Aki Berg,1998-99,21.0,4,7,51,51,0,7,7,56.0,,51,0,7,7,56.0,82,6.29,74,413,2481,10.4
342,Aki Berg,1999-00,22.0,5,8,41,41,2,6,8,65.0,,92,2,13,15,121.0,82,5.83,55,336,2444,9.8
343,Aki Berg,2000-01,23.0,6,8,72,72,0,8,8,58.0,,164,2,21,23,179.0,82,5.28,57,380,2242,9.6
344,Aki Berg,2002-03,25.0,7,16,70,70,3,13,16,70.0,1165.0,234,5,34,39,249.0,82,5.49,53,331,2294,9.8
345,Aki Berg,2003-04,26.0,8,7,59,59,3,4,7,43.0,919.0,293,8,38,46,292.0,82,5.51,63,376,2272,9.9
346,Aki Berg,2004-05,27.0,9,11,81,81,1,10,11,66.0,1516.0,374,9,48,57,358.0,82,5.24,53,338,2262,9.5
347,Aki Berg,2005-06,28.0,10,11,78,78,4,7,11,49.0,1173.0,452,13,55,68,407.0,82,5.31,60,363,2326,9.4
348,Aki Berg,2006-07,29.0,11,9,79,79,2,7,9,69.0,1446.0,531,15,62,77,476.0,82,5.14,57,348,2300,9.2
349,Aki Berg,2008-09,31.0,12,8,75,75,0,8,8,42.0,1197.0,606,15,70,85,518.0,82,6.05,85,480,2458,10.1
350,Akim Aliu,2014-15,25.0,4,3,2,2,2,1,3,3.0,22.0,2,2,1,3,3.0,82,5.32,47,271,2439,8.9
351,Akim Aliu,2015-16,26.0,5,0,5,5,0,0,0,2.0,54.0,7,2,1,3,5.0,48,5.31,29,160,1399,9.1
352,Al Conroy,1994-95,29.0,4,11,31,31,2,9,11,25.0,,31,2,9,11,25.0,80,6.96,77,402,2440,11.4
353,Al Conroy,1995-96,30.0,5,5,21,21,3,2,5,24.0,,52,5,11,16,49.0,84,7.25,87,443,2603,11.7
354,Al Conroy,1996-97,31.0,6,7,62,62,4,3,7,40.0,,114,9,14,23,89.0,84,6.48,76,407,2545,10.7
355,Al Hangsleben,1982-83,29.0,4,35,74,74,13,22,35,107.0,,74,13,22,35,107.0,80,7.03,61,280,2352,12.0
356,Al Hangsleben,1983-84,30.0,5,24,76,76,5,19,24,110.0,,150,18,41,59,217.0,80,7.69,77,340,2441,12.6
357,Al Hangsleben,1984-85,31.0,6,10,35,35,3,7,10,31.0,,185,21,48,69,248.0,80,8.03,73,320,2489,12.9
358,Al Iafrate,1987-88,21.0,4,21,68,68,5,16,21,88.0,,68,5,16,21,88.0,80,7.77,71,321,2447,12.7
359,Al Iafrate,1988-89,22.0,5,33,65,65,8,25,33,97.0,,133,13,41,54,185.0,80,7.94,82,370,2484,12.8
360,Al Iafrate,1989-90,23.0,6,30,80,80,9,21,30,133.0,,213,22,62,84,318.0,80,7.34,72,344,2400,12.2
361,Al Iafrate,1990-91,24.0,7,52,77,77,22,30,52,169.0,,290,44,92,136,487.0,80,7.43,89,437,2435,12.2
362,Al Iafrate,1991-92,25.0,8,33,65,65,13,20,33,105.0,,355,57,112,169,592.0,80,7.48,85,403,2430,12.3
363,Al Iafrate,1992-93,26.0,9,63,75,75,21,42,63,153.0,,430,78,154,232,745.0,80,7.37,76,367,2421,12.2
364,Al Iafrate,1993-94,27.0,10,32,72,72,9,23,32,106.0,,502,87,177,264,851.0,80,6.91,71,366,2385,11.6
365,Al Iafrate,1994-95,28.0,11,51,78,78,17,34,51,151.0,,580,104,211,315,1002.0,80,6.96,77,402,2440,11.4
366,Al Iafrate,1995-96,29.0,12,66,81,81,25,41,66,289.0,,661,129,252,381,1291.0,84,7.25,87,443,2603,11.7
367,Al Iafrate,1996-97,30.0,13,58,79,79,15,43,58,299.0,,740,144,295,439,1590.0,84,6.48,76,407,2545,10.7
368,Al Iafrate,1999-00,33.0,14,15,38,38,6,9,15,91.0,,778,150,304,454,1681.0,82,5.83,55,336,2444,9.8
369,Al Iafrate,2000-01,34.0,15,9,21,21,2,7,9,37.0,,799,152,311,463,1718.0,82,5.28,57,380,2242,9.6
370,Al MacInnis,1984-85,21.0,4,0,2,2,0,0,0,2.0,,2,0,0,0,2.0,80,8.03,73,320,2489,12.9
371,Al MacInnis,1985-86,22.0,5,4,14,14,1,3,4,7.0,,16,1,3,4,9.0,80,7.73,71,310,2444,12.7
372,Al MacInnis,1986-87,23.0,6,45,51,51,11,34,45,160.0,,67,12,37,49,169.0,80,7.89,74,336,2448,12.9
373,Al MacInnis,1987-88,24.0,7,66,67,67,14,52,66,259.0,,134,26,89,115,428.0,80,7.77,71,321,2447,12.7
374,Al MacInnis,1988-89,25.0,8,68,77,77,11,57,68,241.0,,211,37,146,183,669.0,80,7.94,82,370,2484,12.8
375,Al MacInnis,1989-90,26.0,9,76,79,79,20,56,76,262.0,,290,57,202,259,931.0,80,7.34,72,344,2400,12.2
376,Al MacInnis,1990-91,27.0,10,83,80,80,25,58,83,245.0,,370,82,260,342,1176.0,80,7.43,89,437,2435,12.2
377,Al MacInnis,1991-92,28.0,11,74,79,79,16,58,74,277.0,,449,98,318,416,1453.0,80,7.48,85,403,2430,12.3
378,Al MacInnis,1992-93,29.0,12,90,79,79,28,62,90,304.0,,528,126,380,506,1757.0,80,7.37,76,367,2421,12.2
379,Al MacInnis,1993-94,30.0,13,103,78,78,28,75,103,305.0,,606,154,455,609,2062.0,80,6.91,71,366,2385,11.6
380,Al MacInnis,1994-95,31.0,14,77,72,72,20,57,77,304.0,,678,174,512,686,2366.0,80,6.96,77,402,2440,11.4
381,Al MacInnis,1995-96,32.0,15,54,50,50,11,43,54,201.0,,728,185,555,740,2567.0,84,7.25,87,443,2603,11.7
382,Al MacInnis,1996-97,33.0,16,82,75,75,28,54,82,324.0,,803,213,609,822,2891.0,84,6.48,76,407,2545,10.7
383,Al MacInnis,1997-98,34.0,17,28,32,32,8,20,28,110.0,,835,221,629,850,3001.0,48,5.97,37,209,1408,10.2
384,Al MacInnis,1998-99,35.0,18,61,82,82,17,44,61,317.0,,917,238,673,911,3318.0,82,6.29,74,413,2481,10.4
385,Al MacInnis,1999-00,36.0,19,43,72,72,13,30,43,296.0,,989,251,703,954,3614.0,82,5.83,55,336,2444,9.8
386,Al MacInnis,2000-01,37.0,20,49,71,71,19,30,49,227.0,,1060,270,733,1003,3841.0,82,5.28,57,380,2242,9.6
387,Al MacInnis,2001-02,38.0,21,62,82,82,20,42,62,314.0,2388.0,1142,290,775,1065,4155.0,82,5.27,57,359,2285,9.4
388,Al MacInnis,2002-03,39.0,22,39,61,61,11,28,39,245.0,1593.0,1203,301,803,1104,4400.0,82,5.49,53,331,2294,9.8
389,Al MacInnis,2003-04,40.0,23,54,59,59,12,42,54,218.0,1565.0,1262,313,845,1158,4618.0,82,5.51,63,376,2272,9.9
390,Al MacInnis,2004-05,41.0,24,46,71,71,11,35,46,231.0,1912.0,1333,324,880,1204,4849.0,82,5.24,53,338,2262,9.5
391,Al MacInnis,2005-06,42.0,25,68,80,80,16,52,68,299.0,2153.0,1413,340,932,1272,5148.0,82,5.31,60,363,2326,9.4
392,Al MacInnis,2006-07,43.0,26,2,3,3,0,2,2,9.0,75.0,1416,340,934,1274,5157.0,82,5.14,57,348,2300,9.2
393,Alain Cote,1982-83,25.0,4,16,41,41,5,11,16,58.0,,41,5,11,16,58.0,80,7.03,61,280,2352,12.0
394,Alain Cote,1983-84,26.0,5,26,51,51,8,18,26,65.0,,92,13,29,42,123.0,80,7.69,77,340,2441,12.6
395,Alain Cote,1984-85,27.0,6,31,79,79,15,16,31,95.0,,171,28,45,73,218.0,80,8.03,73,320,2489,12.9
396,Alain Cote,1985-86,28.0,7,40,79,79,12,28,40,88.0,,250,40,73,113,306.0,80,7.73,71,310,2444,12.7
397,Alain Cote,1986-87,29.0,8,43,77,77,19,24,43,116.0,,327,59,97,156,422.0,80,7.89,74,336,2448,12.9
398,Alain Cote,1987-88,30.0,9,35,80,80,13,22,35,127.0,,407,72,119,191,549.0,80,7.77,71,321,2447,12.7
399,Alain Cote,1988-89,31.0,10,34,78,78,13,21,34,120.0,,485,85,140,225,669.0,80,7.94,82,370,2484,12.8
400,Alain Cote,1989-90,32.0,11,36,80,80,12,24,36,131.0,,565,97,164,261,800.0,80,7.34,72,344,2400,12.2
401,Alain Cote,1990-91,33.0,12,22,76,76,4,18,22,84.0,,641,101,182,283,884.0,80,7.43,89,437,2435,12.2
402,Alain Cote,1991-92,34.0,13,10,55,55,2,8,10,31.0,,696,103,190,293,915.0,80,7.48,85,403,2430,12.3
403,Alain Cote0,1988-89,21.0,4,6,32,32,0,6,6,15.0,,32,0,6,6,15.0,80,7.94,82,370,2484,12.8
404,Alain Cote0,1989-90,22.0,5,0,3,3,0,0,0,1.0,,35,0,6,6,16.0,80,7.34,72,344,2400,12.2
405,Alain Cote0,1990-91,23.0,6,0,2,2,0,0,0,1.0,,37,0,6,6,17.0,80,7.43,89,437,2435,12.2
406,Alain Cote0,1991-92,24.0,7,5,31,31,2,3,5,45.0,,68,2,9,11,62.0,80,7.48,85,403,2430,12.3
407,Alain Cote0,1992-93,25.0,8,0,2,2,0,0,0,2.0,,70,2,9,11,64.0,80,7.37,76,367,2421,12.2
408,Alain Cote0,1993-94,26.0,9,6,28,28,0,6,6,24.0,,98,2,15,17,88.0,80,6.91,71,366,2385,11.6
409,Alain Cote0,1994-95,27.0,10,3,13,13,0,3,3,6.0,,111,2,18,20,94.0,80,6.96,77,402,2440,11.4
410,Alain Cote0,1995-96,28.0,11,0,2,2,0,0,0,1.0,,113,2,18,20,95.0,84,7.25,87,443,2603,11.7
411,Alain Cote0,1996-97,29.0,12,0,6,6,0,0,0,4.0,,119,2,18,20,99.0,84,6.48,76,407,2545,10.7
412,Alain Lemieux,1984-85,23.0,4,1,3,3,0,1,1,7.0,,3,0,1,1,7.0,80,8.03,73,320,2489,12.9
413,Alain Lemieux,1985-86,24.0,5,34,42,42,9,25,34,72.0,,45,9,26,35,79.0,80,7.73,71,310,2444,12.7
414,Alain Lemieux,1986-87,25.0,6,9,17,17,4,5,9,14.0,,62,13,31,44,93.0,80,7.89,74,336,2448,12.9
415,Alain Lemieux,1987-88,26.0,7,28,49,49,15,13,28,58.0,,111,28,44,72,151.0,80,7.77,71,321,2447,12.7
416,Alain Lemieux,1988-89,27.0,8,0,7,7,0,0,0,1.0,,118,28,44,72,152.0,80,7.94,82,370,2484,12.8
417,Alain Lemieux,1989-90,28.0,9,0,1,1,0,0,0,0.0,,119,28,44,72,152.0,80,7.34,72,344,2400,12.2
418,Alain Nasreddine,2001-02,26.0,4,0,15,15,0,0,0,3.0,151.0,15,0,0,0,3.0,82,5.27,57,359,2285,9.4
419,Alain Nasreddine,2005-06,30.0,5,0,3,3,0,0,0,0.0,37.0,18,0,0,0,3.0,82,5.31,60,363,2326,9.4
420,Alain Nasreddine,2008-09,33.0,6,0,6,6,0,0,0,3.0,91.0,24,0,0,0,6.0,82,6.05,85,480,2458,10.1
421,Alain Nasreddine,2009-10,34.0,7,5,44,44,1,4,5,29.0,694.0,68,1,4,5,35.0,82,5.76,70,398,2426,9.7
422,Alain Nasreddine,2010-11,35.0,8,0,6,6,0,0,0,3.0,77.0,74,1,4,5,38.0,82,5.44,62,351,2383,9.4
423,Alain Vigneault,1984-85,23.0,4,3,14,14,1,2,3,9.0,,14,1,2,3,9.0,80,8.03,73,320,2489,12.9
424,Alain Vigneault,1985-86,24.0,5,4,28,28,1,3,4,13.0,,42,2,5,7,22.0,80,7.73,71,310,2444,12.7
425,Alan Haworth,1983-84,23.0,4,36,49,49,16,20,36,72.0,,49,16,20,36,72.0,80,7.69,77,340,2441,12.6
426,Alan Haworth,1984-85,24.0,5,39,57,57,21,18,39,114.0,,106,37,38,75,186.0,80,8.03,73,320,2489,12.9
427,Alan Haworth,1985-86,25.0,6,50,74,74,23,27,50,145.0,,180,60,65,125,331.0,80,7.73,71,310,2444,12.7
428,Alan Haworth,1986-87,26.0,7,55,75,75,24,31,55,164.0,,255,84,96,180,495.0,80,7.89,74,336,2448,12.9
429,Alan Haworth,1987-88,27.0,8,49,76,76,23,26,49,154.0,,331,107,122,229,649.0,80,7.77,71,321,2447,12.7
430,Alan Haworth,1988-89,28.0,9,73,71,71,34,39,73,194.0,,402,141,161,302,843.0,80,7.94,82,370,2484,12.8
431,Alan Haworth,1989-90,29.0,10,41,50,50,25,16,41,143.0,,452,166,177,343,986.0,80,7.34,72,344,2400,12.2
432,Alan Haworth,1990-91,30.0,11,57,72,72,23,34,57,171.0,,524,189,211,400,1157.0,80,7.43,89,437,2435,12.2
433,Alan Hepple,1986-87,23.0,4,0,1,1,0,0,0,0.0,,1,0,0,0,0.0,80,7.89,74,336,2448,12.9
434,Alan Hepple,1987-88,24.0,5,0,1,1,0,0,0,2.0,,2,0,0,0,2.0,80,7.77,71,321,2447,12.7
435,Alan Hepple,1988-89,25.0,6,0,1,1,0,0,0,0.0,,3,0,0,0,2.0,80,7.94,82,370,2484,12.8
436,Alan Kerr,1987-88,23.0,4,4,19,19,3,1,4,17.0,,19,3,1,4,17.0,80,7.77,71,321,2447,12.7
437,Alan Kerr,1988-89,24.0,5,1,7,7,0,1,1,9.0,,26,3,2,5,26.0,80,7.94,82,370,2484,12.8
438,Alan Kerr,1989-90,25.0,6,17,72,72,7,10,17,97.0,,98,10,12,22,123.0,80,7.34,72,344,2400,12.2
439,Alan Kerr,1990-91,26.0,7,58,80,80,24,34,58,196.0,,178,34,46,80,319.0,80,7.43,89,437,2435,12.2
440,Alan Kerr,1991-92,27.0,8,38,71,71,20,18,38,147.0,,249,54,64,118,466.0,80,7.48,85,403,2430,12.3
441,Alan Kerr,1992-93,28.0,9,36,75,75,15,21,36,127.0,,324,69,85,154,593.0,80,7.37,76,367,2421,12.2
442,Alan Kerr,1993-94,29.0,10,0,2,2,0,0,0,2.0,,326,69,85,154,595.0,80,6.91,71,366,2385,11.6
443,Alan Kerr,1994-95,30.0,11,11,58,58,3,8,11,41.0,,384,72,93,165,636.0,80,6.96,77,402,2440,11.4
444,Alan Kerr,1995-96,31.0,12,1,7,7,0,1,1,1.0,,391,72,94,166,637.0,84,7.25,87,443,2603,11.7
445,Alan Letang,2002-03,27.0,4,0,8,8,0,0,0,1.0,80.0,8,0,0,0,1.0,82,5.49,53,331,2294,9.8
446,Alan Letang,2004-05,29.0,5,0,2,2,0,0,0,0.0,22.0,10,0,0,0,1.0,82,5.24,53,338,2262,9.5
447,Alan Letang,2005-06,30.0,6,0,4,4,0,0,0,2.0,54.0,14,0,0,0,3.0,82,5.31,60,363,2326,9.4
448,Alan May,1990-91,26.0,4,0,3,3,0,0,0,3.0,,3,0,0,0,3.0,80,7.43,89,437,2435,12.2
449,Alan May,1991-92,27.0,5,1,3,3,1,0,1,3.0,,6,1,0,1,6.0,80,7.48,85,403,2430,12.3
450,Alan May,1992-93,28.0,6,17,77,77,7,10,17,67.0,,83,8,10,18,73.0,80,7.37,76,367,2421,12.2
451,Alan May,1993-94,29.0,7,10,67,67,4,6,10,66.0,,150,12,16,28,139.0,80,6.91,71,366,2385,11.6
452,Alan May,1994-95,30.0,8,15,75,75,6,9,15,43.0,,225,18,25,43,182.0,80,6.96,77,402,2440,11.4
453,Alan May,1995-96,31.0,9,16,83,83,6,10,16,75.0,,308,24,35,59,257.0,84,7.25,87,443,2603,11.7
454,Alan May,1996-97,32.0,10,12,51,51,5,7,12,40.0,,359,29,42,71,297.0,84,6.48,76,407,2545,10.7
455,Alan May,1997-98,33.0,11,5,34,34,2,3,5,28.0,,393,31,45,76,325.0,48,5.97,37,209,1408,10.2
456,Alan Quine,2018-19,25.0,4,1,2,2,1,0,1,5.0,36.0,2,1,0,1,5.0,82,5.34,48,255,2438,9.0
457,Alan Quine,2019-20,26.0,5,18,61,61,5,13,18,82.0,764.0,63,6,13,19,87.0,82,5.45,47,245,2478,9.0
458,Alan Quine,2020-21,27.0,6,3,21,21,0,3,3,15.0,246.0,84,6,16,22,102.0,82,5.86,50,250,2620,9.2
459,Alan Quine,2021-22,28.0,7,5,13,13,3,2,5,11.0,123.0,97,9,18,27,113.0,82,5.96,47,239,2579,9.5
460,Alan Quine,2022-23,29.0,8,1,9,9,1,0,1,12.0,88.0,106,10,18,28,125.0,70,5.96,42,208,2192,9.5
461,Alec Martinez,2012-13,25.0,4,0,4,4,0,0,0,6.0,62.0,4,0,0,0,6.0,82,5.53,56,304,2486,9.1
462,Alec Martinez,2013-14,26.0,5,16,60,60,5,11,16,74.0,917.0,64,5,11,16,80.0,82,5.46,52,291,2492,9.0
463,Alec Martinez,2014-15,27.0,6,12,51,51,6,6,12,78.0,751.0,115,11,17,28,158.0,82,5.32,47,271,2439,8.9
464,Alec Martinez,2015-16,28.0,7,5,27,27,1,4,5,30.0,433.0,142,12,21,33,188.0,48,5.31,29,160,1399,9.1
465,Alec Martinez,2016-17,29.0,8,22,61,61,11,11,22,79.0,957.0,203,23,32,55,267.0,82,5.34,48,269,2463,8.9
466,Alec Martinez,2017-18,30.0,9,22,56,56,6,16,22,103.0,1116.0,259,29,48,77,370.0,82,5.32,47,251,2453,8.9
467,Alec Martinez,2018-19,31.0,10,31,78,78,10,21,31,124.0,1650.0,337,39,69,108,494.0,82,5.34,48,255,2438,9.0
468,Alec Martinez,2019-20,32.0,11,39,82,82,9,30,39,144.0,1775.0,419,48,99,147,638.0,82,5.45,47,245,2478,9.0
469,Alec Martinez,2020-21,33.0,12,25,77,77,9,16,25,111.0,1760.0,496,57,115,172,749.0,82,5.86,50,250,2620,9.2
470,Alec Martinez,2021-22,34.0,13,18,60,60,4,14,18,78.0,1282.0,556,61,129,190,827.0,82,5.96,47,239,2579,9.5
471,Alec Martinez,2022-23,35.0,14,16,51,51,3,13,16,75.0,1097.0,607,64,142,206,902.0,70,5.96,42,208,2192,9.5
472,Alek Stojanov,1997-98,24.0,4,0,4,4,0,0,0,1.0,,4,0,0,0,1.0,48,5.97,37,209,1408,10.2
473,Alek Stojanov,1998-99,25.0,5,2,68,68,1,1,2,20.0,,72,1,1,2,21.0,82,6.29,74,413,2481,10.4
474,Alek Stojanov,1999-00,26.0,6,5,35,35,1,4,5,11.0,,107,2,5,7,32.0,82,5.83,55,336,2444,9.8
475,Aleksander Barkov,2016-17,21.0,4,24,54,54,8,16,24,87.0,923.0,54,8,16,24,87.0,82,5.34,48,269,2463,8.9
476,Aleksander Barkov,2017-18,22.0,5,36,71,71,16,20,36,123.0,1242.0,125,24,36,60,210.0,82,5.32,47,251,2453,8.9
477,Aleksander Barkov,2018-19,23.0,6,59,66,66,28,31,59,171.0,1282.0,191,52,67,119,381.0,82,5.34,48,255,2438,9.0
478,Aleksander Barkov,2019-20,24.0,7,52,61,61,21,31,52,142.0,1184.0,252,73,98,171,523.0,82,5.45,47,245,2478,9.0
479,Aleksander Barkov,2020-21,25.0,8,78,79,79,27,51,78,256.0,1744.0,331,100,149,249,779.0,82,5.86,50,250,2620,9.2
480,Aleksander Barkov,2021-22,26.0,9,96,82,82,35,61,96,206.0,1833.0,413,135,210,345,985.0,82,5.96,47,239,2579,9.5
481,Aleksander Barkov,2022-23,27.0,10,62,66,66,20,42,62,172.0,1321.0,479,155,252,407,1157.0,70,5.96,42,208,2192,9.5
482,Aleksey Morozov,2000-01,23.0,4,26,76,76,13,13,26,80.0,,76,13,13,26,80.0,82,5.28,57,380,2242,9.6
483,Aleksey Morozov,2001-02,24.0,5,19,67,67,9,10,19,75.0,793.0,143,22,23,45,155.0,82,5.27,57,359,2285,9.4
484,Aleksey Morozov,2002-03,25.0,6,31,68,68,12,19,31,101.0,942.0,211,34,42,76,256.0,82,5.49,53,331,2294,9.8
485,Aleksey Morozov,2003-04,26.0,7,19,66,66,5,14,19,72.0,705.0,277,39,56,95,328.0,82,5.51,63,376,2272,9.9
486,Aleksey Morozov,2004-05,27.0,8,49,72,72,20,29,49,162.0,1203.0,349,59,85,144,490.0,82,5.24,53,338,2262,9.5
487,Aleksey Morozov,2005-06,28.0,9,25,27,27,9,16,25,46.0,505.0,376,68,101,169,536.0,82,5.31,60,363,2326,9.4
488,Aleksey Morozov,2006-07,29.0,10,50,75,75,16,34,50,132.0,1243.0,451,84,135,219,668.0,82,5.14,57,348,2300,9.2
489,Aleksi Saarela,2022-23,26.0,4,4,9,9,2,2,4,15.0,110.0,9,2,2,4,15.0,70,5.96,42,208,2192,9.5
490,Ales Hemsky,2005-06,22.0,4,30,59,59,6,24,30,50.0,712.0,59,6,24,30,50.0,82,5.31,60,363,2326,9.4
491,Ales Hemsky,2006-07,23.0,5,34,71,71,12,22,34,87.0,1025.0,130,18,46,64,137.0,82,5.14,57,348,2300,9.2
492,Ales Hemsky,2008-09,25.0,6,77,81,81,19,58,77,178.0,1375.0,211,37,104,141,315.0,82,6.05,85,480,2458,10.1
493,Ales Hemsky,2009-10,26.0,7,53,64,64,13,40,53,122.0,1087.0,275,50,144,194,437.0,82,5.76,70,398,2426,9.7
494,Ales Hemsky,2010-11,27.0,8,71,74,74,20,51,71,184.0,1375.0,349,70,195,265,621.0,82,5.44,62,351,2383,9.4
495,Ales Hemsky,2011-12,28.0,9,66,72,72,23,43,66,185.0,1343.0,421,93,238,331,806.0,82,5.7,65,341,2477,9.4
496,Ales Hemsky,2012-13,29.0,10,22,22,22,7,15,22,57.0,395.0,443,100,253,353,863.0,82,5.53,56,304,2486,9.1
497,Ales Hemsky,2013-14,30.0,11,42,47,47,14,28,42,100.0,859.0,490,114,281,395,963.0,82,5.46,52,291,2492,9.0
498,Ales Hemsky,2014-15,31.0,12,36,69,69,10,26,36,137.0,1214.0,559,124,307,431,1100.0,82,5.32,47,271,2439,8.9
499,Ales Hemsky,2015-16,32.0,13,20,38,38,9,11,20,82.0,597.0,597,133,318,451,1182.0,48,5.31,29,160,1399,9.1
500,Ales Hemsky,2016-17,33.0,14,43,75,75,13,30,43,138.0,1197.0,672,146,348,494,1320.0,82,5.34,48,269,2463,8.9
501,Ales Hemsky,2017-18,34.0,15,32,76,76,11,21,32,140.0,1037.0,748,157,369,526,1460.0,82,5.32,47,251,2453,8.9
502,Ales Hemsky,2018-19,35.0,16,39,75,75,13,26,39,155.0,983.0,823,170,395,565,1615.0,82,5.34,48,255,2438,9.0
503,Ales Hemsky,2019-20,36.0,17,7,15,15,4,3,7,30.0,216.0,838,174,398,572,1645.0,82,5.45,47,245,2478,9.0
504,Ales Hemsky,2020-21,37.0,18,0,7,7,0,0,0,5.0,69.0,845,174,398,572,1650.0,82,5.86,50,250,2620,9.2
505,Ales Kotalik,2004-05,26.0,4,4,13,13,1,3,4,21.0,164.0,13,1,3,4,21.0,82,5.24,53,338,2262,9.5
506,Ales Kotalik,2005-06,27.0,5,35,68,68,21,14,35,138.0,1037.0,81,22,17,39,159.0,82,5.31,60,363,2326,9.4
507,Ales Kotalik,2006-07,28.0,6,26,62,62,15,11,26,142.0,941.0,143,37,28,65,301.0,82,5.14,57,348,2300,9.2
508,Ales Kotalik,2008-09,30.0,7,62,82,82,25,37,62,261.0,1276.0,225,62,65,127,562.0,82,6.05,85,480,2458,10.1
509,Ales Kotalik,2009-10,31.0,8,38,66,66,16,22,38,162.0,958.0,291,78,87,165,724.0,82,5.76,70,398,2426,9.7
510,Ales Kotalik,2010-11,32.0,9,43,79,79,23,20,43,207.0,1212.0,370,101,107,208,931.0,82,5.44,62,351,2383,9.4
511,Ales Kotalik,2011-12,33.0,10,43,75,75,20,23,43,208.0,1159.0,445,121,130,251,1139.0,82,5.7,65,341,2477,9.4
512,Ales Kotalik,2012-13,34.0,11,27,71,71,11,16,27,172.0,1007.0,516,132,146,278,1311.0,82,5.53,56,304,2486,9.1
513,Ales Kotalik,2013-14,35.0,12,6,26,26,4,2,6,62.0,322.0,542,136,148,284,1373.0,82,5.46,52,291,2492,9.0
514,Ales Pisa,2004-05,28.0,4,0,2,2,0,0,0,3.0,30.0,2,0,0,0,3.0,82,5.24,53,338,2262,9.5
515,Ales Pisa,2005-06,29.0,5,4,51,51,1,3,4,37.0,663.0,53,1,3,4,40.0,82,5.31,60,363,2326,9.4
516,Alex Biega,2017-18,29.0,4,1,7,7,1,0,1,7.0,111.0,7,1,0,1,7.0,82,5.32,47,251,2453,8.9
517,Alex Biega,2018-19,30.0,5,7,51,51,0,7,7,61.0,855.0,58,1,7,8,68.0,82,5.34,48,255,2438,9.0
518,Alex Biega,2019-20,31.0,6,3,36,36,0,3,3,37.0,474.0,94,1,10,11,105.0,82,5.45,47,245,2478,9.0
519,Alex Biega,2020-21,32.0,7,9,44,44,1,8,9,79.0,661.0,138,2,18,20,184.0,82,5.86,50,250,2620,9.2
520,Alex Biega,2021-22,33.0,8,16,41,41,2,14,16,91.0,725.0,179,4,32,36,275.0,82,5.96,47,239,2579,9.5
521,Alex Biega,2022-23,34.0,9,3,49,49,0,3,3,55.0,805.0,228,4,35,39,330.0,70,5.96,42,208,2192,9.5
522,Alex Broadhurst,2020-21,27.0,4,0,2,2,0,0,0,1.0,20.0,2,0,0,0,1.0,82,5.86,50,250,2620,9.2
523,Alex Brooks,2009-10,33.0,4,1,19,19,0,1,1,4.0,164.0,19,0,1,1,4.0,82,5.76,70,398,2426,9.7
524,Alex Chiasson,2015-16,25.0,4,7,7,7,6,1,7,13.0,99.0,7,6,1,7,13.0,48,5.31,29,160,1399,9.1
525,Alex Chiasson,2016-17,26.0,5,35,79,79,13,22,35,144.0,1194.0,86,19,23,42,157.0,82,5.34,48,269,2463,8.9
526,Alex Chiasson,2017-18,27.0,6,26,76,76,11,15,26,105.0,1017.0,162,30,38,68,262.0,82,5.32,47,251,2453,8.9
527,Alex Chiasson,2018-19,28.0,7,14,77,77,8,6,14,88.0,1050.0,239,38,44,82,350.0,82,5.34,48,255,2438,9.0
528,Alex Chiasson,2019-20,29.0,8,24,81,81,12,12,24,104.0,1084.0,320,50,56,106,454.0,82,5.45,47,245,2478,9.0
529,Alex Chiasson,2020-21,30.0,9,18,61,61,9,9,18,59.0,718.0,381,59,65,124,513.0,82,5.86,50,250,2620,9.2
530,Alex Chiasson,2021-22,31.0,10,38,73,73,22,16,38,123.0,1239.0,454,81,81,162,636.0,82,5.96,47,239,2579,9.5
531,Alex Chiasson,2022-23,32.0,11,24,65,65,11,13,24,97.0,853.0,519,92,94,186,733.0,70,5.96,42,208,2192,9.5
532,Alex DeBrincat,2020-21,23.0,4,52,82,82,28,24,52,181.0,1214.0,82,28,24,52,181.0,82,5.86,50,250,2620,9.2
533,Alex DeBrincat,2021-22,24.0,5,76,82,82,41,35,76,220.0,1451.0,164,69,59,128,401.0,82,5.96,47,239,2579,9.5
534,Alex DeBrincat,2022-23,25.0,6,45,70,70,18,27,45,207.0,1225.0,234,87,86,173,608.0,70,5.96,42,208,2192,9.5
535,Alex Formenton,2020-21,21.0,4,0,1,1,0,0,0,0.0,5.0,1,0,0,0,0.0,82,5.86,50,250,2620,9.2
536,Alex Formenton,2021-22,22.0,5,1,9,9,1,0,1,16.0,105.0,10,1,0,1,16.0,82,5.96,47,239,2579,9.5
537,Alex Foster,2010-11,26.0,4,0,3,3,0,0,0,1.0,11.0,3,0,0,0,1.0,82,5.44,62,351,2383,9.4
538,Alex Friesen,2018-19,28.0,4,0,1,1,0,0,0,1.0,12.0,1,0,0,0,1.0,82,5.34,48,255,2438,9.0
539,Alex Frolov,2005-06,23.0,4,31,79,79,14,17,31,141.0,1136.0,79,14,17,31,141.0,82,5.31,60,363,2326,9.4
540,Alex Frolov,2006-07,24.0,5,48,77,77,24,24,48,168.0,1326.0,156,38,41,79,309.0,82,5.14,57,348,2300,9.2
541,Alex Frolov,2008-09,26.0,6,54,69,69,21,33,54,174.0,1332.0,225,59,74,133,483.0,82,6.05,85,480,2458,10.1
542,Alex Frolov,2009-10,27.0,7,71,82,82,35,36,71,195.0,1635.0,307,94,110,204,678.0,82,5.76,70,398,2426,9.7
543,Alex Frolov,2010-11,28.0,8,67,71,71,23,44,67,160.0,1335.0,378,117,154,271,838.0,82,5.44,62,351,2383,9.4
544,Alex Frolov,2011-12,29.0,9,59,77,77,32,27,59,176.0,1534.0,455,149,181,330,1014.0,82,5.7,65,341,2477,9.4
545,Alex Frolov,2012-13,30.0,10,51,81,81,19,32,51,182.0,1493.0,536,168,213,381,1196.0,82,5.53,56,304,2486,9.1
546,Alex Frolov,2013-14,31.0,11,16,43,43,7,9,16,78.0,620.0,579,175,222,397,1274.0,82,5.46,52,291,2492,9.0
547,Alex Galchenyuk,2015-16,21.0,4,27,48,48,9,18,27,79.0,591.0,48,9,18,27,79.0,48,5.31,29,160,1399,9.1
548,Alex Galchenyuk,2016-17,22.0,5,31,65,65,13,18,31,110.0,936.0,113,22,36,58,189.0,82,5.34,48,269,2463,8.9
549,Alex Galchenyuk,2017-18,23.0,6,46,80,80,20,26,46,163.0,1314.0,193,42,62,104,352.0,82,5.32,47,251,2453,8.9
550,Alex Galchenyuk,2018-19,24.0,7,56,82,82,30,26,56,201.0,1333.0,275,72,88,160,553.0,82,5.34,48,255,2438,9.0
551,Alex Galchenyuk,2019-20,25.0,8,44,61,61,17,27,44,104.0,972.0,336,89,115,204,657.0,82,5.45,47,245,2478,9.0
552,Alex Galchenyuk,2020-21,26.0,9,51,82,82,19,32,51,213.0,1331.0,418,108,147,255,870.0,82,5.86,50,250,2620,9.2
553,Alex Galchenyuk,2021-22,27.0,10,41,72,72,19,22,41,159.0,1133.0,490,127,169,296,1029.0,82,5.96,47,239,2579,9.5
554,Alex Galchenyuk,2022-23,28.0,11,24,59,59,8,16,24,86.0,726.0,549,135,185,320,1115.0,70,5.96,42,208,2192,9.5
555,Alex Goligoski,2010-11,25.0,4,2,3,3,0,2,2,2.0,42.0,3,0,2,2,2.0,82,5.44,62,351,2383,9.4
556,Alex Goligoski,2011-12,26.0,5,20,45,45,6,14,20,61.0,824.0,48,6,16,22,63.0,82,5.7,65,341,2477,9.4
557,Alex Goligoski,2012-13,27.0,6,37,69,69,8,29,37,98.0,1478.0,117,14,45,59,161.0,82,5.53,56,304,2486,9.1
558,Alex Goligoski,2013-14,28.0,7,46,83,83,14,32,46,162.0,1846.0,200,28,77,105,323.0,82,5.46,52,291,2492,9.0
559,Alex Goligoski,2014-15,29.0,8,30,71,71,9,21,30,140.0,1617.0,271,37,98,135,463.0,82,5.32,47,271,2439,8.9
560,Alex Goligoski,2015-16,30.0,9,27,47,47,3,24,27,80.0,1052.0,318,40,122,162,543.0,48,5.31,29,160,1399,9.1
561,Alex Goligoski,2016-17,31.0,10,42,81,81,6,36,42,141.0,1969.0,399,46,158,204,684.0,82,5.34,48,269,2463,8.9
562,Alex Goligoski,2017-18,32.0,11,36,81,81,4,32,36,122.0,1929.0,480,50,190,240,806.0,82,5.32,47,251,2453,8.9
563,Alex Goligoski,2018-19,33.0,12,37,82,82,5,32,37,127.0,1954.0,562,55,222,277,933.0,82,5.34,48,255,2438,9.0
564,Alex Goligoski,2019-20,34.0,13,36,82,82,6,30,36,112.0,1913.0,644,61,252,313,1045.0,82,5.45,47,245,2478,9.0
565,Alex Goligoski,2020-21,35.0,14,35,78,78,12,23,35,119.0,1816.0,722,73,275,348,1164.0,82,5.86,50,250,2620,9.2
566,Alex Goligoski,2021-22,36.0,15,27,76,76,3,24,27,102.0,1582.0,798,76,299,375,1266.0,82,5.96,47,239,2579,9.5
567,Alex Goligoski,2022-23,37.0,16,32,70,70,4,28,32,101.0,1614.0,868,80,327,407,1367.0,70,5.96,42,208,2192,9.5
568,Alex Grant,2016-17,28.0,4,2,2,2,2,0,2,2.0,24.0,2,2,0,2,2.0,82,5.34,48,269,2463,8.9
569,Alex Grant,2018-19,30.0,5,0,5,5,0,0,0,4.0,66.0,7,2,0,2,6.0,82,5.34,48,255,2438,9.0
570,Alex Henry,2005-06,26.0,4,0,41,41,0,0,0,8.0,160.0,41,0,0,0,8.0,82,5.31,60,363,2326,9.4
571,Alex Henry,2006-07,27.0,5,6,71,71,2,4,6,37.0,1057.0,112,2,4,6,45.0,82,5.14,57,348,2300,9.2
572,Alex Henry,2008-09,29.0,6,5,63,63,0,5,5,41.0,720.0,175,2,9,11,86.0,82,6.05,85,480,2458,10.1
573,Alex Henry,2011-12,32.0,7,0,2,2,0,0,0,0.0,13.0,177,2,9,11,86.0,82,5.7,65,341,2477,9.4
574,Alex Hicks,1998-99,29.0,4,21,64,64,10,11,21,83.0,,64,10,11,21,83.0,82,6.29,74,413,2481,10.4
575,Alex Hicks,1999-00,30.0,5,28,73,73,7,21,28,78.0,,137,17,32,49,161.0,82,5.83,55,336,2444,9.8
576,Alex Hicks,2000-01,31.0,6,20,58,58,7,13,20,78.0,,195,24,45,69,239.0,82,5.28,57,380,2242,9.6
577,Alex Hicks,2001-02,32.0,7,7,55,55,0,7,7,51.0,546.0,250,24,52,76,290.0,82,5.27,57,359,2285,9.4
578,Alex Hicks,2002-03,33.0,8,3,8,8,1,2,3,6.0,69.0,258,25,54,79,296.0,82,5.49,53,331,2294,9.8
579,Alex Iafallo,2020-21,27.0,4,25,75,75,9,16,25,129.0,1133.0,75,9,16,25,129.0,82,5.86,50,250,2620,9.2
580,Alex Iafallo,2021-22,28.0,5,33,82,82,15,18,33,148.0,1380.0,157,24,34,58,277.0,82,5.96,47,239,2579,9.5
581,Alex Iafallo,2022-23,29.0,6,43,70,70,17,26,43,142.0,1325.0,227,41,60,101,419.0,70,5.96,42,208,2192,9.5
582,Alex Killorn,2015-16,26.0,4,19,38,38,7,12,19,82.0,639.0,38,7,12,19,82.0,48,5.31,29,160,1399,9.1
583,Alex Killorn,2016-17,27.0,5,41,82,82,17,24,41,173.0,1376.0,120,24,36,60,255.0,82,5.34,48,269,2463,8.9
584,Alex Killorn,2017-18,28.0,6,38,71,71,15,23,38,130.0,1202.0,191,39,59,98,385.0,82,5.32,47,251,2453,8.9
585,Alex Killorn,2018-19,29.0,7,40,81,81,14,26,40,154.0,1360.0,272,53,85,138,539.0,82,5.34,48,255,2438,9.0
586,Alex Killorn,2019-20,30.0,8,36,81,81,19,17,36,176.0,1458.0,353,72,102,174,715.0,82,5.45,47,245,2478,9.0
587,Alex Killorn,2020-21,31.0,9,47,82,82,15,32,47,156.0,1353.0,435,87,134,221,871.0,82,5.86,50,250,2620,9.2
588,Alex Killorn,2021-22,32.0,10,40,82,82,18,22,40,153.0,1220.0,517,105,156,261,1024.0,82,5.96,47,239,2579,9.5
589,Alex Killorn,2022-23,33.0,11,49,68,68,26,23,49,130.0,1219.0,585,131,179,310,1154.0,70,5.96,42,208,2192,9.5
590,Alex Kovalev,1995-96,22.0,4,38,65,65,20,18,38,134.0,,65,20,18,38,134.0,84,7.25,87,443,2603,11.7
591,Alex Kovalev,1996-97,23.0,5,56,76,76,23,33,56,184.0,,141,43,51,94,318.0,84,6.48,76,407,2545,10.7
592,Alex Kovalev,1997-98,24.0,6,28,48,48,13,15,28,103.0,,189,56,66,122,421.0,48,5.97,37,209,1408,10.2
593,Alex Kovalev,1998-99,25.0,7,58,81,81,24,34,58,206.0,,270,80,100,180,627.0,82,6.29,74,413,2481,10.4
594,Alex Kovalev,1999-00,26.0,8,35,45,45,13,22,35,110.0,,315,93,122,215,737.0,82,5.83,55,336,2444,9.8
595,Alex Kovalev,2000-01,27.0,9,53,73,73,23,30,53,173.0,,388,116,152,268,910.0,82,5.28,57,380,2242,9.6
596,Alex Kovalev,2001-02,28.0,10,53,77,77,23,30,53,191.0,1570.0,465,139,182,321,1101.0,82,5.27,57,359,2285,9.4
597,Alex Kovalev,2002-03,29.0,11,66,82,82,26,40,66,254.0,1876.0,547,165,222,387,1355.0,82,5.49,53,331,2294,9.8
598,Alex Kovalev,2003-04,30.0,12,95,79,79,44,51,95,307.0,1863.0,626,209,273,482,1662.0,82,5.51,63,376,2272,9.9
599,Alex Kovalev,2004-05,31.0,13,76,67,67,32,44,76,266.0,1611.0,693,241,317,558,1928.0,82,5.24,53,338,2262,9.5
600,Alex Kovalev,2005-06,32.0,14,77,78,78,37,40,77,271.0,1783.0,771,278,357,635,2199.0,82,5.31,60,363,2326,9.4
601,Alex Kovalev,2006-07,33.0,15,45,78,78,14,31,45,207.0,1482.0,849,292,388,680,2406.0,82,5.14,57,348,2300,9.2
602,Alex Kovalev,2008-09,35.0,16,65,69,69,23,42,65,206.0,1344.0,918,315,430,745,2612.0,82,6.05,85,480,2458,10.1
603,Alex Kovalev,2009-10,36.0,17,47,73,73,18,29,47,197.0,1332.0,991,333,459,792,2809.0,82,5.76,70,398,2426,9.7
604,Alex Kovalev,2010-11,37.0,18,84,82,82,35,49,84,230.0,1603.0,1073,368,508,876,3039.0,82,5.44,62,351,2383,9.4
605,Alex Kovalev,2011-12,38.0,19,65,78,78,26,39,65,209.0,1515.0,1151,394,547,941,3248.0,82,5.7,65,341,2477,9.4
606,Alex Kovalev,2012-13,39.0,20,49,77,77,18,31,49,165.0,1398.0,1228,412,578,990,3413.0,82,5.53,56,304,2486,9.1
607,Alex Kovalev,2013-14,40.0,21,34,74,74,16,18,34,151.0,1222.0,1302,428,596,1024,3564.0,82,5.46,52,291,2492,9.0
608,Alex Kovalev,2015-16,42.0,22,5,14,14,2,3,5,21.0,219.0,1316,430,599,1029,3585.0,48,5.31,29,160,1399,9.1
609,Alex Ovechkin,2008-09,23.0,4,106,81,81,52,54,106,425.0,1751.0,81,52,54,106,425.0,82,6.05,85,480,2458,10.1
610,Alex Ovechkin,2009-10,24.0,5,92,82,82,46,46,92,392.0,1754.0,163,98,100,198,817.0,82,5.76,70,398,2426,9.7
611,Alex Ovechkin,2010-11,25.0,6,112,82,82,65,47,112,446.0,1894.0,245,163,147,310,1263.0,82,5.44,62,351,2383,9.4
612,Alex Ovechkin,2011-12,26.0,7,110,79,79,56,54,110,528.0,1817.0,324,219,201,420,1791.0,82,5.7,65,341,2477,9.4
613,Alex Ovechkin,2012-13,27.0,8,109,72,72,50,59,109,368.0,1569.0,396,269,260,529,2159.0,82,5.53,56,304,2486,9.1
614,Alex Ovechkin,2013-14,28.0,9,85,79,79,32,53,85,367.0,1688.0,475,301,313,614,2526.0,82,5.46,52,291,2492,9.0
615,Alex Ovechkin,2014-15,29.0,10,65,78,78,38,27,65,303.0,1544.0,553,339,340,679,2829.0,82,5.32,47,271,2439,8.9
616,Alex Ovechkin,2015-16,30.0,11,56,48,48,32,24,56,220.0,1002.0,601,371,364,735,3049.0,48,5.31,29,160,1399,9.1
617,Alex Ovechkin,2016-17,31.0,12,79,78,78,51,28,79,386.0,1603.0,679,422,392,814,3435.0,82,5.34,48,269,2463,8.9
618,Alex Ovechkin,2017-18,32.0,13,81,81,81,53,28,81,395.0,1646.0,760,475,420,895,3830.0,82,5.32,47,251,2453,8.9
619,Alex Ovechkin,2018-19,33.0,14,71,79,79,50,21,71,398.0,1604.0,839,525,441,966,4228.0,82,5.34,48,255,2438,9.0
620,Alex Ovechkin,2019-20,34.0,15,69,82,82,33,36,69,313.0,1506.0,921,558,477,1035,4541.0,82,5.45,47,245,2478,9.0
621,Alex Ovechkin,2020-21,35.0,16,87,82,82,49,38,87,355.0,1652.0,1003,607,515,1122,4896.0,82,5.86,50,250,2620,9.2
622,Alex Ovechkin,2021-22,36.0,17,89,81,81,51,38,89,338.0,1695.0,1084,658,553,1211,5234.0,82,5.96,47,239,2579,9.5
623,Alex Ovechkin,2022-23,37.0,18,67,68,68,48,19,67,311.0,1405.0,1152,706,572,1278,5545.0,70,5.96,42,208,2192,9.5
624,Alex Pietrangelo,2011-12,22.0,4,1,8,8,0,1,1,7.0,132.0,8,0,1,1,7.0,82,5.7,65,341,2477,9.4
625,Alex Pietrangelo,2012-13,23.0,5,2,9,9,1,1,2,7.0,149.0,17,1,2,3,14.0,82,5.53,56,304,2486,9.1
626,Alex Pietrangelo,2013-14,24.0,6,43,79,79,11,32,43,161.0,1738.0,96,12,34,46,175.0,82,5.46,52,291,2492,9.0
627,Alex Pietrangelo,2014-15,25.0,7,51,81,81,12,39,51,202.0,2003.0,177,24,73,97,377.0,82,5.32,47,271,2439,8.9
628,Alex Pietrangelo,2015-16,26.0,8,24,47,47,5,19,24,93.0,1180.0,224,29,92,121,470.0,48,5.31,29,160,1399,9.1
629,Alex Pietrangelo,2016-17,27.0,9,51,81,81,8,43,51,164.0,2054.0,305,37,135,172,634.0,82,5.34,48,269,2463,8.9
630,Alex Pietrangelo,2017-18,28.0,10,46,81,81,7,39,46,195.0,2058.0,386,44,174,218,829.0,82,5.32,47,251,2453,8.9
631,Alex Pietrangelo,2018-19,29.0,11,37,73,73,7,30,37,182.0,1920.0,459,51,204,255,1011.0,82,5.34,48,255,2438,9.0
632,Alex Pietrangelo,2019-20,30.0,12,48,80,80,14,34,48,181.0,2023.0,539,65,238,303,1192.0,82,5.45,47,245,2478,9.0
633,Alex Pietrangelo,2020-21,31.0,13,54,78,78,15,39,54,216.0,2007.0,617,80,277,357,1408.0,82,5.86,50,250,2620,9.2
634,Alex Pietrangelo,2021-22,32.0,14,41,71,71,13,28,41,168.0,1709.0,688,93,305,398,1576.0,82,5.96,47,239,2579,9.5
635,Alex Pietrangelo,2022-23,33.0,15,52,70,70,16,36,52,225.0,1693.0,758,109,341,450,1801.0,70,5.96,42,208,2192,9.5
636,Alex Plante,2012-13,23.0,4,1,4,4,0,1,1,4.0,54.0,4,0,1,1,4.0,82,5.53,56,304,2486,9.1
637,Alex Plante,2013-14,24.0,5,0,3,3,0,0,0,5.0,45.0,7,0,1,1,9.0,82,5.46,52,291,2492,9.0
638,Alex Plante,2014-15,25.0,6,1,3,3,0,1,1,0.0,32.0,10,0,2,2,9.0,82,5.32,47,271,2439,8.9
639,Alex Selivanov,1997-98,26.0,4,16,43,43,10,6,16,94.0,,43,10,6,16,94.0,48,5.97,37,209,1408,10.2
640,Alex Selivanov,1998-99,27.0,5,52,79,79,31,21,52,215.0,,122,41,27,68,309.0,82,6.29,74,413,2481,10.4
641,Alex Selivanov,1999-00,28.0,6,33,69,69,15,18,33,187.0,,191,56,45,101,496.0,82,5.83,55,336,2444,9.8
642,Alex Selivanov,2000-01,29.0,7,35,70,70,16,19,35,206.0,,261,72,64,136,702.0,82,5.28,57,380,2242,9.6
643,Alex Selivanov,2001-02,30.0,8,33,72,72,14,19,33,177.0,1067.0,333,86,83,169,879.0,82,5.27,57,359,2285,9.4
644,Alex Selivanov,2002-03,31.0,9,47,67,67,27,20,47,122.0,969.0,400,113,103,216,1001.0,82,5.49,53,331,2294,9.8
645,Alex Selivanov,2003-04,32.0,10,19,59,59,8,11,19,104.0,832.0,459,121,114,235,1105.0,82,5.51,63,376,2272,9.9
646,Alex Steen,2008-09,24.0,4,45,75,75,18,27,45,176.0,1322.0,75,18,27,45,176.0,82,6.05,85,480,2458,10.1
647,Alex Steen,2009-10,25.0,5,35,82,82,15,20,35,192.0,1287.0,157,33,47,80,368.0,82,5.76,70,398,2426,9.7
648,Alex Steen,2010-11,26.0,6,42,76,76,15,27,42,169.0,1375.0,233,48,74,122,537.0,82,5.44,62,351,2383,9.4
649,Alex Steen,2011-12,27.0,7,28,81,81,8,20,28,148.0,1323.0,314,56,94,150,685.0,82,5.7,65,341,2477,9.4
650,Alex Steen,2012-13,28.0,8,47,68,68,24,23,47,189.0,1107.0,382,80,117,197,874.0,82,5.53,56,304,2486,9.1
651,Alex Steen,2013-14,29.0,9,51,72,72,20,31,51,218.0,1408.0,454,100,148,248,1092.0,82,5.46,52,291,2492,9.0
652,Alex Steen,2014-15,30.0,10,28,43,43,15,13,28,134.0,822.0,497,115,161,276,1226.0,82,5.32,47,271,2439,8.9
653,Alex Steen,2015-16,31.0,11,27,40,40,8,19,27,129.0,760.0,537,123,180,303,1355.0,48,5.31,29,160,1399,9.1
654,Alex Steen,2016-17,32.0,12,62,68,68,33,29,62,211.0,1379.0,605,156,209,365,1566.0,82,5.34,48,269,2463,8.9
655,Alex Steen,2017-18,33.0,13,64,74,74,24,40,64,223.0,1479.0,679,180,249,429,1789.0,82,5.32,47,251,2453,8.9
656,Alex Steen,2018-19,34.0,14,52,67,67,17,35,52,172.0,1365.0,746,197,284,481,1961.0,82,5.34,48,255,2438,9.0
657,Alex Steen,2019-20,35.0,15,51,76,76,16,35,51,117.0,1467.0,822,213,319,532,2078.0,82,5.45,47,245,2478,9.0
658,Alex Steen,2020-21,36.0,16,46,76,76,15,31,46,168.0,1421.0,898,228,350,578,2246.0,82,5.86,50,250,2620,9.2
659,Alex Steen,2021-22,37.0,17,27,65,65,10,17,27,114.0,1030.0,963,238,367,605,2360.0,82,5.96,47,239,2579,9.5
660,Alex Steen,2022-23,38.0,18,17,55,55,7,10,17,71.0,772.0,1018,245,377,622,2431.0,70,5.96,42,208,2192,9.5
661,Alex Tanguay,2002-03,23.0,4,51,76,76,17,34,51,74.0,1188.0,76,17,34,51,74.0,82,5.49,53,331,2294,9.8
662,Alex Tanguay,2003-04,24.0,5,77,82,82,27,50,77,135.0,1464.0,158,44,84,128,209.0,82,5.51,63,376,2272,9.9
663,Alex Tanguay,2004-05,25.0,6,48,70,70,13,35,48,90.0,1284.0,228,57,119,176,299.0,82,5.24,53,338,2262,9.5
664,Alex Tanguay,2005-06,26.0,7,67,82,82,26,41,67,142.0,1460.0,310,83,160,243,441.0,82,5.31,60,363,2326,9.4
665,Alex Tanguay,2006-07,27.0,8,79,69,69,25,54,79,117.0,1266.0,379,108,214,322,558.0,82,5.14,57,348,2300,9.2
666,Alex Tanguay,2008-09,29.0,9,78,71,71,29,49,78,125.0,1304.0,450,137,263,400,683.0,82,6.05,85,480,2458,10.1
667,Alex Tanguay,2009-10,30.0,10,81,81,81,22,59,81,107.0,1431.0,531,159,322,481,790.0,82,5.76,70,398,2426,9.7
668,Alex Tanguay,2010-11,31.0,11,58,78,78,18,40,58,121.0,1463.0,609,177,362,539,911.0,82,5.44,62,351,2383,9.4
669,Alex Tanguay,2011-12,32.0,12,41,50,50,16,25,41,76.0,805.0,659,193,387,580,987.0,82,5.7,65,341,2477,9.4
670,Alex Tanguay,2012-13,33.0,13,37,80,80,10,27,37,91.0,1263.0,739,203,414,617,1078.0,82,5.53,56,304,2486,9.1
671,Alex Tanguay,2013-14,34.0,14,69,79,79,22,47,69,120.0,1561.0,818,225,461,686,1198.0,82,5.46,52,291,2492,9.0
672,Alex Tanguay,2014-15,35.0,15,49,64,64,13,36,49,84.0,1219.0,882,238,497,735,1282.0,82,5.32,47,271,2439,8.9
673,Alex Tanguay,2015-16,36.0,16,27,40,40,11,16,27,44.0,774.0,922,249,513,762,1326.0,48,5.31,29,160,1399,9.1
674,Alex Tanguay,2016-17,37.0,17,11,16,16,4,7,11,24.0,276.0,938,253,520,773,1350.0,82,5.34,48,269,2463,8.9
675,Alex Tanguay,2017-18,38.0,18,55,80,80,22,33,55,104.0,1453.0,1018,275,553,828,1454.0,82,5.32,47,251,2453,8.9
676,Alex Tanguay,2018-19,39.0,19,35,70,70,8,27,35,71.0,1105.0,1088,283,580,863,1525.0,82,5.34,48,255,2438,9.0
677,Alex Tuch,2019-20,23.0,4,0,6,6,0,0,0,8.0,64.0,6,0,0,0,8.0,82,5.45,47,245,2478,9.0
678,Alex Tuch,2020-21,24.0,5,37,78,78,15,22,37,171.0,1190.0,84,15,22,37,179.0,82,5.86,50,250,2620,9.2
679,Alex Tuch,2021-22,25.0,6,52,74,74,20,32,52,180.0,1238.0,158,35,54,89,359.0,82,5.96,47,239,2579,9.5
680,Alex Tuch,2022-23,26.0,7,17,42,42,8,9,17,98.0,614.0,200,43,63,106,457.0,70,5.96,42,208,2192,9.5
681,Alex Zhamnov,1995-96,25.0,4,72,68,68,25,47,72,163.0,,68,25,47,72,163.0,84,7.25,87,443,2603,11.7
682,Alex Zhamnov,1996-97,26.0,5,71,61,61,26,45,71,196.0,,129,51,92,143,359.0,84,6.48,76,407,2545,10.7
683,Alex Zhamnov,1997-98,27.0,6,65,48,48,30,35,65,155.0,,177,81,127,208,514.0,48,5.97,37,209,1408,10.2
684,Alex Zhamnov,1998-99,28.0,7,59,58,58,22,37,59,199.0,,235,103,164,267,713.0,82,6.29,74,413,2481,10.4
685,Alex Zhamnov,1999-00,29.0,8,62,74,74,20,42,62,208.0,,309,123,206,329,921.0,82,5.83,55,336,2444,9.8
686,Alex Zhamnov,2000-01,30.0,9,49,70,70,21,28,49,193.0,,379,144,234,378,1114.0,82,5.28,57,380,2242,9.6
687,Alex Zhamnov,2001-02,31.0,10,61,76,76,20,41,61,200.0,1634.0,455,164,275,439,1314.0,82,5.27,57,359,2285,9.4
688,Alex Zhamnov,2002-03,32.0,11,60,71,71,23,37,60,175.0,1572.0,526,187,312,499,1489.0,82,5.49,53,331,2294,9.8
689,Alex Zhamnov,2003-04,33.0,12,49,63,63,13,36,49,117.0,1339.0,589,200,348,548,1606.0,82,5.51,63,376,2272,9.9
690,Alex Zhamnov,2004-05,34.0,13,67,77,77,22,45,67,173.0,1718.0,666,222,393,615,1779.0,82,5.24,53,338,2262,9.5
691,Alex Zhamnov,2005-06,35.0,14,58,74,74,15,43,58,166.0,1561.0,740,237,436,673,1945.0,82,5.31,60,363,2326,9.4
692,Alex Zhamnov,2006-07,36.0,15,36,43,43,11,25,36,96.0,821.0,783,248,461,709,2041.0,82,5.14,57,348,2300,9.2
693,Alex Zhamnov,2008-09,38.0,16,10,24,24,1,9,10,37.0,389.0,807,249,470,719,2078.0,82,6.05,85,480,2458,10.1
694,Alexander Andrievski,1995-96,27.0,4,0,1,1,0,0,0,0.0,,1,0,0,0,0.0,84,7.25,87,443,2603,11.7
695,Alexander Burmistrov,2013-14,22.0,4,20,74,74,6,14,20,92.0,978.0,74,6,14,20,92.0,82,5.46,52,291,2492,9.0
696,Alexander Burmistrov,2014-15,23.0,5,28,76,76,13,15,28,123.0,1266.0,150,19,29,48,215.0,82,5.32,47,271,2439,8.9
697,Alexander Burmistrov,2015-16,24.0,6,10,44,44,4,6,10,55.0,688.0,194,23,35,58,270.0,48,5.31,29,160,1399,9.1
698,Alexander Burmistrov,2018-19,27.0,7,21,81,81,7,14,21,102.0,1310.0,275,30,49,79,372.0,82,5.34,48,255,2438,9.0
699,Alexander Burmistrov,2019-20,28.0,8,16,49,49,5,11,16,45.0,654.0,324,35,60,95,417.0,82,5.45,47,245,2478,9.0
700,Alexander Burmistrov,2020-21,29.0,9,6,24,24,2,4,6,18.0,287.0,348,37,64,101,435.0,82,5.86,50,250,2620,9.2
701,Alexander Edler,2009-10,23.0,4,3,22,22,1,2,3,10.0,252.0,22,1,2,3,10.0,82,5.76,70,398,2426,9.7
702,Alexander Edler,2010-11,24.0,5,20,75,75,8,12,20,124.0,1600.0,97,9,14,23,134.0,82,5.44,62,351,2383,9.4
703,Alexander Edler,2011-12,25.0,6,37,80,80,10,27,37,145.0,1690.0,177,19,41,60,279.0,82,5.7,65,341,2477,9.4
704,Alexander Edler,2012-13,26.0,7,42,76,76,5,37,42,161.0,1721.0,253,24,78,102,440.0,82,5.53,56,304,2486,9.1
705,Alexander Edler,2013-14,27.0,8,33,51,51,8,25,33,121.0,1239.0,304,32,103,135,561.0,82,5.46,52,291,2492,9.0
706,Alexander Edler,2014-15,28.0,9,49,82,82,11,38,49,228.0,1957.0,386,43,141,184,789.0,82,5.32,47,271,2439,8.9
707,Alexander Edler,2015-16,29.0,10,22,45,45,8,14,22,113.0,1073.0,431,51,155,206,902.0,48,5.31,29,160,1399,9.1
708,Alexander Edler,2016-17,30.0,11,22,63,63,7,15,22,178.0,1467.0,494,58,170,228,1080.0,82,5.34,48,269,2463,8.9
709,Alexander Edler,2017-18,31.0,12,31,74,74,8,23,31,175.0,1774.0,568,66,193,259,1255.0,82,5.32,47,251,2453,8.9
710,Alexander Edler,2018-19,32.0,13,20,52,52,6,14,20,111.0,1272.0,620,72,207,279,1366.0,82,5.34,48,255,2438,9.0
711,Alexander Edler,2019-20,33.0,14,21,68,68,6,15,21,138.0,1653.0,688,78,222,300,1504.0,82,5.45,47,245,2478,9.0
712,Alexander Edler,2020-21,34.0,15,34,70,70,6,28,34,172.0,1699.0,758,84,250,334,1676.0,82,5.86,50,250,2620,9.2
713,Alexander Edler,2021-22,35.0,16,34,56,56,10,24,34,128.0,1376.0,814,94,274,368,1804.0,82,5.96,47,239,2579,9.5
714,Alexander Edler,2022-23,36.0,17,33,59,59,5,28,33,118.0,1334.0,873,99,302,401,1922.0,70,5.96,42,208,2192,9.5
715,Alexander Godynyuk,1993-94,24.0,4,3,18,18,0,3,3,15.0,,18,0,3,3,15.0,80,6.91,71,366,2385,11.6
716,Alexander Godynyuk,1994-95,25.0,5,10,37,37,3,7,10,42.0,,55,3,10,13,57.0,80,6.96,77,402,2440,11.4
717,Alexander Godynyuk,1995-96,26.0,6,7,27,27,3,4,7,35.0,,82,6,14,20,92.0,84,7.25,87,443,2603,11.7
718,Alexander Godynyuk,1996-97,27.0,7,22,69,69,3,19,22,110.0,,151,9,33,42,202.0,84,6.48,76,407,2545,10.7
719,Alexander Godynyuk,1997-98,28.0,8,0,14,14,0,0,0,16.0,,165,9,33,42,218.0,48,5.97,37,209,1408,10.2
720,Alexander Godynyuk,1998-99,29.0,9,0,3,3,0,0,0,1.0,,168,9,33,42,219.0,82,6.29,74,413,2481,10.4
721,Alexander Godynyuk,1999-00,30.0,10,7,55,55,1,6,7,34.0,,223,10,39,49,253.0,82,5.83,55,336,2444,9.8
722,Alexander Karpovtsev,1996-97,26.0,4,18,67,67,3,15,18,78.0,,67,3,15,18,78.0,84,6.48,76,407,2545,10.7
723,Alexander Karpovtsev,1997-98,27.0,5,12,47,47,4,8,12,82.0,,114,7,23,30,160.0,48,5.97,37,209,1408,10.2
724,Alexander Karpovtsev,1998-99,28.0,6,18,40,40,2,16,18,71.0,,154,9,39,48,231.0,82,6.29,74,413,2481,10.4
725,Alexander Karpovtsev,1999-00,29.0,7,38,77,77,9,29,38,84.0,,231,18,68,86,315.0,82,5.83,55,336,2444,9.8
726,Alexander Karpovtsev,2000-01,30.0,8,10,47,47,3,7,10,46.0,,278,21,75,96,361.0,82,5.28,57,380,2242,9.6
727,Alexander Karpovtsev,2001-02,31.0,9,28,58,58,3,25,28,65.0,1219.0,336,24,100,124,426.0,82,5.27,57,359,2285,9.4
728,Alexander Karpovtsev,2002-03,32.0,10,17,69,69,3,14,17,51.0,1396.0,405,27,114,141,477.0,82,5.49,53,331,2294,9.8
729,Alexander Karpovtsev,2003-04,33.0,11,15,53,53,2,13,15,52.0,1085.0,458,29,127,156,529.0,82,5.51,63,376,2272,9.9
730,Alexander Karpovtsev,2004-05,34.0,12,10,65,65,1,9,10,40.0,1343.0,523,30,136,166,569.0,82,5.24,53,338,2262,9.5
731,Alexander Karpovtsev,2005-06,35.0,13,14,40,40,4,10,14,36.0,867.0,563,34,146,180,605.0,82,5.31,60,363,2326,9.4
732,Alexander Karpovtsev,2006-07,36.0,14,8,27,27,0,8,8,34.0,511.0,590,34,154,188,639.0,82,5.14,57,348,2300,9.2
733,Alexander Karpovtsev,2008-09,38.0,15,0,6,6,0,0,0,4.0,66.0,596,34,154,188,643.0,82,6.05,85,480,2458,10.1
734,Alexander Kerch,1996-97,29.0,4,0,5,5,0,0,0,4.0,,5,0,0,0,4.0,84,6.48,76,407,2545,10.7
735,Alexander Kerfoot,2020-21,26.0,4,43,79,79,19,24,43,81.0,1062.0,79,19,24,43,81.0,82,5.86,50,250,2620,9.2
736,Alexander Kerfoot,2021-22,27.0,5,42,78,78,15,27,42,116.0,1161.0,157,34,51,85,197.0,82,5.96,47,239,2579,9.5
737,Alexander Kerfoot,2022-23,28.0,6,28,65,65,9,19,28,88.0,960.0,222,43,70,113,285.0,70,5.96,42,208,2192,9.5
738,Alexander Kharitonov,2003-04,27.0,4,22,66,66,7,15,22,103.0,770.0,66,7,15,22,103.0,82,5.51,63,376,2272,9.9
739,Alexander Kharitonov,2004-05,28.0,5,0,5,5,0,0,0,5.0,20.0,71,7,15,22,108.0,82,5.24,53,338,2262,9.5
740,Alexander Khavanov,2003-04,32.0,4,23,74,74,7,16,23,92.0,1547.0,74,7,16,23,92.0,82,5.51,63,376,2272,9.9
741,Alexander Khavanov,2004-05,33.0,5,24,81,81,3,21,24,87.0,1395.0,155,10,37,47,179.0,82,5.24,53,338,2262,9.5
742,Alexander Khavanov,2005-06,34.0,6,33,81,81,8,25,33,90.0,1778.0,236,18,62,80,269.0,82,5.31,60,363,2326,9.4
743,Alexander Khavanov,2006-07,35.0,7,10,48,48,3,7,10,62.0,928.0,284,21,69,90,331.0,82,5.14,57,348,2300,9.2
744,Alexander Khavanov,2008-09,37.0,8,12,64,64,6,6,12,44.0,1096.0,348,27,75,102,375.0,82,6.05,85,480,2458,10.1
745,Alexander Khokhlachev,2016-17,23.0,4,0,1,1,0,0,0,2.0,15.0,1,0,0,0,2.0,82,5.34,48,269,2463,8.9
746,Alexander Khokhlachev,2017-18,24.0,5,0,3,3,0,0,0,1.0,25.0,4,0,0,0,3.0,82,5.32,47,251,2453,8.9
747,Alexander Khokhlachev,2018-19,25.0,6,0,5,5,0,0,0,4.0,51.0,9,0,0,0,7.0,82,5.34,48,255,2438,9.0
748,Alexander Korolyuk,2000-01,25.0,4,5,19,19,2,3,5,23.0,,19,2,3,5,23.0,82,5.28,57,380,2242,9.6
749,Alexander Korolyuk,2001-02,26.0,5,30,55,55,12,18,30,96.0,764.0,74,14,21,35,119.0,82,5.27,57,359,2285,9.4
750,Alexander Korolyuk,2002-03,27.0,6,35,57,57,14,21,35,124.0,776.0,131,28,42,70,243.0,82,5.49,53,331,2294,9.8
751,Alexander Korolyuk,2003-04,28.0,7,25,70,70,12,13,25,140.0,835.0,201,40,55,95,383.0,82,5.51,63,376,2272,9.9
752,Alexander Korolyuk,2004-05,29.0,8,10,32,32,3,7,10,49.0,393.0,233,43,62,105,432.0,82,5.24,53,338,2262,9.5
753,Alexander Korolyuk,2006-07,31.0,9,37,63,63,19,18,37,108.0,940.0,296,62,80,142,540.0,82,5.14,57,348,2300,9.2
754,Alexander Mogilny,1992-93,23.0,4,43,65,65,15,28,43,130.0,,65,15,28,43,130.0,80,7.37,76,367,2421,12.2
755,Alexander Mogilny,1993-94,24.0,5,64,62,62,30,34,64,201.0,,127,45,62,107,331.0,80,6.91,71,366,2385,11.6
756,Alexander Mogilny,1994-95,25.0,6,84,67,67,39,45,84,236.0,,194,84,107,191,567.0,80,6.96,77,402,2440,11.4
757,Alexander Mogilny,1995-96,26.0,7,127,77,77,76,51,127,360.0,,271,160,158,318,927.0,84,7.25,87,443,2603,11.7
758,Alexander Mogilny,1996-97,27.0,8,79,66,66,32,47,79,258.0,,337,192,205,397,1185.0,84,6.48,76,407,2545,10.7
759,Alexander Mogilny,1997-98,28.0,9,47,44,44,19,28,47,148.0,,381,211,233,444,1333.0,48,5.97,37,209,1408,10.2
760,Alexander Mogilny,1998-99,29.0,10,107,79,79,55,52,107,292.0,,460,266,285,551,1625.0,82,6.29,74,413,2481,10.4
761,Alexander Mogilny,1999-00,30.0,11,73,76,76,31,42,73,174.0,,536,297,327,624,1799.0,82,5.83,55,336,2444,9.8
762,Alexander Mogilny,2000-01,31.0,12,45,51,51,18,27,45,118.0,,587,315,354,669,1917.0,82,5.28,57,380,2242,9.6
763,Alexander Mogilny,2001-02,32.0,13,45,59,59,14,31,45,110.0,1214.0,646,329,385,714,2027.0,82,5.27,57,359,2285,9.4
764,Alexander Mogilny,2002-03,33.0,14,44,59,59,24,20,44,161.0,1125.0,705,353,405,758,2188.0,82,5.49,53,331,2294,9.8
765,Alexander Mogilny,2003-04,34.0,15,83,75,75,43,40,83,240.0,1266.0,780,396,445,841,2428.0,82,5.51,63,376,2272,9.9
766,Alexander Mogilny,2004-05,35.0,16,57,66,66,24,33,57,188.0,1164.0,846,420,478,898,2616.0,82,5.24,53,338,2262,9.5
767,Alexander Mogilny,2005-06,36.0,17,79,73,73,33,46,79,165.0,1463.0,919,453,524,977,2781.0,82,5.31,60,363,2326,9.4
768,Alexander Mogilny,2006-07,37.0,18,30,37,37,8,22,30,92.0,684.0,956,461,546,1007,2873.0,82,5.14,57,348,2300,9.2
769,Alexander Mogilny,2008-09,39.0,19,25,34,34,12,13,25,93.0,549.0,990,473,559,1032,2966.0,82,6.05,85,480,2458,10.1
770,Alexander Nikulin,2010-11,25.0,4,0,2,2,0,0,0,0.0,10.0,2,0,0,0,0.0,82,5.44,62,351,2383,9.4
771,Alexander Nikulin,2011-12,26.0,5,0,1,1,0,0,0,1.0,6.0,3,0,0,0,1.0,82,5.7,65,341,2477,9.4
772,Alexander Nylander,2019-20,21.0,4,1,4,4,0,1,1,4.0,49.0,4,0,1,1,4.0,82,5.45,47,245,2478,9.0
773,Alexander Nylander,2020-21,22.0,5,1,3,3,1,0,1,2.0,39.0,7,1,1,2,6.0,82,5.86,50,250,2620,9.2
774,Alexander Nylander,2021-22,23.0,6,4,12,12,2,2,4,16.0,146.0,19,3,3,6,22.0,82,5.96,47,239,2579,9.5
775,Alexander Nylander,2022-23,24.0,7,26,65,65,10,16,26,94.0,789.0,84,13,19,32,116.0,70,5.96,42,208,2192,9.5
776,Alexander Perezhogin,2008-09,25.0,4,19,67,67,9,10,19,109.0,679.0,67,9,10,19,109.0,82,6.05,85,480,2458,10.1
777,Alexander Perezhogin,2009-10,26.0,5,15,61,61,6,9,15,103.0,723.0,128,15,19,34,212.0,82,5.76,70,398,2426,9.7
778,Alexander Petrovic,2015-16,23.0,4,0,6,6,0,0,0,5.0,113.0,6,0,0,0,5.0,48,5.31,29,160,1399,9.1
779,Alexander Petrovic,2016-17,24.0,5,1,7,7,0,1,1,4.0,86.0,13,0,1,1,9.0,82,5.34,48,269,2463,8.9
780,Alexander Petrovic,2017-18,25.0,6,3,33,33,0,3,3,29.0,537.0,46,0,4,4,38.0,82,5.32,47,251,2453,8.9
781,Alexander Petrovic,2018-19,26.0,7,17,66,66,2,15,17,53.0,1119.0,112,2,19,21,91.0,82,5.34,48,255,2438,9.0
782,Alexander Petrovic,2019-20,27.0,8,14,49,49,1,13,14,55.0,889.0,161,3,32,35,146.0,82,5.45,47,245,2478,9.0
783,Alexander Petrovic,2020-21,28.0,9,13,67,67,2,11,13,60.0,982.0,228,5,43,48,206.0,82,5.86,50,250,2620,9.2
784,Alexander Petrovic,2021-22,29.0,10,2,35,35,0,2,2,47.0,578.0,263,5,45,50,253.0,82,5.96,47,239,2579,9.5
785,Alexander Radulov,2009-10,23.0,4,37,64,64,18,19,37,96.0,745.0,64,18,19,37,96.0,82,5.76,70,398,2426,9.7
786,Alexander Radulov,2010-11,24.0,5,58,81,81,26,32,58,183.0,1328.0,145,44,51,95,279.0,82,5.44,62,351,2383,9.4
787,Alexander Radulov,2014-15,28.0,6,7,9,9,3,4,7,21.0,174.0,154,47,55,102,300.0,82,5.32,47,271,2439,8.9
788,Alexander Radulov,2019-20,33.0,7,54,76,76,18,36,54,147.0,1390.0,230,65,91,156,447.0,82,5.45,47,245,2478,9.0
789,Alexander Radulov,2020-21,34.0,8,72,82,82,27,45,72,217.0,1650.0,312,92,136,228,664.0,82,5.86,50,250,2620,9.2
790,Alexander Radulov,2021-22,35.0,9,72,70,70,29,43,72,209.0,1385.0,382,121,179,300,873.0,82,5.96,47,239,2579,9.5
791,Alexander Radulov,2022-23,36.0,10,34,60,60,15,19,34,132.0,1005.0,442,136,198,334,1005.0,70,5.96,42,208,2192,9.5
792,Alexander Semak,1994-95,28.0,4,11,25,25,5,6,11,45.0,,25,5,6,11,45.0,80,6.96,77,402,2440,11.4
793,Alexander Semak,1995-96,29.0,5,79,82,82,37,42,79,217.0,,107,42,48,90,262.0,84,7.25,87,443,2603,11.7
794,Alexander Semak,1996-97,30.0,6,29,54,54,12,17,29,88.0,,161,54,65,119,350.0,84,6.48,76,407,2545,10.7
795,Alexander Semak,1997-98,31.0,7,18,41,41,7,11,18,71.0,,202,61,76,137,421.0,48,5.97,37,209,1408,10.2
796,Alexander Semak,1998-99,32.0,8,34,69,69,20,14,34,128.0,,271,81,90,171,549.0,82,6.29,74,413,2481,10.4
797,Alexander Semak,1999-00,33.0,9,3,18,18,2,1,3,12.0,,289,83,91,174,561.0,82,5.83,55,336,2444,9.8
798,Alexander Semin,2006-07,22.0,4,22,52,52,10,12,22,92.0,656.0,52,10,12,22,92.0,82,5.14,57,348,2300,9.2
799,Alexander Semin,2009-10,25.0,5,73,77,77,38,35,73,243.0,1417.0,129,48,47,95,335.0,82,5.76,70,398,2426,9.7
800,Alexander Semin,2010-11,26.0,6,42,63,63,26,16,42,185.0,1065.0,192,74,63,137,520.0,82,5.44,62,351,2383,9.4
801,Alexander Semin,2011-12,27.0,7,79,62,62,34,45,79,223.0,1193.0,254,108,108,216,743.0,82,5.7,65,341,2477,9.4
802,Alexander Semin,2012-13,28.0,8,84,73,73,40,44,84,278.0,1396.0,327,148,152,300,1021.0,82,5.53,56,304,2486,9.1
803,Alexander Semin,2013-14,29.0,9,54,65,65,28,26,54,196.0,1175.0,392,176,178,354,1217.0,82,5.46,52,291,2492,9.0
804,Alexander Semin,2014-15,30.0,10,54,77,77,21,33,54,183.0,1293.0,469,197,211,408,1400.0,82,5.32,47,271,2439,8.9
805,Alexander Semin,2015-16,31.0,11,44,44,44,13,31,44,150.0,921.0,513,210,242,452,1550.0,48,5.31,29,160,1399,9.1
806,Alexander Semin,2016-17,32.0,12,42,65,65,22,20,42,210.0,1294.0,578,232,262,494,1760.0,82,5.34,48,269,2463,8.9
807,Alexander Semin,2017-18,33.0,13,19,57,57,6,13,19,93.0,908.0,635,238,275,513,1853.0,82,5.32,47,251,2453,8.9
808,Alexander Semin,2018-19,34.0,14,4,15,15,1,3,4,18.0,185.0,650,239,278,517,1871.0,82,5.34,48,255,2438,9.0
809,Alexander Suglobov,2006-07,25.0,4,0,1,1,0,0,0,2.0,8.0,1,0,0,0,2.0,82,5.14,57,348,2300,9.2
810,Alexander Suglobov,2008-09,27.0,5,1,3,3,1,0,1,5.0,36.0,4,1,0,1,7.0,82,6.05,85,480,2458,10.1
811,Alexander Suglobov,2009-10,28.0,6,0,14,14,0,0,0,17.0,104.0,18,1,0,1,24.0,82,5.76,70,398,2426,9.7
812,Alexander Sulzer,2011-12,27.0,4,0,2,2,0,0,0,0.0,13.0,2,0,0,0,0.0,82,5.7,65,341,2477,9.4
813,Alexander Sulzer,2012-13,28.0,5,2,20,20,0,2,2,15.0,268.0,22,0,2,2,15.0,82,5.53,56,304,2486,9.1
814,Alexander Sulzer,2013-14,29.0,6,5,40,40,1,4,5,37.0,702.0,62,1,6,7,52.0,82,5.46,52,291,2492,9.0
815,Alexander Sulzer,2014-15,30.0,7,9,27,27,3,6,9,33.0,481.0,89,4,12,16,85.0,82,5.32,47,271,2439,8.9
816,Alexander Sulzer,2015-16,31.0,8,4,17,17,3,1,4,15.0,281.0,106,7,13,20,100.0,48,5.31,29,160,1399,9.1
817,Alexander Sulzer,2016-17,32.0,9,2,25,25,0,2,2,21.0,453.0,131,7,15,22,121.0,82,5.34,48,269,2463,8.9
818,Alexander Svitov,2005-06,23.0,4,8,63,63,4,4,8,69.0,557.0,63,4,4,8,69.0,82,5.31,60,363,2326,9.4
819,Alexander Svitov,2006-07,24.0,5,11,40,40,2,9,11,52.0,469.0,103,6,13,19,121.0,82,5.14,57,348,2300,9.2
820,Alexander Svitov,2009-10,27.0,6,18,76,76,7,11,18,83.0,1047.0,179,13,24,37,204.0,82,5.76,70,398,2426,9.7
821,Alexander True,2022-23,25.0,4,4,12,12,0,4,4,12.0,120.0,12,0,4,4,12.0,70,5.96,42,208,2192,9.5
822,Alexander Urbom,2013-14,23.0,4,1,8,8,1,0,1,5.0,101.0,8,1,0,1,5.0,82,5.46,52,291,2492,9.0
823,Alexander Urbom,2014-15,24.0,5,1,5,5,1,0,1,3.0,68.0,13,2,0,2,8.0,82,5.32,47,271,2439,8.9
824,Alexander Urbom,2015-16,25.0,6,0,1,1,0,0,0,0.0,14.0,14,2,0,2,8.0,48,5.31,29,160,1399,9.1
825,Alexander Urbom,2016-17,26.0,7,2,20,20,1,1,2,16.0,292.0,34,3,1,4,24.0,82,5.34,48,269,2463,8.9
826,Alexander Vasilevski,1998-99,24.0,4,0,1,1,0,0,0,0.0,,1,0,0,0,0.0,82,6.29,74,413,2481,10.4
827,Alexander Vasilevski,1999-00,25.0,5,0,3,3,0,0,0,3.0,,4,0,0,0,3.0,82,5.83,55,336,2444,9.8
828,Alexander Vasyunov,2013-14,25.0,4,5,18,18,1,4,5,18.0,207.0,18,1,4,5,18.0,82,5.46,52,291,2492,9.0
829,Alexander Volkov,2022-23,25.0,4,1,9,9,0,1,1,7.0,92.0,9,0,1,1,7.0,70,5.96,42,208,2192,9.5
830,Alexander Wennberg,2017-18,23.0,4,20,68,68,4,16,20,85.0,1062.0,68,4,16,20,85.0,82,5.32,47,251,2453,8.9
831,Alexander Wennberg,2018-19,24.0,5,40,69,69,8,32,40,97.0,1094.0,137,12,48,60,182.0,82,5.34,48,255,2438,9.0
832,Alexander Wennberg,2019-20,25.0,6,59,80,80,13,46,59,109.0,1470.0,217,25,94,119,291.0,82,5.45,47,245,2478,9.0
833,Alexander Wennberg,2020-21,26.0,7,35,66,66,8,27,35,74.0,1197.0,283,33,121,154,365.0,82,5.86,50,250,2620,9.2
834,Alexander Wennberg,2021-22,27.0,8,25,75,75,2,23,25,64.0,1131.0,358,35,144,179,429.0,82,5.96,47,239,2579,9.5
835,Alexander Wennberg,2022-23,28.0,9,22,57,57,5,17,22,72.0,951.0,415,40,161,201,501.0,70,5.96,42,208,2192,9.5
836,Alexander Yelesin,2022-23,26.0,4,0,4,4,0,0,0,2.0,50.0,4,0,0,0,2.0,70,5.96,42,208,2192,9.5
837,Alexandre Boikov,2002-03,27.0,4,0,2,2,0,0,0,1.0,17.0,2,0,0,0,1.0,82,5.49,53,331,2294,9.8
838,Alexandre Boikov,2003-04,28.0,5,0,8,8,0,0,0,3.0,50.0,10,0,0,0,4.0,82,5.51,63,376,2272,9.9
839,Alexandre Bolduc,2011-12,26.0,4,1,7,7,0,1,1,7.0,51.0,7,0,1,1,7.0,82,5.7,65,341,2477,9.4
840,Alexandre Bolduc,2012-13,27.0,5,0,15,15,0,0,0,14.0,150.0,22,0,1,1,21.0,82,5.53,56,304,2486,9.1
841,Alexandre Bolduc,2013-14,28.0,6,4,24,24,2,2,4,21.0,178.0,46,2,3,5,42.0,82,5.46,52,291,2492,9.0
842,Alexandre Bolduc,2014-15,29.0,7,0,2,2,0,0,0,1.0,14.0,48,2,3,5,43.0,82,5.32,47,271,2439,8.9
843,Alexandre Bolduc,2015-16,30.0,8,0,14,14,0,0,0,17.0,107.0,62,2,3,5,60.0,48,5.31,29,160,1399,9.1
844,Alexandre Bolduc,2017-18,32.0,9,0,3,3,0,0,0,3.0,32.0,65,2,3,5,63.0,82,5.32,47,251,2453,8.9
845,Alexandre Burrows,2008-09,27.0,4,12,43,43,7,5,12,49.0,447.0,43,7,5,12,49.0,82,6.05,85,480,2458,10.1
846,Alexandre Burrows,2009-10,28.0,5,9,81,81,3,6,9,70.0,927.0,124,10,11,21,119.0,82,5.76,70,398,2426,9.7
847,Alexandre Burrows,2010-11,29.0,6,31,82,82,12,19,31,126.0,1238.0,206,22,30,52,245.0,82,5.44,62,351,2383,9.4
848,Alexandre Burrows,2011-12,30.0,7,51,82,82,28,23,51,175.0,1382.0,288,50,53,103,420.0,82,5.7,65,341,2477,9.4
849,Alexandre Burrows,2012-13,31.0,8,67,82,82,35,32,67,209.0,1465.0,370,85,85,170,629.0,82,5.53,56,304,2486,9.1
850,Alexandre Burrows,2013-14,32.0,9,48,72,72,26,22,48,152.0,1226.0,442,111,107,218,781.0,82,5.46,52,291,2492,9.0
851,Alexandre Burrows,2014-15,33.0,10,52,80,80,28,24,52,198.0,1478.0,522,139,131,270,979.0,82,5.32,47,271,2439,8.9
852,Alexandre Burrows,2015-16,34.0,11,24,47,47,13,11,24,140.0,889.0,569,152,142,294,1119.0,48,5.31,29,160,1399,9.1
853,Alexandre Burrows,2016-17,35.0,12,15,49,49,5,10,15,104.0,873.0,618,157,152,309,1223.0,82,5.34,48,269,2463,8.9
854,Alexandre Burrows,2017-18,36.0,13,33,70,70,18,15,33,145.0,1083.0,688,175,167,342,1368.0,82,5.32,47,251,2453,8.9
855,Alexandre Burrows,2018-19,37.0,14,22,79,79,9,13,22,135.0,1198.0,767,184,180,364,1503.0,82,5.34,48,255,2438,9.0
856,Alexandre Burrows,2019-20,38.0,15,31,75,75,15,16,31,143.0,1099.0,842,199,196,395,1646.0,82,5.45,47,245,2478,9.0
857,Alexandre Burrows,2020-21,39.0,16,14,71,71,6,8,14,90.0,830.0,913,205,204,409,1736.0,82,5.86,50,250,2620,9.2
858,Alexandre Carrier,2019-20,23.0,4,0,2,2,0,0,0,1.0,21.0,2,0,0,0,1.0,82,5.45,47,245,2478,9.0
859,Alexandre Carrier,2022-23,26.0,5,0,3,3,0,0,0,4.0,32.0,5,0,0,0,5.0,70,5.96,42,208,2192,9.5
860,Alexandre Daigle,1996-97,21.0,4,51,84,84,20,31,51,168.0,,84,20,31,51,168.0,84,6.48,76,407,2545,10.7
861,Alexandre Daigle,1997-98,22.0,5,37,47,47,16,21,37,105.0,,131,36,52,88,273.0,48,5.97,37,209,1408,10.2
862,Alexandre Daigle,1998-99,23.0,6,17,50,50,5,12,17,77.0,,181,41,64,105,350.0,82,6.29,74,413,2481,10.4
863,Alexandre Daigle,1999-00,24.0,7,51,82,82,26,25,51,203.0,,263,67,89,156,553.0,82,5.83,55,336,2444,9.8
864,Alexandre Daigle,2000-01,25.0,8,42,75,75,16,26,42,146.0,,338,83,115,198,699.0,82,5.28,57,380,2242,9.6
865,Alexandre Daigle,2001-02,26.0,9,17,63,63,9,8,17,82.0,695.0,401,92,123,215,781.0,82,5.27,57,359,2285,9.4
866,Alexandre Daigle,2002-03,27.0,10,26,58,58,8,18,26,52.0,637.0,459,100,141,241,833.0,82,5.49,53,331,2294,9.8
867,Alexandre Daigle,2005-06,30.0,11,7,33,33,4,3,7,48.0,361.0,492,104,144,248,881.0,82,5.31,60,363,2326,9.4
868,Alexandre Daigle,2006-07,31.0,12,51,78,78,20,31,51,145.0,1183.0,570,124,175,299,1026.0,82,5.14,57,348,2300,9.2
869,Alexandre Daigle,2008-09,33.0,13,28,46,46,5,23,28,59.0,598.0,616,129,198,327,1085.0,82,6.05,85,480,2458,10.1
870,Alexandre Fortin,2021-22,24.0,4,6,24,24,3,3,6,29.0,254.0,24,3,3,6,29.0,82,5.96,47,239,2579,9.5
871,Alexandre Giroux,2008-09,27.0,4,0,1,1,0,0,0,0.0,3.0,1,0,0,0,0.0,82,6.05,85,480,2458,10.1
872,Alexandre Giroux,2009-10,28.0,5,4,9,9,2,2,4,11.0,92.0,10,2,2,4,11.0,82,5.76,70,398,2426,9.7
873,Alexandre Giroux,2011-12,30.0,6,2,12,12,1,1,2,20.0,127.0,22,3,3,6,31.0,82,5.7,65,341,2477,9.4
874,Alexandre Giroux,2012-13,31.0,7,3,9,9,1,2,3,17.0,93.0,31,4,5,9,48.0,82,5.53,56,304,2486,9.1
875,Alexandre Giroux,2013-14,32.0,8,2,8,8,1,1,2,13.0,118.0,39,5,6,11,61.0,82,5.46,52,291,2492,9.0
876,Alexandre Giroux,2014-15,33.0,9,1,9,9,1,0,1,18.0,110.0,48,6,6,12,79.0,82,5.32,47,271,2439,8.9
877,Alexandre Grenier,2018-19,27.0,4,0,6,6,0,0,0,9.0,69.0,6,0,0,0,9.0,82,5.34,48,255,2438,9.0
878,Alexandre Grenier,2019-20,28.0,5,0,3,3,0,0,0,1.0,19.0,9,0,0,0,10.0,82,5.45,47,245,2478,9.0
879,Alexandre Picard,2008-09,23.0,4,0,17,17,0,0,0,10.0,156.0,17,0,0,0,10.0,82,6.05,85,480,2458,10.1
880,Alexandre Picard,2009-10,24.0,5,1,23,23,0,1,1,20.0,180.0,40,0,1,1,30.0,82,5.76,70,398,2426,9.7
881,Alexandre Picard,2010-11,25.0,6,0,3,3,0,0,0,1.0,20.0,43,0,1,1,31.0,82,5.44,62,351,2383,9.4
882,Alexandre Picard,2011-12,26.0,7,1,15,15,0,1,1,10.0,103.0,58,0,2,2,41.0,82,5.7,65,341,2477,9.4
883,Alexandre Picard,2012-13,27.0,8,0,9,9,0,0,0,12.0,65.0,67,0,2,2,53.0,82,5.53,56,304,2486,9.1
884,Alexandre Picard0,2008-09,23.0,4,0,6,6,0,0,0,9.0,57.0,6,0,0,0,9.0,82,6.05,85,480,2458,10.1
885,Alexandre Picard0,2009-10,24.0,5,22,62,62,3,19,22,56.0,1146.0,68,3,19,22,65.0,82,5.76,70,398,2426,9.7
886,Alexandre Picard0,2010-11,25.0,6,6,24,24,3,3,6,24.0,490.0,92,6,22,28,89.0,82,5.44,62,351,2383,9.4
887,Alexandre Picard0,2011-12,26.0,7,14,47,47,6,8,14,72.0,887.0,139,12,30,42,161.0,82,5.7,65,341,2477,9.4
888,Alexandre Picard0,2012-13,27.0,8,15,54,54,4,11,15,71.0,993.0,193,16,41,57,232.0,82,5.53,56,304,2486,9.1
889,Alexandre Picard0,2013-14,28.0,9,8,43,43,3,5,8,49.0,706.0,236,19,46,65,281.0,82,5.46,52,291,2492,9.0
890,Alexandre Picard0,2014-15,29.0,10,4,17,17,0,4,4,10.0,223.0,253,19,50,69,291.0,82,5.32,47,271,2439,8.9
891,Alexandre Texier,2021-22,22.0,4,1,2,2,1,0,1,6.0,26.0,2,1,0,1,6.0,82,5.96,47,239,2579,9.5
892,Alexandre Texier,2022-23,23.0,5,13,36,36,6,7,13,49.0,459.0,38,7,7,14,55.0,70,5.96,42,208,2192,9.5
893,Alexandre Volchkov,2002-03,25.0,4,0,3,3,0,0,0,1.0,30.0,3,0,0,0,1.0,82,5.49,53,331,2294,9.8
894,Alexei Emelin,2014-15,28.0,4,7,67,67,3,4,7,62.0,1159.0,67,3,4,7,62.0,82,5.32,47,271,2439,8.9
895,Alexei Emelin,2015-16,29.0,5,12,38,38,3,9,12,33.0,747.0,105,6,13,19,95.0,48,5.31,29,160,1399,9.1
896,Alexei Emelin,2016-17,30.0,6,17,59,59,3,14,17,58.0,1136.0,164,9,27,36,153.0,82,5.34,48,269,2463,8.9
897,Alexei Emelin,2017-18,31.0,7,14,68,68,3,11,14,43.0,1348.0,232,12,38,50,196.0,82,5.32,47,251,2453,8.9
898,Alexei Emelin,2018-19,32.0,8,12,72,72,0,12,12,71.0,1476.0,304,12,50,62,267.0,82,5.34,48,255,2438,9.0
899,Alexei Emelin,2019-20,33.0,9,10,76,76,2,8,10,82.0,1620.0,380,14,58,72,349.0,82,5.45,47,245,2478,9.0
900,Alexei Emelin,2020-21,34.0,10,9,76,76,1,8,9,59.0,1283.0,456,15,66,81,408.0,82,5.86,50,250,2620,9.2
901,Alexei Gusarov,1993-94,29.0,4,12,36,36,3,9,12,36.0,,36,3,9,12,36.0,80,6.91,71,366,2385,11.6
902,Alexei Gusarov,1994-95,30.0,5,23,68,68,5,18,23,66.0,,104,8,27,35,102.0,80,6.96,77,402,2440,11.4
903,Alexei Gusarov,1995-96,31.0,6,30,79,79,8,22,30,60.0,,183,16,49,65,162.0,84,7.25,87,443,2603,11.7
904,Alexei Gusarov,1996-97,32.0,7,25,76,76,5,20,25,84.0,,259,21,69,90,246.0,84,6.48,76,407,2545,10.7
905,Alexei Gusarov,1997-98,33.0,8,3,14,14,1,2,3,7.0,,273,22,71,93,253.0,48,5.97,37,209,1408,10.2
906,Alexei Gusarov,1998-99,34.0,9,20,65,65,5,15,20,42.0,,338,27,86,113,295.0,82,6.29,74,413,2481,10.4
907,Alexei Gusarov,1999-00,35.0,10,14,58,58,2,12,14,33.0,,396,29,98,127,328.0,82,5.83,55,336,2444,9.8
908,Alexei Gusarov,2000-01,36.0,11,14,72,72,4,10,14,47.0,,468,33,108,141,375.0,82,5.28,57,380,2242,9.6
909,Alexei Gusarov,2001-02,37.0,12,13,54,54,3,10,13,28.0,1077.0,522,36,118,154,403.0,82,5.27,57,359,2285,9.4
910,Alexei Gusarov,2002-03,38.0,13,4,34,34,2,2,4,16.0,662.0,556,38,120,158,419.0,82,5.49,53,331,2294,9.8
911,Alexei Gusarov,2003-04,39.0,14,9,51,51,1,8,9,35.0,982.0,607,39,128,167,454.0,82,5.51,63,376,2272,9.9
912,Alexei Kaigorodov,2009-10,26.0,4,1,6,6,0,1,1,3.0,29.0,6,0,1,1,3.0,82,5.76,70,398,2426,9.7
913,Alexei Kasatonov,1992-93,33.0,4,21,39,39,6,15,21,60.0,,39,6,15,21,60.0,80,7.37,76,367,2421,12.2
914,Alexei Kasatonov,1993-94,34.0,5,41,78,78,10,31,41,122.0,,117,16,46,62,182.0,80,6.91,71,366,2385,11.6
915,Alexei Kasatonov,1994-95,35.0,6,40,76,76,12,28,40,107.0,,193,28,74,102,289.0,80,6.96,77,402,2440,11.4
916,Alexei Kasatonov,1995-96,36.0,7,17,64,64,3,14,17,63.0,,257,31,88,119,352.0,84,7.25,87,443,2603,11.7
917,Alexei Kasatonov,1996-97,37.0,8,24,63,63,4,20,24,87.0,,320,35,108,143,439.0,84,6.48,76,407,2545,10.7
918,Alexei Kasatonov,1997-98,38.0,9,16,44,44,2,14,16,50.0,,364,37,122,159,489.0,48,5.97,37,209,1408,10.2
919,Alexei Kasatonov,1998-99,39.0,10,1,19,19,1,0,1,15.0,,383,38,122,160,504.0,82,6.29,74,413,2481,10.4
920,Alexei Kudashov,1996-97,25.0,4,1,25,25,1,0,1,24.0,,25,1,0,1,24.0,84,6.48,76,407,2545,10.7
921,Alexei Mikhnov,2009-10,27.0,4,0,2,2,0,0,0,0.0,14.0,2,0,0,0,0.0,82,5.76,70,398,2426,9.7
922,Alexei Ponikarovsky,2003-04,23.0,4,4,22,22,1,3,4,21.0,188.0,22,1,3,4,21.0,82,5.51,63,376,2272,9.9
923,Alexei Ponikarovsky,2004-05,24.0,5,2,8,8,2,0,2,8.0,64.0,30,3,3,6,29.0,82,5.24,53,338,2262,9.5
924,Alexei Ponikarovsky,2005-06,25.0,6,3,13,13,0,3,3,13.0,139.0,43,3,6,9,42.0,82,5.31,60,363,2326,9.4
925,Alexei Ponikarovsky,2006-07,26.0,7,28,73,73,9,19,28,110.0,847.0,116,12,25,37,152.0,82,5.14,57,348,2300,9.2
926,Alexei Ponikarovsky,2008-09,28.0,8,38,81,81,21,17,38,157.0,1142.0,197,33,42,75,309.0,82,6.05,85,480,2458,10.1
927,Alexei Ponikarovsky,2009-10,29.0,9,45,71,71,21,24,45,198.0,1214.0,268,54,66,120,507.0,82,5.76,70,398,2426,9.7
928,Alexei Ponikarovsky,2010-11,30.0,10,35,66,66,18,17,35,150.0,1054.0,334,72,83,155,657.0,82,5.44,62,351,2383,9.4
929,Alexei Ponikarovsky,2011-12,31.0,11,61,82,82,23,38,61,185.0,1294.0,416,95,121,216,842.0,82,5.7,65,341,2477,9.4
930,Alexei Ponikarovsky,2012-13,32.0,12,50,77,77,21,29,50,184.0,1268.0,493,116,150,266,1026.0,82,5.53,56,304,2486,9.1
931,Alexei Ponikarovsky,2013-14,33.0,13,15,61,61,5,10,15,94.0,769.0,554,121,160,281,1120.0,82,5.46,52,291,2492,9.0
932,Alexei Ponikarovsky,2014-15,34.0,14,33,82,82,14,19,33,156.0,1209.0,636,135,179,314,1276.0,82,5.32,47,271,2439,8.9
933,Alexei Ponikarovsky,2015-16,35.0,15,9,42,42,4,5,9,51.0,553.0,678,139,184,323,1327.0,48,5.31,29,160,1399,9.1
934,Alexei Semenov,2005-06,24.0,4,7,46,46,1,6,7,33.0,906.0,46,1,6,7,33.0,82,5.31,60,363,2326,9.4
935,Alexei Semenov,2006-07,25.0,5,5,46,46,2,3,5,36.0,794.0,92,3,9,12,69.0,82,5.14,57,348,2300,9.2
936,Alexei Semenov,2008-09,27.0,6,4,27,27,2,2,4,16.0,320.0,119,5,11,16,85.0,82,6.05,85,480,2458,10.1
937,Alexei Semenov,2009-10,28.0,7,5,23,23,0,5,5,23.0,285.0,142,5,16,21,108.0,82,5.76,70,398,2426,9.7
938,Alexei Semenov,2010-11,29.0,8,4,22,22,1,3,4,23.0,335.0,164,6,19,25,131.0,82,5.44,62,351,2383,9.4
939,Alexei Semenov,2011-12,30.0,9,8,47,47,1,7,8,28.0,613.0,211,7,26,33,159.0,82,5.7,65,341,2477,9.4
940,Alexei Smirnov,2005-06,24.0,4,5,44,44,3,2,5,46.0,389.0,44,3,2,5,46.0,82,5.31,60,363,2326,9.4
941,Alexei Smirnov,2006-07,25.0,5,1,8,8,0,1,1,8.0,58.0,52,3,3,6,54.0,82,5.14,57,348,2300,9.2
942,Alexei Tezikov,2001-02,23.0,4,0,5,5,0,0,0,4.0,91.0,5,0,0,0,4.0,82,5.27,57,359,2285,9.4
943,Alexei Tezikov,2002-03,24.0,5,2,23,23,1,1,2,18.0,242.0,28,1,1,2,22.0,82,5.49,53,331,2294,9.8
944,Alexei Tezikov,2004-05,26.0,6,0,2,2,0,0,0,0.0,24.0,30,1,1,2,22.0,82,5.24,53,338,2262,9.5
945,Alexei Vasiliev,2002-03,25.0,4,0,1,1,0,0,0,0.0,16.0,1,0,0,0,0.0,82,5.49,53,331,2294,9.8
946,Alexei Yashin,1996-97,23.0,4,79,83,83,30,49,79,232.0,,83,30,49,79,232.0,84,6.48,76,407,2545,10.7
947,Alexei Yashin,1997-98,24.0,5,44,47,47,21,23,44,154.0,,130,51,72,123,386.0,48,5.97,37,209,1408,10.2
948,Alexei Yashin,1998-99,25.0,6,39,46,46,15,24,39,143.0,,176,66,96,162,529.0,82,6.29,74,413,2481,10.4
949,Alexei Yashin,1999-00,26.0,7,75,82,82,35,40,75,291.0,,258,101,136,237,820.0,82,5.83,55,336,2444,9.8
950,Alexei Yashin,2000-01,27.0,8,72,82,82,33,39,72,291.0,,340,134,175,309,1111.0,82,5.28,57,380,2242,9.6
951,Alexei Yashin,2001-02,28.0,9,94,82,82,44,50,94,337.0,1811.0,422,178,225,403,1448.0,82,5.27,57,359,2285,9.4
952,Alexei Yashin,2003-04,30.0,10,88,82,82,40,48,88,263.0,1672.0,504,218,273,491,1711.0,82,5.51,63,376,2272,9.9
953,Alexei Yashin,2004-05,31.0,11,75,78,78,32,43,75,239.0,1609.0,582,250,316,566,1950.0,82,5.24,53,338,2262,9.5
954,Alexei Yashin,2005-06,32.0,12,65,81,81,26,39,65,274.0,1501.0,663,276,355,631,2224.0,82,5.31,60,363,2326,9.4
955,Alexei Yashin,2006-07,33.0,13,34,47,47,15,19,34,148.0,814.0,710,291,374,665,2372.0,82,5.14,57,348,2300,9.2
956,Alexei Yashin,2008-09,35.0,14,66,82,82,28,38,66,253.0,1517.0,792,319,412,731,2625.0,82,6.05,85,480,2458,10.1
957,Alexei Yashin,2009-10,36.0,15,50,58,58,18,32,50,203.0,990.0,850,337,444,781,2828.0,82,5.76,70,398,2426,9.7
958,Alexei Yegorov,1998-99,23.0,4,5,9,9,3,2,5,10.0,,9,3,2,5,10.0,82,6.29,74,413,2481,10.4
959,Alexei Yegorov,1999-00,24.0,5,1,2,2,0,1,1,0.0,,11,3,3,6,10.0,82,5.83,55,336,2444,9.8
960,Alexei Zhitnik,1995-96,23.0,4,48,78,78,12,36,48,136.0,,78,12,36,48,136.0,84,7.25,87,443,2603,11.7
961,Alexei Zhitnik,1996-97,24.0,5,52,81,81,12,40,52,227.0,,159,24,76,100,363.0,84,6.48,76,407,2545,10.7
962,Alexei Zhitnik,1997-98,25.0,6,14,32,32,4,10,14,66.0,,191,28,86,114,429.0,48,5.97,37,209,1408,10.2
963,Alexei Zhitnik,1998-99,26.0,7,36,80,80,6,30,36,193.0,,271,34,116,150,622.0,82,6.29,74,413,2481,10.4
964,Alexei Zhitnik,1999-00,27.0,8,35,80,80,7,28,35,170.0,,351,41,144,185,792.0,82,5.83,55,336,2444,9.8
965,Alexei Zhitnik,2000-01,28.0,9,45,78,78,15,30,45,191.0,,429,56,174,230,983.0,82,5.28,57,380,2242,9.6
966,Alexei Zhitnik,2001-02,29.0,10,33,81,81,7,26,33,185.0,2078.0,510,63,200,263,1168.0,82,5.27,57,359,2285,9.4
967,Alexei Zhitnik,2002-03,30.0,11,13,74,74,2,11,13,139.0,1835.0,584,65,211,276,1307.0,82,5.49,53,331,2294,9.8
968,Alexei Zhitnik,2003-04,31.0,12,37,78,78,8,29,37,149.0,1892.0,662,73,240,313,1456.0,82,5.51,63,376,2272,9.9
969,Alexei Zhitnik,2004-05,32.0,13,34,82,82,1,33,34,150.0,2100.0,744,74,273,347,1606.0,82,5.24,53,338,2262,9.5
970,Alexei Zhitnik,2005-06,33.0,14,21,70,70,3,18,21,138.0,1858.0,814,77,291,368,1744.0,82,5.31,60,363,2326,9.4
971,Alexei Zhitnik,2006-07,34.0,15,28,68,68,4,24,28,134.0,1701.0,882,81,315,396,1878.0,82,5.14,57,348,2300,9.2
972,Alexei Zhitnik,2008-09,36.0,16,29,59,59,5,24,29,99.0,1446.0,941,86,339,425,1977.0,82,6.05,85,480,2458,10.1
973,Alexei Zhitnik,2009-10,37.0,17,38,79,79,7,31,38,132.0,1904.0,1020,93,370,463,2109.0,82,5.76,70,398,2426,9.7
974,Alexei Zhitnik,2010-11,38.0,18,8,65,65,3,5,8,79.0,1236.0,1085,96,375,471,2188.0,82,5.44,62,351,2383,9.4
975,Alexey Marchenko,2016-17,25.0,4,0,1,1,0,0,0,0.0,13.0,1,0,0,0,0.0,82,5.34,48,269,2463,8.9
976,Alexey Marchenko,2017-18,26.0,5,2,13,13,1,1,2,7.0,201.0,14,1,1,2,7.0,82,5.32,47,251,2453,8.9
977,Alexey Marchenko,2018-19,27.0,6,11,66,66,2,9,11,40.0,1111.0,80,3,10,13,47.0,82,5.34,48,255,2438,9.0
978,Alexey Marchenko,2019-20,28.0,7,8,41,41,1,7,8,36.0,695.0,121,4,17,21,83.0,82,5.45,47,245,2478,9.0
979,Alfie Turcotte,1986-87,21.0,4,14,30,30,7,7,14,33.0,,30,7,7,14,33.0,80,7.89,74,336,2448,12.9
980,Alfie Turcotte,1987-88,22.0,5,24,53,53,8,16,24,59.0,,83,15,23,38,92.0,80,7.77,71,321,2447,12.7
981,Alfie Turcotte,1988-89,23.0,6,0,2,2,0,0,0,0.0,,85,15,23,38,92.0,80,7.94,82,370,2484,12.8
982,Alfie Turcotte,1990-91,25.0,7,0,3,3,0,0,0,3.0,,88,15,23,38,95.0,80,7.43,89,437,2435,12.2
983,Alfie Turcotte,1991-92,26.0,8,4,14,14,1,3,4,10.0,,102,16,26,42,105.0,80,7.48,85,403,2430,12.3
984,Alfie Turcotte,1992-93,27.0,9,2,4,4,0,2,2,4.0,,106,16,28,44,109.0,80,7.37,76,367,2421,12.2
985,Alfie Turcotte,1993-94,28.0,10,2,6,6,1,1,2,8.0,,112,17,29,46,117.0,80,6.91,71,366,2385,11.6
986,Allan Egeland,1998-99,26.0,4,0,5,5,0,0,0,1.0,,5,0,0,0,1.0,82,6.29,74,413,2481,10.4
987,Allan Egeland,1999-00,27.0,5,0,4,4,0,0,0,1.0,,9,0,0,0,2.0,82,5.83,55,336,2444,9.8
988,Allan Egeland,2000-01,28.0,6,0,8,8,0,0,0,4.0,,17,0,0,0,6.0,82,5.28,57,380,2242,9.6
989,Allan Rourke,2006-07,26.0,4,3,25,25,1,2,3,24.0,312.0,25,1,2,3,24.0,82,5.14,57,348,2300,9.2
990,Allan Rourke,2008-09,28.0,5,1,6,6,0,1,1,2.0,103.0,31,1,3,4,26.0,82,6.05,85,480,2458,10.1
991,Allan Rourke,2009-10,29.0,6,1,11,11,0,1,1,1.0,117.0,42,1,4,5,27.0,82,5.76,70,398,2426,9.7
992,Allan Rourke,2010-11,30.0,7,0,13,13,0,0,0,4.0,142.0,55,1,4,5,31.0,82,5.44,62,351,2383,9.4
993,Allan Stewart,1988-89,25.0,4,0,4,4,0,0,0,0.0,,4,0,0,0,0.0,80,7.94,82,370,2484,12.8
994,Allan Stewart,1989-90,26.0,5,1,7,7,1,0,1,8.0,,11,1,0,1,8.0,80,7.34,72,344,2400,12.2
995,Allan Stewart,1990-91,27.0,6,0,1,1,0,0,0,0.0,,12,1,0,1,8.0,80,7.43,89,437,2435,12.2
996,Allan Stewart,1991-92,28.0,7,2,6,6,0,2,2,4.0,,18,1,2,3,12.0,80,7.48,85,403,2430,12.3
997,Allan Stewart,1993-94,30.0,8,7,41,41,5,2,7,33.0,,59,6,4,10,45.0,80,6.91,71,366,2385,11.6
998,Allan Stewart,1994-95,31.0,9,0,5,5,0,0,0,1.0,,64,6,4,10,46.0,80,6.96,77,402,2440,11.4
999,Allan Tuer,1988-89,25.0,4,1,45,45,0,1,1,16.0,,45,0,1,1,16.0,80,7.94,82,370,2484,12.8
1000,Allan Tuer,1990-91,27.0,5,1,6,6,1,0,1,1.0,,51,1,1,2,17.0,80,7.43,89,437,2435,12.2
1001,Allan Tuer,1991-92,28.0,6,0,4,4,0,0,0,0.0,,55,1,1,2,17.0,80,7.48,85,403,2430,12.3
1002,Allan Tuer,1992-93,29.0,7,0,2,2,0,0,0,0.0,,57,1,1,2,17.0,80,7.37,76,367,2421,12.2
1003,Allen Pedersen,1989-90,25.0,4,12,79,79,1,11,12,56.0,,79,1,11,12,56.0,80,7.34,72,344,2400,12.2
1004,Allen Pedersen,1990-91,26.0,5,6,78,78,0,6,6,43.0,,157,1,17,18,99.0,80,7.43,89,437,2435,12.2
1005,Allen Pedersen,1991-92,27.0,6,6,51,51,0,6,6,24.0,,208,1,23,24,123.0,80,7.48,85,403,2430,12.3
1006,Allen Pedersen,1992-93,28.0,7,3,68,68,1,2,3,32.0,,276,2,25,27,155.0,80,7.37,76,367,2421,12.2
1007,Allen Pedersen,1993-94,29.0,8,8,57,57,2,6,8,34.0,,333,4,31,35,189.0,80,6.91,71,366,2385,11.6
1008,Allen Pedersen,1994-95,30.0,9,1,29,29,0,1,1,17.0,,362,4,32,36,206.0,80,6.96,77,402,2440,11.4
1009,Allen Pedersen,1995-96,31.0,10,5,59,59,1,4,5,16.0,,421,5,36,41,222.0,84,7.25,87,443,2603,11.7
1010,Allen Pedersen,1996-97,32.0,11,0,7,7,0,0,0,1.0,,428,5,36,41,223.0,84,6.48,76,407,2545,10.7
1011,Alyn McCauley,2000-01,23.0,4,16,60,60,6,10,16,77.0,,60,6,10,16,77.0,82,5.28,57,380,2242,9.6
1012,Alyn McCauley,2001-02,24.0,5,24,39,39,9,15,24,76.0,592.0,99,15,25,40,153.0,82,5.27,57,359,2285,9.4
1013,Alyn McCauley,2002-03,25.0,6,10,45,45,5,5,10,41.0,485.0,144,20,30,50,194.0,82,5.49,53,331,2294,9.8
1014,Alyn McCauley,2003-04,26.0,7,1,14,14,1,0,1,13.0,147.0,158,21,30,51,207.0,82,5.51,63,376,2272,9.9
1015,Alyn McCauley,2004-05,27.0,8,16,82,82,6,10,16,95.0,935.0,240,27,40,67,302.0,82,5.24,53,338,2262,9.5
1016,Alyn McCauley,2005-06,28.0,9,25,80,80,9,16,25,108.0,1105.0,320,36,56,92,410.0,82,5.31,60,363,2326,9.4
1017,Alyn McCauley,2006-07,29.0,10,47,82,82,20,27,47,146.0,1381.0,402,56,83,139,556.0,82,5.14,57,348,2300,9.2
1018,Alyn McCauley,2008-09,31.0,11,26,76,76,12,14,26,105.0,1082.0,478,68,97,165,661.0,82,6.05,85,480,2458,10.1
1019,Alyn McCauley,2009-10,32.0,12,1,10,10,1,0,1,4.0,97.0,488,69,97,166,665.0,82,5.76,70,398,2426,9.7
1020,Anatoli Fedotov,1995-96,29.0,4,2,1,1,0,2,2,1.0,,1,0,2,2,1.0,84,7.25,87,443,2603,11.7
1021,Anatoli Fedotov,1996-97,30.0,5,0,3,3,0,0,0,1.0,,4,0,2,2,2.0,84,6.48,76,407,2545,10.7
1022,Anatoli Semenov,1993-94,31.0,4,31,57,57,15,16,31,101.0,,57,15,16,31,101.0,80,6.91,71,366,2385,11.6
1023,Anatoli Semenov,1994-95,32.0,5,42,59,59,20,22,42,105.0,,116,35,38,73,206.0,80,6.96,77,402,2440,11.4
1024,Anatoli Semenov,1995-96,33.0,6,49,75,75,12,37,49,102.0,,191,47,75,122,308.0,84,7.25,87,443,2603,11.7
1025,Anatoli Semenov,1996-97,34.0,7,30,49,49,11,19,30,103.0,,240,58,94,152,411.0,84,6.48,76,407,2545,10.7
1026,Anatoli Semenov,1997-98,35.0,8,10,41,41,4,6,10,69.0,,281,62,100,162,480.0,48,5.97,37,209,1408,10.2
1027,Anatoli Semenov,1998-99,36.0,9,26,56,56,4,22,26,79.0,,337,66,122,188,559.0,82,6.29,74,413,2481,10.4
1028,Anatoli Semenov,1999-00,37.0,10,6,25,25,2,4,6,21.0,,362,68,126,194,580.0,82,5.83,55,336,2444,9.8
1029,Anders Bjork,2020-21,24.0,4,12,30,30,4,8,12,30.0,370.0,30,4,8,12,30.0,82,5.86,50,250,2620,9.2
1030,Anders Bjork,2021-22,25.0,5,3,20,20,1,2,3,18.0,236.0,50,5,10,15,48.0,82,5.96,47,239,2579,9.5
1031,Anders Bjork,2022-23,26.0,6,19,58,58,9,10,19,66.0,750.0,108,14,20,34,114.0,70,5.96,42,208,2192,9.5
1032,Anders Carlsson,1989-90,29.0,4,20,48,48,2,18,20,36.0,,48,2,18,20,36.0,80,7.34,72,344,2400,12.2
1033,Anders Carlsson,1990-91,30.0,5,1,9,9,1,0,1,6.0,,57,3,18,21,42.0,80,7.43,89,437,2435,12.2
1034,Anders Carlsson,1991-92,31.0,6,12,47,47,4,8,12,42.0,,104,7,26,33,84.0,80,7.48,85,403,2430,12.3
1035,Anders Eldebrink,1984-85,24.0,4,9,38,38,1,8,9,47.0,,38,1,8,9,47.0,80,8.03,73,320,2489,12.9
1036,Anders Eldebrink,1985-86,25.0,5,5,17,17,2,3,5,20.0,,55,3,11,14,67.0,80,7.73,71,310,2444,12.7
1037,Anders Eriksson,1998-99,24.0,4,0,1,1,0,0,0,0.0,,1,0,0,0,0.0,82,6.29,74,413,2481,10.4
1038,Anders Eriksson,1999-00,25.0,5,6,23,23,0,6,6,27.0,,24,0,6,6,27.0,82,5.83,55,336,2444,9.8
1039,Anders Eriksson,2000-01,26.0,6,21,66,66,7,14,21,91.0,,90,7,20,27,118.0,82,5.28,57,380,2242,9.6
1040,Anders Eriksson,2001-02,27.0,7,20,72,72,2,18,20,79.0,1221.0,162,9,38,47,197.0,82,5.27,57,359,2285,9.4
1041,Anders Eriksson,2002-03,28.0,8,28,73,73,3,25,28,86.0,1537.0,235,12,63,75,283.0,82,5.49,53,331,2294,9.8
1042,Anders Eriksson,2003-04,29.0,9,26,73,73,2,24,26,99.0,1540.0,308,14,87,101,382.0,82,5.51,63,376,2272,9.9
1043,Anders Eriksson,2004-05,30.0,10,2,34,34,0,2,2,31.0,541.0,342,14,89,103,413.0,82,5.24,53,338,2262,9.5
1044,Anders Eriksson,2005-06,31.0,11,0,4,4,0,0,0,7.0,76.0,346,14,89,103,420.0,82,5.31,60,363,2326,9.4
1045,Anders Eriksson,2006-07,32.0,12,27,66,66,7,20,27,84.0,1366.0,412,21,109,130,504.0,82,5.14,57,348,2300,9.2
1046,Anders Eriksson,2009-10,35.0,13,23,79,79,0,23,23,78.0,1596.0,491,21,132,153,582.0,82,5.76,70,398,2426,9.7
1047,Anders Eriksson,2010-11,36.0,14,18,61,61,1,17,18,50.0,1268.0,552,22,149,171,632.0,82,5.44,62,351,2383,9.4
1048,Anders Eriksson,2012-13,38.0,15,5,20,20,0,5,5,6.0,305.0,572,22,154,176,638.0,82,5.53,56,304,2486,9.1
1049,Anders Hakansson,1984-85,28.0,4,16,72,72,12,4,16,76.0,,72,12,4,16,76.0,80,8.03,73,320,2489,12.9
1050,Anders Hakansson,1985-86,29.0,5,21,67,67,9,12,21,70.0,,139,21,16,37,146.0,80,7.73,71,310,2444,12.7
1051,Anders Hakansson,1986-87,30.0,6,32,80,80,15,17,32,117.0,,219,36,33,69,263.0,80,7.89,74,336,2448,12.9
1052,Anders Hakansson,1987-88,31.0,7,24,73,73,12,12,24,76.0,,292,48,45,93,339.0,80,7.77,71,321,2447,12.7
1053,Anders Hakansson,1988-89,32.0,8,5,38,38,4,1,5,29.0,,330,52,46,98,368.0,80,7.94,82,370,2484,12.8
1054,Anders Kallur,1982-83,30.0,4,52,76,76,22,30,52,138.0,,76,22,30,52,138.0,80,7.03,61,280,2352,12.0
1055,Anders Kallur,1983-84,31.0,5,64,78,78,36,28,64,163.0,,154,58,58,116,301.0,80,7.69,77,340,2441,12.6
1056,Anders Kallur,1984-85,32.0,6,40,58,58,18,22,40,74.0,,212,76,80,156,375.0,80,8.03,73,320,2489,12.9
1057,Anders Kallur,1985-86,33.0,7,14,55,55,6,8,14,80.0,,267,82,88,170,455.0,80,7.73,71,310,2444,12.7
1058,Anders Kallur,1986-87,34.0,8,23,65,65,9,14,23,70.0,,332,91,102,193,525.0,80,7.89,74,336,2448,12.9
1059,Anders Kallur,1987-88,35.0,9,18,51,51,10,8,18,71.0,,383,101,110,211,596.0,80,7.77,71,321,2447,12.7
1060,Anders Lee,2015-16,25.0,4,2,2,2,1,1,2,2.0,16.0,2,1,1,2,2.0,48,5.31,29,160,1399,9.1
1061,Anders Lee,2016-17,26.0,5,14,22,22,9,5,14,68.0,346.0,24,10,6,16,70.0,82,5.34,48,269,2463,8.9
1062,Anders Lee,2017-18,27.0,6,41,76,76,25,16,41,197.0,1094.0,100,35,22,57,267.0,82,5.32,47,251,2453,8.9
1063,Anders Lee,2018-19,28.0,7,36,80,80,15,21,36,183.0,1166.0,180,50,43,93,450.0,82,5.34,48,255,2438,9.0
1064,Anders Lee,2019-20,29.0,8,52,81,81,34,18,52,191.0,1263.0,261,84,61,145,641.0,82,5.45,47,245,2478,9.0
1065,Anders Lee,2020-21,30.0,9,62,82,82,40,22,62,208.0,1416.0,343,124,83,207,849.0,82,5.86,50,250,2620,9.2
1066,Anders Lee,2021-22,31.0,10,51,82,82,28,23,51,204.0,1401.0,425,152,106,258,1053.0,82,5.96,47,239,2579,9.5
1067,Anders Lee,2022-23,32.0,11,43,68,68,20,23,43,195.0,1244.0,493,172,129,301,1248.0,70,5.96,42,208,2192,9.5
1068,Anders Myrvold,1998-99,23.0,4,1,4,4,0,1,1,4.0,,4,0,1,1,4.0,82,6.29,74,413,2481,10.4
1069,Anders Myrvold,1999-00,24.0,5,2,9,9,0,2,2,8.0,,13,0,3,3,12.0,82,5.83,55,336,2444,9.8
1070,Anders Myrvold,2003-04,28.0,6,1,12,12,0,1,1,8.0,113.0,25,0,4,4,20.0,82,5.51,63,376,2272,9.9
1071,Anders Myrvold,2006-07,31.0,7,1,8,8,0,1,1,6.0,98.0,33,0,5,5,26.0,82,5.14,57,348,2300,9.2
1072,Anders Steen,1983-84,28.0,4,16,42,42,5,11,16,57.0,,42,5,11,16,57.0,80,7.69,77,340,2441,12.6
1073,Andre Benoit,2013-14,30.0,4,1,8,8,0,1,1,17.0,135.0,8,0,1,1,17.0,82,5.46,52,291,2492,9.0
1074,Andre Benoit,2015-16,32.0,5,10,33,33,3,7,10,50.0,542.0,41,3,8,11,67.0,48,5.31,29,160,1399,9.1
1075,Andre Benoit,2016-17,33.0,6,28,79,79,7,21,28,113.0,1597.0,120,10,29,39,180.0,82,5.34,48,269,2463,8.9
1076,Andre Benoit,2017-18,34.0,7,9,59,59,1,8,9,45.0,1069.0,179,11,37,48,225.0,82,5.32,47,251,2453,8.9
1077,Andre Benoit,2018-19,35.0,8,0,2,2,0,0,0,0.0,27.0,181,11,37,48,225.0,82,5.34,48,255,2438,9.0
1078,Andre Burakovsky,2017-18,22.0,4,22,53,53,9,13,22,65.0,685.0,53,9,13,22,65.0,82,5.32,47,251,2453,8.9
1079,Andre Burakovsky,2018-19,23.0,5,38,79,79,17,21,38,126.0,1029.0,132,26,34,60,191.0,82,5.34,48,255,2438,9.0
1080,Andre Burakovsky,2019-20,24.0,6,35,64,64,12,23,35,111.0,849.0,196,38,57,95,302.0,82,5.45,47,245,2478,9.0
1081,Andre Burakovsky,2020-21,25.0,7,25,56,56,12,13,25,84.0,775.0,252,50,70,120,386.0,82,5.86,50,250,2620,9.2
1082,Andre Burakovsky,2021-22,26.0,8,25,76,76,12,13,25,100.0,846.0,328,62,83,145,486.0,82,5.96,47,239,2579,9.5
1083,Andre Burakovsky,2022-23,27.0,9,45,58,58,20,25,45,103.0,882.0,386,82,108,190,589.0,70,5.96,42,208,2192,9.5
1084,Andre Deveaux,2011-12,27.0,4,1,21,21,0,1,1,15.0,152.0,21,0,1,1,15.0,82,5.7,65,341,2477,9.4
1085,Andre Deveaux,2012-13,28.0,5,0,1,1,0,0,0,1.0,6.0,22,0,1,1,16.0,82,5.53,56,304,2486,9.1
1086,Andre Deveaux,2014-15,30.0,6,1,9,9,0,1,1,2.0,48.0,31,0,2,2,18.0,82,5.32,47,271,2439,8.9
1087,Andre Faust,1995-96,26.0,4,4,10,10,2,2,4,11.0,,10,2,2,4,11.0,84,7.25,87,443,2603,11.7
1088,Andre Faust,1996-97,27.0,5,13,37,37,8,5,13,33.0,,47,10,7,17,44.0,84,6.48,76,407,2545,10.7
1089,Andre Hidi,1986-87,26.0,4,0,1,1,0,0,0,1.0,,1,0,0,0,1.0,80,7.89,74,336,2448,12.9
1090,Andre Hidi,1987-88,27.0,5,3,6,6,2,1,3,7.0,,7,2,1,3,8.0,80,7.77,71,321,2447,12.7
1091,Andre Petersson,2014-15,24.0,4,0,1,1,0,0,0,0.0,5.0,1,0,0,0,0.0,82,5.32,47,271,2439,8.9
1092,Andre Roy,1998-99,23.0,4,0,3,3,0,0,0,0.0,,3,0,0,0,0.0,82,6.29,74,413,2481,10.4
1093,Andre Roy,1999-00,24.0,5,2,10,10,0,2,2,12.0,,13,0,2,2,12.0,82,5.83,55,336,2444,9.8
1094,Andre Roy,2002-03,27.0,6,7,73,73,4,3,7,39.0,474.0,86,4,5,9,51.0,82,5.49,53,331,2294,9.8
1095,Andre Roy,2003-04,28.0,7,8,64,64,3,5,8,33.0,294.0,150,7,10,17,84.0,82,5.51,63,376,2272,9.9
1096,Andre Roy,2004-05,29.0,8,16,65,65,7,9,16,66.0,550.0,215,14,19,33,150.0,82,5.24,53,338,2262,9.5
1097,Andre Roy,2005-06,30.0,9,17,62,62,10,7,17,85.0,667.0,277,24,26,50,235.0,82,5.31,60,363,2326,9.4
1098,Andre Roy,2006-07,31.0,10,2,33,33,1,1,2,24.0,259.0,310,25,27,52,259.0,82,5.14,57,348,2300,9.2
1099,Andre Roy,2008-09,33.0,11,3,42,42,2,1,3,11.0,212.0,352,27,28,55,270.0,82,6.05,85,480,2458,10.1
1100,Andre Roy,2009-10,34.0,12,3,56,56,1,2,3,15.0,250.0,408,28,30,58,285.0,82,5.76,70,398,2426,9.7
1101,Andre Roy,2010-11,35.0,13,7,63,63,4,3,7,38.0,344.0,471,32,33,65,323.0,82,5.44,62,351,2383,9.4
1102,Andre Roy,2011-12,36.0,14,3,44,44,3,0,3,26.0,242.0,515,35,33,68,349.0,82,5.7,65,341,2477,9.4
1103,Andre Savage,2001-02,26.0,4,1,6,6,1,0,1,8.0,57.0,6,1,0,1,8.0,82,5.27,57,359,2285,9.4
1104,Andre Savage,2002-03,27.0,5,20,43,43,7,13,20,70.0,631.0,49,8,13,21,78.0,82,5.49,53,331,2294,9.8
1105,Andre Savage,2003-04,28.0,6,0,1,1,0,0,0,1.0,5.0,50,8,13,21,79.0,82,5.51,63,376,2272,9.9
1106,Andre Savage,2005-06,30.0,7,3,16,16,2,1,3,13.0,125.0,66,10,14,24,92.0,82,5.31,60,363,2326,9.4
1107,Andreas Athanasiou,2018-19,24.0,4,14,37,37,9,5,14,53.0,334.0,37,9,5,14,53.0,82,5.34,48,255,2438,9.0
1108,Andreas Athanasiou,2019-20,25.0,5,29,64,64,18,11,29,120.0,862.0,101,27,16,43,173.0,82,5.45,47,245,2478,9.0
1109,Andreas Athanasiou,2020-21,26.0,6,33,71,71,16,17,33,170.0,1087.0,172,43,33,76,343.0,82,5.86,50,250,2620,9.2
1110,Andreas Athanasiou,2021-22,27.0,7,54,76,76,30,24,54,216.0,1290.0,248,73,57,130,559.0,82,5.96,47,239,2579,9.5
1111,Andreas Athanasiou,2022-23,28.0,8,26,55,55,11,15,26,129.0,871.0,303,84,72,156,688.0,70,5.96,42,208,2192,9.5
1112,Andreas Borgman,2020-21,25.0,4,11,48,48,3,8,11,46.0,657.0,48,3,8,11,46.0,82,5.86,50,250,2620,9.2
1113,Andreas Dackell,1999-00,27.0,4,31,79,79,12,19,31,79.0,,79,12,19,31,79.0,82,5.83,55,336,2444,9.8
1114,Andreas Dackell,2000-01,28.0,5,33,82,82,15,18,33,130.0,,161,27,37,64,209.0,82,5.28,57,380,2242,9.6
1115,Andreas Dackell,2001-02,29.0,6,50,77,77,15,35,50,107.0,1332.0,238,42,72,114,316.0,82,5.27,57,359,2285,9.4
1116,Andreas Dackell,2002-03,30.0,7,35,82,82,10,25,35,99.0,1335.0,320,52,97,149,415.0,82,5.49,53,331,2294,9.8
1117,Andreas Dackell,2003-04,31.0,8,31,81,81,13,18,31,72.0,1136.0,401,65,115,180,487.0,82,5.51,63,376,2272,9.9
1118,Andreas Dackell,2004-05,32.0,9,33,79,79,15,18,33,83.0,1361.0,480,80,133,213,570.0,82,5.24,53,338,2262,9.5
1119,Andreas Dackell,2005-06,33.0,10,25,73,73,7,18,25,74.0,1087.0,553,87,151,238,644.0,82,5.31,60,363,2326,9.4
1120,Andreas Dackell,2006-07,34.0,11,12,60,60,4,8,12,50.0,921.0,613,91,159,250,694.0,82,5.14,57,348,2300,9.2
1121,Andreas Englund,2019-20,24.0,4,0,5,5,0,0,0,3.0,53.0,5,0,0,0,3.0,82,5.45,47,245,2478,9.0
1122,Andreas Englund,2020-21,25.0,5,0,1,1,0,0,0,0.0,11.0,6,0,0,0,3.0,82,5.86,50,250,2620,9.2
1123,Andreas Englund,2021-22,26.0,6,0,3,3,0,0,0,2.0,40.0,9,0,0,0,5.0,82,5.96,47,239,2579,9.5
1124,Andreas Englund,2022-23,27.0,7,3,24,24,0,3,3,10.0,262.0,33,0,3,3,15.0,70,5.96,42,208,2192,9.5
1125,Andreas Engqvist,2013-14,26.0,4,0,3,3,0,0,0,1.0,26.0,3,0,0,0,1.0,82,5.46,52,291,2492,9.0
1126,Andreas Engqvist,2014-15,27.0,5,0,12,12,0,0,0,3.0,79.0,15,0,0,0,4.0,82,5.32,47,271,2439,8.9
1127,Andreas Johansson,1998-99,25.0,4,1,3,3,0,1,1,6.0,,3,0,1,1,6.0,82,6.29,74,413,2481,10.4
1128,Andreas Johansson,1999-00,26.0,5,13,42,42,4,9,13,59.0,,45,4,10,14,65.0,82,5.83,55,336,2444,9.8
1129,Andreas Johansson,2000-01,27.0,6,15,50,50,5,10,15,49.0,,95,9,20,29,114.0,82,5.28,57,380,2242,9.6
1130,Andreas Johansson,2001-02,28.0,7,37,69,69,21,16,37,144.0,1011.0,164,30,36,66,258.0,82,5.27,57,359,2285,9.4
1131,Andreas Johansson,2002-03,29.0,8,15,40,40,5,10,15,58.0,509.0,204,35,46,81,316.0,82,5.49,53,331,2294,9.8
1132,Andreas Johansson,2004-05,31.0,9,24,70,70,14,10,24,108.0,1142.0,274,49,56,105,424.0,82,5.24,53,338,2262,9.5
1133,Andreas Johansson,2005-06,32.0,10,37,56,56,20,17,37,124.0,939.0,330,69,73,142,548.0,82,5.31,60,363,2326,9.4
1134,Andreas Johansson,2006-07,33.0,11,27,47,47,12,15,27,108.0,743.0,377,81,88,169,656.0,82,5.14,57,348,2300,9.2
1135,Andreas Johnsson,2020-21,26.0,4,3,9,9,2,1,3,19.0,105.0,9,2,1,3,19.0,82,5.86,50,250,2620,9.2
1136,Andreas Johnsson,2021-22,27.0,5,43,73,73,20,23,43,130.0,998.0,82,22,24,46,149.0,82,5.96,47,239,2579,9.5
1137,Andreas Johnsson,2022-23,28.0,6,21,43,43,8,13,21,78.0,677.0,125,30,37,67,227.0,70,5.96,42,208,2192,9.5
1138,Andreas Karlsson,2002-03,27.0,4,14,51,51,5,9,14,74.0,663.0,51,5,9,14,74.0,82,5.49,53,331,2294,9.8
1139,Andreas Karlsson,2003-04,28.0,5,16,60,60,5,11,16,83.0,774.0,111,10,20,30,157.0,82,5.51,63,376,2272,9.9
1140,Andreas Karlsson,2004-05,29.0,6,8,42,42,1,7,8,41.0,525.0,153,11,27,38,198.0,82,5.24,53,338,2262,9.5
1141,Andreas Karlsson,2009-10,34.0,7,9,53,53,3,6,9,25.0,446.0,206,14,33,47,223.0,82,5.76,70,398,2426,9.7
1142,Andreas Karlsson,2010-11,35.0,8,4,58,58,2,2,4,31.0,560.0,264,16,35,51,254.0,82,5.44,62,351,2383,9.4
1143,Andreas Lilja,2003-04,28.0,4,0,2,2,0,0,0,1.0,25.0,2,0,0,0,1.0,82,5.51,63,376,2272,9.9
1144,Andreas Lilja,2004-05,29.0,5,5,26,26,1,4,5,12.0,298.0,28,1,4,5,13.0,82,5.24,53,338,2262,9.5
1145,Andreas Lilja,2005-06,30.0,6,15,73,73,4,11,15,72.0,1415.0,101,5,15,20,85.0,82,5.31,60,363,2326,9.4
1146,Andreas Lilja,2006-07,31.0,7,7,79,79,3,4,7,79.0,1545.0,180,8,19,27,164.0,82,5.14,57,348,2300,9.2
1147,Andreas Lilja,2008-09,33.0,8,15,82,82,2,13,15,78.0,1559.0,262,10,32,42,242.0,82,6.05,85,480,2458,10.1
1148,Andreas Lilja,2009-10,34.0,9,5,57,57,0,5,5,37.0,878.0,319,10,37,47,279.0,82,5.76,70,398,2426,9.7
1149,Andreas Lilja,2010-11,35.0,10,12,79,79,2,10,12,72.0,1440.0,398,12,47,59,351.0,82,5.44,62,351,2383,9.4
1150,Andreas Lilja,2011-12,36.0,11,13,60,60,2,11,13,60.0,1020.0,458,14,58,72,411.0,82,5.7,65,341,2477,9.4
1151,Andreas Lilja,2012-13,37.0,12,2,20,20,1,1,2,19.0,283.0,478,15,59,74,430.0,82,5.53,56,304,2486,9.1
1152,Andreas Lilja,2013-14,38.0,13,7,52,52,1,6,7,31.0,907.0,530,16,65,81,461.0,82,5.46,52,291,2492,9.0
1153,Andreas Lilja,2014-15,39.0,14,6,46,46,0,6,6,35.0,630.0,576,16,71,87,496.0,82,5.32,47,271,2439,8.9
1154,Andreas Lilja,2015-16,40.0,15,0,4,4,0,0,0,2.0,67.0,580,16,71,87,498.0,48,5.31,29,160,1399,9.1
1155,Andreas Martinsen,2018-19,28.0,4,11,55,55,4,7,11,52.0,610.0,55,4,7,11,52.0,82,5.34,48,255,2438,9.0
1156,Andreas Martinsen,2019-20,29.0,5,7,64,64,3,4,7,73.0,637.0,119,7,11,18,125.0,82,5.45,47,245,2478,9.0
1157,Andreas Martinsen,2020-21,30.0,6,1,9,9,1,0,1,14.0,114.0,128,8,11,19,139.0,82,5.86,50,250,2620,9.2
1158,Andreas Martinsen,2021-22,31.0,7,4,24,24,1,3,4,21.0,190.0,152,9,14,23,160.0,82,5.96,47,239,2579,9.5
1159,Andreas Nodl,2011-12,24.0,4,4,38,38,1,3,4,33.0,424.0,38,1,3,4,33.0,82,5.7,65,341,2477,9.4
1160,Andreas Nodl,2012-13,25.0,5,1,10,10,0,1,1,2.0,89.0,48,1,4,5,35.0,82,5.53,56,304,2486,9.1
1161,Andreas Nodl,2013-14,26.0,6,22,67,67,11,11,22,100.0,889.0,115,12,15,27,135.0,82,5.46,52,291,2492,9.0
1162,Andreas Nodl,2014-15,27.0,7,8,60,60,3,5,8,66.0,703.0,175,15,20,35,201.0,82,5.32,47,271,2439,8.9
1163,Andreas Nodl,2015-16,28.0,8,1,8,8,0,1,1,6.0,68.0,183,15,21,36,207.0,48,5.31,29,160,1399,9.1
1164,Andreas Salomonsson,2004-05,31.0,4,9,39,39,4,5,9,58.0,527.0,39,4,5,9,58.0,82,5.24,53,338,2262,9.5
1165,Andreas Salomonsson,2005-06,32.0,5,5,32,32,1,4,5,20.0,282.0,71,5,9,14,78.0,82,5.31,60,363,2326,9.4
1166,Andreas Thuresson,2012-13,25.0,4,3,22,22,1,2,3,30.0,220.0,22,1,2,3,30.0,82,5.53,56,304,2486,9.1
1167,Andreas Thuresson,2013-14,26.0,5,0,3,3,0,0,0,2.0,30.0,25,1,2,3,32.0,82,5.46,52,291,2492,9.0
1168,Andrei Bashkirov,2001-02,31.0,4,0,10,10,0,0,0,4.0,70.0,10,0,0,0,4.0,82,5.27,57,359,2285,9.4
1169,Andrei Bashkirov,2002-03,32.0,5,0,2,2,0,0,0,0.0,10.0,12,0,0,0,4.0,82,5.49,53,331,2294,9.8
1170,Andrei Bashkirov,2003-04,33.0,6,3,18,18,0,3,3,22.0,210.0,30,0,3,3,26.0,82,5.51,63,376,2272,9.9
1171,Andrei Chibisov,2022-23,29.0,4,0,2,2,0,0,0,1.0,15.0,2,0,0,0,1.0,70,5.96,42,208,2192,9.5
1172,Andrei Kostitsyn,2008-09,23.0,4,3,12,12,2,1,3,9.0,90.0,12,2,1,3,9.0,82,6.05,85,480,2458,10.1
1173,Andrei Kostitsyn,2009-10,24.0,5,11,22,22,1,10,11,38.0,292.0,34,3,11,14,47.0,82,5.76,70,398,2426,9.7
1174,Andrei Kostitsyn,2010-11,25.0,6,53,78,78,26,27,53,156.0,1224.0,112,29,38,67,203.0,82,5.44,62,351,2383,9.4
1175,Andrei Kostitsyn,2011-12,26.0,7,41,74,74,23,18,41,169.0,1154.0,186,52,56,108,372.0,82,5.7,65,341,2477,9.4
1176,Andrei Kostitsyn,2012-13,27.0,8,33,59,59,15,18,33,136.0,943.0,245,67,74,141,508.0,82,5.53,56,304,2486,9.1
1177,Andrei Kostitsyn,2013-14,28.0,9,45,81,81,20,25,45,196.0,1287.0,326,87,99,186,704.0,82,5.46,52,291,2492,9.0
1178,Andrei Kostitsyn,2014-15,29.0,10,36,72,72,16,20,36,122.0,1088.0,398,103,119,222,826.0,82,5.32,47,271,2439,8.9
1179,Andrei Kovalenko,1995-96,25.0,4,68,81,81,27,41,68,153.0,,81,27,41,68,153.0,84,7.25,87,443,2603,11.7
1180,Andrei Kovalenko,1996-97,26.0,5,33,58,58,16,17,33,92.0,,139,43,58,101,245.0,84,6.48,76,407,2545,10.7
1181,Andrei Kovalenko,1997-98,27.0,6,24,45,45,14,10,24,63.0,,184,57,68,125,308.0,48,5.97,37,209,1408,10.2
1182,Andrei Kovalenko,1998-99,28.0,7,56,77,77,28,28,56,131.0,,261,85,96,181,439.0,82,6.29,74,413,2481,10.4
1183,Andrei Kovalenko,1999-00,29.0,8,59,74,74,32,27,59,163.0,,335,117,123,240,602.0,82,5.83,55,336,2444,9.8
1184,Andrei Kovalenko,2000-01,30.0,9,23,59,59,6,17,23,89.0,,394,123,140,263,691.0,82,5.28,57,380,2242,9.6
1185,Andrei Kovalenko,2001-02,31.0,10,40,74,74,19,21,40,104.0,1056.0,468,142,161,303,795.0,82,5.27,57,359,2285,9.4
1186,Andrei Kovalenko,2002-03,32.0,11,39,76,76,15,24,39,114.0,1138.0,544,157,185,342,909.0,82,5.49,53,331,2294,9.8
1187,Andrei Kovalenko,2003-04,33.0,12,37,76,76,16,21,37,119.0,1174.0,620,173,206,379,1028.0,82,5.51,63,376,2272,9.9
1188,Andrei Loktionov,2012-13,22.0,4,0,1,1,0,0,0,1.0,12.0,1,0,0,0,1.0,82,5.53,56,304,2486,9.1
1189,Andrei Loktionov,2013-14,23.0,5,7,19,19,4,3,7,26.0,280.0,20,4,3,7,27.0,82,5.46,52,291,2492,9.0
1190,Andrei Loktionov,2014-15,24.0,6,7,39,39,3,4,7,60.0,489.0,59,7,7,14,87.0,82,5.32,47,271,2439,8.9
1191,Andrei Loktionov,2015-16,25.0,7,12,28,28,8,4,12,47.0,399.0,87,15,11,26,134.0,48,5.31,29,160,1399,9.1
1192,Andrei Loktionov,2016-17,26.0,8,22,68,68,7,15,22,78.0,883.0,155,22,26,48,212.0,82,5.34,48,269,2463,8.9
1193,Andrei Lomakin,1994-95,30.0,4,30,57,57,14,16,30,82.0,,57,14,16,30,82.0,80,6.96,77,402,2440,11.4
1194,Andrei Lomakin,1995-96,31.0,5,20,51,51,8,12,20,64.0,,108,22,28,50,146.0,84,7.25,87,443,2603,11.7
1195,Andrei Lomakin,1996-97,32.0,6,47,76,76,19,28,47,139.0,,184,41,56,97,285.0,84,6.48,76,407,2545,10.7
1196,Andrei Lomakin,1997-98,33.0,7,7,31,31,1,6,7,25.0,,215,42,62,104,310.0,48,5.97,37,209,1408,10.2
1197,Andrei Markov,2003-04,25.0,4,23,63,63,6,17,23,82.0,1064.0,63,6,17,23,82.0,82,5.51,63,376,2272,9.9
1198,Andrei Markov,2004-05,26.0,5,24,56,56,5,19,24,73.0,966.0,119,11,36,47,155.0,82,5.24,53,338,2262,9.5
1199,Andrei Markov,2005-06,27.0,6,37,79,79,13,24,37,159.0,1840.0,198,24,60,84,314.0,82,5.31,60,363,2326,9.4
1200,Andrei Markov,2006-07,28.0,7,28,69,69,6,22,28,105.0,1482.0,267,30,82,112,419.0,82,5.14,57,348,2300,9.2
1201,Andrei Markov,2008-09,30.0,8,46,67,67,10,36,46,88.0,1578.0,334,40,118,158,507.0,82,6.05,85,480,2458,10.1
1202,Andrei Markov,2009-10,31.0,9,49,77,77,6,43,49,128.0,1885.0,411,46,161,207,635.0,82,5.76,70,398,2426,9.7
1203,Andrei Markov,2010-11,32.0,10,58,82,82,16,42,58,145.0,2048.0,493,62,203,265,780.0,82,5.44,62,351,2383,9.4
1204,Andrei Markov,2011-12,33.0,11,64,78,78,12,52,64,165.0,1921.0,571,74,255,329,945.0,82,5.7,65,341,2477,9.4
1205,Andrei Markov,2012-13,34.0,12,34,45,45,6,28,34,85.0,1071.0,616,80,283,363,1030.0,82,5.53,56,304,2486,9.1
1206,Andrei Markov,2013-14,35.0,13,3,7,7,1,2,3,20.0,160.0,623,81,285,366,1050.0,82,5.46,52,291,2492,9.0
1207,Andrei Markov,2014-15,36.0,14,3,13,13,0,3,3,17.0,234.0,636,81,288,369,1067.0,82,5.32,47,271,2439,8.9
1208,Andrei Markov,2015-16,37.0,15,30,48,48,10,20,30,79.0,1158.0,684,91,308,399,1146.0,48,5.31,29,160,1399,9.1
1209,Andrei Markov,2016-17,38.0,16,43,81,81,7,36,43,131.0,2044.0,765,98,344,442,1277.0,82,5.34,48,269,2463,8.9
1210,Andrei Markov,2017-18,39.0,17,50,81,81,10,40,50,135.0,2018.0,846,108,384,492,1412.0,82,5.32,47,251,2453,8.9
1211,Andrei Markov,2018-19,40.0,18,44,82,82,5,39,44,117.0,1955.0,928,113,423,536,1529.0,82,5.34,48,255,2438,9.0
1212,Andrei Markov,2019-20,41.0,19,36,62,62,6,30,36,98.0,1354.0,990,119,453,572,1627.0,82,5.45,47,245,2478,9.0
1213,Andrei Mironov,2020-21,26.0,4,3,10,10,1,2,3,3.0,110.0,10,1,2,3,3.0,82,5.86,50,250,2620,9.2
1214,Andrei Nazarov,1996-97,22.0,4,0,1,1,0,0,0,0.0,,1,0,0,0,0.0,84,6.48,76,407,2545,10.7
1215,Andrei Nazarov,1997-98,23.0,5,8,26,26,3,5,8,19.0,,27,3,5,8,19.0,48,5.97,37,209,1408,10.2
1216,Andrei Nazarov,1998-99,24.0,6,14,42,42,7,7,14,55.0,,69,10,12,22,74.0,82,6.29,74,413,2481,10.4
1217,Andrei Nazarov,1999-00,25.0,7,27,60,60,12,15,27,116.0,,129,22,27,49,190.0,82,5.83,55,336,2444,9.8
1218,Andrei Nazarov,2000-01,26.0,8,4,54,54,2,2,4,50.0,,183,24,29,53,240.0,82,5.28,57,380,2242,9.6
1219,Andrei Nazarov,2001-02,27.0,9,16,62,62,7,9,16,71.0,736.0,245,31,38,69,311.0,82,5.27,57,359,2285,9.4
1220,Andrei Nazarov,2002-03,28.0,10,32,76,76,10,22,32,110.0,892.0,321,41,60,101,421.0,82,5.49,53,331,2294,9.8
1221,Andrei Nazarov,2003-04,29.0,11,6,79,79,2,4,6,63.0,655.0,400,43,64,107,484.0,82,5.51,63,376,2272,9.9
1222,Andrei Nazarov,2004-05,30.0,12,11,77,77,6,5,11,56.0,376.0,477,49,69,118,540.0,82,5.24,53,338,2262,9.5
1223,Andrei Nazarov,2005-06,31.0,13,3,59,59,3,0,3,35.0,387.0,536,52,69,121,575.0,82,5.31,60,363,2326,9.4
1224,Andrei Nazarov,2006-07,32.0,14,3,33,33,1,2,3,17.0,180.0,569,53,71,124,592.0,82,5.14,57,348,2300,9.2
1225,Andrei Nazarov,2008-09,34.0,15,0,2,2,0,0,0,0.0,10.0,571,53,71,124,592.0,82,6.05,85,480,2458,10.1
1226,Andrei Nikolishin,1997-98,24.0,4,18,39,39,8,10,18,57.0,,39,8,10,18,57.0,48,5.97,37,209,1408,10.2
1227,Andrei Nikolishin,1998-99,25.0,5,51,61,61,14,37,51,83.0,,100,22,47,69,140.0,82,6.29,74,413,2481,10.4
1228,Andrei Nikolishin,1999-00,26.0,6,28,71,71,9,19,28,98.0,,171,31,66,97,238.0,82,5.83,55,336,2444,9.8
1229,Andrei Nikolishin,2000-01,27.0,7,16,38,38,6,10,16,40.0,,209,37,76,113,278.0,82,5.28,57,380,2242,9.6
1230,Andrei Nikolishin,2001-02,28.0,8,35,73,73,8,27,35,121.0,1282.0,282,45,103,148,399.0,82,5.27,57,359,2285,9.4
1231,Andrei Nikolishin,2002-03,29.0,9,25,76,76,11,14,25,98.0,1195.0,358,56,117,173,497.0,82,5.49,53,331,2294,9.8
1232,Andrei Nikolishin,2003-04,30.0,10,38,81,81,13,25,38,145.0,1259.0,439,69,142,211,642.0,82,5.51,63,376,2272,9.9
1233,Andrei Nikolishin,2004-05,31.0,11,36,80,80,13,23,36,143.0,1391.0,519,82,165,247,785.0,82,5.24,53,338,2262,9.5
1234,Andrei Nikolishin,2005-06,32.0,12,21,60,60,6,15,21,73.0,1021.0,579,88,180,268,858.0,82,5.31,60,363,2326,9.4
1235,Andrei Nikolishin,2006-07,33.0,13,12,49,49,5,7,12,71.0,798.0,628,93,187,280,929.0,82,5.14,57,348,2300,9.2
1236,Andrei Skopintsev,2001-02,30.0,4,2,19,19,1,1,2,17.0,306.0,19,1,1,2,17.0,82,5.27,57,359,2285,9.4
1237,Andrei Skopintsev,2002-03,31.0,5,0,4,4,0,0,0,0.0,56.0,23,1,1,2,17.0,82,5.49,53,331,2294,9.8
1238,Andrei Skopintsev,2003-04,32.0,6,4,17,17,1,3,4,10.0,310.0,40,2,4,6,27.0,82,5.51,63,376,2272,9.9
1239,Andrei Svechnikov,2021-22,21.0,4,37,82,82,20,17,37,189.0,1201.0,82,20,17,37,189.0,82,5.96,47,239,2579,9.5
1240,Andrei Svechnikov,2022-23,22.0,5,61,68,68,24,37,61,183.0,1138.0,150,44,54,98,372.0,70,5.96,42,208,2192,9.5
1241,Andrei Vasilyev,1997-98,25.0,4,0,2,2,0,0,0,2.0,,2,0,0,0,2.0,48,5.97,37,209,1408,10.2
1242,Andrei Vasilyev,1998-99,26.0,5,7,10,10,2,5,7,12.0,,12,2,5,7,14.0,82,6.29,74,413,2481,10.4
1243,Andrei Vasilyev,1999-00,27.0,6,0,3,3,0,0,0,1.0,,15,2,5,7,15.0,82,5.83,55,336,2444,9.8
1244,Andrei Vasilyev,2001-02,29.0,7,0,1,1,0,0,0,0.0,1.0,16,2,5,7,15.0,82,5.27,57,359,2285,9.4
1245,Andrei Zubarev,2013-14,26.0,4,1,4,4,0,1,1,2.0,80.0,4,0,1,1,2.0,82,5.46,52,291,2492,9.0
1246,Andrei Zyuzin,2000-01,23.0,4,13,56,56,6,7,13,72.0,,56,6,7,13,72.0,82,5.28,57,380,2242,9.6
1247,Andrei Zyuzin,2001-02,24.0,5,4,25,25,3,1,4,44.0,398.0,81,9,8,17,116.0,82,5.27,57,359,2285,9.4
1248,Andrei Zyuzin,2002-03,25.0,6,11,34,34,2,9,11,47.0,696.0,115,11,17,28,163.0,82,5.49,53,331,2294,9.8
1249,Andrei Zyuzin,2003-04,26.0,7,20,64,64,4,16,20,92.0,1193.0,179,15,33,48,255.0,82,5.51,63,376,2272,9.9
1250,Andrei Zyuzin,2004-05,27.0,8,5,47,47,1,4,5,61.0,750.0,226,16,37,53,316.0,82,5.24,53,338,2262,9.5
1251,Andrei Zyuzin,2005-06,28.0,9,17,67,67,4,13,17,113.0,1448.0,293,20,50,70,429.0,82,5.31,60,363,2326,9.4
1252,Andrei Zyuzin,2006-07,29.0,10,21,65,65,8,13,21,104.0,1324.0,358,28,63,91,533.0,82,5.14,57,348,2300,9.2
1253,Andrei Zyuzin,2008-09,31.0,11,18,57,57,7,11,18,80.0,1076.0,415,35,74,109,613.0,82,6.05,85,480,2458,10.1
1254,Andrei Zyuzin,2009-10,32.0,12,6,49,49,1,5,6,36.0,677.0,464,36,79,115,649.0,82,5.76,70,398,2426,9.7
1255,Andrei Zyuzin,2010-11,33.0,13,5,32,32,2,3,5,34.0,479.0,496,38,82,120,683.0,82,5.44,62,351,2383,9.4
1256,Andrej Meszaros,2008-09,23.0,4,39,82,82,10,29,39,137.0,1491.0,82,10,29,39,137.0,82,6.05,85,480,2458,10.1
1257,Andrej Meszaros,2009-10,24.0,5,35,82,82,7,28,35,147.0,1778.0,164,17,57,74,284.0,82,5.76,70,398,2426,9.7
1258,Andrej Meszaros,2010-11,25.0,6,36,82,82,9,27,36,160.0,1725.0,246,26,84,110,444.0,82,5.44,62,351,2383,9.4
1259,Andrej Meszaros,2011-12,26.0,7,16,52,52,2,14,16,87.0,1257.0,298,28,98,126,531.0,82,5.7,65,341,2477,9.4
1260,Andrej Meszaros,2012-13,27.0,8,17,81,81,6,11,17,145.0,1635.0,379,34,109,143,676.0,82,5.53,56,304,2486,9.1
1261,Andrej Meszaros,2013-14,28.0,9,32,81,81,8,24,32,144.0,1711.0,460,42,133,175,820.0,82,5.46,52,291,2492,9.0
1262,Andrej Meszaros,2014-15,29.0,10,25,62,62,7,18,25,114.0,1281.0,522,49,151,200,934.0,82,5.32,47,271,2439,8.9
1263,Andrej Meszaros,2015-16,30.0,11,2,11,11,0,2,2,18.0,203.0,533,49,153,202,952.0,48,5.31,29,160,1399,9.1
1264,Andrej Meszaros,2016-17,31.0,12,22,52,52,7,15,22,84.0,925.0,585,56,168,224,1036.0,82,5.34,48,269,2463,8.9
1265,Andrej Meszaros,2017-18,32.0,13,14,60,60,7,7,14,67.0,1074.0,645,63,175,238,1103.0,82,5.32,47,251,2453,8.9
1266,Andrej Nedorost,2004-05,24.0,4,2,7,7,0,2,2,12.0,91.0,7,0,2,2,12.0,82,5.24,53,338,2262,9.5
1267,Andrej Nedorost,2005-06,25.0,5,1,12,12,0,1,1,10.0,111.0,19,0,3,3,22.0,82,5.31,60,363,2326,9.4
1268,Andrej Nedorost,2006-07,26.0,6,2,9,9,2,0,2,16.0,117.0,28,2,3,5,38.0,82,5.14,57,348,2300,9.2
1269,Andrej Nestrasil,2017-18,26.0,4,20,54,54,7,13,20,82.0,721.0,54,7,13,20,82.0,82,5.32,47,251,2453,8.9
1270,Andrej Nestrasil,2018-19,27.0,5,23,55,55,9,14,23,105.0,789.0,109,16,27,43,187.0,82,5.34,48,255,2438,9.0
1271,Andrej Nestrasil,2019-20,28.0,6,5,19,19,1,4,5,27.0,207.0,128,17,31,48,214.0,82,5.45,47,245,2478,9.0
1272,Andrej Podkonicky,2003-04,25.0,4,1,6,6,1,0,1,5.0,36.0,6,1,0,1,5.0,82,5.51,63,376,2272,9.9
1273,Andrej Podkonicky,2006-07,28.0,5,0,2,2,0,0,0,1.0,7.0,8,1,0,1,6.0,82,5.14,57,348,2300,9.2
1274,Andrej Sekera,2009-10,23.0,4,0,2,2,0,0,0,0.0,15.0,2,0,0,0,0.0,82,5.76,70,398,2426,9.7
1275,Andrej Sekera,2010-11,24.0,5,8,37,37,2,6,8,28.0,726.0,39,2,6,8,28.0,82,5.44,62,351,2383,9.4
1276,Andrej Sekera,2011-12,25.0,6,19,69,69,3,16,19,84.0,1428.0,108,5,22,27,112.0,82,5.7,65,341,2477,9.4
1277,Andrej Sekera,2012-13,26.0,7,11,49,49,4,7,11,59.0,855.0,157,9,29,38,171.0,82,5.53,56,304,2486,9.1
1278,Andrej Sekera,2013-14,27.0,8,29,76,76,3,26,29,88.0,1603.0,233,12,55,67,259.0,82,5.46,52,291,2492,9.0
1279,Andrej Sekera,2014-15,28.0,9,13,69,69,3,10,13,88.0,1353.0,302,15,65,80,347.0,82,5.32,47,271,2439,8.9
1280,Andrej Sekera,2015-16,29.0,10,12,37,37,2,10,12,33.0,785.0,339,17,75,92,380.0,48,5.31,29,160,1399,9.1
1281,Andrej Sekera,2016-17,30.0,11,44,74,74,11,33,44,142.0,1752.0,413,28,108,136,522.0,82,5.34,48,269,2463,8.9
1282,Andrej Sekera,2017-18,31.0,12,23,73,73,3,20,23,100.0,1605.0,486,31,128,159,622.0,82,5.32,47,251,2453,8.9
1283,Andrej Sekera,2018-19,32.0,13,30,81,81,6,24,30,155.0,1769.0,567,37,152,189,777.0,82,5.34,48,255,2438,9.0
1284,Andrej Sekera,2019-20,33.0,14,35,80,80,8,27,35,128.0,1719.0,647,45,179,224,905.0,82,5.45,47,245,2478,9.0
1285,Andrej Sekera,2020-21,34.0,15,8,36,36,0,8,8,36.0,588.0,683,45,187,232,941.0,82,5.86,50,250,2620,9.2
1286,Andrej Sekera,2021-22,35.0,16,4,24,24,0,4,4,28.0,396.0,707,45,191,236,969.0,82,5.96,47,239,2579,9.5
1287,Andrej Sekera,2022-23,36.0,17,8,57,57,2,6,8,63.0,1026.0,764,47,197,244,1032.0,70,5.96,42,208,2192,9.5
1288,Andrej Sustr,2015-16,25.0,4,0,2,2,0,0,0,2.0,21.0,2,0,0,0,2.0,48,5.31,29,160,1399,9.1
1289,Andrej Sustr,2016-17,26.0,5,8,43,43,1,7,8,39.0,679.0,45,1,7,8,41.0,82,5.34,48,269,2463,8.9
1290,Andrej Sustr,2017-18,27.0,6,13,72,72,0,13,13,55.0,1275.0,117,1,20,21,96.0,82,5.32,47,251,2453,8.9
1291,Andrej Sustr,2018-19,28.0,7,21,77,77,4,17,21,65.0,1296.0,194,5,37,42,161.0,82,5.34,48,255,2438,9.0
1292,Andrej Sustr,2019-20,29.0,8,14,80,80,3,11,14,93.0,1407.0,274,8,48,56,254.0,82,5.45,47,245,2478,9.0
1293,Andrej Sustr,2020-21,30.0,9,7,44,44,2,5,7,45.0,565.0,318,10,53,63,299.0,82,5.86,50,250,2620,9.2
1294,Andrej Sustr,2021-22,31.0,10,0,5,5,0,0,0,6.0,60.0,323,10,53,63,305.0,82,5.96,47,239,2579,9.5
1295,Andrew Agozzino,2017-18,27.0,4,1,1,1,0,1,1,1.0,10.0,1,0,1,1,1.0,82,5.32,47,251,2453,8.9
1296,Andrew Agozzino,2018-19,28.0,5,2,9,9,0,2,2,3.0,77.0,10,0,3,3,4.0,82,5.34,48,255,2438,9.0
1297,Andrew Agozzino,2021-22,31.0,6,2,11,11,1,1,2,11.0,86.0,21,1,4,5,15.0,82,5.96,47,239,2579,9.5
1298,Andrew Agozzino,2022-23,32.0,7,3,22,22,1,2,3,10.0,162.0,43,2,6,8,25.0,70,5.96,42,208,2192,9.5
1299,Andrew Alberts,2008-09,27.0,4,7,73,73,1,6,7,30.0,936.0,73,1,6,7,30.0,82,6.05,85,480,2458,10.1
1300,Andrew Alberts,2009-10,28.0,5,10,76,76,0,10,10,41.0,1495.0,149,1,16,17,71.0,82,5.76,70,398,2426,9.7
1301,Andrew Alberts,2010-11,29.0,6,2,35,35,0,2,2,25.0,722.0,184,1,18,19,96.0,82,5.44,62,351,2383,9.4
1302,Andrew Alberts,2011-12,30.0,7,13,79,79,1,12,13,46.0,1248.0,263,2,30,32,142.0,82,5.7,65,341,2477,9.4
1303,Andrew Alberts,2012-13,31.0,8,12,76,76,3,9,12,50.0,1169.0,339,5,39,44,192.0,82,5.53,56,304,2486,9.1
1304,Andrew Alberts,2013-14,32.0,9,7,42,42,1,6,7,21.0,637.0,381,6,45,51,213.0,82,5.46,52,291,2492,9.0
1305,Andrew Alberts,2014-15,33.0,10,3,44,44,2,1,3,19.0,629.0,425,8,46,54,232.0,82,5.32,47,271,2439,8.9
1306,Andrew Alberts,2015-16,34.0,11,1,24,24,0,1,1,15.0,364.0,449,8,47,55,247.0,48,5.31,29,160,1399,9.1
1307,Andrew Alberts,2016-17,35.0,12,0,10,10,0,0,0,5.0,74.0,459,8,47,55,252.0,82,5.34,48,269,2463,8.9
1308,Andrew Bodnarchuk,2012-13,24.0,4,0,5,5,0,0,0,0.0,37.0,5,0,0,0,0.0,82,5.53,56,304,2486,9.1
1309,Andrew Bodnarchuk,2018-19,30.0,5,4,37,37,0,4,4,9.0,457.0,42,0,4,4,9.0,82,5.34,48,255,2438,9.0
1310,Andrew Brunette,1998-99,25.0,4,6,11,11,3,3,6,16.0,,11,3,3,6,16.0,82,6.29,74,413,2481,10.4
1311,Andrew Brunette,1999-00,26.0,5,11,23,23,4,7,11,23.0,,34,7,10,17,39.0,82,5.83,55,336,2444,9.8
1312,Andrew Brunette,2000-01,27.0,6,23,28,28,11,12,23,42.0,,62,18,22,40,81.0,82,5.28,57,380,2242,9.6
1313,Andrew Brunette,2001-02,28.0,7,31,77,77,11,20,31,65.0,1018.0,139,29,42,71,146.0,82,5.27,57,359,2285,9.4
1314,Andrew Brunette,2002-03,29.0,8,50,81,81,23,27,50,107.0,1272.0,220,52,69,121,253.0,82,5.49,53,331,2294,9.8
1315,Andrew Brunette,2003-04,30.0,9,59,77,77,15,44,59,104.0,1307.0,297,67,113,180,357.0,82,5.51,63,376,2272,9.9
1316,Andrew Brunette,2004-05,31.0,10,69,81,81,21,48,69,106.0,1299.0,378,88,161,249,463.0,82,5.24,53,338,2262,9.5
1317,Andrew Brunette,2005-06,32.0,11,46,82,82,18,28,46,97.0,1187.0,460,106,189,295,560.0,82,5.31,60,363,2326,9.4
1318,Andrew Brunette,2006-07,33.0,12,49,82,82,15,34,49,90.0,1273.0,542,121,223,344,650.0,82,5.14,57,348,2300,9.2
1319,Andrew Brunette,2008-09,35.0,13,63,82,82,24,39,63,129.0,1231.0,624,145,262,407,779.0,82,6.05,85,480,2458,10.1
1320,Andrew Brunette,2009-10,36.0,14,83,82,82,27,56,83,173.0,1436.0,706,172,318,490,952.0,82,5.76,70,398,2426,9.7
1321,Andrew Brunette,2010-11,37.0,15,59,82,82,19,40,59,125.0,1275.0,788,191,358,549,1077.0,82,5.44,62,351,2383,9.4
1322,Andrew Brunette,2011-12,38.0,16,50,80,80,22,28,50,118.0,1356.0,868,213,386,599,1195.0,82,5.7,65,341,2477,9.4
1323,Andrew Brunette,2012-13,39.0,17,61,82,82,25,36,61,129.0,1396.0,950,238,422,660,1324.0,82,5.53,56,304,2486,9.1
1324,Andrew Brunette,2013-14,40.0,18,46,82,82,18,28,46,117.0,1378.0,1032,256,450,706,1441.0,82,5.46,52,291,2492,9.0
1325,Andrew Brunette,2014-15,41.0,19,27,78,78,12,15,27,75.0,1057.0,1110,268,465,733,1516.0,82,5.32,47,271,2439,8.9
1326,Andrew Campbell,2016-17,28.0,4,0,3,3,0,0,0,4.0,38.0,3,0,0,0,4.0,82,5.34,48,269,2463,8.9
1327,Andrew Campbell,2017-18,29.0,5,1,33,33,0,1,1,28.0,579.0,36,0,1,1,32.0,82,5.32,47,251,2453,8.9
1328,Andrew Campbell,2018-19,30.0,6,1,6,6,0,1,1,1.0,70.0,42,0,2,2,33.0,82,5.34,48,255,2438,9.0
1329,Andrew Cassels,1992-93,23.0,4,2,6,6,2,0,2,5.0,,6,2,0,2,5.0,80,7.37,76,367,2421,12.2
1330,Andrew Cassels,1993-94,24.0,5,25,54,54,6,19,25,55.0,,60,8,19,27,60.0,80,6.91,71,366,2385,11.6
1331,Andrew Cassels,1994-95,25.0,6,41,67,67,11,30,41,99.0,,127,19,49,68,159.0,80,6.96,77,402,2440,11.4
1332,Andrew Cassels,1995-96,26.0,7,85,84,84,21,64,85,134.0,,211,40,113,153,293.0,84,7.25,87,443,2603,11.7
1333,Andrew Cassels,1996-97,27.0,8,58,79,79,16,42,58,126.0,,290,56,155,211,419.0,84,6.48,76,407,2545,10.7
1334,Andrew Cassels,1997-98,28.0,9,37,46,46,7,30,37,74.0,,336,63,185,248,493.0,48,5.97,37,209,1408,10.2
1335,Andrew Cassels,1998-99,29.0,10,63,81,81,20,43,63,135.0,,417,83,228,311,628.0,82,6.29,74,413,2481,10.4
1336,Andrew Cassels,1999-00,30.0,11,66,81,81,22,44,66,142.0,,498,105,272,377,770.0,82,5.83,55,336,2444,9.8
1337,Andrew Cassels,2000-01,31.0,12,44,81,81,17,27,44,138.0,,579,122,299,421,908.0,82,5.28,57,380,2242,9.6
1338,Andrew Cassels,2001-02,32.0,13,37,70,70,12,25,37,97.0,1328.0,649,134,324,458,1005.0,82,5.27,57,359,2285,9.4
1339,Andrew Cassels,2002-03,33.0,14,62,79,79,17,45,62,109.0,1526.0,728,151,369,520,1114.0,82,5.49,53,331,2294,9.8
1340,Andrew Cassels,2003-04,34.0,15,56,66,66,12,44,56,104.0,1278.0,794,163,413,576,1218.0,82,5.51,63,376,2272,9.9
1341,Andrew Cassels,2004-05,35.0,16,50,53,53,11,39,50,64.0,925.0,847,174,452,626,1282.0,82,5.24,53,338,2262,9.5
1342,Andrew Cassels,2005-06,36.0,17,68,79,79,20,48,68,113.0,1569.0,926,194,500,694,1395.0,82,5.31,60,363,2326,9.4
1343,Andrew Cassels,2006-07,37.0,18,26,58,58,6,20,26,91.0,1119.0,984,200,520,720,1486.0,82,5.14,57,348,2300,9.2
1344,Andrew Cassels,2008-09,39.0,19,12,31,31,4,8,12,29.0,410.0,1015,204,528,732,1515.0,82,6.05,85,480,2458,10.1
1345,Andrew Cogliano,2010-11,23.0,4,45,82,82,18,27,45,98.0,1120.0,82,18,27,45,98.0,82,5.44,62,351,2383,9.4
1346,Andrew Cogliano,2011-12,24.0,5,38,82,82,18,20,38,116.0,1181.0,164,36,47,83,214.0,82,5.7,65,341,2477,9.4
1347,Andrew Cogliano,2012-13,25.0,6,28,82,82,10,18,28,139.0,1162.0,246,46,65,111,353.0,82,5.53,56,304,2486,9.1
1348,Andrew Cogliano,2013-14,26.0,7,35,82,82,11,24,35,129.0,1415.0,328,57,89,146,482.0,82,5.46,52,291,2492,9.0
1349,Andrew Cogliano,2014-15,27.0,8,26,82,82,13,13,26,115.0,1206.0,410,70,102,172,597.0,82,5.32,47,271,2439,8.9
1350,Andrew Cogliano,2015-16,28.0,9,23,48,48,13,10,23,79.0,738.0,458,83,112,195,676.0,48,5.31,29,160,1399,9.1
1351,Andrew Cogliano,2016-17,29.0,10,42,82,82,21,21,42,157.0,1262.0,540,104,133,237,833.0,82,5.34,48,269,2463,8.9
1352,Andrew Cogliano,2017-18,30.0,11,29,82,82,15,14,29,134.0,1197.0,622,119,147,266,967.0,82,5.32,47,251,2453,8.9
1353,Andrew Cogliano,2018-19,31.0,12,32,82,82,9,23,32,131.0,1183.0,704,128,170,298,1098.0,82,5.34,48,255,2438,9.0
1354,Andrew Cogliano,2019-20,32.0,13,35,82,82,16,19,35,178.0,1241.0,786,144,189,333,1276.0,82,5.45,47,245,2478,9.0
1355,Andrew Cogliano,2020-21,33.0,14,35,80,80,12,23,35,175.0,1216.0,866,156,212,368,1451.0,82,5.86,50,250,2620,9.2
1356,Andrew Cogliano,2021-22,34.0,15,17,78,78,6,11,17,106.0,982.0,944,162,223,385,1557.0,82,5.96,47,239,2579,9.5
1357,Andrew Cogliano,2022-23,35.0,16,14,68,68,3,11,14,68.0,848.0,1012,165,234,399,1625.0,70,5.96,42,208,2192,9.5
1358,Andrew Copp,2017-18,23.0,4,1,1,1,0,1,1,4.0,13.0,1,0,1,1,4.0,82,5.32,47,251,2453,8.9
1359,Andrew Copp,2018-19,24.0,5,13,77,77,7,6,13,54.0,616.0,78,7,7,14,58.0,82,5.34,48,255,2438,9.0
1360,Andrew Copp,2019-20,25.0,6,17,64,64,9,8,17,77.0,790.0,142,16,15,31,135.0,82,5.45,47,245,2478,9.0
1361,Andrew Copp,2020-21,26.0,7,28,82,82,9,19,28,96.0,1126.0,224,25,34,59,231.0,82,5.86,50,250,2620,9.2
1362,Andrew Copp,2021-22,27.0,8,25,69,69,11,14,25,82.0,839.0,293,36,48,84,313.0,82,5.96,47,239,2579,9.5
1363,Andrew Copp,2022-23,28.0,9,26,63,63,10,16,26,121.0,1115.0,356,46,64,110,434.0,70,5.96,42,208,2192,9.5
1364,Andrew Crescenzi,2020-21,28.0,4,0,2,2,0,0,0,0.0,16.0,2,0,0,0,0.0,82,5.86,50,250,2620,9.2
1365,Andrew Desjardins,2013-14,27.0,4,3,17,17,1,2,3,12.0,121.0,17,1,2,3,12.0,82,5.46,52,291,2492,9.0
1366,Andrew Desjardins,2014-15,28.0,5,17,76,76,4,13,17,80.0,728.0,93,5,15,20,92.0,82,5.32,47,271,2439,8.9
1367,Andrew Desjardins,2015-16,29.0,6,3,42,42,2,1,3,51.0,425.0,135,7,16,23,143.0,48,5.31,29,160,1399,9.1
1368,Andrew Desjardins,2016-17,30.0,7,17,81,81,3,14,17,95.0,903.0,216,10,30,40,238.0,82,5.34,48,269,2463,8.9
1369,Andrew Desjardins,2017-18,31.0,8,10,69,69,5,5,10,59.0,741.0,285,15,35,50,297.0,82,5.32,47,251,2453,8.9
1370,Andrew Desjardins,2018-19,32.0,9,13,77,77,8,5,13,96.0,1030.0,362,23,40,63,393.0,82,5.34,48,255,2438,9.0
1371,Andrew Desjardins,2019-20,33.0,10,1,46,46,0,1,1,46.0,432.0,408,23,41,64,439.0,82,5.45,47,245,2478,9.0
1372,Andrew Ebbett,2010-11,28.0,4,0,3,3,0,0,0,3.0,40.0,3,0,0,0,3.0,82,5.44,62,351,2383,9.4
1373,Andrew Ebbett,2011-12,29.0,5,32,48,48,8,24,32,100.0,666.0,51,8,24,32,103.0,82,5.7,65,341,2477,9.4
1374,Andrew Ebbett,2012-13,30.0,6,15,61,61,9,6,15,72.0,775.0,112,17,30,47,175.0,82,5.53,56,304,2486,9.1
1375,Andrew Ebbett,2013-14,31.0,7,5,33,33,2,3,5,23.0,331.0,145,19,33,52,198.0,82,5.46,52,291,2492,9.0
1376,Andrew Ebbett,2014-15,32.0,8,6,18,18,5,1,6,27.0,173.0,163,24,34,58,225.0,82,5.32,47,271,2439,8.9
1377,Andrew Ebbett,2015-16,33.0,9,6,28,28,1,5,6,23.0,345.0,191,25,39,64,248.0,48,5.31,29,160,1399,9.1
1378,Andrew Ebbett,2016-17,34.0,10,1,9,9,0,1,1,9.0,99.0,200,25,40,65,257.0,82,5.34,48,269,2463,8.9
1379,Andrew Ebbett,2017-18,35.0,11,6,24,24,1,5,6,21.0,216.0,224,26,45,71,278.0,82,5.32,47,251,2453,8.9
1380,Andrew Ference,2002-03,23.0,4,6,30,30,2,4,6,26.0,490.0,30,2,4,6,26.0,82,5.49,53,331,2294,9.8
1381,Andrew Ference,2003-04,24.0,5,15,36,36,4,11,15,47.0,679.0,66,6,15,21,73.0,82,5.51,63,376,2272,9.9
1382,Andrew Ference,2004-05,25.0,6,11,75,75,4,7,11,82.0,1392.0,141,10,22,32,155.0,82,5.24,53,338,2262,9.5
1383,Andrew Ference,2005-06,26.0,7,8,38,38,1,7,8,39.0,712.0,179,11,29,40,194.0,82,5.31,60,363,2326,9.4
1384,Andrew Ference,2006-07,27.0,8,16,72,72,4,12,16,86.0,1344.0,251,15,41,56,280.0,82,5.14,57,348,2300,9.2
1385,Andrew Ference,2008-09,29.0,9,31,82,82,4,27,31,111.0,1652.0,333,19,68,87,391.0,82,6.05,85,480,2458,10.1
1386,Andrew Ference,2009-10,30.0,10,15,80,80,3,12,15,80.0,1580.0,413,22,80,102,471.0,82,5.76,70,398,2426,9.7
1387,Andrew Ference,2010-11,31.0,11,15,59,59,1,14,15,71.0,1312.0,472,23,94,117,542.0,82,5.44,62,351,2383,9.4
1388,Andrew Ference,2011-12,32.0,12,16,47,47,1,15,16,72.0,1012.0,519,24,109,133,614.0,82,5.7,65,341,2477,9.4
1389,Andrew Ference,2012-13,33.0,13,8,51,51,0,8,8,60.0,1005.0,570,24,117,141,674.0,82,5.53,56,304,2486,9.1
1390,Andrew Ference,2013-14,34.0,14,15,70,70,3,12,15,78.0,1259.0,640,27,129,156,752.0,82,5.46,52,291,2492,9.0
1391,Andrew Ference,2014-15,35.0,15,24,72,72,6,18,24,107.0,1360.0,712,33,147,180,859.0,82,5.32,47,271,2439,8.9
1392,Andrew Ference,2015-16,36.0,16,13,48,48,4,9,13,66.0,936.0,760,37,156,193,925.0,48,5.31,29,160,1399,9.1
1393,Andrew Ference,2016-17,37.0,17,18,71,71,3,15,18,77.0,1495.0,831,40,171,211,1002.0,82,5.34,48,269,2463,8.9
1394,Andrew Ference,2017-18,38.0,18,14,70,70,3,11,14,58.0,1321.0,901,43,182,225,1060.0,82,5.32,47,251,2453,8.9
1395,Andrew Ference,2018-19,39.0,19,0,6,6,0,0,0,4.0,78.0,907,43,182,225,1064.0,82,5.34,48,255,2438,9.0
1396,Andrew Gordon,2011-12,26.0,4,0,1,1,0,0,0,1.0,7.0,1,0,0,0,1.0,82,5.7,65,341,2477,9.4
1397,Andrew Gordon,2012-13,27.0,5,0,2,2,0,0,0,0.0,13.0,3,0,0,0,1.0,82,5.53,56,304,2486,9.1
1398,Andrew Gordon,2013-14,28.0,6,2,9,9,1,1,2,5.0,78.0,12,1,1,2,6.0,82,5.46,52,291,2492,9.0
1399,Andrew Gordon,2014-15,29.0,7,5,37,37,2,3,5,38.0,402.0,49,3,4,7,44.0,82,5.32,47,271,2439,8.9
1400,Andrew Gordon,2015-16,30.0,8,0,6,6,0,0,0,2.0,51.0,55,3,4,7,46.0,48,5.31,29,160,1399,9.1
1401,Andrew Hutchinson,2006-07,26.0,4,8,18,18,4,4,8,24.0,301.0,18,4,4,8,24.0,82,5.14,57,348,2300,9.2
1402,Andrew Hutchinson,2008-09,28.0,5,11,36,36,3,8,11,33.0,373.0,54,7,12,19,57.0,82,6.05,85,480,2458,10.1
1403,Andrew Hutchinson,2009-10,29.0,6,14,41,41,3,11,14,45.0,501.0,95,10,23,33,102.0,82,5.76,70,398,2426,9.7
1404,Andrew Hutchinson,2011-12,31.0,7,5,40,40,2,3,5,58.0,574.0,135,12,26,38,160.0,82,5.7,65,341,2477,9.4
1405,Andrew Hutchinson,2013-14,33.0,8,1,5,5,0,1,1,2.0,77.0,140,12,27,39,162.0,82,5.46,52,291,2492,9.0
1406,Andrew Joudrey,2014-15,30.0,4,0,1,1,0,0,0,1.0,9.0,1,0,0,0,1.0,82,5.32,47,271,2439,8.9
1407,Andrew Ladd,2008-09,23.0,4,11,29,29,6,5,11,43.0,324.0,29,6,5,11,43.0,82,6.05,85,480,2458,10.1
1408,Andrew Ladd,2009-10,24.0,5,21,65,65,11,10,21,109.0,728.0,94,17,15,32,152.0,82,5.76,70,398,2426,9.7
1409,Andrew Ladd,2010-11,25.0,6,30,63,63,14,16,30,131.0,804.0,157,31,31,62,283.0,82,5.44,62,351,2383,9.4
1410,Andrew Ladd,2011-12,26.0,7,49,82,82,15,34,49,195.0,1180.0,239,46,65,111,478.0,82,5.7,65,341,2477,9.4
1411,Andrew Ladd,2012-13,27.0,8,38,82,82,17,21,38,148.0,1123.0,321,63,86,149,626.0,82,5.53,56,304,2486,9.1
1412,Andrew Ladd,2013-14,28.0,9,59,81,81,29,30,59,195.0,1626.0,402,92,116,208,821.0,82,5.46,52,291,2492,9.0
1413,Andrew Ladd,2014-15,29.0,10,50,82,82,28,22,50,265.0,1604.0,484,120,138,258,1086.0,82,5.32,47,271,2439,8.9
1414,Andrew Ladd,2015-16,30.0,11,46,48,48,18,28,46,121.0,945.0,532,138,166,304,1207.0,48,5.31,29,160,1399,9.1
1415,Andrew Ladd,2016-17,31.0,12,54,78,78,23,31,54,189.0,1539.0,610,161,197,358,1396.0,82,5.34,48,269,2463,8.9
1416,Andrew Ladd,2017-18,32.0,13,62,81,81,24,38,62,224.0,1626.0,691,185,235,420,1620.0,82,5.32,47,251,2453,8.9
1417,Andrew Ladd,2018-19,33.0,14,46,78,78,25,21,46,181.0,1475.0,769,210,256,466,1801.0,82,5.34,48,255,2438,9.0
1418,Andrew Ladd,2019-20,34.0,15,31,78,78,23,8,31,142.0,1262.0,847,233,264,497,1943.0,82,5.45,47,245,2478,9.0
1419,Andrew Ladd,2020-21,35.0,16,29,73,73,12,17,29,112.0,1160.0,920,245,281,526,2055.0,82,5.86,50,250,2620,9.2
1420,Andrew Ladd,2021-22,36.0,17,11,26,26,3,8,11,34.0,360.0,946,248,289,537,2089.0,82,5.96,47,239,2579,9.5
1421,Andrew Ladd,2022-23,37.0,18,1,4,4,1,0,1,5.0,48.0,950,249,289,538,2094.0,70,5.96,42,208,2192,9.5
1422,Andrew MacDonald,2011-12,25.0,4,0,3,3,0,0,0,1.0,31.0,3,0,0,0,1.0,82,5.7,65,341,2477,9.4
1423,Andrew MacDonald,2012-13,26.0,5,7,46,46,1,6,7,43.0,924.0,49,1,6,7,44.0,82,5.53,56,304,2486,9.1
1424,Andrew MacDonald,2013-14,27.0,6,27,60,60,4,23,27,72.0,1405.0,109,5,29,34,116.0,82,5.46,52,291,2492,9.0
1425,Andrew MacDonald,2014-15,28.0,7,19,75,75,5,14,19,71.0,1753.0,184,10,43,53,187.0,82,5.32,47,271,2439,8.9
1426,Andrew MacDonald,2015-16,29.0,8,12,48,48,3,9,12,45.0,1129.0,232,13,52,65,232.0,48,5.31,29,160,1399,9.1
1427,Andrew MacDonald,2016-17,30.0,9,28,82,82,4,24,28,92.0,2020.0,314,17,76,93,324.0,82,5.34,48,269,2463,8.9
1428,Andrew MacDonald,2017-18,31.0,10,12,58,58,2,10,12,62.0,1161.0,372,19,86,105,386.0,82,5.32,47,251,2453,8.9
1429,Andrew MacDonald,2018-19,32.0,11,8,28,28,1,7,8,20.0,563.0,400,20,93,113,406.0,82,5.34,48,255,2438,9.0
1430,Andrew MacDonald,2019-20,33.0,12,18,73,73,2,16,18,65.0,1468.0,473,22,109,131,471.0,82,5.45,47,245,2478,9.0
1431,Andrew MacDonald,2020-21,34.0,13,21,66,66,6,15,21,82.0,1310.0,539,28,124,152,553.0,82,5.86,50,250,2620,9.2
1432,Andrew MacDonald,2021-22,35.0,14,9,47,47,0,9,9,41.0,771.0,586,28,133,161,594.0,82,5.96,47,239,2579,9.5
1433,Andrew MacWilliam,2017-18,27.0,4,2,12,12,0,2,2,5.0,185.0,12,0,2,2,5.0,82,5.32,47,251,2453,8.9
1434,Andrew Mangiapane,2020-21,24.0,4,0,10,10,0,0,0,7.0,89.0,10,0,0,0,7.0,82,5.86,50,250,2620,9.2
1435,Andrew Mangiapane,2021-22,25.0,5,13,44,44,8,5,13,65.0,464.0,54,8,5,13,72.0,82,5.96,47,239,2579,9.5
1436,Andrew Mangiapane,2022-23,26.0,6,32,68,68,17,15,32,109.0,932.0,122,25,20,45,181.0,70,5.96,42,208,2192,9.5
1437,Andrew McBain,1986-87,22.0,4,30,78,78,11,19,30,93.0,,78,11,19,30,93.0,80,7.89,74,336,2448,12.9
1438,Andrew McBain,1987-88,23.0,5,22,77,77,7,15,22,64.0,,155,18,34,52,157.0,80,7.77,71,321,2447,12.7
1439,Andrew McBain,1988-89,24.0,6,6,28,28,3,3,6,24.0,,183,21,37,58,181.0,80,7.94,82,370,2484,12.8
1440,Andrew McBain,1989-90,25.0,7,32,71,71,11,21,32,85.0,,254,32,58,90,266.0,80,7.34,72,344,2400,12.2
1441,Andrew McBain,1990-91,26.0,8,63,74,74,32,31,63,146.0,,328,64,89,153,412.0,80,7.43,89,437,2435,12.2
1442,Andrew McBain,1991-92,27.0,9,77,80,80,37,40,77,180.0,,408,101,129,230,592.0,80,7.48,85,403,2430,12.3
1443,Andrew McBain,1992-93,28.0,10,23,67,67,9,14,23,106.0,,475,110,143,253,698.0,80,7.37,76,367,2421,12.2
1444,Andrew McBain,1993-94,29.0,11,5,13,13,0,5,5,8.0,,488,110,148,258,706.0,80,6.91,71,366,2385,11.6
1445,Andrew McBain,1994-95,30.0,12,1,6,6,1,0,1,11.0,,494,111,148,259,717.0,80,6.96,77,402,2440,11.4
1446,Andrew McBain,1995-96,31.0,13,23,59,59,7,16,23,71.0,,553,118,164,282,788.0,84,7.25,87,443,2603,11.7
1447,Andrew McBain,1996-97,32.0,14,19,55,55,11,8,19,91.0,,608,129,172,301,879.0,84,6.48,76,407,2545,10.7
1448,Andrew McKim,1995-96,25.0,4,4,7,7,1,3,4,12.0,,7,1,3,4,12.0,84,7.25,87,443,2603,11.7
1449,Andrew McKim,1996-97,26.0,5,1,29,29,0,1,1,22.0,,36,1,4,5,34.0,84,6.48,76,407,2545,10.7
1450,Andrew McKim,1997-98,27.0,6,0,2,2,0,0,0,0.0,,38,1,4,5,34.0,48,5.97,37,209,1408,10.2
1451,Andrew Miller,2017-18,29.0,4,6,9,9,1,5,6,14.0,124.0,9,1,5,6,14.0,82,5.32,47,251,2453,8.9
1452,Andrew Miller,2018-19,30.0,5,0,6,6,0,0,0,3.0,55.0,15,1,5,6,17.0,82,5.34,48,255,2438,9.0
1453,Andrew Murray,2010-11,29.0,4,10,39,39,6,4,10,45.0,457.0,39,6,4,10,45.0,82,5.44,62,351,2383,9.4
1454,Andrew Murray,2011-12,30.0,5,11,67,67,8,3,11,89.0,755.0,106,14,7,21,134.0,82,5.7,65,341,2477,9.4
1455,Andrew Murray,2012-13,31.0,6,7,46,46,5,2,7,73.0,477.0,152,19,9,28,207.0,82,5.53,56,304,2486,9.1
1456,Andrew Murray,2013-14,32.0,7,8,29,29,4,4,8,48.0,330.0,181,23,13,36,255.0,82,5.46,52,291,2492,9.0
1457,Andrew Murray,2014-15,33.0,8,4,39,39,1,3,4,33.0,300.0,220,24,16,40,288.0,82,5.32,47,271,2439,8.9
1458,Andrew Murray,2015-16,34.0,9,0,1,1,0,0,0,2.0,8.0,221,24,16,40,290.0,48,5.31,29,160,1399,9.1
1459,Andrew Peeke,2022-23,24.0,4,3,22,22,1,2,3,23.0,305.0,22,1,2,3,23.0,70,5.96,42,208,2192,9.5
1460,Andrew Peters,2006-07,26.0,4,2,42,42,2,0,2,19.0,175.0,42,2,0,2,19.0,82,5.14,57,348,2300,9.2
1461,Andrew Peters,2008-09,28.0,5,0,28,28,0,0,0,6.0,91.0,70,2,0,2,25.0,82,6.05,85,480,2458,10.1
1462,Andrew Peters,2009-10,29.0,6,2,58,58,1,1,2,19.0,219.0,128,3,1,4,44.0,82,5.76,70,398,2426,9.7
1463,Andrew Peters,2010-11,30.0,7,2,44,44,1,1,2,18.0,138.0,172,4,2,6,62.0,82,5.44,62,351,2383,9.4
1464,Andrew Peters,2011-12,31.0,8,1,28,28,0,1,1,10.0,113.0,200,4,3,7,72.0,82,5.7,65,341,2477,9.4
1465,Andrew Peters,2012-13,32.0,9,0,29,29,0,0,0,15.0,151.0,229,4,3,7,87.0,82,5.53,56,304,2486,9.1
1466,Andrew Poturalski,2019-20,26.0,4,0,2,2,0,0,0,1.0,25.0,2,0,0,0,1.0,82,5.45,47,245,2478,9.0
1467,Andrew Shaw,2014-15,23.0,4,23,37,37,12,11,23,74.0,563.0,37,12,11,23,74.0,82,5.32,47,271,2439,8.9
1468,Andrew Shaw,2015-16,24.0,5,15,48,48,9,6,15,64.0,722.0,85,21,17,38,138.0,48,5.31,29,160,1399,9.1
1469,Andrew Shaw,2016-17,25.0,6,39,80,80,20,19,39,149.0,1255.0,165,41,36,77,287.0,82,5.34,48,269,2463,8.9
1470,Andrew Shaw,2017-18,26.0,7,26,79,79,15,11,26,146.0,1181.0,244,56,47,103,433.0,82,5.32,47,251,2453,8.9
1471,Andrew Shaw,2018-19,27.0,8,34,78,78,14,20,34,153.0,1143.0,322,70,67,137,586.0,82,5.34,48,255,2438,9.0
1472,Andrew Shaw,2019-20,28.0,9,29,68,68,12,17,29,127.0,1034.0,390,82,84,166,713.0,82,5.45,47,245,2478,9.0
1473,Andrew Shaw,2020-21,29.0,10,20,51,51,10,10,20,94.0,806.0,441,92,94,186,807.0,82,5.86,50,250,2620,9.2
1474,Andrew Shaw,2021-22,30.0,11,47,63,63,19,28,47,135.0,1003.0,504,111,122,233,942.0,82,5.96,47,239,2579,9.5
1475,Andrew Shaw,2022-23,31.0,12,10,26,26,3,7,10,46.0,376.0,530,114,129,243,988.0,70,5.96,42,208,2192,9.5
1476,Andrey Pedan,2018-19,25.0,4,0,13,13,0,0,0,11.0,142.0,13,0,0,0,11.0,82,5.34,48,255,2438,9.0
1477,Andy Andreoff,2017-18,26.0,4,3,18,18,2,1,3,14.0,154.0,18,2,1,3,14.0,82,5.32,47,251,2453,8.9
1478,Andy Andreoff,2018-19,27.0,5,10,60,60,8,2,10,46.0,528.0,78,10,3,13,60.0,82,5.34,48,255,2438,9.0
1479,Andy Andreoff,2019-20,28.0,6,2,36,36,0,2,2,38.0,381.0,114,10,5,15,98.0,82,5.45,47,245,2478,9.0
1480,Andy Andreoff,2020-21,29.0,7,9,45,45,3,6,9,47.0,423.0,159,13,11,24,145.0,82,5.86,50,250,2620,9.2
1481,Andy Andreoff,2022-23,31.0,8,1,14,14,0,1,1,14.0,119.0,173,13,12,25,159.0,70,5.96,42,208,2192,9.5
1482,Andy Brickley,1985-86,24.0,4,2,3,3,1,1,2,7.0,,3,1,1,2,7.0,80,7.73,71,310,2444,12.7
1483,Andy Brickley,1986-87,25.0,5,38,50,50,18,20,38,75.0,,53,19,21,40,82.0,80,7.89,74,336,2448,12.9
1484,Andy Brickley,1987-88,26.0,6,22,45,45,7,15,22,58.0,,98,26,36,62,140.0,80,7.77,71,321,2447,12.7
1485,Andy Brickley,1989-90,28.0,7,23,51,51,11,12,23,55.0,,149,37,48,85,195.0,80,7.34,72,344,2400,12.2
1486,Andy Brickley,1990-91,29.0,8,22,45,45,8,14,22,61.0,,194,45,62,107,256.0,80,7.43,89,437,2435,12.2
1487,Andy Brickley,1991-92,30.0,9,35,71,71,13,22,35,98.0,,265,58,84,142,354.0,80,7.48,85,403,2430,12.3
1488,Andy Brickley,1992-93,31.0,10,40,43,43,12,28,40,69.0,,308,70,112,182,423.0,80,7.37,76,367,2421,12.2
1489,Andy Brickley,1993-94,32.0,11,11,40,40,2,9,11,28.0,,348,72,121,193,451.0,80,6.91,71,366,2385,11.6
1490,Andy Brickley,1994-95,33.0,12,27,23,23,10,17,27,28.0,,371,82,138,220,479.0,80,6.96,77,402,2440,11.4
1491,Andy Brickley,1995-96,34.0,13,2,12,12,0,2,2,5.0,,383,82,140,222,484.0,84,7.25,87,443,2603,11.7
1492,Andy Brickley,1996-97,35.0,14,0,2,2,0,0,0,0.0,,385,82,140,222,484.0,84,6.48,76,407,2545,10.7
1493,Andy Delmore,2001-02,25.0,4,1,2,2,0,1,1,2.0,41.0,2,0,1,1,2.0,82,5.27,57,359,2285,9.4
1494,Andy Delmore,2002-03,26.0,5,7,27,27,2,5,7,55.0,467.0,29,2,6,8,57.0,82,5.49,53,331,2294,9.8
1495,Andy Delmore,2003-04,27.0,6,14,66,66,5,9,14,119.0,1164.0,95,7,15,22,176.0,82,5.51,63,376,2272,9.9
1496,Andy Delmore,2004-05,28.0,7,38,73,73,16,22,38,175.0,1436.0,168,23,37,60,351.0,82,5.24,53,338,2262,9.5
1497,Andy Delmore,2005-06,29.0,8,34,71,71,18,16,34,149.0,1213.0,239,41,53,94,500.0,82,5.31,60,363,2326,9.4
1498,Andy Delmore,2006-07,30.0,9,7,37,37,2,5,7,40.0,562.0,276,43,58,101,540.0,82,5.14,57,348,2300,9.2
1499,Andy Delmore,2008-09,32.0,10,0,7,7,0,0,0,7.0,108.0,283,43,58,101,547.0,82,6.05,85,480,2458,10.1
1500,Andy Greene,2009-10,27.0,4,6,23,23,1,5,6,23.0,328.0,23,1,5,6,23.0,82,5.76,70,398,2426,9.7
1501,Andy Greene,2010-11,28.0,5,10,59,59,2,8,10,50.0,1151.0,82,3,13,16,73.0,82,5.44,62,351,2383,9.4
1502,Andy Greene,2011-12,29.0,6,9,49,49,2,7,9,38.0,798.0,131,5,20,25,111.0,82,5.7,65,341,2477,9.4
1503,Andy Greene,2012-13,30.0,7,37,78,78,6,31,37,86.0,1836.0,209,11,51,62,197.0,82,5.53,56,304,2486,9.1
1504,Andy Greene,2013-14,31.0,8,23,82,82,4,19,23,91.0,1834.0,291,15,70,85,288.0,82,5.46,52,291,2492,9.0
1505,Andy Greene,2014-15,32.0,9,16,56,56,1,15,16,53.0,1092.0,347,16,85,101,341.0,82,5.32,47,271,2439,8.9
1506,Andy Greene,2015-16,33.0,10,16,48,48,4,12,16,63.0,1106.0,395,20,97,117,404.0,48,5.31,29,160,1399,9.1
1507,Andy Greene,2016-17,34.0,11,32,82,82,8,24,32,134.0,2015.0,477,28,121,149,538.0,82,5.34,48,269,2463,8.9
1508,Andy Greene,2017-18,35.0,12,22,82,82,3,19,22,83.0,1931.0,559,31,140,171,621.0,82,5.32,47,251,2453,8.9
1509,Andy Greene,2018-19,36.0,13,13,82,82,4,9,13,63.0,1882.0,641,35,149,184,684.0,82,5.34,48,255,2438,9.0
1510,Andy Greene,2019-20,37.0,14,13,66,66,4,9,13,83.0,1448.0,707,39,158,197,767.0,82,5.45,47,245,2478,9.0
1511,Andy Greene,2020-21,38.0,15,13,81,81,3,10,13,93.0,1711.0,788,42,168,210,860.0,82,5.86,50,250,2620,9.2
1512,Andy Greene,2021-22,39.0,16,25,82,82,5,20,25,104.0,1708.0,870,47,188,235,964.0,82,5.96,47,239,2579,9.5
1513,Andy Greene,2022-23,40.0,17,14,63,63,2,12,14,60.0,1231.0,933,49,200,249,1024.0,70,5.96,42,208,2192,9.5
1514,Andy Hilbert,2004-05,23.0,4,1,6,6,1,0,1,11.0,69.0,6,1,0,1,11.0,82,5.24,53,338,2262,9.5
1515,Andy Hilbert,2005-06,24.0,5,3,14,14,0,3,3,22.0,161.0,20,1,3,4,33.0,82,5.31,60,363,2326,9.4
1516,Andy Hilbert,2006-07,25.0,6,2,18,18,2,0,2,27.0,161.0,38,3,3,6,60.0,82,5.14,57,348,2300,9.2
1517,Andy Hilbert,2008-09,27.0,7,27,47,47,12,15,27,101.0,614.0,85,15,18,33,161.0,82,6.05,85,480,2458,10.1
1518,Andy Hilbert,2009-10,28.0,8,28,81,81,8,20,28,164.0,931.0,166,23,38,61,325.0,82,5.76,70,398,2426,9.7
1519,Andy Hilbert,2010-11,29.0,9,16,70,70,8,8,16,127.0,943.0,236,31,46,77,452.0,82,5.44,62,351,2383,9.4
1520,Andy Hilbert,2011-12,30.0,10,27,67,67,11,16,27,167.0,1082.0,303,42,62,104,619.0,82,5.7,65,341,2477,9.4
1521,Andy Hilbert,2012-13,31.0,11,0,4,4,0,0,0,6.0,39.0,307,42,62,104,625.0,82,5.53,56,304,2486,9.1
1522,Andy McDonald,2003-04,26.0,4,1,16,16,1,0,1,21.0,179.0,16,1,0,1,21.0,82,5.51,63,376,2272,9.9
1523,Andy McDonald,2004-05,27.0,5,28,53,53,7,21,28,79.0,847.0,69,8,21,29,100.0,82,5.24,53,338,2262,9.5
1524,Andy McDonald,2005-06,28.0,6,21,46,46,10,11,21,92.0,852.0,115,18,32,50,192.0,82,5.31,60,363,2326,9.4
1525,Andy McDonald,2006-07,29.0,7,30,79,79,9,21,30,162.0,1308.0,194,27,53,80,354.0,82,5.14,57,348,2300,9.2
1526,Andy McDonald,2008-09,31.0,8,85,82,82,34,51,85,229.0,1378.0,276,61,104,165,583.0,82,6.05,85,480,2458,10.1
1527,Andy McDonald,2009-10,32.0,9,78,82,82,27,51,78,252.0,1442.0,358,88,155,243,835.0,82,5.76,70,398,2426,9.7
1528,Andy McDonald,2010-11,33.0,10,52,82,82,18,34,52,182.0,1465.0,440,106,189,295,1017.0,82,5.44,62,351,2383,9.4
1529,Andy McDonald,2011-12,34.0,11,44,46,46,15,29,44,128.0,877.0,486,121,218,339,1145.0,82,5.7,65,341,2477,9.4
1530,Andy McDonald,2012-13,35.0,12,57,79,79,24,33,57,191.0,1432.0,565,145,251,396,1336.0,82,5.53,56,304,2486,9.1
1531,Andy McDonald,2013-14,36.0,13,50,58,58,20,30,50,180.0,1162.0,623,165,281,446,1516.0,82,5.46,52,291,2492,9.0
1532,Andy McDonald,2014-15,37.0,14,22,25,25,10,12,22,64.0,463.0,648,175,293,468,1580.0,82,5.32,47,271,2439,8.9
1533,Andy McDonald,2015-16,38.0,15,21,37,37,7,14,21,86.0,638.0,685,182,307,489,1666.0,48,5.31,29,160,1399,9.1
1534,Andy Miele,2014-15,26.0,4,0,7,7,0,0,0,4.0,63.0,7,0,0,0,4.0,82,5.32,47,271,2439,8.9
1535,Andy Miele,2015-16,27.0,5,0,1,1,0,0,0,0.0,9.0,8,0,0,0,4.0,48,5.31,29,160,1399,9.1
1536,Andy Miele,2016-17,28.0,6,2,7,7,0,2,2,6.0,65.0,15,0,2,2,10.0,82,5.34,48,269,2463,8.9
1537,Andy Roach,2008-09,35.0,4,3,5,5,1,2,3,2.0,72.0,5,1,2,3,2.0,82,6.05,85,480,2458,10.1
1538,Andy Rymsha,1994-95,26.0,4,0,6,6,0,0,0,4.0,,6,0,0,0,4.0,80,6.96,77,402,2440,11.4
1539,Andy Schliebener,1984-85,22.0,4,1,22,22,0,1,1,19.0,,22,0,1,1,19.0,80,8.03,73,320,2489,12.9
1540,Andy Schliebener,1986-87,24.0,5,12,51,51,2,10,12,62.0,,73,2,11,13,81.0,80,7.89,74,336,2448,12.9
1541,Andy Schliebener,1987-88,25.0,6,0,11,11,0,0,0,6.0,,84,2,11,13,87.0,80,7.77,71,321,2447,12.7
1542,Andy Schneider,1996-97,24.0,4,0,10,10,0,0,0,4.0,,10,0,0,0,4.0,84,6.48,76,407,2545,10.7
1543,Andy Sutton,2001-02,26.0,4,3,31,31,0,3,3,24.0,402.0,31,0,3,3,24.0,82,5.27,57,359,2285,9.4
1544,Andy Sutton,2002-03,27.0,5,2,40,40,1,1,2,29.0,518.0,71,1,4,5,53.0,82,5.49,53,331,2294,9.8
1545,Andy Sutton,2003-04,28.0,6,7,69,69,3,4,7,64.0,891.0,140,4,8,12,117.0,82,5.51,63,376,2272,9.9
1546,Andy Sutton,2004-05,29.0,7,10,43,43,2,8,10,41.0,578.0,183,6,16,22,158.0,82,5.24,53,338,2262,9.5
1547,Andy Sutton,2005-06,30.0,8,21,53,53,3,18,21,65.0,954.0,236,9,34,43,223.0,82,5.31,60,363,2326,9.4
1548,Andy Sutton,2006-07,31.0,9,21,65,65,8,13,21,102.0,1517.0,301,17,47,64,325.0,82,5.14,57,348,2300,9.2
1549,Andy Sutton,2008-09,33.0,10,25,76,76,8,17,25,86.0,1602.0,377,25,64,89,411.0,82,6.05,85,480,2458,10.1
1550,Andy Sutton,2009-10,34.0,11,16,55,55,2,14,16,51.0,1070.0,432,27,78,105,462.0,82,5.76,70,398,2426,9.7
1551,Andy Sutton,2010-11,35.0,12,8,58,58,1,7,8,57.0,1053.0,490,28,85,113,519.0,82,5.44,62,351,2383,9.4
1552,Andy Sutton,2011-12,36.0,13,10,23,23,2,8,10,19.0,465.0,513,30,93,123,538.0,82,5.7,65,341,2477,9.4
1553,Andy Sutton,2012-13,37.0,14,13,72,72,5,8,13,77.0,1470.0,585,35,101,136,615.0,82,5.53,56,304,2486,9.1
1554,Andy Sutton,2013-14,38.0,15,4,39,39,0,4,4,31.0,575.0,624,35,105,140,646.0,82,5.46,52,291,2492,9.0
1555,Andy Sutton,2014-15,39.0,16,10,52,52,3,7,10,41.0,868.0,676,38,112,150,687.0,82,5.32,47,271,2439,8.9
1556,Andy Welinski,2020-21,27.0,4,2,7,7,0,2,2,6.0,113.0,7,0,2,2,6.0,82,5.86,50,250,2620,9.2
1557,Andy Welinski,2021-22,28.0,5,4,26,26,1,3,4,32.0,417.0,33,1,5,6,38.0,82,5.96,47,239,2579,9.5
1558,Andy Wozniewski,2008-09,28.0,4,1,13,13,0,1,1,6.0,233.0,13,0,1,1,6.0,82,6.05,85,480,2458,10.1
1559,Andy Wozniewski,2009-10,29.0,5,2,15,15,0,2,2,10.0,209.0,28,0,3,3,16.0,82,5.76,70,398,2426,9.7
1560,Andy Wozniewski,2010-11,30.0,6,9,48,48,2,7,9,34.0,680.0,76,2,10,12,50.0,82,5.44,62,351,2383,9.4
1561,Andy Wozniewski,2011-12,31.0,7,0,1,1,0,0,0,0.0,7.0,77,2,10,12,50.0,82,5.7,65,341,2477,9.4
1562,Andy Wozniewski,2012-13,32.0,8,0,2,2,0,0,0,1.0,19.0,79,2,10,12,51.0,82,5.53,56,304,2486,9.1
1563,Anson Carter,1999-00,25.0,4,18,38,38,11,7,18,79.0,,38,11,7,18,79.0,82,5.83,55,336,2444,9.8
1564,Anson Carter,2000-01,26.0,5,43,78,78,16,27,43,179.0,,116,27,34,61,258.0,82,5.28,57,380,2242,9.6
1565,Anson Carter,2001-02,27.0,6,40,55,55,24,16,40,123.0,1030.0,171,51,50,101,381.0,82,5.27,57,359,2285,9.4
1566,Anson Carter,2002-03,28.0,7,47,59,59,22,25,47,144.0,1211.0,230,73,75,148,525.0,82,5.49,53,331,2294,9.8
1567,Anson Carter,2003-04,29.0,8,42,61,61,16,26,42,102.0,1111.0,291,89,101,190,627.0,82,5.51,63,376,2272,9.9
1568,Anson Carter,2004-05,30.0,9,60,82,82,28,32,60,181.0,1583.0,373,117,133,250,808.0,82,5.24,53,338,2262,9.5
1569,Anson Carter,2005-06,31.0,10,60,79,79,26,34,60,193.0,1532.0,452,143,167,310,1001.0,82,5.31,60,363,2326,9.4
1570,Anson Carter,2006-07,32.0,11,28,77,77,15,13,28,114.0,1292.0,529,158,180,338,1115.0,82,5.14,57,348,2300,9.2
1571,Anson Carter,2008-09,34.0,12,55,81,81,33,22,55,146.0,1179.0,610,191,202,393,1261.0,82,6.05,85,480,2458,10.1
1572,Anson Carter,2009-10,35.0,13,28,64,64,11,17,28,70.0,901.0,674,202,219,421,1331.0,82,5.76,70,398,2426,9.7
1573,Anssi Melametsa,1988-89,27.0,4,3,27,27,0,3,3,20.0,,27,0,3,3,20.0,80,7.94,82,370,2484,12.8
1574,Anssi Salmela,2011-12,27.0,4,6,26,26,1,5,6,41.0,416.0,26,1,5,6,41.0,82,5.7,65,341,2477,9.4
1575,Anssi Salmela,2012-13,28.0,5,8,38,38,2,6,8,41.0,512.0,64,3,11,14,82.0,82,5.53,56,304,2486,9.1
1576,Anssi Salmela,2013-14,29.0,6,7,48,48,1,6,7,57.0,835.0,112,4,17,21,139.0,82,5.46,52,291,2492,9.0
1577,Antero Lehtonen,1982-83,28.0,4,21,65,65,9,12,21,101.0,,65,9,12,21,101.0,80,7.03,61,280,2352,12.0
1578,Anthony Angello,2022-23,26.0,4,1,8,8,1,0,1,5.0,46.0,8,1,0,1,5.0,70,5.96,42,208,2192,9.5
1579,Anthony Beauvillier,2019-20,22.0,4,24,66,66,9,15,24,101.0,859.0,66,9,15,24,101.0,82,5.45,47,245,2478,9.0
1580,Anthony Beauvillier,2020-21,23.0,5,36,71,71,21,15,36,132.0,1031.0,137,30,30,60,233.0,82,5.86,50,250,2620,9.2
1581,Anthony Beauvillier,2021-22,24.0,6,28,81,81,18,10,28,156.0,1186.0,218,48,40,88,389.0,82,5.96,47,239,2579,9.5
1582,Anthony Beauvillier,2022-23,25.0,7,39,68,68,18,21,39,132.0,1174.0,286,66,61,127,521.0,70,5.96,42,208,2192,9.5
1583,Anthony Bitetto,2017-18,27.0,4,0,7,7,0,0,0,2.0,82.0,7,0,0,0,2.0,82,5.32,47,251,2453,8.9
1584,Anthony Bitetto,2018-19,28.0,5,6,28,28,1,5,6,19.0,340.0,35,1,5,6,21.0,82,5.34,48,255,2438,9.0
1585,Anthony Bitetto,2019-20,29.0,6,7,29,29,0,7,7,17.0,342.0,64,1,12,13,38.0,82,5.45,47,245,2478,9.0
1586,Anthony Bitetto,2020-21,30.0,7,3,32,32,1,2,3,25.0,430.0,96,2,14,16,63.0,82,5.86,50,250,2620,9.2
1587,Anthony Bitetto,2021-22,31.0,8,3,36,36,0,3,3,30.0,429.0,132,2,17,19,93.0,82,5.96,47,239,2579,9.5
1588,Anthony Bitetto,2022-23,32.0,9,8,51,51,0,8,8,54.0,773.0,183,2,25,27,147.0,70,5.96,42,208,2192,9.5
1589,Anthony Cirelli,2020-21,23.0,4,11,18,18,5,6,11,26.0,238.0,18,5,6,11,26.0,82,5.86,50,250,2620,9.2
1590,Anthony Cirelli,2021-22,24.0,5,39,82,82,19,20,39,123.0,1217.0,100,24,26,50,149.0,82,5.96,47,239,2579,9.5
1591,Anthony Cirelli,2022-23,25.0,6,44,68,68,16,28,44,113.0,1255.0,168,40,54,94,262.0,70,5.96,42,208,2192,9.5
1592,Anthony DeAngelo,2019-20,24.0,4,14,39,39,5,9,14,60.0,667.0,39,5,9,14,60.0,82,5.45,47,245,2478,9.0
1593,Anthony DeAngelo,2020-21,25.0,5,8,32,32,0,8,8,68.0,530.0,71,5,17,22,128.0,82,5.86,50,250,2620,9.2
1594,Anthony DeAngelo,2021-22,26.0,6,30,61,61,4,26,30,111.0,1179.0,132,9,43,52,239.0,82,5.96,47,239,2579,9.5
1595,Anthony DeAngelo,2022-23,27.0,7,53,68,68,15,38,53,149.0,1312.0,200,24,81,105,388.0,70,5.96,42,208,2192,9.5
1596,Anthony Duclair,2017-18,22.0,4,7,18,18,1,6,7,18.0,219.0,18,1,6,7,18.0,82,5.32,47,251,2453,8.9
1597,Anthony Duclair,2018-19,23.0,5,44,81,81,20,24,44,105.0,1164.0,99,21,30,51,123.0,82,5.34,48,255,2438,9.0
1598,Anthony Duclair,2019-20,24.0,6,15,58,58,5,10,15,76.0,771.0,157,26,40,66,199.0,82,5.45,47,245,2478,9.0
1599,Anthony Duclair,2020-21,25.0,7,23,56,56,11,12,23,97.0,744.0,213,37,52,89,296.0,82,5.86,50,250,2620,9.2
1600,Anthony Duclair,2021-22,26.0,8,33,74,74,19,14,33,132.0,940.0,287,56,66,122,428.0,82,5.96,47,239,2579,9.5
1601,Anthony Duclair,2022-23,27.0,9,40,66,66,23,17,40,184.0,1073.0,353,79,83,162,612.0,70,5.96,42,208,2192,9.5
1602,Anthony Greco,2021-22,28.0,4,0,1,1,0,0,0,2.0,10.0,1,0,0,0,2.0,82,5.96,47,239,2579,9.5
1603,Anthony Mantha,2018-19,24.0,4,3,10,10,2,1,3,18.0,117.0,10,2,1,3,18.0,82,5.34,48,255,2438,9.0
1604,Anthony Mantha,2019-20,25.0,5,36,60,60,17,19,36,133.0,954.0,70,19,20,39,151.0,82,5.45,47,245,2478,9.0
1605,Anthony Mantha,2020-21,26.0,6,48,80,80,24,24,48,190.0,1384.0,150,43,44,87,341.0,82,5.86,50,250,2620,9.2
1606,Anthony Mantha,2021-22,27.0,7,48,67,67,25,23,48,198.0,1194.0,217,68,67,135,539.0,82,5.96,47,239,2579,9.5
1607,Anthony Mantha,2022-23,28.0,8,38,43,43,16,22,38,137.0,812.0,260,84,89,173,676.0,70,5.96,42,208,2192,9.5
1608,Anthony Peluso,2015-16,26.0,4,2,5,5,0,2,2,4.0,25.0,5,0,2,2,4.0,48,5.31,29,160,1399,9.1
1609,Anthony Peluso,2016-17,27.0,5,5,53,53,2,3,5,24.0,306.0,58,2,5,7,28.0,82,5.34,48,269,2463,8.9
1610,Anthony Peluso,2017-18,28.0,6,2,49,49,1,1,2,23.0,288.0,107,3,6,9,51.0,82,5.32,47,251,2453,8.9
1611,Anthony Peluso,2018-19,29.0,7,5,35,35,1,4,5,16.0,223.0,142,4,10,14,67.0,82,5.34,48,255,2438,9.0
1612,Anthony Peluso,2020-21,31.0,8,0,2,2,0,0,0,0.0,9.0,144,4,10,14,67.0,82,5.86,50,250,2620,9.2
1613,Anthony Peluso,2021-22,32.0,9,0,4,4,0,0,0,1.0,16.0,148,4,10,14,68.0,82,5.96,47,239,2579,9.5
1614,Anthony Richard,2021-22,25.0,4,0,1,1,0,0,0,0.0,7.0,1,0,0,0,0.0,82,5.96,47,239,2579,9.5
1615,Anthony Richard,2022-23,26.0,5,0,1,1,0,0,0,2.0,4.0,2,0,0,0,2.0,70,5.96,42,208,2192,9.5
1616,Anthony Stewart,2008-09,24.0,4,3,10,10,2,1,3,16.0,72.0,10,2,1,3,16.0,82,6.05,85,480,2458,10.1
1617,Anthony Stewart,2009-10,25.0,5,1,10,10,0,1,1,8.0,69.0,20,2,2,4,24.0,82,5.76,70,398,2426,9.7
1618,Anthony Stewart,2010-11,26.0,6,1,26,26,0,1,1,21.0,160.0,46,2,3,5,45.0,82,5.44,62,351,2383,9.4
1619,Anthony Stewart,2011-12,27.0,7,7,59,59,2,5,7,56.0,451.0,105,4,8,12,101.0,82,5.7,65,341,2477,9.4
1620,Anthony Stewart,2013-14,29.0,8,39,80,80,14,25,39,141.0,1198.0,185,18,33,51,242.0,82,5.46,52,291,2492,9.0
1621,Anthony Stewart,2014-15,30.0,9,20,77,77,9,11,20,64.0,626.0,262,27,44,71,306.0,82,5.32,47,271,2439,8.9
1622,Antoine Roussel,2015-16,26.0,4,14,39,39,7,7,14,46.0,367.0,39,7,7,14,46.0,48,5.31,29,160,1399,9.1
1623,Antoine Roussel,2016-17,27.0,5,29,81,81,14,15,29,113.0,1080.0,120,21,22,43,159.0,82,5.34,48,269,2463,8.9
1624,Antoine Roussel,2017-18,28.0,6,25,80,80,13,12,25,113.0,1162.0,200,34,34,68,272.0,82,5.32,47,251,2453,8.9
1625,Antoine Roussel,2018-19,29.0,7,29,80,80,13,16,29,111.0,1109.0,280,47,50,97,383.0,82,5.34,48,255,2438,9.0
1626,Antoine Roussel,2019-20,30.0,8,27,60,60,12,15,27,82.0,931.0,340,59,65,124,465.0,82,5.45,47,245,2478,9.0
1627,Antoine Roussel,2020-21,31.0,9,17,73,73,5,12,17,85.0,908.0,413,64,77,141,550.0,82,5.86,50,250,2620,9.2
1628,Antoine Roussel,2021-22,32.0,10,31,65,65,9,22,31,84.0,894.0,478,73,99,172,634.0,82,5.96,47,239,2579,9.5
1629,Antoine Roussel,2022-23,33.0,11,13,41,41,7,6,13,55.0,485.0,519,80,105,185,689.0,70,5.96,42,208,2192,9.5
1630,Antoine Vermette,2006-07,24.0,4,14,57,57,7,7,14,63.0,684.0,57,7,7,14,63.0,82,5.14,57,348,2300,9.2
1631,Antoine Vermette,2008-09,26.0,5,33,82,82,21,12,33,123.0,1031.0,139,28,19,47,186.0,82,6.05,85,480,2458,10.1
1632,Antoine Vermette,2009-10,27.0,6,39,77,77,19,20,39,151.0,1210.0,216,47,39,86,337.0,82,5.76,70,398,2426,9.7
1633,Antoine Vermette,2010-11,28.0,7,53,81,81,24,29,53,175.0,1424.0,297,71,68,139,512.0,82,5.44,62,351,2383,9.4
1634,Antoine Vermette,2011-12,29.0,8,41,79,79,16,25,41,174.0,1450.0,376,87,93,180,686.0,82,5.7,65,341,2477,9.4
1635,Antoine Vermette,2012-13,30.0,9,65,82,82,27,38,65,156.0,1652.0,458,114,131,245,842.0,82,5.53,56,304,2486,9.1
1636,Antoine Vermette,2013-14,31.0,10,47,82,82,19,28,47,183.0,1543.0,540,133,159,292,1025.0,82,5.46,52,291,2492,9.0
1637,Antoine Vermette,2014-15,32.0,11,37,82,82,11,26,37,149.0,1411.0,622,144,185,329,1174.0,82,5.32,47,271,2439,8.9
1638,Antoine Vermette,2015-16,33.0,12,21,48,48,13,8,21,91.0,876.0,670,157,193,350,1265.0,48,5.31,29,160,1399,9.1
1639,Antoine Vermette,2016-17,34.0,13,45,82,82,24,21,45,160.0,1575.0,752,181,214,395,1425.0,82,5.34,48,269,2463,8.9
1640,Antoine Vermette,2017-18,35.0,14,38,82,82,13,25,38,109.0,1463.0,834,194,239,433,1534.0,82,5.32,47,251,2453,8.9
1641,Antoine Vermette,2018-19,36.0,15,38,76,76,17,21,38,123.0,1265.0,910,211,260,471,1657.0,82,5.34,48,255,2438,9.0
1642,Antoine Vermette,2019-20,37.0,16,28,72,72,9,19,28,88.0,1145.0,982,220,279,499,1745.0,82,5.45,47,245,2478,9.0
1643,Antoine Vermette,2020-21,38.0,17,16,64,64,8,8,16,91.0,880.0,1046,228,287,515,1836.0,82,5.86,50,250,2620,9.2
1644,Anton Babchuk,2006-07,22.0,4,2,5,5,0,2,2,11.0,64.0,5,0,2,2,11.0,82,5.14,57,348,2300,9.2
1645,Anton Babchuk,2008-09,24.0,5,10,39,39,5,5,10,56.0,577.0,44,5,7,12,67.0,82,6.05,85,480,2458,10.1
1646,Anton Babchuk,2009-10,25.0,6,14,52,52,2,12,14,63.0,906.0,96,7,19,26,130.0,82,5.76,70,398,2426,9.7
1647,Anton Babchuk,2011-12,27.0,7,35,72,72,16,19,35,127.0,1301.0,168,23,38,61,257.0,82,5.7,65,341,2477,9.4
1648,Anton Babchuk,2013-14,29.0,8,35,82,82,11,24,35,132.0,1340.0,250,34,62,96,389.0,82,5.46,52,291,2492,9.0
1649,Anton Babchuk,2014-15,30.0,9,10,32,32,2,8,10,48.0,464.0,282,36,70,106,437.0,82,5.32,47,271,2439,8.9
1650,Anton Babchuk,2015-16,31.0,10,1,7,7,0,1,1,5.0,83.0,289,36,71,107,442.0,48,5.31,29,160,1399,9.1
1651,Anton Belov,2016-17,30.0,4,7,57,57,1,6,7,54.0,951.0,57,1,6,7,54.0,82,5.34,48,269,2463,8.9
1652,Anton Blidh,2019-20,24.0,4,2,19,19,1,1,2,26.0,167.0,19,1,1,2,26.0,82,5.45,47,245,2478,9.0
1653,Anton Blidh,2020-21,25.0,5,0,1,1,0,0,0,0.0,10.0,20,1,1,2,26.0,82,5.86,50,250,2620,9.2
1654,Anton Blidh,2021-22,26.0,6,0,1,1,0,0,0,0.0,14.0,21,1,1,2,26.0,82,5.96,47,239,2579,9.5
1655,Anton Blidh,2022-23,27.0,7,0,7,7,0,0,0,9.0,81.0,28,1,1,2,35.0,70,5.96,42,208,2192,9.5
1656,Anton Klementyev,2012-13,22.0,4,0,1,1,0,0,0,0.0,6.0,1,0,0,0,0.0,82,5.53,56,304,2486,9.1
1657,Anton Lander,2014-15,23.0,4,6,56,56,2,4,6,54.0,594.0,56,2,4,6,54.0,82,5.32,47,271,2439,8.9
1658,Anton Lander,2015-16,24.0,5,1,11,11,0,1,1,11.0,121.0,67,2,5,7,65.0,48,5.31,29,160,1399,9.1
1659,Anton Lander,2016-17,25.0,6,1,27,27,0,1,1,18.0,368.0,94,2,6,8,83.0,82,5.34,48,269,2463,8.9
1660,Anton Lander,2017-18,26.0,7,20,38,38,6,14,20,61.0,570.0,132,8,20,28,144.0,82,5.32,47,251,2453,8.9
1661,Anton Lander,2018-19,27.0,8,3,61,61,1,2,3,54.0,737.0,193,9,22,31,198.0,82,5.34,48,255,2438,9.0
1662,Anton Lander,2019-20,28.0,9,4,22,22,1,3,4,12.0,215.0,215,10,25,35,210.0,82,5.45,47,245,2478,9.0
1663,Anton Lindholm,2019-20,25.0,4,0,12,12,0,0,0,7.0,177.0,12,0,0,0,7.0,82,5.45,47,245,2478,9.0
1664,Anton Lindholm,2020-21,26.0,5,4,48,48,0,4,4,22.0,632.0,60,0,4,4,29.0,82,5.86,50,250,2620,9.2
1665,Anton Lindholm,2021-22,27.0,6,0,2,2,0,0,0,0.0,14.0,62,0,4,4,29.0,82,5.96,47,239,2579,9.5
1666,Anton Lindholm,2022-23,28.0,7,1,4,4,0,1,1,1.0,47.0,66,0,5,5,30.0,70,5.96,42,208,2192,9.5
1667,Anton Rodin,2019-20,29.0,4,1,3,3,0,1,1,2.0,27.0,3,0,1,1,2.0,82,5.45,47,245,2478,9.0
1668,Anton Slepyshev,2018-19,24.0,4,1,11,11,0,1,1,5.0,96.0,11,0,1,1,5.0,82,5.34,48,255,2438,9.0
1669,Anton Slepyshev,2019-20,25.0,5,10,41,41,4,6,10,55.0,456.0,52,4,7,11,60.0,82,5.45,47,245,2478,9.0
1670,Anton Slepyshev,2020-21,26.0,6,12,50,50,6,6,12,73.0,591.0,102,10,13,23,133.0,82,5.86,50,250,2620,9.2
1671,Anton Stastny,1983-84,24.0,4,85,80,80,39,46,85,177.0,,80,39,46,85,177.0,80,7.69,77,340,2441,12.6
1672,Anton Stastny,1984-85,25.0,5,72,68,68,26,46,72,137.0,,148,65,92,157,314.0,80,8.03,73,320,2489,12.9
1673,Anton Stastny,1985-86,26.0,6,92,79,79,32,60,92,166.0,,227,97,152,249,480.0,80,7.73,71,310,2444,12.7
1674,Anton Stastny,1986-87,27.0,7,62,69,69,25,37,62,147.0,,296,122,189,311,627.0,80,7.89,74,336,2448,12.9
1675,Anton Stastny,1987-88,28.0,8,80,79,79,38,42,80,176.0,,375,160,231,391,803.0,80,7.77,71,321,2447,12.7
1676,Anton Stastny,1988-89,29.0,9,74,74,74,31,43,74,163.0,,449,191,274,465,966.0,80,7.94,82,370,2484,12.8
1677,Anton Stastny,1989-90,30.0,10,62,77,77,27,35,62,178.0,,526,218,309,527,1144.0,80,7.34,72,344,2400,12.2
1678,Anton Stastny,1990-91,31.0,11,72,69,69,27,45,72,177.0,,595,245,354,599,1321.0,80,7.43,89,437,2435,12.2
1679,Anton Stastny,1991-92,32.0,12,37,55,55,7,30,37,84.0,,650,252,384,636,1405.0,80,7.48,85,403,2430,12.3
1680,Anton Stralman,2010-11,24.0,4,9,50,50,3,6,9,40.0,641.0,50,3,6,9,40.0,82,5.44,62,351,2383,9.4
1681,Anton Stralman,2011-12,25.0,5,13,38,38,1,12,13,43.0,592.0,88,4,18,22,83.0,82,5.7,65,341,2477,9.4
1682,Anton Stralman,2012-13,26.0,6,34,73,73,6,28,34,121.0,1496.0,161,10,46,56,204.0,82,5.53,56,304,2486,9.1
1683,Anton Stralman,2013-14,27.0,7,18,51,51,1,17,18,80.0,1006.0,212,11,63,74,284.0,82,5.46,52,291,2492,9.0
1684,Anton Stralman,2014-15,28.0,8,18,53,53,2,16,18,55.0,906.0,265,13,79,92,339.0,82,5.32,47,271,2439,8.9
1685,Anton Stralman,2015-16,29.0,9,7,48,48,4,3,7,66.0,866.0,313,17,82,99,405.0,48,5.31,29,160,1399,9.1
1686,Anton Stralman,2016-17,30.0,10,13,81,81,1,12,13,104.0,1571.0,394,18,94,112,509.0,82,5.34,48,269,2463,8.9
1687,Anton Stralman,2017-18,31.0,11,39,82,82,9,30,39,138.0,1800.0,476,27,124,151,647.0,82,5.32,47,251,2453,8.9
1688,Anton Stralman,2018-19,32.0,12,34,73,73,9,25,34,127.0,1612.0,549,36,149,185,774.0,82,5.34,48,255,2438,9.0
1689,Anton Stralman,2019-20,33.0,13,22,73,73,5,17,22,130.0,1672.0,622,41,166,207,904.0,82,5.45,47,245,2478,9.0
1690,Anton Stralman,2020-21,34.0,14,18,80,80,4,14,18,131.0,1719.0,702,45,180,225,1035.0,82,5.86,50,250,2620,9.2
1691,Anton Stralman,2021-22,35.0,15,17,47,47,2,15,17,57.0,965.0,749,47,195,242,1092.0,82,5.96,47,239,2579,9.5
1692,Anton Stralman,2022-23,36.0,16,19,69,69,5,14,19,89.0,1454.0,818,52,209,261,1181.0,70,5.96,42,208,2192,9.5
1693,Anton Volchenkov,2005-06,23.0,4,16,57,57,3,13,16,75.0,884.0,57,3,13,16,75.0,82,5.31,60,363,2326,9.4
1694,Anton Volchenkov,2006-07,24.0,5,3,19,19,1,2,3,15.0,248.0,76,4,15,19,90.0,82,5.14,57,348,2300,9.2
1695,Anton Volchenkov,2008-09,26.0,6,17,75,75,4,13,17,82.0,1354.0,151,8,28,36,172.0,82,6.05,85,480,2458,10.1
1696,Anton Volchenkov,2009-10,27.0,7,19,78,78,1,18,19,85.0,1660.0,229,9,46,55,257.0,82,5.76,70,398,2426,9.7
1697,Anton Volchenkov,2010-11,28.0,8,15,67,67,1,14,15,71.0,1374.0,296,10,60,70,328.0,82,5.44,62,351,2383,9.4
1698,Anton Volchenkov,2011-12,29.0,9,10,68,68,2,8,10,79.0,1370.0,364,12,68,80,407.0,82,5.7,65,341,2477,9.4
1699,Anton Volchenkov,2012-13,30.0,10,14,64,64,4,10,14,69.0,1324.0,428,16,78,94,476.0,82,5.53,56,304,2486,9.1
1700,Anton Volchenkov,2013-14,31.0,11,8,57,57,0,8,8,65.0,1032.0,485,16,86,102,541.0,82,5.46,52,291,2492,9.0
1701,Anton Volchenkov,2014-15,32.0,12,11,72,72,2,9,11,63.0,1294.0,557,18,95,113,604.0,82,5.32,47,271,2439,8.9
1702,Anton Volchenkov,2015-16,33.0,13,5,37,37,1,4,5,38.0,594.0,594,19,99,118,642.0,48,5.31,29,160,1399,9.1
1703,Anton Volchenkov,2016-17,34.0,14,8,56,56,0,8,8,42.0,940.0,650,19,107,126,684.0,82,5.34,48,269,2463,8.9
1704,Anton Volchenkov,2017-18,35.0,15,7,46,46,0,7,7,35.0,606.0,696,19,114,133,719.0,82,5.32,47,251,2453,8.9
1705,Anton Wedin,2022-23,29.0,4,0,4,4,0,0,0,2.0,36.0,4,0,0,0,2.0,70,5.96,42,208,2192,9.5
1706,Antti Aalto,2000-01,25.0,4,0,3,3,0,0,0,1.0,,3,0,0,0,1.0,82,5.28,57,380,2242,9.6
1707,Antti Aalto,2001-02,26.0,5,8,73,73,3,5,8,61.0,685.0,76,3,5,8,62.0,82,5.27,57,359,2285,9.4
1708,Antti Aalto,2002-03,27.0,6,18,63,63,7,11,18,102.0,830.0,139,10,16,26,164.0,82,5.49,53,331,2294,9.8
1709,Antti Aalto,2003-04,28.0,7,2,12,12,1,1,2,18.0,127.0,151,11,17,28,182.0,82,5.51,63,376,2272,9.9
1710,Antti Laaksonen,2001-02,28.0,4,3,11,11,1,2,3,8.0,103.0,11,1,2,3,8.0,82,5.27,57,359,2285,9.4
1711,Antti Laaksonen,2002-03,29.0,5,9,27,27,6,3,9,23.0,212.0,38,7,5,12,31.0,82,5.49,53,331,2294,9.8
1712,Antti Laaksonen,2003-04,30.0,6,28,82,82,12,16,28,129.0,1349.0,120,19,21,40,160.0,82,5.51,63,376,2272,9.9
1713,Antti Laaksonen,2004-05,31.0,7,33,82,82,16,17,33,104.0,1339.0,202,35,38,73,264.0,82,5.24,53,338,2262,9.5
1714,Antti Laaksonen,2005-06,32.0,8,31,82,82,15,16,31,106.0,1305.0,284,50,54,104,370.0,82,5.31,60,363,2326,9.4
1715,Antti Laaksonen,2006-07,33.0,9,26,77,77,12,14,26,100.0,1236.0,361,62,68,130,470.0,82,5.14,57,348,2300,9.2
1716,Antti Laaksonen,2008-09,35.0,10,34,81,81,16,18,34,141.0,1297.0,442,78,86,164,611.0,82,6.05,85,480,2458,10.1
1717,Antti Laaksonen,2009-10,36.0,11,4,41,41,3,1,4,43.0,438.0,483,81,87,168,654.0,82,5.76,70,398,2426,9.7
1718,Antti Miettinen,2006-07,26.0,4,1,16,16,1,0,1,17.0,158.0,16,1,0,1,17.0,82,5.14,57,348,2300,9.2
1719,Antti Miettinen,2008-09,28.0,5,31,79,79,11,20,31,107.0,956.0,95,12,20,32,124.0,82,6.05,85,480,2458,10.1
1720,Antti Miettinen,2009-10,29.0,6,25,74,74,11,14,25,141.0,1060.0,169,23,34,57,265.0,82,5.76,70,398,2426,9.7
1721,Antti Miettinen,2010-11,30.0,7,34,69,69,15,19,34,136.0,965.0,238,38,53,91,401.0,82,5.44,62,351,2383,9.4
1722,Antti Miettinen,2011-12,31.0,8,44,82,82,15,29,44,186.0,1499.0,320,53,82,135,587.0,82,5.7,65,341,2477,9.4
1723,Antti Miettinen,2012-13,32.0,9,42,79,79,20,22,42,175.0,1426.0,399,73,104,177,762.0,82,5.53,56,304,2486,9.1
1724,Antti Miettinen,2013-14,33.0,10,35,73,73,16,19,35,168.0,1243.0,472,89,123,212,930.0,82,5.46,52,291,2492,9.0
1725,Antti Miettinen,2014-15,34.0,11,13,45,45,5,8,13,58.0,527.0,517,94,131,225,988.0,82,5.32,47,271,2439,8.9
1726,Antti Miettinen,2015-16,35.0,12,5,22,22,3,2,5,26.0,278.0,539,97,133,230,1014.0,48,5.31,29,160,1399,9.1
1727,Antti Pihlstrom,2010-11,26.0,4,0,1,1,0,0,0,1.0,9.0,1,0,0,0,1.0,82,5.44,62,351,2383,9.4
1728,Antti Pihlstrom,2011-12,27.0,5,7,53,53,2,5,7,88.0,607.0,54,2,5,7,89.0,82,5.7,65,341,2477,9.4
1729,Antti Suomela,2021-22,27.0,4,8,27,27,3,5,8,42.0,306.0,27,3,5,8,42.0,82,5.96,47,239,2579,9.5
1730,Antti Suomela,2022-23,28.0,5,7,20,20,1,6,7,18.0,194.0,47,4,11,15,60.0,70,5.96,42,208,2192,9.5
1731,Antti Tormanen,1998-99,28.0,4,15,50,50,7,8,15,68.0,,50,7,8,15,68.0,82,6.29,74,413,2481,10.4
1732,Antti-Jussi Niemi,2003-04,26.0,4,2,28,28,1,1,2,18.0,446.0,28,1,1,2,18.0,82,5.51,63,376,2272,9.9
1733,Antti-Jussi Niemi,2004-05,27.0,5,0,1,1,0,0,0,0.0,10.0,29,1,1,2,18.0,82,5.24,53,338,2262,9.5
1734,Anze Kopitar,2009-10,22.0,4,61,72,72,20,41,61,193.0,1479.0,72,20,41,61,193.0,82,5.76,70,398,2426,9.7
1735,Anze Kopitar,2010-11,23.0,5,77,82,82,32,45,77,201.0,1696.0,154,52,86,138,394.0,82,5.44,62,351,2383,9.4
1736,Anze Kopitar,2011-12,24.0,6,66,82,82,27,39,66,234.0,1677.0,236,79,125,204,628.0,82,5.7,65,341,2477,9.4
1737,Anze Kopitar,2012-13,25.0,7,81,82,82,34,47,81,259.0,1786.0,318,113,172,285,887.0,82,5.53,56,304,2486,9.1
1738,Anze Kopitar,2013-14,26.0,8,73,75,75,25,48,73,233.0,1619.0,393,138,220,358,1120.0,82,5.46,52,291,2492,9.0
1739,Anze Kopitar,2014-15,27.0,9,76,82,82,25,51,76,230.0,1750.0,475,163,271,434,1350.0,82,5.32,47,271,2439,8.9
1740,Anze Kopitar,2015-16,28.0,10,42,47,47,10,32,42,98.0,963.0,522,173,303,476,1448.0,48,5.31,29,160,1399,9.1
1741,Anze Kopitar,2016-17,29.0,11,70,82,82,29,41,70,200.0,1713.0,604,202,344,546,1648.0,82,5.34,48,269,2463,8.9
1742,Anze Kopitar,2017-18,30.0,12,64,79,79,16,48,64,134.0,1532.0,683,218,392,610,1782.0,82,5.32,47,251,2453,8.9
1743,Anze Kopitar,2018-19,31.0,13,74,81,81,25,49,74,177.0,1690.0,764,243,441,684,1959.0,82,5.34,48,255,2438,9.0
1744,Anze Kopitar,2019-20,32.0,14,52,76,76,12,40,52,150.0,1578.0,840,255,481,736,2109.0,82,5.45,47,245,2478,9.0
1745,Anze Kopitar,2020-21,33.0,15,92,82,82,35,57,92,200.0,1811.0,922,290,538,828,2309.0,82,5.86,50,250,2620,9.2
1746,Anze Kopitar,2021-22,34.0,16,60,81,81,22,38,60,156.0,1807.0,1003,312,576,888,2465.0,82,5.96,47,239,2579,9.5
1747,Anze Kopitar,2022-23,35.0,17,62,70,70,21,41,62,135.0,1473.0,1073,333,617,950,2600.0,70,5.96,42,208,2192,9.5
1748,Archie Henderson,1983-84,26.0,4,1,7,7,1,0,1,4.0,,7,1,0,1,4.0,80,7.69,77,340,2441,12.6
1749,Archie Henderson,1984-85,27.0,5,0,1,1,0,0,0,0.0,,8,1,0,1,4.0,80,8.03,73,320,2489,12.9
1750,Archie Henderson,1985-86,28.0,6,3,15,15,2,1,3,7.0,,23,3,1,4,11.0,80,7.73,71,310,2444,12.7
1751,Ari Haanpaa,1988-89,23.0,4,7,18,18,0,7,7,16.0,,18,0,7,7,16.0,80,7.94,82,370,2484,12.8
1752,Ari Haanpaa,1989-90,24.0,5,10,41,41,6,4,10,45.0,,59,6,11,17,61.0,80,7.34,72,344,2400,12.2
1753,Ari Haanpaa,1990-91,25.0,6,0,1,1,0,0,0,0.0,,60,6,11,17,61.0,80,7.43,89,437,2435,12.2
1754,Aris Brimanis,1996-97,24.0,4,0,1,1,0,0,0,1.0,,1,0,0,0,1.0,84,6.48,76,407,2545,10.7
1755,Aris Brimanis,1998-99,26.0,5,2,17,17,0,2,2,11.0,,18,0,2,2,12.0,82,6.29,74,413,2481,10.4
1756,Aris Brimanis,1999-00,27.0,6,1,3,3,0,1,1,1.0,,21,0,3,3,13.0,82,5.83,55,336,2444,9.8
1757,Aris Brimanis,2002-03,30.0,7,3,18,18,2,1,3,16.0,360.0,39,2,4,6,29.0,82,5.49,53,331,2294,9.8
1758,Aris Brimanis,2003-04,31.0,8,8,56,56,0,8,8,66.0,874.0,95,2,12,14,95.0,82,5.51,63,376,2272,9.9
1759,Aris Brimanis,2004-05,32.0,9,0,5,5,0,0,0,2.0,48.0,100,2,12,14,97.0,82,5.24,53,338,2262,9.5
1760,Aris Brimanis,2006-07,34.0,10,0,13,13,0,0,0,3.0,156.0,113,2,12,14,100.0,82,5.14,57,348,2300,9.2
1761,Arron Asham,2001-02,23.0,4,0,7,7,0,0,0,5.0,52.0,7,0,0,0,5.0,82,5.27,57,359,2285,9.4
1762,Arron Asham,2002-03,24.0,5,6,33,33,4,2,6,29.0,338.0,40,4,2,6,34.0,82,5.49,53,331,2294,9.8
1763,Arron Asham,2003-04,25.0,6,5,46,46,2,3,5,32.0,389.0,86,6,5,11,66.0,82,5.51,63,376,2272,9.9
1764,Arron Asham,2004-05,26.0,7,9,35,35,5,4,9,30.0,287.0,121,11,9,20,96.0,82,5.24,53,338,2262,9.5
1765,Arron Asham,2005-06,27.0,8,34,78,78,15,19,34,114.0,953.0,199,26,28,54,210.0,82,5.31,60,363,2326,9.4
1766,Arron Asham,2006-07,28.0,9,24,79,79,12,12,24,108.0,1044.0,278,38,40,78,318.0,82,5.14,57,348,2300,9.2
1767,Arron Asham,2008-09,30.0,10,24,63,63,9,15,24,99.0,853.0,341,47,55,102,417.0,82,6.05,85,480,2458,10.1
1768,Arron Asham,2009-10,31.0,11,23,80,80,11,12,23,85.0,746.0,421,58,67,125,502.0,82,5.76,70,398,2426,9.7
1769,Arron Asham,2010-11,32.0,12,10,77,77,6,4,10,68.0,659.0,498,64,71,135,570.0,82,5.44,62,351,2383,9.4
1770,Arron Asham,2011-12,33.0,13,20,78,78,8,12,20,74.0,682.0,576,72,83,155,644.0,82,5.7,65,341,2477,9.4
1771,Arron Asham,2012-13,34.0,14,24,72,72,10,14,24,91.0,725.0,648,82,97,179,735.0,82,5.53,56,304,2486,9.1
1772,Arron Asham,2013-14,35.0,15,11,44,44,5,6,11,60.0,420.0,692,87,103,190,795.0,82,5.46,52,291,2492,9.0
1773,Arron Asham,2014-15,36.0,16,16,64,64,5,11,16,49.0,591.0,756,92,114,206,844.0,82,5.32,47,271,2439,8.9
1774,Arron Asham,2015-16,37.0,17,2,27,27,2,0,2,14.0,179.0,783,94,114,208,858.0,48,5.31,29,160,1399,9.1
1775,Arron Asham,2016-17,38.0,18,0,6,6,0,0,0,1.0,45.0,789,94,114,208,859.0,82,5.34,48,269,2463,8.9
1776,Artem Anisimov,2011-12,23.0,4,0,1,1,0,0,0,1.0,9.0,1,0,0,0,1.0,82,5.7,65,341,2477,9.4
1777,Artem Anisimov,2012-13,24.0,5,28,82,82,12,16,28,124.0,1058.0,83,12,16,28,125.0,82,5.53,56,304,2486,9.1
1778,Artem Anisimov,2013-14,25.0,6,44,82,82,18,26,44,190.0,1329.0,165,30,42,72,315.0,82,5.46,52,291,2492,9.0
1779,Artem Anisimov,2014-15,26.0,7,36,79,79,16,20,36,132.0,1217.0,244,46,62,108,447.0,82,5.32,47,271,2439,8.9
1780,Artem Anisimov,2015-16,27.0,8,18,35,35,11,7,18,68.0,574.0,279,57,69,126,515.0,48,5.31,29,160,1399,9.1
1781,Artem Anisimov,2016-17,28.0,9,39,81,81,22,17,39,162.0,1344.0,360,79,86,165,677.0,82,5.34,48,269,2463,8.9
1782,Artem Anisimov,2017-18,29.0,10,27,52,52,7,20,27,88.0,852.0,412,86,106,192,765.0,82,5.32,47,251,2453,8.9
1783,Artem Anisimov,2018-19,30.0,11,42,77,77,20,22,42,121.0,1393.0,489,106,128,234,886.0,82,5.34,48,255,2438,9.0
1784,Artem Anisimov,2019-20,31.0,12,45,64,64,22,23,45,105.0,1142.0,553,128,151,279,991.0,82,5.45,47,245,2478,9.0
1785,Artem Anisimov,2020-21,32.0,13,31,72,72,20,11,31,130.0,1209.0,625,148,162,310,1121.0,82,5.86,50,250,2620,9.2
1786,Artem Anisimov,2021-22,33.0,14,37,78,78,15,22,37,142.0,1275.0,703,163,184,347,1263.0,82,5.96,47,239,2579,9.5
1787,Artem Anisimov,2022-23,34.0,15,20,49,49,15,5,20,87.0,679.0,752,178,189,367,1350.0,70,5.96,42,208,2192,9.5
1788,Artem Chubarov,2002-03,23.0,4,9,49,49,1,8,9,53.0,574.0,49,1,8,9,53.0,82,5.49,53,331,2294,9.8
1789,Artem Chubarov,2003-04,24.0,5,0,1,1,0,0,0,0.0,15.0,50,1,8,9,53.0,82,5.51,63,376,2272,9.9
1790,Artem Chubarov,2004-05,25.0,6,10,51,51,5,5,10,73.0,644.0,101,6,13,19,126.0,82,5.24,53,338,2262,9.5
1791,Artem Chubarov,2005-06,26.0,7,20,62,62,7,13,20,78.0,889.0,163,13,26,39,204.0,82,5.31,60,363,2326,9.4
1792,Artem Chubarov,2006-07,27.0,8,19,65,65,12,7,19,93.0,915.0,228,25,33,58,297.0,82,5.14,57,348,2300,9.2
1793,Artemi Panarin,2018-19,27.0,4,77,80,80,30,47,77,187.0,1482.0,80,30,47,77,187.0,82,5.34,48,255,2438,9.0
1794,Artemi Panarin,2019-20,28.0,5,74,82,82,31,43,74,211.0,1597.0,162,61,90,151,398.0,82,5.45,47,245,2478,9.0
1795,Artemi Panarin,2020-21,29.0,6,82,81,81,27,55,82,228.0,1631.0,243,88,145,233,626.0,82,5.86,50,250,2620,9.2
1796,Artemi Panarin,2021-22,30.0,7,87,79,79,28,59,87,191.0,1569.0,322,116,204,320,817.0,82,5.96,47,239,2579,9.5
1797,Artemi Panarin,2022-23,31.0,8,95,69,69,32,63,95,209.0,1422.0,391,148,267,415,1026.0,70,5.96,42,208,2192,9.5
1798,Arto Blomsten,1996-97,31.0,4,2,18,18,0,2,2,15.0,,18,0,2,2,15.0,84,6.48,76,407,2545,10.7
1799,Arto Blomsten,1997-98,32.0,5,1,5,5,0,1,1,1.0,,23,0,3,3,16.0,48,5.97,37,209,1408,10.2
1800,Arto Blomsten,1998-99,33.0,6,1,2,2,0,1,1,1.0,,25,0,4,4,17.0,82,6.29,74,413,2481,10.4
1801,Arto Javanainen,1987-88,28.0,4,5,14,14,4,1,5,20.0,,14,4,1,5,20.0,80,7.77,71,321,2447,12.7
1802,Artturi Lehkonen,2019-20,24.0,4,28,73,73,18,10,28,158.0,1012.0,73,18,10,28,158.0,82,5.45,47,245,2478,9.0
1803,Artturi Lehkonen,2020-21,25.0,5,21,66,66,12,9,21,164.0,1088.0,139,30,19,49,322.0,82,5.86,50,250,2620,9.2
1804,Artturi Lehkonen,2021-22,26.0,6,31,82,82,11,20,31,176.0,1276.0,221,41,39,80,498.0,82,5.96,47,239,2579,9.5
1805,Artturi Lehkonen,2022-23,27.0,7,27,70,70,13,14,27,140.0,1080.0,291,54,53,107,638.0,70,5.96,42,208,2192,9.5
1806,Arturs Kulda ,2012-13,24.0,4,2,4,4,0,2,2,5.0,48.0,4,0,2,2,5.0,82,5.53,56,304,2486,9.1
1807,Arturs Kulda ,2013-14,25.0,5,0,2,2,0,0,0,3.0,22.0,6,0,2,2,8.0,82,5.46,52,291,2492,9.0
1808,Arturs Kulda ,2014-15,26.0,6,0,9,9,0,0,0,8.0,98.0,15,0,2,2,16.0,82,5.32,47,271,2439,8.9
1809,Ashton Sautner,2020-21,26.0,4,2,5,5,0,2,2,3.0,67.0,5,0,2,2,3.0,82,5.86,50,250,2620,9.2
1810,Ashton Sautner,2021-22,27.0,5,1,17,17,0,1,1,21.0,247.0,22,0,3,3,24.0,82,5.96,47,239,2579,9.5
1811,Ashton Sautner,2022-23,28.0,6,0,1,1,0,0,0,1.0,3.0,23,0,3,3,25.0,70,5.96,42,208,2192,9.5
1812,Austin Czarnik,2019-20,27.0,4,13,49,49,5,8,13,66.0,638.0,49,5,8,13,66.0,82,5.45,47,245,2478,9.0
1813,Austin Czarnik,2020-21,28.0,5,4,10,10,0,4,4,7.0,109.0,59,5,12,17,73.0,82,5.86,50,250,2620,9.2
1814,Austin Czarnik,2021-22,29.0,6,18,54,54,6,12,18,65.0,612.0,113,11,24,35,138.0,82,5.96,47,239,2579,9.5
1815,Austin Czarnik,2022-23,30.0,7,3,8,8,2,1,3,9.0,82.0,121,13,25,38,147.0,70,5.96,42,208,2192,9.5
1816,Austin Poganski,2022-23,26.0,4,0,1,1,0,0,0,0.0,6.0,1,0,0,0,0.0,70,5.96,42,208,2192,9.5
1817,Austin Wagner,2021-22,24.0,4,21,62,62,12,9,21,67.0,554.0,62,12,9,21,67.0,82,5.96,47,239,2579,9.5
1818,Austin Wagner,2022-23,25.0,5,11,65,65,6,5,11,124.0,763.0,127,18,14,32,191.0,70,5.96,42,208,2192,9.5
1819,Austin Watson,2015-16,24.0,4,1,6,6,1,0,1,4.0,76.0,6,1,0,1,4.0,48,5.31,29,160,1399,9.1
1820,Austin Watson,2018-19,27.0,5,10,57,57,3,7,10,55.0,570.0,63,4,7,11,59.0,82,5.34,48,255,2438,9.0
1821,Austin Watson,2019-20,28.0,6,17,77,77,5,12,17,90.0,957.0,140,9,19,28,149.0,82,5.45,47,245,2478,9.0
1822,Austin Watson,2020-21,29.0,7,19,76,76,14,5,19,96.0,937.0,216,23,24,47,245.0,82,5.86,50,250,2620,9.2
1823,Austin Watson,2021-22,30.0,8,16,37,37,7,9,16,64.0,536.0,253,30,33,63,309.0,82,5.96,47,239,2579,9.5
1824,Austin Watson,2022-23,31.0,9,14,53,53,6,8,14,50.0,616.0,306,36,41,77,359.0,70,5.96,42,208,2192,9.5
1825,Auston Matthews,2019-20,22.0,4,69,82,82,40,29,69,279.0,1446.0,82,40,29,69,279.0,82,5.45,47,245,2478,9.0
1826,Auston Matthews,2020-21,23.0,5,63,62,62,34,29,63,187.0,1124.0,144,74,58,132,466.0,82,5.86,50,250,2620,9.2
1827,Auston Matthews,2021-22,24.0,6,73,68,68,37,36,73,251.0,1262.0,212,111,94,205,717.0,82,5.96,47,239,2579,9.5
1828,Auston Matthews,2022-23,25.0,7,80,70,70,47,33,80,290.0,1468.0,282,158,127,285,1007.0,70,5.96,42,208,2192,9.5
1829,B.J. Crombeen,2010-11,25.0,4,2,8,8,0,2,2,9.0,53.0,8,0,2,2,9.0,82,5.44,62,351,2383,9.4
1830,B.J. Crombeen,2011-12,26.0,5,22,81,81,12,10,22,124.0,1031.0,89,12,12,24,133.0,82,5.7,65,341,2477,9.4
1831,B.J. Crombeen,2012-13,27.0,6,15,79,79,7,8,15,120.0,1033.0,168,19,20,39,253.0,82,5.53,56,304,2486,9.1
1832,B.J. Crombeen,2013-14,28.0,7,14,80,80,7,7,14,113.0,1024.0,248,26,27,53,366.0,82,5.46,52,291,2492,9.0
1833,B.J. Crombeen,2014-15,29.0,8,3,40,40,1,2,3,50.0,332.0,288,27,29,56,416.0,82,5.32,47,271,2439,8.9
1834,B.J. Crombeen,2015-16,30.0,9,8,44,44,1,7,8,50.0,488.0,332,28,36,64,466.0,48,5.31,29,160,1399,9.1
1835,B.J. Crombeen,2016-17,31.0,10,10,55,55,3,7,10,60.0,559.0,387,31,43,74,526.0,82,5.34,48,269,2463,8.9
1836,B.J. Crombeen,2017-18,32.0,11,6,58,58,3,3,6,43.0,469.0,445,34,46,80,569.0,82,5.32,47,251,2453,8.9
1837,B.J. Young,2002-03,25.0,4,0,1,1,0,0,0,1.0,1.0,1,0,0,0,1.0,82,5.49,53,331,2294,9.8
1838,Barclay Goodrow,2017-18,24.0,4,12,60,60,4,8,12,68.0,664.0,60,4,8,12,68.0,82,5.32,47,251,2453,8.9
1839,Barclay Goodrow,2018-19,25.0,5,3,14,14,0,3,3,7.0,144.0,74,4,11,15,75.0,82,5.34,48,255,2438,9.0
1840,Barclay Goodrow,2019-20,26.0,6,1,3,3,0,1,1,3.0,34.0,77,4,12,16,78.0,82,5.45,47,245,2478,9.0
1841,Barclay Goodrow,2020-21,27.0,7,14,47,47,7,7,14,57.0,512.0,124,11,19,30,135.0,82,5.86,50,250,2620,9.2
1842,Barclay Goodrow,2021-22,28.0,8,17,82,82,7,10,17,84.0,903.0,206,18,29,47,219.0,82,5.96,47,239,2579,9.5
1843,Barclay Goodrow,2022-23,29.0,9,26,70,70,8,18,26,102.0,1115.0,276,26,47,73,321.0,70,5.96,42,208,2192,9.5
1844,Barret Jackman,2004-05,23.0,4,0,1,1,0,0,0,1.0,19.0,1,0,0,0,1.0,82,5.24,53,338,2262,9.5
1845,Barret Jackman,2005-06,24.0,5,19,82,82,3,16,19,66.0,1644.0,83,3,16,19,67.0,82,5.31,60,363,2326,9.4
1846,Barret Jackman,2006-07,25.0,6,3,15,15,1,2,3,11.0,274.0,98,4,18,22,78.0,82,5.14,57,348,2300,9.2
1847,Barret Jackman,2008-09,27.0,7,10,63,63,4,6,10,56.0,1182.0,161,8,24,32,134.0,82,6.05,85,480,2458,10.1
1848,Barret Jackman,2009-10,28.0,8,27,70,70,3,24,27,86.0,1505.0,231,11,48,59,220.0,82,5.76,70,398,2426,9.7
1849,Barret Jackman,2010-11,29.0,9,16,78,78,2,14,16,80.0,1747.0,309,13,62,75,300.0,82,5.44,62,351,2383,9.4
1850,Barret Jackman,2011-12,30.0,10,21,82,82,4,17,21,89.0,1922.0,391,17,79,96,389.0,82,5.7,65,341,2477,9.4
1851,Barret Jackman,2012-13,31.0,11,17,66,66,2,15,17,73.0,1497.0,457,19,94,113,462.0,82,5.53,56,304,2486,9.1
1852,Barret Jackman,2013-14,32.0,12,13,60,60,0,13,13,65.0,1248.0,517,19,107,126,527.0,82,5.46,52,291,2492,9.0
1853,Barret Jackman,2014-15,33.0,13,13,81,81,1,12,13,82.0,1675.0,598,20,119,139,609.0,82,5.32,47,271,2439,8.9
1854,Barret Jackman,2015-16,34.0,14,12,46,46,3,9,12,39.0,889.0,644,23,128,151,648.0,48,5.31,29,160,1399,9.1
1855,Barret Jackman,2016-17,35.0,15,15,79,79,3,12,15,83.0,1416.0,723,26,140,166,731.0,82,5.34,48,269,2463,8.9
1856,Barret Jackman,2017-18,36.0,16,15,80,80,2,13,15,86.0,1345.0,803,28,153,181,817.0,82,5.32,47,251,2453,8.9
1857,Barret Jackman,2018-19,37.0,17,5,73,73,1,4,5,64.0,1012.0,876,29,157,186,881.0,82,5.34,48,255,2438,9.0
1858,Barrett Hayton,2022-23,22.0,4,4,20,20,1,3,4,27.0,223.0,20,1,3,4,27.0,70,5.96,42,208,2192,9.5
1859,Barrett Heisten,2004-05,24.0,4,0,10,10,0,0,0,7.0,76.0,10,0,0,0,7.0,82,5.24,53,338,2262,9.5
1860,Barrie Moore,1998-99,23.0,4,0,3,3,0,0,0,3.0,,3,0,0,0,3.0,82,6.29,74,413,2481,10.4
1861,Barrie Moore,1999-00,24.0,5,8,35,35,2,6,8,43.0,,38,2,6,8,46.0,82,5.83,55,336,2444,9.8
1862,Barrie Moore,2002-03,27.0,6,0,1,1,0,0,0,2.0,10.0,39,2,6,8,48.0,82,5.49,53,331,2294,9.8
1863,Barry Legge,1982-83,28.0,4,3,31,31,0,3,3,15.0,,31,0,3,3,15.0,80,7.03,61,280,2352,12.0
1864,Barry Legge,1983-84,29.0,5,6,38,38,0,6,6,14.0,,69,0,9,9,29.0,80,7.69,77,340,2441,12.6
1865,Barry Legge,1984-85,30.0,6,3,38,38,1,2,3,23.0,,107,1,11,12,52.0,80,8.03,73,320,2489,12.9
1866,Barry Melrose,1982-83,26.0,4,10,74,74,4,6,10,101.0,,74,4,6,10,101.0,80,7.03,61,280,2352,12.0
1867,Barry Melrose,1983-84,27.0,5,9,75,75,3,6,9,55.0,,149,7,12,19,156.0,80,7.69,77,340,2441,12.6
1868,Barry Melrose,1984-85,28.0,6,6,64,64,1,5,6,45.0,,213,8,17,25,201.0,80,8.03,73,320,2489,12.9
1869,Barry Melrose,1985-86,29.0,7,7,52,52,2,5,7,25.0,,265,10,22,32,226.0,80,7.73,71,310,2444,12.7
1870,Barry Melrose,1986-87,30.0,8,1,21,21,0,1,1,8.0,,286,10,23,33,234.0,80,7.89,74,336,2448,12.9
1871,Barry Melrose,1988-89,32.0,9,0,14,14,0,0,0,2.0,,300,10,23,33,236.0,80,7.94,82,370,2484,12.8
1872,Barry Nieckar,1995-96,28.0,4,0,2,2,0,0,0,1.0,,2,0,0,0,1.0,84,7.25,87,443,2603,11.7
1873,Barry Nieckar,1997-98,30.0,5,0,3,3,0,0,0,0.0,,5,0,0,0,1.0,48,5.97,37,209,1408,10.2
1874,Barry Nieckar,1999-00,32.0,6,0,2,2,0,0,0,0.0,,7,0,0,0,1.0,82,5.83,55,336,2444,9.8
1875,Barry Nieckar,2000-01,33.0,7,0,1,1,0,0,0,0.0,,8,0,0,0,1.0,82,5.28,57,380,2242,9.6
1876,Barry Pederson,1983-84,22.0,4,5,9,9,1,4,5,20.0,,9,1,4,5,20.0,80,7.69,77,340,2441,12.6
1877,Barry Pederson,1984-85,23.0,5,92,80,80,44,48,92,197.0,,89,45,52,97,217.0,80,8.03,73,320,2489,12.9
1878,Barry Pederson,1985-86,24.0,6,107,77,77,46,61,107,213.0,,166,91,113,204,430.0,80,7.73,71,310,2444,12.7
1879,Barry Pederson,1986-87,25.0,7,116,80,80,39,77,116,236.0,,246,130,190,320,666.0,80,7.89,74,336,2448,12.9
1880,Barry Pederson,1987-88,26.0,8,12,22,22,4,8,12,35.0,,268,134,198,332,701.0,80,7.77,71,321,2447,12.7
1881,Barry Pederson,1988-89,27.0,9,76,79,79,29,47,76,192.0,,347,163,245,408,893.0,80,7.94,82,370,2484,12.8
1882,Barry Pederson,1989-90,28.0,10,76,79,79,24,52,76,182.0,,426,187,297,484,1075.0,80,7.34,72,344,2400,12.2
1883,Barry Pederson,1990-91,29.0,11,71,76,76,19,52,71,163.0,,502,206,349,555,1238.0,80,7.43,89,437,2435,12.2
1884,Barry Pederson,1991-92,30.0,12,41,62,62,15,26,41,98.0,,564,221,375,596,1336.0,80,7.48,85,403,2430,12.3
1885,Barry Pederson,1992-93,31.0,13,31,54,54,6,25,31,80.0,,618,227,400,627,1416.0,80,7.37,76,367,2421,12.2
1886,Barry Pederson,1993-94,32.0,14,14,46,46,6,8,14,26.0,,664,233,408,641,1442.0,80,6.91,71,366,2385,11.6
1887,Barry Pederson,1994-95,33.0,15,13,37,37,5,8,13,47.0,,701,238,416,654,1489.0,80,6.96,77,402,2440,11.4
1888,Barry Potomski,1998-99,26.0,4,5,33,33,3,2,5,23.0,,33,3,2,5,23.0,82,6.29,74,413,2481,10.4
1889,Barry Potomski,1999-00,27.0,5,5,26,26,3,2,5,18.0,,59,6,4,10,41.0,82,5.83,55,336,2444,9.8
1890,Barry Potomski,2000-01,28.0,6,1,9,9,0,1,1,4.0,,68,6,5,11,45.0,82,5.28,57,380,2242,9.6
1891,Barry Richter,1998-99,28.0,4,1,4,4,0,1,1,3.0,,4,0,1,1,3.0,82,6.29,74,413,2481,10.4
1892,Barry Richter,1999-00,29.0,5,18,50,50,5,13,18,79.0,,54,5,14,19,82.0,82,5.83,55,336,2444,9.8
1893,Barry Richter,2001-02,31.0,6,24,72,72,6,18,24,111.0,1522.0,126,11,32,43,193.0,82,5.27,57,359,2285,9.4
1894,Barry Richter,2002-03,32.0,7,2,23,23,0,2,2,13.0,282.0,149,11,34,45,206.0,82,5.49,53,331,2294,9.8
1895,Barry Richter,2003-04,33.0,8,0,2,2,0,0,0,0.0,21.0,151,11,34,45,206.0,82,5.51,63,376,2272,9.9
1896,Barry Tallackson,2008-09,25.0,4,2,10,10,1,1,2,11.0,81.0,10,1,1,2,11.0,82,6.05,85,480,2458,10.1
1897,Barry Tallackson,2009-10,26.0,5,0,3,3,0,0,0,3.0,36.0,13,1,1,2,14.0,82,5.76,70,398,2426,9.7
1898,Barry Tallackson,2010-11,27.0,6,0,3,3,0,0,0,0.0,21.0,16,1,1,2,14.0,82,5.44,62,351,2383,9.4
1899,Barry Tallackson,2011-12,28.0,7,0,4,4,0,0,0,2.0,18.0,20,1,1,2,16.0,82,5.7,65,341,2477,9.4
1900,Basil McRae,1984-85,24.0,4,7,20,20,4,3,7,20.0,,20,4,3,7,20.0,80,8.03,73,320,2489,12.9
1901,Basil McRae,1985-86,25.0,5,2,22,22,1,1,2,6.0,,42,5,4,9,26.0,80,7.73,71,310,2444,12.7
1902,Basil McRae,1986-87,26.0,6,0,3,3,0,0,0,7.0,,45,5,4,9,33.0,80,7.89,74,336,2448,12.9
1903,Basil McRae,1987-88,27.0,7,0,1,1,0,0,0,0.0,,46,5,4,9,33.0,80,7.77,71,321,2447,12.7
1904,Basil McRae,1988-89,28.0,8,0,4,4,0,0,0,3.0,,50,5,4,9,36.0,80,7.94,82,370,2484,12.8
1905,Basil McRae,1989-90,29.0,9,18,69,69,11,7,18,56.0,,119,16,11,27,92.0,80,7.34,72,344,2400,12.2
1906,Basil McRae,1990-91,30.0,10,16,80,80,5,11,16,107.0,,199,21,22,43,199.0,80,7.43,89,437,2435,12.2
1907,Basil McRae,1991-92,31.0,11,31,78,78,12,19,31,122.0,,277,33,41,74,321.0,80,7.48,85,403,2430,12.3
1908,Basil McRae,1992-93,32.0,12,26,66,66,9,17,26,95.0,,343,42,58,100,416.0,80,7.37,76,367,2421,12.2
1909,Basil McRae,1993-94,33.0,13,4,40,40,1,3,4,44.0,,383,43,61,104,460.0,80,6.91,71,366,2385,11.6
1910,Basil McRae,1994-95,34.0,14,13,59,59,5,8,13,64.0,,442,48,69,117,524.0,80,6.96,77,402,2440,11.4
1911,Basil McRae,1995-96,35.0,15,9,47,47,3,6,9,45.0,,489,51,75,126,569.0,84,7.25,87,443,2603,11.7
1912,Basil McRae,1996-97,36.0,16,3,40,40,1,2,3,23.0,,529,52,77,129,592.0,84,6.48,76,407,2545,10.7
1913,Basil McRae,1997-98,37.0,17,5,21,21,0,5,5,14.0,,550,52,82,134,606.0,48,5.97,37,209,1408,10.2
1914,Basil McRae,1998-99,38.0,18,2,18,18,1,1,2,5.0,,568,53,83,136,611.0,82,6.29,74,413,2481,10.4
1915,Basil McRae,1999-00,39.0,19,0,8,8,0,0,0,1.0,,576,53,83,136,612.0,82,5.83,55,336,2444,9.8
1916,Bates Battaglia,2000-01,25.0,4,6,33,33,2,4,6,21.0,,33,2,4,6,21.0,82,5.28,57,380,2242,9.6
1917,Bates Battaglia,2001-02,26.0,5,18,60,60,7,11,18,52.0,593.0,93,9,15,24,73.0,82,5.27,57,359,2285,9.4
1918,Bates Battaglia,2002-03,27.0,6,34,77,77,16,18,34,86.0,1171.0,170,25,33,58,159.0,82,5.49,53,331,2294,9.8
1919,Bates Battaglia,2003-04,28.0,7,27,80,80,12,15,27,133.0,1157.0,250,37,48,85,292.0,82,5.51,63,376,2272,9.9
1920,Bates Battaglia,2004-05,29.0,8,46,82,82,21,25,46,167.0,1565.0,332,58,73,131,459.0,82,5.24,53,338,2262,9.5
1921,Bates Battaglia,2005-06,30.0,9,25,83,83,6,19,25,123.0,1505.0,415,64,92,156,582.0,82,5.31,60,363,2326,9.4
1922,Bates Battaglia,2006-07,31.0,10,11,70,70,4,7,11,70.0,943.0,485,68,99,167,652.0,82,5.14,57,348,2300,9.2
1923,Bates Battaglia,2009-10,34.0,11,31,82,82,12,19,31,94.0,1021.0,567,80,118,198,746.0,82,5.76,70,398,2426,9.7
1924,Bates Battaglia,2010-11,35.0,12,0,13,13,0,0,0,6.0,62.0,580,80,118,198,752.0,82,5.44,62,351,2383,9.4
1925,Beau Bennett,2015-16,24.0,4,14,26,26,3,11,14,30.0,320.0,26,3,11,14,30.0,48,5.31,29,160,1399,9.1
1926,Beau Bennett,2016-17,25.0,5,7,21,21,3,4,7,27.0,291.0,47,6,15,21,57.0,82,5.34,48,269,2463,8.9
1927,Beau Bennett,2017-18,26.0,6,12,49,49,4,8,12,81.0,612.0,96,10,23,33,138.0,82,5.32,47,251,2453,8.9
1928,Beau Bennett,2018-19,27.0,7,12,33,33,6,6,12,52.0,393.0,129,16,29,45,190.0,82,5.34,48,255,2438,9.0
1929,Beau Bennett,2019-20,28.0,8,19,65,65,8,11,19,101.0,881.0,194,24,40,64,291.0,82,5.45,47,245,2478,9.0
1930,Beau Bennett,2020-21,29.0,9,0,6,6,0,0,0,6.0,65.0,200,24,40,64,297.0,82,5.86,50,250,2620,9.2
1931,Beck Malenstyn,2022-23,24.0,4,0,3,3,0,0,0,4.0,28.0,3,0,0,0,4.0,70,5.96,42,208,2192,9.5
1932,Ben Chiarot,2016-17,25.0,4,0,1,1,0,0,0,0.0,11.0,1,0,0,0,0.0,82,5.34,48,269,2463,8.9
1933,Ben Chiarot,2017-18,26.0,5,8,40,40,2,6,8,37.0,681.0,41,2,6,8,37.0,82,5.32,47,251,2453,8.9
1934,Ben Chiarot,2018-19,27.0,6,10,70,70,1,9,10,74.0,1012.0,111,3,15,18,111.0,82,5.34,48,255,2438,9.0
1935,Ben Chiarot,2019-20,28.0,7,12,59,59,2,10,12,49.0,904.0,170,5,25,30,160.0,82,5.45,47,245,2478,9.0
1936,Ben Chiarot,2020-21,29.0,8,14,57,57,2,12,14,57.0,871.0,227,7,37,44,217.0,82,5.86,50,250,2620,9.2
1937,Ben Chiarot,2021-22,30.0,9,20,78,78,5,15,20,111.0,1452.0,305,12,52,64,328.0,82,5.96,47,239,2579,9.5
1938,Ben Chiarot,2022-23,31.0,10,21,69,69,9,12,21,130.0,1596.0,374,21,64,85,458.0,70,5.96,42,208,2192,9.5
1939,Ben Clymer,2002-03,24.0,4,8,60,60,2,6,8,98.0,1177.0,60,2,6,8,98.0,82,5.49,53,331,2294,9.8
1940,Ben Clymer,2003-04,25.0,5,6,23,23,5,1,6,25.0,300.0,83,7,7,14,123.0,82,5.51,63,376,2272,9.9
1941,Ben Clymer,2004-05,26.0,6,34,81,81,14,20,34,151.0,1412.0,164,21,27,48,274.0,82,5.24,53,338,2262,9.5
1942,Ben Clymer,2005-06,27.0,7,18,65,65,6,12,18,103.0,887.0,229,27,39,66,377.0,82,5.31,60,363,2326,9.4
1943,Ben Clymer,2006-07,28.0,8,10,66,66,2,8,10,96.0,647.0,295,29,47,76,473.0,82,5.14,57,348,2300,9.2
1944,Ben Clymer,2008-09,30.0,9,33,77,77,16,17,33,149.0,1091.0,372,45,64,109,622.0,82,6.05,85,480,2458,10.1
1945,Ben Clymer,2009-10,31.0,10,20,66,66,7,13,20,78.0,920.0,438,52,77,129,700.0,82,5.76,70,398,2426,9.7
1946,Ben Eager,2008-09,25.0,4,8,25,25,3,5,8,21.0,185.0,25,3,5,8,21.0,82,6.05,85,480,2458,10.1
1947,Ben Eager,2009-10,26.0,5,11,63,63,6,5,11,48.0,519.0,88,9,10,19,69.0,82,5.76,70,398,2426,9.7
1948,Ben Eager,2010-11,27.0,6,2,32,32,0,2,2,16.0,186.0,120,9,12,21,85.0,82,5.44,62,351,2383,9.4
1949,Ben Eager,2011-12,28.0,7,15,75,75,11,4,15,80.0,639.0,195,20,16,36,165.0,82,5.7,65,341,2477,9.4
1950,Ben Eager,2012-13,29.0,8,16,60,60,7,9,16,68.0,500.0,255,27,25,52,233.0,82,5.53,56,304,2486,9.1
1951,Ben Eager,2013-14,30.0,9,17,68,68,7,10,17,84.0,723.0,323,34,35,69,317.0,82,5.46,52,291,2492,9.0
1952,Ben Eager,2014-15,31.0,10,13,63,63,8,5,13,69.0,538.0,386,42,40,82,386.0,82,5.32,47,271,2439,8.9
1953,Ben Eager,2015-16,32.0,11,2,14,14,1,1,2,14.0,135.0,400,43,41,84,400.0,48,5.31,29,160,1399,9.1
1954,Ben Eager,2016-17,33.0,12,1,7,7,0,1,1,4.0,51.0,407,43,42,85,404.0,82,5.34,48,269,2463,8.9
1955,Ben Gleason,2021-22,23.0,4,1,4,4,0,1,1,2.0,60.0,4,0,1,1,2.0,82,5.96,47,239,2579,9.5
1956,Ben Guite,2008-09,30.0,4,0,1,1,0,0,0,2.0,9.0,1,0,0,0,2.0,82,6.05,85,480,2458,10.1
1957,Ben Guite,2009-10,31.0,5,11,39,39,3,8,11,63.0,479.0,40,3,8,11,65.0,82,5.76,70,398,2426,9.7
1958,Ben Guite,2010-11,32.0,6,22,79,79,11,11,22,103.0,1033.0,119,14,19,33,168.0,82,5.44,62,351,2383,9.4
1959,Ben Guite,2011-12,33.0,7,12,50,50,5,7,12,63.0,636.0,169,19,26,45,231.0,82,5.7,65,341,2477,9.4
1960,Ben Guite,2012-13,34.0,8,0,6,6,0,0,0,5.0,51.0,175,19,26,45,236.0,82,5.53,56,304,2486,9.1
1961,Ben Hankinson,1995-96,26.0,4,3,4,4,2,1,3,3.0,,4,2,1,3,3.0,84,7.25,87,443,2603,11.7
1962,Ben Hankinson,1996-97,27.0,5,1,13,13,1,0,1,14.0,,17,3,1,4,17.0,84,6.48,76,407,2545,10.7
1963,Ben Hankinson,1997-98,28.0,6,2,26,26,0,2,2,26.0,,43,3,3,6,43.0,48,5.97,37,209,1408,10.2
1964,Ben Hanowski,2015-16,25.0,4,1,5,5,1,0,1,4.0,66.0,5,1,0,1,4.0,48,5.31,29,160,1399,9.1
1965,Ben Hanowski,2016-17,26.0,5,2,11,11,0,2,2,10.0,80.0,16,1,2,3,14.0,82,5.34,48,269,2463,8.9
1966,Ben Harpur,2018-19,24.0,4,1,5,5,0,1,1,3.0,68.0,5,0,1,1,3.0,82,5.34,48,255,2438,9.0
1967,Ben Harpur,2019-20,25.0,5,0,6,6,0,0,0,3.0,107.0,11,0,1,1,6.0,82,5.45,47,245,2478,9.0
1968,Ben Harpur,2020-21,26.0,6,1,41,41,0,1,1,26.0,610.0,52,0,2,2,32.0,82,5.86,50,250,2620,9.2
1969,Ben Harpur,2021-22,27.0,7,5,51,51,1,4,5,50.0,899.0,103,1,6,7,82.0,82,5.96,47,239,2579,9.5
1970,Ben Holmstrom,2013-14,26.0,4,0,2,2,0,0,0,0.0,18.0,2,0,0,0,0.0,82,5.46,52,291,2492,9.0
1971,Ben Holmstrom,2014-15,27.0,5,0,5,5,0,0,0,3.0,34.0,7,0,0,0,3.0,82,5.32,47,271,2439,8.9
1972,Ben Hutton,2018-19,25.0,4,25,75,75,1,24,25,104.0,1491.0,75,1,24,25,104.0,82,5.34,48,255,2438,9.0
1973,Ben Hutton,2019-20,26.0,5,19,71,71,5,14,19,130.0,1455.0,146,6,38,44,234.0,82,5.45,47,245,2478,9.0
1974,Ben Hutton,2020-21,27.0,6,6,61,61,0,6,6,103.0,1123.0,207,6,44,50,337.0,82,5.86,50,250,2620,9.2
1975,Ben Hutton,2021-22,28.0,7,20,69,69,5,15,20,114.0,1543.0,276,11,59,70,451.0,82,5.96,47,239,2579,9.5
1976,Ben Hutton,2022-23,29.0,8,16,65,65,4,12,16,114.0,1187.0,341,15,71,86,565.0,70,5.96,42,208,2192,9.5
1977,Ben Lovejoy,2011-12,27.0,4,0,2,2,0,0,0,1.0,24.0,2,0,0,0,1.0,82,5.7,65,341,2477,9.4
1978,Ben Lovejoy,2012-13,28.0,5,3,12,12,0,3,3,14.0,199.0,14,0,3,3,15.0,82,5.53,56,304,2486,9.1
1979,Ben Lovejoy,2013-14,29.0,6,17,47,47,3,14,17,60.0,705.0,61,3,17,20,75.0,82,5.46,52,291,2492,9.0
1980,Ben Lovejoy,2014-15,30.0,7,5,34,34,1,4,5,48.0,451.0,95,4,21,25,123.0,82,5.32,47,271,2439,8.9
1981,Ben Lovejoy,2015-16,31.0,8,10,35,35,0,10,10,58.0,624.0,130,4,31,35,181.0,48,5.31,29,160,1399,9.1
1982,Ben Lovejoy,2016-17,32.0,9,18,78,78,5,13,18,107.0,1513.0,208,9,44,53,288.0,82,5.34,48,269,2463,8.9
1983,Ben Lovejoy,2017-18,33.0,10,14,60,60,2,12,14,86.0,1166.0,268,11,56,67,374.0,82,5.32,47,251,2453,8.9
1984,Ben Lovejoy,2018-19,34.0,11,10,66,66,4,6,10,90.0,1245.0,334,15,62,77,464.0,82,5.34,48,255,2438,9.0
1985,Ben Lovejoy,2019-20,35.0,12,7,82,82,1,6,7,84.0,1703.0,416,16,68,84,548.0,82,5.45,47,245,2478,9.0
1986,Ben Lovejoy,2020-21,36.0,13,8,57,57,2,6,8,74.0,946.0,473,18,74,92,622.0,82,5.86,50,250,2620,9.2
1987,Ben Lovejoy,2021-22,37.0,14,9,71,71,2,7,9,95.0,1213.0,544,20,81,101,717.0,82,5.96,47,239,2579,9.5
1988,Ben Maxwell,2011-12,23.0,4,0,7,7,0,0,0,2.0,69.0,7,0,0,0,2.0,82,5.7,65,341,2477,9.4
1989,Ben Maxwell,2012-13,24.0,5,0,13,13,0,0,0,6.0,114.0,20,0,0,0,8.0,82,5.53,56,304,2486,9.1
1990,Ben Maxwell,2013-14,25.0,6,2,12,12,1,1,2,13.0,144.0,32,1,1,2,21.0,82,5.46,52,291,2492,9.0
1991,Ben Maxwell,2014-15,26.0,7,6,15,15,1,5,6,10.0,101.0,47,2,6,8,31.0,82,5.32,47,271,2439,8.9
1992,Ben Ondrus,2008-09,26.0,4,0,22,22,0,0,0,17.0,223.0,22,0,0,0,17.0,82,6.05,85,480,2458,10.1
1993,Ben Ondrus,2009-10,27.0,5,2,16,16,0,2,2,7.0,78.0,38,0,2,2,24.0,82,5.76,70,398,2426,9.7
1994,Ben Ondrus,2010-11,28.0,6,0,3,3,0,0,0,4.0,15.0,41,0,2,2,28.0,82,5.44,62,351,2383,9.4
1995,Ben Ondrus,2011-12,29.0,7,0,11,11,0,0,0,2.0,104.0,52,0,2,2,30.0,82,5.7,65,341,2477,9.4
1996,Ben Sexton,2020-21,29.0,4,0,2,2,0,0,0,1.0,21.0,2,0,0,0,1.0,82,5.86,50,250,2620,9.2
1997,Ben Simon,2004-05,26.0,4,0,6,6,0,0,0,7.0,56.0,6,0,0,0,7.0,82,5.24,53,338,2262,9.5
1998,Ben Simon,2005-06,27.0,5,1,10,10,0,1,1,7.0,94.0,16,0,1,1,14.0,82,5.31,60,363,2326,9.4
1999,Ben Simon,2006-07,28.0,6,3,52,52,3,0,3,30.0,316.0,68,3,1,4,44.0,82,5.14,57,348,2300,9.2
2000,Ben Simon,2008-09,30.0,7,0,13,13,0,0,0,7.0,73.0,81,3,1,4,51.0,82,6.05,85,480,2458,10.1
2001,Ben Smith,2013-14,25.0,4,1,6,6,1,0,1,6.0,83.0,6,1,0,1,6.0,82,5.46,52,291,2492,9.0
2002,Ben Smith,2014-15,26.0,5,2,13,13,2,0,2,18.0,128.0,19,3,0,3,24.0,82,5.32,47,271,2439,8.9
2003,Ben Smith,2015-16,27.0,6,1,1,1,1,0,1,1.0,18.0,20,4,0,4,25.0,48,5.31,29,160,1399,9.1
2004,Ben Smith,2016-17,28.0,7,26,75,75,14,12,26,90.0,955.0,95,18,12,30,115.0,82,5.34,48,269,2463,8.9
2005,Ben Smith,2017-18,29.0,8,14,80,80,7,7,14,92.0,1044.0,175,25,19,44,207.0,82,5.32,47,251,2453,8.9
2006,Ben Smith,2018-19,30.0,9,6,22,22,2,4,6,17.0,266.0,197,27,23,50,224.0,82,5.34,48,255,2438,9.0
2007,Ben Smith,2019-20,31.0,10,4,40,40,2,2,4,30.0,459.0,237,29,25,54,254.0,82,5.45,47,245,2478,9.0
2008,Ben Street,2015-16,28.0,4,1,6,6,0,1,1,13.0,82.0,6,0,1,1,13.0,48,5.31,29,160,1399,9.1
2009,Ben Street,2016-17,29.0,5,1,13,13,0,1,1,17.0,138.0,19,0,2,2,30.0,82,5.34,48,269,2463,8.9
2010,Ben Street,2017-18,30.0,6,0,3,3,0,0,0,4.0,35.0,22,0,2,2,34.0,82,5.32,47,251,2453,8.9
2011,Ben Street,2018-19,31.0,7,0,7,7,0,0,0,8.0,51.0,29,0,2,2,42.0,82,5.34,48,255,2438,9.0
2012,Ben Street,2019-20,32.0,8,1,6,6,0,1,1,8.0,50.0,35,0,3,3,50.0,82,5.45,47,245,2478,9.0
2013,Ben Street,2021-22,34.0,9,5,21,21,3,2,5,19.0,253.0,56,3,5,8,69.0,82,5.96,47,239,2579,9.5
2014,Ben Street,2022-23,35.0,10,1,3,3,0,1,1,4.0,24.0,59,3,6,9,73.0,70,5.96,42,208,2192,9.5
2015,Ben Thomson,2019-20,27.0,4,0,3,3,0,0,0,7.0,33.0,3,0,0,0,7.0,82,5.45,47,245,2478,9.0
2016,Ben Walter,2008-09,24.0,4,0,6,6,0,0,0,6.0,71.0,6,0,0,0,6.0,82,6.05,85,480,2458,10.1
2017,Ben Walter,2009-10,25.0,5,0,4,4,0,0,0,0.0,25.0,10,0,0,0,6.0,82,5.76,70,398,2426,9.7
2018,Ben Walter,2010-11,26.0,6,1,8,8,1,0,1,6.0,49.0,18,1,0,1,12.0,82,5.44,62,351,2383,9.4
2019,Ben Walter,2011-12,27.0,7,0,4,4,0,0,0,2.0,44.0,22,1,0,1,14.0,82,5.7,65,341,2477,9.4
2020,Ben Walter,2012-13,28.0,8,0,2,2,0,0,0,0.0,12.0,24,1,0,1,14.0,82,5.53,56,304,2486,9.1
2021,Bengt Lundholm,1984-85,29.0,4,44,66,66,14,30,44,99.0,,66,14,30,44,99.0,80,8.03,73,320,2489,12.9
2022,Bengt Lundholm,1985-86,30.0,5,42,58,58,14,28,42,60.0,,124,28,58,86,159.0,80,7.73,71,310,2444,12.7
2023,Bengt Lundholm,1986-87,31.0,6,19,57,57,5,14,19,48.0,,181,33,72,105,207.0,80,7.89,74,336,2448,12.9
2024,Bengt Lundholm,1987-88,32.0,7,30,78,78,12,18,30,59.0,,259,45,90,135,266.0,80,7.77,71,321,2447,12.7
2025,Bengt Lundholm,1988-89,33.0,8,8,16,16,3,5,8,14.0,,275,48,95,143,280.0,80,7.94,82,370,2484,12.8
2026,Bengt-Ake Gustafsson,1982-83,24.0,4,60,80,80,22,38,60,185.0,,80,22,38,60,185.0,80,7.03,61,280,2352,12.0
2027,Bengt-Ake Gustafsson,1983-84,25.0,5,55,72,72,21,34,55,170.0,,152,43,72,115,355.0,80,7.69,77,340,2441,12.6
2028,Bengt-Ake Gustafsson,1984-85,26.0,6,60,70,70,26,34,60,144.0,,222,69,106,175,499.0,80,8.03,73,320,2489,12.9
2029,Bengt-Ake Gustafsson,1985-86,27.0,7,64,67,67,22,42,64,138.0,,289,91,148,239,637.0,80,7.73,71,310,2444,12.7
2030,Bengt-Ake Gustafsson,1986-87,28.0,8,75,69,69,32,43,75,146.0,,358,123,191,314,783.0,80,7.89,74,336,2448,12.9
2031,Bengt-Ake Gustafsson,1987-88,29.0,9,42,51,51,13,29,42,98.0,,409,136,220,356,881.0,80,7.77,71,321,2447,12.7
2032,Bengt-Ake Gustafsson,1988-89,30.0,10,75,70,70,23,52,75,113.0,,479,159,272,431,994.0,80,7.94,82,370,2484,12.8
2033,Bengt-Ake Gustafsson,1990-91,32.0,11,54,78,78,18,36,54,136.0,,557,177,308,485,1130.0,80,7.43,89,437,2435,12.2
2034,Bengt-Ake Gustafsson,1991-92,33.0,12,69,72,72,18,51,69,107.0,,629,195,359,554,1237.0,80,7.48,85,403,2430,12.3
2035,Benn Ferriero,2012-13,25.0,4,5,24,24,2,3,5,42.0,267.0,24,2,3,5,42.0,82,5.53,56,304,2486,9.1
2036,Benn Ferriero,2013-14,26.0,5,9,33,33,5,4,9,56.0,432.0,57,7,7,14,98.0,82,5.46,52,291,2492,9.0
2037,Benn Ferriero,2014-15,27.0,6,8,35,35,7,1,8,68.0,422.0,92,14,8,22,166.0,82,5.32,47,271,2439,8.9
2038,Benn Ferriero,2015-16,28.0,7,1,4,4,0,1,1,4.0,38.0,96,14,9,23,170.0,48,5.31,29,160,1399,9.1
2039,Benn Ferriero,2016-17,29.0,8,0,2,2,0,0,0,0.0,9.0,98,14,9,23,170.0,82,5.34,48,269,2463,8.9
2040,Bennett Wolf,1983-84,24.0,4,1,24,24,0,1,1,14.0,,24,0,1,1,14.0,80,7.69,77,340,2441,12.6
2041,Bennett Wolf,1984-85,25.0,5,0,1,1,0,0,0,0.0,,25,0,1,1,14.0,80,8.03,73,320,2489,12.9
2042,Bennett Wolf,1985-86,26.0,6,0,5,5,0,0,0,4.0,,30,0,1,1,18.0,80,7.73,71,310,2444,12.7
2043,Benoit Brunet,1991-92,23.0,4,1,2,2,0,1,1,1.0,,2,0,1,1,1.0,80,7.48,85,403,2430,12.3
2044,Benoit Brunet,1993-94,25.0,5,4,17,17,1,3,4,12.0,,19,1,4,5,13.0,80,6.91,71,366,2385,11.6
2045,Benoit Brunet,1994-95,26.0,6,10,18,18,4,6,10,37.0,,37,5,10,15,50.0,80,6.96,77,402,2440,11.4
2046,Benoit Brunet,1995-96,27.0,7,25,47,47,10,15,25,71.0,,84,15,25,40,121.0,84,7.25,87,443,2603,11.7
2047,Benoit Brunet,1996-97,28.0,8,30,71,71,10,20,30,92.0,,155,25,45,70,213.0,84,6.48,76,407,2545,10.7
2048,Benoit Brunet,1997-98,29.0,9,25,45,45,7,18,25,80.0,,200,32,63,95,293.0,48,5.97,37,209,1408,10.2
2049,Benoit Brunet,1998-99,30.0,10,15,26,26,7,8,15,48.0,,226,39,71,110,341.0,82,6.29,74,413,2481,10.4
2050,Benoit Brunet,1999-00,31.0,11,23,39,39,10,13,23,63.0,,265,49,84,133,404.0,82,5.83,55,336,2444,9.8
2051,Benoit Brunet,2000-01,32.0,12,32,68,68,12,20,32,87.0,,333,61,104,165,491.0,82,5.28,57,380,2242,9.6
2052,Benoit Brunet,2001-02,33.0,13,31,60,60,14,17,31,115.0,1067.0,393,75,121,196,606.0,82,5.27,57,359,2285,9.4
2053,Benoit Brunet,2002-03,34.0,14,29,50,50,14,15,29,103.0,899.0,443,89,136,225,709.0,82,5.49,53,331,2294,9.8
2054,Benoit Brunet,2003-04,35.0,15,14,35,35,3,11,14,61.0,583.0,478,92,147,239,770.0,82,5.51,63,376,2272,9.9
2055,Benoit Brunet,2004-05,36.0,16,23,61,61,9,14,23,72.0,847.0,539,101,161,262,842.0,82,5.24,53,338,2262,9.5
2056,Benoit Dusablon,2006-07,27.0,4,0,3,3,0,0,0,3.0,25.0,3,0,0,0,3.0,82,5.14,57,348,2300,9.2
2057,Benoit Gratton,2000-01,24.0,4,1,6,6,0,1,1,5.0,,6,0,1,1,5.0,82,5.28,57,380,2242,9.6
2058,Benoit Gratton,2001-02,25.0,5,7,16,16,4,3,7,24.0,215.0,22,4,4,8,29.0,82,5.27,57,359,2285,9.4
2059,Benoit Gratton,2002-03,26.0,6,2,10,10,0,2,2,4.0,83.0,32,4,6,10,33.0,82,5.49,53,331,2294,9.8
2060,Benoit Gratton,2003-04,27.0,7,4,14,14,1,3,4,13.0,129.0,46,5,9,14,46.0,82,5.51,63,376,2272,9.9
2061,Benoit Gratton,2004-05,28.0,8,1,8,8,1,0,1,8.0,79.0,54,6,9,15,54.0,82,5.24,53,338,2262,9.5
2062,Benoit Gratton,2006-07,30.0,9,1,4,4,0,1,1,3.0,39.0,58,6,10,16,57.0,82,5.14,57,348,2300,9.2
2063,Benoit Hogue,1990-91,24.0,4,2,3,3,1,1,2,3.0,,3,1,1,2,3.0,80,7.43,89,437,2435,12.2
2064,Benoit Hogue,1991-92,25.0,5,44,69,69,14,30,44,114.0,,72,15,31,46,117.0,80,7.48,85,403,2430,12.3
2065,Benoit Hogue,1992-93,26.0,6,18,45,45,11,7,18,73.0,,117,26,38,64,190.0,80,7.37,76,367,2421,12.2
2066,Benoit Hogue,1993-94,27.0,7,47,76,76,19,28,47,134.0,,193,45,66,111,324.0,80,6.91,71,366,2385,11.6
2067,Benoit Hogue,1994-95,28.0,8,76,75,75,30,46,76,149.0,,268,75,112,187,473.0,80,6.96,77,402,2440,11.4
2068,Benoit Hogue,1995-96,29.0,9,75,70,70,33,42,75,147.0,,338,108,154,262,620.0,84,7.25,87,443,2603,11.7
2069,Benoit Hogue,1996-97,30.0,10,69,83,83,36,33,69,218.0,,421,144,187,331,838.0,84,6.48,76,407,2545,10.7
2070,Benoit Hogue,1997-98,31.0,11,16,45,45,9,7,16,66.0,,466,153,194,347,904.0,48,5.97,37,209,1408,10.2
2071,Benoit Hogue,1998-99,32.0,12,64,78,78,19,45,64,155.0,,544,172,239,411,1059.0,82,6.29,74,413,2481,10.4
2072,Benoit Hogue,1999-00,33.0,13,43,73,73,19,24,43,131.0,,617,191,263,454,1190.0,82,5.83,55,336,2444,9.8
2073,Benoit Hogue,2000-01,34.0,14,22,53,53,6,16,22,55.0,,670,197,279,476,1245.0,82,5.28,57,380,2242,9.6
2074,Benoit Hogue,2001-02,35.0,15,29,74,74,12,17,29,121.0,1197.0,744,209,296,505,1366.0,82,5.27,57,359,2285,9.4
2075,Benoit Hogue,2002-03,36.0,16,13,27,27,3,10,13,39.0,425.0,771,212,306,518,1405.0,82,5.49,53,331,2294,9.8
2076,Benoit Hogue,2003-04,37.0,17,10,34,34,3,7,10,35.0,424.0,805,215,313,528,1440.0,82,5.51,63,376,2272,9.9
2077,Benoit Hogue,2004-05,38.0,18,15,58,58,7,8,15,42.0,651.0,863,222,321,543,1482.0,82,5.24,53,338,2262,9.5
2078,Benoit Pouliot,2009-10,23.0,4,0,3,3,0,0,0,1.0,21.0,3,0,0,0,1.0,82,5.76,70,398,2426,9.7
2079,Benoit Pouliot,2010-11,24.0,5,3,11,11,2,1,3,10.0,97.0,14,2,1,3,11.0,82,5.44,62,351,2383,9.4
2080,Benoit Pouliot,2011-12,25.0,6,11,37,37,5,6,11,34.0,438.0,51,7,7,14,45.0,82,5.7,65,341,2477,9.4
2081,Benoit Pouliot,2012-13,26.0,7,28,53,53,17,11,28,111.0,820.0,104,24,18,42,156.0,82,5.53,56,304,2486,9.1
2082,Benoit Pouliot,2013-14,27.0,8,30,79,79,13,17,30,129.0,911.0,183,37,35,72,285.0,82,5.46,52,291,2492,9.0
2083,Benoit Pouliot,2014-15,28.0,9,32,74,74,16,16,32,107.0,904.0,257,53,51,104,392.0,82,5.32,47,271,2439,8.9
2084,Benoit Pouliot,2015-16,29.0,10,20,34,34,8,12,20,60.0,450.0,291,61,63,124,452.0,48,5.31,29,160,1399,9.1
2085,Benoit Pouliot,2016-17,30.0,11,36,80,80,15,21,36,141.0,1075.0,371,76,84,160,593.0,82,5.34,48,269,2463,8.9
2086,Benoit Pouliot,2017-18,31.0,12,34,58,58,19,15,34,105.0,964.0,429,95,99,194,698.0,82,5.32,47,251,2453,8.9
2087,Benoit Pouliot,2018-19,32.0,13,36,55,55,14,22,36,109.0,883.0,484,109,121,230,807.0,82,5.34,48,255,2438,9.0
2088,Benoit Pouliot,2019-20,33.0,14,14,67,67,8,6,14,77.0,942.0,551,117,127,244,884.0,82,5.45,47,245,2478,9.0
2089,Benoit Pouliot,2020-21,34.0,15,19,74,74,13,6,19,83.0,1013.0,625,130,133,263,967.0,82,5.86,50,250,2620,9.2
2090,Bernie Johnston,1982-83,26.0,4,21,32,32,8,13,21,54.0,,32,8,13,21,54.0,80,7.03,61,280,2352,12.0
2091,Bernie Johnston,1983-84,27.0,5,15,25,25,4,11,15,34.0,,57,12,24,36,88.0,80,7.69,77,340,2441,12.6
2092,Bernie Nicholls,1984-85,23.0,4,32,22,22,14,18,32,63.0,,22,14,18,32,63.0,80,8.03,73,320,2489,12.9
2093,Bernie Nicholls,1985-86,24.0,5,50,71,71,28,22,50,171.0,,93,42,40,82,234.0,80,7.73,71,310,2444,12.7
2094,Bernie Nicholls,1986-87,25.0,6,95,78,78,41,54,95,255.0,,171,83,94,177,489.0,80,7.89,74,336,2448,12.9
2095,Bernie Nicholls,1987-88,26.0,7,100,80,80,46,54,100,329.0,,251,129,148,277,818.0,80,7.77,71,321,2447,12.7
2096,Bernie Nicholls,1988-89,27.0,8,97,80,80,36,61,97,281.0,,331,165,209,374,1099.0,80,7.94,82,370,2484,12.8
2097,Bernie Nicholls,1989-90,28.0,9,81,80,80,33,48,81,227.0,,411,198,257,455,1326.0,80,7.34,72,344,2400,12.2
2098,Bernie Nicholls,1990-91,29.0,10,78,65,65,32,46,78,236.0,,476,230,303,533,1562.0,80,7.43,89,437,2435,12.2
2099,Bernie Nicholls,1991-92,30.0,11,150,79,79,70,80,150,385.0,,555,300,383,683,1947.0,80,7.48,85,403,2430,12.3
2100,Bernie Nicholls,1992-93,31.0,12,112,79,79,39,73,112,287.0,,634,339,456,795,2234.0,80,7.37,76,367,2421,12.2
2101,Bernie Nicholls,1993-94,32.0,13,73,71,71,25,48,73,163.0,,705,364,504,868,2397.0,80,6.91,71,366,2385,11.6
2102,Bernie Nicholls,1994-95,33.0,14,49,50,50,20,29,49,117.0,,755,384,533,917,2514.0,80,6.96,77,402,2440,11.4
2103,Bernie Nicholls,1995-96,34.0,15,60,69,69,13,47,60,132.0,,824,397,580,977,2646.0,84,7.25,87,443,2603,11.7
2104,Bernie Nicholls,1996-97,35.0,16,46,61,61,19,27,46,142.0,,885,416,607,1023,2788.0,84,6.48,76,407,2545,10.7
2105,Bernie Nicholls,1997-98,36.0,17,51,48,48,22,29,51,114.0,,933,438,636,1074,2902.0,48,5.97,37,209,1408,10.2
2106,Bernie Nicholls,1998-99,37.0,18,60,59,59,19,41,60,100.0,,992,457,677,1134,3002.0,82,6.29,74,413,2481,10.4
2107,Bernie Nicholls,1999-00,38.0,19,45,65,65,12,33,45,137.0,,1057,469,710,1179,3139.0,82,5.83,55,336,2444,9.8
2108,Bernie Nicholls,2000-01,39.0,20,28,60,60,6,22,28,81.0,,1117,475,732,1207,3220.0,82,5.28,57,380,2242,9.6
2109,Bernie Nicholls,2001-02,40.0,21,2,10,10,0,2,2,11.0,110.0,1127,475,734,1209,3231.0,82,5.27,57,359,2285,9.4
2110,Bernie Saunders,1982-83,26.0,4,0,4,4,0,0,0,4.0,,4,0,0,0,4.0,80,7.03,61,280,2352,12.0
2111,Bernie Saunders,1983-84,27.0,5,1,6,6,0,1,1,5.0,,10,0,1,1,9.0,80,7.69,77,340,2441,12.6
2112,Bert Robertsson,2000-01,26.0,4,6,30,30,2,4,6,19.0,,30,2,4,6,19.0,82,5.28,57,380,2242,9.6
2113,Bert Robertsson,2001-02,27.0,5,4,39,39,2,2,4,13.0,290.0,69,4,6,10,32.0,82,5.27,57,359,2285,9.4
2114,Bert Robertsson,2002-03,28.0,6,4,52,52,0,4,4,31.0,562.0,121,4,10,14,63.0,82,5.49,53,331,2294,9.8
2115,Bert Robertsson,2003-04,29.0,7,0,2,2,0,0,0,0.0,11.0,123,4,10,14,63.0,82,5.51,63,376,2272,9.9
2116,Bill Armstrong,1993-94,27.0,4,1,1,1,0,1,1,1.0,,1,0,1,1,1.0,80,6.91,71,366,2385,11.6
2117,Bill Arnold,2016-17,24.0,4,0,1,1,0,0,0,0.0,14.0,1,0,0,0,0.0,82,5.34,48,269,2463,8.9
2118,Bill Baker,1983-84,27.0,4,3,24,24,0,3,3,25.0,,24,0,3,3,25.0,80,7.69,77,340,2441,12.6
2119,Bill Baker,1984-85,28.0,5,11,49,49,3,8,11,55.0,,73,3,11,14,80.0,80,8.03,73,320,2489,12.9
2120,Bill Baker,1985-86,29.0,6,18,70,70,4,14,18,65.0,,143,7,25,32,145.0,80,7.73,71,310,2444,12.7
2121,Bill Berg,1991-92,24.0,4,3,7,7,1,2,3,10.0,,7,1,2,3,10.0,80,7.48,85,403,2430,12.3
2122,Bill Berg,1993-94,26.0,5,23,78,78,9,14,23,95.0,,85,10,16,26,105.0,80,6.91,71,366,2385,11.6
2123,Bill Berg,1994-95,27.0,6,14,47,47,5,9,14,60.0,,132,15,25,40,165.0,80,6.96,77,402,2440,11.4
2124,Bill Berg,1995-96,28.0,7,24,80,80,13,11,24,113.0,,212,28,36,64,278.0,84,7.25,87,443,2603,11.7
2125,Bill Berg,1996-97,29.0,8,19,83,83,8,11,19,99.0,,295,36,47,83,377.0,84,6.48,76,407,2545,10.7
2126,Bill Berg,1997-98,30.0,9,6,32,32,5,1,6,57.0,,327,41,48,89,434.0,48,5.97,37,209,1408,10.2
2127,Bill Berg,1998-99,31.0,10,5,41,41,3,2,5,60.0,,368,44,50,94,494.0,82,6.29,74,413,2481,10.4
2128,Bill Berg,1999-00,32.0,11,14,67,67,8,6,14,84.0,,435,52,56,108,578.0,82,5.83,55,336,2444,9.8
2129,Bill Berg,2000-01,33.0,12,10,67,67,1,9,10,74.0,,502,53,65,118,652.0,82,5.28,57,380,2242,9.6
2130,Bill Berg,2001-02,34.0,13,4,44,44,2,2,4,40.0,455.0,546,55,67,122,692.0,82,5.27,57,359,2285,9.4
2131,Bill Bowler,2003-04,29.0,4,2,9,9,0,2,2,3.0,88.0,9,0,2,2,3.0,82,5.51,63,376,2272,9.9
2132,Bill Gardner,1983-84,23.0,4,0,1,1,0,0,0,0.0,,1,0,0,0,0.0,80,7.69,77,340,2441,12.6
2133,Bill Gardner,1984-85,24.0,5,23,69,69,8,15,23,66.0,,70,8,15,23,66.0,80,8.03,73,320,2489,12.9
2134,Bill Gardner,1985-86,25.0,6,40,77,77,15,25,40,105.0,,147,23,40,63,171.0,80,7.73,71,310,2444,12.7
2135,Bill Gardner,1986-87,26.0,7,48,79,79,27,21,48,115.0,,226,50,61,111,286.0,80,7.89,74,336,2448,12.9
2136,Bill Gardner,1987-88,27.0,8,51,74,74,17,34,51,119.0,,300,67,95,162,405.0,80,7.77,71,321,2447,12.7
2137,Bill Gardner,1988-89,28.0,9,22,64,64,4,18,22,41.0,,364,71,113,184,446.0,80,7.94,82,370,2484,12.8
2138,Bill Gardner,1989-90,29.0,10,1,8,8,0,1,1,7.0,,372,71,114,185,453.0,80,7.34,72,344,2400,12.2
2139,Bill Gardner,1990-91,30.0,11,1,2,2,1,0,1,1.0,,374,72,114,186,454.0,80,7.43,89,437,2435,12.2
2140,Bill Gardner,1991-92,31.0,12,2,6,6,1,1,2,4.0,,380,73,115,188,458.0,80,7.48,85,403,2430,12.3
2141,Bill Guerin,1994-95,24.0,4,1,5,5,0,1,1,8.0,,5,0,1,1,8.0,80,6.96,77,402,2440,11.4
2142,Bill Guerin,1995-96,25.0,5,34,65,65,14,20,34,123.0,,70,14,21,35,131.0,84,7.25,87,443,2603,11.7
2143,Bill Guerin,1996-97,26.0,6,44,81,81,25,19,44,195.0,,151,39,40,79,326.0,84,6.48,76,407,2545,10.7
2144,Bill Guerin,1997-98,27.0,7,25,48,48,12,13,25,96.0,,199,51,53,104,422.0,48,5.97,37,209,1408,10.2
2145,Bill Guerin,1998-99,28.0,8,53,80,80,23,30,53,216.0,,279,74,83,157,638.0,82,6.29,74,413,2481,10.4
2146,Bill Guerin,1999-00,29.0,9,47,82,82,29,18,47,177.0,,361,103,101,204,815.0,82,5.83,55,336,2444,9.8
2147,Bill Guerin,2000-01,30.0,10,39,59,59,18,21,39,178.0,,420,121,122,243,993.0,82,5.28,57,380,2242,9.6
2148,Bill Guerin,2001-02,31.0,11,64,80,80,30,34,64,261.0,1576.0,500,151,156,307,1254.0,82,5.27,57,359,2285,9.4
2149,Bill Guerin,2002-03,32.0,12,46,70,70,24,22,46,188.0,1262.0,570,175,178,353,1442.0,82,5.49,53,331,2294,9.8
2150,Bill Guerin,2003-04,33.0,13,85,85,85,40,45,85,289.0,1870.0,655,215,223,438,1731.0,82,5.51,63,376,2272,9.9
2151,Bill Guerin,2004-05,34.0,14,66,78,78,41,25,66,355.0,1618.0,733,256,248,504,2086.0,82,5.24,53,338,2262,9.5
2152,Bill Guerin,2005-06,35.0,15,50,64,64,25,25,50,229.0,1187.0,797,281,273,554,2315.0,82,5.31,60,363,2326,9.4
2153,Bill Guerin,2006-07,36.0,16,69,82,82,34,35,69,263.0,1533.0,879,315,308,623,2578.0,82,5.14,57,348,2300,9.2
2154,Bill Guerin,2008-09,38.0,17,40,70,70,13,27,40,210.0,1150.0,949,328,335,663,2788.0,82,6.05,85,480,2458,10.1
2155,Bill Guerin,2009-10,39.0,18,56,77,77,36,20,56,225.0,1309.0,1026,364,355,719,3013.0,82,5.76,70,398,2426,9.7
2156,Bill Guerin,2010-11,40.0,19,44,81,81,23,21,44,227.0,1408.0,1107,387,376,763,3240.0,82,5.44,62,351,2383,9.4
2157,Bill Guerin,2011-12,41.0,20,48,78,78,21,27,48,226.0,1300.0,1185,408,403,811,3466.0,82,5.7,65,341,2477,9.4
2158,Bill Guerin,2012-13,42.0,21,45,78,78,21,24,45,227.0,1367.0,1263,429,427,856,3693.0,82,5.53,56,304,2486,9.1
2159,Bill Houlder,1990-91,23.0,4,3,30,30,1,2,3,20.0,,30,1,2,3,20.0,80,7.43,89,437,2435,12.2
2160,Bill Houlder,1991-92,24.0,5,3,8,8,0,3,3,5.0,,38,1,5,6,25.0,80,7.48,85,403,2430,12.3
2161,Bill Houlder,1992-93,25.0,6,12,41,41,1,11,12,49.0,,79,2,16,18,74.0,80,7.37,76,367,2421,12.2
2162,Bill Houlder,1993-94,26.0,7,2,7,7,0,2,2,7.0,,86,2,18,20,81.0,80,6.91,71,366,2385,11.6
2163,Bill Houlder,1994-95,27.0,8,1,10,10,1,0,1,18.0,,96,3,18,21,99.0,80,6.96,77,402,2440,11.4
2164,Bill Houlder,1995-96,28.0,9,8,15,15,3,5,8,29.0,,111,6,23,29,128.0,84,7.25,87,443,2603,11.7
2165,Bill Houlder,1996-97,29.0,10,39,80,80,14,25,39,187.0,,191,20,48,68,315.0,84,6.48,76,407,2545,10.7
2166,Bill Houlder,1997-98,30.0,11,18,41,41,5,13,18,59.0,,232,25,61,86,374.0,48,5.97,37,209,1408,10.2
2167,Bill Houlder,1998-99,31.0,12,28,61,61,5,23,28,90.0,,293,30,84,114,464.0,82,6.29,74,413,2481,10.4
2168,Bill Houlder,1999-00,32.0,13,25,79,79,4,21,25,116.0,,372,34,105,139,580.0,82,5.83,55,336,2444,9.8
2169,Bill Houlder,2000-01,33.0,14,32,82,82,7,25,32,102.0,,454,41,130,171,682.0,82,5.28,57,380,2242,9.6
2170,Bill Houlder,2001-02,34.0,15,32,76,76,9,23,32,115.0,1682.0,530,50,153,203,797.0,82,5.27,57,359,2285,9.4
2171,Bill Houlder,2002-03,35.0,16,17,71,71,3,14,17,89.0,1589.0,601,53,167,220,886.0,82,5.49,53,331,2294,9.8
2172,Bill Houlder,2003-04,36.0,17,16,81,81,4,12,16,78.0,1717.0,682,57,179,236,964.0,82,5.51,63,376,2272,9.9
2173,Bill Houlder,2004-05,37.0,18,8,82,82,0,8,8,44.0,1768.0,764,57,187,244,1008.0,82,5.24,53,338,2262,9.5
2174,Bill Houlder,2005-06,38.0,19,6,82,82,2,4,6,51.0,1567.0,846,59,191,250,1059.0,82,5.31,60,363,2326,9.4
2175,Bill Huard,1995-96,28.0,4,0,2,2,0,0,0,0.0,,2,0,0,0,0.0,84,7.25,87,443,2603,11.7
2176,Bill Huard,1996-97,29.0,5,4,63,63,2,2,4,24.0,,65,2,2,4,24.0,84,6.48,76,407,2545,10.7
2177,Bill Huard,1997-98,30.0,6,6,33,33,3,3,6,21.0,,98,5,5,10,45.0,48,5.97,37,209,1408,10.2
2178,Bill Huard,1998-99,31.0,7,12,51,51,6,6,12,34.0,,149,11,11,22,79.0,82,6.29,74,413,2481,10.4
2179,Bill Huard,1999-00,32.0,8,11,40,40,5,6,11,34.0,,189,16,17,33,113.0,82,5.83,55,336,2444,9.8
2180,Bill Huard,2000-01,33.0,9,1,30,30,0,1,1,12.0,,219,16,18,34,125.0,82,5.28,57,380,2242,9.6
2181,Bill Huard,2001-02,34.0,10,0,3,3,0,0,0,2.0,17.0,222,16,18,34,127.0,82,5.27,57,359,2285,9.4
2182,Bill Huard,2002-03,35.0,11,0,1,1,0,0,0,0.0,2.0,223,16,18,34,127.0,82,5.49,53,331,2294,9.8
2183,Bill Kitchen,1984-85,24.0,4,0,1,1,0,0,0,0.0,,1,0,0,0,0.0,80,8.03,73,320,2489,12.9
2184,Bill Kitchen,1985-86,25.0,5,0,8,8,0,0,0,3.0,,9,0,0,0,3.0,80,7.73,71,310,2444,12.7
2185,Bill Kitchen,1986-87,26.0,6,0,3,3,0,0,0,3.0,,12,0,0,0,6.0,80,7.89,74,336,2448,12.9
2186,Bill Kitchen,1987-88,27.0,7,5,29,29,1,4,5,21.0,,41,1,4,5,27.0,80,7.77,71,321,2447,12.7
2187,Bill Lindsay,1994-95,23.0,4,6,23,23,2,4,6,35.0,,23,2,4,6,35.0,80,6.96,77,402,2440,11.4
2188,Bill Lindsay,1995-96,24.0,5,13,44,44,4,9,13,58.0,,67,6,13,19,93.0,84,7.25,87,443,2603,11.7
2189,Bill Lindsay,1996-97,25.0,6,12,84,84,6,6,12,90.0,,151,12,19,31,183.0,84,6.48,76,407,2545,10.7
2190,Bill Lindsay,1997-98,26.0,7,19,48,48,10,9,19,63.0,,199,22,28,50,246.0,48,5.97,37,209,1408,10.2
2191,Bill Lindsay,1998-99,27.0,8,34,73,73,12,22,34,118.0,,272,34,50,84,364.0,82,6.29,74,413,2481,10.4
2192,Bill Lindsay,1999-00,28.0,9,34,81,81,11,23,34,168.0,,353,45,73,118,532.0,82,5.83,55,336,2444,9.8
2193,Bill Lindsay,2000-01,29.0,10,28,82,82,12,16,28,150.0,,435,57,89,146,682.0,82,5.28,57,380,2242,9.6
2194,Bill Lindsay,2001-02,30.0,11,27,75,75,12,15,27,135.0,1021.0,510,69,104,173,817.0,82,5.27,57,359,2285,9.4
2195,Bill Lindsay,2002-03,31.0,12,20,80,80,8,12,20,147.0,1034.0,590,77,116,193,964.0,82,5.49,53,331,2294,9.8
2196,Bill Lindsay,2003-04,32.0,13,14,68,68,1,13,14,71.0,696.0,658,78,129,207,1035.0,82,5.51,63,376,2272,9.9
2197,Bill Lindsay,2004-05,33.0,14,15,76,76,5,10,15,77.0,742.0,734,83,139,222,1112.0,82,5.24,53,338,2262,9.5
2198,Bill Lindsay,2005-06,34.0,15,2,19,19,0,2,2,7.0,101.0,753,83,141,224,1119.0,82,5.31,60,363,2326,9.4
2199,Bill Lindsay,2006-07,35.0,16,0,24,24,0,0,0,10.0,142.0,777,83,141,224,1129.0,82,5.14,57,348,2300,9.2
2200,Bill McCreary,1983-84,23.0,4,1,12,12,1,0,1,7.0,,12,1,0,1,7.0,80,7.69,77,340,2441,12.6
2201,Bill McDougall,1993-94,27.0,4,1,2,2,0,1,1,3.0,,2,0,1,1,3.0,80,6.91,71,366,2385,11.6
2202,Bill McDougall,1995-96,29.0,5,3,4,4,2,1,3,8.0,,6,2,2,4,11.0,84,7.25,87,443,2603,11.7
2203,Bill McDougall,1996-97,30.0,6,6,22,22,3,3,6,26.0,,28,5,5,10,37.0,84,6.48,76,407,2545,10.7
2204,Bill Muckalt,2001-02,27.0,4,36,73,73,16,20,36,119.0,1124.0,73,16,20,36,119.0,82,5.27,57,359,2285,9.4
2205,Bill Muckalt,2002-03,28.0,5,19,45,45,8,11,19,79.0,629.0,118,24,31,55,198.0,82,5.49,53,331,2294,9.8
2206,Bill Muckalt,2003-04,29.0,6,26,60,60,11,15,26,90.0,823.0,178,35,46,81,288.0,82,5.51,63,376,2272,9.9
2207,Bill Muckalt,2004-05,30.0,7,8,70,70,0,8,8,73.0,684.0,248,35,54,89,361.0,82,5.24,53,338,2262,9.5
2208,Bill Muckalt,2005-06,31.0,8,8,8,8,5,3,8,13.0,104.0,256,40,57,97,374.0,82,5.31,60,363,2326,9.4
2209,Bill O'Dwyer,1986-87,27.0,4,0,5,5,0,0,0,2.0,,5,0,0,0,2.0,80,7.89,74,336,2448,12.9
2210,Bill O'Dwyer,1987-88,28.0,5,1,13,13,1,0,1,8.0,,18,1,0,1,10.0,80,7.77,71,321,2447,12.7
2211,Bill O'Dwyer,1990-91,31.0,6,17,77,77,7,10,17,98.0,,95,8,10,18,108.0,80,7.43,89,437,2435,12.2
2212,Bill O'Dwyer,1991-92,32.0,7,3,19,19,1,2,3,18.0,,114,9,12,21,126.0,80,7.48,85,403,2430,12.3
2213,Bill O'Dwyer,1992-93,33.0,8,1,6,6,0,1,1,7.0,,120,9,13,22,133.0,80,7.37,76,367,2421,12.2
2214,Bill Root,1985-86,26.0,4,5,46,46,2,3,5,44.0,,46,2,3,5,44.0,80,7.73,71,310,2444,12.7
2215,Bill Root,1986-87,27.0,5,17,72,72,4,13,17,70.0,,118,6,16,22,114.0,80,7.89,74,336,2448,12.9
2216,Bill Root,1987-88,28.0,6,2,35,35,1,1,2,34.0,,153,7,17,24,148.0,80,7.77,71,321,2447,12.7
2217,Bill Root,1988-89,29.0,7,1,27,27,0,1,1,34.0,,180,7,18,25,182.0,80,7.94,82,370,2484,12.8
2218,Bill Root,1989-90,30.0,8,6,34,34,3,3,6,31.0,,214,10,21,31,213.0,80,7.34,72,344,2400,12.2
2219,Bill Root,1990-91,31.0,9,3,33,33,1,2,3,19.0,,247,11,23,34,232.0,80,7.43,89,437,2435,12.2
2220,Bill Sweatt,2014-15,26.0,4,0,2,2,0,0,0,2.0,11.0,2,0,0,0,2.0,82,5.32,47,271,2439,8.9
2221,Bill Sweatt,2015-16,27.0,5,0,1,1,0,0,0,0.0,12.0,3,0,0,0,2.0,48,5.31,29,160,1399,9.1
2222,Bill Terry,1990-91,29.0,4,0,5,5,0,0,0,3.0,,5,0,0,0,3.0,80,7.43,89,437,2435,12.2
2223,Bill Thomas,2008-09,25.0,4,3,9,9,1,2,3,15.0,122.0,9,1,2,3,15.0,82,6.05,85,480,2458,10.1
2224,Bill Thomas,2009-10,26.0,5,14,24,24,8,6,14,60.0,324.0,33,9,8,17,75.0,82,5.76,70,398,2426,9.7
2225,Bill Thomas,2010-11,27.0,6,0,7,7,0,0,0,9.0,92.0,40,9,8,17,84.0,82,5.44,62,351,2383,9.4
2226,Bill Thomas,2011-12,28.0,7,3,16,16,2,1,3,17.0,152.0,56,11,9,20,101.0,82,5.7,65,341,2477,9.4
2227,Bill Thomas,2013-14,30.0,8,7,24,24,4,3,7,33.0,204.0,80,15,12,27,134.0,82,5.46,52,291,2492,9.0
2228,Bill Thomas,2014-15,31.0,9,1,7,7,1,0,1,9.0,61.0,87,16,12,28,143.0,82,5.32,47,271,2439,8.9
2229,Bill Watson,1988-89,24.0,4,24,52,52,8,16,24,67.0,,52,8,16,24,67.0,80,7.94,82,370,2484,12.8
2230,Bill Watson,1989-90,25.0,5,32,51,51,13,19,32,107.0,,103,21,35,56,174.0,80,7.34,72,344,2400,12.2
2231,Bill Watson,1990-91,26.0,6,2,9,9,2,0,2,7.0,,112,23,35,58,181.0,80,7.43,89,437,2435,12.2
2232,Bill Watson,1991-92,27.0,7,1,3,3,0,1,1,2.0,,115,23,36,59,183.0,80,7.48,85,403,2430,12.3
2233,Bill Whelton,1983-84,24.0,4,0,2,2,0,0,0,1.0,,2,0,0,0,1.0,80,7.69,77,340,2441,12.6
2234,Billy Carroll,1983-84,25.0,4,8,18,18,4,4,8,25.0,,18,4,4,8,25.0,80,7.69,77,340,2441,12.6
2235,Billy Carroll,1984-85,26.0,5,29,72,72,9,20,29,42.0,,90,13,24,37,67.0,80,8.03,73,320,2489,12.9
2236,Billy Carroll,1985-86,27.0,6,12,71,71,1,11,12,48.0,,161,14,35,49,115.0,80,7.73,71,310,2444,12.7
2237,Billy Carroll,1986-87,28.0,7,7,39,39,5,2,7,39.0,,200,19,37,56,154.0,80,7.89,74,336,2448,12.9
2238,Billy Carroll,1987-88,29.0,8,17,65,65,8,9,17,44.0,,265,27,46,73,198.0,80,7.77,71,321,2447,12.7
2239,Billy Carroll,1988-89,30.0,9,8,26,26,2,6,8,13.0,,291,29,52,81,211.0,80,7.94,82,370,2484,12.8
2240,Billy Carroll,1989-90,31.0,10,3,31,31,1,2,3,12.0,,322,30,54,84,223.0,80,7.34,72,344,2400,12.2
2241,Billy Tibbetts,2003-04,29.0,4,3,29,29,1,2,3,16.0,210.0,29,1,2,3,16.0,82,5.51,63,376,2272,9.9
2242,Billy Tibbetts,2004-05,30.0,5,7,42,42,1,6,7,48.0,459.0,71,2,8,10,64.0,82,5.24,53,338,2262,9.5
2243,Billy Tibbetts,2005-06,31.0,6,0,11,11,0,0,0,6.0,110.0,82,2,8,10,70.0,82,5.31,60,363,2326,9.4
2244,Bjorn Melin,2009-10,28.0,4,1,3,3,1,0,1,1.0,22.0,3,1,0,1,1.0,82,5.76,70,398,2426,9.7
2245,Blair Atcheynum,1995-96,26.0,4,1,4,4,0,1,1,2.0,,4,0,1,1,2.0,84,7.25,87,443,2603,11.7
2246,Blair Atcheynum,2000-01,31.0,5,26,61,61,11,15,26,103.0,,65,11,16,27,105.0,82,5.28,57,380,2242,9.6
2247,Blair Atcheynum,2001-02,32.0,6,18,65,65,10,8,18,93.0,977.0,130,21,24,45,198.0,82,5.27,57,359,2285,9.4
2248,Blair Atcheynum,2002-03,33.0,7,12,47,47,5,7,12,48.0,576.0,177,26,31,57,246.0,82,5.49,53,331,2294,9.8
2249,Blair Atcheynum,2003-04,34.0,8,3,19,19,1,2,3,18.0,173.0,196,27,33,60,264.0,82,5.51,63,376,2272,9.9
2250,Blair Barnes,1985-86,25.0,4,0,1,1,0,0,0,0.0,,1,0,0,0,0.0,80,7.73,71,310,2444,12.7
2251,Blair Betts,2004-05,24.0,4,1,6,6,1,0,1,4.0,43.0,6,1,0,1,4.0,82,5.24,53,338,2262,9.5
2252,Blair Betts,2005-06,25.0,5,4,9,9,1,3,4,16.0,104.0,15,2,3,5,20.0,82,5.31,60,363,2326,9.4
2253,Blair Betts,2006-07,26.0,6,3,20,20,1,2,3,21.0,255.0,35,3,5,8,41.0,82,5.14,57,348,2300,9.2
2254,Blair Betts,2008-09,28.0,7,10,66,66,8,2,10,94.0,853.0,101,11,7,18,135.0,82,6.05,85,480,2458,10.1
2255,Blair Betts,2009-10,29.0,8,13,82,82,9,4,13,120.0,1151.0,183,20,11,31,255.0,82,5.76,70,398,2426,9.7
2256,Blair Betts,2010-11,30.0,9,7,75,75,2,5,7,85.0,889.0,258,22,16,38,340.0,82,5.44,62,351,2383,9.4
2257,Blair Betts,2011-12,31.0,10,10,81,81,6,4,10,83.0,860.0,339,28,20,48,423.0,82,5.7,65,341,2477,9.4
2258,Blair Betts,2012-13,32.0,11,18,63,63,8,10,18,63.0,795.0,402,36,30,66,486.0,82,5.53,56,304,2486,9.1
2259,Blair Betts,2013-14,33.0,12,12,75,75,5,7,12,51.0,784.0,477,41,37,78,537.0,82,5.46,52,291,2492,9.0
2260,Blair Jones,2009-10,23.0,4,3,20,20,1,2,3,6.0,115.0,20,1,2,3,6.0,82,5.76,70,398,2426,9.7
2261,Blair Jones,2010-11,24.0,5,0,4,4,0,0,0,1.0,8.0,24,1,2,3,7.0,82,5.44,62,351,2383,9.4
2262,Blair Jones,2012-13,26.0,6,0,14,14,0,0,0,26.0,180.0,38,1,2,3,33.0,82,5.53,56,304,2486,9.1
2263,Blair Jones,2013-14,27.0,7,3,18,18,1,2,3,20.0,144.0,56,2,4,6,53.0,82,5.46,52,291,2492,9.0
2264,Blair Jones,2014-15,28.0,8,8,43,43,3,5,8,58.0,488.0,99,5,9,14,111.0,82,5.32,47,271,2439,8.9
2265,Blair Jones,2015-16,29.0,9,1,15,15,0,1,1,22.0,161.0,114,5,10,15,133.0,48,5.31,29,160,1399,9.1
2266,Blair Jones,2016-17,30.0,10,2,14,14,2,0,2,14.0,159.0,128,7,10,17,147.0,82,5.34,48,269,2463,8.9
2267,Blair Jones,2017-18,31.0,11,0,4,4,0,0,0,0.0,28.0,132,7,10,17,147.0,82,5.32,47,251,2453,8.9
2268,Blair MacDonald,1982-83,29.0,4,94,80,80,46,48,94,266.0,,80,46,48,94,266.0,80,7.03,61,280,2352,12.0
2269,Blair MacDonald,1983-84,30.0,5,57,63,63,24,33,57,172.0,,143,70,81,151,438.0,80,7.69,77,340,2441,12.6
2270,Blair MacDonald,1984-85,31.0,6,33,59,59,18,15,33,116.0,,202,88,96,184,554.0,80,8.03,73,320,2489,12.9
2271,Blair MacDonald,1985-86,32.0,7,7,17,17,3,4,7,29.0,,219,91,100,191,583.0,80,7.73,71,310,2444,12.7
2272,Blake Bellefeuille,2004-05,27.0,4,1,2,2,0,1,1,2.0,17.0,2,0,1,1,2.0,82,5.24,53,338,2262,9.5
2273,Blake Bellefeuille,2005-06,28.0,5,0,3,3,0,0,0,0.0,21.0,5,0,1,1,2.0,82,5.31,60,363,2326,9.4
2274,Blake Coleman,2019-20,28.0,4,2,23,23,1,1,2,29.0,295.0,23,1,1,2,29.0,82,5.45,47,245,2478,9.0
2275,Blake Coleman,2020-21,29.0,5,25,79,79,13,12,25,146.0,1137.0,102,14,13,27,175.0,82,5.86,50,250,2620,9.2
2276,Blake Coleman,2021-22,30.0,6,36,78,78,22,14,36,213.0,1327.0,180,36,27,63,388.0,82,5.96,47,239,2579,9.5
2277,Blake Coleman,2022-23,31.0,7,32,66,66,21,11,32,200.0,1103.0,246,57,38,95,588.0,70,5.96,42,208,2192,9.5
2278,Blake Comeau,2009-10,23.0,4,0,3,3,0,0,0,1.0,28.0,3,0,0,0,1.0,82,5.76,70,398,2426,9.7
2279,Blake Comeau,2010-11,24.0,5,15,51,51,8,7,15,67.0,595.0,54,8,7,15,68.0,82,5.44,62,351,2383,9.4
2280,Blake Comeau,2011-12,25.0,6,25,53,53,7,18,25,78.0,863.0,107,15,25,40,146.0,82,5.7,65,341,2477,9.4
2281,Blake Comeau,2012-13,26.0,7,35,61,61,17,18,35,133.0,940.0,168,32,43,75,279.0,82,5.53,56,304,2486,9.1
2282,Blake Comeau,2013-14,27.0,8,46,77,77,24,22,46,182.0,1439.0,245,56,65,121,461.0,82,5.46,52,291,2492,9.0
2283,Blake Comeau,2014-15,28.0,9,15,74,74,5,10,15,137.0,1143.0,319,61,75,136,598.0,82,5.32,47,271,2439,8.9
2284,Blake Comeau,2015-16,29.0,10,12,42,42,6,6,12,48.0,511.0,361,67,81,148,646.0,48,5.31,29,160,1399,9.1
2285,Blake Comeau,2016-17,30.0,11,16,61,61,5,11,16,107.0,736.0,422,72,92,164,753.0,82,5.34,48,269,2463,8.9
2286,Blake Comeau,2017-18,31.0,12,31,61,61,16,15,31,147.0,932.0,483,88,107,195,900.0,82,5.32,47,251,2453,8.9
2287,Blake Comeau,2018-19,32.0,13,36,81,81,12,24,36,142.0,1428.0,564,100,131,231,1042.0,82,5.34,48,255,2438,9.0
2288,Blake Comeau,2019-20,33.0,14,20,77,77,8,12,20,103.0,1154.0,641,108,143,251,1145.0,82,5.45,47,245,2478,9.0
2289,Blake Comeau,2020-21,34.0,15,34,79,79,13,21,34,123.0,1254.0,720,121,164,285,1268.0,82,5.86,50,250,2620,9.2
2290,Blake Comeau,2021-22,35.0,16,18,77,77,7,11,18,102.0,1211.0,797,128,175,303,1370.0,82,5.96,47,239,2579,9.5
2291,Blake Comeau,2022-23,36.0,17,16,55,55,8,8,16,74.0,822.0,852,136,183,319,1444.0,70,5.96,42,208,2192,9.5
2292,Blake Geoffrion,2013-14,25.0,4,8,20,20,6,2,8,24.0,165.0,20,6,2,8,24.0,82,5.46,52,291,2492,9.0
2293,Blake Geoffrion,2014-15,26.0,5,5,35,35,2,3,5,29.0,386.0,55,8,5,13,53.0,82,5.32,47,271,2439,8.9
2294,Blake Hillman,2020-21,25.0,4,1,4,4,1,0,1,5.0,72.0,4,1,0,1,5.0,82,5.86,50,250,2620,9.2
2295,Blake Lizotte,2021-22,24.0,4,0,1,1,0,0,0,1.0,11.0,1,0,0,0,1.0,82,5.96,47,239,2579,9.5
2296,Blake Lizotte,2022-23,25.0,5,23,65,65,6,17,23,87.0,907.0,66,6,17,23,88.0,70,5.96,42,208,2192,9.5
2297,Blake Pietila,2018-19,25.0,4,2,7,7,1,1,2,10.0,84.0,7,1,1,2,10.0,82,5.34,48,255,2438,9.0
2298,Blake Pietila,2019-20,26.0,5,1,10,10,0,1,1,9.0,130.0,17,1,2,3,19.0,82,5.45,47,245,2478,9.0
2299,Blake Pietila,2020-21,27.0,6,0,2,2,0,0,0,1.0,19.0,19,1,2,3,20.0,82,5.86,50,250,2620,9.2
2300,Blake Pietila,2021-22,28.0,7,1,19,19,0,1,1,22.0,252.0,38,1,3,4,42.0,82,5.96,47,239,2579,9.5
2301,Blake Sloan,2001-02,26.0,4,0,14,14,0,0,0,7.0,126.0,14,0,0,0,7.0,82,5.27,57,359,2285,9.4
2302,Blake Sloan,2002-03,27.0,5,17,67,67,4,13,17,78.0,904.0,81,4,13,17,85.0,82,5.49,53,331,2294,9.8
2303,Blake Sloan,2003-04,28.0,6,5,47,47,3,2,5,45.0,514.0,128,7,15,22,130.0,82,5.51,63,376,2272,9.9
2304,Blake Sloan,2004-05,29.0,7,11,67,67,2,9,11,56.0,742.0,195,9,24,33,186.0,82,5.24,53,338,2262,9.5
2305,Blake Sloan,2005-06,30.0,8,10,67,67,2,8,10,56.0,830.0,262,11,32,43,242.0,82,5.31,60,363,2326,9.4
2306,Blake Sloan,2006-07,31.0,9,0,28,28,0,0,0,23.0,201.0,290,11,32,43,265.0,82,5.14,57,348,2300,9.2
2307,Blake Speers,2019-20,23.0,4,0,3,3,0,0,0,3.0,28.0,3,0,0,0,3.0,82,5.45,47,245,2478,9.0
2308,Blake Wesley,1982-83,23.0,4,1,2,2,0,1,1,4.0,,2,0,1,1,4.0,80,7.03,61,280,2352,12.0
2309,Blake Wesley,1983-84,24.0,5,10,50,50,3,7,10,53.0,,52,3,8,11,57.0,80,7.69,77,340,2441,12.6
2310,Blake Wesley,1984-85,25.0,6,27,78,78,9,18,27,115.0,,130,12,26,38,172.0,80,8.03,73,320,2489,12.9
2311,Blake Wesley,1985-86,26.0,7,13,74,74,4,9,13,71.0,,204,16,35,51,243.0,80,7.73,71,310,2444,12.7
2312,Blake Wesley,1986-87,27.0,8,10,46,46,2,8,10,40.0,,250,18,43,61,283.0,80,7.89,74,336,2448,12.9
2313,Blake Wesley,1987-88,28.0,9,2,21,21,0,2,2,11.0,,271,18,45,63,294.0,80,7.77,71,321,2447,12.7
2314,Blake Wesley,1988-89,29.0,10,1,27,27,0,1,1,11.0,,298,18,46,64,305.0,80,7.94,82,370,2484,12.8
2315,Blake Wheeler,2011-12,25.0,4,45,81,81,21,24,45,150.0,1109.0,81,21,24,45,150.0,82,5.7,65,341,2477,9.4
2316,Blake Wheeler,2012-13,26.0,5,38,82,82,18,20,38,159.0,1295.0,163,39,44,83,309.0,82,5.53,56,304,2486,9.1
2317,Blake Wheeler,2013-14,27.0,6,44,81,81,18,26,44,179.0,1316.0,244,57,70,127,488.0,82,5.46,52,291,2492,9.0
2318,Blake Wheeler,2014-15,28.0,7,64,80,80,17,47,64,208.0,1526.0,324,74,117,191,696.0,82,5.32,47,271,2439,8.9
2319,Blake Wheeler,2015-16,29.0,8,41,48,48,19,22,41,129.0,902.0,372,93,139,232,825.0,48,5.31,29,160,1399,9.1
2320,Blake Wheeler,2016-17,30.0,9,69,82,82,28,41,69,225.0,1532.0,454,121,180,301,1050.0,82,5.34,48,269,2463,8.9
2321,Blake Wheeler,2017-18,31.0,10,61,79,79,26,35,61,244.0,1553.0,533,147,215,362,1294.0,82,5.32,47,251,2453,8.9
2322,Blake Wheeler,2018-19,32.0,11,78,82,82,26,52,78,256.0,1623.0,615,173,267,440,1550.0,82,5.34,48,255,2438,9.0
2323,Blake Wheeler,2019-20,33.0,12,74,82,82,26,48,74,259.0,1652.0,697,199,315,514,1809.0,82,5.45,47,245,2478,9.0
2324,Blake Wheeler,2020-21,34.0,13,91,81,81,23,68,91,246.0,1641.0,778,222,383,605,2055.0,82,5.86,50,250,2620,9.2
2325,Blake Wheeler,2021-22,35.0,14,91,82,82,20,71,91,231.0,1698.0,860,242,454,696,2286.0,82,5.96,47,239,2579,9.5
2326,Blake Wheeler,2022-23,36.0,15,65,71,71,22,43,65,180.0,1372.0,931,264,497,761,2466.0,70,5.96,42,208,2192,9.5
2327,Bo Berglund,1986-87,31.0,4,43,75,75,16,27,43,83.0,,75,16,27,43,83.0,80,7.89,74,336,2448,12.9
2328,Bo Berglund,1987-88,32.0,5,20,45,45,10,10,20,58.0,,120,26,37,63,141.0,80,7.77,71,321,2447,12.7
2329,Bo Berglund,1988-89,33.0,6,4,10,10,2,2,4,11.0,,130,28,39,67,152.0,80,7.94,82,370,2484,12.8
2330,Bo Horvat,2017-18,22.0,4,25,68,68,13,12,25,93.0,834.0,68,13,12,25,93.0,82,5.32,47,251,2453,8.9
2331,Bo Horvat,2018-19,23.0,5,40,82,82,16,24,40,155.0,1405.0,150,29,36,65,248.0,82,5.34,48,255,2438,9.0
2332,Bo Horvat,2019-20,24.0,6,52,81,81,20,32,52,158.0,1461.0,231,49,68,117,406.0,82,5.45,47,245,2478,9.0
2333,Bo Horvat,2020-21,25.0,7,44,64,64,22,22,44,158.0,1238.0,295,71,90,161,564.0,82,5.86,50,250,2620,9.2
2334,Bo Horvat,2021-22,26.0,8,61,82,82,27,34,61,227.0,1709.0,377,98,124,222,791.0,82,5.96,47,239,2579,9.5
2335,Bo Horvat,2022-23,27.0,9,53,69,69,22,31,53,178.0,1362.0,446,120,155,275,969.0,70,5.96,42,208,2192,9.5
2336,Bob Attwell,1982-83,23.0,4,2,7,7,1,1,2,2.0,,7,1,1,2,2.0,80,7.03,61,280,2352,12.0
2337,Bob Attwell,1983-84,24.0,5,4,15,15,0,4,4,11.0,,22,1,5,6,13.0,80,7.69,77,340,2441,12.6
2338,Bob Bassen,1988-89,23.0,4,3,11,11,2,1,3,5.0,,11,2,1,3,5.0,80,7.94,82,370,2484,12.8
2339,Bob Bassen,1989-90,24.0,5,17,77,77,7,10,17,59.0,,88,9,11,20,64.0,80,7.34,72,344,2400,12.2
2340,Bob Bassen,1990-91,25.0,6,22,77,77,6,16,22,65.0,,165,15,27,42,129.0,80,7.43,89,437,2435,12.2
2341,Bob Bassen,1991-92,26.0,7,21,68,68,5,16,21,51.0,,233,20,43,63,180.0,80,7.48,85,403,2430,12.3
2342,Bob Bassen,1992-93,27.0,8,2,6,6,1,1,2,7.0,,239,21,44,65,187.0,80,7.37,76,367,2421,12.2
2343,Bob Bassen,1993-94,28.0,9,34,79,79,16,18,34,117.0,,318,37,62,99,304.0,80,6.91,71,366,2385,11.6
2344,Bob Bassen,1994-95,29.0,10,32,79,79,7,25,32,101.0,,397,44,87,131,405.0,80,6.96,77,402,2440,11.4
2345,Bob Bassen,1995-96,30.0,11,19,53,53,9,10,19,61.0,,450,53,97,150,466.0,84,7.25,87,443,2603,11.7
2346,Bob Bassen,1996-97,31.0,12,28,83,83,13,15,28,129.0,,533,66,112,178,595.0,84,6.48,76,407,2545,10.7
2347,Bob Bassen,1997-98,32.0,13,27,47,47,12,15,27,66.0,,580,78,127,205,661.0,48,5.97,37,209,1408,10.2
2348,Bob Bassen,1998-99,33.0,14,1,13,13,0,1,1,9.0,,593,78,128,206,670.0,82,6.29,74,413,2481,10.4
2349,Bob Bassen,1999-00,34.0,15,12,46,46,5,7,12,50.0,,639,83,135,218,720.0,82,5.83,55,336,2444,9.8
2350,Bob Bassen,2000-01,35.0,16,7,58,58,3,4,7,40.0,,697,86,139,225,760.0,82,5.28,57,380,2242,9.6
2351,Bob Bassen,2001-02,36.0,17,3,41,41,1,2,3,47.0,517.0,738,87,141,228,807.0,82,5.27,57,359,2285,9.4
2352,Bob Bassen,2002-03,37.0,18,4,27,27,1,3,4,26.0,266.0,765,88,144,232,833.0,82,5.49,53,331,2294,9.8
2353,Bob Beers,1992-93,25.0,4,1,3,3,0,1,1,0.0,,3,0,1,1,0.0,80,7.37,76,367,2421,12.2
2354,Bob Beers,1993-94,26.0,5,1,16,16,0,1,1,9.0,,19,0,2,2,9.0,80,6.91,71,366,2385,11.6
2355,Bob Beers,1994-95,27.0,6,5,31,31,0,5,5,25.0,,50,0,7,7,34.0,80,6.96,77,402,2440,11.4
2356,Bob Beers,1995-96,28.0,7,36,64,64,12,24,36,138.0,,114,12,31,43,172.0,84,7.25,87,443,2603,11.7
2357,Bob Beers,1996-97,29.0,8,43,82,82,11,32,43,187.0,,196,23,63,86,359.0,84,6.48,76,407,2545,10.7
2358,Bob Beers,1997-98,30.0,9,9,22,22,2,7,9,38.0,,218,25,70,95,397.0,48,5.97,37,209,1408,10.2
2359,Bob Beers,1998-99,31.0,10,5,13,13,0,5,5,9.0,,231,25,75,100,406.0,82,6.29,74,413,2481,10.4
2360,Bob Beers,1999-00,32.0,11,7,27,27,3,4,7,49.0,,258,28,79,107,455.0,82,5.83,55,336,2444,9.8
2361,Bob Bergloff,1985-86,27.0,4,0,2,2,0,0,0,1.0,,2,0,0,0,1.0,80,7.73,71,310,2444,12.7
2362,Bob Bodak,1990-91,29.0,4,0,3,3,0,0,0,0.0,,3,0,0,0,0.0,80,7.43,89,437,2435,12.2
2363,Bob Bodak,1992-93,31.0,5,0,1,1,0,0,0,1.0,,4,0,0,0,1.0,80,7.37,76,367,2421,12.2
2364,Bob Boughner,1998-99,27.0,4,1,31,31,0,1,1,14.0,,31,0,1,1,14.0,82,6.29,74,413,2481,10.4
2365,Bob Boughner,1999-00,28.0,5,8,77,77,1,7,8,34.0,,108,1,8,9,48.0,82,5.83,55,336,2444,9.8
2366,Bob Boughner,2000-01,29.0,6,4,69,69,1,3,4,26.0,,177,2,11,13,74.0,82,5.28,57,380,2242,9.6
2367,Bob Boughner,2001-02,30.0,7,13,79,79,3,10,13,59.0,1463.0,256,5,21,26,133.0,82,5.27,57,359,2285,9.4
2368,Bob Boughner,2002-03,31.0,8,7,73,73,3,4,7,40.0,1262.0,329,8,25,33,173.0,82,5.49,53,331,2294,9.8
2369,Bob Boughner,2003-04,32.0,9,4,58,58,1,3,4,46.0,957.0,387,9,28,37,219.0,82,5.51,63,376,2272,9.9
2370,Bob Boughner,2004-05,33.0,10,6,79,79,2,4,6,58.0,1479.0,466,11,32,43,277.0,82,5.24,53,338,2262,9.5
2371,Bob Boughner,2005-06,34.0,11,17,69,69,3,14,17,62.0,1370.0,535,14,46,60,339.0,82,5.31,60,363,2326,9.4
2372,Bob Boughner,2006-07,35.0,12,5,54,54,0,5,5,34.0,784.0,589,14,51,65,373.0,82,5.14,57,348,2300,9.2
2373,Bob Boughner,2008-09,37.0,13,7,41,41,1,6,7,15.0,297.0,630,15,57,72,388.0,82,6.05,85,480,2458,10.1
2374,Bob Brooke,1986-87,26.0,4,3,9,9,1,2,3,10.0,,9,1,2,3,10.0,80,7.89,74,336,2448,12.9
2375,Bob Brooke,1987-88,27.0,5,16,72,72,7,9,16,96.0,,81,8,11,19,106.0,80,7.77,71,321,2447,12.7
2376,Bob Brooke,1988-89,28.0,6,44,79,79,24,20,44,178.0,,160,32,31,63,284.0,80,7.94,82,370,2484,12.8
2377,Bob Brooke,1989-90,29.0,7,36,80,80,13,23,36,138.0,,240,45,54,99,422.0,80,7.34,72,344,2400,12.2
2378,Bob Brooke,1990-91,30.0,8,25,77,77,5,20,25,127.0,,317,50,74,124,549.0,80,7.43,89,437,2435,12.2
2379,Bob Brooke,1991-92,31.0,9,16,57,57,7,9,16,77.0,,374,57,83,140,626.0,80,7.48,85,403,2430,12.3
2380,Bob Brooke,1992-93,32.0,10,26,73,73,12,14,26,109.0,,447,69,97,166,735.0,80,7.37,76,367,2421,12.2
2381,Bob Carpenter,1984-85,21.0,4,67,80,80,32,35,67,262.0,,80,32,35,67,262.0,80,8.03,73,320,2489,12.9
2382,Bob Carpenter,1985-86,22.0,5,69,80,80,32,37,69,197.0,,160,64,72,136,459.0,80,7.73,71,310,2444,12.7
2383,Bob Carpenter,1986-87,23.0,6,68,80,80,28,40,68,228.0,,240,92,112,204,687.0,80,7.89,74,336,2448,12.9
2384,Bob Carpenter,1987-88,24.0,7,95,80,80,53,42,95,260.0,,320,145,154,299,947.0,80,7.77,71,321,2447,12.7
2385,Bob Carpenter,1988-89,25.0,8,56,80,80,27,29,56,205.0,,400,172,183,355,1152.0,80,7.94,82,370,2484,12.8
2386,Bob Carpenter,1989-90,26.0,9,27,60,60,9,18,27,113.0,,460,181,201,382,1265.0,80,7.34,72,344,2400,12.2
2387,Bob Carpenter,1990-91,27.0,10,52,71,71,19,33,52,176.0,,531,200,234,434,1441.0,80,7.43,89,437,2435,12.2
2388,Bob Carpenter,1991-92,28.0,11,40,57,57,16,24,40,137.0,,588,216,258,474,1578.0,80,7.48,85,403,2430,12.3
2389,Bob Carpenter,1992-93,29.0,12,56,80,80,25,31,56,220.0,,668,241,289,530,1798.0,80,7.37,76,367,2421,12.2
2390,Bob Carpenter,1993-94,30.0,13,16,29,29,8,8,16,54.0,,697,249,297,546,1852.0,80,6.91,71,366,2385,11.6
2391,Bob Carpenter,1994-95,31.0,14,48,60,60,25,23,48,171.0,,757,274,320,594,2023.0,80,6.96,77,402,2440,11.4
2392,Bob Carpenter,1995-96,32.0,15,28,68,68,11,17,28,141.0,,825,285,337,622,2164.0,84,7.25,87,443,2603,11.7
2393,Bob Carpenter,1996-97,33.0,16,33,76,76,10,23,33,125.0,,901,295,360,655,2289.0,84,6.48,76,407,2545,10.7
2394,Bob Carpenter,1997-98,34.0,17,16,41,41,5,11,16,69.0,,942,300,371,671,2358.0,48,5.97,37,209,1408,10.2
2395,Bob Carpenter,1998-99,35.0,18,10,52,52,5,5,10,63.0,,994,305,376,681,2421.0,82,6.29,74,413,2481,10.4
2396,Bob Carpenter,1999-00,36.0,19,19,62,62,4,15,19,76.0,,1056,309,391,700,2497.0,82,5.83,55,336,2444,9.8
2397,Bob Carpenter,2000-01,37.0,20,18,66,66,9,9,18,81.0,,1122,318,400,718,2578.0,82,5.28,57,380,2242,9.6
2398,Bob Carpenter,2001-02,38.0,21,10,56,56,2,8,10,69.0,856.0,1178,320,408,728,2647.0,82,5.27,57,359,2285,9.4
2399,Bob Corkum,1992-93,25.0,4,2,8,8,2,0,2,6.0,,8,2,0,2,6.0,80,7.37,76,367,2421,12.2
2400,Bob Corkum,1994-95,27.0,5,6,20,20,2,4,6,23.0,,28,4,4,8,29.0,80,6.96,77,402,2440,11.4
2401,Bob Corkum,1995-96,28.0,6,10,68,68,6,4,10,69.0,,96,10,8,18,98.0,84,7.25,87,443,2603,11.7
2402,Bob Corkum,1996-97,29.0,7,51,76,76,23,28,51,180.0,,172,33,36,69,278.0,84,6.48,76,407,2545,10.7
2403,Bob Corkum,1997-98,30.0,8,19,44,44,10,9,19,100.0,,216,43,45,88,378.0,48,5.97,37,209,1408,10.2
2404,Bob Corkum,1998-99,31.0,9,19,76,76,9,10,19,126.0,,292,52,55,107,504.0,82,6.29,74,413,2481,10.4
2405,Bob Corkum,1999-00,32.0,10,20,80,80,9,11,20,119.0,,372,61,66,127,623.0,82,5.83,55,336,2444,9.8
2406,Bob Corkum,2000-01,33.0,11,21,76,76,12,9,21,105.0,,448,73,75,148,728.0,82,5.28,57,380,2242,9.6
2407,Bob Corkum,2001-02,34.0,12,19,77,77,9,10,19,146.0,1328.0,525,82,85,167,874.0,82,5.27,57,359,2285,9.4
2408,Bob Corkum,2002-03,35.0,13,11,45,45,5,6,11,45.0,650.0,570,87,91,178,919.0,82,5.49,53,331,2294,9.8
2409,Bob Corkum,2003-04,36.0,14,14,75,75,7,7,14,66.0,946.0,645,94,98,192,985.0,82,5.51,63,376,2272,9.9
2410,Bob Corkum,2004-05,37.0,15,8,75,75,3,5,8,80.0,1133.0,720,97,103,200,1065.0,82,5.24,53,338,2262,9.5
2411,Bob Crawford,1982-83,23.0,4,1,8,8,1,0,1,12.0,,8,1,0,1,12.0,80,7.03,61,280,2352,12.0
2412,Bob Crawford,1984-85,25.0,5,1,3,3,0,1,1,9.0,,11,1,1,2,21.0,80,8.03,73,320,2489,12.9
2413,Bob Crawford,1985-86,26.0,6,14,27,27,5,9,14,63.0,,38,6,10,16,84.0,80,7.73,71,310,2444,12.7
2414,Bob Crawford,1986-87,27.0,7,61,80,80,36,25,61,179.0,,118,42,35,77,263.0,80,7.89,74,336,2448,12.9
2415,Bob Crawford,1987-88,28.0,8,28,45,45,14,14,28,90.0,,163,56,49,105,353.0,80,7.77,71,321,2447,12.7
2416,Bob Crawford,1988-89,29.0,9,37,68,68,15,22,37,126.0,,231,71,71,142,479.0,80,7.94,82,370,2484,12.8
2417,Bob Crawford,1989-90,30.0,10,0,15,15,0,0,0,14.0,,246,71,71,142,493.0,80,7.34,72,344,2400,12.2
2418,Bob Errey,1986-87,22.0,4,22,65,65,9,13,22,84.0,,65,9,13,22,84.0,80,7.89,74,336,2448,12.9
2419,Bob Errey,1987-88,23.0,5,2,16,16,0,2,2,12.0,,81,9,15,24,96.0,80,7.77,71,321,2447,12.7
2420,Bob Errey,1988-89,24.0,6,17,37,37,11,6,17,57.0,,118,20,21,41,153.0,80,7.94,82,370,2484,12.8
2421,Bob Errey,1989-90,25.0,7,34,72,72,16,18,34,138.0,,190,36,39,75,291.0,80,7.34,72,344,2400,12.2
2422,Bob Errey,1990-91,26.0,8,9,17,17,3,6,9,18.0,,207,39,45,84,309.0,80,7.43,89,437,2435,12.2
2423,Bob Errey,1991-92,27.0,9,58,76,76,26,32,58,130.0,,283,65,77,142,439.0,80,7.48,85,403,2430,12.3
2424,Bob Errey,1992-93,28.0,10,39,78,78,20,19,39,127.0,,361,85,96,181,566.0,80,7.37,76,367,2421,12.2
2425,Bob Errey,1993-94,29.0,11,42,79,79,20,22,42,131.0,,440,105,118,223,697.0,80,6.91,71,366,2385,11.6
2426,Bob Errey,1994-95,30.0,12,35,78,78,19,16,35,122.0,,518,124,134,258,819.0,80,6.96,77,402,2440,11.4
2427,Bob Errey,1995-96,31.0,13,18,62,62,9,9,18,88.0,,580,133,143,276,907.0,84,7.25,87,443,2603,11.7
2428,Bob Errey,1996-97,32.0,14,30,64,64,12,18,30,89.0,,644,145,161,306,996.0,84,6.48,76,407,2545,10.7
2429,Bob Errey,1997-98,33.0,15,21,43,43,8,13,21,72.0,,687,153,174,327,1068.0,48,5.97,37,209,1408,10.2
2430,Bob Errey,1998-99,34.0,16,32,71,71,11,21,32,85.0,,758,164,195,359,1153.0,82,6.29,74,413,2481,10.4
2431,Bob Errey,1999-00,35.0,17,12,66,66,4,8,12,72.0,,824,168,203,371,1225.0,82,5.83,55,336,2444,9.8
2432,Bob Errey,2000-01,36.0,18,11,71,71,2,9,11,45.0,,895,170,212,382,1270.0,82,5.28,57,380,2242,9.6
2433,Bob Fitchner,1982-83,32.0,4,31,70,70,11,20,31,87.0,,70,11,20,31,87.0,80,7.03,61,280,2352,12.0
2434,Bob Fitchner,1983-84,33.0,5,1,8,8,1,0,1,1.0,,78,12,20,32,88.0,80,7.69,77,340,2441,12.6
2435,Bob Geale,1987-88,25.0,4,0,1,1,0,0,0,1.0,,1,0,0,0,1.0,80,7.77,71,321,2447,12.7
2436,Bob Gladney,1985-86,28.0,4,0,1,1,0,0,0,2.0,,1,0,0,0,2.0,80,7.73,71,310,2444,12.7
2437,Bob Gladney,1986-87,29.0,5,6,13,13,1,5,6,15.0,,14,1,5,6,17.0,80,7.89,74,336,2448,12.9
2438,Bob Halkidis,1988-89,22.0,4,10,37,37,1,9,10,19.0,,37,1,9,10,19.0,80,7.94,82,370,2484,12.8
2439,Bob Halkidis,1989-90,23.0,5,2,6,6,1,1,2,4.0,,43,2,10,12,23.0,80,7.34,72,344,2400,12.2
2440,Bob Halkidis,1990-91,24.0,6,3,30,30,0,3,3,26.0,,73,2,13,15,49.0,80,7.43,89,437,2435,12.2
2441,Bob Halkidis,1991-92,25.0,7,1,16,16,0,1,1,9.0,,89,2,14,16,58.0,80,7.48,85,403,2430,12.3
2442,Bob Halkidis,1992-93,26.0,8,4,20,20,0,4,4,19.0,,109,2,18,20,77.0,80,7.37,76,367,2421,12.2
2443,Bob Halkidis,1993-94,27.0,9,4,34,34,1,3,4,25.0,,143,3,21,24,102.0,80,6.91,71,366,2385,11.6
2444,Bob Halkidis,1994-95,28.0,10,6,46,46,3,3,6,36.0,,189,6,24,30,138.0,80,6.96,77,402,2440,11.4
2445,Bob Halkidis,1996-97,30.0,11,5,28,28,1,4,5,35.0,,217,7,28,35,173.0,84,6.48,76,407,2545,10.7
2446,Bob Halkidis,1997-98,31.0,12,5,31,31,1,4,5,25.0,,248,8,32,40,198.0,48,5.97,37,209,1408,10.2
2447,Bob Halkidis,1998-99,32.0,13,0,8,8,0,0,0,2.0,,256,8,32,40,200.0,82,6.29,74,413,2481,10.4
2448,Bob Jay,1996-97,31.0,4,1,3,3,0,1,1,2.0,,3,0,1,1,2.0,84,6.48,76,407,2545,10.7
2449,Bob Joyce,1990-91,24.0,4,12,15,15,7,5,12,30.0,,15,7,5,12,30.0,80,7.43,89,437,2435,12.2
2450,Bob Joyce,1991-92,25.0,5,49,77,77,18,31,49,142.0,,92,25,36,61,172.0,80,7.48,85,403,2430,12.3
2451,Bob Joyce,1992-93,26.0,6,16,47,47,6,10,16,62.0,,139,31,46,77,234.0,80,7.37,76,367,2421,12.2
2452,Bob Joyce,1993-94,27.0,7,6,17,17,3,3,6,30.0,,156,34,49,83,264.0,80,6.91,71,366,2385,11.6
2453,Bob Joyce,1994-95,28.0,8,0,1,1,0,0,0,0.0,,157,34,49,83,264.0,80,6.96,77,402,2440,11.4
2454,Bob Joyce,1995-96,29.0,9,0,1,1,0,0,0,0.0,,158,34,49,83,264.0,84,7.25,87,443,2603,11.7
2455,Bob Kudelski,1990-91,26.0,4,1,26,26,0,1,1,18.0,,26,0,1,1,18.0,80,7.43,89,437,2435,12.2
2456,Bob Kudelski,1991-92,27.0,5,4,14,14,1,3,4,15.0,,40,1,4,5,33.0,80,7.48,85,403,2430,12.3
2457,Bob Kudelski,1992-93,28.0,6,36,62,62,23,13,36,135.0,,102,24,17,41,168.0,80,7.37,76,367,2421,12.2
2458,Bob Kudelski,1993-94,29.0,7,36,72,72,23,13,36,137.0,,174,47,30,77,305.0,80,6.91,71,366,2385,11.6
2459,Bob Kudelski,1994-95,30.0,8,43,80,80,22,21,43,155.0,,254,69,51,120,460.0,80,6.96,77,402,2440,11.4
2460,Bob Kudelski,1995-96,31.0,9,41,63,63,24,17,41,137.0,,317,93,68,161,597.0,84,7.25,87,443,2603,11.7
2461,Bob Kudelski,1996-97,32.0,10,70,86,86,40,30,70,251.0,,403,133,98,231,848.0,84,6.48,76,407,2545,10.7
2462,Bob Kudelski,1997-98,33.0,11,9,26,26,6,3,9,29.0,,429,139,101,240,877.0,48,5.97,37,209,1408,10.2
2463,Bob Kudelski,1998-99,34.0,12,1,13,13,0,1,1,23.0,,442,139,102,241,900.0,82,6.29,74,413,2481,10.4
2464,Bob LaForest,1986-87,23.0,4,1,5,5,1,0,1,15.0,,5,1,0,1,15.0,80,7.89,74,336,2448,12.9
2465,Bob McGill,1984-85,22.0,4,11,68,68,1,10,11,35.0,,68,1,10,11,35.0,80,8.03,73,320,2489,12.9
2466,Bob McGill,1985-86,23.0,5,0,30,30,0,0,0,13.0,,98,1,10,11,48.0,80,7.73,71,310,2444,12.7
2467,Bob McGill,1986-87,24.0,6,2,12,12,0,2,2,3.0,,110,1,12,13,51.0,80,7.89,74,336,2448,12.9
2468,Bob McGill,1987-88,25.0,7,5,72,72,0,5,5,35.0,,182,1,17,18,86.0,80,7.77,71,321,2447,12.7
2469,Bob McGill,1988-89,26.0,8,5,61,61,1,4,5,28.0,,243,2,21,23,114.0,80,7.94,82,370,2484,12.8
2470,Bob McGill,1989-90,27.0,9,5,56,56,1,4,5,27.0,,299,3,25,28,141.0,80,7.34,72,344,2400,12.2
2471,Bob McGill,1990-91,28.0,10,11,67,67,4,7,11,56.0,,366,7,32,39,197.0,80,7.43,89,437,2435,12.2
2472,Bob McGill,1991-92,29.0,11,4,68,68,0,4,4,38.0,,434,7,36,43,235.0,80,7.48,85,403,2430,12.3
2473,Bob McGill,1992-93,30.0,12,12,69,69,2,10,12,53.0,,503,9,46,55,288.0,80,7.37,76,367,2421,12.2
2474,Bob McGill,1993-94,31.0,13,9,77,77,4,5,9,69.0,,580,13,51,64,357.0,80,6.91,71,366,2385,11.6
2475,Bob McGill,1994-95,32.0,14,4,74,74,3,1,4,62.0,,654,16,52,68,419.0,80,6.96,77,402,2440,11.4
2476,Bob McGill,1995-96,33.0,15,1,19,19,1,0,1,8.0,,673,17,52,69,427.0,84,7.25,87,443,2603,11.7
2477,Bob McGill,1996-97,34.0,16,3,33,33,0,3,3,14.0,,706,17,55,72,441.0,84,6.48,76,407,2545,10.7
2478,Bob Mongrain,1982-83,23.0,4,10,34,34,4,6,10,33.0,,34,4,6,10,33.0,80,7.03,61,280,2352,12.0
2479,Bob Mongrain,1983-84,24.0,5,0,4,4,0,0,0,2.0,,38,4,6,10,35.0,80,7.69,77,340,2441,12.6
2480,Bob Mongrain,1984-85,25.0,6,10,24,24,6,4,10,29.0,,62,10,10,20,64.0,80,8.03,73,320,2489,12.9
2481,Bob Mongrain,1987-88,28.0,7,2,8,8,1,1,2,10.0,,70,11,11,22,74.0,80,7.77,71,321,2447,12.7
2482,Bob Mongrain,1988-89,29.0,8,5,11,11,2,3,5,10.0,,81,13,14,27,84.0,80,7.94,82,370,2484,12.8
2483,Bob Probert,1988-89,23.0,4,21,44,44,8,13,21,46.0,,44,8,13,21,46.0,80,7.94,82,370,2484,12.8
2484,Bob Probert,1989-90,24.0,5,24,63,63,13,11,24,55.0,,107,21,24,45,101.0,80,7.34,72,344,2400,12.2
2485,Bob Probert,1990-91,25.0,6,62,74,74,29,33,62,126.0,,181,50,57,107,227.0,80,7.43,89,437,2435,12.2
2486,Bob Probert,1991-92,26.0,7,6,25,25,4,2,6,23.0,,206,54,59,113,250.0,80,7.48,85,403,2430,12.3
2487,Bob Probert,1992-93,27.0,8,3,4,4,3,0,3,12.0,,210,57,59,116,262.0,80,7.37,76,367,2421,12.2
2488,Bob Probert,1993-94,28.0,9,39,55,55,16,23,39,88.0,,265,73,82,155,350.0,80,6.91,71,366,2385,11.6
2489,Bob Probert,1994-95,29.0,10,44,63,63,20,24,44,96.0,,328,93,106,199,446.0,80,6.96,77,402,2440,11.4
2490,Bob Probert,1995-96,30.0,11,43,80,80,14,29,43,128.0,,408,107,135,242,574.0,84,7.25,87,443,2603,11.7
2491,Bob Probert,1996-97,31.0,12,17,66,66,7,10,17,105.0,,474,114,145,259,679.0,84,6.48,76,407,2545,10.7
2492,Bob Probert,1998-99,33.0,13,40,78,78,19,21,40,97.0,,552,133,166,299,776.0,82,6.29,74,413,2481,10.4
2493,Bob Probert,1999-00,34.0,14,23,82,82,9,14,23,111.0,,634,142,180,322,887.0,82,5.83,55,336,2444,9.8
2494,Bob Probert,2000-01,35.0,15,3,14,14,2,1,3,18.0,,648,144,181,325,905.0,82,5.28,57,380,2242,9.6
2495,Bob Probert,2001-02,36.0,16,21,78,78,7,14,21,87.0,829.0,726,151,195,346,992.0,82,5.27,57,359,2285,9.4
2496,Bob Probert,2002-03,37.0,17,15,69,69,4,11,15,38.0,722.0,795,155,206,361,1030.0,82,5.49,53,331,2294,9.8
2497,Bob Probert,2003-04,38.0,18,19,79,79,7,12,19,45.0,856.0,874,162,218,380,1075.0,82,5.51,63,376,2272,9.9
2498,Bob Probert,2004-05,39.0,19,4,61,61,1,3,4,33.0,411.0,935,163,221,384,1108.0,82,5.24,53,338,2262,9.5
2499,Bob Rouse,1986-87,22.0,4,0,1,1,0,0,0,0.0,,1,0,0,0,0.0,80,7.89,74,336,2448,12.9
2500,Bob Rouse,1987-88,23.0,5,11,63,63,2,9,11,80.0,,64,2,9,11,80.0,80,7.77,71,321,2447,12.7
2501,Bob Rouse,1988-89,24.0,6,15,75,75,1,14,15,91.0,,139,3,23,26,171.0,80,7.94,82,370,2484,12.8
2502,Bob Rouse,1989-90,25.0,7,12,72,72,2,10,12,71.0,,211,5,33,38,242.0,80,7.34,72,344,2400,12.2
2503,Bob Rouse,1990-91,26.0,8,12,74,74,0,12,12,62.0,,285,5,45,50,304.0,80,7.43,89,437,2435,12.2
2504,Bob Rouse,1991-92,27.0,9,19,79,79,4,15,19,85.0,,364,9,60,69,389.0,80,7.48,85,403,2430,12.3
2505,Bob Rouse,1992-93,28.0,10,20,70,70,4,16,20,72.0,,434,13,76,89,461.0,80,7.37,76,367,2421,12.2
2506,Bob Rouse,1993-94,29.0,11,26,60,60,7,19,26,65.0,,494,20,95,115,526.0,80,6.91,71,366,2385,11.6
2507,Bob Rouse,1994-95,30.0,12,22,79,79,3,19,22,115.0,,573,23,114,137,641.0,80,6.96,77,402,2440,11.4
2508,Bob Rouse,1995-96,31.0,13,14,82,82,3,11,14,78.0,,655,26,125,151,719.0,84,7.25,87,443,2603,11.7
2509,Bob Rouse,1996-97,32.0,14,16,63,63,5,11,16,77.0,,718,31,136,167,796.0,84,6.48,76,407,2545,10.7
2510,Bob Rouse,1997-98,33.0,15,8,48,48,1,7,8,51.0,,766,32,143,175,847.0,48,5.97,37,209,1408,10.2
2511,Bob Rouse,1998-99,34.0,16,6,58,58,0,6,6,49.0,,824,32,149,181,896.0,82,6.29,74,413,2481,10.4
2512,Bob Rouse,1999-00,35.0,17,13,70,70,4,9,13,70.0,,894,36,158,194,966.0,82,5.83,55,336,2444,9.8
2513,Bob Rouse,2000-01,36.0,18,12,71,71,1,11,12,54.0,,965,37,169,206,1020.0,82,5.28,57,380,2242,9.6
2514,Bob Rouse,2001-02,37.0,19,11,70,70,0,11,11,75.0,1187.0,1035,37,180,217,1095.0,82,5.27,57,359,2285,9.4
2515,Bob Rouse,2002-03,38.0,20,1,26,26,0,1,1,20.0,388.0,1061,37,181,218,1115.0,82,5.49,53,331,2294,9.8
2516,Bob Stephenson,1982-83,28.0,4,5,18,18,2,3,5,13.0,,18,2,3,5,13.0,80,7.03,61,280,2352,12.0
2517,Bob Sullivan,1985-86,28.0,4,37,62,62,18,19,37,93.0,,62,18,19,37,93.0,80,7.73,71,310,2444,12.7
2518,Bob Sweeney,1989-90,26.0,4,6,14,14,2,4,6,13.0,,14,2,4,6,13.0,80,7.34,72,344,2400,12.2
2519,Bob Sweeney,1990-91,27.0,5,45,80,80,22,23,45,118.0,,94,24,27,51,131.0,80,7.43,89,437,2435,12.2
2520,Bob Sweeney,1991-92,28.0,6,28,75,75,14,14,28,117.0,,169,38,41,79,248.0,80,7.48,85,403,2430,12.3
2521,Bob Sweeney,1992-93,29.0,7,46,70,70,22,24,46,147.0,,239,60,65,125,395.0,80,7.37,76,367,2421,12.2
2522,Bob Sweeney,1993-94,30.0,8,48,80,80,15,33,48,116.0,,319,75,98,173,511.0,80,6.91,71,366,2385,11.6
2523,Bob Sweeney,1994-95,31.0,9,20,63,63,6,14,20,70.0,,382,81,112,193,581.0,80,6.96,77,402,2440,11.4
2524,Bob Sweeney,1995-96,32.0,10,47,80,80,21,26,47,120.0,,462,102,138,240,701.0,84,7.25,87,443,2603,11.7
2525,Bob Sweeney,1996-97,33.0,11,25,60,60,11,14,25,76.0,,522,113,152,265,777.0,84,6.48,76,407,2545,10.7
2526,Bob Sweeney,1997-98,34.0,12,9,45,45,5,4,9,47.0,,567,118,156,274,824.0,48,5.97,37,209,1408,10.2
2527,Bob Sweeney,1998-99,35.0,13,14,72,72,7,7,14,62.0,,639,125,163,288,886.0,82,6.29,74,413,2481,10.4
2528,Bob Wilkie,1993-94,24.0,4,3,8,8,1,2,3,9.0,,8,1,2,3,9.0,80,6.91,71,366,2385,11.6
2529,Bob Wilkie,1996-97,27.0,5,4,10,10,1,3,4,10.0,,18,2,5,7,19.0,84,6.48,76,407,2545,10.7
2530,Bob Wren,2000-01,26.0,4,0,3,3,0,0,0,4.0,,3,0,0,0,4.0,82,5.28,57,380,2242,9.6
2531,Bob Wren,2003-04,29.0,5,0,1,1,0,0,0,0.0,12.0,4,0,0,0,4.0,82,5.51,63,376,2272,9.9
2532,Bob Wren,2004-05,30.0,6,0,1,1,0,0,0,0.0,10.0,5,0,0,0,4.0,82,5.24,53,338,2262,9.5
2533,Bobby Allen,2005-06,27.0,4,0,1,1,0,0,0,0.0,3.0,1,0,0,0,0.0,82,5.31,60,363,2326,9.4
2534,Bobby Allen,2009-10,31.0,5,3,31,31,0,3,3,14.0,404.0,32,0,3,3,14.0,82,5.76,70,398,2426,9.7
2535,Bobby Allen,2010-11,32.0,6,0,19,19,0,0,0,10.0,188.0,51,0,3,3,24.0,82,5.44,62,351,2383,9.4
2536,Bobby Babcock,1993-94,25.0,4,0,1,1,0,0,0,0.0,,1,0,0,0,0.0,80,6.91,71,366,2385,11.6
2537,Bobby Babcock,1995-96,27.0,5,0,1,1,0,0,0,0.0,,2,0,0,0,0.0,84,7.25,87,443,2603,11.7
2538,Bobby Butler,2012-13,25.0,4,0,2,2,0,0,0,2.0,17.0,2,0,0,0,2.0,82,5.53,56,304,2486,9.1
2539,Bobby Butler,2013-14,26.0,5,21,36,36,10,11,21,73.0,555.0,38,10,11,21,75.0,82,5.46,52,291,2492,9.0
2540,Bobby Butler,2014-15,27.0,6,16,56,56,6,10,16,86.0,643.0,94,16,21,37,161.0,82,5.32,47,271,2439,8.9
2541,Bobby Butler,2015-16,28.0,7,11,34,34,4,7,11,41.0,367.0,128,20,28,48,202.0,48,5.31,29,160,1399,9.1
2542,Bobby Butler,2016-17,29.0,8,1,2,2,0,1,1,5.0,28.0,130,20,29,49,207.0,82,5.34,48,269,2463,8.9
2543,Bobby Crawford,1983-84,23.0,4,4,15,15,1,3,4,25.0,,15,1,3,4,25.0,80,7.69,77,340,2441,12.6
2544,Bobby Crawford,1985-86,25.0,5,0,1,1,0,0,0,1.0,,16,1,3,4,26.0,80,7.73,71,310,2444,12.7
2545,Bobby Dollas,1986-87,22.0,4,0,1,1,0,0,0,0.0,,1,0,0,0,0.0,80,7.89,74,336,2448,12.9
2546,Bobby Dollas,1987-88,23.0,5,0,9,9,0,0,0,3.0,,10,0,0,0,3.0,80,7.77,71,321,2447,12.7
2547,Bobby Dollas,1988-89,24.0,6,5,46,46,0,5,5,52.0,,56,0,5,5,55.0,80,7.94,82,370,2484,12.8
2548,Bobby Dollas,1990-91,26.0,7,0,9,9,0,0,0,5.0,,65,0,5,5,60.0,80,7.43,89,437,2435,12.2
2549,Bobby Dollas,1991-92,27.0,8,3,16,16,0,3,3,11.0,,81,0,8,8,71.0,80,7.48,85,403,2430,12.3
2550,Bobby Dollas,1993-94,29.0,9,8,56,56,3,5,8,59.0,,137,3,13,16,130.0,80,6.91,71,366,2385,11.6
2551,Bobby Dollas,1994-95,30.0,10,4,27,27,3,1,4,26.0,,164,6,14,20,156.0,80,6.96,77,402,2440,11.4
2552,Bobby Dollas,1995-96,31.0,11,0,6,6,0,0,0,5.0,,170,6,14,20,161.0,84,7.25,87,443,2603,11.7
2553,Bobby Dollas,1996-97,32.0,12,20,77,77,9,11,20,121.0,,247,15,25,40,282.0,84,6.48,76,407,2545,10.7
2554,Bobby Dollas,1997-98,33.0,13,20,45,45,7,13,20,70.0,,292,22,38,60,352.0,48,5.97,37,209,1408,10.2
2555,Bobby Dollas,1998-99,34.0,14,30,82,82,8,22,30,117.0,,374,30,60,90,469.0,82,6.29,74,413,2481,10.4
2556,Bobby Dollas,1999-00,35.0,15,18,79,79,4,14,18,96.0,,453,34,74,108,565.0,82,5.83,55,336,2444,9.8
2557,Bobby Dollas,2000-01,36.0,16,8,52,52,2,6,8,38.0,,505,36,80,116,603.0,82,5.28,57,380,2242,9.6
2558,Bobby Dollas,2001-02,37.0,17,10,70,70,2,8,10,34.0,1091.0,575,38,88,126,637.0,82,5.27,57,359,2285,9.4
2559,Bobby Dollas,2002-03,38.0,18,10,50,50,3,7,10,36.0,1004.0,625,41,95,136,673.0,82,5.49,53,331,2294,9.8
2560,Bobby Dollas,2003-04,39.0,19,2,21,21,1,1,2,11.0,270.0,646,42,96,138,684.0,82,5.51,63,376,2272,9.9
2561,Bobby Farnham,2017-18,29.0,4,0,11,11,0,0,0,6.0,79.0,11,0,0,0,6.0,82,5.32,47,251,2453,8.9
2562,Bobby Farnham,2018-19,30.0,5,10,53,53,8,2,10,50.0,494.0,64,8,2,10,56.0,82,5.34,48,255,2438,9.0
2563,Bobby Farnham,2019-20,31.0,6,0,3,3,0,0,0,4.0,25.0,67,8,2,10,60.0,82,5.45,47,245,2478,9.0
2564,Bobby Francis,1985-86,27.0,4,2,14,14,2,0,2,4.0,,14,2,0,2,4.0,80,7.73,71,310,2444,12.7
2565,Bobby Gould,1982-83,25.0,4,0,1,1,0,0,0,1.0,,1,0,0,0,1.0,80,7.03,61,280,2352,12.0
2566,Bobby Gould,1983-84,26.0,5,0,3,3,0,0,0,5.0,,4,0,0,0,6.0,80,7.69,77,340,2441,12.6
2567,Bobby Gould,1984-85,27.0,6,34,76,76,21,13,34,121.0,,80,21,13,34,127.0,80,8.03,73,320,2489,12.9
2568,Bobby Gould,1985-86,28.0,7,40,80,80,22,18,40,142.0,,160,43,31,74,269.0,80,7.73,71,310,2444,12.7
2569,Bobby Gould,1986-87,29.0,8,40,78,78,21,19,40,155.0,,238,64,50,114,424.0,80,7.89,74,336,2448,12.9
2570,Bobby Gould,1987-88,30.0,9,33,78,78,14,19,33,113.0,,316,78,69,147,537.0,80,7.77,71,321,2447,12.7
2571,Bobby Gould,1988-89,31.0,10,38,79,79,19,19,38,123.0,,395,97,88,185,660.0,80,7.94,82,370,2484,12.8
2572,Bobby Gould,1989-90,32.0,11,50,78,78,23,27,50,157.0,,473,120,115,235,817.0,80,7.34,72,344,2400,12.2
2573,Bobby Gould,1990-91,33.0,12,26,72,72,12,14,26,119.0,,545,132,129,261,936.0,80,7.43,89,437,2435,12.2
2574,Bobby Gould,1991-92,34.0,13,18,75,75,5,13,18,91.0,,620,137,142,279,1027.0,80,7.48,85,403,2430,12.3
2575,Bobby Gould,1992-93,35.0,14,25,77,77,8,17,25,92.0,,697,145,159,304,1119.0,80,7.37,76,367,2421,12.2
2576,Bobby Guindon,1982-83,32.0,4,1,6,6,0,1,1,10.0,,6,0,1,1,10.0,80,7.03,61,280,2352,12.0
2577,Bobby Holik,1993-94,23.0,4,43,78,78,21,22,43,173.0,,78,21,22,43,173.0,80,6.91,71,366,2385,11.6
2578,Bobby Holik,1994-95,24.0,5,45,76,76,21,24,45,207.0,,154,42,46,88,380.0,80,6.96,77,402,2440,11.4
2579,Bobby Holik,1995-96,25.0,6,39,61,61,20,19,39,180.0,,215,62,65,127,560.0,84,7.25,87,443,2603,11.7
2580,Bobby Holik,1996-97,26.0,7,33,70,70,13,20,33,130.0,,285,75,85,160,690.0,84,6.48,76,407,2545,10.7
2581,Bobby Holik,1997-98,27.0,8,20,48,48,10,10,20,84.0,,333,85,95,180,774.0,48,5.97,37,209,1408,10.2
2582,Bobby Holik,1998-99,28.0,9,30,63,63,13,17,30,157.0,,396,98,112,210,931.0,82,6.29,74,413,2481,10.4
2583,Bobby Holik,1999-00,29.0,10,62,82,82,23,39,62,192.0,,478,121,151,272,1123.0,82,5.83,55,336,2444,9.8
2584,Bobby Holik,2000-01,30.0,11,65,82,82,29,36,65,238.0,,560,150,187,337,1361.0,82,5.28,57,380,2242,9.6
2585,Bobby Holik,2001-02,31.0,12,64,78,78,27,37,64,253.0,1370.0,638,177,224,401,1614.0,82,5.27,57,359,2285,9.4
2586,Bobby Holik,2002-03,32.0,13,46,79,79,23,23,46,257.0,1333.0,717,200,247,447,1871.0,82,5.49,53,331,2294,9.8
2587,Bobby Holik,2003-04,33.0,14,50,80,80,15,35,50,206.0,1266.0,797,215,282,497,2077.0,82,5.51,63,376,2272,9.9
2588,Bobby Holik,2004-05,34.0,15,54,81,81,25,29,54,270.0,1434.0,878,240,311,551,2347.0,82,5.24,53,338,2262,9.5
2589,Bobby Holik,2005-06,35.0,16,35,64,64,16,19,35,213.0,1159.0,942,256,330,586,2560.0,82,5.31,60,363,2326,9.4
2590,Bobby Holik,2006-07,36.0,17,56,82,82,25,31,56,225.0,1522.0,1024,281,361,642,2785.0,82,5.14,57,348,2300,9.2
2591,Bobby Holik,2008-09,38.0,18,33,64,64,15,18,33,151.0,1121.0,1088,296,379,675,2936.0,82,6.05,85,480,2458,10.1
2592,Bobby Holik,2009-10,39.0,19,29,82,82,11,18,29,190.0,1307.0,1170,307,397,704,3126.0,82,5.76,70,398,2426,9.7
2593,Bobby Holik,2010-11,40.0,20,34,82,82,15,19,34,140.0,1310.0,1252,322,416,738,3266.0,82,5.44,62,351,2383,9.4
2594,Bobby Holik,2011-12,41.0,21,9,62,62,4,5,9,79.0,632.0,1314,326,421,747,3345.0,82,5.7,65,341,2477,9.4
2595,Bobby Reynolds,1992-93,25.0,4,2,7,7,1,1,2,13.0,,7,1,1,2,13.0,80,7.37,76,367,2421,12.2
2596,Bobby Robins,2017-18,36.0,4,0,3,3,0,0,0,0.0,23.0,3,0,0,0,0.0,82,5.32,47,251,2453,8.9
2597,Bobby Ryan,2010-11,23.0,4,10,23,23,5,5,10,37.0,259.0,23,5,5,10,37.0,82,5.44,62,351,2383,9.4
2598,Bobby Ryan,2011-12,24.0,5,57,64,64,31,26,57,174.0,988.0,87,36,31,67,211.0,82,5.7,65,341,2477,9.4
2599,Bobby Ryan,2012-13,25.0,6,64,81,81,35,29,64,258.0,1498.0,168,71,60,131,469.0,82,5.53,56,304,2486,9.1
2600,Bobby Ryan,2013-14,26.0,7,71,82,82,34,37,71,270.0,1655.0,250,105,97,202,739.0,82,5.46,52,291,2492,9.0
2601,Bobby Ryan,2014-15,27.0,8,57,82,82,31,26,57,204.0,1505.0,332,136,123,259,943.0,82,5.32,47,271,2439,8.9
2602,Bobby Ryan,2015-16,28.0,9,30,46,46,11,19,30,101.0,763.0,378,147,142,289,1044.0,48,5.31,29,160,1399,9.1
2603,Bobby Ryan,2016-17,29.0,10,48,70,70,23,25,48,190.0,1181.0,448,170,167,337,1234.0,82,5.34,48,269,2463,8.9
2604,Bobby Ryan,2017-18,30.0,11,54,78,78,18,36,54,221.0,1363.0,526,188,203,391,1455.0,82,5.32,47,251,2453,8.9
2605,Bobby Ryan,2018-19,31.0,12,56,81,81,22,34,56,183.0,1391.0,607,210,237,447,1638.0,82,5.34,48,255,2438,9.0
2606,Bobby Ryan,2019-20,32.0,13,25,62,62,13,12,25,111.0,963.0,669,223,249,472,1749.0,82,5.45,47,245,2478,9.0
2607,Bobby Ryan,2020-21,33.0,14,33,62,62,11,22,33,112.0,1019.0,731,234,271,505,1861.0,82,5.86,50,250,2620,9.2
2608,Bobby Ryan,2021-22,34.0,15,42,78,78,15,27,42,160.0,1223.0,809,249,298,547,2021.0,82,5.96,47,239,2579,9.5
2609,Bobby Ryan,2022-23,35.0,16,8,24,24,5,3,8,43.0,324.0,833,254,301,555,2064.0,70,5.96,42,208,2192,9.5
2610,Bobby Sanguinetti,2012-13,24.0,4,0,5,5,0,0,0,5.0,58.0,5,0,0,0,5.0,82,5.53,56,304,2486,9.1
2611,Bobby Sanguinetti,2014-15,26.0,5,0,3,3,0,0,0,5.0,36.0,8,0,0,0,10.0,82,5.32,47,271,2439,8.9
2612,Bobby Sanguinetti,2015-16,27.0,6,6,37,37,2,4,6,48.0,546.0,45,2,4,6,58.0,48,5.31,29,160,1399,9.1
2613,Bogdan Kiselevich,2021-22,31.0,4,8,32,32,0,8,8,14.0,475.0,32,0,8,8,14.0,82,5.96,47,239,2579,9.5
2614,Bogdan Yakimov,2017-18,23.0,4,0,1,1,0,0,0,1.0,11.0,1,0,0,0,1.0,82,5.32,47,251,2453,8.9
2615,Boo Nieves,2019-20,26.0,4,0,1,1,0,0,0,0.0,12.0,1,0,0,0,0.0,82,5.45,47,245,2478,9.0
2616,Boo Nieves,2020-21,27.0,5,9,28,28,1,8,9,23.0,286.0,29,1,8,9,23.0,82,5.86,50,250,2620,9.2
2617,Boo Nieves,2021-22,28.0,6,10,43,43,4,6,10,34.0,415.0,72,5,14,19,57.0,82,5.96,47,239,2579,9.5
2618,Boo Nieves,2022-23,29.0,7,0,4,4,0,0,0,2.0,30.0,76,5,14,19,59.0,70,5.96,42,208,2192,9.5
2619,Boone Jenner,2016-17,23.0,4,29,72,72,16,13,29,127.0,1014.0,72,16,13,29,127.0,82,5.34,48,269,2463,8.9
2620,Boone Jenner,2017-18,24.0,5,17,31,31,9,8,17,83.0,566.0,103,25,21,46,210.0,82,5.32,47,251,2453,8.9
2621,Boone Jenner,2018-19,25.0,6,49,82,82,30,19,49,225.0,1346.0,185,55,40,95,435.0,82,5.34,48,255,2438,9.0
2622,Boone Jenner,2019-20,26.0,7,34,82,82,18,16,34,211.0,1317.0,267,73,56,129,646.0,82,5.45,47,245,2478,9.0
2623,Boone Jenner,2020-21,27.0,8,32,75,75,13,19,32,187.0,1235.0,342,86,75,161,833.0,82,5.86,50,250,2620,9.2
2624,Boone Jenner,2021-22,28.0,9,38,77,77,16,22,38,170.0,1314.0,419,102,97,199,1003.0,82,5.96,47,239,2579,9.5
2625,Boone Jenner,2022-23,29.0,10,24,70,70,11,13,24,179.0,1268.0,489,113,110,223,1182.0,70,5.96,42,208,2192,9.5
2626,Boris Mironov,1996-97,24.0,4,31,79,79,7,24,31,145.0,,79,7,24,31,145.0,84,6.48,76,407,2545,10.7
2627,Boris Mironov,1997-98,25.0,5,8,29,29,1,7,8,48.0,,108,8,31,39,193.0,48,5.97,37,209,1408,10.2
2628,Boris Mironov,1998-99,26.0,6,32,78,78,8,24,32,158.0,,186,16,55,71,351.0,82,6.29,74,413,2481,10.4
2629,Boris Mironov,1999-00,27.0,7,32,55,55,6,26,32,147.0,,241,22,81,103,498.0,82,5.83,55,336,2444,9.8
2630,Boris Mironov,2000-01,28.0,8,46,81,81,16,30,46,203.0,,322,38,111,149,701.0,82,5.28,57,380,2242,9.6
2631,Boris Mironov,2001-02,29.0,9,49,75,75,11,38,49,173.0,1924.0,397,49,149,198,874.0,82,5.27,57,359,2285,9.4
2632,Boris Mironov,2002-03,30.0,10,37,58,58,9,28,37,144.0,1443.0,455,58,177,235,1018.0,82,5.49,53,331,2294,9.8
2633,Boris Mironov,2003-04,31.0,11,22,66,66,5,17,22,143.0,1458.0,521,63,194,257,1161.0,82,5.51,63,376,2272,9.9
2634,Boris Mironov,2004-05,32.0,12,18,64,64,4,14,18,129.0,1454.0,585,67,208,275,1290.0,82,5.24,53,338,2262,9.5
2635,Boris Mironov,2005-06,33.0,13,16,56,56,6,10,16,70.0,1125.0,641,73,218,291,1360.0,82,5.31,60,363,2326,9.4
2636,Boris Mironov,2006-07,34.0,14,16,75,75,3,13,16,129.0,1547.0,716,76,231,307,1489.0,82,5.14,57,348,2300,9.2
2637,Boris Valabik,2010-11,24.0,4,0,7,7,0,0,0,5.0,117.0,7,0,0,0,5.0,82,5.44,62,351,2383,9.4
2638,Boris Valabik,2011-12,25.0,5,5,50,50,0,5,5,16.0,762.0,57,0,5,5,21.0,82,5.7,65,341,2477,9.4
2639,Boris Valabik,2012-13,26.0,6,2,23,23,0,2,2,22.0,304.0,80,0,7,7,43.0,82,5.53,56,304,2486,9.1
2640,Borna Rendulic,2017-18,25.0,4,2,11,11,1,1,2,6.0,103.0,11,1,1,2,6.0,82,5.32,47,251,2453,8.9
2641,Borna Rendulic,2018-19,26.0,5,0,3,3,0,0,0,1.0,23.0,14,1,1,2,7.0,82,5.34,48,255,2438,9.0
2642,Borna Rendulic,2019-20,27.0,6,0,1,1,0,0,0,1.0,5.0,15,1,1,2,8.0,82,5.45,47,245,2478,9.0
2643,Boyd Devereaux,2000-01,22.0,4,5,38,38,1,4,5,27.0,,38,1,4,5,27.0,82,5.28,57,380,2242,9.6
2644,Boyd Devereaux,2001-02,23.0,5,14,61,61,6,8,14,39.0,619.0,99,7,12,19,66.0,82,5.27,57,359,2285,9.4
2645,Boyd Devereaux,2002-03,24.0,6,27,76,76,8,19,27,108.0,958.0,175,15,31,46,174.0,82,5.49,53,331,2294,9.8
2646,Boyd Devereaux,2003-04,25.0,7,11,55,55,5,6,11,66.0,557.0,230,20,37,57,240.0,82,5.51,63,376,2272,9.9
2647,Boyd Devereaux,2004-05,26.0,8,25,79,79,9,16,25,116.0,909.0,309,29,53,82,356.0,82,5.24,53,338,2262,9.5
2648,Boyd Devereaux,2005-06,27.0,9,12,61,61,3,9,12,72.0,575.0,370,32,62,94,428.0,82,5.31,60,363,2326,9.4
2649,Boyd Devereaux,2006-07,28.0,10,15,61,61,6,9,15,62.0,608.0,431,38,71,109,490.0,82,5.14,57,348,2300,9.2
2650,Boyd Devereaux,2008-09,30.0,11,22,78,78,8,14,22,76.0,997.0,509,46,85,131,566.0,82,6.05,85,480,2458,10.1
2651,Boyd Devereaux,2009-10,31.0,12,19,33,33,8,11,19,57.0,504.0,542,54,96,150,623.0,82,5.76,70,398,2426,9.7
2652,Boyd Devereaux,2010-11,32.0,13,18,62,62,7,11,18,81.0,866.0,604,61,107,168,704.0,82,5.44,62,351,2383,9.4
2653,Boyd Devereaux,2011-12,33.0,14,11,23,23,6,5,11,41.0,315.0,627,67,112,179,745.0,82,5.7,65,341,2477,9.4
2654,Boyd Gordon,2006-07,23.0,4,6,41,41,1,5,6,42.0,540.0,41,1,5,6,42.0,82,5.14,57,348,2300,9.2
2655,Boyd Gordon,2008-09,25.0,5,1,25,25,0,1,1,12.0,292.0,66,1,6,7,54.0,82,6.05,85,480,2458,10.1
2656,Boyd Gordon,2009-10,26.0,6,29,71,71,7,22,29,104.0,1127.0,137,8,28,36,158.0,82,5.76,70,398,2426,9.7
2657,Boyd Gordon,2010-11,27.0,7,16,67,67,7,9,16,100.0,1054.0,204,15,37,52,258.0,82,5.44,62,351,2383,9.4
2658,Boyd Gordon,2011-12,28.0,8,14,63,63,5,9,14,69.0,848.0,267,20,46,66,327.0,82,5.7,65,341,2477,9.4
2659,Boyd Gordon,2012-13,29.0,9,10,36,36,4,6,10,40.0,370.0,303,24,52,76,367.0,82,5.53,56,304,2486,9.1
2660,Boyd Gordon,2013-14,30.0,10,9,60,60,3,6,9,77.0,783.0,363,27,58,85,444.0,82,5.46,52,291,2492,9.0
2661,Boyd Gordon,2014-15,31.0,11,23,75,75,8,15,23,114.0,1194.0,438,35,73,108,558.0,82,5.32,47,271,2439,8.9
2662,Boyd Gordon,2015-16,32.0,12,14,48,48,4,10,14,59.0,721.0,486,39,83,122,617.0,48,5.31,29,160,1399,9.1
2663,Boyd Gordon,2016-17,33.0,13,21,74,74,8,13,21,80.0,1092.0,560,47,96,143,697.0,82,5.34,48,269,2463,8.9
2664,Boyd Gordon,2017-18,34.0,14,13,68,68,6,7,13,65.0,906.0,628,53,103,156,762.0,82,5.32,47,251,2453,8.9
2665,Boyd Gordon,2018-19,35.0,15,4,65,65,2,2,4,53.0,793.0,693,55,105,160,815.0,82,5.34,48,255,2438,9.0
2666,Boyd Gordon,2019-20,36.0,16,1,13,13,1,0,1,8.0,106.0,706,56,105,161,823.0,82,5.45,47,245,2478,9.0
2667,Boyd Kane,2006-07,28.0,4,0,7,7,0,0,0,6.0,70.0,7,0,0,0,6.0,82,5.14,57,348,2300,9.2
2668,Boyd Kane,2008-09,30.0,5,1,5,5,0,1,1,1.0,20.0,12,0,1,1,7.0,82,6.05,85,480,2458,10.1
2669,Boyd Kane,2009-10,31.0,6,2,15,15,0,2,2,7.0,104.0,27,0,3,3,14.0,82,5.76,70,398,2426,9.7
2670,Boyd Kane,2011-12,33.0,7,0,1,1,0,0,0,0.0,8.0,28,0,3,3,14.0,82,5.7,65,341,2477,9.4
2671,Boyd Kane,2012-13,34.0,8,0,3,3,0,0,0,2.0,25.0,31,0,3,3,16.0,82,5.53,56,304,2486,9.1
2672,Bracken Kearns,2014-15,33.0,4,0,5,5,0,0,0,0.0,36.0,5,0,0,0,0.0,82,5.32,47,271,2439,8.9
2673,Bracken Kearns,2015-16,34.0,5,0,1,1,0,0,0,0.0,12.0,6,0,0,0,0.0,48,5.31,29,160,1399,9.1
2674,Bracken Kearns,2016-17,35.0,6,5,25,25,3,2,5,37.0,330.0,31,3,2,5,37.0,82,5.34,48,269,2463,8.9
2675,Bracken Kearns,2018-19,37.0,7,1,2,2,0,1,1,0.0,32.0,33,3,3,6,37.0,82,5.34,48,255,2438,9.0
2676,Bracken Kearns,2019-20,38.0,8,0,2,2,0,0,0,3.0,22.0,35,3,3,6,40.0,82,5.45,47,245,2478,9.0
2677,Brad Aitken,1990-91,23.0,4,2,5,5,1,1,2,4.0,,5,1,1,2,4.0,80,7.43,89,437,2435,12.2
2678,Brad Aitken,1993-94,26.0,5,2,9,9,0,2,2,3.0,,14,1,3,4,7.0,80,6.91,71,366,2385,11.6
2679,Brad Berry,1988-89,23.0,4,1,13,13,1,0,1,15.0,,13,1,0,1,15.0,80,7.94,82,370,2484,12.8
2680,Brad Berry,1989-90,24.0,5,10,52,52,2,8,10,40.0,,65,3,8,11,55.0,80,7.34,72,344,2400,12.2
2681,Brad Berry,1990-91,25.0,6,6,48,48,0,6,6,31.0,,113,3,14,17,86.0,80,7.43,89,437,2435,12.2
2682,Brad Berry,1991-92,26.0,7,9,38,38,0,9,9,21.0,,151,3,23,26,107.0,80,7.48,85,403,2430,12.3
2683,Brad Berry,1992-93,27.0,8,3,12,12,1,2,3,7.0,,163,4,25,29,114.0,80,7.37,76,367,2421,12.2
2684,Brad Berry,1994-95,29.0,9,0,7,7,0,0,0,2.0,,170,4,25,29,116.0,80,6.96,77,402,2440,11.4
2685,Brad Berry,1995-96,30.0,10,3,63,63,0,3,3,49.0,,233,4,28,32,165.0,84,7.25,87,443,2603,11.7
2686,Brad Berry,1996-97,31.0,11,0,8,8,0,0,0,4.0,,241,4,28,32,169.0,84,6.48,76,407,2545,10.7
2687,Brad Bombardir,2000-01,28.0,4,6,43,43,1,5,6,16.0,,43,1,5,6,16.0,82,5.28,57,380,2242,9.6
2688,Brad Bombardir,2001-02,29.0,5,8,56,56,1,7,8,47.0,843.0,99,2,12,14,63.0,82,5.27,57,359,2285,9.4
2689,Brad Bombardir,2002-03,30.0,6,4,32,32,3,1,4,24.0,509.0,131,5,13,18,87.0,82,5.49,53,331,2294,9.8
2690,Brad Bombardir,2003-04,31.0,7,15,70,70,0,15,15,81.0,1458.0,201,5,28,33,168.0,82,5.51,63,376,2272,9.9
2691,Brad Bombardir,2004-05,32.0,8,3,28,28,1,2,3,24.0,575.0,229,6,30,36,192.0,82,5.24,53,338,2262,9.5
2692,Brad Bombardir,2005-06,33.0,9,15,58,58,1,14,15,55.0,1277.0,287,7,44,51,247.0,82,5.31,60,363,2326,9.4
2693,Brad Bombardir,2006-07,34.0,10,3,69,69,1,2,3,47.0,1380.0,356,8,46,54,294.0,82,5.14,57,348,2300,9.2
2694,Brad Boyes,2006-07,24.0,4,0,1,1,0,0,0,0.0,13.0,1,0,0,0,0.0,82,5.14,57,348,2300,9.2
2695,Brad Boyes,2008-09,26.0,5,69,82,82,26,43,69,203.0,1293.0,83,26,43,69,203.0,82,6.05,85,480,2458,10.1
2696,Brad Boyes,2009-10,27.0,6,46,81,81,17,29,46,182.0,1327.0,164,43,72,115,385.0,82,5.76,70,398,2426,9.7
2697,Brad Boyes,2010-11,28.0,7,65,82,82,43,22,65,207.0,1471.0,246,86,94,180,592.0,82,5.44,62,351,2383,9.4
2698,Brad Boyes,2011-12,29.0,8,72,82,82,33,39,72,220.0,1570.0,328,119,133,252,812.0,82,5.7,65,341,2477,9.4
2699,Brad Boyes,2012-13,30.0,9,42,82,82,14,28,42,197.0,1377.0,410,133,161,294,1009.0,82,5.53,56,304,2486,9.1
2700,Brad Boyes,2013-14,31.0,10,55,83,83,17,38,55,178.0,1410.0,493,150,199,349,1187.0,82,5.46,52,291,2492,9.0
2701,Brad Boyes,2014-15,32.0,11,23,65,65,8,15,23,100.0,856.0,558,158,214,372,1287.0,82,5.32,47,271,2439,8.9
2702,Brad Boyes,2015-16,33.0,12,35,48,48,10,25,35,97.0,874.0,606,168,239,407,1384.0,48,5.31,29,160,1399,9.1
2703,Brad Boyes,2016-17,34.0,13,36,78,78,21,15,36,176.0,1329.0,684,189,254,443,1560.0,82,5.34,48,269,2463,8.9
2704,Brad Boyes,2017-18,35.0,14,38,78,78,14,24,38,151.0,1221.0,762,203,278,481,1711.0,82,5.32,47,251,2453,8.9
2705,Brad Boyes,2018-19,36.0,15,24,60,60,8,16,24,85.0,718.0,822,211,294,505,1796.0,82,5.34,48,255,2438,9.0
2706,Brad Brown,1999-00,24.0,4,0,8,8,0,0,0,0.0,,8,0,0,0,0.0,82,5.83,55,336,2444,9.8
2707,Brad Brown,2001-02,26.0,5,8,66,66,1,7,8,26.0,953.0,74,1,7,8,26.0,82,5.27,57,359,2285,9.4
2708,Brad Brown,2002-03,27.0,6,9,57,57,0,9,9,15.0,809.0,131,1,16,17,41.0,82,5.49,53,331,2294,9.8
2709,Brad Brown,2003-04,28.0,7,4,48,48,1,3,4,14.0,697.0,179,2,19,21,55.0,82,5.51,63,376,2272,9.9
2710,Brad Brown,2004-05,29.0,8,4,51,51,0,4,4,23.0,811.0,230,2,23,25,78.0,82,5.24,53,338,2262,9.5
2711,Brad Brown,2005-06,30.0,9,1,57,57,0,1,1,10.0,526.0,287,2,24,26,88.0,82,5.31,60,363,2326,9.4
2712,Brad Brown,2006-07,31.0,10,3,43,43,0,3,3,20.0,506.0,330,2,27,29,108.0,82,5.14,57,348,2300,9.2
2713,Brad Chartrand,2002-03,28.0,4,12,50,50,6,6,12,51.0,552.0,50,6,6,12,51.0,82,5.49,53,331,2294,9.8
2714,Brad Chartrand,2003-04,29.0,5,1,4,4,1,0,1,6.0,46.0,54,7,6,13,57.0,82,5.51,63,376,2272,9.9
2715,Brad Chartrand,2004-05,30.0,6,16,46,46,7,9,16,49.0,556.0,100,14,15,29,106.0,82,5.24,53,338,2262,9.5
2716,Brad Chartrand,2005-06,31.0,7,14,62,62,8,6,14,64.0,759.0,162,22,21,43,170.0,82,5.31,60,363,2326,9.4
2717,Brad Chartrand,2006-07,32.0,8,7,53,53,3,4,7,63.0,615.0,215,25,25,50,233.0,82,5.14,57,348,2300,9.2
2718,Brad Church,2000-01,24.0,4,0,2,2,0,0,0,4.0,,2,0,0,0,4.0,82,5.28,57,380,2242,9.6
2719,Brad Dalgarno,1988-89,21.0,4,1,2,2,1,0,1,3.0,,2,1,0,1,3.0,80,7.94,82,370,2484,12.8
2720,Brad Dalgarno,1990-91,23.0,5,10,38,38,2,8,10,39.0,,40,3,8,11,42.0,80,7.43,89,437,2435,12.2
2721,Brad Dalgarno,1991-92,24.0,6,21,55,55,11,10,21,83.0,,95,14,18,32,125.0,80,7.48,85,403,2430,12.3
2722,Brad Dalgarno,1993-94,26.0,7,15,41,41,3,12,15,34.0,,136,17,30,47,159.0,80,6.91,71,366,2385,11.6
2723,Brad Dalgarno,1994-95,27.0,8,3,15,15,2,1,3,17.0,,151,19,31,50,176.0,80,6.96,77,402,2440,11.4
2724,Brad Dalgarno,1995-96,28.0,9,32,57,57,15,17,32,62.0,,208,34,48,82,238.0,84,7.25,87,443,2603,11.7
2725,Brad Dalgarno,1996-97,29.0,10,30,73,73,11,19,30,97.0,,281,45,67,112,335.0,84,6.48,76,407,2545,10.7
2726,Brad Dalgarno,1997-98,30.0,11,5,22,22,3,2,5,18.0,,303,48,69,117,353.0,48,5.97,37,209,1408,10.2
2727,Brad Dalgarno,1998-99,31.0,12,3,18,18,1,2,3,11.0,,321,49,71,120,364.0,82,6.29,74,413,2481,10.4
2728,Brad DeFauw,2005-06,28.0,4,3,9,9,3,0,3,19.0,124.0,9,3,0,3,19.0,82,5.31,60,363,2326,9.4
2729,Brad Fast,2006-07,26.0,4,1,1,1,1,0,1,4.0,21.0,1,1,0,1,4.0,82,5.14,57,348,2300,9.2
2730,Brad Ference,2002-03,23.0,4,2,13,13,0,2,2,10.0,178.0,13,0,2,2,10.0,82,5.49,53,331,2294,9.8
2731,Brad Ference,2003-04,24.0,5,1,14,14,0,1,1,5.0,183.0,27,0,3,3,15.0,82,5.51,63,376,2272,9.9
2732,Brad Ference,2004-05,25.0,6,17,80,80,2,15,17,65.0,1579.0,107,2,18,20,80.0,82,5.24,53,338,2262,9.5
2733,Brad Ference,2005-06,26.0,7,9,75,75,2,7,9,49.0,1206.0,182,4,25,29,129.0,82,5.31,60,363,2326,9.4
2734,Brad Ference,2006-07,27.0,8,5,63,63,0,5,5,39.0,885.0,245,4,30,34,168.0,82,5.14,57,348,2300,9.2
2735,Brad Ference,2009-10,30.0,9,0,5,5,0,0,0,1.0,59.0,250,4,30,34,169.0,82,5.76,70,398,2426,9.7
2736,Brad Hunt,2016-17,28.0,4,0,3,3,0,0,0,1.0,38.0,3,0,0,0,1.0,82,5.34,48,269,2463,8.9
2737,Brad Hunt,2017-18,29.0,5,3,11,11,1,2,3,20.0,214.0,14,1,2,3,21.0,82,5.32,47,251,2453,8.9
2738,Brad Hunt,2018-19,30.0,6,0,7,7,0,0,0,12.0,99.0,21,1,2,3,33.0,82,5.34,48,255,2438,9.0
2739,Brad Hunt,2019-20,31.0,7,6,12,12,1,5,6,14.0,174.0,33,2,7,9,47.0,82,5.45,47,245,2478,9.0
2740,Brad Hunt,2020-21,32.0,8,18,45,45,3,15,18,80.0,749.0,78,5,22,27,127.0,82,5.86,50,250,2620,9.2
2741,Brad Hunt,2021-22,33.0,9,12,42,42,5,7,12,75.0,625.0,120,10,29,39,202.0,82,5.96,47,239,2579,9.5
2742,Brad Hunt,2022-23,34.0,10,19,59,59,8,11,19,106.0,893.0,179,18,40,58,308.0,70,5.96,42,208,2192,9.5
2743,Brad Isbister,2000-01,23.0,4,17,66,66,9,8,17,115.0,,66,9,8,17,115.0,82,5.28,57,380,2242,9.6
2744,Brad Isbister,2001-02,24.0,5,8,32,32,4,4,8,48.0,370.0,98,13,12,25,163.0,82,5.27,57,359,2285,9.4
2745,Brad Isbister,2002-03,25.0,6,42,64,64,22,20,42,135.0,1086.0,162,35,32,67,298.0,82,5.49,53,331,2294,9.8
2746,Brad Isbister,2003-04,26.0,7,32,51,51,18,14,32,129.0,991.0,213,53,46,99,427.0,82,5.51,63,376,2272,9.9
2747,Brad Isbister,2004-05,27.0,8,38,79,79,17,21,38,142.0,1209.0,292,70,67,137,569.0,82,5.24,53,338,2262,9.5
2748,Brad Isbister,2005-06,28.0,9,28,66,66,13,15,28,119.0,909.0,358,83,82,165,688.0,82,5.31,60,363,2326,9.4
2749,Brad Isbister,2006-07,29.0,10,18,51,51,10,8,18,80.0,651.0,409,93,90,183,768.0,82,5.14,57,348,2300,9.2
2750,Brad Isbister,2008-09,31.0,11,23,58,58,6,17,23,112.0,807.0,467,99,107,206,880.0,82,6.05,85,480,2458,10.1
2751,Brad Isbister,2009-10,32.0,12,5,19,19,1,4,5,36.0,259.0,486,100,111,211,916.0,82,5.76,70,398,2426,9.7
2752,Brad Isbister,2010-11,33.0,13,11,55,55,6,5,11,71.0,595.0,541,106,116,222,987.0,82,5.44,62,351,2383,9.4
2753,Brad Jones,1989-90,24.0,4,1,4,4,1,0,1,8.0,,4,1,0,1,8.0,80,7.34,72,344,2400,12.2
2754,Brad Jones,1990-91,25.0,5,7,19,19,2,5,7,33.0,,23,3,5,8,41.0,80,7.43,89,437,2435,12.2
2755,Brad Jones,1991-92,26.0,6,11,22,22,6,5,11,25.0,,45,9,10,19,66.0,80,7.48,85,403,2430,12.3
2756,Brad Jones,1992-93,27.0,7,0,2,2,0,0,0,0.0,,47,9,10,19,66.0,80,7.37,76,367,2421,12.2
2757,Brad Jones,1993-94,28.0,8,20,53,53,9,11,20,47.0,,100,18,21,39,113.0,80,6.91,71,366,2385,11.6
2758,Brad Jones,1994-95,29.0,9,17,48,48,7,10,17,67.0,,148,25,31,56,180.0,80,6.96,77,402,2440,11.4
2759,Brad Larsen,2000-01,23.0,4,0,1,1,0,0,0,0.0,,1,0,0,0,0.0,82,5.28,57,380,2242,9.6
2760,Brad Larsen,2003-04,26.0,5,0,9,9,0,0,0,3.0,84.0,10,0,0,0,3.0,82,5.51,63,376,2272,9.9
2761,Brad Larsen,2004-05,27.0,6,9,50,50,2,7,9,38.0,406.0,60,2,7,9,41.0,82,5.24,53,338,2262,9.5
2762,Brad Larsen,2005-06,28.0,7,3,6,6,0,3,3,6.0,50.0,66,2,10,12,47.0,82,5.31,60,363,2326,9.4
2763,Brad Larsen,2006-07,29.0,8,4,32,32,2,2,4,23.0,282.0,98,4,12,16,70.0,82,5.14,57,348,2300,9.2
2764,Brad Larsen,2008-09,31.0,9,15,62,62,7,8,15,48.0,681.0,160,11,20,31,118.0,82,6.05,85,480,2458,10.1
2765,Brad Larsen,2009-10,32.0,10,13,72,72,7,6,13,61.0,891.0,232,18,26,44,179.0,82,5.76,70,398,2426,9.7
2766,Brad Larsen,2010-11,33.0,11,4,62,62,1,3,4,35.0,560.0,294,19,29,48,214.0,82,5.44,62,351,2383,9.4
2767,Brad Lauer,1989-90,23.0,4,21,61,61,7,14,21,75.0,,61,7,14,21,75.0,80,7.34,72,344,2400,12.2
2768,Brad Lauer,1990-91,24.0,5,35,69,69,17,18,35,94.0,,130,24,32,56,169.0,80,7.43,89,437,2435,12.2
2769,Brad Lauer,1991-92,25.0,6,5,14,14,3,2,5,21.0,,144,27,34,61,190.0,80,7.48,85,403,2430,12.3
2770,Brad Lauer,1992-93,26.0,7,24,63,63,6,18,24,86.0,,207,33,52,85,276.0,80,7.37,76,367,2421,12.2
2771,Brad Lauer,1993-94,27.0,8,12,44,44,4,8,12,70.0,,251,37,60,97,346.0,80,6.91,71,366,2385,11.6
2772,Brad Lauer,1994-95,28.0,9,1,14,14,1,0,1,18.0,,265,38,60,98,364.0,80,6.96,77,402,2440,11.4
2773,Brad Lauer,1995-96,29.0,10,1,7,7,0,1,1,8.0,,272,38,61,99,372.0,84,7.25,87,443,2603,11.7
2774,Brad Lauer,1996-97,30.0,11,7,30,30,2,5,7,45.0,,302,40,66,106,417.0,84,6.48,76,407,2545,10.7
2775,Brad Lauer,1998-99,32.0,12,5,21,21,4,1,5,29.0,,323,44,67,111,446.0,82,6.29,74,413,2481,10.4
2776,Brad Leeb,2002-03,23.0,4,0,2,2,0,0,0,3.0,24.0,2,0,0,0,3.0,82,5.49,53,331,2294,9.8
2777,Brad Leeb,2004-05,25.0,5,0,2,2,0,0,0,1.0,19.0,4,0,0,0,4.0,82,5.24,53,338,2262,9.5
2778,Brad Leeb,2006-07,27.0,6,0,1,1,0,0,0,1.0,11.0,5,0,0,0,5.0,82,5.14,57,348,2300,9.2
2779,Brad Lukowich,2000-01,24.0,4,1,4,4,0,1,1,2.0,,4,0,1,1,2.0,82,5.28,57,380,2242,9.6
2780,Brad Lukowich,2001-02,25.0,5,3,14,14,1,2,3,8.0,228.0,18,1,3,4,10.0,82,5.27,57,359,2285,9.4
2781,Brad Lukowich,2002-03,26.0,6,4,60,60,3,1,4,33.0,704.0,78,4,4,8,43.0,82,5.49,53,331,2294,9.8
2782,Brad Lukowich,2003-04,27.0,7,14,80,80,4,10,14,43.0,1184.0,158,8,14,22,86.0,82,5.51,63,376,2272,9.9
2783,Brad Lukowich,2004-05,28.0,8,7,66,66,1,6,7,56.0,873.0,224,9,20,29,142.0,82,5.24,53,338,2262,9.5
2784,Brad Lukowich,2005-06,29.0,9,15,70,70,1,14,15,52.0,1230.0,294,10,34,44,194.0,82,5.31,60,363,2326,9.4
2785,Brad Lukowich,2006-07,30.0,10,19,79,79,5,14,19,86.0,1482.0,373,15,48,63,280.0,82,5.14,57,348,2300,9.2
2786,Brad Lukowich,2008-09,32.0,11,21,75,75,2,19,21,49.0,1443.0,448,17,67,84,329.0,82,6.05,85,480,2458,10.1
2787,Brad Lukowich,2009-10,33.0,12,12,75,75,4,8,12,50.0,1517.0,523,21,75,96,379.0,82,5.76,70,398,2426,9.7
2788,Brad Lukowich,2010-11,34.0,13,7,59,59,1,6,7,28.0,980.0,582,22,81,103,407.0,82,5.44,62,351,2383,9.4
2789,Brad Lukowich,2011-12,35.0,14,8,58,58,0,8,8,43.0,940.0,640,22,89,111,450.0,82,5.7,65,341,2477,9.4
2790,Brad Lukowich,2012-13,36.0,15,2,13,13,1,1,2,1.0,146.0,653,23,90,113,451.0,82,5.53,56,304,2486,9.1
2791,Brad Lukowich,2013-14,37.0,16,0,5,5,0,0,0,3.0,51.0,658,23,90,113,454.0,82,5.46,52,291,2492,9.0
2792,Brad Malone,2014-15,25.0,4,2,9,9,0,2,2,6.0,90.0,9,0,2,2,6.0,82,5.32,47,271,2439,8.9
2793,Brad Malone,2015-16,26.0,5,2,13,13,1,1,2,10.0,114.0,22,1,3,4,16.0,48,5.31,29,160,1399,9.1
2794,Brad Malone,2016-17,27.0,6,5,32,32,3,2,5,16.0,217.0,54,4,5,9,32.0,82,5.34,48,269,2463,8.9
2795,Brad Malone,2017-18,28.0,7,15,65,65,7,8,15,65.0,660.0,119,11,13,24,97.0,82,5.32,47,251,2453,8.9
2796,Brad Malone,2018-19,29.0,8,6,57,57,2,4,6,31.0,544.0,176,13,17,30,128.0,82,5.34,48,255,2438,9.0
2797,Brad Malone,2020-21,31.0,9,0,7,7,0,0,0,9.0,56.0,183,13,17,30,137.0,82,5.86,50,250,2620,9.2
2798,Brad Malone,2021-22,32.0,10,0,16,16,0,0,0,13.0,143.0,199,13,17,30,150.0,82,5.96,47,239,2579,9.5
2799,Brad Marchand,2012-13,24.0,4,1,20,20,0,1,1,32.0,239.0,20,0,1,1,32.0,82,5.53,56,304,2486,9.1
2800,Brad Marchand,2013-14,25.0,5,41,77,77,21,20,41,149.0,1077.0,97,21,21,42,181.0,82,5.46,52,291,2492,9.0
2801,Brad Marchand,2014-15,26.0,6,55,76,76,28,27,55,167.0,1339.0,173,49,48,97,348.0,82,5.32,47,271,2439,8.9
2802,Brad Marchand,2015-16,27.0,7,36,45,45,18,18,36,91.0,763.0,218,67,66,133,439.0,48,5.31,29,160,1399,9.1
2803,Brad Marchand,2016-17,28.0,8,53,82,82,25,28,53,149.0,1308.0,300,92,94,186,588.0,82,5.34,48,269,2463,8.9
2804,Brad Marchand,2017-18,29.0,9,42,77,77,24,18,42,180.0,1301.0,377,116,112,228,768.0,82,5.32,47,251,2453,8.9
2805,Brad Marchand,2018-19,30.0,10,61,77,77,37,24,61,250.0,1432.0,454,153,136,289,1018.0,82,5.34,48,255,2438,9.0
2806,Brad Marchand,2019-20,31.0,11,85,80,80,39,46,85,226.0,1555.0,534,192,182,374,1244.0,82,5.45,47,245,2478,9.0
2807,Brad Marchand,2020-21,32.0,12,85,68,68,34,51,85,182.0,1341.0,602,226,233,459,1426.0,82,5.86,50,250,2620,9.2
2808,Brad Marchand,2021-22,33.0,13,100,79,79,36,64,100,231.0,1550.0,681,262,297,559,1657.0,82,5.96,47,239,2579,9.5
2809,Brad Marchand,2022-23,34.0,14,87,70,70,28,59,87,185.0,1362.0,751,290,356,646,1842.0,70,5.96,42,208,2192,9.5
2810,Brad May,1994-95,23.0,4,17,69,69,11,6,17,82.0,,69,11,6,17,82.0,80,6.96,77,402,2440,11.4
2811,Brad May,1995-96,24.0,5,26,82,82,13,13,26,114.0,,151,24,19,43,196.0,84,7.25,87,443,2603,11.7
2812,Brad May,1996-97,25.0,6,45,84,84,18,27,45,166.0,,235,42,46,88,362.0,84,6.48,76,407,2545,10.7
2813,Brad May,1997-98,26.0,7,6,33,33,3,3,6,42.0,,268,45,49,94,404.0,48,5.97,37,209,1408,10.2
2814,Brad May,1998-99,27.0,8,44,79,79,15,29,44,168.0,,347,60,78,138,572.0,82,6.29,74,413,2481,10.4
2815,Brad May,1999-00,28.0,9,7,42,42,3,4,7,75.0,,389,63,82,145,647.0,82,5.83,55,336,2444,9.8
2816,Brad May,2000-01,29.0,10,23,63,63,13,10,23,97.0,,452,76,92,168,744.0,82,5.28,57,380,2242,9.6
2817,Brad May,2001-02,30.0,11,17,66,66,6,11,17,91.0,862.0,518,82,103,185,835.0,82,5.27,57,359,2285,9.4
2818,Brad May,2002-03,31.0,12,16,59,59,9,7,16,66.0,613.0,577,91,110,201,901.0,82,5.49,53,331,2294,9.8
2819,Brad May,2003-04,32.0,13,25,62,62,11,14,25,83.0,693.0,639,102,124,226,984.0,82,5.51,63,376,2272,9.9
2820,Brad May,2004-05,33.0,14,22,72,72,10,12,22,105.0,869.0,711,112,136,248,1089.0,82,5.24,53,338,2262,9.5
2821,Brad May,2005-06,34.0,15,7,23,23,3,4,7,25.0,222.0,734,115,140,255,1114.0,82,5.31,60,363,2326,9.4
2822,Brad May,2006-07,35.0,16,11,70,70,5,6,11,75.0,625.0,804,120,146,266,1189.0,82,5.14,57,348,2300,9.2
2823,Brad May,2008-09,37.0,17,6,54,54,3,3,6,55.0,453.0,858,123,149,272,1244.0,82,6.05,85,480,2458,10.1
2824,Brad May,2009-10,38.0,18,4,24,24,0,4,4,22.0,236.0,882,123,153,276,1266.0,82,5.76,70,398,2426,9.7
2825,Brad May,2010-11,39.0,19,4,61,61,3,1,4,34.0,404.0,943,126,154,280,1300.0,82,5.44,62,351,2383,9.4
2826,Brad May,2011-12,40.0,20,7,58,58,1,6,7,32.0,421.0,1001,127,160,287,1332.0,82,5.7,65,341,2477,9.4
2827,Brad May,2012-13,41.0,21,1,40,40,0,1,1,26.0,279.0,1041,127,161,288,1358.0,82,5.53,56,304,2486,9.1
2828,Brad McCrimmon,1982-83,23.0,4,16,72,72,5,11,16,89.0,,72,5,11,16,89.0,80,7.03,61,280,2352,12.0
2829,Brad McCrimmon,1983-84,24.0,5,29,78,78,11,18,29,115.0,,150,16,29,45,204.0,80,7.69,77,340,2441,12.6
2830,Brad McCrimmon,1984-85,25.0,6,9,78,78,1,8,9,136.0,,228,17,37,54,340.0,80,8.03,73,320,2489,12.9
2831,Brad McCrimmon,1985-86,26.0,7,25,79,79,4,21,25,107.0,,307,21,58,79,447.0,80,7.73,71,310,2444,12.7
2832,Brad McCrimmon,1986-87,27.0,8,24,71,71,0,24,24,107.0,,378,21,82,103,554.0,80,7.89,74,336,2448,12.9
2833,Brad McCrimmon,1987-88,28.0,9,43,66,66,8,35,43,145.0,,444,29,117,146,699.0,80,7.77,71,321,2447,12.7
2834,Brad McCrimmon,1988-89,29.0,10,56,80,80,13,43,56,167.0,,524,42,160,202,866.0,80,7.94,82,370,2484,12.8
2835,Brad McCrimmon,1989-90,30.0,11,39,71,71,10,29,39,110.0,,595,52,189,241,976.0,80,7.34,72,344,2400,12.2
2836,Brad McCrimmon,1990-91,31.0,12,42,80,80,7,35,42,102.0,,675,59,224,283,1078.0,80,7.43,89,437,2435,12.2
2837,Brad McCrimmon,1991-92,32.0,13,22,72,72,5,17,22,78.0,,747,64,241,305,1156.0,80,7.48,85,403,2430,12.3
2838,Brad McCrimmon,1992-93,33.0,14,19,79,79,4,15,19,97.0,,826,68,256,324,1253.0,80,7.37,76,367,2421,12.2
2839,Brad McCrimmon,1993-94,34.0,15,13,64,64,0,13,13,43.0,,890,68,269,337,1296.0,80,6.91,71,366,2385,11.6
2840,Brad McCrimmon,1994-95,35.0,16,29,79,79,7,22,29,94.0,,969,75,291,366,1390.0,80,6.96,77,402,2440,11.4
2841,Brad McCrimmon,1995-96,36.0,17,15,60,60,1,14,15,53.0,,1029,76,305,381,1443.0,84,7.25,87,443,2603,11.7
2842,Brad McCrimmon,1996-97,37.0,18,6,65,65,1,5,6,39.0,,1094,77,310,387,1482.0,84,6.48,76,407,2545,10.7
2843,Brad McCrimmon,1997-98,38.0,19,1,33,33,0,1,1,13.0,,1127,77,311,388,1495.0,48,5.97,37,209,1408,10.2
2844,Brad McCrimmon,1998-99,39.0,20,9,58,58,3,6,9,39.0,,1185,80,317,397,1534.0,82,6.29,74,413,2481,10.4
2845,Brad McCrimmon,1999-00,40.0,21,6,37,37,1,5,6,28.0,,1222,81,322,403,1562.0,82,5.83,55,336,2444,9.8
2846,Brad Miller,1991-92,22.0,4,0,7,7,0,0,0,0.0,,7,0,0,0,0.0,80,7.48,85,403,2430,12.3
2847,Brad Miller,1992-93,23.0,5,0,1,1,0,0,0,0.0,,8,0,0,0,0.0,80,7.37,76,367,2421,12.2
2848,Brad Miller,1993-94,24.0,6,0,13,13,0,0,0,4.0,,21,0,0,0,4.0,80,6.91,71,366,2385,11.6
2849,Brad Miller,1994-95,25.0,7,5,42,42,1,4,5,30.0,,63,1,4,5,34.0,80,6.96,77,402,2440,11.4
2850,Brad Miller,1995-96,26.0,8,0,11,11,0,0,0,2.0,,74,1,4,5,36.0,84,7.25,87,443,2603,11.7
2851,Brad Miller,1996-97,27.0,9,1,8,8,0,1,1,2.0,,82,1,5,6,38.0,84,6.48,76,407,2545,10.7
2852,Brad Mills,2013-14,30.0,4,1,4,4,1,0,1,6.0,33.0,4,1,0,1,6.0,82,5.46,52,291,2492,9.0
2853,Brad Mills,2014-15,31.0,5,1,27,27,0,1,1,18.0,194.0,31,1,1,2,24.0,82,5.32,47,271,2439,8.9
2854,Brad Mills,2016-17,33.0,6,0,3,3,0,0,0,2.0,31.0,34,1,1,2,26.0,82,5.34,48,269,2463,8.9
2855,Brad Moran,2004-05,25.0,4,0,3,3,0,0,0,2.0,23.0,3,0,0,0,2.0,82,5.24,53,338,2262,9.5
2856,Brad Moran,2006-07,27.0,5,2,2,2,1,1,2,4.0,20.0,5,1,1,2,6.0,82,5.14,57,348,2300,9.2
2857,Brad Moran,2009-10,30.0,6,1,3,3,0,1,1,3.0,38.0,8,1,2,3,9.0,82,5.76,70,398,2426,9.7
2858,Brad Norton,2004-05,29.0,4,2,22,22,0,2,2,6.0,203.0,22,0,2,2,6.0,82,5.24,53,338,2262,9.5
2859,Brad Norton,2005-06,30.0,5,6,53,53,3,3,6,19.0,322.0,75,3,5,8,25.0,82,5.31,60,363,2326,9.4
2860,Brad Norton,2006-07,31.0,6,2,36,36,0,2,2,16.0,377.0,111,3,7,10,41.0,82,5.14,57,348,2300,9.2
2861,Brad Norton,2008-09,33.0,7,0,7,7,0,0,0,3.0,71.0,118,3,7,10,44.0,82,6.05,85,480,2458,10.1
2862,Brad Norton,2009-10,34.0,8,1,6,6,0,1,1,2.0,25.0,124,3,8,11,46.0,82,5.76,70,398,2426,9.7
2863,Brad Palmer,1983-84,22.0,4,8,23,23,4,4,8,59.0,,23,4,4,8,59.0,80,7.69,77,340,2441,12.6
2864,Brad Palmer,1984-85,23.0,5,45,72,72,22,23,45,180.0,,95,26,27,53,239.0,80,8.03,73,320,2489,12.9
2865,Brad Palmer,1985-86,24.0,6,17,73,73,6,11,17,123.0,,168,32,38,70,362.0,80,7.73,71,310,2444,12.7
2866,Brad Ralph,2003-04,23.0,4,0,1,1,0,0,0,0.0,5.0,1,0,0,0,0.0,82,5.51,63,376,2272,9.9
2867,Brad Richards,2003-04,23.0,4,62,82,82,21,41,62,179.0,1386.0,82,21,41,62,179.0,82,5.51,63,376,2272,9.9
2868,Brad Richards,2004-05,24.0,5,62,82,82,20,42,62,251.0,1624.0,164,41,83,124,430.0,82,5.24,53,338,2262,9.5
2869,Brad Richards,2005-06,25.0,6,74,80,80,17,57,74,277.0,1595.0,244,58,140,198,707.0,82,5.31,60,363,2326,9.4
2870,Brad Richards,2006-07,26.0,7,79,82,82,26,53,79,244.0,1675.0,326,84,193,277,951.0,82,5.14,57,348,2300,9.2
2871,Brad Richards,2008-09,28.0,8,91,82,82,23,68,91,282.0,1866.0,408,107,261,368,1233.0,82,6.05,85,480,2458,10.1
2872,Brad Richards,2009-10,29.0,9,70,82,82,25,45,70,272.0,1977.0,490,132,306,438,1505.0,82,5.76,70,398,2426,9.7
2873,Brad Richards,2010-11,30.0,10,62,74,74,20,42,62,249.0,1736.0,564,152,348,500,1754.0,82,5.44,62,351,2383,9.4
2874,Brad Richards,2011-12,31.0,11,48,56,56,16,32,48,180.0,1147.0,620,168,380,548,1934.0,82,5.7,65,341,2477,9.4
2875,Brad Richards,2012-13,32.0,12,91,80,80,24,67,91,284.0,1669.0,700,192,447,639,2218.0,82,5.53,56,304,2486,9.1
2876,Brad Richards,2013-14,33.0,13,77,72,72,28,49,77,272.0,1564.0,772,220,496,716,2490.0,82,5.46,52,291,2492,9.0
2877,Brad Richards,2014-15,34.0,14,66,82,82,25,41,66,229.0,1662.0,854,245,537,782,2719.0,82,5.32,47,271,2439,8.9
2878,Brad Richards,2015-16,35.0,15,34,46,46,11,23,34,110.0,865.0,900,256,560,816,2829.0,48,5.31,29,160,1399,9.1
2879,Brad Richards,2016-17,36.0,16,51,82,82,20,31,51,259.0,1531.0,982,276,591,867,3088.0,82,5.34,48,269,2463,8.9
2880,Brad Richards,2017-18,37.0,17,37,76,76,12,25,37,199.0,1131.0,1058,288,616,904,3287.0,82,5.32,47,251,2453,8.9
2881,Brad Richards,2018-19,38.0,18,28,68,68,10,18,28,164.0,1006.0,1126,298,634,932,3451.0,82,5.34,48,255,2438,9.0
2882,Brad Richardson,2008-09,23.0,4,13,41,41,3,10,13,51.0,440.0,41,3,10,13,51.0,82,6.05,85,480,2458,10.1
2883,Brad Richardson,2009-10,24.0,5,22,73,73,14,8,22,129.0,961.0,114,17,18,35,180.0,82,5.76,70,398,2426,9.7
2884,Brad Richardson,2010-11,25.0,6,5,22,22,2,3,5,32.0,297.0,136,19,21,40,212.0,82,5.44,62,351,2383,9.4
2885,Brad Richardson,2011-12,26.0,7,5,31,31,0,5,5,37.0,335.0,167,19,26,45,249.0,82,5.7,65,341,2477,9.4
2886,Brad Richardson,2012-13,27.0,8,27,81,81,11,16,27,148.0,1041.0,248,30,42,72,397.0,82,5.53,56,304,2486,9.1
2887,Brad Richardson,2013-14,28.0,9,19,68,68,7,12,19,103.0,800.0,316,37,54,91,500.0,82,5.46,52,291,2492,9.0
2888,Brad Richardson,2014-15,29.0,10,8,59,59,5,3,8,98.0,759.0,375,42,57,99,598.0,82,5.32,47,271,2439,8.9
2889,Brad Richardson,2015-16,30.0,11,6,16,16,1,5,6,27.0,174.0,391,43,62,105,625.0,48,5.31,29,160,1399,9.1
2890,Brad Richardson,2016-17,31.0,12,23,73,73,11,12,23,85.0,1088.0,464,54,74,128,710.0,82,5.34,48,269,2463,8.9
2891,Brad Richardson,2017-18,32.0,13,21,45,45,8,13,21,66.0,651.0,509,62,87,149,776.0,82,5.32,47,251,2453,8.9
2892,Brad Richardson,2018-19,33.0,14,31,82,82,11,20,31,117.0,1281.0,591,73,107,180,893.0,82,5.34,48,255,2438,9.0
2893,Brad Richardson,2019-20,34.0,15,9,16,16,5,4,9,25.0,246.0,607,78,111,189,918.0,82,5.45,47,245,2478,9.0
2894,Brad Richardson,2020-21,35.0,16,15,76,76,3,12,15,105.0,1122.0,683,81,123,204,1023.0,82,5.86,50,250,2620,9.2
2895,Brad Richardson,2021-22,36.0,17,27,66,66,19,8,27,128.0,1054.0,749,100,131,231,1151.0,82,5.96,47,239,2579,9.5
2896,Brad Richardson,2022-23,37.0,18,11,59,59,6,5,11,76.0,805.0,808,106,136,242,1227.0,70,5.96,42,208,2192,9.5
2897,Brad Schlegel,1994-95,26.0,4,1,15,15,0,1,1,7.0,,15,0,1,1,7.0,80,6.96,77,402,2440,11.4
2898,Brad Schlegel,1995-96,27.0,5,1,7,7,0,1,1,8.0,,22,0,2,2,15.0,84,7.25,87,443,2603,11.7
2899,Brad Schlegel,1996-97,28.0,6,7,26,26,1,6,7,24.0,,48,1,8,9,39.0,84,6.48,76,407,2545,10.7
2900,Brad Shaw,1988-89,24.0,4,2,8,8,0,2,2,17.0,,8,0,2,2,17.0,80,7.94,82,370,2484,12.8
2901,Brad Shaw,1989-90,25.0,5,0,2,2,0,0,0,2.0,,10,0,2,2,19.0,80,7.34,72,344,2400,12.2
2902,Brad Shaw,1990-91,26.0,6,0,1,1,0,0,0,1.0,,11,0,2,2,20.0,80,7.43,89,437,2435,12.2
2903,Brad Shaw,1991-92,27.0,7,1,3,3,1,0,1,2.0,,14,1,2,3,22.0,80,7.48,85,403,2430,12.3
2904,Brad Shaw,1992-93,28.0,8,35,64,64,3,32,35,65.0,,78,4,34,38,87.0,80,7.37,76,367,2421,12.2
2905,Brad Shaw,1993-94,29.0,9,32,72,72,4,28,32,129.0,,150,8,62,70,216.0,80,6.91,71,366,2385,11.6
2906,Brad Shaw,1994-95,30.0,10,25,62,62,3,22,25,100.0,,212,11,84,95,316.0,80,6.96,77,402,2440,11.4
2907,Brad Shaw,1995-96,31.0,11,41,81,81,7,34,41,166.0,,293,18,118,136,482.0,84,7.25,87,443,2603,11.7
2908,Brad Shaw,1996-97,32.0,12,23,66,66,4,19,23,113.0,,359,22,137,159,595.0,84,6.48,76,407,2545,10.7
2909,Brad Shaw,1997-98,33.0,13,0,2,2,0,0,0,3.0,,361,22,137,159,598.0,48,5.97,37,209,1408,10.2
2910,Brad Shaw,2001-02,37.0,14,0,16,16,0,0,0,15.0,220.0,377,22,137,159,613.0,82,5.27,57,359,2285,9.4
2911,Brad Smyth,1998-99,25.0,4,2,7,7,1,1,2,12.0,,7,1,1,2,12.0,82,6.29,74,413,2481,10.4
2912,Brad Smyth,1999-00,26.0,5,17,52,52,9,8,17,84.0,,59,10,9,19,96.0,82,5.83,55,336,2444,9.8
2913,Brad Smyth,2000-01,27.0,6,4,10,10,1,3,4,13.0,,69,11,12,23,109.0,82,5.28,57,380,2242,9.6
2914,Brad Smyth,2001-02,28.0,7,0,3,3,0,0,0,5.0,30.0,72,11,12,23,114.0,82,5.27,57,359,2285,9.4
2915,Brad Smyth,2003-04,30.0,8,1,4,4,1,0,1,10.0,56.0,76,12,12,24,124.0,82,5.51,63,376,2272,9.9
2916,Brad Smyth,2005-06,32.0,9,4,12,12,3,1,4,16.0,114.0,88,15,13,28,140.0,82,5.31,60,363,2326,9.4
2917,Brad Staubitz,2011-12,27.0,4,3,35,35,1,2,3,22.0,218.0,35,1,2,3,22.0,82,5.7,65,341,2477,9.4
2918,Brad Staubitz,2012-13,28.0,5,6,47,47,3,3,6,24.0,292.0,82,4,5,9,46.0,82,5.53,56,304,2486,9.1
2919,Brad Staubitz,2013-14,29.0,6,9,71,71,4,5,9,29.0,463.0,153,8,10,18,75.0,82,5.46,52,291,2492,9.0
2920,Brad Staubitz,2014-15,30.0,7,1,62,62,1,0,1,27.0,404.0,215,9,10,19,102.0,82,5.32,47,271,2439,8.9
2921,Brad Staubitz,2015-16,31.0,8,2,15,15,1,1,2,5.0,93.0,230,10,11,21,107.0,48,5.31,29,160,1399,9.1
2922,Brad Stuart,2002-03,23.0,4,36,82,82,10,26,36,133.0,1673.0,82,10,26,36,133.0,82,5.49,53,331,2294,9.8
2923,Brad Stuart,2003-04,24.0,5,23,77,77,5,18,23,119.0,1547.0,159,15,44,59,252.0,82,5.51,63,376,2272,9.9
2924,Brad Stuart,2004-05,25.0,6,29,82,82,6,23,29,96.0,1778.0,241,21,67,88,348.0,82,5.24,53,338,2262,9.5
2925,Brad Stuart,2005-06,26.0,7,14,36,36,4,10,14,63.0,752.0,277,25,77,102,411.0,82,5.31,60,363,2326,9.4
2926,Brad Stuart,2006-07,27.0,8,39,77,77,9,30,39,129.0,1705.0,354,34,107,141,540.0,82,5.14,57,348,2300,9.2
2927,Brad Stuart,2008-09,29.0,9,43,78,78,12,31,43,163.0,1947.0,432,46,138,184,703.0,82,6.05,85,480,2458,10.1
2928,Brad Stuart,2009-10,30.0,10,22,75,75,7,15,22,109.0,1716.0,507,53,153,206,812.0,82,5.76,70,398,2426,9.7
2929,Brad Stuart,2010-11,31.0,11,23,72,72,6,17,23,132.0,1523.0,579,59,170,229,944.0,82,5.44,62,351,2383,9.4
2930,Brad Stuart,2011-12,32.0,12,15,67,67,2,13,15,105.0,1355.0,646,61,183,244,1049.0,82,5.7,65,341,2477,9.4
2931,Brad Stuart,2012-13,33.0,13,20,82,82,4,16,20,153.0,1900.0,728,65,199,264,1202.0,82,5.53,56,304,2486,9.1
2932,Brad Stuart,2013-14,34.0,14,20,67,67,3,17,20,81.0,1442.0,795,68,216,284,1283.0,82,5.46,52,291,2492,9.0
2933,Brad Stuart,2014-15,35.0,15,21,81,81,6,15,21,96.0,1705.0,876,74,231,305,1379.0,82,5.32,47,271,2439,8.9
2934,Brad Stuart,2015-16,36.0,16,6,48,48,0,6,6,39.0,982.0,924,74,237,311,1418.0,48,5.31,29,160,1399,9.1
2935,Brad Stuart,2016-17,37.0,17,11,61,61,3,8,11,64.0,1169.0,985,77,245,322,1482.0,82,5.34,48,269,2463,8.9
2936,Brad Stuart,2017-18,38.0,18,13,65,65,3,10,13,64.0,1323.0,1050,80,255,335,1546.0,82,5.32,47,251,2453,8.9
2937,Brad Stuart,2018-19,39.0,19,0,6,6,0,0,0,0.0,84.0,1056,80,255,335,1546.0,82,5.34,48,255,2438,9.0
2938,Brad Tapper,2003-04,25.0,4,5,16,16,2,3,5,21.0,204.0,16,2,3,5,21.0,82,5.51,63,376,2272,9.9
2939,Brad Tapper,2004-05,26.0,5,6,20,20,2,4,6,34.0,267.0,36,4,7,11,55.0,82,5.24,53,338,2262,9.5
2940,Brad Tapper,2005-06,27.0,6,14,35,35,10,4,14,68.0,457.0,71,14,11,25,123.0,82,5.31,60,363,2326,9.4
2941,Brad Tiley,2000-01,29.0,4,0,1,1,0,0,0,0.0,,1,0,0,0,0.0,82,5.28,57,380,2242,9.6
2942,Brad Tiley,2001-02,30.0,5,0,8,8,0,0,0,1.0,92.0,9,0,0,0,1.0,82,5.27,57,359,2285,9.4
2943,Brad Tiley,2003-04,32.0,6,0,2,2,0,0,0,1.0,32.0,11,0,0,0,2.0,82,5.51,63,376,2272,9.9
2944,Brad Turner,1994-95,26.0,4,0,3,3,0,0,0,1.0,,3,0,0,0,1.0,80,6.96,77,402,2440,11.4
2945,Brad Werenka,1995-96,26.0,4,9,27,27,5,4,9,38.0,,27,5,4,9,38.0,84,7.25,87,443,2603,11.7
2946,Brad Werenka,1996-97,27.0,5,11,26,26,0,11,11,28.0,,53,5,15,20,66.0,84,6.48,76,407,2545,10.7
2947,Brad Werenka,1998-99,29.0,6,0,9,9,0,0,0,2.0,,62,5,15,20,68.0,82,6.29,74,413,2481,10.4
2948,Brad Werenka,2000-01,31.0,7,18,71,71,3,15,18,50.0,,133,8,30,38,118.0,82,5.28,57,380,2242,9.6
2949,Brad Werenka,2001-02,32.0,8,24,81,81,6,18,24,77.0,1717.0,214,14,48,62,195.0,82,5.27,57,359,2285,9.4
2950,Brad Werenka,2002-03,33.0,9,13,73,73,4,9,13,62.0,1396.0,287,18,57,75,257.0,82,5.49,53,331,2294,9.8
2951,Brad Werenka,2003-04,34.0,10,5,33,33,1,4,5,23.0,595.0,320,19,61,80,280.0,82,5.51,63,376,2272,9.9
2952,Brad Winchester,2008-09,27.0,4,1,19,19,0,1,1,19.0,116.0,19,0,1,1,19.0,82,6.05,85,480,2458,10.1
2953,Brad Winchester,2009-10,28.0,5,9,59,59,4,5,9,66.0,476.0,78,4,6,10,85.0,82,5.76,70,398,2426,9.7
2954,Brad Winchester,2010-11,29.0,6,3,41,41,1,2,3,36.0,310.0,119,5,8,13,121.0,82,5.44,62,351,2383,9.4
2955,Brad Winchester,2011-12,30.0,7,21,64,64,13,8,21,82.0,778.0,183,18,16,34,203.0,82,5.7,65,341,2477,9.4
2956,Brad Winchester,2012-13,31.0,8,8,64,64,3,5,8,69.0,580.0,247,21,21,42,272.0,82,5.53,56,304,2486,9.1
2957,Brad Winchester,2013-14,32.0,9,16,76,76,10,6,16,90.0,797.0,323,31,27,58,362.0,82,5.46,52,291,2492,9.0
2958,Brad Winchester,2014-15,33.0,10,10,67,67,6,4,10,72.0,523.0,390,37,31,68,434.0,82,5.32,47,271,2439,8.9
2959,Brad Zavisha,1996-97,25.0,4,0,2,2,0,0,0,1.0,,2,0,0,0,1.0,84,6.48,76,407,2545,10.7
2960,Brady Austin,2019-20,26.0,4,0,5,5,0,0,0,8.0,80.0,5,0,0,0,8.0,82,5.45,47,245,2478,9.0
2961,Brady Keeper,2021-22,25.0,4,0,1,1,0,0,0,1.0,13.0,1,0,0,0,1.0,82,5.96,47,239,2579,9.5
2962,Brady Murray,2010-11,26.0,4,1,4,4,1,0,1,2.0,45.0,4,1,0,1,2.0,82,5.44,62,351,2383,9.4
2963,Brady Skjei,2018-19,24.0,4,0,7,7,0,0,0,6.0,124.0,7,0,0,0,6.0,82,5.34,48,255,2438,9.0
2964,Brady Skjei,2019-20,25.0,5,39,80,80,5,34,39,127.0,1397.0,87,5,34,39,133.0,82,5.45,47,245,2478,9.0
2965,Brady Skjei,2020-21,26.0,6,25,82,82,4,21,25,153.0,1724.0,169,9,55,64,286.0,82,5.86,50,250,2620,9.2
2966,Brady Skjei,2021-22,27.0,7,25,78,78,8,17,25,126.0,1656.0,247,17,72,89,412.0,82,5.96,47,239,2579,9.5
2967,Brady Skjei,2022-23,28.0,8,24,67,67,8,16,24,139.0,1386.0,314,25,88,113,551.0,70,5.96,42,208,2192,9.5
2968,Brady Tkachuk,2021-22,22.0,4,45,71,71,22,23,45,214.0,1138.0,71,22,23,45,214.0,82,5.96,47,239,2579,9.5
2969,Brady Tkachuk,2022-23,23.0,5,44,71,71,21,23,44,259.0,1344.0,142,43,46,89,473.0,70,5.96,42,208,2192,9.5
2970,Brandon Bochenski,2008-09,26.0,4,17,40,40,8,9,17,62.0,423.0,40,8,9,17,62.0,82,6.05,85,480,2458,10.1
2971,Brandon Bochenski,2009-10,27.0,5,24,41,41,13,11,24,92.0,564.0,81,21,20,41,154.0,82,5.76,70,398,2426,9.7
2972,Brandon Bochenski,2010-11,28.0,6,13,40,40,3,10,13,56.0,478.0,121,24,30,54,210.0,82,5.44,62,351,2383,9.4
2973,Brandon Bochenski,2011-12,29.0,7,1,7,7,0,1,1,11.0,76.0,128,24,31,55,221.0,82,5.7,65,341,2477,9.4
2974,Brandon Bochenski,2012-13,30.0,8,13,28,28,4,9,13,43.0,344.0,156,28,40,68,264.0,82,5.53,56,304,2486,9.1
2975,Brandon Bollig,2014-15,28.0,4,0,18,18,0,0,0,16.0,106.0,18,0,0,0,16.0,82,5.32,47,271,2439,8.9
2976,Brandon Bollig,2015-16,29.0,5,0,25,25,0,0,0,34.0,200.0,43,0,0,0,50.0,48,5.31,29,160,1399,9.1
2977,Brandon Bollig,2016-17,30.0,6,14,82,82,7,7,14,109.0,843.0,125,7,7,14,159.0,82,5.34,48,269,2463,8.9
2978,Brandon Bollig,2017-18,31.0,7,5,62,62,1,4,5,67.0,533.0,187,8,11,19,226.0,82,5.32,47,251,2453,8.9
2979,Brandon Bollig,2018-19,32.0,8,4,54,54,2,2,4,56.0,502.0,241,10,13,23,282.0,82,5.34,48,255,2438,9.0
2980,Brandon Carlo,2019-20,23.0,4,16,82,82,6,10,16,88.0,1707.0,82,6,10,16,88.0,82,5.45,47,245,2478,9.0
2981,Brandon Carlo,2020-21,24.0,5,6,76,76,0,6,6,76.0,1462.0,158,6,16,22,164.0,82,5.86,50,250,2620,9.2
2982,Brandon Carlo,2021-22,25.0,6,10,72,72,2,8,10,116.0,1506.0,230,8,24,32,280.0,82,5.96,47,239,2579,9.5
2983,Brandon Carlo,2022-23,26.0,7,19,67,67,4,15,19,111.0,1372.0,297,12,39,51,391.0,70,5.96,42,208,2192,9.5
2984,Brandon Convery,1998-99,24.0,4,7,11,11,5,2,7,16.0,,11,5,2,7,16.0,82,6.29,74,413,2481,10.4
2985,Brandon Convery,1999-00,25.0,5,10,39,39,2,8,10,41.0,,50,7,10,17,57.0,82,5.83,55,336,2444,9.8
2986,Brandon Convery,2000-01,26.0,6,2,7,7,0,2,2,2.0,,57,7,12,19,59.0,82,5.28,57,380,2242,9.6
2987,Brandon Convery,2001-02,27.0,7,9,15,15,2,7,9,14.0,156.0,72,9,19,28,73.0,82,5.27,57,359,2285,9.4
2988,Brandon Davidson,2017-18,26.0,4,1,12,12,1,0,1,7.0,182.0,12,1,0,1,7.0,82,5.32,47,251,2453,8.9
2989,Brandon Davidson,2018-19,27.0,5,11,51,51,4,7,11,63.0,979.0,63,5,7,12,70.0,82,5.34,48,255,2438,9.0
2990,Brandon Davidson,2019-20,28.0,6,3,38,38,0,3,3,42.0,597.0,101,5,10,15,112.0,82,5.45,47,245,2478,9.0
2991,Brandon Davidson,2020-21,29.0,7,7,51,51,4,3,7,63.0,858.0,152,9,13,22,175.0,82,5.86,50,250,2620,9.2
2992,Brandon Davidson,2021-22,30.0,8,1,10,10,0,1,1,7.0,138.0,162,9,14,23,182.0,82,5.96,47,239,2579,9.5
2993,Brandon Davidson,2022-23,31.0,9,0,12,12,0,0,0,17.0,150.0,174,9,14,23,199.0,70,5.96,42,208,2192,9.5
2994,Brandon DeFazio,2017-18,29.0,4,0,2,2,0,0,0,2.0,12.0,2,0,0,0,2.0,82,5.32,47,251,2453,8.9
2995,Brandon Dubinsky,2009-10,23.0,4,0,6,6,0,0,0,9.0,49.0,6,0,0,0,9.0,82,5.76,70,398,2426,9.7
2996,Brandon Dubinsky,2010-11,24.0,5,40,82,82,14,26,40,157.0,1189.0,88,14,26,40,166.0,82,5.44,62,351,2383,9.4
2997,Brandon Dubinsky,2011-12,25.0,6,41,82,82,13,28,41,188.0,1364.0,170,27,54,81,354.0,82,5.7,65,341,2477,9.4
2998,Brandon Dubinsky,2012-13,26.0,7,44,69,69,20,24,44,165.0,1349.0,239,47,78,125,519.0,82,5.53,56,304,2486,9.1
2999,Brandon Dubinsky,2013-14,27.0,8,54,77,77,24,30,54,202.0,1557.0,316,71,108,179,721.0,82,5.46,52,291,2492,9.0
3000,Brandon Dubinsky,2014-15,28.0,9,34,77,77,10,24,34,140.0,1253.0,393,81,132,213,861.0,82,5.32,47,271,2439,8.9
3001,Brandon Dubinsky,2015-16,29.0,10,20,29,29,2,18,20,50.0,534.0,422,83,150,233,911.0,48,5.31,29,160,1399,9.1
3002,Brandon Dubinsky,2016-17,30.0,11,50,76,76,16,34,50,189.0,1427.0,498,99,184,283,1100.0,82,5.34,48,269,2463,8.9
3003,Brandon Dubinsky,2017-18,31.0,12,36,47,47,13,23,36,100.0,849.0,545,112,207,319,1200.0,82,5.32,47,251,2453,8.9
3004,Brandon Dubinsky,2018-19,32.0,13,48,75,75,17,31,48,158.0,1407.0,620,129,238,367,1358.0,82,5.34,48,255,2438,9.0
3005,Brandon Dubinsky,2019-20,33.0,14,41,80,80,12,29,41,115.0,1432.0,700,141,267,408,1473.0,82,5.45,47,245,2478,9.0
3006,Brandon Dubinsky,2020-21,34.0,15,16,62,62,6,10,16,89.0,951.0,762,147,277,424,1562.0,82,5.86,50,250,2620,9.2
3007,Brandon Dubinsky,2021-22,35.0,16,14,61,61,6,8,14,63.0,754.0,823,153,285,438,1625.0,82,5.96,47,239,2579,9.5
3008,Brandon Gignac,2021-22,24.0,4,0,1,1,0,0,0,1.0,9.0,1,0,0,0,1.0,82,5.96,47,239,2579,9.5
3009,Brandon Gormley,2016-17,24.0,4,0,5,5,0,0,0,4.0,73.0,5,0,0,0,4.0,82,5.34,48,269,2463,8.9
3010,Brandon Gormley,2017-18,25.0,5,4,27,27,2,2,4,39.0,414.0,32,2,2,4,43.0,82,5.32,47,251,2453,8.9
3011,Brandon Gormley,2018-19,26.0,6,1,26,26,0,1,1,11.0,317.0,58,2,3,5,54.0,82,5.34,48,255,2438,9.0
3012,Brandon Hagel,2022-23,24.0,4,0,1,1,0,0,0,4.0,12.0,1,0,0,0,4.0,70,5.96,42,208,2192,9.5
3013,Brandon Kozun,2017-18,27.0,4,4,20,20,2,2,4,8.0,158.0,20,2,2,4,8.0,82,5.32,47,251,2453,8.9
3014,Brandon Manning,2014-15,24.0,4,0,4,4,0,0,0,6.0,55.0,4,0,0,0,6.0,82,5.32,47,271,2439,8.9
3015,Brandon Manning,2015-16,25.0,5,2,6,6,0,2,2,5.0,89.0,10,0,2,2,11.0,48,5.31,29,160,1399,9.1
3016,Brandon Manning,2017-18,27.0,6,3,11,11,0,3,3,10.0,189.0,21,0,5,5,21.0,82,5.32,47,251,2453,8.9
3017,Brandon Manning,2018-19,28.0,7,7,56,56,1,6,7,67.0,926.0,77,1,11,12,88.0,82,5.34,48,255,2438,9.0
3018,Brandon Manning,2019-20,29.0,8,12,65,65,3,9,12,84.0,1174.0,142,4,20,24,172.0,82,5.45,47,245,2478,9.0
3019,Brandon Manning,2020-21,30.0,9,19,65,65,7,12,19,111.0,1167.0,207,11,32,43,283.0,82,5.86,50,250,2620,9.2
3020,Brandon Manning,2021-22,31.0,10,4,39,39,2,2,4,33.0,579.0,246,13,34,47,316.0,82,5.96,47,239,2579,9.5
3021,Brandon Manning,2022-23,32.0,11,1,9,9,1,0,1,8.0,99.0,255,14,34,48,324.0,70,5.96,42,208,2192,9.5
3022,Brandon Mashinter,2013-14,25.0,4,0,13,13,0,0,0,5.0,83.0,13,0,0,0,5.0,82,5.46,52,291,2492,9.0
3023,Brandon Mashinter,2015-16,27.0,5,0,4,4,0,0,0,2.0,24.0,17,0,0,0,7.0,48,5.31,29,160,1399,9.1
3024,Brandon Mashinter,2016-17,28.0,6,0,6,6,0,0,0,3.0,27.0,23,0,0,0,10.0,82,5.34,48,269,2463,8.9
3025,Brandon Mashinter,2018-19,30.0,7,5,41,41,4,1,5,25.0,307.0,64,4,1,5,35.0,82,5.34,48,255,2438,9.0
3026,Brandon McMillan,2013-14,23.0,4,21,60,60,11,10,21,77.0,844.0,60,11,10,21,77.0,82,5.46,52,291,2492,9.0
3027,Brandon McMillan,2014-15,24.0,5,4,25,25,0,4,4,26.0,280.0,85,11,14,25,103.0,82,5.32,47,271,2439,8.9
3028,Brandon McMillan,2015-16,25.0,6,1,6,6,0,1,1,2.0,52.0,91,11,15,26,105.0,48,5.31,29,160,1399,9.1
3029,Brandon McMillan,2016-17,26.0,7,6,22,22,2,4,6,35.0,277.0,113,13,19,32,140.0,82,5.34,48,269,2463,8.9
3030,Brandon McMillan,2017-18,27.0,8,4,58,58,1,3,4,51.0,607.0,171,14,22,36,191.0,82,5.32,47,251,2453,8.9
3031,Brandon Montour,2019-20,25.0,4,6,27,27,2,4,6,50.0,469.0,27,2,4,6,50.0,82,5.45,47,245,2478,9.0
3032,Brandon Montour,2020-21,26.0,5,32,80,80,9,23,32,160.0,1638.0,107,11,27,38,210.0,82,5.86,50,250,2620,9.2
3033,Brandon Montour,2021-22,27.0,6,35,82,82,8,27,35,181.0,1841.0,189,19,54,73,391.0,82,5.96,47,239,2579,9.5
3034,Brandon Montour,2022-23,28.0,7,18,54,54,5,13,18,86.0,1053.0,243,24,67,91,477.0,70,5.96,42,208,2192,9.5
3035,Brandon Nolan,2010-11,27.0,4,1,6,6,0,1,1,2.0,44.0,6,0,1,1,2.0,82,5.44,62,351,2383,9.4
3036,Brandon Pirri,2013-14,22.0,4,0,1,1,0,0,0,1.0,9.0,1,0,0,0,1.0,82,5.46,52,291,2492,9.0
3037,Brandon Pirri,2014-15,23.0,5,2,5,5,0,2,2,5.0,68.0,6,0,2,2,6.0,82,5.32,47,271,2439,8.9
3038,Brandon Pirri,2015-16,24.0,6,0,1,1,0,0,0,2.0,18.0,7,0,2,2,8.0,48,5.31,29,160,1399,9.1
3039,Brandon Pirri,2016-17,25.0,7,25,49,49,13,12,25,80.0,636.0,56,13,14,27,88.0,82,5.34,48,269,2463,8.9
3040,Brandon Pirri,2017-18,26.0,8,24,49,49,22,2,24,143.0,724.0,105,35,16,51,231.0,82,5.32,47,251,2453,8.9
3041,Brandon Pirri,2018-19,27.0,9,29,61,61,14,15,29,128.0,886.0,166,49,31,80,359.0,82,5.34,48,255,2438,9.0
3042,Brandon Pirri,2019-20,28.0,10,18,60,60,8,10,18,96.0,737.0,226,57,41,98,455.0,82,5.45,47,245,2478,9.0
3043,Brandon Pirri,2020-21,29.0,11,3,2,2,3,0,3,11.0,35.0,228,60,41,101,466.0,82,5.86,50,250,2620,9.2
3044,Brandon Pirri,2021-22,30.0,12,18,31,31,12,6,18,82.0,448.0,259,72,47,119,548.0,82,5.96,47,239,2579,9.5
3045,Brandon Pirri,2022-23,31.0,13,2,16,16,0,2,2,24.0,201.0,275,72,49,121,572.0,70,5.96,42,208,2192,9.5
3046,Brandon Prust,2009-10,25.0,4,0,10,10,0,0,0,1.0,61.0,10,0,0,0,1.0,82,5.76,70,398,2426,9.7
3047,Brandon Prust,2011-12,27.0,5,3,36,36,1,2,3,23.0,269.0,46,1,2,3,24.0,82,5.7,65,341,2477,9.4
3048,Brandon Prust,2012-13,28.0,6,14,69,69,5,9,14,44.0,524.0,115,6,11,17,68.0,82,5.53,56,304,2486,9.1
3049,Brandon Prust,2013-14,29.0,7,29,82,82,13,16,29,87.0,1133.0,197,19,27,46,155.0,82,5.46,52,291,2492,9.0
3050,Brandon Prust,2014-15,30.0,8,17,82,82,5,12,17,68.0,979.0,279,24,39,63,223.0,82,5.32,47,271,2439,8.9
3051,Brandon Prust,2015-16,31.0,9,14,38,38,5,9,14,39.0,518.0,317,29,48,77,262.0,48,5.31,29,160,1399,9.1
3052,Brandon Prust,2016-17,32.0,10,13,52,52,6,7,13,49.0,667.0,369,35,55,90,311.0,82,5.34,48,269,2463,8.9
3053,Brandon Prust,2017-18,33.0,11,18,82,82,4,14,18,78.0,1063.0,451,39,69,108,389.0,82,5.32,47,251,2453,8.9
3054,Brandon Prust,2018-19,34.0,12,7,35,35,1,6,7,19.0,447.0,486,40,75,115,408.0,82,5.34,48,255,2438,9.0
3055,Brandon Reid,2005-06,24.0,4,5,7,7,2,3,5,15.0,69.0,7,2,3,5,15.0,82,5.31,60,363,2326,9.4
3056,Brandon Reid,2006-07,25.0,5,1,3,3,0,1,1,2.0,28.0,10,2,4,6,17.0,82,5.14,57,348,2300,9.2
3057,Brandon Reid,2009-10,28.0,6,0,3,3,0,0,0,8.0,35.0,13,2,4,6,25.0,82,5.76,70,398,2426,9.7
3058,Brandon Saad,2014-15,22.0,4,0,2,2,0,0,0,3.0,28.0,2,0,0,0,3.0,82,5.32,47,271,2439,8.9
3059,Brandon Saad,2015-16,23.0,5,27,46,46,10,17,27,98.0,757.0,48,10,17,27,101.0,48,5.31,29,160,1399,9.1
3060,Brandon Saad,2016-17,24.0,6,47,78,78,19,28,47,159.0,1271.0,126,29,45,74,260.0,82,5.34,48,269,2463,8.9
3061,Brandon Saad,2017-18,25.0,7,52,82,82,23,29,52,203.0,1415.0,208,52,74,126,463.0,82,5.32,47,251,2453,8.9
3062,Brandon Saad,2018-19,26.0,8,53,78,78,31,22,53,233.0,1343.0,286,83,96,179,696.0,82,5.34,48,255,2438,9.0
3063,Brandon Saad,2019-20,27.0,9,53,82,82,24,29,53,210.0,1396.0,368,107,125,232,906.0,82,5.45,47,245,2478,9.0
3064,Brandon Saad,2020-21,28.0,10,35,82,82,18,17,35,237.0,1435.0,450,125,142,267,1143.0,82,5.86,50,250,2620,9.2
3065,Brandon Saad,2021-22,29.0,11,47,80,80,23,24,47,195.0,1415.0,530,148,166,314,1338.0,82,5.96,47,239,2579,9.5
3066,Brandon Saad,2022-23,30.0,12,33,58,58,21,12,33,140.0,971.0,588,169,178,347,1478.0,70,5.96,42,208,2192,9.5
3067,Brandon Segal,2011-12,28.0,4,0,2,2,0,0,0,2.0,28.0,2,0,0,0,2.0,82,5.7,65,341,2477,9.4
3068,Brandon Segal,2012-13,29.0,5,12,44,44,6,6,12,55.0,385.0,46,6,6,12,57.0,82,5.53,56,304,2486,9.1
3069,Brandon Segal,2013-14,30.0,6,10,46,46,5,5,10,40.0,381.0,92,11,11,22,97.0,82,5.46,52,291,2492,9.0
3070,Brandon Segal,2014-15,31.0,7,0,10,10,0,0,0,8.0,66.0,102,11,11,22,105.0,82,5.32,47,271,2439,8.9
3071,Brandon Segal,2015-16,32.0,8,0,1,1,0,0,0,0.0,5.0,103,11,11,22,105.0,48,5.31,29,160,1399,9.1
3072,Brandon Smith,2001-02,28.0,4,0,5,5,0,0,0,2.0,48.0,5,0,0,0,2.0,82,5.27,57,359,2285,9.4
3073,Brandon Smith,2002-03,29.0,5,6,22,22,2,4,6,24.0,429.0,27,2,4,6,26.0,82,5.49,53,331,2294,9.8
3074,Brandon Smith,2003-04,30.0,6,1,3,3,1,0,1,2.0,20.0,30,3,4,7,28.0,82,5.51,63,376,2272,9.9
3075,Brandon Smith,2005-06,32.0,7,0,3,3,0,0,0,1.0,30.0,33,3,4,7,29.0,82,5.31,60,363,2326,9.4
3076,Brandon Sutter,2011-12,22.0,4,6,50,50,1,5,6,57.0,441.0,50,1,5,6,57.0,82,5.7,65,341,2477,9.4
3077,Brandon Sutter,2012-13,23.0,5,40,72,72,21,19,40,168.0,1191.0,122,22,24,46,225.0,82,5.53,56,304,2486,9.1
3078,Brandon Sutter,2013-14,24.0,6,29,82,82,14,15,29,145.0,1382.0,204,36,39,75,370.0,82,5.46,52,291,2492,9.0
3079,Brandon Sutter,2014-15,25.0,7,32,82,82,17,15,32,171.0,1427.0,286,53,54,107,541.0,82,5.32,47,271,2439,8.9
3080,Brandon Sutter,2015-16,26.0,8,19,48,48,11,8,19,82.0,788.0,334,64,62,126,623.0,48,5.31,29,160,1399,9.1
3081,Brandon Sutter,2016-17,27.0,9,26,81,81,13,13,26,144.0,1277.0,415,77,75,152,767.0,82,5.34,48,269,2463,8.9
3082,Brandon Sutter,2017-18,28.0,10,33,80,80,21,12,33,180.0,1386.0,495,98,87,185,947.0,82,5.32,47,251,2453,8.9
3083,Brandon Sutter,2018-19,29.0,11,9,20,20,5,4,9,45.0,360.0,515,103,91,194,992.0,82,5.34,48,255,2438,9.0
3084,Brandon Sutter,2019-20,30.0,12,34,81,81,17,17,34,160.0,1523.0,596,120,108,228,1152.0,82,5.45,47,245,2478,9.0
3085,Brandon Sutter,2020-21,31.0,13,26,61,61,11,15,26,106.0,1056.0,657,131,123,254,1258.0,82,5.86,50,250,2620,9.2
3086,Brandon Sutter,2021-22,32.0,14,6,26,26,4,2,6,43.0,454.0,683,135,125,260,1301.0,82,5.96,47,239,2579,9.5
3087,Brandon Sutter,2022-23,33.0,15,17,44,44,8,9,17,76.0,653.0,727,143,134,277,1377.0,70,5.96,42,208,2192,9.5
3088,Brandon Tanev,2018-19,27.0,4,0,3,3,0,0,0,4.0,36.0,3,0,0,0,4.0,82,5.34,48,255,2438,9.0
3089,Brandon Tanev,2019-20,28.0,5,4,51,51,2,2,4,54.0,545.0,54,2,2,4,58.0,82,5.45,47,245,2478,9.0
3090,Brandon Tanev,2020-21,29.0,6,18,61,61,8,10,18,79.0,772.0,115,10,12,22,137.0,82,5.86,50,250,2620,9.2
3091,Brandon Tanev,2021-22,30.0,7,29,80,80,14,15,29,127.0,1129.0,195,24,27,51,264.0,82,5.96,47,239,2579,9.5
3092,Brandon Tanev,2022-23,31.0,8,25,68,68,11,14,25,95.0,1004.0,263,35,41,76,359.0,70,5.96,42,208,2192,9.5
3093,Brandon Yip,2012-13,27.0,4,19,32,32,11,8,19,65.0,470.0,32,11,8,19,65.0,82,5.53,56,304,2486,9.1
3094,Brandon Yip,2013-14,28.0,5,22,71,71,12,10,22,127.0,975.0,103,23,18,41,192.0,82,5.46,52,291,2492,9.0
3095,Brandon Yip,2014-15,29.0,6,7,35,35,3,4,7,41.0,374.0,138,26,22,48,233.0,82,5.32,47,271,2439,8.9
3096,Brandon Yip,2015-16,30.0,7,8,34,34,3,5,8,35.0,409.0,172,29,27,56,268.0,48,5.31,29,160,1399,9.1
3097,Brandon Yip,2016-17,31.0,8,0,2,2,0,0,0,1.0,14.0,174,29,27,56,269.0,82,5.34,48,269,2463,8.9
3098,Brandy Semchuk,1995-96,24.0,4,0,1,1,0,0,0,0.0,,1,0,0,0,0.0,84,7.25,87,443,2603,11.7
3099,Branislav Mezei,2003-04,23.0,4,5,42,42,1,4,5,29.0,622.0,42,1,4,5,29.0,82,5.51,63,376,2272,9.9
3100,Branislav Mezei,2004-05,24.0,5,2,24,24,0,2,2,4.0,203.0,66,1,6,7,33.0,82,5.24,53,338,2262,9.5
3101,Branislav Mezei,2005-06,25.0,6,2,11,11,2,0,2,10.0,202.0,77,3,6,9,43.0,82,5.31,60,363,2326,9.4
3102,Branislav Mezei,2006-07,26.0,7,7,45,45,0,7,7,26.0,798.0,122,3,13,16,69.0,82,5.14,57,348,2300,9.2
3103,Branislav Mezei,2008-09,28.0,8,1,16,16,0,1,1,13.0,308.0,138,3,14,17,82.0,82,6.05,85,480,2458,10.1
3104,Branislav Mezei,2009-10,29.0,9,3,45,45,0,3,3,24.0,718.0,183,3,17,20,106.0,82,5.76,70,398,2426,9.7
3105,Branislav Mezei,2010-11,30.0,10,4,57,57,2,2,4,38.0,824.0,240,5,19,24,144.0,82,5.44,62,351,2383,9.4
3106,Branko Radivojevic,2004-05,24.0,4,6,18,18,4,2,6,19.0,169.0,18,4,2,6,19.0,82,5.24,53,338,2262,9.5
3107,Branko Radivojevic,2005-06,25.0,5,27,79,79,12,15,27,109.0,1051.0,97,16,17,33,128.0,82,5.31,60,363,2326,9.4
3108,Branko Radivojevic,2006-07,26.0,6,32,77,77,10,22,32,107.0,1123.0,174,26,39,65,235.0,82,5.14,57,348,2300,9.2
3109,Branko Radivojevic,2008-09,28.0,7,14,64,64,8,6,14,84.0,817.0,238,34,45,79,319.0,82,6.05,85,480,2458,10.1
3110,Branko Radivojevic,2009-10,29.0,8,24,82,82,11,13,24,116.0,1064.0,320,45,58,103,435.0,82,5.76,70,398,2426,9.7
3111,Branko Radivojevic,2010-11,30.0,9,17,73,73,7,10,17,91.0,1089.0,393,52,68,120,526.0,82,5.44,62,351,2383,9.4
3112,Brantt Myhres,1997-98,23.0,4,2,15,15,2,0,2,4.0,,15,2,0,2,4.0,48,5.97,37,209,1408,10.2
3113,Brantt Myhres,1999-00,25.0,5,4,47,47,3,1,4,13.0,,62,5,1,6,17.0,82,5.83,55,336,2444,9.8
3114,Brantt Myhres,2000-01,26.0,6,0,23,23,0,0,0,0.0,,85,5,1,6,17.0,82,5.28,57,380,2242,9.6
3115,Brantt Myhres,2001-02,27.0,7,1,30,30,1,0,1,7.0,144.0,115,6,1,7,24.0,82,5.27,57,359,2285,9.4
3116,Brantt Myhres,2002-03,28.0,8,1,13,13,0,1,1,2.0,40.0,128,6,2,8,26.0,82,5.49,53,331,2294,9.8
3117,Brantt Myhres,2003-04,29.0,9,0,25,25,0,0,0,1.0,94.0,153,6,2,8,27.0,82,5.51,63,376,2272,9.9
3118,Brantt Myhres,2005-06,31.0,10,0,1,1,0,0,0,0.0,5.0,154,6,2,8,27.0,82,5.31,60,363,2326,9.4
3119,Brayden Irwin,2012-13,25.0,4,0,2,2,0,0,0,3.0,20.0,2,0,0,0,3.0,82,5.53,56,304,2486,9.1
3120,Brayden McNabb,2014-15,24.0,4,8,25,25,1,7,8,23.0,446.0,25,1,7,8,23.0,82,5.32,47,271,2439,8.9
3121,Brayden McNabb,2016-17,26.0,5,0,12,12,0,0,0,10.0,207.0,37,1,7,8,33.0,82,5.34,48,269,2463,8.9
3122,Brayden McNabb,2017-18,27.0,6,24,71,71,2,22,24,74.0,1129.0,108,3,29,32,107.0,82,5.32,47,251,2453,8.9
3123,Brayden McNabb,2018-19,28.0,7,14,81,81,2,12,14,91.0,1524.0,189,5,41,46,198.0,82,5.34,48,255,2438,9.0
3124,Brayden McNabb,2019-20,29.0,8,4,49,49,2,2,4,47.0,738.0,238,7,43,50,245.0,82,5.45,47,245,2478,9.0
3125,Brayden McNabb,2020-21,30.0,9,15,76,76,5,10,15,88.0,1532.0,314,12,53,65,333.0,82,5.86,50,250,2620,9.2
3126,Brayden McNabb,2021-22,31.0,10,16,81,81,4,12,16,84.0,1578.0,395,16,65,81,417.0,82,5.96,47,239,2579,9.5
3127,Brayden McNabb,2022-23,32.0,11,9,71,71,2,7,9,73.0,1421.0,466,18,72,90,490.0,70,5.96,42,208,2192,9.5
3128,Brayden Point,2019-20,23.0,4,40,68,68,18,22,40,122.0,1165.0,68,18,22,40,122.0,82,5.45,47,245,2478,9.0
3129,Brayden Point,2020-21,24.0,5,66,82,82,32,34,66,217.0,1609.0,150,50,56,106,339.0,82,5.86,50,250,2620,9.2
3130,Brayden Point,2021-22,25.0,6,92,79,79,41,51,92,191.0,1495.0,229,91,107,198,530.0,82,5.96,47,239,2579,9.5
3131,Brayden Point,2022-23,26.0,7,64,66,66,25,39,64,141.0,1248.0,295,116,146,262,671.0,70,5.96,42,208,2192,9.5
3132,Brayden Schenn,2012-13,21.0,4,0,1,1,0,0,0,0.0,13.0,1,0,0,0,0.0,82,5.53,56,304,2486,9.1
3133,Brayden Schenn,2013-14,22.0,5,2,8,8,0,2,2,11.0,90.0,9,0,2,2,11.0,82,5.46,52,291,2492,9.0
3134,Brayden Schenn,2014-15,23.0,6,18,54,54,12,6,18,97.0,763.0,63,12,8,20,108.0,82,5.32,47,271,2439,8.9
3135,Brayden Schenn,2015-16,24.0,7,26,47,47,8,18,26,79.0,730.0,110,20,26,46,187.0,48,5.31,29,160,1399,9.1
3136,Brayden Schenn,2016-17,25.0,8,41,82,82,20,21,41,178.0,1291.0,192,40,47,87,365.0,82,5.34,48,269,2463,8.9
3137,Brayden Schenn,2017-18,26.0,9,47,82,82,18,29,47,156.0,1401.0,274,58,76,134,521.0,82,5.32,47,251,2453,8.9
3138,Brayden Schenn,2018-19,27.0,10,59,80,80,26,33,59,178.0,1352.0,354,84,109,193,699.0,82,5.34,48,255,2438,9.0
3139,Brayden Schenn,2019-20,28.0,11,55,79,79,25,30,55,178.0,1407.0,433,109,139,248,877.0,82,5.45,47,245,2478,9.0
3140,Brayden Schenn,2020-21,29.0,12,70,82,82,28,42,70,210.0,1617.0,515,137,181,318,1087.0,82,5.86,50,250,2620,9.2
3141,Brayden Schenn,2021-22,30.0,13,54,72,72,17,37,54,159.0,1338.0,587,154,218,372,1246.0,82,5.96,47,239,2579,9.5
3142,Brayden Schenn,2022-23,31.0,14,58,71,71,25,33,58,138.0,1311.0,658,179,251,430,1384.0,70,5.96,42,208,2192,9.5
3143,Braydon Coburn,2008-09,23.0,4,1,9,9,0,1,1,4.0,69.0,9,0,1,1,4.0,82,6.05,85,480,2458,10.1
3144,Braydon Coburn,2009-10,24.0,5,11,49,49,3,8,11,54.0,758.0,58,3,9,12,58.0,82,5.76,70,398,2426,9.7
3145,Braydon Coburn,2010-11,25.0,6,36,78,78,9,27,36,113.0,1656.0,136,12,36,48,171.0,82,5.44,62,351,2383,9.4
3146,Braydon Coburn,2011-12,26.0,7,28,80,80,7,21,28,130.0,1970.0,216,19,57,76,301.0,82,5.7,65,341,2477,9.4
3147,Braydon Coburn,2012-13,27.0,8,19,81,81,5,14,19,122.0,1712.0,297,24,71,95,423.0,82,5.53,56,304,2486,9.1
3148,Braydon Coburn,2013-14,28.0,9,16,82,82,2,14,16,114.0,1728.0,379,26,85,111,537.0,82,5.46,52,291,2492,9.0
3149,Braydon Coburn,2014-15,29.0,10,24,81,81,4,20,24,113.0,1786.0,460,30,105,135,650.0,82,5.32,47,271,2439,8.9
3150,Braydon Coburn,2015-16,30.0,11,5,33,33,1,4,5,38.0,746.0,493,31,109,140,688.0,48,5.31,29,160,1399,9.1
3151,Braydon Coburn,2016-17,31.0,12,17,82,82,5,12,17,122.0,1840.0,575,36,121,157,810.0,82,5.34,48,269,2463,8.9
3152,Braydon Coburn,2017-18,32.0,13,11,43,43,1,10,11,46.0,857.0,618,37,131,168,856.0,82,5.32,47,251,2453,8.9
3153,Braydon Coburn,2018-19,33.0,14,10,80,80,1,9,10,92.0,1340.0,698,38,140,178,948.0,82,5.34,48,255,2438,9.0
3154,Braydon Coburn,2019-20,34.0,15,12,80,80,5,7,12,102.0,1339.0,778,43,147,190,1050.0,82,5.45,47,245,2478,9.0
3155,Braydon Coburn,2020-21,35.0,16,15,72,72,1,14,15,73.0,1154.0,850,44,161,205,1123.0,82,5.86,50,250,2620,9.2
3156,Braydon Coburn,2021-22,36.0,17,23,74,74,4,19,23,113.0,1192.0,924,48,180,228,1236.0,82,5.96,47,239,2579,9.5
3157,Braydon Coburn,2022-23,37.0,18,4,40,40,1,3,4,44.0,562.0,964,49,183,232,1280.0,70,5.96,42,208,2192,9.5
3158,Brendan Bell,2008-09,25.0,4,0,1,1,0,0,0,2.0,14.0,1,0,0,0,2.0,82,6.05,85,480,2458,10.1
3159,Brendan Bell,2009-10,26.0,5,7,45,45,1,6,7,47.0,616.0,46,1,6,7,49.0,82,5.76,70,398,2426,9.7
3160,Brendan Bell,2010-11,27.0,6,0,2,2,0,0,0,0.0,30.0,48,1,6,7,49.0,82,5.44,62,351,2383,9.4
3161,Brendan Bell,2011-12,28.0,7,21,53,53,6,15,21,76.0,940.0,101,7,21,28,125.0,82,5.7,65,341,2477,9.4
3162,Brendan Bell,2014-15,31.0,8,0,1,1,0,0,0,2.0,11.0,102,7,21,28,127.0,82,5.32,47,271,2439,8.9
3163,Brendan Gallagher,2015-16,23.0,4,28,44,44,15,13,28,117.0,610.0,44,15,13,28,117.0,48,5.31,29,160,1399,9.1
3164,Brendan Gallagher,2016-17,24.0,5,41,81,81,19,22,41,211.0,1293.0,125,34,35,69,328.0,82,5.34,48,269,2463,8.9
3165,Brendan Gallagher,2017-18,25.0,6,47,82,82,24,23,47,254.0,1360.0,207,58,58,116,582.0,82,5.32,47,251,2453,8.9
3166,Brendan Gallagher,2018-19,26.0,7,40,53,53,19,21,40,173.0,879.0,260,77,79,156,755.0,82,5.34,48,255,2438,9.0
3167,Brendan Gallagher,2019-20,27.0,8,29,64,64,10,19,29,187.0,966.0,324,87,98,185,942.0,82,5.45,47,245,2478,9.0
3168,Brendan Gallagher,2020-21,28.0,9,54,82,82,31,23,54,278.0,1325.0,406,118,121,239,1220.0,82,5.86,50,250,2620,9.2
3169,Brendan Gallagher,2021-22,29.0,10,52,82,82,33,19,52,302.0,1345.0,488,151,140,291,1522.0,82,5.96,47,239,2579,9.5
3170,Brendan Gallagher,2022-23,30.0,11,43,59,59,22,21,43,226.0,998.0,547,173,161,334,1748.0,70,5.96,42,208,2192,9.5
3171,Brendan Gaunce,2018-19,24.0,4,1,20,20,1,0,1,34.0,255.0,20,1,0,1,34.0,82,5.34,48,255,2438,9.0
3172,Brendan Gaunce,2019-20,25.0,5,5,57,57,0,5,5,51.0,541.0,77,1,5,6,85.0,82,5.45,47,245,2478,9.0
3173,Brendan Gaunce,2020-21,26.0,6,6,37,37,4,2,6,55.0,492.0,114,5,7,12,140.0,82,5.86,50,250,2620,9.2
3174,Brendan Gaunce,2021-22,27.0,7,3,3,3,1,2,3,2.0,23.0,117,6,9,15,142.0,82,5.96,47,239,2579,9.5
3175,Brendan Gaunce,2022-23,28.0,8,1,1,1,0,1,1,0.0,9.0,118,6,10,16,142.0,70,5.96,42,208,2192,9.5
3176,Brendan Guhle,2019-20,22.0,4,0,3,3,0,0,0,4.0,49.0,3,0,0,0,4.0,82,5.45,47,245,2478,9.0
3177,Brendan Guhle,2020-21,23.0,5,5,18,18,0,5,5,37.0,326.0,21,0,5,5,41.0,82,5.86,50,250,2620,9.2
3178,Brendan Guhle,2021-22,24.0,6,1,8,8,0,1,1,15.0,120.0,29,0,6,6,56.0,82,5.96,47,239,2579,9.5
3179,Brendan Guhle,2022-23,25.0,7,8,30,30,4,4,8,39.0,512.0,59,4,10,14,95.0,70,5.96,42,208,2192,9.5
3180,Brendan Leipsic,2018-19,24.0,4,3,6,6,1,2,3,11.0,85.0,6,1,2,3,11.0,82,5.34,48,255,2438,9.0
3181,Brendan Leipsic,2020-21,26.0,5,22,58,58,5,17,22,95.0,762.0,64,6,19,25,106.0,82,5.86,50,250,2620,9.2
3182,Brendan Leipsic,2021-22,27.0,6,23,62,62,7,16,23,92.0,855.0,126,13,35,48,198.0,82,5.96,47,239,2579,9.5
3183,Brendan Leipsic,2022-23,28.0,7,11,61,61,3,8,11,49.0,559.0,187,16,43,59,247.0,70,5.96,42,208,2192,9.5
3184,Brendan Lemieux,2020-21,24.0,4,1,9,9,1,0,1,6.0,71.0,9,1,0,1,6.0,82,5.86,50,250,2620,9.2
3185,Brendan Lemieux,2021-22,25.0,5,17,63,63,12,5,17,67.0,570.0,72,13,5,18,73.0,82,5.96,47,239,2579,9.5
3186,Brendan Lemieux,2022-23,26.0,6,18,59,59,6,12,18,86.0,759.0,131,19,17,36,159.0,70,5.96,42,208,2192,9.5
3187,Brendan Mikkelson,2011-12,24.0,4,2,34,34,0,2,2,19.0,474.0,34,0,2,2,19.0,82,5.7,65,341,2477,9.4
3188,Brendan Mikkelson,2012-13,25.0,5,2,28,28,0,2,2,21.0,420.0,62,0,4,4,40.0,82,5.53,56,304,2486,9.1
3189,Brendan Mikkelson,2013-14,26.0,6,2,24,24,0,2,2,14.0,341.0,86,0,6,6,54.0,82,5.46,52,291,2492,9.0
3190,Brendan Mikkelson,2014-15,27.0,7,3,41,41,1,2,3,45.0,590.0,127,1,8,9,99.0,82,5.32,47,271,2439,8.9
3191,Brendan Mikkelson,2015-16,28.0,8,1,4,4,0,1,1,0.0,39.0,131,1,9,10,99.0,48,5.31,29,160,1399,9.1
3192,Brendan Morrison,2000-01,25.0,4,9,11,11,5,4,9,19.0,,11,5,4,9,19.0,82,5.28,57,380,2242,9.6
3193,Brendan Morrison,2001-02,26.0,5,46,76,76,13,33,46,111.0,1058.0,87,18,37,55,130.0,82,5.27,57,359,2285,9.4
3194,Brendan Morrison,2002-03,27.0,6,35,56,56,7,28,35,96.0,887.0,143,25,65,90,226.0,82,5.49,53,331,2294,9.8
3195,Brendan Morrison,2003-04,28.0,7,54,82,82,16,38,54,179.0,1506.0,225,41,103,144,405.0,82,5.51,63,376,2272,9.9
3196,Brendan Morrison,2004-05,29.0,8,67,82,82,23,44,67,183.0,1587.0,307,64,147,211,588.0,82,5.24,53,338,2262,9.5
3197,Brendan Morrison,2005-06,30.0,9,71,82,82,25,46,71,167.0,1740.0,389,89,193,282,755.0,82,5.31,60,363,2326,9.4
3198,Brendan Morrison,2006-07,31.0,10,60,82,82,22,38,60,161.0,1651.0,471,111,231,342,916.0,82,5.14,57,348,2300,9.2
3199,Brendan Morrison,2008-09,33.0,11,56,82,82,19,37,56,156.0,1600.0,553,130,268,398,1072.0,82,6.05,85,480,2458,10.1
3200,Brendan Morrison,2009-10,34.0,12,51,82,82,20,31,51,139.0,1472.0,635,150,299,449,1211.0,82,5.76,70,398,2426,9.7
3201,Brendan Morrison,2010-11,35.0,13,25,39,39,9,16,25,54.0,600.0,674,159,315,474,1265.0,82,5.44,62,351,2383,9.4
3202,Brendan Morrison,2011-12,36.0,14,31,81,81,16,15,31,111.0,1151.0,755,175,330,505,1376.0,82,5.7,65,341,2477,9.4
3203,Brendan Morrison,2012-13,37.0,15,42,74,74,12,30,42,105.0,1164.0,829,187,360,547,1481.0,82,5.53,56,304,2486,9.1
3204,Brendan Morrison,2013-14,38.0,16,43,66,66,9,34,43,89.0,1102.0,895,196,394,590,1570.0,82,5.46,52,291,2492,9.0
3205,Brendan Morrison,2014-15,39.0,17,11,39,39,4,7,11,43.0,521.0,934,200,401,601,1613.0,82,5.32,47,271,2439,8.9
3206,Brendan Perlini,2019-20,23.0,4,21,57,57,14,7,21,92.0,846.0,57,14,7,21,92.0,82,5.45,47,245,2478,9.0
3207,Brendan Perlini,2020-21,24.0,5,30,74,74,17,13,30,129.0,1074.0,131,31,20,51,221.0,82,5.86,50,250,2620,9.2
3208,Brendan Perlini,2021-22,25.0,6,21,68,68,14,7,21,117.0,789.0,199,45,27,72,338.0,82,5.96,47,239,2579,9.5
3209,Brendan Perlini,2022-23,26.0,7,4,40,40,1,3,4,48.0,428.0,239,46,30,76,386.0,70,5.96,42,208,2192,9.5
3210,Brendan Ranford,2017-18,25.0,4,0,1,1,0,0,0,0.0,9.0,1,0,0,0,0.0,82,5.32,47,251,2453,8.9
3211,Brendan Shanahan,1990-91,22.0,4,26,65,65,7,19,26,72.0,,65,7,19,26,72.0,80,7.43,89,437,2435,12.2
3212,Brendan Shanahan,1991-92,23.0,5,50,68,68,22,28,50,152.0,,133,29,47,76,224.0,80,7.48,85,403,2430,12.3
3213,Brendan Shanahan,1992-93,24.0,6,72,73,73,30,42,72,196.0,,206,59,89,148,420.0,80,7.37,76,367,2421,12.2
3214,Brendan Shanahan,1993-94,25.0,7,66,75,75,29,37,66,195.0,,281,88,126,214,615.0,80,6.91,71,366,2385,11.6
3215,Brendan Shanahan,1994-95,26.0,8,69,80,80,33,36,69,215.0,,361,121,162,283,830.0,80,6.96,77,402,2440,11.4
3216,Brendan Shanahan,1995-96,27.0,9,94,71,71,51,43,94,232.0,,432,172,205,377,1062.0,84,7.25,87,443,2603,11.7
3217,Brendan Shanahan,1996-97,28.0,10,102,81,81,52,50,102,397.0,,513,224,255,479,1459.0,84,6.48,76,407,2545,10.7
3218,Brendan Shanahan,1997-98,29.0,11,41,45,45,20,21,41,153.0,,558,244,276,520,1612.0,48,5.97,37,209,1408,10.2
3219,Brendan Shanahan,1998-99,30.0,12,78,74,74,44,34,78,280.0,,632,288,310,598,1892.0,82,6.29,74,413,2481,10.4
3220,Brendan Shanahan,1999-00,31.0,13,88,81,81,47,41,88,336.0,,713,335,351,686,2228.0,82,5.83,55,336,2444,9.8
3221,Brendan Shanahan,2000-01,32.0,14,57,75,75,28,29,57,266.0,,788,363,380,743,2494.0,82,5.28,57,380,2242,9.6
3222,Brendan Shanahan,2001-02,33.0,15,58,81,81,31,27,58,288.0,1419.0,869,394,407,801,2782.0,82,5.27,57,359,2285,9.4
3223,Brendan Shanahan,2002-03,34.0,16,78,78,78,41,37,78,283.0,1449.0,947,435,444,879,3065.0,82,5.49,53,331,2294,9.8
3224,Brendan Shanahan,2003-04,35.0,17,76,81,81,31,45,76,278.0,1488.0,1028,466,489,955,3343.0,82,5.51,63,376,2272,9.9
3225,Brendan Shanahan,2004-05,36.0,18,75,80,80,37,38,75,277.0,1513.0,1108,503,527,1030,3620.0,82,5.24,53,338,2262,9.5
3226,Brendan Shanahan,2005-06,37.0,19,68,78,78,30,38,68,260.0,1454.0,1186,533,565,1098,3880.0,82,5.31,60,363,2326,9.4
3227,Brendan Shanahan,2006-07,38.0,20,53,82,82,25,28,53,280.0,1483.0,1268,558,593,1151,4160.0,82,5.14,57,348,2300,9.2
3228,Brendan Shanahan,2008-09,40.0,21,81,82,82,40,41,81,289.0,1360.0,1350,598,634,1232,4449.0,82,6.05,85,480,2458,10.1
3229,Brendan Shanahan,2009-10,41.0,22,62,67,67,29,33,62,295.0,1328.0,1417,627,667,1294,4744.0,82,5.76,70,398,2426,9.7
3230,Brendan Shanahan,2010-11,42.0,23,46,73,73,23,23,46,265.0,1351.0,1490,650,690,1340,5009.0,82,5.44,62,351,2383,9.4
3231,Brendan Shanahan,2011-12,43.0,24,14,34,34,6,8,14,77.0,506.0,1524,656,698,1354,5086.0,82,5.7,65,341,2477,9.4
3232,Brendan Shinnimin,2017-18,27.0,4,1,12,12,0,1,1,10.0,132.0,12,0,1,1,10.0,82,5.32,47,251,2453,8.9
3233,Brendan Smith,2014-15,25.0,4,7,14,14,1,6,7,13.0,219.0,14,1,6,7,13.0,82,5.32,47,271,2439,8.9
3234,Brendan Smith,2015-16,26.0,5,8,34,34,0,8,8,33.0,626.0,48,1,14,15,46.0,48,5.31,29,160,1399,9.1
3235,Brendan Smith,2016-17,27.0,6,19,71,71,5,14,19,90.0,1306.0,119,6,28,34,136.0,82,5.34,48,269,2463,8.9
3236,Brendan Smith,2017-18,28.0,7,13,76,76,4,9,13,88.0,1360.0,195,10,37,47,224.0,82,5.32,47,251,2453,8.9
3237,Brendan Smith,2018-19,29.0,8,15,63,63,3,12,15,82.0,1109.0,258,13,49,62,306.0,82,5.34,48,255,2438,9.0
3238,Brendan Smith,2019-20,30.0,9,9,51,51,3,6,9,62.0,981.0,309,16,55,71,368.0,82,5.45,47,245,2478,9.0
3239,Brendan Smith,2020-21,31.0,10,8,44,44,1,7,8,66.0,755.0,353,17,62,79,434.0,82,5.86,50,250,2620,9.2
3240,Brendan Smith,2021-22,32.0,11,13,63,63,4,9,13,66.0,964.0,416,21,71,92,500.0,82,5.96,47,239,2579,9.5
3241,Brendan Smith,2022-23,33.0,12,8,62,62,3,5,8,45.0,688.0,478,24,76,100,545.0,70,5.96,42,208,2192,9.5
3242,Brendan Witt,1998-99,23.0,4,5,48,48,2,3,5,44.0,,48,2,3,5,44.0,82,6.29,74,413,2481,10.4
3243,Brendan Witt,1999-00,24.0,5,5,44,44,3,2,5,41.0,,92,5,5,10,85.0,82,5.83,55,336,2444,9.8
3244,Brendan Witt,2000-01,25.0,6,8,64,64,1,7,8,68.0,,156,6,12,18,153.0,82,5.28,57,380,2242,9.6
3245,Brendan Witt,2001-02,26.0,7,7,54,54,2,5,7,51.0,855.0,210,8,17,25,204.0,82,5.27,57,359,2285,9.4
3246,Brendan Witt,2002-03,27.0,8,8,77,77,1,7,8,64.0,1612.0,287,9,24,33,268.0,82,5.49,53,331,2294,9.8
3247,Brendan Witt,2003-04,28.0,9,6,72,72,3,3,6,87.0,1489.0,359,12,27,39,355.0,82,5.51,63,376,2272,9.9
3248,Brendan Witt,2004-05,29.0,10,10,68,68,3,7,10,81.0,1363.0,427,15,34,49,436.0,82,5.24,53,338,2262,9.5
3249,Brendan Witt,2005-06,30.0,11,11,69,69,2,9,11,80.0,1444.0,496,17,43,60,516.0,82,5.31,60,363,2326,9.4
3250,Brendan Witt,2006-07,31.0,12,12,72,72,2,10,12,91.0,1641.0,568,19,53,72,607.0,82,5.14,57,348,2300,9.2
3251,Brendan Witt,2008-09,33.0,13,14,75,75,1,13,14,75.0,1555.0,643,20,66,86,682.0,82,6.05,85,480,2458,10.1
3252,Brendan Witt,2009-10,34.0,14,14,81,81,1,13,14,75.0,1753.0,724,21,79,100,757.0,82,5.76,70,398,2426,9.7
3253,Brendan Witt,2010-11,35.0,15,7,59,59,2,5,7,58.0,1285.0,783,23,84,107,815.0,82,5.44,62,351,2383,9.4
3254,Brendan Witt,2011-12,36.0,16,9,65,65,0,9,9,52.0,1320.0,848,23,93,116,867.0,82,5.7,65,341,2477,9.4
3255,Brendan Witt,2012-13,37.0,17,5,42,42,2,3,5,25.0,640.0,890,25,96,121,892.0,82,5.53,56,304,2486,9.1
3256,Brendan Woods,2017-18,25.0,4,0,2,2,0,0,0,3.0,12.0,2,0,0,0,3.0,82,5.32,47,251,2453,8.9
3257,Brendan Woods,2018-19,26.0,5,0,5,5,0,0,0,5.0,44.0,7,0,0,0,8.0,82,5.34,48,255,2438,9.0
3258,Brenden Dillon,2014-15,24.0,4,0,1,1,0,0,0,6.0,20.0,1,0,0,0,6.0,82,5.32,47,271,2439,8.9
3259,Brenden Dillon,2015-16,25.0,5,8,48,48,3,5,8,75.0,1026.0,49,3,5,8,81.0,48,5.31,29,160,1399,9.1
3260,Brenden Dillon,2016-17,26.0,6,17,80,80,6,11,17,97.0,1687.0,129,9,16,25,178.0,82,5.34,48,269,2463,8.9
3261,Brenden Dillon,2017-18,27.0,7,10,80,80,2,8,10,91.0,1566.0,209,11,24,35,269.0,82,5.32,47,251,2453,8.9
3262,Brenden Dillon,2018-19,28.0,8,11,76,76,2,9,11,93.0,1268.0,285,13,33,46,362.0,82,5.34,48,255,2438,9.0
3263,Brenden Dillon,2019-20,29.0,9,10,81,81,2,8,10,86.0,1334.0,366,15,41,56,448.0,82,5.45,47,245,2478,9.0
3264,Brenden Dillon,2020-21,30.0,10,22,81,81,5,17,22,88.0,1403.0,447,20,58,78,536.0,82,5.86,50,250,2620,9.2
3265,Brenden Dillon,2021-22,31.0,11,22,82,82,1,21,22,71.0,1455.0,529,21,79,100,607.0,82,5.96,47,239,2579,9.5
3266,Brenden Dillon,2022-23,32.0,12,14,69,69,1,13,14,58.0,1343.0,598,22,92,114,665.0,70,5.96,42,208,2192,9.5
3267,Brenden Morrow,2002-03,24.0,4,33,64,64,14,19,33,113.0,1014.0,64,14,19,33,113.0,82,5.49,53,331,2294,9.8
3268,Brenden Morrow,2003-04,25.0,5,44,82,82,20,24,44,121.0,1270.0,146,34,43,77,234.0,82,5.51,63,376,2272,9.9
3269,Brenden Morrow,2004-05,26.0,6,35,72,72,17,18,35,102.0,1215.0,218,51,61,112,336.0,82,5.24,53,338,2262,9.5
3270,Brenden Morrow,2005-06,27.0,7,43,71,71,21,22,43,105.0,1115.0,289,72,83,155,441.0,82,5.31,60,363,2326,9.4
3271,Brenden Morrow,2006-07,28.0,8,49,81,81,25,24,49,132.0,1571.0,370,97,107,204,573.0,82,5.14,57,348,2300,9.2
3272,Brenden Morrow,2008-09,30.0,9,65,81,81,23,42,65,146.0,1560.0,451,120,149,269,719.0,82,6.05,85,480,2458,10.1
3273,Brenden Morrow,2009-10,31.0,10,31,40,40,16,15,31,101.0,731.0,491,136,164,300,820.0,82,5.76,70,398,2426,9.7
3274,Brenden Morrow,2010-11,32.0,11,74,82,82,32,42,74,207.0,1639.0,573,168,206,374,1027.0,82,5.44,62,351,2383,9.4
3275,Brenden Morrow,2011-12,33.0,12,15,18,18,5,10,15,52.0,384.0,591,173,216,389,1079.0,82,5.7,65,341,2477,9.4
3276,Brenden Morrow,2012-13,34.0,13,46,76,76,20,26,46,155.0,1457.0,667,193,242,435,1234.0,82,5.53,56,304,2486,9.1
3277,Brenden Morrow,2013-14,35.0,14,56,82,82,33,23,56,209.0,1577.0,749,226,265,491,1443.0,82,5.46,52,291,2492,9.0
3278,Brenden Morrow,2014-15,36.0,15,26,57,57,11,15,26,88.0,971.0,806,237,280,517,1531.0,82,5.32,47,271,2439,8.9
3279,Brenden Morrow,2015-16,37.0,16,25,44,44,12,13,25,55.0,654.0,850,249,293,542,1586.0,48,5.31,29,160,1399,9.1
3280,Brenden Morrow,2016-17,38.0,17,25,71,71,13,12,25,56.0,845.0,921,262,305,567,1642.0,82,5.34,48,269,2463,8.9
3281,Brenden Morrow,2017-18,39.0,18,8,70,70,3,5,8,28.0,653.0,991,265,310,575,1670.0,82,5.32,47,251,2453,8.9
3282,Brendon Nash,2013-14,26.0,4,0,2,2,0,0,0,2.0,20.0,2,0,0,0,2.0,82,5.46,52,291,2492,9.0
3283,Brennan Menell,2022-23,25.0,4,0,5,5,0,0,0,4.0,70.0,5,0,0,0,4.0,70,5.96,42,208,2192,9.5
3284,Brent Ashton,1982-83,22.0,4,19,47,47,5,14,19,69.0,,47,5,14,19,69.0,80,7.03,61,280,2352,12.0
3285,Brent Ashton,1983-84,23.0,5,29,77,77,18,11,29,111.0,,124,23,25,48,180.0,80,7.69,77,340,2441,12.6
3286,Brent Ashton,1984-85,24.0,6,60,80,80,24,36,60,182.0,,204,47,61,108,362.0,80,8.03,73,320,2489,12.9
3287,Brent Ashton,1985-86,25.0,7,33,76,76,14,19,33,113.0,,280,61,80,141,475.0,80,7.73,71,310,2444,12.7
3288,Brent Ashton,1986-87,26.0,8,17,68,68,7,10,17,82.0,,348,68,90,158,557.0,80,7.89,74,336,2448,12.9
3289,Brent Ashton,1987-88,27.0,9,62,78,78,31,31,62,153.0,,426,99,121,220,710.0,80,7.77,71,321,2447,12.7
3290,Brent Ashton,1988-89,28.0,10,58,77,77,26,32,58,207.0,,503,125,153,278,917.0,80,7.94,82,370,2484,12.8
3291,Brent Ashton,1989-90,29.0,11,75,81,81,40,35,75,185.0,,584,165,188,353,1102.0,80,7.34,72,344,2400,12.2
3292,Brent Ashton,1990-91,30.0,12,53,73,73,26,27,53,161.0,,657,191,215,406,1263.0,80,7.43,89,437,2435,12.2
3293,Brent Ashton,1991-92,31.0,13,68,75,75,31,37,68,180.0,,732,222,252,474,1443.0,80,7.48,85,403,2430,12.3
3294,Brent Ashton,1992-93,32.0,14,56,79,79,22,34,56,167.0,,811,244,286,530,1610.0,80,7.37,76,367,2421,12.2
3295,Brent Ashton,1993-94,33.0,15,36,61,61,12,24,36,107.0,,872,256,310,566,1717.0,80,6.91,71,366,2385,11.6
3296,Brent Ashton,1994-95,34.0,16,40,68,68,18,22,40,130.0,,940,274,332,606,1847.0,80,6.96,77,402,2440,11.4
3297,Brent Ashton,1995-96,35.0,17,23,58,58,10,13,23,84.0,,998,284,345,629,1931.0,84,7.25,87,443,2603,11.7
3298,Brent Burns,2006-07,21.0,4,6,36,36,1,5,6,34.0,485.0,36,1,5,6,34.0,82,5.14,57,348,2300,9.2
3299,Brent Burns,2008-09,23.0,5,16,72,72,4,12,16,73.0,1016.0,108,5,17,22,107.0,82,6.05,85,480,2458,10.1
3300,Brent Burns,2009-10,24.0,6,25,77,77,7,18,25,108.0,1216.0,185,12,35,47,215.0,82,5.76,70,398,2426,9.7
3301,Brent Burns,2010-11,25.0,7,43,82,82,15,28,43,158.0,1894.0,267,27,63,90,373.0,82,5.44,62,351,2383,9.4
3302,Brent Burns,2011-12,26.0,8,27,59,59,8,19,27,147.0,1323.0,326,35,82,117,520.0,82,5.7,65,341,2477,9.4
3303,Brent Burns,2012-13,27.0,9,20,47,47,3,17,20,104.0,1052.0,373,38,99,137,624.0,82,5.53,56,304,2486,9.1
3304,Brent Burns,2013-14,28.0,10,46,80,80,17,29,46,170.0,2004.0,453,55,128,183,794.0,82,5.46,52,291,2492,9.0
3305,Brent Burns,2014-15,29.0,11,37,81,81,11,26,37,201.0,1826.0,534,66,154,220,995.0,82,5.32,47,271,2439,8.9
3306,Brent Burns,2015-16,30.0,12,20,30,30,9,11,20,81.0,488.0,564,75,165,240,1076.0,48,5.31,29,160,1399,9.1
3307,Brent Burns,2016-17,31.0,13,48,69,69,22,26,48,245.0,1160.0,633,97,191,288,1321.0,82,5.34,48,269,2463,8.9
3308,Brent Burns,2017-18,32.0,14,60,82,82,17,43,60,245.0,1964.0,715,114,234,348,1566.0,82,5.32,47,251,2453,8.9
3309,Brent Burns,2018-19,33.0,15,75,82,82,27,48,75,353.0,2121.0,797,141,282,423,1919.0,82,5.34,48,255,2438,9.0
3310,Brent Burns,2019-20,34.0,16,76,82,82,29,47,76,320.0,2039.0,879,170,329,499,2239.0,82,5.45,47,245,2478,9.0
3311,Brent Burns,2020-21,35.0,17,67,82,82,12,55,67,332.0,2070.0,961,182,384,566,2571.0,82,5.86,50,250,2620,9.2
3312,Brent Burns,2021-22,36.0,18,83,82,82,16,67,83,300.0,2058.0,1043,198,451,649,2871.0,82,5.96,47,239,2579,9.5
3313,Brent Burns,2022-23,37.0,19,45,70,70,12,33,45,225.0,1779.0,1113,210,484,694,3096.0,70,5.96,42,208,2192,9.5
3314,Brent Fedyk,1990-91,23.0,4,1,2,2,0,1,1,2.0,,2,0,1,1,2.0,80,7.43,89,437,2435,12.2
3315,Brent Fedyk,1991-92,24.0,5,2,5,5,2,0,2,6.0,,7,2,1,3,8.0,80,7.48,85,403,2430,12.3
3316,Brent Fedyk,1992-93,25.0,6,5,27,27,1,4,5,28.0,,34,3,5,8,36.0,80,7.37,76,367,2421,12.2
3317,Brent Fedyk,1993-94,26.0,7,35,67,67,16,19,35,74.0,,101,19,24,43,110.0,80,6.91,71,366,2385,11.6
3318,Brent Fedyk,1994-95,27.0,8,13,61,61,5,8,13,60.0,,162,24,32,56,170.0,80,6.96,77,402,2440,11.4
3319,Brent Fedyk,1995-96,28.0,9,59,74,74,21,38,59,167.0,,236,45,70,115,337.0,84,7.25,87,443,2603,11.7
3320,Brent Fedyk,1996-97,29.0,10,38,72,72,20,18,38,104.0,,308,65,88,153,441.0,84,6.48,76,407,2545,10.7
3321,Brent Fedyk,1997-98,30.0,11,12,30,30,8,4,12,41.0,,338,73,92,165,482.0,48,5.97,37,209,1408,10.2
3322,Brent Fedyk,1998-99,31.0,12,34,65,65,20,14,34,113.0,,403,93,106,199,595.0,82,6.29,74,413,2481,10.4
3323,Brent Fedyk,2001-02,34.0,13,10,67,67,4,6,10,47.0,744.0,470,97,112,209,642.0,82,5.27,57,359,2285,9.4
3324,Brent Gilchrist,1991-92,24.0,4,24,49,49,8,16,24,68.0,,49,8,16,24,68.0,80,7.48,85,403,2430,12.3
3325,Brent Gilchrist,1992-93,25.0,5,24,57,57,9,15,24,80.0,,106,17,31,48,148.0,80,7.37,76,367,2421,12.2
3326,Brent Gilchrist,1993-94,26.0,6,15,51,51,6,9,15,81.0,,157,23,40,63,229.0,80,6.91,71,366,2385,11.6
3327,Brent Gilchrist,1994-95,27.0,7,50,79,79,23,27,50,146.0,,236,46,67,113,375.0,80,6.96,77,402,2440,11.4
3328,Brent Gilchrist,1995-96,28.0,8,21,68,68,10,11,21,106.0,,304,56,78,134,481.0,84,7.25,87,443,2603,11.7
3329,Brent Gilchrist,1996-97,29.0,9,31,76,76,17,14,31,103.0,,380,73,92,165,584.0,84,6.48,76,407,2545,10.7
3330,Brent Gilchrist,1997-98,30.0,10,13,32,32,9,4,13,70.0,,412,82,96,178,654.0,48,5.97,37,209,1408,10.2
3331,Brent Gilchrist,1998-99,31.0,11,42,77,77,20,22,42,164.0,,489,102,118,220,818.0,82,6.29,74,413,2481,10.4
3332,Brent Gilchrist,1999-00,32.0,12,30,67,67,10,20,30,116.0,,556,112,138,250,934.0,82,5.83,55,336,2444,9.8
3333,Brent Gilchrist,2000-01,33.0,13,27,61,61,13,14,27,124.0,,617,125,152,277,1058.0,82,5.28,57,380,2242,9.6
3334,Brent Gilchrist,2001-02,34.0,14,1,5,5,1,0,1,4.0,60.0,622,126,152,278,1062.0,82,5.27,57,359,2285,9.4
3335,Brent Gilchrist,2002-03,35.0,15,6,24,24,4,2,6,33.0,272.0,646,130,154,284,1095.0,82,5.49,53,331,2294,9.8
3336,Brent Gilchrist,2003-04,36.0,16,9,60,60,1,8,9,75.0,701.0,706,131,162,293,1170.0,82,5.51,63,376,2272,9.9
3337,Brent Gilchrist,2004-05,37.0,17,9,45,45,3,6,9,53.0,505.0,751,134,168,302,1223.0,82,5.24,53,338,2262,9.5
3338,Brent Gilchrist,2005-06,38.0,18,3,41,41,1,2,3,41.0,441.0,792,135,170,305,1264.0,82,5.31,60,363,2326,9.4
3339,Brent Gretzky,1996-97,24.0,4,3,10,10,1,2,3,14.0,,10,1,2,3,14.0,84,6.48,76,407,2545,10.7
3340,Brent Gretzky,1997-98,25.0,5,1,3,3,0,1,1,1.0,,13,1,3,4,15.0,48,5.97,37,209,1408,10.2
3341,Brent Grieve,1996-97,27.0,4,18,27,27,13,5,18,54.0,,27,13,5,18,54.0,84,6.48,76,407,2545,10.7
3342,Brent Grieve,1997-98,28.0,5,6,24,24,1,5,6,30.0,,51,14,10,24,84.0,48,5.97,37,209,1408,10.2
3343,Brent Grieve,1998-99,29.0,6,6,28,28,2,4,6,22.0,,79,16,14,30,106.0,82,6.29,74,413,2481,10.4
3344,Brent Grieve,1999-00,30.0,7,6,18,18,4,2,6,50.0,,97,20,16,36,156.0,82,5.83,55,336,2444,9.8
3345,Brent Hughes,1991-92,25.0,4,5,28,28,3,2,5,37.0,,28,3,2,5,37.0,80,7.48,85,403,2430,12.3
3346,Brent Hughes,1992-93,26.0,5,3,11,11,1,2,3,7.0,,39,4,4,8,44.0,80,7.37,76,367,2421,12.2
3347,Brent Hughes,1994-95,28.0,6,2,8,8,1,1,2,10.0,,47,5,5,10,54.0,80,6.96,77,402,2440,11.4
3348,Brent Hughes,1995-96,29.0,7,9,62,62,5,4,9,54.0,,109,10,9,19,108.0,84,7.25,87,443,2603,11.7
3349,Brent Hughes,1996-97,30.0,8,24,77,77,13,11,24,100.0,,186,23,20,43,208.0,84,6.48,76,407,2545,10.7
3350,Brent Hughes,1997-98,31.0,9,12,44,44,6,6,12,75.0,,230,29,26,55,283.0,48,5.97,37,209,1408,10.2
3351,Brent Hughes,1998-99,32.0,10,15,76,76,5,10,15,56.0,,306,34,36,70,339.0,82,6.29,74,413,2481,10.4
3352,Brent Hughes,1999-00,33.0,11,10,51,51,7,3,10,47.0,,357,41,39,80,386.0,82,5.83,55,336,2444,9.8
3353,Brent Peterson,1999-00,27.0,4,2,17,17,2,0,2,11.0,,17,2,0,2,11.0,82,5.83,55,336,2444,9.8
3354,Brent Peterson,2000-01,28.0,5,5,19,19,5,0,5,15.0,,36,7,0,7,26.0,82,5.28,57,380,2242,9.6
3355,Brent Peterson,2001-02,29.0,6,3,20,20,2,1,3,16.0,179.0,56,9,1,10,42.0,82,5.27,57,359,2285,9.4
3356,Brent Regner,2018-19,29.0,4,0,7,7,0,0,0,7.0,81.0,7,0,0,0,7.0,82,5.34,48,255,2438,9.0
3357,Brent Seabrook,2008-09,23.0,4,32,69,69,5,27,32,114.0,1382.0,69,5,27,32,114.0,82,6.05,85,480,2458,10.1
3358,Brent Seabrook,2009-10,24.0,5,24,81,81,4,20,24,144.0,1683.0,150,9,47,56,258.0,82,5.76,70,398,2426,9.7
3359,Brent Seabrook,2010-11,25.0,6,32,82,82,9,23,32,152.0,1763.0,232,18,70,88,410.0,82,5.44,62,351,2383,9.4
3360,Brent Seabrook,2011-12,26.0,7,26,82,82,8,18,26,132.0,1912.0,314,26,88,114,542.0,82,5.7,65,341,2477,9.4
3361,Brent Seabrook,2012-13,27.0,8,30,78,78,4,26,30,129.0,1811.0,392,30,114,144,671.0,82,5.53,56,304,2486,9.1
3362,Brent Seabrook,2013-14,28.0,9,48,82,82,9,39,48,135.0,2000.0,474,39,153,192,806.0,82,5.46,52,291,2492,9.0
3363,Brent Seabrook,2014-15,29.0,10,34,78,78,9,25,34,156.0,1929.0,552,48,178,226,962.0,82,5.32,47,271,2439,8.9
3364,Brent Seabrook,2015-16,30.0,11,20,47,47,8,12,20,65.0,1034.0,599,56,190,246,1027.0,48,5.31,29,160,1399,9.1
3365,Brent Seabrook,2016-17,31.0,12,41,82,82,7,34,41,149.0,1826.0,681,63,224,287,1176.0,82,5.34,48,269,2463,8.9
3366,Brent Seabrook,2017-18,32.0,13,31,82,82,8,23,31,181.0,1819.0,763,71,247,318,1357.0,82,5.32,47,251,2453,8.9
3367,Brent Seabrook,2018-19,33.0,14,49,81,81,14,35,49,167.0,1849.0,844,85,282,367,1524.0,82,5.34,48,255,2438,9.0
3368,Brent Seabrook,2019-20,34.0,15,39,79,79,3,36,39,131.0,1729.0,923,88,318,406,1655.0,82,5.45,47,245,2478,9.0
3369,Brent Seabrook,2020-21,35.0,16,26,81,81,7,19,26,136.0,1636.0,1004,95,337,432,1791.0,82,5.86,50,250,2620,9.2
3370,Brent Seabrook,2021-22,36.0,17,28,78,78,5,23,28,165.0,1490.0,1082,100,360,460,1956.0,82,5.96,47,239,2579,9.5
3371,Brent Seabrook,2022-23,37.0,18,4,32,32,3,1,4,40.0,581.0,1114,103,361,464,1996.0,70,5.96,42,208,2192,9.5
3372,Brent Severyn,1992-93,26.0,4,2,35,35,0,2,2,28.0,,35,0,2,2,28.0,80,7.37,76,367,2421,12.2
3373,Brent Severyn,1996-97,30.0,5,11,67,67,4,7,11,93.0,,102,4,9,13,121.0,84,6.48,76,407,2545,10.7
3374,Brent Severyn,1997-98,31.0,6,6,28,28,2,4,6,32.0,,130,6,13,19,153.0,48,5.97,37,209,1408,10.2
3375,Brent Severyn,1998-99,32.0,7,9,65,65,1,8,9,40.0,,195,7,21,28,193.0,82,6.29,74,413,2481,10.4
3376,Brent Severyn,1999-00,33.0,8,5,66,66,1,4,5,55.0,,261,8,25,33,248.0,82,5.83,55,336,2444,9.8
3377,Brent Severyn,2000-01,34.0,9,4,37,37,1,3,4,27.0,,298,9,28,37,275.0,82,5.28,57,380,2242,9.6
3378,Brent Severyn,2001-02,35.0,10,3,30,30,1,2,3,22.0,154.0,328,10,30,40,297.0,82,5.27,57,359,2285,9.4
3379,Brent Sopel,2001-02,25.0,4,1,5,5,1,0,1,5.0,60.0,5,1,0,1,5.0,82,5.27,57,359,2285,9.4
3380,Brent Sopel,2002-03,26.0,5,6,18,18,2,4,6,11.0,189.0,23,3,4,7,16.0,82,5.49,53,331,2294,9.8
3381,Brent Sopel,2003-04,27.0,6,14,52,52,4,10,14,57.0,833.0,75,7,14,21,73.0,82,5.51,63,376,2272,9.9
3382,Brent Sopel,2004-05,28.0,7,25,66,66,8,17,25,116.0,1255.0,141,15,31,46,189.0,82,5.24,53,338,2262,9.5
3383,Brent Sopel,2005-06,29.0,8,37,81,81,7,30,37,167.0,1758.0,222,22,61,83,356.0,82,5.31,60,363,2326,9.4
3384,Brent Sopel,2006-07,30.0,9,42,80,80,10,32,42,173.0,1754.0,302,32,93,125,529.0,82,5.14,57,348,2300,9.2
3385,Brent Sopel,2008-09,32.0,10,28,68,68,2,26,28,133.0,1586.0,370,34,119,153,662.0,82,6.05,85,480,2458,10.1
3386,Brent Sopel,2009-10,33.0,11,28,64,64,5,23,28,131.0,1297.0,434,39,142,181,793.0,82,5.76,70,398,2426,9.7
3387,Brent Sopel,2010-11,34.0,12,20,58,58,1,19,20,56.0,1178.0,492,40,161,201,849.0,82,5.44,62,351,2383,9.4
3388,Brent Sopel,2011-12,35.0,13,2,23,23,1,1,2,15.0,318.0,515,41,162,203,864.0,82,5.7,65,341,2477,9.4
3389,Brent Sopel,2012-13,36.0,14,8,73,73,1,7,8,48.0,1085.0,588,42,169,211,912.0,82,5.53,56,304,2486,9.1
3390,Brent Sopel,2013-14,37.0,15,7,71,71,2,5,7,44.0,1160.0,659,44,174,218,956.0,82,5.46,52,291,2492,9.0
3391,Brent Sutter,1983-84,21.0,4,4,3,3,2,2,4,2.0,,3,2,2,4,2.0,80,7.69,77,340,2441,12.6
3392,Brent Sutter,1984-85,22.0,5,43,43,43,21,22,43,93.0,,46,23,24,47,95.0,80,8.03,73,320,2489,12.9
3393,Brent Sutter,1985-86,23.0,6,40,80,80,21,19,40,149.0,,126,44,43,87,244.0,80,7.73,71,310,2444,12.7
3394,Brent Sutter,1986-87,24.0,7,49,69,69,34,15,49,156.0,,195,78,58,136,400.0,80,7.89,74,336,2448,12.9
3395,Brent Sutter,1987-88,25.0,8,102,72,72,42,60,102,195.0,,267,120,118,238,595.0,80,7.77,71,321,2447,12.7
3396,Brent Sutter,1988-89,26.0,9,55,61,61,24,31,55,135.0,,328,144,149,293,730.0,80,7.94,82,370,2484,12.8
3397,Brent Sutter,1989-90,27.0,10,63,69,69,27,36,63,177.0,,397,171,185,356,907.0,80,7.34,72,344,2400,12.2
3398,Brent Sutter,1990-91,28.0,11,60,70,70,29,31,60,162.0,,467,200,216,416,1069.0,80,7.43,89,437,2435,12.2
3399,Brent Sutter,1991-92,29.0,12,63,77,77,29,34,63,187.0,,544,229,250,479,1256.0,80,7.48,85,403,2430,12.3
3400,Brent Sutter,1992-93,30.0,13,68,67,67,33,35,68,198.0,,611,262,285,547,1454.0,80,7.37,76,367,2421,12.2
3401,Brent Sutter,1993-94,31.0,14,53,75,75,21,32,53,186.0,,686,283,317,600,1640.0,80,6.91,71,366,2385,11.6
3402,Brent Sutter,1994-95,32.0,15,60,69,69,22,38,60,206.0,,755,305,355,660,1846.0,80,6.96,77,402,2440,11.4
3403,Brent Sutter,1995-96,33.0,16,54,65,65,20,34,54,151.0,,820,325,389,714,1997.0,84,7.25,87,443,2603,11.7
3404,Brent Sutter,1996-97,34.0,17,38,73,73,9,29,38,127.0,,893,334,418,752,2124.0,84,6.48,76,407,2545,10.7
3405,Brent Sutter,1997-98,35.0,18,15,47,47,7,8,15,65.0,,940,341,426,767,2189.0,48,5.97,37,209,1408,10.2
3406,Brent Sutter,1998-99,36.0,19,40,80,80,13,27,40,102.0,,1020,354,453,807,2291.0,82,6.29,74,413,2481,10.4
3407,Brent Sutter,1999-00,37.0,20,14,39,39,7,7,14,62.0,,1059,361,460,821,2353.0,82,5.83,55,336,2444,9.8
3408,Brent Sutter,2000-01,38.0,21,8,52,52,2,6,8,43.0,,1111,363,466,829,2396.0,82,5.28,57,380,2242,9.6
3409,Brent Thompson,1994-95,24.0,4,5,27,27,0,5,5,18.0,,27,0,5,5,18.0,80,6.96,77,402,2440,11.4
3410,Brent Thompson,1995-96,25.0,5,4,30,30,0,4,4,18.0,,57,0,9,9,36.0,84,7.25,87,443,2603,11.7
3411,Brent Thompson,1996-97,26.0,6,1,24,24,1,0,1,9.0,,81,1,9,10,45.0,84,6.48,76,407,2545,10.7
3412,Brent Thompson,1997-98,27.0,7,0,29,29,0,0,0,16.0,,110,1,9,10,61.0,48,5.97,37,209,1408,10.2
3413,Brent Thompson,1998-99,28.0,8,1,10,10,0,1,1,7.0,,120,1,10,11,68.0,82,6.29,74,413,2481,10.4
3414,Brent Thompson,1999-00,29.0,9,0,1,1,0,0,0,0.0,,121,1,10,11,68.0,82,5.83,55,336,2444,9.8
3415,Bret Hedican,1994-95,24.0,4,1,4,4,1,0,1,1.0,,4,1,0,1,1.0,80,6.96,77,402,2440,11.4
3416,Bret Hedican,1995-96,25.0,5,8,42,42,0,8,8,40.0,,46,1,8,9,41.0,84,7.25,87,443,2603,11.7
3417,Bret Hedican,1996-97,26.0,6,12,69,69,0,12,12,88.0,,115,1,20,21,129.0,84,6.48,76,407,2545,10.7
3418,Bret Hedican,1997-98,27.0,7,13,45,45,2,11,13,56.0,,160,3,31,34,185.0,48,5.97,37,209,1408,10.2
3419,Bret Hedican,1998-99,28.0,8,29,77,77,6,23,29,113.0,,237,9,54,63,298.0,82,6.29,74,413,2481,10.4
3420,Bret Hedican,1999-00,29.0,9,19,67,67,4,15,19,93.0,,304,13,69,82,391.0,82,5.83,55,336,2444,9.8
3421,Bret Hedican,2000-01,30.0,10,27,71,71,3,24,27,84.0,,375,16,93,109,475.0,82,5.28,57,380,2242,9.6
3422,Bret Hedican,2001-02,31.0,11,23,67,67,5,18,23,90.0,1344.0,442,21,111,132,565.0,82,5.27,57,359,2285,9.4
3423,Bret Hedican,2002-03,32.0,12,25,76,76,6,19,25,58.0,1489.0,518,27,130,157,623.0,82,5.49,53,331,2294,9.8
3424,Bret Hedican,2003-04,33.0,13,20,70,70,5,15,20,104.0,1527.0,588,32,145,177,727.0,82,5.51,63,376,2272,9.9
3425,Bret Hedican,2004-05,34.0,14,16,57,57,5,11,16,85.0,1355.0,645,37,156,193,812.0,82,5.24,53,338,2262,9.5
3426,Bret Hedican,2005-06,35.0,15,17,72,72,3,14,17,113.0,1658.0,717,40,170,210,925.0,82,5.31,60,363,2326,9.4
3427,Bret Hedican,2006-07,36.0,16,24,81,81,7,17,24,112.0,1829.0,798,47,187,234,1037.0,82,5.14,57,348,2300,9.2
3428,Bret Hedican,2008-09,38.0,17,27,74,74,5,22,27,73.0,1503.0,872,52,209,261,1110.0,82,6.05,85,480,2458,10.1
3429,Bret Hedican,2009-10,39.0,18,10,50,50,0,10,10,44.0,998.0,922,52,219,271,1154.0,82,5.76,70,398,2426,9.7
3430,Bret Hedican,2010-11,40.0,19,17,66,66,2,15,17,80.0,1273.0,988,54,234,288,1234.0,82,5.44,62,351,2383,9.4
3431,Bret Hedican,2011-12,41.0,20,6,51,51,1,5,6,40.0,832.0,1039,55,239,294,1274.0,82,5.7,65,341,2477,9.4
3432,Brett Bellemore,2015-16,27.0,4,2,8,8,0,2,2,3.0,110.0,8,0,2,2,3.0,48,5.31,29,160,1399,9.1
3433,Brett Bellemore,2016-17,28.0,5,8,64,64,2,6,8,54.0,1118.0,72,2,8,10,57.0,82,5.34,48,269,2463,8.9
3434,Brett Bellemore,2017-18,29.0,6,10,49,49,2,8,10,26.0,802.0,121,4,16,20,83.0,82,5.32,47,251,2453,8.9
3435,Brett Bulmer,2014-15,22.0,4,3,9,9,0,3,3,7.0,99.0,9,0,3,3,7.0,82,5.32,47,271,2439,8.9
3436,Brett Bulmer,2016-17,24.0,5,0,5,5,0,0,0,7.0,53.0,14,0,3,3,14.0,82,5.34,48,269,2463,8.9
3437,Brett Bulmer,2018-19,26.0,6,0,3,3,0,0,0,2.0,20.0,17,0,3,3,16.0,82,5.34,48,255,2438,9.0
3438,Brett Callighen,1982-83,29.0,4,58,59,59,23,35,58,159.0,,59,23,35,58,159.0,80,7.03,61,280,2352,12.0
3439,Brett Callighen,1983-84,30.0,5,60,55,55,25,35,60,127.0,,114,48,70,118,286.0,80,7.69,77,340,2441,12.6
3440,Brett Callighen,1984-85,31.0,6,27,46,46,8,19,27,87.0,,160,56,89,145,373.0,80,8.03,73,320,2489,12.9
3441,Brett Carson,2011-12,26.0,4,0,5,5,0,0,0,2.0,79.0,5,0,0,0,2.0,82,5.7,65,341,2477,9.4
3442,Brett Carson,2012-13,27.0,5,12,54,54,2,10,12,42.0,938.0,59,2,10,12,44.0,82,5.53,56,304,2486,9.1
3443,Brett Carson,2013-14,28.0,6,0,19,19,0,0,0,12.0,217.0,78,2,10,12,56.0,82,5.46,52,291,2492,9.0
3444,Brett Carson,2014-15,29.0,7,0,2,2,0,0,0,1.0,23.0,80,2,10,12,57.0,82,5.32,47,271,2439,8.9
3445,Brett Carson,2015-16,30.0,8,1,10,10,0,1,1,8.0,109.0,90,2,11,13,65.0,48,5.31,29,160,1399,9.1
3446,Brett Clark,2000-01,24.0,4,1,41,41,1,0,1,26.0,,41,1,0,1,26.0,82,5.28,57,380,2242,9.6
3447,Brett Clark,2001-02,25.0,5,4,61,61,2,2,4,36.0,804.0,102,3,2,5,62.0,82,5.27,57,359,2285,9.4
3448,Brett Clark,2002-03,26.0,6,1,14,14,0,1,1,13.0,236.0,116,3,3,6,75.0,82,5.49,53,331,2294,9.8
3449,Brett Clark,2003-04,27.0,7,3,28,28,1,2,3,35.0,505.0,144,4,5,9,110.0,82,5.51,63,376,2272,9.9
3450,Brett Clark,2004-05,28.0,8,0,2,2,0,0,0,0.0,31.0,146,4,5,9,110.0,82,5.24,53,338,2262,9.5
3451,Brett Clark,2006-07,30.0,9,2,12,12,1,1,2,14.0,125.0,158,5,6,11,124.0,82,5.14,57,348,2300,9.2
3452,Brett Clark,2008-09,32.0,10,36,80,80,9,27,36,148.0,1572.0,238,14,33,47,272.0,82,6.05,85,480,2458,10.1
3453,Brett Clark,2009-10,33.0,11,39,82,82,10,29,39,140.0,1942.0,320,24,62,86,412.0,82,5.76,70,398,2426,9.7
3454,Brett Clark,2010-11,34.0,12,21,57,57,5,16,21,87.0,1320.0,377,29,78,107,499.0,82,5.44,62,351,2383,9.4
3455,Brett Clark,2011-12,35.0,13,12,76,76,2,10,12,97.0,1697.0,453,31,88,119,596.0,82,5.7,65,341,2477,9.4
3456,Brett Clark,2012-13,36.0,14,20,64,64,3,17,20,75.0,1225.0,517,34,105,139,671.0,82,5.53,56,304,2486,9.1
3457,Brett Clark,2013-14,37.0,15,31,82,82,9,22,31,87.0,1548.0,599,43,127,170,758.0,82,5.46,52,291,2492,9.0
3458,Brett Clark,2014-15,38.0,16,15,82,82,2,13,15,61.0,1507.0,681,45,140,185,819.0,82,5.32,47,271,2439,8.9
3459,Brett Clark,2015-16,39.0,17,1,8,8,0,1,1,6.0,113.0,689,45,141,186,825.0,48,5.31,29,160,1399,9.1
3460,Brett Connolly,2014-15,22.0,4,15,68,68,4,11,15,94.0,780.0,68,4,11,15,94.0,82,5.32,47,271,2439,8.9
3461,Brett Connolly,2015-16,23.0,5,1,5,5,1,0,1,10.0,51.0,73,5,11,16,104.0,48,5.31,29,160,1399,9.1
3462,Brett Connolly,2016-17,24.0,6,1,11,11,1,0,1,12.0,132.0,84,6,11,17,116.0,82,5.34,48,269,2463,8.9
3463,Brett Connolly,2017-18,25.0,7,17,55,55,12,5,17,83.0,668.0,139,18,16,34,199.0,82,5.32,47,251,2453,8.9
3464,Brett Connolly,2018-19,26.0,8,25,71,71,9,16,25,95.0,920.0,210,27,32,59,294.0,82,5.34,48,255,2438,9.0
3465,Brett Connolly,2019-20,27.0,9,23,66,66,15,8,23,81.0,706.0,276,42,40,82,375.0,82,5.45,47,245,2478,9.0
3466,Brett Connolly,2020-21,28.0,10,27,70,70,15,12,27,67.0,840.0,346,57,52,109,442.0,82,5.86,50,250,2620,9.2
3467,Brett Connolly,2021-22,29.0,11,46,81,81,22,24,46,139.0,1080.0,427,79,76,155,581.0,82,5.96,47,239,2579,9.5
3468,Brett Connolly,2022-23,30.0,12,33,69,69,19,14,33,117.0,1000.0,496,98,90,188,698.0,70,5.96,42,208,2192,9.5
3469,Brett Festerling,2011-12,25.0,4,5,40,40,0,5,5,15.0,667.0,40,0,5,5,15.0,82,5.7,65,341,2477,9.4
3470,Brett Festerling,2012-13,26.0,5,3,42,42,0,3,3,25.0,525.0,82,0,8,8,40.0,82,5.53,56,304,2486,9.1
3471,Brett Festerling,2013-14,27.0,6,0,1,1,0,0,0,0.0,15.0,83,0,8,8,40.0,82,5.46,52,291,2492,9.0
3472,Brett Festerling,2014-15,28.0,7,0,5,5,0,0,0,2.0,66.0,88,0,8,8,42.0,82,5.32,47,271,2439,8.9
3473,Brett Gallant,2016-17,28.0,4,0,4,4,0,0,0,3.0,28.0,4,0,0,0,3.0,82,5.34,48,269,2463,8.9
3474,Brett Harkins,1997-98,27.0,4,1,1,1,0,1,1,1.0,,1,0,1,1,1.0,48,5.97,37,209,1408,10.2
3475,Brett Harkins,1998-99,28.0,5,3,8,8,0,3,3,4.0,,9,0,4,4,5.0,82,6.29,74,413,2481,10.4
3476,Brett Harkins,1999-00,29.0,6,18,44,44,4,14,18,52.0,,53,4,18,22,57.0,82,5.83,55,336,2444,9.8
3477,Brett Harkins,2004-05,34.0,7,14,25,25,2,12,14,9.0,316.0,78,6,30,36,66.0,82,5.24,53,338,2262,9.5
3478,Brett Hauer,1998-99,27.0,4,6,29,29,4,2,6,53.0,,29,4,2,6,53.0,82,6.29,74,413,2481,10.4
3479,Brett Hauer,2002-03,31.0,5,2,5,5,0,2,2,8.0,74.0,34,4,4,8,61.0,82,5.49,53,331,2294,9.8
3480,Brett Hauer,2004-05,33.0,6,0,3,3,0,0,0,2.0,31.0,37,4,4,8,63.0,82,5.24,53,338,2262,9.5
3481,Brett Howden,2021-22,23.0,4,23,66,66,6,17,23,74.0,986.0,66,6,17,23,74.0,82,5.96,47,239,2579,9.5
3482,Brett Howden,2022-23,24.0,5,19,70,70,9,10,19,64.0,920.0,136,15,27,42,138.0,70,5.96,42,208,2192,9.5
3483,Brett Hull,1989-90,25.0,4,1,5,5,1,0,1,5.0,,5,1,0,1,5.0,80,7.34,72,344,2400,12.2
3484,Brett Hull,1990-91,26.0,5,64,65,65,32,32,64,211.0,,70,33,32,65,216.0,80,7.43,89,437,2435,12.2
3485,Brett Hull,1991-92,27.0,6,84,78,78,41,43,84,305.0,,148,74,75,149,521.0,80,7.48,85,403,2430,12.3
3486,Brett Hull,1992-93,28.0,7,113,80,80,72,41,113,385.0,,228,146,116,262,906.0,80,7.37,76,367,2421,12.2
3487,Brett Hull,1993-94,29.0,8,131,78,78,86,45,131,389.0,,306,232,161,393,1295.0,80,6.91,71,366,2385,11.6
3488,Brett Hull,1994-95,30.0,9,109,73,73,70,39,109,408.0,,379,302,200,502,1703.0,80,6.96,77,402,2440,11.4
3489,Brett Hull,1995-96,31.0,10,101,80,80,54,47,101,390.0,,459,356,247,603,2093.0,84,7.25,87,443,2603,11.7
3490,Brett Hull,1996-97,32.0,11,97,81,81,57,40,97,392.0,,540,413,287,700,2485.0,84,6.48,76,407,2545,10.7
3491,Brett Hull,1997-98,33.0,12,50,48,48,29,21,50,200.0,,588,442,308,750,2685.0,48,5.97,37,209,1408,10.2
3492,Brett Hull,1998-99,34.0,13,83,70,70,43,40,83,327.0,,658,485,348,833,3012.0,82,6.29,74,413,2481,10.4
3493,Brett Hull,1999-00,35.0,14,82,77,77,42,40,82,302.0,,735,527,388,915,3314.0,82,5.83,55,336,2444,9.8
3494,Brett Hull,2000-01,36.0,15,72,66,66,27,45,72,211.0,,801,554,433,987,3525.0,82,5.28,57,380,2242,9.6
3495,Brett Hull,2001-02,37.0,16,58,60,60,32,26,58,192.0,1044.0,861,586,459,1045,3717.0,82,5.27,57,359,2285,9.4
3496,Brett Hull,2002-03,38.0,17,59,79,79,24,35,59,223.0,1470.0,940,610,494,1104,3940.0,82,5.49,53,331,2294,9.8
3497,Brett Hull,2003-04,39.0,18,79,79,79,39,40,79,219.0,1413.0,1019,649,534,1183,4159.0,82,5.51,63,376,2272,9.9
3498,Brett Hull,2004-05,40.0,19,63,82,82,30,33,63,247.0,1543.0,1101,679,567,1246,4406.0,82,5.24,53,338,2262,9.5
3499,Brett Hull,2005-06,41.0,20,76,82,82,37,39,76,262.0,1486.0,1183,716,606,1322,4668.0,82,5.31,60,363,2326,9.4
3500,Brett Hull,2006-07,42.0,21,68,81,81,25,43,68,200.0,1369.0,1264,741,649,1390,4868.0,82,5.14,57,348,2300,9.2
3501,Brett Hull,2008-09,44.0,22,1,5,5,0,1,1,8.0,69.0,1269,741,650,1391,4876.0,82,6.05,85,480,2458,10.1
3502,Brett Kulak,2017-18,24.0,4,0,1,1,0,0,0,0.0,20.0,1,0,0,0,0.0,82,5.32,47,251,2453,8.9
3503,Brett Kulak,2018-19,25.0,5,0,8,8,0,0,0,9.0,99.0,9,0,0,0,9.0,82,5.34,48,255,2438,9.0
3504,Brett Kulak,2019-20,26.0,6,3,21,21,0,3,3,19.0,299.0,30,0,3,3,28.0,82,5.45,47,245,2478,9.0
3505,Brett Kulak,2020-21,27.0,7,8,71,71,2,6,8,73.0,922.0,101,2,9,11,101.0,82,5.86,50,250,2620,9.2
3506,Brett Kulak,2021-22,28.0,8,17,57,57,6,11,17,102.0,1017.0,158,8,20,28,203.0,82,5.96,47,239,2579,9.5
3507,Brett Kulak,2022-23,29.0,9,7,56,56,0,7,7,101.0,960.0,214,8,27,35,304.0,70,5.96,42,208,2192,9.5
3508,Brett Lebda,2008-09,27.0,4,12,46,46,3,9,12,50.0,581.0,46,3,9,12,50.0,82,6.05,85,480,2458,10.1
3509,Brett Lebda,2009-10,28.0,5,18,74,74,5,13,18,107.0,1103.0,120,8,22,30,157.0,82,5.76,70,398,2426,9.7
3510,Brett Lebda,2010-11,29.0,6,14,78,78,3,11,14,110.0,1285.0,198,11,33,44,267.0,82,5.44,62,351,2383,9.4
3511,Brett Lebda,2011-12,30.0,7,16,65,65,6,10,16,69.0,887.0,263,17,43,60,336.0,82,5.7,65,341,2477,9.4
3512,Brett Lebda,2012-13,31.0,8,8,63,63,1,7,8,61.0,944.0,326,18,50,68,397.0,82,5.53,56,304,2486,9.1
3513,Brett Lebda,2013-14,32.0,9,4,41,41,1,3,4,34.0,547.0,367,19,53,72,431.0,82,5.46,52,291,2492,9.0
3514,Brett Lebda,2014-15,33.0,10,4,30,30,1,3,4,36.0,494.0,397,20,56,76,467.0,82,5.32,47,271,2439,8.9
3515,Brett Lernout,2018-19,23.0,4,0,1,1,0,0,0,0.0,7.0,1,0,0,0,0.0,82,5.34,48,255,2438,9.0
3516,Brett Lernout,2019-20,24.0,5,0,2,2,0,0,0,3.0,38.0,3,0,0,0,3.0,82,5.45,47,245,2478,9.0
3517,Brett Lernout,2020-21,25.0,6,1,18,18,0,1,1,14.0,301.0,21,0,1,1,17.0,82,5.86,50,250,2620,9.2
3518,Brett Lindros,1997-98,22.0,4,4,33,33,1,3,4,35.0,,33,1,3,4,35.0,48,5.97,37,209,1408,10.2
3519,Brett Lindros,1998-99,23.0,5,3,18,18,1,2,3,10.0,,51,2,5,7,45.0,82,6.29,74,413,2481,10.4
3520,Brett Lysak,2006-07,26.0,4,0,2,2,0,0,0,0.0,7.0,2,0,0,0,0.0,82,5.14,57,348,2300,9.2
3521,Brett MacDonald,1990-91,25.0,4,0,1,1,0,0,0,0.0,,1,0,0,0,0.0,80,7.43,89,437,2435,12.2
3522,Brett Maclean,2013-14,25.0,4,3,13,13,2,1,3,16.0,114.0,13,2,1,3,16.0,82,5.46,52,291,2492,9.0
3523,Brett Maclean,2014-15,26.0,5,2,5,5,0,2,2,6.0,42.0,18,2,3,5,22.0,82,5.32,47,271,2439,8.9
3524,Brett McLean,2005-06,27.0,4,0,2,2,0,0,0,1.0,22.0,2,0,0,0,1.0,82,5.31,60,363,2326,9.4
3525,Brett McLean,2006-07,28.0,5,31,76,76,11,20,31,125.0,1334.0,78,11,20,31,126.0,82,5.14,57,348,2300,9.2
3526,Brett McLean,2008-09,30.0,6,40,82,82,9,31,40,115.0,1001.0,160,20,51,71,241.0,82,6.05,85,480,2458,10.1
3527,Brett McLean,2009-10,31.0,7,35,78,78,15,20,35,134.0,1063.0,238,35,71,106,375.0,82,5.76,70,398,2426,9.7
3528,Brett McLean,2010-11,32.0,8,37,67,67,14,23,37,140.0,1088.0,305,49,94,143,515.0,82,5.44,62,351,2383,9.4
3529,Brett McLean,2011-12,33.0,9,19,80,80,7,12,19,114.0,994.0,385,56,106,162,629.0,82,5.7,65,341,2477,9.4
3530,Brett Pesce,2018-19,24.0,4,16,69,69,4,12,16,85.0,1295.0,69,4,12,16,85.0,82,5.34,48,255,2438,9.0
3531,Brett Pesce,2019-20,25.0,5,20,82,82,2,18,20,109.0,1739.0,151,6,30,36,194.0,82,5.45,47,245,2478,9.0
3532,Brett Pesce,2020-21,26.0,6,19,65,65,3,16,19,88.0,1359.0,216,9,46,55,282.0,82,5.86,50,250,2620,9.2
3533,Brett Pesce,2021-22,27.0,7,29,73,73,7,22,29,98.0,1496.0,289,16,68,84,380.0,82,5.96,47,239,2579,9.5
3534,Brett Pesce,2022-23,28.0,8,18,61,61,4,14,18,104.0,1335.0,350,20,82,102,484.0,70,5.96,42,208,2192,9.5
3535,Brett Ritchie,2017-18,24.0,4,9,31,31,6,3,9,78.0,434.0,31,6,3,9,78.0,82,5.32,47,251,2453,8.9
3536,Brett Ritchie,2018-19,25.0,5,1,8,8,0,1,1,15.0,93.0,39,6,4,10,93.0,82,5.34,48,255,2438,9.0
3537,Brett Ritchie,2019-20,26.0,6,24,78,78,16,8,24,167.0,1006.0,117,22,12,34,260.0,82,5.45,47,245,2478,9.0
3538,Brett Ritchie,2020-21,27.0,7,14,71,71,7,7,14,117.0,770.0,188,29,19,48,377.0,82,5.86,50,250,2620,9.2
3539,Brett Ritchie,2021-22,28.0,8,6,53,53,4,2,6,57.0,509.0,241,33,21,54,434.0,82,5.96,47,239,2579,9.5
3540,Brett Ritchie,2022-23,29.0,9,6,27,27,2,4,6,34.0,281.0,268,35,25,60,468.0,70,5.96,42,208,2192,9.5
3541,Brett Seney,2021-22,25.0,4,13,51,51,5,8,13,49.0,527.0,51,5,8,13,49.0,82,5.96,47,239,2579,9.5
3542,Brett Seney,2022-23,26.0,5,0,2,2,0,0,0,1.0,20.0,53,5,8,13,50.0,70,5.96,42,208,2192,9.5
3543,Brett Skinner,2011-12,28.0,4,0,11,11,0,0,0,5.0,129.0,11,0,0,0,5.0,82,5.7,65,341,2477,9.4
3544,Brett Sterling,2010-11,26.0,4,3,13,13,1,2,3,14.0,161.0,13,1,2,3,14.0,82,5.44,62,351,2383,9.4
3545,Brett Sterling,2011-12,27.0,5,1,6,6,1,0,1,11.0,83.0,19,2,2,4,25.0,82,5.7,65,341,2477,9.4
3546,Brett Sterling,2013-14,29.0,6,5,7,7,3,2,5,14.0,106.0,26,5,4,9,39.0,82,5.46,52,291,2492,9.0
3547,Brett Sterling,2014-15,30.0,7,0,4,4,0,0,0,5.0,30.0,30,5,4,9,44.0,82,5.32,47,271,2439,8.9
3548,Brett Sutter,2011-12,24.0,4,1,4,4,1,0,1,6.0,32.0,4,1,0,1,6.0,82,5.7,65,341,2477,9.4
3549,Brett Sutter,2012-13,25.0,5,0,10,10,0,0,0,9.0,97.0,14,1,0,1,15.0,82,5.53,56,304,2486,9.1
3550,Brett Sutter,2013-14,26.0,6,1,5,5,0,1,1,3.0,45.0,19,1,1,2,18.0,82,5.46,52,291,2492,9.0
3551,Brett Sutter,2014-15,27.0,7,3,15,15,0,3,3,11.0,114.0,34,1,4,5,29.0,82,5.32,47,271,2439,8.9
3552,Brett Sutter,2015-16,28.0,8,0,3,3,0,0,0,2.0,25.0,37,1,4,5,31.0,48,5.31,29,160,1399,9.1
3553,Brett Sutter,2016-17,29.0,9,2,17,17,1,1,2,16.0,129.0,54,2,5,7,47.0,82,5.34,48,269,2463,8.9
3554,Brett Sutter,2017-18,30.0,10,3,6,6,0,3,3,6.0,56.0,60,2,8,10,53.0,82,5.32,47,251,2453,8.9
3555,Brian Bellows,1985-86,21.0,4,65,78,78,35,30,65,184.0,,78,35,30,65,184.0,80,7.73,71,310,2444,12.7
3556,Brian Bellows,1986-87,22.0,5,83,78,78,41,42,83,236.0,,156,76,72,148,420.0,80,7.89,74,336,2448,12.9
3557,Brian Bellows,1987-88,23.0,6,62,78,78,26,36,62,210.0,,234,102,108,210,630.0,80,7.77,71,321,2447,12.7
3558,Brian Bellows,1988-89,24.0,7,79,77,77,31,48,79,256.0,,311,133,156,289,886.0,80,7.94,82,370,2484,12.8
3559,Brian Bellows,1989-90,25.0,8,53,65,65,26,27,53,200.0,,376,159,183,342,1086.0,80,7.34,72,344,2400,12.2
3560,Brian Bellows,1990-91,26.0,9,81,77,77,40,41,81,283.0,,453,199,224,423,1369.0,80,7.43,89,437,2435,12.2
3561,Brian Bellows,1991-92,27.0,10,50,60,60,23,27,50,196.0,,513,222,251,473,1565.0,80,7.48,85,403,2430,12.3
3562,Brian Bellows,1992-93,28.0,11,99,80,80,55,44,99,300.0,,593,277,295,572,1865.0,80,7.37,76,367,2421,12.2
3563,Brian Bellows,1993-94,29.0,12,75,80,80,35,40,75,296.0,,673,312,335,647,2161.0,80,6.91,71,366,2385,11.6
3564,Brian Bellows,1994-95,30.0,13,75,80,80,30,45,75,255.0,,753,342,380,722,2416.0,80,6.96,77,402,2440,11.4
3565,Brian Bellows,1995-96,31.0,14,88,82,82,40,48,88,260.0,,835,382,428,810,2676.0,84,7.25,87,443,2603,11.7
3566,Brian Bellows,1996-97,32.0,15,71,77,77,33,38,71,251.0,,912,415,466,881,2927.0,84,6.48,76,407,2545,10.7
3567,Brian Bellows,1997-98,33.0,16,16,41,41,8,8,16,110.0,,953,423,474,897,3037.0,48,5.97,37,209,1408,10.2
3568,Brian Bellows,1998-99,34.0,17,49,79,79,23,26,49,190.0,,1032,446,500,946,3227.0,82,6.29,74,413,2481,10.4
3569,Brian Bellows,1999-00,35.0,18,31,69,69,16,15,31,168.0,,1101,462,515,977,3395.0,82,5.83,55,336,2444,9.8
3570,Brian Bellows,2000-01,36.0,19,9,11,11,6,3,9,26.0,,1112,468,518,986,3421.0,82,5.28,57,380,2242,9.6
3571,Brian Bellows,2001-02,37.0,20,36,76,76,17,19,36,166.0,1158.0,1188,485,537,1022,3587.0,82,5.27,57,359,2285,9.4
3572,Brian Benning,1987-88,21.0,4,2,4,4,0,2,2,2.0,,4,0,2,2,2.0,80,7.77,71,321,2447,12.7
3573,Brian Benning,1989-90,23.0,5,49,78,78,13,36,49,144.0,,82,13,38,51,146.0,80,7.34,72,344,2400,12.2
3574,Brian Benning,1990-91,24.0,6,37,77,77,8,29,37,130.0,,159,21,67,88,276.0,80,7.43,89,437,2435,12.2
3575,Brian Benning,1991-92,25.0,7,34,66,66,8,26,34,91.0,,225,29,93,122,367.0,80,7.48,85,403,2430,12.3
3576,Brian Benning,1992-93,26.0,8,25,55,55,6,19,25,122.0,,280,35,112,147,489.0,80,7.37,76,367,2421,12.2
3577,Brian Benning,1993-94,27.0,9,31,61,61,7,24,31,120.0,,341,42,136,178,609.0,80,6.91,71,366,2385,11.6
3578,Brian Benning,1994-95,28.0,10,46,75,75,4,42,46,152.0,,416,46,178,224,761.0,80,6.96,77,402,2440,11.4
3579,Brian Benning,1995-96,29.0,11,34,55,55,10,24,34,115.0,,471,56,202,258,876.0,84,7.25,87,443,2603,11.7
3580,Brian Benning,1996-97,30.0,12,30,73,73,6,24,30,112.0,,544,62,226,288,988.0,84,6.48,76,407,2545,10.7
3581,Brian Benning,1997-98,31.0,13,8,24,24,1,7,8,26.0,,568,63,233,296,1014.0,48,5.97,37,209,1408,10.2
3582,Brian Bonin,2001-02,28.0,4,0,5,5,0,0,0,2.0,62.0,5,0,0,0,2.0,82,5.27,57,359,2285,9.4
3583,Brian Bonin,2003-04,30.0,5,0,7,7,0,0,0,7.0,68.0,12,0,0,0,9.0,82,5.51,63,376,2272,9.9
3584,Brian Boyle,2010-11,26.0,4,5,8,8,4,1,5,19.0,109.0,8,4,1,5,19.0,82,5.44,62,351,2383,9.4
3585,Brian Boyle,2011-12,27.0,5,5,28,28,4,1,5,36.0,284.0,36,8,2,10,55.0,82,5.7,65,341,2477,9.4
3586,Brian Boyle,2012-13,28.0,6,6,71,71,4,2,6,73.0,598.0,107,12,4,16,128.0,82,5.53,56,304,2486,9.1
3587,Brian Boyle,2013-14,29.0,7,35,82,82,21,14,35,218.0,1291.0,189,33,18,51,346.0,82,5.46,52,291,2492,9.0
3588,Brian Boyle,2014-15,30.0,8,26,82,82,11,15,26,165.0,1250.0,271,44,33,77,511.0,82,5.32,47,271,2439,8.9
3589,Brian Boyle,2015-16,31.0,9,5,38,38,2,3,5,56.0,540.0,309,46,36,82,567.0,48,5.31,29,160,1399,9.1
3590,Brian Boyle,2016-17,32.0,10,18,82,82,6,12,18,137.0,1047.0,391,52,48,100,704.0,82,5.34,48,269,2463,8.9
3591,Brian Boyle,2017-18,33.0,11,24,82,82,15,9,24,140.0,1065.0,473,67,57,124,844.0,82,5.32,47,251,2453,8.9
3592,Brian Boyle,2018-19,34.0,12,20,76,76,13,7,20,117.0,981.0,549,80,64,144,961.0,82,5.34,48,255,2438,9.0
3593,Brian Boyle,2019-20,35.0,13,25,75,75,13,12,25,131.0,977.0,624,93,76,169,1092.0,82,5.45,47,245,2478,9.0
3594,Brian Boyle,2020-21,36.0,14,23,69,69,13,10,23,120.0,917.0,693,106,86,192,1212.0,82,5.86,50,250,2620,9.2
3595,Brian Boyle,2021-22,37.0,15,24,73,73,18,6,24,123.0,981.0,766,124,92,216,1335.0,82,5.96,47,239,2579,9.5
3596,Brian Boyle,2022-23,38.0,16,15,39,39,6,9,15,56.0,483.0,805,130,101,231,1391.0,70,5.96,42,208,2192,9.5
3597,Brian Bradley,1988-89,24.0,4,1,5,5,0,1,1,4.0,,5,0,1,1,4.0,80,7.94,82,370,2484,12.8
3598,Brian Bradley,1989-90,25.0,5,28,40,40,10,18,28,64.0,,45,10,19,29,68.0,80,7.34,72,344,2400,12.2
3599,Brian Bradley,1990-91,26.0,6,8,11,11,3,5,8,26.0,,56,13,24,37,94.0,80,7.43,89,437,2435,12.2
3600,Brian Bradley,1991-92,27.0,7,45,71,71,18,27,45,151.0,,127,31,51,82,245.0,80,7.48,85,403,2430,12.3
3601,Brian Bradley,1992-93,28.0,8,48,67,67,19,29,48,121.0,,194,50,80,130,366.0,80,7.37,76,367,2421,12.2
3602,Brian Bradley,1993-94,29.0,9,42,70,70,11,31,42,116.0,,264,61,111,172,482.0,80,6.91,71,366,2385,11.6
3603,Brian Bradley,1994-95,30.0,10,31,59,59,10,21,31,78.0,,323,71,132,203,560.0,80,6.96,77,402,2440,11.4
3604,Brian Bradley,1995-96,31.0,11,86,80,80,42,44,86,205.0,,403,113,176,289,765.0,84,7.25,87,443,2603,11.7
3605,Brian Bradley,1996-97,32.0,12,64,78,78,24,40,64,180.0,,481,137,216,353,945.0,84,6.48,76,407,2545,10.7
3606,Brian Bradley,1997-98,33.0,13,40,46,46,13,27,40,111.0,,527,150,243,393,1056.0,48,5.97,37,209,1408,10.2
3607,Brian Bradley,1998-99,34.0,14,79,75,75,23,56,79,189.0,,602,173,299,472,1245.0,82,6.29,74,413,2481,10.4
3608,Brian Bradley,1999-00,35.0,15,24,35,35,7,17,24,93.0,,637,180,316,496,1338.0,82,5.83,55,336,2444,9.8
3609,Brian Bradley,2000-01,36.0,16,7,14,14,2,5,7,24.0,,651,182,321,503,1362.0,82,5.28,57,380,2242,9.6
3610,Brian Campbell,2002-03,23.0,4,5,12,12,1,4,5,10.0,190.0,12,1,4,5,10.0,82,5.49,53,331,2294,9.8
3611,Brian Campbell,2003-04,24.0,5,0,8,8,0,0,0,7.0,125.0,20,1,4,5,17.0,82,5.51,63,376,2272,9.9
3612,Brian Campbell,2004-05,25.0,6,6,29,29,3,3,6,30.0,444.0,49,4,7,11,47.0,82,5.24,53,338,2262,9.5
3613,Brian Campbell,2005-06,26.0,7,19,65,65,2,17,19,90.0,1213.0,114,6,24,30,137.0,82,5.31,60,363,2326,9.4
3614,Brian Campbell,2006-07,27.0,8,11,53,53,3,8,11,45.0,850.0,167,9,32,41,182.0,82,5.14,57,348,2300,9.2
3615,Brian Campbell,2008-09,29.0,9,44,79,79,12,32,44,105.0,1399.0,246,21,64,85,287.0,82,6.05,85,480,2458,10.1
3616,Brian Campbell,2009-10,30.0,10,48,82,82,6,42,48,92.0,1794.0,328,27,106,133,379.0,82,5.76,70,398,2426,9.7
3617,Brian Campbell,2010-11,31.0,11,62,83,83,8,54,62,142.0,2084.0,411,35,160,195,521.0,82,5.44,62,351,2383,9.4
3618,Brian Campbell,2011-12,32.0,12,52,82,82,7,45,52,108.0,1851.0,493,42,205,247,629.0,82,5.7,65,341,2477,9.4
3619,Brian Campbell,2012-13,33.0,13,38,68,68,7,31,38,131.0,1579.0,561,49,236,285,760.0,82,5.53,56,304,2486,9.1
3620,Brian Campbell,2013-14,34.0,14,27,65,65,5,22,27,84.0,1494.0,626,54,258,312,844.0,82,5.46,52,291,2492,9.0
3621,Brian Campbell,2014-15,35.0,15,53,82,82,4,49,53,131.0,2206.0,708,58,307,365,975.0,82,5.32,47,271,2439,8.9
3622,Brian Campbell,2015-16,36.0,16,27,48,48,8,19,27,70.0,1268.0,756,66,326,392,1045.0,48,5.31,29,160,1399,9.1
3623,Brian Campbell,2016-17,37.0,17,37,82,82,7,30,37,116.0,2211.0,838,73,356,429,1161.0,82,5.34,48,269,2463,8.9
3624,Brian Campbell,2017-18,38.0,18,27,82,82,3,24,27,118.0,1903.0,920,76,380,456,1279.0,82,5.32,47,251,2453,8.9
3625,Brian Campbell,2018-19,39.0,19,31,82,82,6,25,31,99.0,1827.0,1002,82,405,487,1378.0,82,5.34,48,255,2438,9.0
3626,Brian Campbell,2019-20,40.0,20,17,80,80,5,12,17,74.0,1474.0,1082,87,417,504,1452.0,82,5.45,47,245,2478,9.0
3627,Brian Chapman,1993-94,25.0,4,0,3,3,0,0,0,0.0,,3,0,0,0,0.0,80,6.91,71,366,2385,11.6
3628,Brian Curran,1986-87,23.0,4,2,16,16,1,1,2,6.0,,16,1,1,2,6.0,80,7.89,74,336,2448,12.9
3629,Brian Curran,1987-88,24.0,5,1,56,56,0,1,1,17.0,,72,1,2,3,23.0,80,7.77,71,321,2447,12.7
3630,Brian Curran,1988-89,25.0,6,7,43,43,2,5,7,23.0,,115,3,7,10,46.0,80,7.94,82,370,2484,12.8
3631,Brian Curran,1989-90,26.0,7,10,68,68,0,10,10,34.0,,183,3,17,20,80.0,80,7.34,72,344,2400,12.2
3632,Brian Curran,1990-91,27.0,8,2,29,29,0,2,2,13.0,,212,3,19,22,93.0,80,7.43,89,437,2435,12.2
3633,Brian Curran,1991-92,28.0,9,5,47,47,1,4,5,18.0,,259,4,23,27,111.0,80,7.48,85,403,2430,12.3
3634,Brian Curran,1992-93,29.0,10,11,72,72,2,9,11,21.0,,331,6,32,38,132.0,80,7.37,76,367,2421,12.2
3635,Brian Curran,1993-94,30.0,11,1,21,21,0,1,1,7.0,,352,6,33,39,139.0,80,6.91,71,366,2385,11.6
3636,Brian Curran,1994-95,31.0,12,0,3,3,0,0,0,1.0,,355,6,33,39,140.0,80,6.96,77,402,2440,11.4
3637,Brian Curran,1996-97,33.0,13,1,26,26,1,0,1,11.0,,381,7,33,40,151.0,84,6.48,76,407,2545,10.7
3638,Brian Dobbin,1989-90,23.0,4,3,12,12,2,1,3,13.0,,12,2,1,3,13.0,80,7.34,72,344,2400,12.2
3639,Brian Dobbin,1990-91,24.0,5,8,21,21,3,5,8,15.0,,33,5,6,11,28.0,80,7.43,89,437,2435,12.2
3640,Brian Dobbin,1991-92,25.0,6,1,14,14,0,1,1,13.0,,47,5,7,12,41.0,80,7.48,85,403,2430,12.3
3641,Brian Dobbin,1992-93,26.0,7,2,9,9,1,1,2,11.0,,56,6,8,14,52.0,80,7.37,76,367,2421,12.2
3642,Brian Dobbin,1994-95,28.0,8,1,7,7,1,0,1,4.0,,63,7,8,15,56.0,80,6.96,77,402,2440,11.4
3643,Brian Dumoulin,2016-17,25.0,4,1,6,6,0,1,1,3.0,115.0,6,0,1,1,3.0,82,5.34,48,269,2463,8.9
3644,Brian Dumoulin,2017-18,26.0,5,1,8,8,1,0,1,4.0,125.0,14,1,1,2,7.0,82,5.32,47,251,2453,8.9
3645,Brian Dumoulin,2018-19,27.0,6,16,79,79,0,16,16,101.0,1492.0,93,1,17,18,108.0,82,5.34,48,255,2438,9.0
3646,Brian Dumoulin,2019-20,28.0,7,15,70,70,1,14,15,78.0,1438.0,163,2,31,33,186.0,82,5.45,47,245,2478,9.0
3647,Brian Dumoulin,2020-21,29.0,8,18,80,80,5,13,18,102.0,1649.0,243,7,44,51,288.0,82,5.86,50,250,2620,9.2
3648,Brian Dumoulin,2021-22,30.0,9,23,76,76,3,20,23,99.0,1598.0,319,10,64,74,387.0,82,5.96,47,239,2579,9.5
3649,Brian Dumoulin,2022-23,31.0,10,8,28,28,1,7,8,35.0,590.0,347,11,71,82,422.0,70,5.96,42,208,2192,9.5
3650,Brian Fahey,2013-14,32.0,4,1,7,7,0,1,1,4.0,83.0,7,0,1,1,4.0,82,5.46,52,291,2492,9.0
3651,Brian Felsner,2000-01,28.0,4,4,12,12,1,3,4,14.0,,12,1,3,4,14.0,82,5.28,57,380,2242,9.6
3652,Brian Ferlin,2017-18,25.0,4,1,7,7,0,1,1,6.0,62.0,7,0,1,1,6.0,82,5.32,47,251,2453,8.9
3653,Brian Flynn,2015-16,27.0,4,11,26,26,6,5,11,49.0,382.0,26,6,5,11,49.0,48,5.31,29,160,1399,9.1
3654,Brian Flynn,2016-17,28.0,5,13,79,79,6,7,13,102.0,1139.0,105,12,12,24,151.0,82,5.34,48,269,2463,8.9
3655,Brian Flynn,2017-18,29.0,6,17,63,63,5,12,17,82.0,939.0,168,17,24,41,233.0,82,5.32,47,251,2453,8.9
3656,Brian Flynn,2018-19,30.0,7,10,56,56,4,6,10,73.0,657.0,224,21,30,51,306.0,82,5.34,48,255,2438,9.0
3657,Brian Flynn,2019-20,31.0,8,10,51,51,6,4,10,47.0,615.0,275,27,34,61,353.0,82,5.45,47,245,2478,9.0
3658,Brian Gibbons,2016-17,28.0,4,17,41,41,5,12,17,29.0,490.0,41,5,12,17,29.0,82,5.34,48,269,2463,8.9
3659,Brian Gibbons,2017-18,29.0,5,5,25,25,0,5,5,21.0,346.0,66,5,17,22,50.0,82,5.32,47,251,2453,8.9
3660,Brian Gibbons,2020-21,32.0,6,26,59,59,12,14,26,72.0,851.0,125,17,31,48,122.0,82,5.86,50,250,2620,9.2
3661,Brian Gibbons,2021-22,33.0,7,19,64,64,8,11,19,50.0,699.0,189,25,42,67,172.0,82,5.96,47,239,2579,9.5
3662,Brian Gibbons,2022-23,34.0,8,0,15,15,0,0,0,9.0,146.0,204,25,42,67,181.0,70,5.96,42,208,2192,9.5
3663,Brian Gionta,2004-05,26.0,4,11,33,33,4,7,11,58.0,443.0,33,4,7,11,58.0,82,5.24,53,338,2262,9.5
3664,Brian Gionta,2005-06,27.0,5,25,58,58,12,13,25,129.0,858.0,91,16,20,36,187.0,82,5.31,60,363,2326,9.4
3665,Brian Gionta,2006-07,28.0,6,29,75,75,21,8,29,174.0,1105.0,166,37,28,65,361.0,82,5.14,57,348,2300,9.2
3666,Brian Gionta,2008-09,30.0,7,89,82,82,48,41,89,291.0,1625.0,248,85,69,154,652.0,82,6.05,85,480,2458,10.1
3667,Brian Gionta,2009-10,31.0,8,45,62,62,25,20,45,194.0,1167.0,310,110,89,199,846.0,82,5.76,70,398,2426,9.7
3668,Brian Gionta,2010-11,32.0,9,53,82,82,22,31,53,257.0,1498.0,392,132,120,252,1103.0,82,5.44,62,351,2383,9.4
3669,Brian Gionta,2011-12,33.0,10,60,81,81,20,40,60,248.0,1374.0,473,152,160,312,1351.0,82,5.7,65,341,2477,9.4
3670,Brian Gionta,2012-13,34.0,11,46,61,61,28,18,46,237.0,1266.0,534,180,178,358,1588.0,82,5.53,56,304,2486,9.1
3671,Brian Gionta,2013-14,35.0,12,46,82,82,29,17,46,298.0,1609.0,616,209,195,404,1886.0,82,5.46,52,291,2492,9.0
3672,Brian Gionta,2014-15,36.0,13,15,31,31,8,7,15,75.0,602.0,647,217,202,419,1961.0,82,5.32,47,271,2439,8.9
3673,Brian Gionta,2015-16,37.0,14,26,48,48,14,12,26,112.0,870.0,695,231,214,445,2073.0,48,5.31,29,160,1399,9.1
3674,Brian Gionta,2016-17,38.0,15,40,81,81,18,22,40,184.0,1446.0,776,249,236,485,2257.0,82,5.34,48,269,2463,8.9
3675,Brian Gionta,2017-18,39.0,16,35,69,69,13,22,35,153.0,1246.0,845,262,258,520,2410.0,82,5.32,47,251,2453,8.9
3676,Brian Gionta,2018-19,40.0,17,33,79,79,12,21,33,169.0,1401.0,924,274,279,553,2579.0,82,5.34,48,255,2438,9.0
3677,Brian Gionta,2019-20,41.0,18,35,82,82,15,20,35,149.0,1362.0,1006,289,299,588,2728.0,82,5.45,47,245,2478,9.0
3678,Brian Gionta,2020-21,42.0,19,7,20,20,2,5,7,42.0,261.0,1026,291,304,595,2770.0,82,5.86,50,250,2620,9.2
3679,Brian Glynn,1990-91,23.0,4,19,67,67,5,14,19,84.0,,67,5,14,19,84.0,80,7.43,89,437,2435,12.2
3680,Brian Glynn,1991-92,24.0,5,1,9,9,0,1,1,4.0,,76,5,15,20,88.0,80,7.48,85,403,2430,12.3
3681,Brian Glynn,1992-93,25.0,6,0,1,1,0,0,0,0.0,,77,5,15,20,88.0,80,7.37,76,367,2421,12.2
3682,Brian Glynn,1993-94,26.0,7,19,66,66,8,11,19,111.0,,143,13,26,39,199.0,80,6.91,71,366,2385,11.6
3683,Brian Glynn,1994-95,27.0,8,22,62,62,4,18,22,82.0,,205,17,44,61,281.0,80,6.96,77,402,2440,11.4
3684,Brian Glynn,1995-96,28.0,9,16,64,64,4,12,16,80.0,,269,21,56,77,361.0,84,7.25,87,443,2603,11.7
3685,Brian Glynn,1996-97,29.0,10,15,64,64,2,13,15,71.0,,333,23,69,92,432.0,84,6.48,76,407,2545,10.7
3686,Brian Glynn,1997-98,30.0,11,7,43,43,1,6,7,35.0,,376,24,75,99,467.0,48,5.97,37,209,1408,10.2
3687,Brian Glynn,1998-99,31.0,12,4,54,54,0,4,4,46.0,,430,24,79,103,513.0,82,6.29,74,413,2481,10.4
3688,Brian Glynn,1999-00,32.0,13,1,1,1,1,0,1,2.0,,431,25,79,104,515.0,82,5.83,55,336,2444,9.8
3689,Brian Hill,1982-83,26.0,4,2,19,19,1,1,2,17.0,,19,1,1,2,17.0,80,7.03,61,280,2352,12.0
3690,Brian Holzinger,1997-98,25.0,4,3,4,4,0,3,3,3.0,,4,0,3,3,3.0,48,5.97,37,209,1408,10.2
3691,Brian Holzinger,1998-99,26.0,5,20,58,58,10,10,20,71.0,,62,10,13,23,74.0,82,6.29,74,413,2481,10.4
3692,Brian Holzinger,1999-00,27.0,6,51,81,81,22,29,51,142.0,,143,32,42,74,216.0,82,5.83,55,336,2444,9.8
3693,Brian Holzinger,2000-01,28.0,7,35,69,69,14,21,35,116.0,,212,46,63,109,332.0,82,5.28,57,380,2242,9.6
3694,Brian Holzinger,2001-02,29.0,8,34,81,81,17,17,34,143.0,1338.0,293,63,80,143,475.0,82,5.27,57,359,2285,9.4
3695,Brian Holzinger,2002-03,30.0,9,30,73,73,10,20,30,104.0,1090.0,366,73,100,173,579.0,82,5.49,53,331,2294,9.8
3696,Brian Holzinger,2003-04,31.0,10,36,70,70,11,25,36,87.0,1123.0,436,84,125,209,666.0,82,5.51,63,376,2272,9.9
3697,Brian Holzinger,2004-05,32.0,11,3,23,23,1,2,3,20.0,214.0,459,85,127,212,686.0,82,5.24,53,338,2262,9.5
3698,Brian Holzinger,2005-06,33.0,12,4,14,14,1,3,4,23.0,193.0,473,86,130,216,709.0,82,5.31,60,363,2326,9.4
3699,Brian Holzinger,2006-07,34.0,13,22,74,74,7,15,22,96.0,1226.0,547,93,145,238,805.0,82,5.14,57,348,2300,9.2
3700,Brian Johnson,1986-87,26.0,4,0,3,3,0,0,0,4.0,,3,0,0,0,4.0,80,7.89,74,336,2448,12.9
3701,Brian Lashoff,2015-16,25.0,4,5,31,31,1,4,5,26.0,551.0,31,1,4,5,26.0,48,5.31,29,160,1399,9.1
3702,Brian Lashoff,2016-17,26.0,5,6,75,75,1,5,6,38.0,1082.0,106,2,9,11,64.0,82,5.34,48,269,2463,8.9
3703,Brian Lashoff,2017-18,27.0,6,2,11,11,0,2,2,7.0,146.0,117,2,11,13,71.0,82,5.32,47,251,2453,8.9
3704,Brian Lashoff,2019-20,29.0,7,0,5,5,0,0,0,1.0,63.0,122,2,11,13,72.0,82,5.45,47,245,2478,9.0
3705,Brian Lashoff,2020-21,30.0,8,0,1,1,0,0,0,0.0,4.0,123,2,11,13,72.0,82,5.86,50,250,2620,9.2
3706,Brian Lashoff,2021-22,31.0,9,1,4,4,0,1,1,2.0,55.0,127,2,12,14,74.0,82,5.96,47,239,2579,9.5
3707,Brian Lashoff,2022-23,32.0,10,1,9,9,0,1,1,6.0,131.0,136,2,13,15,80.0,70,5.96,42,208,2192,9.5
3708,Brian Lawton,1986-87,21.0,4,31,58,58,10,21,31,74.0,,58,10,21,31,74.0,80,7.89,74,336,2448,12.9
3709,Brian Lawton,1987-88,22.0,5,11,40,40,5,6,11,40.0,,98,15,27,42,114.0,80,7.77,71,321,2447,12.7
3710,Brian Lawton,1988-89,23.0,6,35,65,65,18,17,35,98.0,,163,33,44,77,212.0,80,7.94,82,370,2484,12.8
3711,Brian Lawton,1989-90,24.0,7,44,66,66,21,23,44,125.0,,229,54,67,121,337.0,80,7.34,72,344,2400,12.2
3712,Brian Lawton,1990-91,25.0,8,41,74,74,17,24,41,155.0,,303,71,91,162,492.0,80,7.43,89,437,2435,12.2
3713,Brian Lawton,1991-92,26.0,9,43,65,65,17,26,43,128.0,,368,88,117,205,620.0,80,7.48,85,403,2430,12.3
3714,Brian Lawton,1992-93,27.0,10,14,35,35,7,7,14,52.0,,403,95,124,219,672.0,80,7.37,76,367,2421,12.2
3715,Brian Lawton,1994-95,29.0,11,37,59,59,15,22,37,131.0,,462,110,146,256,803.0,80,6.96,77,402,2440,11.4
3716,Brian Lawton,1995-96,30.0,12,10,21,21,2,8,10,29.0,,483,112,154,266,832.0,84,7.25,87,443,2603,11.7
3717,Brian Lee,2010-11,23.0,4,1,6,6,0,1,1,6.0,101.0,6,0,1,1,6.0,82,5.44,62,351,2383,9.4
3718,Brian Lee,2011-12,24.0,5,13,53,53,2,11,13,51.0,1001.0,59,2,12,14,57.0,82,5.7,65,341,2477,9.4
3719,Brian Lee,2012-13,25.0,6,3,23,23,2,1,3,22.0,358.0,82,4,13,17,79.0,82,5.53,56,304,2486,9.1
3720,Brian Lee,2013-14,26.0,7,3,50,50,0,3,3,35.0,865.0,132,4,16,20,114.0,82,5.46,52,291,2492,9.0
3721,Brian Lee,2014-15,27.0,8,16,55,55,1,15,16,32.0,854.0,187,5,31,36,146.0,82,5.32,47,271,2439,8.9
3722,Brian Lee,2015-16,28.0,9,0,22,22,0,0,0,13.0,306.0,209,5,31,36,159.0,48,5.31,29,160,1399,9.1
3723,Brian Leetch,1990-91,22.0,4,14,17,17,2,12,14,40.0,,17,2,12,14,40.0,80,7.43,89,437,2435,12.2
3724,Brian Leetch,1991-92,23.0,5,71,68,68,23,48,71,268.0,,85,25,60,85,308.0,80,7.48,85,403,2430,12.3
3725,Brian Leetch,1992-93,24.0,6,56,72,72,11,45,56,222.0,,157,36,105,141,530.0,80,7.37,76,367,2421,12.2
3726,Brian Leetch,1993-94,25.0,7,88,80,80,16,72,88,206.0,,237,52,177,229,736.0,80,6.91,71,366,2385,11.6
3727,Brian Leetch,1994-95,26.0,8,102,80,80,22,80,102,245.0,,317,74,257,331,981.0,80,6.96,77,402,2440,11.4
3728,Brian Leetch,1995-96,27.0,9,36,36,36,6,30,36,150.0,,353,80,287,367,1131.0,84,7.25,87,443,2603,11.7
3729,Brian Leetch,1996-97,28.0,10,79,84,84,23,56,79,328.0,,437,103,343,446,1459.0,84,6.48,76,407,2545,10.7
3730,Brian Leetch,1997-98,29.0,11,41,48,48,9,32,41,182.0,,485,112,375,487,1641.0,48,5.97,37,209,1408,10.2
3731,Brian Leetch,1998-99,30.0,12,85,82,82,15,70,85,276.0,,567,127,445,572,1917.0,82,6.29,74,413,2481,10.4
3732,Brian Leetch,1999-00,31.0,13,78,82,82,20,58,78,256.0,,649,147,503,650,2173.0,82,5.83,55,336,2444,9.8
3733,Brian Leetch,2000-01,32.0,14,50,76,76,17,33,50,230.0,,725,164,536,700,2403.0,82,5.28,57,380,2242,9.6
3734,Brian Leetch,2001-02,33.0,15,55,82,82,13,42,55,184.0,2449.0,807,177,578,755,2587.0,82,5.27,57,359,2285,9.4
3735,Brian Leetch,2002-03,34.0,16,26,50,50,7,19,26,124.0,1347.0,857,184,597,781,2711.0,82,5.49,53,331,2294,9.8
3736,Brian Leetch,2003-04,35.0,17,79,82,82,21,58,79,241.0,2407.0,939,205,655,860,2952.0,82,5.51,63,376,2272,9.9
3737,Brian Leetch,2004-05,36.0,18,55,82,82,10,45,55,202.0,2121.0,1021,215,700,915,3154.0,82,5.24,53,338,2262,9.5
3738,Brian Leetch,2005-06,37.0,19,30,51,51,12,18,30,150.0,1331.0,1072,227,718,945,3304.0,82,5.31,60,363,2326,9.4
3739,Brian Leetch,2006-07,38.0,20,51,72,72,15,36,51,206.0,1893.0,1144,242,754,996,3510.0,82,5.14,57,348,2300,9.2
3740,Brian Leetch,2008-09,40.0,21,32,61,61,5,27,32,130.0,1435.0,1205,247,781,1028,3640.0,82,6.05,85,480,2458,10.1
3741,Brian Loney,1998-99,26.0,4,5,12,12,2,3,5,19.0,,12,2,3,5,19.0,82,6.29,74,413,2481,10.4
3742,Brian Lundberg,1985-86,25.0,4,0,1,1,0,0,0,0.0,,1,0,0,0,0.0,80,7.73,71,310,2444,12.7
3743,Brian MacLellan,1985-86,27.0,4,3,8,8,0,3,3,5.0,,8,0,3,3,5.0,80,7.73,71,310,2444,12.7
3744,Brian MacLellan,1986-87,28.0,5,54,72,72,25,29,54,106.0,,80,25,32,57,111.0,80,7.89,74,336,2448,12.9
3745,Brian MacLellan,1987-88,29.0,6,85,80,80,31,54,85,171.0,,160,56,86,142,282.0,80,7.77,71,321,2447,12.7
3746,Brian MacLellan,1988-89,30.0,7,45,78,78,16,29,45,166.0,,238,72,115,187,448.0,80,7.94,82,370,2484,12.8
3747,Brian MacLellan,1989-90,31.0,8,63,76,76,32,31,63,146.0,,314,104,146,250,594.0,80,7.34,72,344,2400,12.2
3748,Brian MacLellan,1990-91,32.0,9,48,75,75,16,32,48,194.0,,389,120,178,298,788.0,80,7.43,89,437,2435,12.2
3749,Brian MacLellan,1991-92,33.0,10,44,72,72,18,26,44,137.0,,461,138,204,342,925.0,80,7.48,85,403,2430,12.3
3750,Brian MacLellan,1992-93,34.0,11,38,65,65,20,18,38,127.0,,526,158,222,380,1052.0,80,7.37,76,367,2421,12.2
3751,Brian MacLellan,1993-94,35.0,12,27,57,57,13,14,27,74.0,,583,171,236,407,1126.0,80,6.91,71,366,2385,11.6
3752,Brian MacLellan,1994-95,36.0,13,6,23,23,1,5,6,17.0,,606,172,241,413,1143.0,80,6.96,77,402,2440,11.4
3753,Brian McGrattan,2008-09,27.0,4,5,60,60,2,3,5,36.0,254.0,60,2,3,5,36.0,82,6.05,85,480,2458,10.1
3754,Brian McGrattan,2009-10,28.0,5,2,45,45,0,2,2,22.0,174.0,105,2,5,7,58.0,82,5.76,70,398,2426,9.7
3755,Brian McGrattan,2010-11,29.0,6,3,38,38,0,3,3,11.0,109.0,143,2,8,10,69.0,82,5.44,62,351,2383,9.4
3756,Brian McGrattan,2011-12,30.0,7,0,5,5,0,0,0,2.0,28.0,148,2,8,10,71.0,82,5.7,65,341,2477,9.4
3757,Brian McGrattan,2012-13,31.0,8,4,34,34,1,3,4,19.0,117.0,182,3,11,14,90.0,82,5.53,56,304,2486,9.1
3758,Brian McGrattan,2014-15,33.0,9,2,30,30,0,2,2,10.0,160.0,212,3,13,16,100.0,82,5.32,47,271,2439,8.9
3759,Brian McGrattan,2015-16,34.0,10,3,21,21,3,0,3,18.0,149.0,233,6,13,19,118.0,48,5.31,29,160,1399,9.1
3760,Brian McGrattan,2016-17,35.0,11,8,76,76,4,4,8,79.0,511.0,309,10,17,27,197.0,82,5.34,48,269,2463,8.9
3761,Brian McGrattan,2017-18,36.0,12,0,8,8,0,0,0,10.0,53.0,317,10,17,27,207.0,82,5.32,47,251,2453,8.9
3762,Brian McReynolds,1992-93,28.0,4,2,9,9,0,2,2,11.0,,9,0,2,2,11.0,80,7.37,76,367,2421,12.2
3763,Brian McReynolds,1993-94,29.0,5,0,1,1,0,0,0,0.0,,10,0,2,2,11.0,80,6.91,71,366,2385,11.6
3764,Brian McReynolds,1996-97,32.0,6,4,20,20,1,3,4,10.0,,30,1,5,6,21.0,84,6.48,76,407,2545,10.7
3765,Brian Mullen,1985-86,23.0,4,50,80,80,24,26,50,194.0,,80,24,26,50,194.0,80,7.73,71,310,2444,12.7
3766,Brian Mullen,1986-87,24.0,5,62,75,75,21,41,62,164.0,,155,45,67,112,358.0,80,7.89,74,336,2448,12.9
3767,Brian Mullen,1987-88,25.0,6,71,69,69,32,39,71,189.0,,224,77,106,183,547.0,80,7.77,71,321,2447,12.7
3768,Brian Mullen,1988-89,26.0,7,62,79,79,28,34,62,211.0,,303,105,140,245,758.0,80,7.94,82,370,2484,12.8
3769,Brian Mullen,1989-90,27.0,8,51,69,69,19,32,51,185.0,,372,124,172,296,943.0,80,7.34,72,344,2400,12.2
3770,Brian Mullen,1990-91,28.0,9,54,74,74,25,29,54,147.0,,446,149,201,350,1090.0,80,7.43,89,437,2435,12.2
3771,Brian Mullen,1991-92,29.0,10,64,78,78,29,35,64,217.0,,524,178,236,414,1307.0,80,7.48,85,403,2430,12.3
3772,Brian Mullen,1992-93,30.0,11,68,76,76,27,41,68,186.0,,600,205,277,482,1493.0,80,7.37,76,367,2421,12.2
3773,Brian Mullen,1993-94,31.0,12,62,79,79,19,43,62,188.0,,679,224,320,544,1681.0,80,6.91,71,366,2385,11.6
3774,Brian Mullen,1994-95,32.0,13,46,72,72,18,28,46,168.0,,751,242,348,590,1849.0,80,6.96,77,402,2440,11.4
3775,Brian Mullen,1995-96,33.0,14,32,81,81,18,14,32,126.0,,832,260,362,622,1975.0,84,7.25,87,443,2603,11.7
3776,Brian Noonan,1990-91,25.0,4,30,77,77,10,20,30,87.0,,77,10,20,30,87.0,80,7.43,89,437,2435,12.2
3777,Brian Noonan,1991-92,26.0,5,16,45,45,4,12,16,84.0,,122,14,32,46,171.0,80,7.48,85,403,2430,12.3
3778,Brian Noonan,1992-93,27.0,6,2,8,8,0,2,2,13.0,,130,14,34,48,184.0,80,7.37,76,367,2421,12.2
3779,Brian Noonan,1993-94,28.0,7,4,7,7,0,4,4,12.0,,137,14,38,52,196.0,80,6.91,71,366,2385,11.6
3780,Brian Noonan,1994-95,29.0,8,31,65,65,19,12,31,154.0,,202,33,50,83,350.0,80,6.96,77,402,2440,11.4
3781,Brian Noonan,1995-96,30.0,9,30,63,63,16,14,30,129.0,,265,49,64,113,479.0,84,7.25,87,443,2603,11.7
3782,Brian Noonan,1996-97,31.0,10,41,76,76,18,23,41,160.0,,341,67,87,154,639.0,84,6.48,76,407,2545,10.7
3783,Brian Noonan,1997-98,32.0,11,27,45,45,14,13,27,95.0,,386,81,100,181,734.0,48,5.97,37,209,1408,10.2
3784,Brian Noonan,1998-99,33.0,12,35,81,81,13,22,35,131.0,,467,94,122,216,865.0,82,6.29,74,413,2481,10.4
3785,Brian Noonan,1999-00,34.0,13,34,73,73,12,22,34,100.0,,540,106,144,250,965.0,82,5.83,55,336,2444,9.8
3786,Brian Noonan,2000-01,35.0,14,25,82,82,10,15,25,87.0,,622,116,159,275,1052.0,82,5.28,57,380,2242,9.6
3787,Brian Noonan,2001-02,36.0,15,0,7,7,0,0,0,1.0,58.0,629,116,159,275,1053.0,82,5.27,57,359,2285,9.4
3788,Brian O'Neill,2018-19,30.0,4,2,22,22,0,2,2,14.0,228.0,22,0,2,2,14.0,82,5.34,48,255,2438,9.0
3789,Brian Pothier,2003-04,26.0,4,0,3,3,0,0,0,0.0,62.0,3,0,0,0,0.0,82,5.51,63,376,2272,9.9
3790,Brian Pothier,2004-05,27.0,5,9,33,33,3,6,9,65.0,716.0,36,3,6,9,65.0,82,5.24,53,338,2262,9.5
3791,Brian Pothier,2005-06,28.0,6,6,14,14,2,4,6,23.0,215.0,50,5,10,15,88.0,82,5.31,60,363,2326,9.4
3792,Brian Pothier,2006-07,29.0,7,8,55,55,2,6,8,78.0,920.0,105,7,16,23,166.0,82,5.14,57,348,2300,9.2
3793,Brian Pothier,2008-09,31.0,8,35,77,77,5,30,35,133.0,1291.0,182,12,46,58,299.0,82,6.05,85,480,2458,10.1
3794,Brian Pothier,2009-10,32.0,9,28,72,72,3,25,28,118.0,1727.0,254,15,71,86,417.0,82,5.76,70,398,2426,9.7
3795,Brian Pothier,2010-11,33.0,10,14,38,38,5,9,14,65.0,710.0,292,20,80,100,482.0,82,5.44,62,351,2383,9.4
3796,Brian Pothier,2011-12,34.0,11,3,9,9,1,2,3,8.0,149.0,301,21,82,103,490.0,82,5.7,65,341,2477,9.4
3797,Brian Pothier,2012-13,35.0,12,15,61,61,5,10,15,81.0,1160.0,362,26,92,118,571.0,82,5.53,56,304,2486,9.1
3798,Brian Propp,1982-83,23.0,4,75,80,80,34,41,75,209.0,,80,34,41,75,209.0,80,7.03,61,280,2352,12.0
3799,Brian Propp,1983-84,24.0,5,66,79,79,26,40,66,194.0,,159,60,81,141,403.0,80,7.69,77,340,2441,12.6
3800,Brian Propp,1984-85,25.0,6,91,80,80,44,47,91,290.0,,239,104,128,232,693.0,80,8.03,73,320,2489,12.9
3801,Brian Propp,1985-86,26.0,7,82,80,80,40,42,82,250.0,,319,144,170,314,943.0,80,7.73,71,310,2444,12.7
3802,Brian Propp,1986-87,27.0,8,92,79,79,39,53,92,301.0,,398,183,223,406,1244.0,80,7.89,74,336,2448,12.9
3803,Brian Propp,1987-88,28.0,9,97,76,76,43,54,97,266.0,,474,226,277,503,1510.0,80,7.77,71,321,2447,12.7
3804,Brian Propp,1988-89,29.0,10,97,72,72,40,57,97,317.0,,546,266,334,600,1827.0,80,7.94,82,370,2484,12.8
3805,Brian Propp,1989-90,30.0,11,67,53,53,31,36,67,208.0,,599,297,370,667,2035.0,80,7.34,72,344,2400,12.2
3806,Brian Propp,1990-91,31.0,12,76,74,74,27,49,76,257.0,,673,324,419,743,2292.0,80,7.43,89,437,2435,12.2
3807,Brian Propp,1991-92,32.0,13,78,77,77,32,46,78,245.0,,750,356,465,821,2537.0,80,7.48,85,403,2430,12.3
3808,Brian Propp,1992-93,33.0,14,40,54,54,16,24,40,153.0,,804,372,489,861,2690.0,80,7.37,76,367,2421,12.2
3809,Brian Propp,1993-94,34.0,15,73,79,79,26,47,73,171.0,,883,398,536,934,2861.0,80,6.91,71,366,2385,11.6
3810,Brian Propp,1994-95,35.0,16,35,51,51,12,23,35,115.0,,934,410,559,969,2976.0,80,6.96,77,402,2440,11.4
3811,Brian Propp,1995-96,36.0,17,6,17,17,3,3,6,35.0,,951,413,562,975,3011.0,84,7.25,87,443,2603,11.7
3812,Brian Propp,1996-97,37.0,18,29,65,65,12,17,29,108.0,,1016,425,579,1004,3119.0,84,6.48,76,407,2545,10.7
3813,Brian Rafalski,2002-03,29.0,4,32,75,75,5,27,32,128.0,1414.0,75,5,27,32,128.0,82,5.49,53,331,2294,9.8
3814,Brian Rafalski,2003-04,30.0,5,52,78,78,9,43,52,142.0,1691.0,153,14,70,84,270.0,82,5.51,63,376,2272,9.9
3815,Brian Rafalski,2004-05,31.0,6,47,76,76,7,40,47,125.0,1682.0,229,21,110,131,395.0,82,5.24,53,338,2262,9.5
3816,Brian Rafalski,2005-06,32.0,7,40,79,79,3,37,40,178.0,1829.0,308,24,147,171,573.0,82,5.31,60,363,2326,9.4
3817,Brian Rafalski,2006-07,33.0,8,36,69,69,6,30,36,130.0,1573.0,377,30,177,207,703.0,82,5.14,57,348,2300,9.2
3818,Brian Rafalski,2008-09,35.0,9,49,82,82,6,43,49,126.0,2093.0,459,36,220,256,829.0,82,6.05,85,480,2458,10.1
3819,Brian Rafalski,2009-10,36.0,10,55,82,82,8,47,55,148.0,2090.0,541,44,267,311,977.0,82,5.76,70,398,2426,9.7
3820,Brian Rafalski,2010-11,37.0,11,55,73,73,13,42,55,175.0,1757.0,614,57,309,366,1152.0,82,5.44,62,351,2383,9.4
3821,Brian Rafalski,2011-12,38.0,12,59,78,78,10,49,59,141.0,1808.0,692,67,358,425,1293.0,82,5.7,65,341,2477,9.4
3822,Brian Rafalski,2012-13,39.0,13,42,78,78,8,34,42,134.0,1890.0,770,75,392,467,1427.0,82,5.53,56,304,2486,9.1
3823,Brian Rafalski,2013-14,40.0,14,48,63,63,4,44,48,106.0,1287.0,833,79,436,515,1533.0,82,5.46,52,291,2492,9.0
3824,Brian Rolston,1997-98,24.0,4,18,40,40,7,11,18,92.0,,40,7,11,18,92.0,48,5.97,37,209,1408,10.2
3825,Brian Rolston,1998-99,25.0,5,24,58,58,13,11,24,139.0,,98,20,22,42,231.0,82,6.29,74,413,2481,10.4
3826,Brian Rolston,1999-00,26.0,6,45,81,81,18,27,45,237.0,,179,38,49,87,468.0,82,5.83,55,336,2444,9.8
3827,Brian Rolston,2000-01,27.0,7,30,76,76,16,14,30,185.0,,255,54,63,117,653.0,82,5.28,57,380,2242,9.6
3828,Brian Rolston,2001-02,28.0,8,57,82,82,24,33,57,210.0,1543.0,337,78,96,174,863.0,82,5.27,57,359,2285,9.4
3829,Brian Rolston,2002-03,29.0,9,31,77,77,16,15,31,206.0,1381.0,414,94,111,205,1069.0,82,5.49,53,331,2294,9.8
3830,Brian Rolston,2003-04,30.0,10,58,77,77,19,39,58,286.0,1488.0,491,113,150,263,1355.0,82,5.51,63,376,2272,9.9
3831,Brian Rolston,2004-05,31.0,11,62,82,82,31,31,62,331.0,1673.0,573,144,181,325,1686.0,82,5.24,53,338,2262,9.5
3832,Brian Rolston,2005-06,32.0,12,59,81,81,27,32,59,281.0,1657.0,654,171,213,384,1967.0,82,5.31,60,363,2326,9.4
3833,Brian Rolston,2006-07,33.0,13,48,82,82,19,29,48,257.0,1609.0,736,190,242,432,2224.0,82,5.14,57,348,2300,9.2
3834,Brian Rolston,2008-09,35.0,14,79,82,82,34,45,79,293.0,1669.0,818,224,287,511,2517.0,82,6.05,85,480,2458,10.1
3835,Brian Rolston,2009-10,36.0,15,64,78,78,31,33,64,305.0,1659.0,896,255,320,575,2822.0,82,5.76,70,398,2426,9.7
3836,Brian Rolston,2010-11,37.0,16,59,81,81,31,28,59,289.0,1626.0,977,286,348,634,3111.0,82,5.44,62,351,2383,9.4
3837,Brian Rolston,2011-12,38.0,17,32,64,64,15,17,32,174.0,967.0,1041,301,365,666,3285.0,82,5.7,65,341,2477,9.4
3838,Brian Rolston,2012-13,39.0,18,37,80,80,20,17,37,232.0,1354.0,1121,321,382,703,3517.0,82,5.53,56,304,2486,9.1
3839,Brian Rolston,2013-14,40.0,19,34,65,65,14,20,34,168.0,1144.0,1186,335,402,737,3685.0,82,5.46,52,291,2492,9.0
3840,Brian Rolston,2014-15,41.0,20,24,70,70,7,17,24,151.0,1000.0,1256,342,419,761,3836.0,82,5.32,47,271,2439,8.9
3841,Brian Salcido,2011-12,26.0,4,1,2,2,0,1,1,1.0,25.0,2,0,1,1,1.0,82,5.7,65,341,2477,9.4
3842,Brian Savage,1996-97,25.0,4,1,3,3,1,0,1,3.0,,3,1,0,1,3.0,84,6.48,76,407,2545,10.7
3843,Brian Savage,1997-98,26.0,5,19,37,37,12,7,19,64.0,,40,13,7,20,67.0,48,5.97,37,209,1408,10.2
3844,Brian Savage,1998-99,27.0,6,33,75,75,25,8,33,150.0,,115,38,15,53,217.0,82,6.29,74,413,2481,10.4
3845,Brian Savage,1999-00,28.0,7,60,81,81,23,37,60,219.0,,196,61,52,113,436.0,82,5.83,55,336,2444,9.8
3846,Brian Savage,2000-01,29.0,8,43,64,64,26,17,43,152.0,,260,87,69,156,588.0,82,5.28,57,380,2242,9.6
3847,Brian Savage,2001-02,30.0,9,26,54,54,16,10,26,124.0,891.0,314,103,79,182,712.0,82,5.27,57,359,2285,9.4
3848,Brian Savage,2002-03,31.0,10,29,38,38,17,12,29,107.0,682.0,352,120,91,211,819.0,82,5.49,53,331,2294,9.8
3849,Brian Savage,2003-04,32.0,11,45,62,62,21,24,45,172.0,1168.0,414,141,115,256,991.0,82,5.51,63,376,2272,9.9
3850,Brian Savage,2004-05,33.0,12,41,77,77,20,21,41,164.0,1306.0,491,161,136,297,1155.0,82,5.24,53,338,2262,9.5
3851,Brian Savage,2005-06,34.0,13,16,43,43,6,10,16,68.0,575.0,534,167,146,313,1223.0,82,5.31,60,363,2326,9.4
3852,Brian Savage,2006-07,35.0,14,32,74,74,16,16,32,124.0,1084.0,608,183,162,345,1347.0,82,5.14,57,348,2300,9.2
3853,Brian Savage,2008-09,37.0,15,14,66,66,9,5,14,102.0,879.0,674,192,167,359,1449.0,82,6.05,85,480,2458,10.1
3854,Brian Skrudland,1988-89,25.0,4,22,65,65,9,13,22,62.0,,65,9,13,22,62.0,80,7.94,82,370,2484,12.8
3855,Brian Skrudland,1989-90,26.0,5,28,79,79,11,17,28,72.0,,144,20,30,50,134.0,80,7.34,72,344,2400,12.2
3856,Brian Skrudland,1990-91,27.0,6,36,79,79,12,24,36,96.0,,223,32,54,86,230.0,80,7.43,89,437,2435,12.2
3857,Brian Skrudland,1991-92,28.0,7,41,71,71,12,29,41,98.0,,294,44,83,127,328.0,80,7.48,85,403,2430,12.3
3858,Brian Skrudland,1992-93,29.0,8,42,59,59,11,31,42,70.0,,353,55,114,169,398.0,80,7.37,76,367,2421,12.2
3859,Brian Skrudland,1993-94,30.0,9,34,57,57,15,19,34,71.0,,410,70,133,203,469.0,80,6.91,71,366,2385,11.6
3860,Brian Skrudland,1994-95,31.0,10,6,42,42,3,3,6,51.0,,452,73,136,209,520.0,80,6.96,77,402,2440,11.4
3861,Brian Skrudland,1995-96,32.0,11,14,39,39,7,7,14,51.0,,491,80,143,223,571.0,84,7.25,87,443,2603,11.7
3862,Brian Skrudland,1996-97,33.0,12,40,79,79,15,25,40,110.0,,570,95,168,263,681.0,84,6.48,76,407,2545,10.7
3863,Brian Skrudland,1997-98,34.0,13,14,47,47,5,9,14,44.0,,617,100,177,277,725.0,48,5.97,37,209,1408,10.2
3864,Brian Skrudland,1998-99,35.0,14,27,79,79,7,20,27,90.0,,696,107,197,304,815.0,82,6.29,74,413,2481,10.4
3865,Brian Skrudland,1999-00,36.0,15,18,51,51,5,13,18,57.0,,747,112,210,322,872.0,82,5.83,55,336,2444,9.8
3866,Brian Skrudland,2000-01,37.0,16,13,72,72,7,6,13,55.0,,819,119,216,335,927.0,82,5.28,57,380,2242,9.6
3867,Brian Skrudland,2001-02,38.0,17,5,40,40,4,1,5,33.0,377.0,859,123,217,340,960.0,82,5.27,57,359,2285,9.4
3868,Brian Skrudland,2002-03,39.0,18,3,22,22,1,2,3,16.0,185.0,881,124,219,343,976.0,82,5.49,53,331,2294,9.8
3869,Brian Strait,2013-14,26.0,4,0,3,3,0,0,0,0.0,41.0,3,0,0,0,0.0,82,5.46,52,291,2492,9.0
3870,Brian Strait,2014-15,27.0,5,1,9,9,0,1,1,4.0,116.0,12,0,1,1,4.0,82,5.32,47,271,2439,8.9
3871,Brian Strait,2015-16,28.0,6,4,19,19,0,4,4,13.0,326.0,31,0,5,5,17.0,48,5.31,29,160,1399,9.1
3872,Brian Strait,2016-17,29.0,7,9,47,47,3,6,9,40.0,844.0,78,3,11,14,57.0,82,5.34,48,269,2463,8.9
3873,Brian Strait,2017-18,30.0,8,7,52,52,2,5,7,59.0,955.0,130,5,16,21,116.0,82,5.32,47,251,2453,8.9
3874,Brian Strait,2018-19,31.0,9,6,52,52,1,5,6,43.0,803.0,182,6,21,27,159.0,82,5.34,48,255,2438,9.0
3875,Brian Strait,2019-20,32.0,10,2,5,5,0,2,2,3.0,80.0,187,6,23,29,162.0,82,5.45,47,245,2478,9.0
3876,Brian Sullivan,1995-96,26.0,4,1,2,2,0,1,1,2.0,,2,0,1,1,2.0,84,7.25,87,443,2603,11.7
3877,Brian Sutherby,2004-05,22.0,4,0,7,7,0,0,0,3.0,51.0,7,0,0,0,3.0,82,5.24,53,338,2262,9.5
3878,Brian Sutherby,2005-06,23.0,5,11,72,72,2,9,11,38.0,701.0,79,2,9,11,41.0,82,5.31,60,363,2326,9.4
3879,Brian Sutherby,2006-07,24.0,6,2,30,30,2,0,2,24.0,308.0,109,4,9,13,65.0,82,5.14,57,348,2300,9.2
3880,Brian Sutherby,2008-09,26.0,7,30,76,76,14,16,30,85.0,1044.0,185,18,25,43,150.0,82,6.05,85,480,2458,10.1
3881,Brian Sutherby,2009-10,27.0,8,17,69,69,7,10,17,87.0,945.0,254,25,35,60,237.0,82,5.76,70,398,2426,9.7
3882,Brian Sutherby,2010-11,28.0,9,2,50,50,1,1,2,49.0,429.0,304,26,36,62,286.0,82,5.44,62,351,2383,9.4
3883,Brian Sutherby,2011-12,29.0,10,15,59,59,8,7,15,67.0,644.0,363,34,43,77,353.0,82,5.7,65,341,2477,9.4
3884,Brian Sutherby,2012-13,30.0,11,9,46,46,5,4,9,49.0,396.0,409,39,47,86,402.0,82,5.53,56,304,2486,9.1
3885,Brian Sutherby,2013-14,31.0,12,4,51,51,2,2,4,32.0,378.0,460,41,49,90,434.0,82,5.46,52,291,2492,9.0
3886,Brian Swanson,2003-04,27.0,4,2,16,16,1,1,2,8.0,175.0,16,1,1,2,8.0,82,5.51,63,376,2272,9.9
3887,Brian Swanson,2004-05,28.0,5,2,8,8,1,1,2,7.0,81.0,24,2,2,4,15.0,82,5.24,53,338,2262,9.5
3888,Brian Swanson,2005-06,29.0,6,12,44,44,2,10,12,67.0,524.0,68,4,12,16,82.0,82,5.31,60,363,2326,9.4
3889,Brian Swanson,2006-07,30.0,7,1,2,2,0,1,1,0.0,13.0,70,4,13,17,82.0,82,5.14,57,348,2300,9.2
3890,Brian Tutt,1992-93,30.0,4,1,7,7,1,0,1,5.0,,7,1,0,1,5.0,80,7.37,76,367,2421,12.2
3891,Brian Wesenberg,2001-02,24.0,4,0,1,1,0,0,0,0.0,1.0,1,0,0,0,0.0,82,5.27,57,359,2285,9.4
3892,Brian White,2001-02,25.0,4,0,2,2,0,0,0,0.0,1.0,2,0,0,0,0.0,82,5.27,57,359,2285,9.4
3893,Brian Wilks,1987-88,21.0,4,0,2,2,0,0,0,3.0,,2,0,0,0,3.0,80,7.77,71,321,2447,12.7
3894,Brian Wilks,1988-89,22.0,5,12,43,43,4,8,12,31.0,,45,4,8,12,34.0,80,7.94,82,370,2484,12.8
3895,Brian Wilks,1989-90,23.0,6,0,1,1,0,0,0,0.0,,46,4,8,12,34.0,80,7.34,72,344,2400,12.2
3896,Brian Wilks,1991-92,25.0,7,0,2,2,0,0,0,2.0,,48,4,8,12,36.0,80,7.48,85,403,2430,12.3
3897,Brian Willsie,2002-03,24.0,4,0,1,1,0,0,0,1.0,8.0,1,0,0,0,1.0,82,5.49,53,331,2294,9.8
3898,Brian Willsie,2004-05,26.0,5,14,56,56,7,7,14,66.0,638.0,57,7,7,14,67.0,82,5.24,53,338,2262,9.5
3899,Brian Willsie,2005-06,27.0,6,1,12,12,0,1,1,12.0,115.0,69,7,8,15,79.0,82,5.31,60,363,2326,9.4
3900,Brian Willsie,2006-07,28.0,7,15,49,49,10,5,15,85.0,622.0,118,17,13,30,164.0,82,5.14,57,348,2300,9.2
3901,Brian Willsie,2008-09,30.0,8,41,82,82,19,22,41,185.0,1366.0,200,36,35,71,349.0,82,6.05,85,480,2458,10.1
3902,Brian Willsie,2009-10,31.0,9,21,81,81,11,10,21,131.0,1084.0,281,47,45,92,480.0,82,5.76,70,398,2426,9.7
3903,Brian Willsie,2010-11,32.0,10,12,53,53,4,8,12,62.0,563.0,334,51,53,104,542.0,82,5.44,62,351,2383,9.4
3904,Brian Willsie,2011-12,33.0,11,4,42,42,1,3,4,59.0,495.0,376,52,56,108,601.0,82,5.7,65,341,2477,9.4
3905,Brian Willsie,2012-13,34.0,12,0,4,4,0,0,0,2.0,44.0,380,52,56,108,603.0,82,5.53,56,304,2486,9.1
3906,Brian Willsie,2013-14,35.0,13,1,1,1,0,1,1,0.0,6.0,381,52,57,109,603.0,82,5.46,52,291,2492,9.0
3907,Brian Wiseman,1999-00,28.0,4,0,3,3,0,0,0,1.0,,3,0,0,0,1.0,82,5.83,55,336,2444,9.8
3908,Brian Young,1983-84,25.0,4,2,8,8,0,2,2,5.0,,8,0,2,2,5.0,80,7.69,77,340,2441,12.6
3909,Brock Boeser,2019-20,22.0,4,5,9,9,4,1,5,25.0,146.0,9,4,1,5,25.0,82,5.45,47,245,2478,9.0
3910,Brock Boeser,2020-21,23.0,5,55,62,62,29,26,55,179.0,1085.0,71,33,27,60,204.0,82,5.86,50,250,2620,9.2
3911,Brock Boeser,2021-22,24.0,6,56,69,69,26,30,56,209.0,1322.0,140,59,57,116,413.0,82,5.96,47,239,2579,9.5
3912,Brock Boeser,2022-23,25.0,7,45,57,57,16,29,45,169.0,1059.0,197,75,86,161,582.0,70,5.96,42,208,2192,9.5
3913,Brock McGinn,2018-19,24.0,4,4,21,21,3,1,4,25.0,235.0,21,3,1,4,25.0,82,5.34,48,255,2438,9.0
3914,Brock McGinn,2019-20,25.0,5,16,57,57,7,9,16,74.0,684.0,78,10,10,20,99.0,82,5.45,47,245,2478,9.0
3915,Brock McGinn,2020-21,26.0,6,30,80,80,16,14,30,159.0,1160.0,158,26,24,50,258.0,82,5.86,50,250,2620,9.2
3916,Brock McGinn,2021-22,27.0,7,26,82,82,10,16,26,123.0,1173.0,240,36,40,76,381.0,82,5.96,47,239,2579,9.5
3917,Brock McGinn,2022-23,28.0,8,17,68,68,7,10,17,93.0,898.0,308,43,50,93,474.0,70,5.96,42,208,2192,9.5
3918,Brock Nelson,2016-17,25.0,4,26,72,72,14,12,26,132.0,1027.0,72,14,12,26,132.0,82,5.34,48,269,2463,8.9
3919,Brock Nelson,2017-18,26.0,5,42,82,82,20,22,42,190.0,1302.0,154,34,34,68,322.0,82,5.32,47,251,2453,8.9
3920,Brock Nelson,2018-19,27.0,6,40,81,81,26,14,40,165.0,1280.0,235,60,48,108,487.0,82,5.34,48,255,2438,9.0
3921,Brock Nelson,2019-20,28.0,7,45,81,81,20,25,45,173.0,1268.0,316,80,73,153,660.0,82,5.45,47,245,2478,9.0
3922,Brock Nelson,2020-21,29.0,8,35,82,82,19,16,35,138.0,1208.0,398,99,89,188,798.0,82,5.86,50,250,2620,9.2
3923,Brock Nelson,2021-22,30.0,9,53,82,82,25,28,53,181.0,1474.0,480,124,117,241,979.0,82,5.96,47,239,2579,9.5
3924,Brock Nelson,2022-23,31.0,10,54,68,68,26,28,54,175.0,1282.0,548,150,145,295,1154.0,70,5.96,42,208,2192,9.5
3925,Brock Trotter,2012-13,25.0,4,0,2,2,0,0,0,6.0,18.0,2,0,0,0,6.0,82,5.53,56,304,2486,9.1
3926,Brodie Dupont,2013-14,26.0,4,0,1,1,0,0,0,1.0,6.0,1,0,0,0,1.0,82,5.46,52,291,2492,9.0
3927,Brody Sutter,2017-18,26.0,4,0,4,4,0,0,0,0.0,30.0,4,0,0,0,0.0,82,5.32,47,251,2453,8.9
3928,Brody Sutter,2018-19,27.0,5,0,8,8,0,0,0,7.0,72.0,12,0,0,0,7.0,82,5.34,48,255,2438,9.0
3929,Brogan Rafferty,2021-22,26.0,4,0,2,2,0,0,0,3.0,27.0,2,0,0,0,3.0,82,5.96,47,239,2579,9.5
3930,Brooks Laich,2006-07,23.0,4,1,5,5,0,1,1,3.0,53.0,5,0,1,1,3.0,82,5.14,57,348,2300,9.2
3931,Brooks Laich,2008-09,25.0,5,21,73,73,7,14,21,118.0,819.0,78,7,15,22,121.0,82,6.05,85,480,2458,10.1
3932,Brooks Laich,2009-10,26.0,6,18,73,73,8,10,18,119.0,993.0,151,15,25,40,240.0,82,5.76,70,398,2426,9.7
3933,Brooks Laich,2010-11,27.0,7,37,82,82,21,16,37,122.0,1152.0,233,36,41,77,362.0,82,5.44,62,351,2383,9.4
3934,Brooks Laich,2011-12,28.0,8,53,82,82,23,30,53,185.0,1417.0,315,59,71,130,547.0,82,5.7,65,341,2477,9.4
3935,Brooks Laich,2012-13,29.0,9,59,78,78,25,34,59,222.0,1426.0,393,84,105,189,769.0,82,5.53,56,304,2486,9.1
3936,Brooks Laich,2013-14,30.0,10,48,82,82,16,32,48,207.0,1511.0,475,100,137,237,976.0,82,5.46,52,291,2492,9.0
3937,Brooks Laich,2014-15,31.0,11,41,82,82,16,25,41,191.0,1517.0,557,116,162,278,1167.0,82,5.32,47,271,2439,8.9
3938,Brooks Laich,2015-16,32.0,12,4,9,9,1,3,4,10.0,149.0,566,117,165,282,1177.0,48,5.31,29,160,1399,9.1
3939,Brooks Laich,2016-17,33.0,13,15,51,51,8,7,15,75.0,880.0,617,125,172,297,1252.0,82,5.34,48,269,2463,8.9
3940,Brooks Laich,2017-18,34.0,14,20,66,66,7,13,20,106.0,972.0,683,132,185,317,1358.0,82,5.32,47,251,2453,8.9
3941,Brooks Laich,2018-19,35.0,15,14,81,81,2,12,14,101.0,926.0,764,134,197,331,1459.0,82,5.34,48,255,2438,9.0
3942,Brooks Laich,2020-21,37.0,16,1,12,12,0,1,1,10.0,134.0,776,134,198,332,1469.0,82,5.86,50,250,2620,9.2
3943,Brooks Orpik,2005-06,25.0,4,0,6,6,0,0,0,2.0,110.0,6,0,0,0,2.0,82,5.31,60,363,2326,9.4
3944,Brooks Orpik,2006-07,26.0,5,10,79,79,1,9,10,56.0,1455.0,85,1,9,10,58.0,82,5.14,57,348,2300,9.2
3945,Brooks Orpik,2008-09,28.0,6,9,64,64,2,7,9,32.0,1206.0,149,3,16,19,90.0,82,6.05,85,480,2458,10.1
3946,Brooks Orpik,2009-10,29.0,7,6,70,70,0,6,6,59.0,1163.0,219,3,22,25,149.0,82,5.76,70,398,2426,9.7
3947,Brooks Orpik,2010-11,30.0,8,11,78,78,1,10,11,50.0,1323.0,297,4,32,36,199.0,82,5.44,62,351,2383,9.4
3948,Brooks Orpik,2011-12,31.0,9,19,79,79,2,17,19,39.0,1606.0,376,6,49,55,238.0,82,5.7,65,341,2477,9.4
3949,Brooks Orpik,2012-13,32.0,10,25,73,73,2,23,25,61.0,1467.0,449,8,72,80,299.0,82,5.53,56,304,2486,9.1
3950,Brooks Orpik,2013-14,33.0,11,13,63,63,1,12,13,56.0,1316.0,512,9,84,93,355.0,82,5.46,52,291,2492,9.0
3951,Brooks Orpik,2014-15,34.0,12,18,73,73,2,16,18,44.0,1646.0,585,11,100,111,399.0,82,5.32,47,271,2439,8.9
3952,Brooks Orpik,2015-16,35.0,13,8,46,46,0,8,8,32.0,1025.0,631,11,108,119,431.0,48,5.31,29,160,1399,9.1
3953,Brooks Orpik,2016-17,36.0,14,13,72,72,2,11,13,50.0,1526.0,703,13,119,132,481.0,82,5.34,48,269,2463,8.9
3954,Brooks Orpik,2017-18,37.0,15,19,78,78,0,19,19,66.0,1700.0,781,13,138,151,547.0,82,5.32,47,251,2453,8.9
3955,Brooks Orpik,2018-19,38.0,16,10,41,41,3,7,10,31.0,812.0,822,16,145,161,578.0,82,5.34,48,255,2438,9.0
3956,Brooks Orpik,2019-20,39.0,17,14,79,79,0,14,14,93.0,1405.0,901,16,159,175,671.0,82,5.45,47,245,2478,9.0
3957,Brooks Orpik,2020-21,40.0,18,10,81,81,0,10,10,54.0,1569.0,982,16,169,185,725.0,82,5.86,50,250,2620,9.2
3958,Brooks Orpik,2021-22,41.0,19,9,53,53,2,7,9,43.0,830.0,1035,18,176,194,768.0,82,5.96,47,239,2579,9.5
3959,Bruce Bell,1987-88,22.0,4,37,75,75,6,31,37,117.0,,75,6,31,37,117.0,80,7.77,71,321,2447,12.7
3960,Bruce Bell,1988-89,23.0,5,20,75,75,2,18,20,95.0,,150,8,49,57,212.0,80,7.94,82,370,2484,12.8
3961,Bruce Bell,1989-90,24.0,6,16,45,45,3,13,16,50.0,,195,11,62,73,262.0,80,7.34,72,344,2400,12.2
3962,Bruce Bell,1990-91,25.0,7,3,13,13,1,2,3,12.0,,208,12,64,76,274.0,80,7.43,89,437,2435,12.2
3963,Bruce Bell,1992-93,27.0,8,0,1,1,0,0,0,1.0,,209,12,64,76,275.0,80,7.37,76,367,2421,12.2
3964,Bruce Cassidy,1986-87,21.0,4,0,1,1,0,0,0,1.0,,1,0,0,0,1.0,80,7.89,74,336,2448,12.9
3965,Bruce Cassidy,1988-89,23.0,5,0,1,1,0,0,0,2.0,,2,0,0,0,3.0,80,7.94,82,370,2484,12.8
3966,Bruce Cassidy,1989-90,24.0,6,0,2,2,0,0,0,0.0,,4,0,0,0,3.0,80,7.34,72,344,2400,12.2
3967,Bruce Cassidy,1990-91,25.0,7,13,21,21,3,10,13,46.0,,25,3,10,13,49.0,80,7.43,89,437,2435,12.2
3968,Bruce Cassidy,1991-92,26.0,8,2,9,9,0,2,2,12.0,,34,3,12,15,61.0,80,7.48,85,403,2430,12.3
3969,Bruce Cassidy,1992-93,27.0,9,2,2,2,1,1,2,3.0,,36,4,13,17,64.0,80,7.37,76,367,2421,12.2
3970,Bruce Crowder,1984-85,27.0,4,27,63,63,16,11,27,84.0,,63,16,11,27,84.0,80,8.03,73,320,2489,12.9
3971,Bruce Crowder,1985-86,28.0,5,40,80,80,21,19,40,148.0,,143,37,30,67,232.0,80,7.73,71,310,2444,12.7
3972,Bruce Crowder,1986-87,29.0,6,20,74,74,6,14,20,65.0,,217,43,44,87,297.0,80,7.89,74,336,2448,12.9
3973,Bruce Crowder,1987-88,30.0,7,11,26,26,4,7,11,36.0,,243,47,51,98,333.0,80,7.77,71,321,2447,12.7
3974,Bruce Driver,1986-87,24.0,4,2,4,4,0,2,2,5.0,,4,0,2,2,5.0,80,7.89,74,336,2448,12.9
3975,Bruce Driver,1987-88,25.0,5,32,67,67,9,23,32,143.0,,71,9,25,34,148.0,80,7.77,71,321,2447,12.7
3976,Bruce Driver,1988-89,26.0,6,18,40,40,3,15,18,64.0,,111,12,40,52,212.0,80,7.94,82,370,2484,12.8
3977,Bruce Driver,1989-90,27.0,7,34,74,74,6,28,34,134.0,,185,18,68,86,346.0,80,7.34,72,344,2400,12.2
3978,Bruce Driver,1990-91,28.0,8,55,74,74,15,40,55,190.0,,259,33,108,141,536.0,80,7.43,89,437,2435,12.2
3979,Bruce Driver,1991-92,29.0,9,16,27,27,1,15,16,69.0,,286,34,123,157,605.0,80,7.48,85,403,2430,12.3
3980,Bruce Driver,1992-93,30.0,10,53,75,75,7,46,53,185.0,,361,41,169,210,790.0,80,7.37,76,367,2421,12.2
3981,Bruce Driver,1993-94,31.0,11,45,73,73,9,36,45,195.0,,434,50,205,255,985.0,80,6.91,71,366,2385,11.6
3982,Bruce Driver,1994-95,32.0,12,42,78,78,7,35,42,205.0,,512,57,240,297,1190.0,80,6.96,77,402,2440,11.4
3983,Bruce Driver,1995-96,33.0,13,54,83,83,14,40,54,177.0,,595,71,280,351,1367.0,84,7.25,87,443,2603,11.7
3984,Bruce Driver,1996-97,34.0,14,32,66,66,8,24,32,109.0,,661,79,304,383,1476.0,84,6.48,76,407,2545,10.7
3985,Bruce Driver,1997-98,35.0,15,16,41,41,4,12,16,62.0,,702,83,316,399,1538.0,48,5.97,37,209,1408,10.2
3986,Bruce Driver,1998-99,36.0,16,37,66,66,3,34,37,140.0,,768,86,350,436,1678.0,82,6.29,74,413,2481,10.4
3987,Bruce Driver,1999-00,37.0,17,30,79,79,5,25,30,154.0,,847,91,375,466,1832.0,82,5.83,55,336,2444,9.8
3988,Bruce Driver,2000-01,38.0,18,20,75,75,5,15,20,116.0,,922,96,390,486,1948.0,82,5.28,57,380,2242,9.6
3989,Bruce Eakin,1984-85,22.0,4,0,1,1,0,0,0,0.0,,1,0,0,0,0.0,80,8.03,73,320,2489,12.9
3990,Bruce Eakin,1986-87,24.0,5,3,7,7,2,1,3,8.0,,8,2,1,3,8.0,80,7.89,74,336,2448,12.9
3991,Bruce Eakin,1987-88,25.0,6,0,1,1,0,0,0,0.0,,9,2,1,3,8.0,80,7.77,71,321,2447,12.7
3992,Bruce Eakin,1988-89,26.0,7,1,4,4,0,1,1,1.0,,13,2,2,4,9.0,80,7.94,82,370,2484,12.8
3993,Bruce Gardiner,1999-00,27.0,4,21,67,67,11,10,21,94.0,,67,11,10,21,94.0,82,5.83,55,336,2444,9.8
3994,Bruce Gardiner,2000-01,28.0,5,18,55,55,7,11,18,64.0,,122,18,21,39,158.0,82,5.28,57,380,2242,9.6
3995,Bruce Gardiner,2001-02,29.0,6,12,59,59,4,8,12,70.0,759.0,181,22,29,51,228.0,82,5.27,57,359,2285,9.4
3996,Bruce Gardiner,2002-03,30.0,7,12,51,51,3,9,12,48.0,691.0,232,25,38,63,276.0,82,5.49,53,331,2294,9.8
3997,Bruce Gardiner,2003-04,31.0,8,22,73,73,7,15,22,60.0,1066.0,305,32,53,85,336.0,82,5.51,63,376,2272,9.9
3998,Bruce Gardiner,2004-05,32.0,9,3,7,7,2,1,3,10.0,93.0,312,34,54,88,346.0,82,5.24,53,338,2262,9.5
3999,Bruce Holloway,1987-88,24.0,4,0,2,2,0,0,0,0.0,,2,0,0,0,0.0,80,7.77,71,321,2447,12.7
4000,Bruce Major,1993-94,27.0,4,0,4,4,0,0,0,0.0,,4,0,0,0,0.0,80,6.91,71,366,2385,11.6
4001,Bruce Shoebottom,1990-91,25.0,4,1,3,3,0,1,1,2.0,,3,0,1,1,2.0,80,7.43,89,437,2435,12.2
4002,Bruce Shoebottom,1991-92,26.0,5,4,29,29,1,3,4,19.0,,32,1,4,5,21.0,80,7.48,85,403,2430,12.3
4003,Bruce Shoebottom,1992-93,27.0,6,0,2,2,0,0,0,3.0,,34,1,4,5,24.0,80,7.37,76,367,2421,12.2
4004,Bruce Shoebottom,1993-94,28.0,7,0,1,1,0,0,0,0.0,,35,1,4,5,24.0,80,6.91,71,366,2385,11.6
4005,Bruno Gervais,2008-09,24.0,4,7,27,27,3,4,7,21.0,453.0,27,3,4,7,21.0,82,6.05,85,480,2458,10.1
4006,Bruno Gervais,2009-10,25.0,5,6,51,51,0,6,6,47.0,784.0,78,3,10,13,68.0,82,5.76,70,398,2426,9.7
4007,Bruno Gervais,2010-11,26.0,6,13,60,60,0,13,13,59.0,1200.0,138,3,23,26,127.0,82,5.44,62,351,2383,9.4
4008,Bruno Gervais,2011-12,27.0,7,19,69,69,3,16,19,82.0,1490.0,207,6,39,45,209.0,82,5.7,65,341,2477,9.4
4009,Bruno Gervais,2012-13,28.0,8,17,71,71,3,14,17,83.0,1421.0,278,9,53,62,292.0,82,5.53,56,304,2486,9.1
4010,Bruno Gervais,2013-14,29.0,9,6,53,53,0,6,6,43.0,831.0,331,9,59,68,335.0,82,5.46,52,291,2492,9.0
4011,Bruno Gervais,2014-15,30.0,10,13,50,50,6,7,13,57.0,713.0,381,15,66,81,392.0,82,5.32,47,271,2439,8.9
4012,Bruno Gervais,2015-16,31.0,11,6,37,37,1,5,6,49.0,634.0,418,16,71,87,441.0,48,5.31,29,160,1399,9.1
4013,Bruno St. Jacques,2004-05,24.0,4,0,7,7,0,0,0,4.0,97.0,7,0,0,0,4.0,82,5.24,53,338,2262,9.5
4014,Bruno St. Jacques,2005-06,25.0,5,7,24,24,2,5,7,19.0,416.0,31,2,5,7,23.0,82,5.31,60,363,2326,9.4
4015,Bruno St. Jacques,2006-07,26.0,6,2,35,35,0,2,2,16.0,414.0,66,2,7,9,39.0,82,5.14,57,348,2300,9.2
4016,Bruno St. Jacques,2008-09,28.0,7,1,1,1,1,0,1,2.0,14.0,67,3,7,10,41.0,82,6.05,85,480,2458,10.1
4017,Bryan Adams,2002-03,25.0,4,0,2,2,0,0,0,1.0,22.0,2,0,0,0,1.0,82,5.49,53,331,2294,9.8
4018,Bryan Adams,2003-04,26.0,5,1,9,9,0,1,1,3.0,87.0,11,0,1,1,4.0,82,5.51,63,376,2272,9.9
4019,Bryan Allen,2003-04,23.0,4,0,6,6,0,0,0,2.0,56.0,6,0,0,0,2.0,82,5.51,63,376,2272,9.9
4020,Bryan Allen,2004-05,24.0,5,0,11,11,0,0,0,4.0,119.0,17,0,0,0,6.0,82,5.24,53,338,2262,9.5
4021,Bryan Allen,2005-06,25.0,6,8,48,48,5,3,8,43.0,621.0,65,5,3,8,49.0,82,5.31,60,363,2326,9.4
4022,Bryan Allen,2006-07,26.0,7,7,74,74,2,5,7,70.0,1247.0,139,7,8,15,119.0,82,5.14,57,348,2300,9.2
4023,Bryan Allen,2008-09,28.0,8,17,77,77,7,10,17,88.0,1574.0,216,14,18,32,207.0,82,6.05,85,480,2458,10.1
4024,Bryan Allen,2009-10,29.0,9,25,82,82,4,21,25,99.0,1771.0,298,18,39,57,306.0,82,5.76,70,398,2426,9.7
4025,Bryan Allen,2010-11,30.0,10,16,73,73,2,14,16,67.0,1554.0,371,20,53,73,373.0,82,5.44,62,351,2383,9.4
4026,Bryan Allen,2011-12,31.0,11,1,2,2,0,1,1,5.0,54.0,373,20,54,74,378.0,82,5.7,65,341,2477,9.4
4027,Bryan Allen,2012-13,32.0,12,13,74,74,4,9,13,78.0,1418.0,447,24,63,87,456.0,82,5.53,56,304,2486,9.1
4028,Bryan Allen,2013-14,33.0,13,17,72,72,4,13,17,58.0,1319.0,519,28,76,104,514.0,82,5.46,52,291,2492,9.0
4029,Bryan Allen,2014-15,34.0,14,14,82,82,1,13,14,87.0,1571.0,601,29,89,118,601.0,82,5.32,47,271,2439,8.9
4030,Bryan Allen,2015-16,35.0,15,6,41,41,0,6,6,25.0,768.0,642,29,95,124,626.0,48,5.31,29,160,1399,9.1
4031,Bryan Allen,2016-17,36.0,16,10,68,68,0,10,10,60.0,1193.0,710,29,105,134,686.0,82,5.34,48,269,2463,8.9
4032,Bryan Allen,2017-18,37.0,17,2,11,11,0,2,2,6.0,173.0,721,29,107,136,692.0,82,5.32,47,251,2453,8.9
4033,Bryan Berard,1999-00,22.0,4,48,82,82,8,40,48,172.0,,82,8,40,48,172.0,82,5.83,55,336,2444,9.8
4034,Bryan Berard,2000-01,23.0,5,46,75,75,14,32,46,192.0,,157,22,72,94,364.0,82,5.28,57,380,2242,9.6
4035,Bryan Berard,2001-02,24.0,6,34,69,69,9,25,34,135.0,1627.0,226,31,97,128,499.0,82,5.27,57,359,2285,9.4
4036,Bryan Berard,2002-03,25.0,7,30,64,64,3,27,30,98.0,1253.0,290,34,124,158,597.0,82,5.49,53,331,2294,9.8
4037,Bryan Berard,2004-05,27.0,8,23,82,82,2,21,23,132.0,1610.0,372,36,145,181,729.0,82,5.24,53,338,2262,9.5
4038,Bryan Berard,2005-06,28.0,9,38,80,80,10,28,38,205.0,1709.0,452,46,173,219,934.0,82,5.31,60,363,2326,9.4
4039,Bryan Berard,2006-07,29.0,10,47,58,58,13,34,47,203.0,1263.0,510,59,207,266,1137.0,82,5.14,57,348,2300,9.2
4040,Bryan Berard,2008-09,31.0,11,32,44,44,12,20,32,126.0,997.0,554,71,227,298,1263.0,82,6.05,85,480,2458,10.1
4041,Bryan Berard,2009-10,32.0,12,3,11,11,0,3,3,22.0,209.0,565,71,230,301,1285.0,82,5.76,70,398,2426,9.7
4042,Bryan Berard,2010-11,33.0,13,22,54,54,5,17,22,87.0,953.0,619,76,247,323,1372.0,82,5.44,62,351,2383,9.4
4043,Bryan Bickell,2009-10,23.0,4,2,3,3,2,0,2,10.0,35.0,3,2,0,2,10.0,82,5.76,70,398,2426,9.7
4044,Bryan Bickell,2010-11,24.0,5,0,4,4,0,0,0,3.0,37.0,7,2,0,2,13.0,82,5.44,62,351,2383,9.4
4045,Bryan Bickell,2012-13,26.0,6,4,16,16,3,1,4,20.0,154.0,23,5,1,6,33.0,82,5.53,56,304,2486,9.1
4046,Bryan Bickell,2013-14,27.0,7,37,78,78,17,20,37,130.0,1079.0,101,22,21,43,163.0,82,5.46,52,291,2492,9.0
4047,Bryan Bickell,2014-15,28.0,8,24,71,71,9,15,24,84.0,862.0,172,31,36,67,247.0,82,5.32,47,271,2439,8.9
4048,Bryan Bickell,2015-16,29.0,9,23,48,48,9,14,23,82.0,615.0,220,40,50,90,329.0,48,5.31,29,160,1399,9.1
4049,Bryan Bickell,2016-17,30.0,10,15,59,59,11,4,15,93.0,670.0,279,51,54,105,422.0,82,5.34,48,269,2463,8.9
4050,Bryan Bickell,2017-18,31.0,11,28,80,80,14,14,28,113.0,966.0,359,65,68,133,535.0,82,5.32,47,251,2453,8.9
4051,Bryan Bickell,2018-19,32.0,12,2,25,25,0,2,2,21.0,245.0,384,65,70,135,556.0,82,5.34,48,255,2438,9.0
4052,Bryan Bickell,2019-20,33.0,13,1,11,11,1,0,1,8.0,115.0,395,66,70,136,564.0,82,5.45,47,245,2478,9.0
4053,Bryan Erickson,1986-87,26.0,4,29,45,45,12,17,29,66.0,,45,12,17,29,66.0,80,7.89,74,336,2448,12.9
4054,Bryan Erickson,1987-88,27.0,5,28,57,57,15,13,28,79.0,,102,27,30,57,145.0,80,7.77,71,321,2447,12.7
4055,Bryan Erickson,1988-89,28.0,6,43,55,55,20,23,43,108.0,,157,47,53,100,253.0,80,7.94,82,370,2484,12.8
4056,Bryan Erickson,1989-90,29.0,7,50,68,68,20,30,50,142.0,,225,67,83,150,395.0,80,7.34,72,344,2400,12.2
4057,Bryan Erickson,1990-91,30.0,8,26,53,53,7,19,26,81.0,,278,74,102,176,476.0,80,7.43,89,437,2435,12.2
4058,Bryan Erickson,1993-94,33.0,9,7,6,6,0,7,7,16.0,,284,74,109,183,492.0,80,6.91,71,366,2385,11.6
4059,Bryan Erickson,1994-95,34.0,10,6,10,10,2,4,6,16.0,,294,76,113,189,508.0,80,6.96,77,402,2440,11.4
4060,Bryan Erickson,1995-96,35.0,11,16,41,41,4,12,16,45.0,,335,80,125,205,553.0,84,7.25,87,443,2603,11.7
4061,Bryan Erickson,1996-97,36.0,12,0,16,16,0,0,0,8.0,,351,80,125,205,561.0,84,6.48,76,407,2545,10.7
4062,Bryan Fogarty,1992-93,23.0,4,14,45,45,4,10,14,93.0,,45,4,10,14,93.0,80,7.37,76,367,2421,12.2
4063,Bryan Fogarty,1993-94,24.0,5,31,45,45,9,22,31,107.0,,90,13,32,45,200.0,80,6.91,71,366,2385,11.6
4064,Bryan Fogarty,1994-95,25.0,6,15,20,20,3,12,15,30.0,,110,16,44,60,230.0,80,6.96,77,402,2440,11.4
4065,Bryan Fogarty,1995-96,26.0,7,4,12,12,0,4,4,11.0,,122,16,48,64,241.0,84,7.25,87,443,2603,11.7
4066,Bryan Fogarty,1996-97,27.0,8,3,13,13,1,2,3,22.0,,135,17,50,67,263.0,84,6.48,76,407,2545,10.7
4067,Bryan Fogarty,1997-98,28.0,9,7,21,21,5,2,7,41.0,,156,22,52,74,304.0,48,5.97,37,209,1408,10.2
4068,Bryan Helmer,2001-02,29.0,4,4,40,40,0,4,4,49.0,640.0,40,0,4,4,49.0,82,5.27,57,359,2285,9.4
4069,Bryan Helmer,2002-03,30.0,5,2,15,15,1,1,2,19.0,244.0,55,1,5,6,68.0,82,5.49,53,331,2294,9.8
4070,Bryan Helmer,2003-04,31.0,6,6,20,20,2,4,6,28.0,337.0,75,3,9,12,96.0,82,5.51,63,376,2272,9.9
4071,Bryan Helmer,2004-05,32.0,7,10,40,40,5,5,10,43.0,483.0,115,8,14,22,139.0,82,5.24,53,338,2262,9.5
4072,Bryan Helmer,2005-06,33.0,8,0,2,2,0,0,0,2.0,27.0,117,8,14,22,141.0,82,5.31,60,363,2326,9.4
4073,Bryan Helmer,2006-07,34.0,9,1,17,17,0,1,1,10.0,217.0,134,8,15,23,151.0,82,5.14,57,348,2300,9.2
4074,Bryan Helmer,2011-12,39.0,10,3,12,12,0,3,3,8.0,199.0,146,8,18,26,159.0,82,5.7,65,341,2477,9.4
4075,Bryan Lerg,2017-18,32.0,4,1,2,2,1,0,1,8.0,25.0,2,1,0,1,8.0,82,5.32,47,251,2453,8.9
4076,Bryan Lerg,2018-19,33.0,5,0,6,6,0,0,0,4.0,53.0,8,1,0,1,12.0,82,5.34,48,255,2438,9.0
4077,Bryan Little,2010-11,23.0,4,16,48,48,6,10,16,76.0,749.0,48,6,10,16,76.0,82,5.44,62,351,2383,9.4
4078,Bryan Little,2011-12,24.0,5,51,79,79,31,20,51,172.0,1337.0,127,37,30,67,248.0,82,5.7,65,341,2477,9.4
4079,Bryan Little,2012-13,25.0,6,34,79,79,13,21,34,165.0,1244.0,206,50,51,101,413.0,82,5.53,56,304,2486,9.1
4080,Bryan Little,2013-14,26.0,7,48,76,76,18,30,48,158.0,1403.0,282,68,81,149,571.0,82,5.46,52,291,2492,9.0
4081,Bryan Little,2014-15,27.0,8,46,74,74,24,22,46,162.0,1496.0,356,92,103,195,733.0,82,5.32,47,271,2439,8.9
4082,Bryan Little,2015-16,28.0,9,32,48,48,7,25,32,84.0,950.0,404,99,128,227,817.0,48,5.31,29,160,1399,9.1
4083,Bryan Little,2016-17,29.0,10,64,82,82,23,41,64,170.0,1640.0,486,122,169,291,987.0,82,5.34,48,269,2463,8.9
4084,Bryan Little,2017-18,30.0,11,52,70,70,24,28,52,148.0,1394.0,556,146,197,343,1135.0,82,5.32,47,251,2453,8.9
4085,Bryan Little,2018-19,31.0,12,42,57,57,17,25,42,127.0,1117.0,613,163,222,385,1262.0,82,5.34,48,255,2438,9.0
4086,Bryan Little,2019-20,32.0,13,47,59,59,21,26,47,119.0,1036.0,672,184,248,432,1381.0,82,5.45,47,245,2478,9.0
4087,Bryan Little,2020-21,33.0,14,43,82,82,16,27,43,129.0,1389.0,754,200,275,475,1510.0,82,5.86,50,250,2620,9.2
4088,Bryan Little,2021-22,34.0,15,41,82,82,15,26,41,126.0,1298.0,836,215,301,516,1636.0,82,5.96,47,239,2579,9.5
4089,Bryan Little,2022-23,35.0,16,5,7,7,2,3,5,13.0,113.0,843,217,304,521,1649.0,70,5.96,42,208,2192,9.5
4090,Bryan Marchment,1991-92,22.0,4,0,2,2,0,0,0,1.0,,2,0,0,0,1.0,80,7.48,85,403,2430,12.3
4091,Bryan Marchment,1992-93,23.0,5,2,7,7,0,2,2,5.0,,9,0,2,2,6.0,80,7.37,76,367,2421,12.2
4092,Bryan Marchment,1993-94,24.0,6,4,28,28,2,2,4,24.0,,37,2,4,6,30.0,80,6.91,71,366,2385,11.6
4093,Bryan Marchment,1994-95,25.0,7,15,58,58,5,10,15,55.0,,95,7,14,21,85.0,80,6.96,77,402,2440,11.4
4094,Bryan Marchment,1995-96,26.0,8,20,78,78,5,15,20,75.0,,173,12,29,41,160.0,84,7.25,87,443,2603,11.7
4095,Bryan Marchment,1996-97,27.0,9,15,55,55,4,11,15,92.0,,228,16,40,56,252.0,84,6.48,76,407,2545,10.7
4096,Bryan Marchment,1997-98,28.0,10,6,40,40,1,5,6,57.0,,268,17,45,62,309.0,48,5.97,37,209,1408,10.2
4097,Bryan Marchment,1998-99,29.0,11,18,78,78,3,15,18,96.0,,346,20,60,80,405.0,82,6.29,74,413,2481,10.4
4098,Bryan Marchment,1999-00,30.0,12,16,71,71,3,13,16,89.0,,417,23,73,96,494.0,82,5.83,55,336,2444,9.8
4099,Bryan Marchment,2000-01,31.0,13,13,61,61,2,11,13,56.0,,478,25,84,109,550.0,82,5.28,57,380,2242,9.6
4100,Bryan Marchment,2001-02,32.0,14,8,59,59,2,6,8,49.0,1045.0,537,27,90,117,599.0,82,5.27,57,359,2285,9.4
4101,Bryan Marchment,2002-03,33.0,15,4,49,49,0,4,4,51.0,927.0,586,27,94,121,650.0,82,5.49,53,331,2294,9.8
4102,Bryan Marchment,2003-04,34.0,16,18,75,75,7,11,18,73.0,1365.0,661,34,105,139,723.0,82,5.51,63,376,2272,9.9
4103,Bryan Marchment,2004-05,35.0,17,22,72,72,2,20,22,68.0,1353.0,733,36,125,161,791.0,82,5.24,53,338,2262,9.5
4104,Bryan Marchment,2005-06,36.0,18,14,81,81,2,12,14,84.0,1528.0,814,38,137,175,875.0,82,5.31,60,363,2326,9.4
4105,Bryan Marchment,2006-07,37.0,19,4,75,75,1,3,4,56.0,1142.0,889,39,140,179,931.0,82,5.14,57,348,2300,9.2
4106,Bryan Marchment,2008-09,39.0,20,3,37,37,1,2,3,16.0,485.0,926,40,142,182,947.0,82,6.05,85,480,2458,10.1
4107,Bryan McCabe,1998-99,23.0,4,23,82,82,7,16,23,130.0,,82,7,16,23,130.0,82,6.29,74,413,2481,10.4
4108,Bryan McCabe,1999-00,24.0,5,28,82,82,8,20,28,117.0,,164,15,36,51,247.0,82,5.83,55,336,2444,9.8
4109,Bryan McCabe,2000-01,25.0,6,24,82,82,4,20,24,123.0,,246,19,56,75,370.0,82,5.28,57,380,2242,9.6
4110,Bryan McCabe,2001-02,26.0,7,21,69,69,7,14,21,98.0,1671.0,315,26,70,96,468.0,82,5.27,57,359,2285,9.4
4111,Bryan McCabe,2002-03,27.0,8,25,79,79,6,19,25,119.0,1848.0,394,32,89,121,587.0,82,5.49,53,331,2294,9.8
4112,Bryan McCabe,2003-04,28.0,9,29,82,82,5,24,29,159.0,1953.0,476,37,113,150,746.0,82,5.51,63,376,2272,9.9
4113,Bryan McCabe,2004-05,29.0,10,43,82,82,17,26,43,157.0,2015.0,558,54,139,193,903.0,82,5.24,53,338,2262,9.5
4114,Bryan McCabe,2005-06,30.0,11,24,75,75,6,18,24,149.0,1773.0,633,60,157,217,1052.0,82,5.31,60,363,2326,9.4
4115,Bryan McCabe,2006-07,31.0,12,53,75,75,16,37,53,168.0,1930.0,708,76,194,270,1220.0,82,5.14,57,348,2300,9.2
4116,Bryan McCabe,2008-09,33.0,13,68,73,73,19,49,68,207.0,2066.0,781,95,243,338,1427.0,82,6.05,85,480,2458,10.1
4117,Bryan McCabe,2009-10,34.0,14,57,82,82,15,42,57,207.0,2200.0,863,110,285,395,1634.0,82,5.76,70,398,2426,9.7
4118,Bryan McCabe,2010-11,35.0,15,23,54,54,5,18,23,107.0,1400.0,917,115,303,418,1741.0,82,5.44,62,351,2383,9.4
4119,Bryan McCabe,2011-12,36.0,16,39,69,69,15,24,39,153.0,1596.0,986,130,327,457,1894.0,82,5.7,65,341,2477,9.4
4120,Bryan McCabe,2012-13,37.0,17,43,82,82,8,35,43,169.0,1913.0,1068,138,362,500,2063.0,82,5.53,56,304,2486,9.1
4121,Bryan McCabe,2013-14,38.0,18,28,67,67,7,21,28,122.0,1311.0,1135,145,383,528,2185.0,82,5.46,52,291,2492,9.0
4122,Bryan Muir,1998-99,25.0,4,0,5,5,0,0,0,4.0,,5,0,0,0,4.0,82,6.29,74,413,2481,10.4
4123,Bryan Muir,2000-01,27.0,5,0,7,7,0,0,0,6.0,,12,0,0,0,10.0,82,5.28,57,380,2242,9.6
4124,Bryan Muir,2001-02,28.0,6,5,54,54,1,4,5,82.0,1007.0,66,1,4,5,92.0,82,5.27,57,359,2285,9.4
4125,Bryan Muir,2002-03,29.0,7,7,41,41,3,4,7,51.0,781.0,107,4,8,12,143.0,82,5.49,53,331,2294,9.8
4126,Bryan Muir,2003-04,30.0,8,3,18,18,0,3,3,17.0,252.0,125,4,11,15,160.0,82,5.51,63,376,2272,9.9
4127,Bryan Muir,2004-05,31.0,9,2,22,22,1,1,2,26.0,227.0,147,5,12,17,186.0,82,5.24,53,338,2262,9.5
4128,Bryan Muir,2005-06,32.0,10,2,32,32,0,2,2,9.0,209.0,179,5,14,19,195.0,82,5.31,60,363,2326,9.4
4129,Bryan Muir,2006-07,33.0,11,1,2,2,0,1,1,2.0,36.0,181,5,15,20,197.0,82,5.14,57,348,2300,9.2
4130,Bryan Muir,2008-09,35.0,12,26,72,72,8,18,26,136.0,1524.0,253,13,33,46,333.0,82,6.05,85,480,2458,10.1
4131,Bryan Muir,2009-10,36.0,13,7,26,26,3,4,7,28.0,380.0,279,16,37,53,361.0,82,5.76,70,398,2426,9.7
4132,Bryan Rodney,2011-12,27.0,4,2,8,8,0,2,2,3.0,101.0,8,0,2,2,3.0,82,5.7,65,341,2477,9.4
4133,Bryan Rodney,2012-13,28.0,5,11,22,22,1,10,11,24.0,368.0,30,1,12,13,27.0,82,5.53,56,304,2486,9.1
4134,Bryan Rodney,2013-14,29.0,6,0,3,3,0,0,0,3.0,26.0,33,1,12,13,30.0,82,5.46,52,291,2492,9.0
4135,Bryan Rodney,2014-15,30.0,7,0,1,1,0,0,0,0.0,13.0,34,1,12,13,30.0,82,5.32,47,271,2439,8.9
4136,Bryan Rust,2017-18,25.0,4,2,14,14,1,1,2,34.0,168.0,14,1,1,2,34.0,82,5.32,47,251,2453,8.9
4137,Bryan Rust,2018-19,26.0,5,11,41,41,4,7,11,68.0,512.0,55,5,8,13,102.0,82,5.34,48,255,2438,9.0
4138,Bryan Rust,2019-20,27.0,6,28,57,57,15,13,28,110.0,777.0,112,20,21,41,212.0,82,5.45,47,245,2478,9.0
4139,Bryan Rust,2020-21,28.0,7,38,69,69,13,25,38,123.0,1107.0,181,33,46,79,335.0,82,5.86,50,250,2620,9.2
4140,Bryan Rust,2021-22,29.0,8,35,72,72,18,17,35,141.0,1145.0,253,51,63,114,476.0,82,5.96,47,239,2579,9.5
4141,Bryan Rust,2022-23,30.0,9,56,55,55,27,29,56,151.0,1087.0,308,78,92,170,627.0,70,5.96,42,208,2192,9.5
4142,Bryan Smolinski,1995-96,24.0,4,4,9,9,1,3,4,10.0,,9,1,3,4,10.0,84,7.25,87,443,2603,11.7
4143,Bryan Smolinski,1996-97,25.0,5,51,83,83,31,20,51,179.0,,92,32,23,55,189.0,84,6.48,76,407,2545,10.7
4144,Bryan Smolinski,1997-98,26.0,6,31,44,44,18,13,31,121.0,,136,50,36,86,310.0,48,5.97,37,209,1408,10.2
4145,Bryan Smolinski,1998-99,27.0,7,64,81,81,24,40,64,229.0,,217,74,76,150,539.0,82,6.29,74,413,2481,10.4
4146,Bryan Smolinski,1999-00,28.0,8,56,64,64,28,28,56,183.0,,281,102,104,206,722.0,82,5.83,55,336,2444,9.8
4147,Bryan Smolinski,2000-01,29.0,9,43,81,81,13,30,43,203.0,,362,115,134,249,925.0,82,5.28,57,380,2242,9.6
4148,Bryan Smolinski,2001-02,30.0,10,40,82,82,16,24,40,223.0,1584.0,444,131,158,289,1148.0,82,5.27,57,359,2285,9.4
4149,Bryan Smolinski,2002-03,31.0,11,56,79,79,20,36,56,160.0,1468.0,523,151,194,345,1308.0,82,5.49,53,331,2294,9.8
4150,Bryan Smolinski,2003-04,32.0,12,59,78,78,27,32,59,183.0,1445.0,601,178,226,404,1491.0,82,5.51,63,376,2272,9.9
4151,Bryan Smolinski,2004-05,33.0,13,38,80,80,13,25,38,187.0,1551.0,681,191,251,442,1678.0,82,5.24,53,338,2262,9.5
4152,Bryan Smolinski,2005-06,34.0,14,46,68,68,21,25,46,176.0,1261.0,749,212,276,488,1854.0,82,5.31,60,363,2326,9.4
4153,Bryan Smolinski,2006-07,35.0,15,46,80,80,19,27,46,182.0,1332.0,829,231,303,534,2036.0,82,5.14,57,348,2300,9.2
4154,Bryan Smolinski,2008-09,37.0,16,48,81,81,17,31,48,178.0,1199.0,910,248,334,582,2214.0,82,6.05,85,480,2458,10.1
4155,Bryan Smolinski,2009-10,38.0,17,44,82,82,18,26,44,163.0,1475.0,992,266,360,626,2377.0,82,5.76,70,398,2426,9.7
4156,Bryan Smolinski,2010-11,39.0,18,25,64,64,8,17,25,89.0,840.0,1056,274,377,651,2466.0,82,5.44,62,351,2383,9.4
4157,Bryan Young,2009-10,23.0,4,0,15,15,0,0,0,2.0,152.0,15,0,0,0,2.0,82,5.76,70,398,2426,9.7
4158,Bryan Young,2010-11,24.0,5,0,2,2,0,0,0,0.0,4.0,17,0,0,0,2.0,82,5.44,62,351,2383,9.4
4159,Bryce Lampman,2006-07,24.0,4,0,8,8,0,0,0,7.0,156.0,8,0,0,0,7.0,82,5.14,57,348,2300,9.2
4160,Bryce Lampman,2008-09,26.0,5,0,1,1,0,0,0,1.0,14.0,9,0,0,0,8.0,82,6.05,85,480,2458,10.1
4161,Bryce Lampman,2009-10,27.0,6,0,1,1,0,0,0,0.0,12.0,10,0,0,0,8.0,82,5.76,70,398,2426,9.7
4162,Bryce Salvador,2003-04,27.0,4,10,75,75,2,8,10,60.0,1247.0,75,2,8,10,60.0,82,5.51,63,376,2272,9.9
4163,Bryce Salvador,2004-05,28.0,5,12,66,66,5,7,12,37.0,1117.0,141,7,15,22,97.0,82,5.24,53,338,2262,9.5
4164,Bryce Salvador,2005-06,29.0,6,10,71,71,2,8,10,73.0,1346.0,212,9,23,32,170.0,82,5.31,60,363,2326,9.4
4165,Bryce Salvador,2006-07,30.0,7,8,69,69,3,5,8,60.0,1206.0,281,12,28,40,230.0,82,5.14,57,348,2300,9.2
4166,Bryce Salvador,2008-09,32.0,8,5,46,46,1,4,5,23.0,911.0,327,13,32,45,253.0,82,6.05,85,480,2458,10.1
4167,Bryce Salvador,2009-10,33.0,9,7,64,64,2,5,7,40.0,1263.0,391,15,37,52,293.0,82,5.76,70,398,2426,9.7
4168,Bryce Salvador,2010-11,34.0,10,11,64,64,1,10,11,29.0,1267.0,455,16,47,63,322.0,82,5.44,62,351,2383,9.4
4169,Bryce Salvador,2011-12,35.0,11,16,76,76,3,13,16,68.0,1481.0,531,19,60,79,390.0,82,5.7,65,341,2477,9.4
4170,Bryce Salvador,2012-13,36.0,12,14,79,79,4,10,14,47.0,1490.0,610,23,70,93,437.0,82,5.53,56,304,2486,9.1
4171,Bryce Salvador,2014-15,38.0,13,9,82,82,0,9,9,52.0,1657.0,692,23,79,102,489.0,82,5.32,47,271,2439,8.9
4172,Bryce Salvador,2015-16,39.0,14,2,39,39,0,2,2,29.0,832.0,731,23,81,104,518.0,48,5.31,29,160,1399,9.1
4173,Bryce Salvador,2016-17,40.0,15,4,40,40,1,3,4,24.0,812.0,771,24,84,108,542.0,82,5.34,48,269,2463,8.9
4174,Bryce Salvador,2017-18,41.0,16,2,15,15,0,2,2,13.0,278.0,786,24,86,110,555.0,82,5.32,47,251,2453,8.9
4175,Bryce Van Brabant,2016-17,25.0,4,0,6,6,0,0,0,4.0,55.0,6,0,0,0,4.0,82,5.34,48,269,2463,8.9
4176,Bryon Baltimore,1982-83,30.0,4,0,2,2,0,0,0,2.0,,2,0,0,0,2.0,80,7.03,61,280,2352,12.0
4177,Bubba Berenzweig,2002-03,25.0,4,0,2,2,0,0,0,3.0,35.0,2,0,0,0,3.0,82,5.49,53,331,2294,9.8
4178,Bubba Berenzweig,2003-04,26.0,5,0,5,5,0,0,0,0.0,60.0,7,0,0,0,3.0,82,5.51,63,376,2272,9.9
4179,Bubba Berenzweig,2004-05,27.0,6,10,26,26,3,7,10,27.0,357.0,33,3,7,10,30.0,82,5.24,53,338,2262,9.5
4180,Bubba Berenzweig,2005-06,28.0,7,0,4,4,0,0,0,5.0,71.0,37,3,7,10,35.0,82,5.31,60,363,2326,9.4
4181,Bud Holloway,2018-19,30.0,4,0,1,1,0,0,0,1.0,7.0,1,0,0,0,1.0,82,5.34,48,255,2438,9.0
4182,Buddy Robinson,2018-19,27.0,4,2,3,3,1,1,2,5.0,26.0,3,1,1,2,5.0,82,5.34,48,255,2438,9.0
4183,Buddy Robinson,2019-20,28.0,5,0,4,4,0,0,0,4.0,28.0,7,1,1,2,9.0,82,5.45,47,245,2478,9.0
4184,Buddy Robinson,2022-23,31.0,6,1,5,5,1,0,1,6.0,61.0,12,2,1,3,15.0,70,5.96,42,208,2192,9.5
4185,Burke Henry,2005-06,27.0,4,2,16,16,0,2,2,25.0,297.0,16,0,2,2,25.0,82,5.31,60,363,2326,9.4
4186,Burke Henry,2006-07,28.0,5,6,23,23,2,4,6,31.0,392.0,39,2,6,8,56.0,82,5.14,57,348,2300,9.2
4187,Byron Bitz,2011-12,27.0,4,7,35,35,4,3,7,31.0,363.0,35,4,3,7,31.0,82,5.7,65,341,2477,9.4
4188,Byron Bitz,2012-13,28.0,5,11,52,52,5,6,11,58.0,574.0,87,9,9,18,89.0,82,5.53,56,304,2486,9.1
4189,Byron Bitz,2014-15,30.0,6,4,10,10,1,3,4,6.0,105.0,97,10,12,22,95.0,82,5.32,47,271,2439,8.9
4190,Byron Froese,2018-19,27.0,4,5,56,56,2,3,5,64.0,707.0,56,2,3,5,64.0,82,5.34,48,255,2438,9.0
4191,Byron Froese,2019-20,28.0,5,0,6,6,0,0,0,6.0,63.0,62,2,3,5,70.0,82,5.45,47,245,2478,9.0
4192,Byron Froese,2020-21,29.0,6,11,48,48,3,8,11,49.0,556.0,110,5,11,16,119.0,82,5.86,50,250,2620,9.2
4193,Byron Ritchie,2001-02,24.0,4,0,3,3,0,0,0,0.0,10.0,3,0,0,0,0.0,82,5.27,57,359,2285,9.4
4194,Byron Ritchie,2002-03,25.0,5,2,26,26,0,2,2,13.0,193.0,29,0,2,2,13.0,82,5.49,53,331,2294,9.8
4195,Byron Ritchie,2004-05,27.0,6,11,35,35,5,6,11,60.0,431.0,64,5,8,13,73.0,82,5.24,53,338,2262,9.5
4196,Byron Ritchie,2005-06,28.0,7,3,30,30,0,3,3,29.0,279.0,94,5,11,16,102.0,82,5.31,60,363,2326,9.4
4197,Byron Ritchie,2006-07,29.0,8,11,50,50,5,6,11,65.0,695.0,144,10,17,27,167.0,82,5.14,57,348,2300,9.2
4198,Byron Ritchie,2008-09,31.0,9,6,45,45,4,2,6,34.0,444.0,189,14,19,33,201.0,82,6.05,85,480,2458,10.1
4199,Byron Ritchie,2009-10,32.0,10,14,64,64,8,6,14,46.0,625.0,253,22,25,47,247.0,82,5.76,70,398,2426,9.7
4200,Byron Ritchie,2010-11,33.0,11,11,71,71,3,8,11,73.0,875.0,324,25,33,58,320.0,82,5.44,62,351,2383,9.4
4201,C.J. Smith,2019-20,25.0,4,1,2,2,0,1,1,2.0,23.0,2,0,1,1,2.0,82,5.45,47,245,2478,9.0
4202,C.J. Smith,2021-22,27.0,5,2,11,11,2,0,2,18.0,117.0,13,2,1,3,20.0,82,5.96,47,239,2579,9.5
4203,C.J. Suess,2022-23,28.0,4,0,1,1,0,0,0,0.0,6.0,1,0,0,0,0.0,70,5.96,42,208,2192,9.5
4204,C.J. Young,1995-96,28.0,4,14,43,43,7,7,14,43.0,,43,7,7,14,43.0,84,7.25,87,443,2603,11.7
4205,Cade Fairchild,2014-15,26.0,4,1,5,5,0,1,1,1.0,48.0,5,0,1,1,1.0,82,5.32,47,271,2439,8.9
4206,Cal Clutterbuck,2010-11,23.0,4,0,2,2,0,0,0,0.0,14.0,2,0,0,0,0.0,82,5.44,62,351,2383,9.4
4207,Cal Clutterbuck,2011-12,24.0,5,18,78,78,11,7,18,136.0,1014.0,80,11,7,18,136.0,82,5.7,65,341,2477,9.4
4208,Cal Clutterbuck,2012-13,25.0,6,21,74,74,13,8,21,136.0,1057.0,154,24,15,39,272.0,82,5.53,56,304,2486,9.1
4209,Cal Clutterbuck,2013-14,26.0,7,34,76,76,19,15,34,191.0,1204.0,230,43,30,73,463.0,82,5.46,52,291,2492,9.0
4210,Cal Clutterbuck,2014-15,27.0,8,27,74,74,15,12,27,161.0,1210.0,304,58,42,100,624.0,82,5.32,47,271,2439,8.9
4211,Cal Clutterbuck,2015-16,28.0,9,10,42,42,4,6,10,87.0,577.0,346,62,48,110,711.0,48,5.31,29,160,1399,9.1
4212,Cal Clutterbuck,2016-17,29.0,10,19,73,73,12,7,19,172.0,1046.0,419,74,55,129,883.0,82,5.34,48,269,2463,8.9
4213,Cal Clutterbuck,2017-18,30.0,11,16,76,76,7,9,16,124.0,967.0,495,81,64,145,1007.0,82,5.32,47,251,2453,8.9
4214,Cal Clutterbuck,2018-19,31.0,12,23,77,77,15,8,23,80.0,918.0,572,96,72,168,1087.0,82,5.34,48,255,2438,9.0
4215,Cal Clutterbuck,2019-20,32.0,13,20,66,66,5,15,20,115.0,924.0,638,101,87,188,1202.0,82,5.45,47,245,2478,9.0
4216,Cal Clutterbuck,2020-21,33.0,14,18,76,76,8,10,18,101.0,972.0,714,109,97,206,1303.0,82,5.86,50,250,2620,9.2
4217,Cal Clutterbuck,2021-22,34.0,15,23,73,73,8,15,23,95.0,1020.0,787,117,112,229,1398.0,82,5.96,47,239,2579,9.5
4218,Cal Clutterbuck,2022-23,35.0,16,7,37,37,3,4,7,35.0,497.0,824,120,116,236,1433.0,70,5.96,42,208,2192,9.5
4219,Cal O'Reilly,2011-12,25.0,4,5,11,11,3,2,5,6.0,139.0,11,3,2,5,6.0,82,5.7,65,341,2477,9.4
4220,Cal O'Reilly,2012-13,26.0,5,11,31,31,2,9,11,23.0,423.0,42,5,11,16,29.0,82,5.53,56,304,2486,9.1
4221,Cal O'Reilly,2013-14,27.0,6,18,38,38,6,12,18,44.0,642.0,80,11,23,34,73.0,82,5.46,52,291,2492,9.0
4222,Cal O'Reilly,2014-15,28.0,7,7,33,33,2,5,7,17.0,421.0,113,13,28,41,90.0,82,5.32,47,271,2439,8.9
4223,Cal O'Reilly,2018-19,32.0,8,7,20,20,3,4,7,10.0,224.0,133,16,32,48,100.0,82,5.34,48,255,2438,9.0
4224,Cal O'Reilly,2019-20,33.0,9,1,11,11,0,1,1,3.0,87.0,144,16,33,49,103.0,82,5.45,47,245,2478,9.0
4225,Cal O'Reilly,2020-21,34.0,10,0,1,1,0,0,0,1.0,8.0,145,16,33,49,104.0,82,5.86,50,250,2620,9.2
4226,Cale Fleury,2022-23,24.0,4,1,41,41,1,0,1,45.0,588.0,41,1,0,1,45.0,70,5.96,42,208,2192,9.5
4227,Cale Hulse,1998-99,25.0,4,0,11,11,0,0,0,9.0,,11,0,0,0,9.0,82,6.29,74,413,2481,10.4
4228,Cale Hulse,1999-00,26.0,5,7,63,63,1,6,7,58.0,,74,1,6,7,67.0,82,5.83,55,336,2444,9.8
4229,Cale Hulse,2000-01,27.0,6,27,79,79,5,22,27,117.0,,153,6,28,34,184.0,82,5.28,57,380,2242,9.6
4230,Cale Hulse,2001-02,28.0,7,12,73,73,3,9,12,83.0,1214.0,226,9,37,46,267.0,82,5.27,57,359,2285,9.4
4231,Cale Hulse,2002-03,29.0,8,7,47,47,1,6,7,41.0,594.0,273,10,43,53,308.0,82,5.49,53,331,2294,9.8
4232,Cale Hulse,2003-04,30.0,9,8,82,82,1,7,8,93.0,1647.0,355,11,50,61,401.0,82,5.51,63,376,2272,9.9
4233,Cale Hulse,2004-05,31.0,10,2,63,63,0,2,2,70.0,1188.0,418,11,52,63,471.0,82,5.24,53,338,2262,9.5
4234,Cale Hulse,2005-06,32.0,11,8,80,80,2,6,8,82.0,1527.0,498,13,58,71,553.0,82,5.31,60,363,2326,9.4
4235,Cale Hulse,2006-07,33.0,12,20,82,82,3,17,20,115.0,1760.0,580,16,75,91,668.0,82,5.14,57,348,2300,9.2
4236,Cale Hulse,2008-09,35.0,13,4,39,39,0,4,4,34.0,596.0,619,16,79,95,702.0,82,6.05,85,480,2458,10.1
4237,Cale Makar,2022-23,24.0,4,50,57,57,12,38,50,121.0,1198.0,57,12,38,50,121.0,70,5.96,42,208,2192,9.5
4238,Caleb Jones,2021-22,24.0,4,6,17,17,1,5,6,21.0,337.0,17,1,5,6,21.0,82,5.96,47,239,2579,9.5
4239,Caleb Jones,2022-23,25.0,5,9,43,43,4,5,9,38.0,608.0,60,5,10,15,59.0,70,5.96,42,208,2192,9.5
4240,Calle Jarnkrok,2016-17,25.0,4,9,12,12,2,7,9,13.0,169.0,12,2,7,9,13.0,82,5.34,48,269,2463,8.9
4241,Calle Jarnkrok,2017-18,26.0,5,18,74,74,7,11,18,95.0,951.0,86,9,18,27,108.0,82,5.32,47,251,2453,8.9
4242,Calle Jarnkrok,2018-19,27.0,6,30,81,81,16,14,30,125.0,1307.0,167,25,32,57,233.0,82,5.34,48,255,2438,9.0
4243,Calle Jarnkrok,2019-20,28.0,7,31,81,81,15,16,31,134.0,1274.0,248,40,48,88,367.0,82,5.45,47,245,2478,9.0
4244,Calle Jarnkrok,2020-21,29.0,8,35,68,68,16,19,35,105.0,1080.0,316,56,67,123,472.0,82,5.86,50,250,2620,9.2
4245,Calle Jarnkrok,2021-22,30.0,9,26,79,79,10,16,26,106.0,1219.0,395,66,83,149,578.0,82,5.96,47,239,2579,9.5
4246,Calle Jarnkrok,2022-23,31.0,10,34,64,64,15,19,34,136.0,1020.0,459,81,102,183,714.0,70,5.96,42,208,2192,9.5
4247,Calle Johansson,1990-91,23.0,4,42,71,71,4,38,42,93.0,,71,4,38,42,93.0,80,7.43,89,437,2435,12.2
4248,Calle Johansson,1991-92,24.0,5,21,59,59,3,18,21,75.0,,130,7,56,63,168.0,80,7.48,85,403,2430,12.3
4249,Calle Johansson,1992-93,25.0,6,39,70,70,8,31,39,103.0,,200,15,87,102,271.0,80,7.37,76,367,2421,12.2
4250,Calle Johansson,1993-94,26.0,7,52,80,80,11,41,52,128.0,,280,26,128,154,399.0,80,6.91,71,366,2385,11.6
4251,Calle Johansson,1994-95,27.0,8,56,80,80,14,42,56,119.0,,360,40,170,210,518.0,80,6.96,77,402,2440,11.4
4252,Calle Johansson,1995-96,28.0,9,45,77,77,7,38,45,133.0,,437,47,208,255,651.0,84,7.25,87,443,2603,11.7
4253,Calle Johansson,1996-97,29.0,10,42,84,84,9,33,42,141.0,,521,56,241,297,792.0,84,6.48,76,407,2545,10.7
4254,Calle Johansson,1997-98,30.0,11,31,46,46,5,26,31,112.0,,567,61,267,328,904.0,48,5.97,37,209,1408,10.2
4255,Calle Johansson,1998-99,31.0,12,35,78,78,10,25,35,182.0,,645,71,292,363,1086.0,82,6.29,74,413,2481,10.4
4256,Calle Johansson,1999-00,32.0,13,17,65,65,6,11,17,133.0,,710,77,303,380,1219.0,82,5.83,55,336,2444,9.8
4257,Calle Johansson,2000-01,33.0,14,35,73,73,15,20,35,163.0,,783,92,323,415,1382.0,82,5.28,57,380,2242,9.6
4258,Calle Johansson,2001-02,34.0,15,29,67,67,8,21,29,145.0,1606.0,850,100,344,444,1527.0,82,5.27,57,359,2285,9.4
4259,Calle Johansson,2002-03,35.0,16,32,82,82,7,25,32,138.0,1961.0,932,107,369,476,1665.0,82,5.49,53,331,2294,9.8
4260,Calle Johansson,2003-04,36.0,17,36,76,76,7,29,36,154.0,1804.0,1008,114,398,512,1819.0,82,5.51,63,376,2272,9.9
4261,Calle Johansson,2004-05,37.0,18,2,11,11,2,0,2,18.0,233.0,1019,116,398,514,1837.0,82,5.24,53,338,2262,9.5
4262,Calle Johansson,2005-06,38.0,19,15,82,82,3,12,15,77.0,1784.0,1101,119,410,529,1914.0,82,5.31,60,363,2326,9.4
4263,Calle Johansson,2006-07,39.0,20,6,8,8,0,6,6,8.0,140.0,1109,119,416,535,1922.0,82,5.14,57,348,2300,9.2
4264,Calle Rosen,2020-21,26.0,4,1,4,4,0,1,1,5.0,51.0,4,0,1,1,5.0,82,5.86,50,250,2620,9.2
4265,Calle Rosen,2021-22,27.0,5,1,4,4,1,0,1,5.0,67.0,8,1,1,2,10.0,82,5.96,47,239,2579,9.5
4266,Calle Rosen,2022-23,28.0,6,3,12,12,0,3,3,14.0,163.0,20,1,4,5,24.0,70,5.96,42,208,2192,9.5
4267,Calvin Thurkauf,2022-23,25.0,4,0,3,3,0,0,0,1.0,25.0,3,0,0,0,1.0,70,5.96,42,208,2192,9.5
4268,Calvin de Haan,2014-15,23.0,4,0,1,1,0,0,0,2.0,13.0,1,0,0,0,2.0,82,5.32,47,271,2439,8.9
4269,Calvin de Haan,2016-17,25.0,5,16,51,51,3,13,16,71.0,1072.0,52,3,13,16,73.0,82,5.34,48,269,2463,8.9
4270,Calvin de Haan,2017-18,26.0,6,12,65,65,1,11,12,92.0,1236.0,117,4,24,28,165.0,82,5.32,47,251,2453,8.9
4271,Calvin de Haan,2018-19,27.0,7,16,72,72,2,14,16,102.0,1486.0,189,6,38,44,267.0,82,5.34,48,255,2438,9.0
4272,Calvin de Haan,2019-20,28.0,8,25,82,82,5,20,25,116.0,1628.0,271,11,58,69,383.0,82,5.45,47,245,2478,9.0
4273,Calvin de Haan,2020-21,29.0,9,12,33,33,1,11,12,44.0,619.0,304,12,69,81,427.0,82,5.86,50,250,2620,9.2
4274,Calvin de Haan,2021-22,30.0,10,14,74,74,1,13,14,102.0,1370.0,378,13,82,95,529.0,82,5.96,47,239,2579,9.5
4275,Calvin de Haan,2022-23,31.0,11,6,29,29,1,5,6,42.0,577.0,407,14,87,101,571.0,70,5.96,42,208,2192,9.5
4276,Cam Atkinson,2014-15,25.0,4,14,27,27,7,7,14,66.0,415.0,27,7,7,14,66.0,82,5.32,47,271,2439,8.9
4277,Cam Atkinson,2015-16,26.0,5,18,35,35,9,9,18,91.0,546.0,62,16,16,32,157.0,48,5.31,29,160,1399,9.1
4278,Cam Atkinson,2016-17,27.0,6,40,79,79,21,19,40,216.0,1247.0,141,37,35,72,373.0,82,5.34,48,269,2463,8.9
4279,Cam Atkinson,2017-18,28.0,7,40,78,78,22,18,40,212.0,1325.0,219,59,53,112,585.0,82,5.32,47,251,2453,8.9
4280,Cam Atkinson,2018-19,29.0,8,53,81,81,27,26,53,226.0,1442.0,300,86,79,165,811.0,82,5.34,48,255,2438,9.0
4281,Cam Atkinson,2019-20,30.0,9,62,82,82,35,27,62,240.0,1483.0,382,121,106,227,1051.0,82,5.45,47,245,2478,9.0
4282,Cam Atkinson,2020-21,31.0,10,46,65,65,24,22,46,231.0,1229.0,447,145,128,273,1282.0,82,5.86,50,250,2620,9.2
4283,Cam Atkinson,2021-22,32.0,11,69,80,80,41,28,69,295.0,1550.0,527,186,156,342,1577.0,82,5.96,47,239,2579,9.5
4284,Cam Atkinson,2022-23,33.0,12,26,44,44,12,14,26,148.0,785.0,571,198,170,368,1725.0,70,5.96,42,208,2192,9.5
4285,Cam Barker,2008-09,22.0,4,0,1,1,0,0,0,1.0,11.0,1,0,0,0,1.0,82,6.05,85,480,2458,10.1
4286,Cam Barker,2009-10,23.0,5,8,35,35,1,7,8,38.0,676.0,36,1,7,8,39.0,82,5.76,70,398,2426,9.7
4287,Cam Barker,2010-11,24.0,6,18,45,45,6,12,18,42.0,774.0,81,7,19,26,81.0,82,5.44,62,351,2383,9.4
4288,Cam Barker,2011-12,25.0,7,40,68,68,6,34,40,101.0,1247.0,149,13,53,66,182.0,82,5.7,65,341,2477,9.4
4289,Cam Barker,2012-13,26.0,8,21,70,70,5,16,21,105.0,1086.0,219,18,69,87,287.0,82,5.53,56,304,2486,9.1
4290,Cam Barker,2013-14,27.0,9,5,52,52,1,4,5,44.0,853.0,271,19,73,92,331.0,82,5.46,52,291,2492,9.0
4291,Cam Barker,2014-15,28.0,10,2,25,25,2,0,2,35.0,459.0,296,21,73,94,366.0,82,5.32,47,271,2439,8.9
4292,Cam Barker,2015-16,29.0,11,2,14,14,0,2,2,19.0,199.0,310,21,75,96,385.0,48,5.31,29,160,1399,9.1
4293,Cam Brown,1993-94,24.0,4,0,1,1,0,0,0,0.0,,1,0,0,0,0.0,80,6.91,71,366,2385,11.6
4294,Cam Fowler,2013-14,22.0,4,40,76,76,10,30,40,123.0,1682.0,76,10,30,40,123.0,82,5.46,52,291,2492,9.0
4295,Cam Fowler,2014-15,23.0,5,29,82,82,5,24,29,123.0,1907.0,158,15,54,69,246.0,82,5.32,47,271,2439,8.9
4296,Cam Fowler,2015-16,24.0,6,11,37,37,1,10,11,50.0,756.0,195,16,64,80,296.0,48,5.31,29,160,1399,9.1
4297,Cam Fowler,2016-17,25.0,7,36,70,70,6,30,36,100.0,1670.0,265,22,94,116,396.0,82,5.34,48,269,2463,8.9
4298,Cam Fowler,2017-18,26.0,8,34,80,80,7,27,34,87.0,1692.0,345,29,121,150,483.0,82,5.32,47,251,2453,8.9
4299,Cam Fowler,2018-19,27.0,9,28,69,69,5,23,28,113.0,1572.0,414,34,144,178,596.0,82,5.34,48,255,2438,9.0
4300,Cam Fowler,2019-20,28.0,10,39,80,80,11,28,39,186.0,1988.0,494,45,172,217,782.0,82,5.45,47,245,2478,9.0
4301,Cam Fowler,2020-21,29.0,11,32,67,67,8,24,32,122.0,1665.0,561,53,196,249,904.0,82,5.86,50,250,2620,9.2
4302,Cam Fowler,2021-22,30.0,12,23,59,59,5,18,23,88.0,1379.0,620,58,214,272,992.0,82,5.96,47,239,2579,9.5
4303,Cam Fowler,2022-23,31.0,13,29,59,59,9,20,29,117.0,1297.0,679,67,234,301,1109.0,70,5.96,42,208,2192,9.5
4304,Cam Janssen,2008-09,24.0,4,0,47,47,0,0,0,10.0,222.0,47,0,0,0,10.0,82,6.05,85,480,2458,10.1
4305,Cam Janssen,2009-10,25.0,5,1,48,48,1,0,1,9.0,197.0,95,1,0,1,19.0,82,5.76,70,398,2426,9.7
4306,Cam Janssen,2010-11,26.0,6,1,12,12,0,1,1,9.0,85.0,107,1,1,2,28.0,82,5.44,62,351,2383,9.4
4307,Cam Janssen,2011-12,27.0,7,4,56,56,1,3,4,22.0,281.0,163,2,4,6,50.0,82,5.7,65,341,2477,9.4
4308,Cam Janssen,2012-13,28.0,8,0,43,43,0,0,0,11.0,203.0,206,2,4,6,61.0,82,5.53,56,304,2486,9.1
4309,Cam Janssen,2013-14,29.0,9,4,54,54,1,3,4,16.0,263.0,260,3,7,10,77.0,82,5.46,52,291,2492,9.0
4310,Cam Janssen,2014-15,30.0,10,1,48,48,0,1,1,17.0,225.0,308,3,8,11,94.0,82,5.32,47,271,2439,8.9
4311,Cam Janssen,2015-16,31.0,11,0,4,4,0,0,0,0.0,16.0,312,3,8,11,94.0,48,5.31,29,160,1399,9.1
4312,Cam Janssen,2016-17,32.0,12,3,24,24,3,0,3,11.0,118.0,336,6,8,14,105.0,82,5.34,48,269,2463,8.9
4313,Cam Neely,1986-87,21.0,4,31,56,56,16,15,31,87.0,,56,16,15,31,87.0,80,7.89,74,336,2448,12.9
4314,Cam Neely,1987-88,22.0,5,39,72,72,21,18,39,140.0,,128,37,33,70,227.0,80,7.77,71,321,2447,12.7
4315,Cam Neely,1988-89,23.0,6,34,73,73,14,20,34,113.0,,201,51,53,104,340.0,80,7.94,82,370,2484,12.8
4316,Cam Neely,1989-90,24.0,7,72,75,75,36,36,72,206.0,,276,87,89,176,546.0,80,7.34,72,344,2400,12.2
4317,Cam Neely,1990-91,25.0,8,69,69,69,42,27,69,207.0,,345,129,116,245,753.0,80,7.43,89,437,2435,12.2
4318,Cam Neely,1991-92,26.0,9,75,74,74,37,38,75,235.0,,419,166,154,320,988.0,80,7.48,85,403,2430,12.3
4319,Cam Neely,1992-93,27.0,10,92,76,76,55,37,92,271.0,,495,221,191,412,1259.0,80,7.37,76,367,2421,12.2
4320,Cam Neely,1993-94,28.0,11,91,69,69,51,40,91,262.0,,564,272,231,503,1521.0,80,6.91,71,366,2385,11.6
4321,Cam Neely,1994-95,29.0,12,12,9,9,9,3,12,30.0,,573,281,234,515,1551.0,80,6.96,77,402,2440,11.4
4322,Cam Neely,1995-96,30.0,13,18,13,13,11,7,18,45.0,,586,292,241,533,1596.0,84,7.25,87,443,2603,11.7
4323,Cam Neely,1996-97,31.0,14,74,49,49,50,24,74,185.0,,635,342,265,607,1781.0,84,6.48,76,407,2545,10.7
4324,Cam Neely,1997-98,32.0,15,41,42,42,27,14,41,178.0,,677,369,279,648,1959.0,48,5.97,37,209,1408,10.2
4325,Cam Neely,1998-99,33.0,16,46,49,49,26,20,46,191.0,,726,395,299,694,2150.0,82,6.29,74,413,2481,10.4
4326,Cam Paddock,2011-12,28.0,4,3,16,16,2,1,3,17.0,171.0,16,2,1,3,17.0,82,5.7,65,341,2477,9.4
4327,Cam Plante,1987-88,23.0,4,0,2,2,0,0,0,0.0,,2,0,0,0,0.0,80,7.77,71,321,2447,12.7
4328,Cam Russell,1992-93,24.0,4,1,19,19,0,1,1,10.0,,19,0,1,1,10.0,80,7.37,76,367,2421,12.2
4329,Cam Russell,1993-94,25.0,5,0,3,3,0,0,0,0.0,,22,0,1,1,10.0,80,6.91,71,366,2385,11.6
4330,Cam Russell,1994-95,26.0,6,0,19,19,0,0,0,9.0,,41,0,1,1,19.0,80,6.96,77,402,2440,11.4
4331,Cam Russell,1995-96,27.0,7,6,67,67,2,4,6,49.0,,108,2,5,7,68.0,84,7.25,87,443,2603,11.7
4332,Cam Russell,1996-97,28.0,8,8,67,67,1,7,8,41.0,,175,3,12,15,109.0,84,6.48,76,407,2545,10.7
4333,Cam Russell,1997-98,29.0,9,4,33,33,1,3,4,18.0,,208,4,15,19,127.0,48,5.97,37,209,1408,10.2
4334,Cam Russell,1998-99,30.0,10,4,61,61,2,2,4,22.0,,269,6,17,23,149.0,82,6.29,74,413,2481,10.4
4335,Cam Russell,1999-00,31.0,11,2,44,44,1,1,2,19.0,,313,7,18,25,168.0,82,5.83,55,336,2444,9.8
4336,Cam Russell,2000-01,32.0,12,2,41,41,1,1,2,18.0,,354,8,19,27,186.0,82,5.28,57,380,2242,9.6
4337,Cam Russell,2001-02,33.0,13,3,42,42,1,2,3,15.0,479.0,396,9,21,30,201.0,82,5.27,57,359,2285,9.4
4338,Cam Severson,2005-06,28.0,4,0,2,2,0,0,0,1.0,13.0,2,0,0,0,1.0,82,5.31,60,363,2326,9.4
4339,Cam Severson,2006-07,29.0,5,3,31,31,3,0,3,24.0,228.0,33,3,0,3,25.0,82,5.14,57,348,2300,9.2
4340,Cam Severson,2008-09,31.0,6,0,4,4,0,0,0,2.0,12.0,37,3,0,3,27.0,82,6.05,85,480,2458,10.1
4341,Cam Stewart,1996-97,25.0,4,9,57,57,3,6,9,55.0,,57,3,6,9,55.0,84,6.48,76,407,2545,10.7
4342,Cam Stewart,1997-98,26.0,5,0,5,5,0,0,0,2.0,,62,3,6,9,57.0,48,5.97,37,209,1408,10.2
4343,Cam Stewart,1998-99,27.0,6,0,6,6,0,0,0,2.0,,68,3,6,9,59.0,82,6.29,74,413,2481,10.4
4344,Cam Stewart,1999-00,28.0,7,1,15,15,0,1,1,21.0,,83,3,7,10,80.0,82,5.83,55,336,2444,9.8
4345,Cam Stewart,2002-03,31.0,8,16,65,65,9,7,16,52.0,589.0,148,12,14,26,132.0,82,5.49,53,331,2294,9.8
4346,Cam Stewart,2003-04,32.0,9,13,54,54,4,9,13,61.0,713.0,202,16,23,39,193.0,82,5.51,63,376,2272,9.9
4347,Cameron Gaunce,2013-14,23.0,4,1,11,11,1,0,1,4.0,140.0,11,1,0,1,4.0,82,5.46,52,291,2492,9.0
4348,Cameron Gaunce,2016-17,26.0,5,0,9,9,0,0,0,9.0,125.0,20,1,0,1,13.0,82,5.34,48,269,2463,8.9
4349,Cameron Gaunce,2019-20,29.0,6,4,12,12,1,3,4,8.0,150.0,32,2,3,5,21.0,82,5.45,47,245,2478,9.0
4350,Cameron Gaunce,2021-22,31.0,7,0,2,2,0,0,0,2.0,31.0,34,2,3,5,23.0,82,5.96,47,239,2579,9.5
4351,Cameron Gaunce,2022-23,32.0,8,4,3,3,1,3,4,5.0,36.0,37,3,6,9,28.0,70,5.96,42,208,2192,9.5
4352,Cameron Hughes,2022-23,26.0,4,0,1,1,0,0,0,0.0,10.0,1,0,0,0,0.0,70,5.96,42,208,2192,9.5
4353,Cameron Mann,2000-01,23.0,4,1,9,9,0,1,1,6.0,,9,0,1,1,6.0,82,5.28,57,380,2242,9.6
4354,Cameron Mann,2001-02,24.0,5,7,33,33,5,2,7,42.0,352.0,42,5,3,8,48.0,82,5.27,57,359,2285,9.4
4355,Cameron Mann,2002-03,25.0,6,12,32,32,8,4,12,48.0,411.0,74,13,7,20,96.0,82,5.49,53,331,2294,9.8
4356,Cameron Mann,2003-04,26.0,7,4,15,15,1,3,4,17.0,127.0,89,14,10,24,113.0,82,5.51,63,376,2272,9.9
4357,Cameron Mann,2005-06,28.0,8,0,4,4,0,0,0,5.0,24.0,93,14,10,24,118.0,82,5.31,60,363,2326,9.4
4358,Cameron Schilling,2015-16,27.0,4,0,1,1,0,0,0,0.0,12.0,1,0,0,0,0.0,48,5.31,29,160,1399,9.1
4359,Cameron Schilling,2016-17,28.0,5,0,1,1,0,0,0,2.0,18.0,2,0,0,0,2.0,82,5.34,48,269,2463,8.9
4360,Cameron Schilling,2017-18,29.0,6,0,4,4,0,0,0,2.0,46.0,6,0,0,0,4.0,82,5.32,47,251,2453,8.9
4361,Cameron Schilling,2021-22,33.0,7,1,4,4,0,1,1,2.0,48.0,10,0,1,1,6.0,82,5.96,47,239,2579,9.5
4362,Carey Wilson,1986-87,24.0,4,7,15,15,2,5,7,11.0,,15,2,5,7,11.0,80,7.89,74,336,2448,12.9
4363,Carey Wilson,1987-88,25.0,5,72,74,74,24,48,72,128.0,,89,26,53,79,139.0,80,7.77,71,321,2447,12.7
4364,Carey Wilson,1988-89,26.0,6,58,76,76,29,29,58,149.0,,165,55,82,137,288.0,80,7.94,82,370,2484,12.8
4365,Carey Wilson,1989-90,27.0,7,56,80,80,20,36,56,140.0,,245,75,118,193,428.0,80,7.34,72,344,2400,12.2
4366,Carey Wilson,1990-91,28.0,8,68,70,70,27,41,68,138.0,,315,102,159,261,566.0,80,7.43,89,437,2435,12.2
4367,Carey Wilson,1991-92,29.0,9,77,75,75,32,45,77,164.0,,390,134,204,338,730.0,80,7.48,85,403,2430,12.3
4368,Carey Wilson,1992-93,30.0,10,26,41,41,9,17,26,64.0,,431,143,221,364,794.0,80,7.37,76,367,2421,12.2
4369,Carey Wilson,1993-94,31.0,11,29,57,57,11,18,29,79.0,,488,154,239,393,873.0,80,6.91,71,366,2385,11.6
4370,Carey Wilson,1994-95,32.0,12,23,42,42,11,12,23,74.0,,530,165,251,416,947.0,80,6.96,77,402,2440,11.4
4371,Carey Wilson,1995-96,33.0,13,11,22,22,4,7,11,30.0,,552,169,258,427,977.0,84,7.25,87,443,2603,11.7
4372,Carl Corazzini,2006-07,27.0,4,2,12,12,2,0,2,16.0,128.0,12,2,0,2,16.0,82,5.14,57,348,2300,9.2
4373,Carl Corazzini,2009-10,30.0,5,1,7,7,0,1,1,5.0,76.0,19,2,1,3,21.0,82,5.76,70,398,2426,9.7
4374,Carl Dahlstrom,2020-21,26.0,4,3,11,11,0,3,3,12.0,193.0,11,0,3,3,12.0,82,5.86,50,250,2620,9.2
4375,Carl Dahlstrom,2021-22,27.0,5,6,38,38,0,6,6,42.0,707.0,49,0,9,9,54.0,82,5.96,47,239,2579,9.5
4376,Carl Dahlstrom,2022-23,28.0,6,1,15,15,0,1,1,9.0,221.0,64,0,10,10,63.0,70,5.96,42,208,2192,9.5
4377,Carl Grundstrom,2021-22,24.0,4,6,15,15,5,1,6,26.0,225.0,15,5,1,6,26.0,82,5.96,47,239,2579,9.5
4378,Carl Grundstrom,2022-23,25.0,5,4,13,13,0,4,4,16.0,166.0,28,5,5,10,42.0,70,5.96,42,208,2192,9.5
4379,Carl Gunnarsson,2012-13,26.0,4,15,43,43,3,12,15,45.0,922.0,43,3,12,15,45.0,82,5.53,56,304,2486,9.1
4380,Carl Gunnarsson,2013-14,27.0,5,20,68,68,4,16,20,69.0,1240.0,111,7,28,35,114.0,82,5.46,52,291,2492,9.0
4381,Carl Gunnarsson,2014-15,28.0,6,19,76,76,4,15,19,89.0,1649.0,187,11,43,54,203.0,82,5.32,47,271,2439,8.9
4382,Carl Gunnarsson,2015-16,29.0,7,15,37,37,1,14,15,28.0,787.0,224,12,57,69,231.0,48,5.31,29,160,1399,9.1
4383,Carl Gunnarsson,2016-17,30.0,8,17,80,80,3,14,17,48.0,1553.0,304,15,71,86,279.0,82,5.34,48,269,2463,8.9
4384,Carl Gunnarsson,2017-18,31.0,9,12,61,61,2,10,12,54.0,1102.0,365,17,81,98,333.0,82,5.32,47,251,2453,8.9
4385,Carl Gunnarsson,2018-19,32.0,10,9,72,72,3,6,9,51.0,1251.0,437,20,87,107,384.0,82,5.34,48,255,2438,9.0
4386,Carl Gunnarsson,2019-20,33.0,11,6,56,56,0,6,6,32.0,761.0,493,20,93,113,416.0,82,5.45,47,245,2478,9.0
4387,Carl Gunnarsson,2020-21,34.0,12,9,63,63,5,4,9,59.0,1018.0,556,25,97,122,475.0,82,5.86,50,250,2620,9.2
4388,Carl Gunnarsson,2021-22,35.0,13,7,25,25,3,4,7,21.0,398.0,581,28,101,129,496.0,82,5.96,47,239,2579,9.5
4389,Carl Gunnarsson,2022-23,36.0,14,7,36,36,2,5,7,31.0,568.0,617,30,106,136,527.0,70,5.96,42,208,2192,9.5
4390,Carl Hagelin,2014-15,26.0,4,38,64,64,14,24,38,131.0,963.0,64,14,24,38,131.0,82,5.32,47,271,2439,8.9
4391,Carl Hagelin,2015-16,27.0,5,24,48,48,10,14,24,132.0,831.0,112,24,38,62,263.0,48,5.31,29,160,1399,9.1
4392,Carl Hagelin,2016-17,28.0,6,33,72,72,17,16,33,144.0,1117.0,184,41,54,95,407.0,82,5.34,48,269,2463,8.9
4393,Carl Hagelin,2017-18,29.0,7,35,82,82,17,18,35,185.0,1249.0,266,58,72,130,592.0,82,5.32,47,251,2453,8.9
4394,Carl Hagelin,2018-19,30.0,8,39,80,80,14,25,39,178.0,1257.0,346,72,97,169,770.0,82,5.34,48,255,2438,9.0
4395,Carl Hagelin,2019-20,31.0,9,22,61,61,6,16,22,128.0,945.0,407,78,113,191,898.0,82,5.45,47,245,2478,9.0
4396,Carl Hagelin,2020-21,32.0,10,31,81,81,10,21,31,169.0,1291.0,488,88,134,222,1067.0,82,5.86,50,250,2620,9.2
4397,Carl Hagelin,2021-22,33.0,11,19,58,58,5,14,19,99.0,854.0,546,93,148,241,1166.0,82,5.96,47,239,2579,9.5
4398,Carl Hagelin,2022-23,34.0,12,25,58,58,8,17,25,107.0,831.0,604,101,165,266,1273.0,70,5.96,42,208,2192,9.5
4399,Carl Klingberg,2013-14,23.0,4,0,1,1,0,0,0,0.0,10.0,1,0,0,0,0.0,82,5.46,52,291,2492,9.0
4400,Carl Klingberg,2014-15,24.0,5,0,6,6,0,0,0,7.0,33.0,7,0,0,0,7.0,82,5.32,47,271,2439,8.9
4401,Carl Klingberg,2016-17,26.0,6,1,3,3,1,0,1,3.0,27.0,10,1,0,1,10.0,82,5.34,48,269,2463,8.9
4402,Carl Klingberg,2017-18,27.0,7,0,2,2,0,0,0,0.0,7.0,12,1,0,1,10.0,82,5.32,47,251,2453,8.9
4403,Carl Mokosak,1984-85,22.0,4,1,1,1,0,1,1,0.0,,1,0,1,1,0.0,80,8.03,73,320,2489,12.9
4404,Carl Mokosak,1985-86,23.0,5,13,41,41,7,6,13,38.0,,42,7,7,14,38.0,80,7.73,71,310,2444,12.7
4405,Carl Mokosak,1987-88,25.0,6,12,30,30,4,8,12,29.0,,72,11,15,26,67.0,80,7.77,71,321,2447,12.7
4406,Carl Mokosak,1988-89,26.0,7,0,1,1,0,0,0,0.0,,73,11,15,26,67.0,80,7.94,82,370,2484,12.8
4407,Carl Mokosak,1989-90,27.0,8,0,3,3,0,0,0,3.0,,76,11,15,26,70.0,80,7.34,72,344,2400,12.2
4408,Carl Mokosak,1991-92,29.0,9,0,7,7,0,0,0,3.0,,83,11,15,26,73.0,80,7.48,85,403,2430,12.3
4409,Carl Sneep,2014-15,27.0,4,1,1,1,0,1,1,0.0,16.0,1,0,1,1,0.0,82,5.32,47,271,2439,8.9
4410,Carl Soderberg,2015-16,30.0,4,2,6,6,0,2,2,6.0,88.0,6,0,2,2,6.0,48,5.31,29,160,1399,9.1
4411,Carl Soderberg,2016-17,31.0,5,48,73,73,16,32,48,129.0,1041.0,79,16,34,50,135.0,82,5.34,48,269,2463,8.9
4412,Carl Soderberg,2017-18,32.0,6,44,82,82,13,31,44,163.0,1378.0,161,29,65,94,298.0,82,5.32,47,251,2453,8.9
4413,Carl Soderberg,2018-19,33.0,7,51,82,82,12,39,51,163.0,1477.0,243,41,104,145,461.0,82,5.34,48,255,2438,9.0
4414,Carl Soderberg,2019-20,34.0,8,14,80,80,6,8,14,128.0,1076.0,323,47,112,159,589.0,82,5.45,47,245,2478,9.0
4415,Carl Soderberg,2020-21,35.0,9,37,77,77,16,21,37,150.0,1336.0,400,63,133,196,739.0,82,5.86,50,250,2620,9.2
4416,Carl Soderberg,2021-22,36.0,10,49,82,82,23,26,49,188.0,1431.0,482,86,159,245,927.0,82,5.96,47,239,2579,9.5
4417,Carl Soderberg,2022-23,37.0,11,35,70,70,17,18,35,135.0,1113.0,552,103,177,280,1062.0,70,5.96,42,208,2192,9.5
4418,Carlo Colaiacovo,2005-06,23.0,4,1,2,2,0,1,1,1.0,27.0,2,0,1,1,1.0,82,5.31,60,363,2326,9.4
4419,Carlo Colaiacovo,2006-07,24.0,5,1,2,2,0,1,1,0.0,28.0,4,0,2,2,1.0,82,5.14,57,348,2300,9.2
4420,Carlo Colaiacovo,2008-09,26.0,6,7,21,21,2,5,7,21.0,324.0,25,2,7,9,22.0,82,6.05,85,480,2458,10.1
4421,Carlo Colaiacovo,2009-10,27.0,7,17,48,48,8,9,17,60.0,862.0,73,10,16,26,82.0,82,5.76,70,398,2426,9.7
4422,Carlo Colaiacovo,2010-11,28.0,8,6,28,28,2,4,6,30.0,488.0,101,12,20,32,112.0,82,5.44,62,351,2383,9.4
4423,Carlo Colaiacovo,2011-12,29.0,9,30,73,73,3,27,30,87.0,1333.0,174,15,47,62,199.0,82,5.7,65,341,2477,9.4
4424,Carlo Colaiacovo,2012-13,30.0,10,32,67,67,7,25,32,74.0,1159.0,241,22,72,94,273.0,82,5.53,56,304,2486,9.1
4425,Carlo Colaiacovo,2013-14,31.0,11,26,65,65,6,20,26,81.0,1179.0,306,28,92,120,354.0,82,5.46,52,291,2492,9.0
4426,Carlo Colaiacovo,2014-15,32.0,12,19,64,64,2,17,19,68.0,1216.0,370,30,109,139,422.0,82,5.32,47,271,2439,8.9
4427,Carlo Colaiacovo,2015-16,33.0,13,1,6,6,0,1,1,12.0,113.0,376,30,110,140,434.0,48,5.31,29,160,1399,9.1
4428,Carlo Colaiacovo,2016-17,34.0,14,4,25,25,1,3,4,18.0,379.0,401,31,113,144,452.0,82,5.34,48,269,2463,8.9
4429,Carlo Colaiacovo,2017-18,35.0,15,8,33,33,2,6,8,42.0,544.0,434,33,119,152,494.0,82,5.32,47,251,2453,8.9
4430,Carlo Colaiacovo,2018-19,36.0,16,5,36,36,1,4,5,29.0,521.0,470,34,123,157,523.0,82,5.34,48,255,2438,9.0
4431,Carsen Germyn,2008-09,26.0,4,0,2,2,0,0,0,2.0,10.0,2,0,0,0,2.0,82,6.05,85,480,2458,10.1
4432,Carsen Germyn,2009-10,27.0,5,0,2,2,0,0,0,3.0,17.0,4,0,0,0,5.0,82,5.76,70,398,2426,9.7
4433,Carsen Twarynski,2022-23,25.0,4,1,15,15,1,0,1,14.0,160.0,15,1,0,1,14.0,70,5.96,42,208,2192,9.5
4434,Carson McMillan,2013-14,25.0,4,2,4,4,1,1,2,5.0,37.0,4,1,1,2,5.0,82,5.46,52,291,2492,9.0
4435,Carson McMillan,2014-15,26.0,5,3,11,11,1,2,3,8.0,122.0,15,2,3,5,13.0,82,5.32,47,271,2439,8.9
4436,Carson McMillan,2016-17,28.0,6,0,1,1,0,0,0,0.0,8.0,16,2,3,5,13.0,82,5.34,48,269,2463,8.9
4437,Carson Soucy,2020-21,26.0,4,0,3,3,0,0,0,4.0,45.0,3,0,0,0,4.0,82,5.86,50,250,2620,9.2
4438,Carson Soucy,2022-23,28.0,5,14,55,55,7,7,14,61.0,860.0,58,7,7,14,65.0,70,5.96,42,208,2192,9.5
4439,Carter Ashton,2014-15,23.0,4,0,15,15,0,0,0,22.0,156.0,15,0,0,0,22.0,82,5.32,47,271,2439,8.9
4440,Carter Ashton,2016-17,25.0,5,3,32,32,0,3,3,23.0,201.0,47,0,3,3,45.0,82,5.34,48,269,2463,8.9
4441,Carter Ashton,2017-18,26.0,6,0,7,7,0,0,0,4.0,44.0,54,0,3,3,49.0,82,5.32,47,251,2453,8.9
4442,Carter Bancks,2015-16,26.0,4,0,2,2,0,0,0,0.0,29.0,2,0,0,0,0.0,48,5.31,29,160,1399,9.1
4443,Carter Camper,2014-15,26.0,4,1,3,3,1,0,1,1.0,20.0,3,1,0,1,1.0,82,5.32,47,271,2439,8.9
4444,Carter Rowney,2019-20,30.0,4,7,27,27,3,4,7,24.0,296.0,27,3,4,7,24.0,82,5.45,47,245,2478,9.0
4445,Carter Rowney,2020-21,31.0,5,5,44,44,2,3,5,21.0,411.0,71,5,7,12,45.0,82,5.86,50,250,2620,9.2
4446,Carter Rowney,2021-22,32.0,6,20,62,62,7,13,20,53.0,778.0,133,12,20,32,98.0,82,5.96,47,239,2579,9.5
4447,Carter Rowney,2022-23,33.0,7,19,71,71,8,11,19,63.0,910.0,204,20,31,51,161.0,70,5.96,42,208,2192,9.5
4448,Carter Verhaeghe,2022-23,27.0,4,13,52,52,9,4,13,57.0,487.0,52,9,4,13,57.0,70,5.96,42,208,2192,9.5
4449,Casey Bailey,2017-18,26.0,4,1,6,6,1,0,1,9.0,54.0,6,1,0,1,9.0,82,5.32,47,251,2453,8.9
4450,Casey Bailey,2019-20,28.0,5,0,7,7,0,0,0,10.0,56.0,13,1,0,1,19.0,82,5.45,47,245,2478,9.0
4451,Casey Borer,2010-11,25.0,4,3,11,11,1,2,3,5.0,168.0,11,1,2,3,5.0,82,5.44,62,351,2383,9.4
4452,Casey Borer,2011-12,26.0,5,0,3,3,0,0,0,0.0,33.0,14,1,2,3,5.0,82,5.7,65,341,2477,9.4
4453,Casey Borer,2012-13,27.0,6,0,2,2,0,0,0,0.0,22.0,16,1,2,3,5.0,82,5.53,56,304,2486,9.1
4454,Casey Cizikas,2014-15,23.0,4,4,15,15,0,4,4,12.0,159.0,15,0,4,4,12.0,82,5.32,47,271,2439,8.9
4455,Casey Cizikas,2015-16,24.0,5,15,45,45,6,9,15,45.0,485.0,60,6,13,19,57.0,48,5.31,29,160,1399,9.1
4456,Casey Cizikas,2016-17,25.0,6,16,80,80,6,10,16,79.0,1070.0,140,12,23,35,136.0,82,5.34,48,269,2463,8.9
4457,Casey Cizikas,2017-18,26.0,7,18,70,70,9,9,18,90.0,876.0,210,21,32,53,226.0,82,5.32,47,251,2453,8.9
4458,Casey Cizikas,2018-19,27.0,8,29,80,80,8,21,29,84.0,1015.0,290,29,53,82,310.0,82,5.34,48,255,2438,9.0
4459,Casey Cizikas,2019-20,28.0,9,25,59,59,8,17,25,82.0,821.0,349,37,70,107,392.0,82,5.45,47,245,2478,9.0
4460,Casey Cizikas,2020-21,29.0,10,17,64,64,7,10,17,74.0,846.0,413,44,80,124,466.0,82,5.86,50,250,2620,9.2
4461,Casey Cizikas,2021-22,30.0,11,33,73,73,20,13,33,111.0,1024.0,486,64,93,157,577.0,82,5.96,47,239,2579,9.5
4462,Casey Cizikas,2022-23,31.0,12,14,48,48,10,4,14,67.0,686.0,534,74,97,171,644.0,70,5.96,42,208,2192,9.5
4463,Casey Hankinson,2003-04,27.0,4,1,11,11,0,1,1,15.0,107.0,11,0,1,1,15.0,82,5.51,63,376,2272,9.9
4464,Casey Hankinson,2004-05,28.0,5,0,3,3,0,0,0,1.0,26.0,14,0,1,1,16.0,82,5.24,53,338,2262,9.5
4465,Casey Hankinson,2006-07,30.0,6,0,4,4,0,0,0,0.0,25.0,18,0,1,1,16.0,82,5.14,57,348,2300,9.2
4466,Casey Mittelstadt,2020-21,22.0,4,5,6,6,1,4,5,9.0,84.0,6,1,4,5,9.0,82,5.86,50,250,2620,9.2
4467,Casey Mittelstadt,2021-22,23.0,5,25,77,77,12,13,25,118.0,1036.0,83,13,17,30,127.0,82,5.96,47,239,2579,9.5
4468,Casey Mittelstadt,2022-23,24.0,6,9,31,31,4,5,9,34.0,396.0,114,17,22,39,161.0,70,5.96,42,208,2192,9.5
4469,Casey Nelson,2018-19,26.0,4,4,7,7,0,4,4,5.0,104.0,7,0,4,4,5.0,82,5.34,48,255,2438,9.0
4470,Casey Nelson,2019-20,27.0,5,0,11,11,0,0,0,10.0,139.0,18,0,4,4,15.0,82,5.45,47,245,2478,9.0
4471,Casey Nelson,2020-21,28.0,6,8,37,37,3,5,8,48.0,695.0,55,3,9,12,63.0,82,5.86,50,250,2620,9.2
4472,Casey Nelson,2021-22,29.0,7,6,38,38,1,5,6,37.0,586.0,93,4,14,18,100.0,82,5.96,47,239,2579,9.5
4473,Casey Wellman,2012-13,25.0,4,4,12,12,1,3,4,18.0,145.0,12,1,3,4,18.0,82,5.53,56,304,2486,9.1
4474,Casey Wellman,2013-14,26.0,5,2,15,15,1,1,2,20.0,160.0,27,2,4,6,38.0,82,5.46,52,291,2492,9.0
4475,Casey Wellman,2014-15,27.0,6,7,14,14,2,5,7,25.0,178.0,41,4,9,13,63.0,82,5.32,47,271,2439,8.9
4476,Casey Wellman,2016-17,29.0,7,3,13,13,2,1,3,15.0,122.0,54,6,10,16,78.0,82,5.34,48,269,2463,8.9
4477,Cedric Paquette,2016-17,23.0,4,1,2,2,0,1,1,1.0,29.0,2,0,1,1,1.0,82,5.34,48,269,2463,8.9
4478,Cedric Paquette,2017-18,24.0,5,19,64,64,12,7,19,91.0,871.0,66,12,8,20,92.0,82,5.32,47,251,2453,8.9
4479,Cedric Paquette,2018-19,25.0,6,11,56,56,6,5,11,50.0,713.0,122,18,13,31,142.0,82,5.34,48,255,2438,9.0
4480,Cedric Paquette,2019-20,26.0,7,10,58,58,4,6,10,68.0,668.0,180,22,19,41,210.0,82,5.45,47,245,2478,9.0
4481,Cedric Paquette,2020-21,27.0,8,9,56,56,5,4,9,64.0,572.0,236,27,23,50,274.0,82,5.86,50,250,2620,9.2
4482,Cedric Paquette,2021-22,28.0,9,17,80,80,13,4,17,87.0,960.0,316,40,27,67,361.0,82,5.96,47,239,2579,9.5
4483,Cedric Paquette,2022-23,29.0,10,18,61,61,7,11,18,78.0,796.0,377,47,38,85,439.0,70,5.96,42,208,2192,9.5
4484,Chad Billins,2016-17,27.0,4,3,10,10,0,3,3,3.0,122.0,10,0,3,3,3.0,82,5.34,48,269,2463,8.9
4485,Chad Kilger,1998-99,22.0,4,17,74,74,7,10,17,57.0,,74,7,10,17,57.0,82,6.29,74,413,2481,10.4
4486,Chad Kilger,1999-00,23.0,5,7,24,24,4,3,7,30.0,,98,11,13,24,87.0,82,5.83,55,336,2444,9.8
4487,Chad Kilger,2000-01,24.0,6,12,32,32,3,9,12,32.0,,130,14,22,36,119.0,82,5.28,57,380,2242,9.6
4488,Chad Kilger,2001-02,25.0,7,27,77,77,15,12,27,81.0,1047.0,207,29,34,63,200.0,82,5.27,57,359,2285,9.4
4489,Chad Kilger,2002-03,26.0,8,5,40,40,3,2,5,32.0,342.0,247,32,36,68,232.0,82,5.49,53,331,2294,9.8
4490,Chad Kilger,2003-04,27.0,9,32,77,77,14,18,32,103.0,1054.0,324,46,54,100,335.0,82,5.51,63,376,2272,9.9
4491,Chad Kilger,2004-05,28.0,10,23,75,75,8,15,23,87.0,993.0,399,54,69,123,422.0,82,5.24,53,338,2262,9.5
4492,Chad Kilger,2005-06,29.0,11,16,60,60,9,7,16,60.0,642.0,459,63,76,139,482.0,82,5.31,60,363,2326,9.4
4493,Chad Kilger,2006-07,30.0,12,6,41,41,3,3,6,35.0,437.0,500,66,79,145,517.0,82,5.14,57,348,2300,9.2
4494,Chad Kilger,2008-09,32.0,13,28,79,79,17,11,28,103.0,980.0,579,83,90,173,620.0,82,6.05,85,480,2458,10.1
4495,Chad Kilger,2009-10,33.0,14,28,82,82,14,14,28,141.0,1189.0,661,97,104,201,761.0,82,5.76,70,398,2426,9.7
4496,Chad Kilger,2010-11,34.0,15,17,53,53,10,7,17,74.0,617.0,714,107,111,218,835.0,82,5.44,62,351,2383,9.4
4497,Chad Kolarik,2012-13,27.0,4,0,2,2,0,0,0,2.0,13.0,2,0,0,0,2.0,82,5.53,56,304,2486,9.1
4498,Chad Kolarik,2013-14,28.0,5,1,4,4,0,1,1,4.0,37.0,6,0,1,1,6.0,82,5.46,52,291,2492,9.0
4499,Chad Larose,2008-09,26.0,4,13,49,49,1,12,13,62.0,518.0,49,1,12,13,62.0,82,6.05,85,480,2458,10.1
4500,Chad Larose,2009-10,27.0,5,18,80,80,6,12,18,94.0,817.0,129,7,24,31,156.0,82,5.76,70,398,2426,9.7
4501,Chad Larose,2010-11,28.0,6,23,58,58,11,12,23,117.0,815.0,187,18,36,54,273.0,82,5.44,62,351,2383,9.4
4502,Chad Larose,2011-12,29.0,7,31,81,81,19,12,31,171.0,1226.0,268,37,48,85,444.0,82,5.7,65,341,2477,9.4
4503,Chad Larose,2012-13,30.0,8,28,56,56,11,17,28,138.0,879.0,324,48,65,113,582.0,82,5.53,56,304,2486,9.1
4504,Chad Larose,2013-14,31.0,9,31,82,82,16,15,31,176.0,1313.0,406,64,80,144,758.0,82,5.46,52,291,2492,9.0
4505,Chad Larose,2014-15,32.0,10,32,67,67,19,13,32,199.0,1123.0,473,83,93,176,957.0,82,5.32,47,271,2439,8.9
4506,Chad Larose,2015-16,33.0,11,4,35,35,2,2,4,65.0,450.0,508,85,95,180,1022.0,48,5.31,29,160,1399,9.1
4507,Chad Penney,1996-97,23.0,4,0,3,3,0,0,0,2.0,,3,0,0,0,2.0,84,6.48,76,407,2545,10.7
4508,Chad Rau,2014-15,28.0,4,2,9,9,2,0,2,7.0,98.0,9,2,0,2,7.0,82,5.32,47,271,2439,8.9
4509,Chad Ruhwedel,2015-16,25.0,4,0,7,7,0,0,0,8.0,99.0,7,0,0,0,8.0,48,5.31,29,160,1399,9.1
4510,Chad Ruhwedel,2016-17,26.0,5,1,21,21,0,1,1,35.0,375.0,28,0,1,1,43.0,82,5.34,48,269,2463,8.9
4511,Chad Ruhwedel,2017-18,27.0,6,1,4,4,0,1,1,4.0,50.0,32,0,2,2,47.0,82,5.32,47,251,2453,8.9
4512,Chad Ruhwedel,2018-19,28.0,7,0,1,1,0,0,0,1.0,16.0,33,0,2,2,48.0,82,5.34,48,255,2438,9.0
4513,Chad Ruhwedel,2019-20,29.0,8,10,34,34,2,8,10,45.0,589.0,67,2,10,12,93.0,82,5.45,47,245,2478,9.0
4514,Chad Ruhwedel,2020-21,30.0,9,5,44,44,2,3,5,67.0,692.0,111,4,13,17,160.0,82,5.86,50,250,2620,9.2
4515,Chad Ruhwedel,2021-22,31.0,10,2,18,18,1,1,2,22.0,293.0,129,5,14,19,182.0,82,5.96,47,239,2579,9.5
4516,Chad Ruhwedel,2022-23,32.0,11,6,41,41,2,4,6,44.0,606.0,170,7,18,25,226.0,70,5.96,42,208,2192,9.5
4517,Chad Wiseman,2005-06,24.0,4,0,4,4,0,0,0,1.0,37.0,4,0,0,0,1.0,82,5.31,60,363,2326,9.4
4518,Chad Wiseman,2006-07,25.0,5,1,4,4,1,0,1,3.0,35.0,8,1,0,1,4.0,82,5.14,57,348,2300,9.2
4519,Chad Wiseman,2008-09,27.0,6,1,1,1,0,1,1,1.0,9.0,9,1,1,2,5.0,82,6.05,85,480,2458,10.1
4520,Chandler Stephenson,2018-19,24.0,4,0,9,9,0,0,0,2.0,71.0,9,0,0,0,2.0,82,5.34,48,255,2438,9.0
4521,Chandler Stephenson,2019-20,25.0,5,0,4,4,0,0,0,3.0,36.0,13,0,0,0,5.0,82,5.45,47,245,2478,9.0
4522,Chandler Stephenson,2020-21,26.0,6,18,67,67,6,12,18,36.0,795.0,80,6,12,18,41.0,82,5.86,50,250,2620,9.2
4523,Chandler Stephenson,2021-22,27.0,7,11,64,64,5,6,11,36.0,775.0,144,11,18,29,77.0,82,5.96,47,239,2579,9.5
4524,Chandler Stephenson,2022-23,28.0,8,26,65,65,11,15,26,73.0,931.0,209,22,33,55,150.0,70,5.96,42,208,2192,9.5
4525,Charles Hudon,2018-19,24.0,4,2,3,3,0,2,2,3.0,32.0,3,0,2,2,3.0,82,5.34,48,255,2438,9.0
4526,Charles Hudon,2019-20,25.0,5,2,3,3,0,2,2,3.0,36.0,6,0,4,4,6.0,82,5.45,47,245,2478,9.0
4527,Charles Hudon,2020-21,26.0,6,30,72,72,10,20,30,179.0,1010.0,78,10,24,34,185.0,82,5.86,50,250,2620,9.2
4528,Charles Hudon,2021-22,27.0,7,5,32,32,3,2,5,50.0,374.0,110,13,26,39,235.0,82,5.96,47,239,2579,9.5
4529,Charles Hudon,2022-23,28.0,8,2,15,15,1,1,2,22.0,173.0,125,14,27,41,257.0,70,5.96,42,208,2192,9.5
4530,Charles Linglet,2012-13,30.0,4,0,5,5,0,0,0,7.0,51.0,5,0,0,0,7.0,82,5.53,56,304,2486,9.1
4531,Charlie Bourgeois,1984-85,25.0,4,15,54,54,2,13,15,33.0,,54,2,13,15,33.0,80,8.03,73,320,2489,12.9
4532,Charlie Bourgeois,1985-86,26.0,5,5,15,15,2,3,5,11.0,,69,4,16,20,44.0,80,7.73,71,310,2444,12.7
4533,Charlie Bourgeois,1986-87,27.0,6,4,17,17,1,3,4,20.0,,86,5,19,24,64.0,80,7.89,74,336,2448,12.9
4534,Charlie Bourgeois,1987-88,28.0,7,12,47,47,2,10,12,38.0,,133,7,29,36,102.0,80,7.77,71,321,2447,12.7
4535,Charlie Bourgeois,1988-89,29.0,8,19,60,60,7,12,19,64.0,,193,14,41,55,166.0,80,7.94,82,370,2484,12.8
4536,Charlie Bourgeois,1989-90,30.0,9,14,66,66,2,12,14,53.0,,259,16,53,69,219.0,80,7.34,72,344,2400,12.2
4537,Charlie Bourgeois,1990-91,31.0,10,1,31,31,0,1,1,9.0,,290,16,54,70,228.0,80,7.43,89,437,2435,12.2
4538,Charlie Coyle,2015-16,23.0,4,14,37,37,8,6,14,50.0,557.0,37,8,6,14,50.0,48,5.31,29,160,1399,9.1
4539,Charlie Coyle,2016-17,24.0,5,30,70,70,12,18,30,135.0,1196.0,107,20,24,44,185.0,82,5.34,48,269,2463,8.9
4540,Charlie Coyle,2017-18,25.0,6,35,82,82,11,24,35,120.0,1193.0,189,31,48,79,305.0,82,5.32,47,251,2453,8.9
4541,Charlie Coyle,2018-19,26.0,7,42,82,82,21,21,42,140.0,1419.0,271,52,69,121,445.0,82,5.34,48,255,2438,9.0
4542,Charlie Coyle,2019-20,27.0,8,56,82,82,18,38,56,159.0,1370.0,353,70,107,177,604.0,82,5.45,47,245,2478,9.0
4543,Charlie Coyle,2020-21,28.0,9,37,66,66,11,26,37,117.0,1091.0,419,81,133,214,721.0,82,5.86,50,250,2620,9.2
4544,Charlie Coyle,2021-22,29.0,10,34,81,81,12,22,34,155.0,1359.0,500,93,155,248,876.0,82,5.96,47,239,2579,9.5
4545,Charlie Coyle,2022-23,30.0,11,37,70,70,16,21,37,145.0,1175.0,570,109,176,285,1021.0,70,5.96,42,208,2192,9.5
4546,Charlie Huddy,1983-84,24.0,4,7,12,12,2,5,7,23.0,,12,2,5,7,23.0,80,7.69,77,340,2441,12.6
4547,Charlie Huddy,1984-85,25.0,5,15,41,41,4,11,15,84.0,,53,6,16,22,107.0,80,8.03,73,320,2489,12.9
4548,Charlie Huddy,1985-86,26.0,6,57,76,76,20,37,57,151.0,,129,26,53,79,258.0,80,7.73,71,310,2444,12.7
4549,Charlie Huddy,1986-87,27.0,7,42,75,75,8,34,42,163.0,,204,34,87,121,421.0,80,7.89,74,336,2448,12.9
4550,Charlie Huddy,1987-88,28.0,8,51,80,80,7,44,51,145.0,,284,41,131,172,566.0,80,7.77,71,321,2447,12.7
4551,Charlie Huddy,1988-89,29.0,9,41,76,76,6,35,41,149.0,,360,47,166,213,715.0,80,7.94,82,370,2484,12.8
4552,Charlie Huddy,1989-90,30.0,10,19,58,58,4,15,19,75.0,,418,51,181,232,790.0,80,7.34,72,344,2400,12.2
4553,Charlie Huddy,1990-91,31.0,11,41,77,77,13,28,41,163.0,,495,64,209,273,953.0,80,7.43,89,437,2435,12.2
4554,Charlie Huddy,1991-92,32.0,12,44,76,76,11,33,44,178.0,,571,75,242,317,1131.0,80,7.48,85,403,2430,12.3
4555,Charlie Huddy,1992-93,33.0,13,24,70,70,1,23,24,119.0,,641,76,265,341,1250.0,80,7.37,76,367,2421,12.2
4556,Charlie Huddy,1993-94,34.0,14,27,53,53,5,22,27,90.0,,694,81,287,368,1340.0,80,6.91,71,366,2385,11.6
4557,Charlie Huddy,1994-95,35.0,15,23,56,56,4,19,23,109.0,,750,85,306,391,1449.0,80,6.96,77,402,2440,11.4
4558,Charlie Huddy,1995-96,36.0,16,27,82,82,2,25,27,106.0,,832,87,331,418,1555.0,84,7.25,87,443,2603,11.7
4559,Charlie Huddy,1996-97,37.0,17,18,79,79,5,13,18,134.0,,911,92,344,436,1689.0,84,6.48,76,407,2545,10.7
4560,Charlie Huddy,1997-98,38.0,18,7,41,41,2,5,7,51.0,,952,94,349,443,1740.0,48,5.97,37,209,1408,10.2
4561,Charlie Huddy,1998-99,39.0,19,10,64,64,5,5,10,70.0,,1016,99,354,453,1810.0,82,6.29,74,413,2481,10.4
4562,Charlie Huddy,1999-00,40.0,20,0,1,1,0,0,0,0.0,,1017,99,354,453,1810.0,82,5.83,55,336,2444,9.8
4563,Charlie Luksa,1982-83,28.0,4,1,8,8,0,1,1,3.0,,8,0,1,1,3.0,80,7.03,61,280,2352,12.0
4564,Charlie McAvoy,2020-21,23.0,4,32,63,63,7,25,32,77.0,1395.0,63,7,25,32,77.0,82,5.86,50,250,2620,9.2
4565,Charlie McAvoy,2021-22,24.0,5,28,54,54,7,21,28,79.0,1197.0,117,14,46,60,156.0,82,5.96,47,239,2579,9.5
4566,Charlie McAvoy,2022-23,25.0,6,32,67,67,5,27,32,101.0,1552.0,184,19,73,92,257.0,70,5.96,42,208,2192,9.5
4567,Charlie Stephens,2005-06,24.0,4,0,2,2,0,0,0,1.0,11.0,2,0,0,0,1.0,82,5.31,60,363,2326,9.4
4568,Charlie Stephens,2006-07,25.0,5,2,6,6,0,2,2,1.0,37.0,8,0,2,2,2.0,82,5.14,57,348,2300,9.2
4569,Chase Balisy,2020-21,28.0,4,0,8,8,0,0,0,6.0,79.0,8,0,0,0,6.0,82,5.86,50,250,2620,9.2
4570,Chase De Leo,2018-19,23.0,4,0,2,2,0,0,0,2.0,19.0,2,0,0,0,2.0,82,5.34,48,255,2438,9.0
4571,Chase De Leo,2021-22,26.0,5,0,1,1,0,0,0,4.0,13.0,3,0,0,0,6.0,82,5.96,47,239,2579,9.5
4572,Chase De Leo,2022-23,27.0,6,0,1,1,0,0,0,1.0,15.0,4,0,0,0,7.0,70,5.96,42,208,2192,9.5
4573,Chay Genoway,2014-15,28.0,4,1,1,1,0,1,1,1.0,18.0,1,0,1,1,1.0,82,5.32,47,271,2439,8.9
4574,Chris Allen,2000-01,22.0,4,0,1,1,0,0,0,1.0,,1,0,0,0,1.0,82,5.28,57,380,2242,9.6
4575,Chris Allen,2001-02,23.0,5,0,1,1,0,0,0,0.0,13.0,2,0,0,0,1.0,82,5.27,57,359,2285,9.4
4576,Chris Armstrong,2003-04,28.0,4,0,3,3,0,0,0,4.0,54.0,3,0,0,0,4.0,82,5.51,63,376,2272,9.9
4577,Chris Armstrong,2006-07,31.0,5,1,4,4,0,1,1,8.0,50.0,7,0,1,1,12.0,82,5.14,57,348,2300,9.2
4578,Chris Bala,2004-05,26.0,4,1,6,6,0,1,1,2.0,34.0,6,0,1,1,2.0,82,5.24,53,338,2262,9.5
4579,Chris Bigras,2018-19,23.0,4,3,31,31,1,2,3,21.0,414.0,31,1,2,3,21.0,82,5.34,48,255,2438,9.0
4580,Chris Bigras,2020-21,25.0,5,1,15,15,0,1,1,8.0,208.0,46,1,3,4,29.0,82,5.86,50,250,2620,9.2
4581,Chris Bourque,2010-11,25.0,4,0,4,4,0,0,0,4.0,35.0,4,0,0,0,4.0,82,5.44,62,351,2383,9.4
4582,Chris Bourque,2011-12,26.0,5,1,8,8,1,0,1,11.0,78.0,12,1,0,1,15.0,82,5.7,65,341,2477,9.4
4583,Chris Bourque,2012-13,27.0,6,3,21,21,0,3,3,21.0,201.0,33,1,3,4,36.0,82,5.53,56,304,2486,9.1
4584,Chris Bourque,2015-16,30.0,7,4,18,18,1,3,4,24.0,217.0,51,2,6,8,60.0,48,5.31,29,160,1399,9.1
4585,Chris Brown,2015-16,24.0,4,0,5,5,0,0,0,6.0,38.0,5,0,0,0,6.0,48,5.31,29,160,1399,9.1
4586,Chris Brown,2016-17,25.0,5,2,12,12,1,1,2,8.0,104.0,17,1,1,2,14.0,82,5.34,48,269,2463,8.9
4587,Chris Brown,2017-18,26.0,6,1,5,5,1,0,1,4.0,32.0,22,2,1,3,18.0,82,5.32,47,251,2453,8.9
4588,Chris Brown,2018-19,27.0,7,0,1,1,0,0,0,1.0,8.0,23,2,1,3,19.0,82,5.34,48,255,2438,9.0
4589,Chris Butler,2011-12,25.0,4,6,47,47,2,4,6,36.0,786.0,47,2,4,6,36.0,82,5.7,65,341,2477,9.4
4590,Chris Butler,2012-13,26.0,5,21,59,59,1,20,21,61.0,1181.0,106,3,24,27,97.0,82,5.53,56,304,2486,9.1
4591,Chris Butler,2013-14,27.0,6,9,49,49,2,7,9,52.0,890.0,155,5,31,36,149.0,82,5.46,52,291,2492,9.0
4592,Chris Butler,2014-15,28.0,7,15,68,68,2,13,15,62.0,1469.0,223,7,44,51,211.0,82,5.32,47,271,2439,8.9
4593,Chris Butler,2015-16,29.0,8,8,44,44,1,7,8,40.0,750.0,267,8,51,59,251.0,48,5.31,29,160,1399,9.1
4594,Chris Butler,2016-17,30.0,9,16,82,82,2,14,16,83.0,1662.0,349,10,65,75,334.0,82,5.34,48,269,2463,8.9
4595,Chris Butler,2017-18,31.0,10,9,33,33,3,6,9,54.0,567.0,382,13,71,84,388.0,82,5.32,47,251,2453,8.9
4596,Chris Butler,2018-19,32.0,11,0,5,5,0,0,0,4.0,58.0,387,13,71,84,392.0,82,5.34,48,255,2438,9.0
4597,Chris Butler,2019-20,33.0,12,0,1,1,0,0,0,1.0,21.0,388,13,71,84,393.0,82,5.45,47,245,2478,9.0
4598,Chris Butler,2020-21,34.0,13,0,6,6,0,0,0,2.0,80.0,394,13,71,84,395.0,82,5.86,50,250,2620,9.2
4599,Chris Butler,2021-22,35.0,14,2,13,13,1,1,2,10.0,183.0,407,14,72,86,405.0,82,5.96,47,239,2579,9.5
4600,Chris Campoli,2008-09,24.0,4,34,80,80,9,25,34,123.0,1483.0,80,9,25,34,123.0,82,6.05,85,480,2458,10.1
4601,Chris Campoli,2009-10,25.0,5,14,51,51,1,13,14,41.0,756.0,131,10,38,48,164.0,82,5.76,70,398,2426,9.7
4602,Chris Campoli,2010-11,26.0,6,18,46,46,4,14,18,68.0,881.0,177,14,52,66,232.0,82,5.44,62,351,2383,9.4
4603,Chris Campoli,2011-12,27.0,7,30,76,76,11,19,30,91.0,1485.0,253,25,71,96,323.0,82,5.7,65,341,2477,9.4
4604,Chris Campoli,2012-13,28.0,8,18,67,67,4,14,18,71.0,1196.0,320,29,85,114,394.0,82,5.53,56,304,2486,9.1
4605,Chris Campoli,2013-14,29.0,9,21,77,77,4,17,21,84.0,1474.0,397,33,102,135,478.0,82,5.46,52,291,2492,9.0
4606,Chris Campoli,2014-15,30.0,10,11,43,43,2,9,11,43.0,740.0,440,35,111,146,521.0,82,5.32,47,271,2439,8.9
4607,Chris Chelios,1986-87,25.0,4,2,12,12,0,2,2,23.0,,12,0,2,2,23.0,80,7.89,74,336,2448,12.9
4608,Chris Chelios,1987-88,26.0,5,64,74,74,9,55,64,200.0,,86,9,57,66,223.0,80,7.77,71,321,2447,12.7
4609,Chris Chelios,1988-89,27.0,6,34,41,41,8,26,34,101.0,,127,17,83,100,324.0,80,7.94,82,370,2484,12.8
4610,Chris Chelios,1989-90,28.0,7,44,71,71,11,33,44,141.0,,198,28,116,144,465.0,80,7.34,72,344,2400,12.2
4611,Chris Chelios,1990-91,29.0,8,61,71,71,20,41,61,199.0,,269,48,157,205,664.0,80,7.43,89,437,2435,12.2
4612,Chris Chelios,1991-92,30.0,9,73,80,80,15,58,73,206.0,,349,63,215,278,870.0,80,7.48,85,403,2430,12.3
4613,Chris Chelios,1992-93,31.0,10,31,53,53,9,22,31,123.0,,402,72,237,309,993.0,80,7.37,76,367,2421,12.2
4614,Chris Chelios,1993-94,32.0,11,64,77,77,12,52,64,187.0,,479,84,289,373,1180.0,80,6.91,71,366,2385,11.6
4615,Chris Chelios,1994-95,33.0,12,56,80,80,9,47,56,239.0,,559,93,336,429,1419.0,80,6.96,77,402,2440,11.4
4616,Chris Chelios,1995-96,34.0,13,73,84,84,15,58,73,290.0,,643,108,394,502,1709.0,84,7.25,87,443,2603,11.7
4617,Chris Chelios,1996-97,35.0,14,60,76,76,16,44,60,219.0,,719,124,438,562,1928.0,84,6.48,76,407,2545,10.7
4618,Chris Chelios,1997-98,36.0,15,38,48,48,5,33,38,166.0,,767,129,471,600,2094.0,48,5.97,37,209,1408,10.2
4619,Chris Chelios,1998-99,37.0,16,72,81,81,14,58,72,219.0,,848,143,529,672,2313.0,82,6.29,74,413,2481,10.4
4620,Chris Chelios,1999-00,38.0,17,48,72,72,10,38,48,194.0,,920,153,567,720,2507.0,82,5.83,55,336,2444,9.8
4621,Chris Chelios,2000-01,39.0,18,42,81,81,3,39,42,205.0,,1001,156,606,762,2712.0,82,5.28,57,380,2242,9.6
4622,Chris Chelios,2001-02,40.0,19,36,75,75,9,27,36,187.0,1999.0,1076,165,633,798,2899.0,82,5.27,57,359,2285,9.4
4623,Chris Chelios,2002-03,41.0,20,34,81,81,3,31,34,135.0,2047.0,1157,168,664,832,3034.0,82,5.49,53,331,2294,9.8
4624,Chris Chelios,2003-04,42.0,21,3,24,24,0,3,3,26.0,548.0,1181,168,667,835,3060.0,82,5.51,63,376,2272,9.9
4625,Chris Chelios,2004-05,43.0,22,39,79,79,6,33,39,128.0,1999.0,1260,174,700,874,3188.0,82,5.24,53,338,2262,9.5
4626,Chris Chelios,2005-06,44.0,23,19,66,66,2,17,19,92.0,1600.0,1326,176,717,893,3280.0,82,5.31,60,363,2326,9.4
4627,Chris Chelios,2006-07,45.0,24,21,69,69,2,19,21,113.0,1473.0,1395,178,736,914,3393.0,82,5.14,57,348,2300,9.2
4628,Chris Chelios,2008-09,47.0,25,11,81,81,4,7,11,83.0,1497.0,1476,182,743,925,3476.0,82,6.05,85,480,2458,10.1
4629,Chris Chelios,2009-10,48.0,26,11,71,71,0,11,11,72.0,1287.0,1547,182,754,936,3548.0,82,5.76,70,398,2426,9.7
4630,Chris Chelios,2010-11,49.0,27,12,69,69,3,9,12,60.0,1170.0,1616,185,763,948,3608.0,82,5.44,62,351,2383,9.4
4631,Chris Chelios,2011-12,50.0,28,0,28,28,0,0,0,14.0,327.0,1644,185,763,948,3622.0,82,5.7,65,341,2477,9.4
4632,Chris Chelios,2012-13,51.0,29,0,7,7,0,0,0,5.0,78.0,1651,185,763,948,3627.0,82,5.53,56,304,2486,9.1
4633,Chris Cichocki,1988-89,25.0,4,21,59,59,10,11,21,76.0,,59,10,11,21,76.0,80,7.94,82,370,2484,12.8
4634,Chris Cichocki,1989-90,26.0,5,0,2,2,0,0,0,0.0,,61,10,11,21,76.0,80,7.34,72,344,2400,12.2
4635,Chris Cichocki,1990-91,27.0,6,1,5,5,1,0,1,2.0,,66,11,11,22,78.0,80,7.43,89,437,2435,12.2
4636,Chris Cichocki,1991-92,28.0,7,1,2,2,0,1,1,2.0,,68,11,12,23,80.0,80,7.48,85,403,2430,12.3
4637,Chris Clark,2002-03,26.0,4,1,22,22,0,1,1,17.0,199.0,22,0,1,1,17.0,82,5.49,53,331,2294,9.8
4638,Chris Clark,2003-04,27.0,5,6,29,29,5,1,6,43.0,346.0,51,5,2,7,60.0,82,5.51,63,376,2272,9.9
4639,Chris Clark,2004-05,28.0,6,17,64,64,10,7,17,109.0,893.0,115,15,9,24,169.0,82,5.24,53,338,2262,9.5
4640,Chris Clark,2005-06,29.0,7,22,81,81,10,12,22,156.0,1166.0,196,25,21,46,325.0,82,5.31,60,363,2326,9.4
4641,Chris Clark,2006-07,30.0,8,25,82,82,10,15,25,137.0,1154.0,278,35,36,71,462.0,82,5.14,57,348,2300,9.2
4642,Chris Clark,2008-09,32.0,9,39,78,78,20,19,39,144.0,1202.0,356,55,55,110,606.0,82,6.05,85,480,2458,10.1
4643,Chris Clark,2009-10,33.0,10,54,74,74,30,24,54,164.0,1363.0,430,85,79,164,770.0,82,5.76,70,398,2426,9.7
4644,Chris Clark,2010-11,34.0,11,9,18,18,5,4,9,29.0,304.0,448,90,83,173,799.0,82,5.44,62,351,2383,9.4
4645,Chris Clark,2011-12,35.0,12,6,32,32,1,5,6,36.0,370.0,480,91,88,179,835.0,82,5.7,65,341,2477,9.4
4646,Chris Clark,2012-13,36.0,13,20,74,74,7,13,20,105.0,878.0,554,98,101,199,940.0,82,5.53,56,304,2486,9.1
4647,Chris Clark,2013-14,37.0,14,15,53,53,5,10,15,83.0,776.0,607,103,111,214,1023.0,82,5.46,52,291,2492,9.0
4648,Chris Conner,2009-10,26.0,4,3,11,11,1,2,3,18.0,124.0,11,1,2,3,18.0,82,5.76,70,398,2426,9.7
4649,Chris Conner,2010-11,27.0,5,5,22,22,3,2,5,27.0,264.0,33,4,4,8,45.0,82,5.44,62,351,2383,9.4
4650,Chris Conner,2011-12,28.0,6,13,38,38,3,10,13,34.0,415.0,71,7,14,21,79.0,82,5.7,65,341,2477,9.4
4651,Chris Conner,2012-13,29.0,7,3,8,8,2,1,3,11.0,77.0,79,9,15,24,90.0,82,5.53,56,304,2486,9.1
4652,Chris Conner,2013-14,30.0,8,16,60,60,7,9,16,91.0,709.0,139,16,24,40,181.0,82,5.46,52,291,2492,9.0
4653,Chris Conner,2014-15,31.0,9,3,8,8,1,2,3,10.0,85.0,147,17,26,43,191.0,82,5.32,47,271,2439,8.9
4654,Chris Conner,2015-16,32.0,10,2,12,12,1,1,2,15.0,137.0,159,18,27,45,206.0,48,5.31,29,160,1399,9.1
4655,Chris Conner,2016-17,33.0,11,5,19,19,4,1,5,17.0,224.0,178,22,28,50,223.0,82,5.34,48,269,2463,8.9
4656,Chris Conner,2017-18,34.0,12,0,2,2,0,0,0,3.0,18.0,180,22,28,50,226.0,82,5.32,47,251,2453,8.9
4657,Chris Corrinet,2004-05,26.0,4,1,8,8,0,1,1,8.0,81.0,8,0,1,1,8.0,82,5.24,53,338,2262,9.5
4658,Chris Dahlquist,1988-89,26.0,4,3,5,5,1,2,3,5.0,,5,1,2,3,5.0,80,7.94,82,370,2484,12.8
4659,Chris Dahlquist,1989-90,27.0,5,1,19,19,0,1,1,15.0,,24,1,3,4,20.0,80,7.34,72,344,2400,12.2
4660,Chris Dahlquist,1990-91,28.0,6,9,44,44,3,6,9,35.0,,68,4,9,13,55.0,80,7.43,89,437,2435,12.2
4661,Chris Dahlquist,1991-92,29.0,7,6,43,43,1,5,6,27.0,,111,5,14,19,82.0,80,7.48,85,403,2430,12.3
4662,Chris Dahlquist,1992-93,30.0,8,14,62,62,4,10,14,57.0,,173,9,24,33,139.0,80,7.37,76,367,2421,12.2
4663,Chris Dahlquist,1993-94,31.0,9,11,64,64,3,8,11,52.0,,237,12,32,44,191.0,80,6.91,71,366,2385,11.6
4664,Chris Dahlquist,1994-95,32.0,10,14,74,74,1,13,14,63.0,,311,13,45,58,254.0,80,6.96,77,402,2440,11.4
4665,Chris Dahlquist,1995-96,33.0,11,10,74,74,3,7,10,64.0,,385,16,52,68,318.0,84,7.25,87,443,2603,11.7
4666,Chris Dahlquist,1996-97,34.0,12,12,77,77,1,11,12,57.0,,462,17,63,80,375.0,84,6.48,76,407,2545,10.7
4667,Chris Dahlquist,1997-98,35.0,13,8,46,46,1,7,8,45.0,,508,18,70,88,420.0,48,5.97,37,209,1408,10.2
4668,Chris Dahlquist,1998-99,36.0,14,2,24,24,1,1,2,13.0,,532,19,71,90,433.0,82,6.29,74,413,2481,10.4
4669,Chris Dingman,2000-01,24.0,4,6,70,70,3,3,6,47.0,,70,3,3,6,47.0,82,5.28,57,380,2242,9.6
4670,Chris Dingman,2001-02,25.0,5,0,3,3,0,0,0,1.0,17.0,73,3,3,6,48.0,82,5.27,57,359,2285,9.4
4671,Chris Dingman,2002-03,26.0,6,11,68,68,8,3,11,54.0,441.0,141,11,6,17,102.0,82,5.49,53,331,2294,9.8
4672,Chris Dingman,2003-04,27.0,7,2,41,41,1,1,2,33.0,264.0,182,12,7,19,135.0,82,5.51,63,376,2272,9.9
4673,Chris Dingman,2004-05,28.0,8,5,44,44,0,5,5,41.0,357.0,226,12,12,24,176.0,82,5.24,53,338,2262,9.5
4674,Chris Dingman,2005-06,29.0,9,3,51,51,2,1,3,41.0,488.0,277,14,13,27,217.0,82,5.31,60,363,2326,9.4
4675,Chris Dingman,2006-07,30.0,10,6,74,74,1,5,6,65.0,612.0,351,15,18,33,282.0,82,5.14,57,348,2300,9.2
4676,Chris Dingman,2008-09,32.0,11,1,34,34,0,1,1,24.0,187.0,385,15,19,34,306.0,82,6.05,85,480,2458,10.1
4677,Chris Drury,2001-02,25.0,4,44,79,79,20,24,44,138.0,1047.0,79,20,24,44,138.0,82,5.27,57,359,2285,9.4
4678,Chris Drury,2002-03,26.0,5,67,82,82,20,47,67,213.0,1521.0,161,40,71,111,351.0,82,5.49,53,331,2294,9.8
4679,Chris Drury,2003-04,27.0,6,65,71,71,24,41,65,204.0,1281.0,232,64,112,176,555.0,82,5.51,63,376,2272,9.9
4680,Chris Drury,2004-05,28.0,7,46,82,82,21,25,46,236.0,1471.0,314,85,137,222,791.0,82,5.24,53,338,2262,9.5
4681,Chris Drury,2005-06,29.0,8,53,80,80,23,30,53,224.0,1484.0,394,108,167,275,1015.0,82,5.31,60,363,2326,9.4
4682,Chris Drury,2006-07,30.0,9,53,76,76,18,35,53,152.0,1373.0,470,126,202,328,1167.0,82,5.14,57,348,2300,9.2
4683,Chris Drury,2008-09,32.0,10,67,81,81,30,37,67,172.0,1466.0,551,156,239,395,1339.0,82,6.05,85,480,2458,10.1
4684,Chris Drury,2009-10,33.0,11,69,77,77,37,32,69,199.0,1446.0,628,193,271,464,1538.0,82,5.76,70,398,2426,9.7
4685,Chris Drury,2010-11,34.0,12,58,82,82,25,33,58,220.0,1623.0,710,218,304,522,1758.0,82,5.44,62,351,2383,9.4
4686,Chris Drury,2011-12,35.0,13,56,81,81,22,34,56,219.0,1640.0,791,240,338,578,1977.0,82,5.7,65,341,2477,9.4
4687,Chris Drury,2012-13,36.0,14,32,77,77,14,18,32,148.0,1369.0,868,254,356,610,2125.0,82,5.53,56,304,2486,9.1
4688,Chris Drury,2013-14,37.0,15,5,24,24,1,4,5,26.0,288.0,892,255,360,615,2151.0,82,5.46,52,291,2492,9.0
4689,Chris Durno,2011-12,31.0,4,0,2,2,0,0,0,3.0,12.0,2,0,0,0,3.0,82,5.7,65,341,2477,9.4
4690,Chris Durno,2012-13,32.0,5,8,41,41,4,4,8,27.0,306.0,43,4,4,8,30.0,82,5.53,56,304,2486,9.1
4691,Chris Felix,1991-92,27.0,4,8,21,21,0,8,8,18.0,,21,0,8,8,18.0,80,7.48,85,403,2430,12.3
4692,Chris Felix,1992-93,28.0,5,1,6,6,1,0,1,3.0,,27,1,8,9,21.0,80,7.37,76,367,2421,12.2
4693,Chris Felix,1993-94,29.0,6,4,8,8,0,4,4,7.0,,35,1,12,13,28.0,80,6.91,71,366,2385,11.6
4694,Chris Ferraro,1998-99,26.0,4,1,2,2,1,0,1,4.0,,2,1,0,1,4.0,82,6.29,74,413,2481,10.4
4695,Chris Ferraro,1999-00,27.0,5,2,12,12,1,1,2,23.0,,14,2,1,3,27.0,82,5.83,55,336,2444,9.8
4696,Chris Ferraro,2000-01,28.0,6,7,46,46,3,4,7,42.0,,60,5,5,10,69.0,82,5.28,57,380,2242,9.6
4697,Chris Ferraro,2001-02,29.0,7,1,2,2,1,0,1,1.0,17.0,62,6,5,11,70.0,82,5.27,57,359,2285,9.4
4698,Chris Ferraro,2002-03,30.0,8,4,11,11,1,3,4,15.0,105.0,73,7,8,15,85.0,82,5.49,53,331,2294,9.8
4699,Chris Ferraro,2004-05,32.0,9,1,1,1,0,1,1,4.0,15.0,74,7,9,16,89.0,82,5.24,53,338,2262,9.5
4700,Chris Govedaris,1992-93,22.0,4,1,12,12,0,1,1,13.0,,12,0,1,1,13.0,80,7.37,76,367,2421,12.2
4701,Chris Govedaris,1993-94,23.0,5,4,14,14,1,3,4,10.0,,26,1,4,5,23.0,80,6.91,71,366,2385,11.6
4702,Chris Govedaris,1995-96,25.0,6,1,7,7,1,0,1,6.0,,33,2,4,6,29.0,84,7.25,87,443,2603,11.7
4703,Chris Govedaris,1996-97,26.0,7,4,12,12,2,2,4,16.0,,45,4,6,10,45.0,84,6.48,76,407,2545,10.7
4704,Chris Gratton,1996-97,21.0,4,42,84,84,13,29,42,161.0,,84,13,29,42,161.0,84,6.48,76,407,2545,10.7
4705,Chris Gratton,1997-98,22.0,5,27,46,46,7,20,27,91.0,,130,20,49,69,252.0,48,5.97,37,209,1408,10.2
4706,Chris Gratton,1998-99,23.0,6,38,82,82,17,21,38,183.0,,212,37,70,107,435.0,82,6.29,74,413,2481,10.4
4707,Chris Gratton,1999-00,24.0,7,62,82,82,30,32,62,230.0,,294,67,102,169,665.0,82,5.83,55,336,2444,9.8
4708,Chris Gratton,2000-01,25.0,8,62,82,82,22,40,62,182.0,,376,89,142,231,847.0,82,5.28,57,380,2242,9.6
4709,Chris Gratton,2001-02,26.0,9,34,78,78,8,26,34,181.0,1328.0,454,97,168,265,1028.0,82,5.27,57,359,2285,9.4
4710,Chris Gratton,2002-03,27.0,10,49,72,72,15,34,49,202.0,1396.0,526,112,202,314,1230.0,82,5.49,53,331,2294,9.8
4711,Chris Gratton,2003-04,28.0,11,40,82,82,19,21,40,156.0,1199.0,608,131,223,354,1386.0,82,5.51,63,376,2272,9.9
4712,Chris Gratton,2004-05,29.0,12,39,82,82,15,24,39,139.0,1226.0,690,146,247,393,1525.0,82,5.24,53,338,2262,9.5
4713,Chris Gratton,2005-06,30.0,13,45,80,80,15,30,45,215.0,1325.0,770,161,277,438,1740.0,82,5.31,60,363,2326,9.4
4714,Chris Gratton,2006-07,31.0,14,32,81,81,13,19,32,150.0,1218.0,851,174,296,470,1890.0,82,5.14,57,348,2300,9.2
4715,Chris Gratton,2008-09,33.0,15,39,76,76,17,22,39,135.0,1195.0,927,191,318,509,2025.0,82,6.05,85,480,2458,10.1
4716,Chris Gratton,2009-10,34.0,16,35,81,81,13,22,35,131.0,980.0,1008,204,340,544,2156.0,82,5.76,70,398,2426,9.7
4717,Chris Gratton,2010-11,35.0,17,21,60,60,10,11,21,92.0,762.0,1068,214,351,565,2248.0,82,5.44,62,351,2383,9.4
4718,Chris Gratton,2011-12,36.0,18,3,24,24,0,3,3,20.0,253.0,1092,214,354,568,2268.0,82,5.7,65,341,2477,9.4
4719,Chris Hajt,2003-04,25.0,4,0,1,1,0,0,0,0.0,8.0,1,0,0,0,0.0,82,5.51,63,376,2272,9.9
4720,Chris Hajt,2006-07,28.0,5,0,5,5,0,0,0,1.0,54.0,6,0,0,0,1.0,82,5.14,57,348,2300,9.2
4721,Chris Herperger,2002-03,28.0,4,0,9,9,0,0,0,2.0,69.0,9,0,0,0,2.0,82,5.49,53,331,2294,9.8
4722,Chris Herperger,2003-04,29.0,5,25,61,61,10,15,25,76.0,800.0,70,10,15,25,78.0,82,5.51,63,376,2272,9.9
4723,Chris Herperger,2004-05,30.0,6,13,72,72,4,9,13,81.0,815.0,142,14,24,38,159.0,82,5.24,53,338,2262,9.5
4724,Chris Herperger,2005-06,31.0,7,5,27,27,4,1,5,26.0,338.0,169,18,25,43,185.0,82,5.31,60,363,2326,9.4
4725,Chris Higgins,2006-07,23.0,4,0,2,2,0,0,0,0.0,13.0,2,0,0,0,0.0,82,5.14,57,348,2300,9.2
4726,Chris Higgins,2008-09,25.0,5,38,80,80,23,15,38,148.0,1153.0,82,23,15,38,148.0,82,6.05,85,480,2458,10.1
4727,Chris Higgins,2009-10,26.0,6,38,61,61,22,16,38,159.0,1092.0,143,45,31,76,307.0,82,5.76,70,398,2426,9.7
4728,Chris Higgins,2010-11,27.0,7,52,82,82,27,25,52,241.0,1472.0,225,72,56,128,548.0,82,5.44,62,351,2383,9.4
4729,Chris Higgins,2011-12,28.0,8,23,57,57,12,11,23,151.0,969.0,282,84,67,151,699.0,82,5.7,65,341,2477,9.4
4730,Chris Higgins,2012-13,29.0,9,17,67,67,8,9,17,165.0,1175.0,349,92,76,168,864.0,82,5.53,56,304,2486,9.1
4731,Chris Higgins,2013-14,30.0,10,28,62,62,13,15,28,160.0,1011.0,411,105,91,196,1024.0,82,5.46,52,291,2492,9.0
4732,Chris Higgins,2014-15,31.0,11,43,71,71,18,25,43,165.0,1158.0,482,123,116,239,1189.0,82,5.32,47,271,2439,8.9
4733,Chris Higgins,2015-16,32.0,12,15,41,41,10,5,15,77.0,673.0,523,133,121,254,1266.0,48,5.31,29,160,1399,9.1
4734,Chris Higgins,2016-17,33.0,13,39,78,78,17,22,39,216.0,1496.0,601,150,143,293,1482.0,82,5.34,48,269,2463,8.9
4735,Chris Higgins,2017-18,34.0,14,36,77,77,12,24,36,171.0,1216.0,678,162,167,329,1653.0,82,5.32,47,251,2453,8.9
4736,Chris Higgins,2018-19,35.0,15,4,33,33,3,1,4,51.0,455.0,711,165,168,333,1704.0,82,5.34,48,255,2438,9.0
4737,Chris Jensen,1988-89,25.0,4,4,9,9,1,3,4,18.0,,9,1,3,4,18.0,80,7.94,82,370,2484,12.8
4738,Chris Jensen,1989-90,26.0,5,13,36,36,6,7,13,70.0,,45,7,10,17,88.0,80,7.34,72,344,2400,12.2
4739,Chris Jensen,1990-91,27.0,6,1,7,7,0,1,1,11.0,,52,7,11,18,99.0,80,7.43,89,437,2435,12.2
4740,Chris Jensen,1992-93,29.0,7,0,1,1,0,0,0,0.0,,53,7,11,18,99.0,80,7.37,76,367,2421,12.2
4741,Chris Jensen,1993-94,30.0,8,3,18,18,2,1,3,22.0,,71,9,12,21,121.0,80,6.91,71,366,2385,11.6
4742,Chris Jensen,1994-95,31.0,9,0,2,2,0,0,0,2.0,,73,9,12,21,123.0,80,6.96,77,402,2440,11.4
4743,Chris Joseph,1990-91,21.0,4,8,24,24,0,8,8,14.0,,24,0,8,8,14.0,80,7.43,89,437,2435,12.2
4744,Chris Joseph,1991-92,22.0,5,9,44,44,4,5,9,36.0,,68,4,13,17,50.0,80,7.48,85,403,2430,12.3
4745,Chris Joseph,1992-93,23.0,6,2,4,4,0,2,2,5.0,,72,4,15,19,55.0,80,7.37,76,367,2421,12.2
4746,Chris Joseph,1993-94,24.0,7,22,49,49,5,17,22,74.0,,121,9,32,41,129.0,80,6.91,71,366,2385,11.6
4747,Chris Joseph,1994-95,25.0,8,0,7,7,0,0,0,5.0,,128,9,32,41,134.0,80,6.96,77,402,2440,11.4
4748,Chris Joseph,1995-96,26.0,9,12,33,33,2,10,12,49.0,,161,11,42,53,183.0,84,7.25,87,443,2603,11.7
4749,Chris Joseph,1996-97,27.0,10,31,76,76,11,20,31,179.0,,237,22,62,84,362.0,84,6.48,76,407,2545,10.7
4750,Chris Joseph,1997-98,28.0,11,15,33,33,5,10,15,73.0,,270,27,72,99,435.0,48,5.97,37,209,1408,10.2
4751,Chris Joseph,1998-99,29.0,12,19,70,70,5,14,19,94.0,,340,32,86,118,529.0,82,6.29,74,413,2481,10.4
4752,Chris Joseph,1999-00,30.0,13,16,63,63,3,13,16,99.0,,403,35,99,134,628.0,82,5.83,55,336,2444,9.8
4753,Chris Joseph,2000-01,31.0,14,1,15,15,1,0,1,20.0,,418,36,99,135,648.0,82,5.28,57,380,2242,9.6
4754,Chris Joseph,2001-02,32.0,15,0,2,2,0,0,0,1.0,19.0,420,36,99,135,649.0,82,5.27,57,359,2285,9.4
4755,Chris Joseph,2002-03,33.0,16,11,47,47,2,9,11,86.0,775.0,467,38,108,146,735.0,82,5.49,53,331,2294,9.8
4756,Chris Joseph,2003-04,34.0,17,5,43,43,1,4,5,58.0,707.0,510,39,112,151,793.0,82,5.51,63,376,2272,9.9
4757,Chris Kelleher,2004-05,29.0,4,0,1,1,0,0,0,0.0,6.0,1,0,0,0,0.0,82,5.24,53,338,2262,9.5
4758,Chris Kelly,2006-07,26.0,4,0,4,4,0,0,0,4.0,38.0,4,0,0,0,4.0,82,5.14,57,348,2300,9.2
4759,Chris Kelly,2008-09,28.0,5,30,82,82,10,20,30,112.0,1011.0,86,10,20,30,116.0,82,6.05,85,480,2458,10.1
4760,Chris Kelly,2009-10,29.0,6,38,82,82,15,23,38,131.0,1255.0,168,25,43,68,247.0,82,5.76,70,398,2426,9.7
4761,Chris Kelly,2010-11,30.0,7,30,75,75,11,19,30,124.0,1245.0,243,36,62,98,371.0,82,5.44,62,351,2383,9.4
4762,Chris Kelly,2011-12,31.0,8,23,82,82,12,11,23,118.0,1279.0,325,48,73,121,489.0,82,5.7,65,341,2477,9.4
4763,Chris Kelly,2012-13,32.0,9,32,81,81,15,17,32,112.0,1212.0,406,63,90,153,601.0,82,5.53,56,304,2486,9.1
4764,Chris Kelly,2013-14,33.0,10,28,81,81,14,14,28,113.0,1249.0,487,77,104,181,714.0,82,5.46,52,291,2492,9.0
4765,Chris Kelly,2014-15,34.0,11,39,82,82,20,19,39,122.0,1208.0,569,97,123,220,836.0,82,5.32,47,271,2439,8.9
4766,Chris Kelly,2015-16,35.0,12,9,34,34,3,6,9,40.0,509.0,603,100,129,229,876.0,48,5.31,29,160,1399,9.1
4767,Chris Kelly,2016-17,36.0,13,18,57,57,9,9,18,69.0,838.0,660,109,138,247,945.0,82,5.34,48,269,2463,8.9
4768,Chris Kelly,2017-18,37.0,14,28,80,80,7,21,28,112.0,1211.0,740,116,159,275,1057.0,82,5.32,47,251,2453,8.9
4769,Chris Kelly,2018-19,38.0,15,2,11,11,2,0,2,8.0,144.0,751,118,159,277,1065.0,82,5.34,48,255,2438,9.0
4770,Chris Kelly,2019-20,39.0,16,12,82,82,5,7,12,85.0,979.0,833,123,166,289,1150.0,82,5.45,47,245,2478,9.0
4771,Chris Kelly,2020-21,40.0,17,2,12,12,0,2,2,5.0,92.0,845,123,168,291,1155.0,82,5.86,50,250,2620,9.2
4772,Chris Kenady,2000-01,27.0,4,2,5,5,0,2,2,3.0,,5,0,2,2,3.0,82,5.28,57,380,2242,9.6
4773,Chris Kenady,2002-03,29.0,5,0,2,2,0,0,0,1.0,15.0,7,0,2,2,4.0,82,5.49,53,331,2294,9.8
4774,Chris Kontos,1985-86,22.0,4,15,44,44,8,7,15,63.0,,44,8,7,15,63.0,80,7.73,71,310,2444,12.7
4775,Chris Kontos,1986-87,23.0,5,1,6,6,0,1,1,1.0,,50,8,8,16,64.0,80,7.89,74,336,2448,12.9
4776,Chris Kontos,1987-88,24.0,6,12,28,28,4,8,12,51.0,,78,12,16,28,115.0,80,7.77,71,321,2447,12.7
4777,Chris Kontos,1989-90,26.0,7,17,31,31,8,9,17,38.0,,109,20,25,45,153.0,80,7.34,72,344,2400,12.2
4778,Chris Kontos,1990-91,27.0,8,20,42,42,3,17,20,36.0,,151,23,42,65,189.0,80,7.43,89,437,2435,12.2
4779,Chris Kontos,1991-92,28.0,9,3,7,7,2,1,3,9.0,,158,25,43,68,198.0,80,7.48,85,403,2430,12.3
4780,Chris Kontos,1992-93,29.0,10,4,6,6,2,2,4,9.0,,164,27,45,72,207.0,80,7.37,76,367,2421,12.2
4781,Chris Kontos,1995-96,32.0,11,51,66,66,27,24,51,136.0,,230,54,69,123,343.0,84,7.25,87,443,2603,11.7
4782,Chris Kotsopoulos,1983-84,25.0,4,16,54,54,4,12,16,104.0,,54,4,12,16,104.0,80,7.69,77,340,2441,12.6
4783,Chris Kotsopoulos,1984-85,26.0,5,33,68,68,13,20,33,152.0,,122,17,32,49,256.0,80,8.03,73,320,2489,12.9
4784,Chris Kotsopoulos,1985-86,27.0,6,30,68,68,6,24,30,122.0,,190,23,56,79,378.0,80,7.73,71,310,2444,12.7
4785,Chris Kotsopoulos,1986-87,28.0,7,18,72,72,5,13,18,96.0,,262,28,69,97,474.0,80,7.89,74,336,2448,12.9
4786,Chris Kotsopoulos,1987-88,29.0,8,8,33,33,5,3,8,42.0,,295,33,72,105,516.0,80,7.77,71,321,2447,12.7
4787,Chris Kotsopoulos,1988-89,30.0,9,17,61,61,6,11,17,69.0,,356,39,83,122,585.0,80,7.94,82,370,2484,12.8
4788,Chris Kotsopoulos,1989-90,31.0,10,12,43,43,2,10,12,43.0,,399,41,93,134,628.0,80,7.34,72,344,2400,12.2
4789,Chris Kotsopoulos,1990-91,32.0,11,4,21,21,2,2,4,22.0,,420,43,95,138,650.0,80,7.43,89,437,2435,12.2
4790,Chris Kotsopoulos,1991-92,33.0,12,15,57,57,1,14,15,66.0,,477,44,109,153,716.0,80,7.48,85,403,2430,12.3
4791,Chris Kotsopoulos,1992-93,34.0,13,0,2,2,0,0,0,0.0,,479,44,109,153,716.0,80,7.37,76,367,2421,12.2
4792,Chris Kreider,2015-16,24.0,4,3,23,23,2,1,3,19.0,233.0,23,2,1,3,19.0,48,5.31,29,160,1399,9.1
4793,Chris Kreider,2016-17,25.0,5,37,66,66,17,20,37,136.0,1038.0,89,19,21,40,155.0,82,5.34,48,269,2463,8.9
4794,Chris Kreider,2017-18,26.0,6,46,80,80,21,25,46,180.0,1257.0,169,40,46,86,335.0,82,5.32,47,251,2453,8.9
4795,Chris Kreider,2018-19,27.0,7,43,79,79,21,22,43,158.0,1261.0,248,61,68,129,493.0,82,5.34,48,255,2438,9.0
4796,Chris Kreider,2019-20,28.0,8,53,75,75,28,25,53,186.0,1275.0,323,89,93,182,679.0,82,5.45,47,245,2478,9.0
4797,Chris Kreider,2020-21,29.0,9,37,58,58,16,21,37,137.0,906.0,381,105,114,219,816.0,82,5.86,50,250,2620,9.2
4798,Chris Kreider,2021-22,30.0,10,52,79,79,28,24,52,201.0,1375.0,460,133,138,271,1017.0,82,5.96,47,239,2579,9.5
4799,Chris Kreider,2022-23,31.0,11,45,63,63,24,21,45,156.0,1087.0,523,157,159,316,1173.0,70,5.96,42,208,2192,9.5
4800,Chris Kunitz,2006-07,27.0,4,6,21,21,0,6,6,31.0,191.0,21,0,6,6,31.0,82,5.14,57,348,2300,9.2
4801,Chris Kunitz,2008-09,29.0,5,41,69,69,19,22,41,149.0,959.0,90,19,28,47,180.0,82,6.05,85,480,2458,10.1
4802,Chris Kunitz,2009-10,30.0,6,60,81,81,25,35,60,180.0,1381.0,171,44,63,107,360.0,82,5.76,70,398,2426,9.7
4803,Chris Kunitz,2010-11,31.0,7,50,82,82,21,29,50,196.0,1386.0,253,65,92,157,556.0,82,5.44,62,351,2383,9.4
4804,Chris Kunitz,2011-12,32.0,8,53,82,82,23,30,53,178.0,1348.0,335,88,122,210,734.0,82,5.7,65,341,2477,9.4
4805,Chris Kunitz,2012-13,33.0,9,32,50,50,13,19,32,131.0,822.0,385,101,141,242,865.0,82,5.53,56,304,2486,9.1
4806,Chris Kunitz,2013-14,34.0,10,48,66,66,23,25,48,133.0,1206.0,451,124,166,290,998.0,82,5.46,52,291,2492,9.0
4807,Chris Kunitz,2014-15,35.0,11,61,82,82,26,35,61,230.0,1502.0,533,150,201,351,1228.0,82,5.32,47,271,2439,8.9
4808,Chris Kunitz,2015-16,36.0,12,52,48,48,22,30,52,113.0,865.0,581,172,231,403,1341.0,48,5.31,29,160,1399,9.1
4809,Chris Kunitz,2016-17,37.0,13,68,78,78,35,33,68,218.0,1494.0,659,207,264,471,1559.0,82,5.34,48,269,2463,8.9
4810,Chris Kunitz,2017-18,38.0,14,40,74,74,17,23,40,170.0,1324.0,733,224,287,511,1729.0,82,5.32,47,251,2453,8.9
4811,Chris Kunitz,2018-19,39.0,15,40,80,80,17,23,40,150.0,1346.0,813,241,310,551,1879.0,82,5.34,48,255,2438,9.0
4812,Chris Kunitz,2019-20,40.0,16,29,71,71,9,20,29,134.0,1101.0,884,250,330,580,2013.0,82,5.45,47,245,2478,9.0
4813,Chris Kunitz,2020-21,41.0,17,29,82,82,13,16,29,81.0,980.0,966,263,346,609,2094.0,82,5.86,50,250,2620,9.2
4814,Chris Kunitz,2021-22,42.0,18,10,56,56,5,5,10,44.0,507.0,1022,268,351,619,2138.0,82,5.96,47,239,2579,9.5
4815,Chris Langevin,1986-87,27.0,4,1,6,6,1,0,1,4.0,,6,1,0,1,4.0,80,7.89,74,336,2448,12.9
4816,Chris Langevin,1988-89,29.0,5,3,16,16,2,1,3,10.0,,22,3,1,4,14.0,80,7.94,82,370,2484,12.8
4817,Chris Lindberg,1994-95,27.0,4,7,17,17,2,5,7,19.0,,17,2,5,7,19.0,80,6.96,77,402,2440,11.4
4818,Chris Lindberg,1995-96,28.0,5,21,62,62,9,12,21,74.0,,79,11,17,28,93.0,84,7.25,87,443,2603,11.7
4819,Chris Lindberg,1996-97,29.0,6,14,37,37,6,8,14,42.0,,116,17,25,42,135.0,84,6.48,76,407,2545,10.7
4820,Chris Lipuma,1995-96,24.0,4,5,15,15,0,5,5,17.0,,15,0,5,5,17.0,84,7.25,87,443,2603,11.7
4821,Chris Lipuma,1996-97,25.0,5,4,27,27,0,4,4,20.0,,42,0,9,9,37.0,84,6.48,76,407,2545,10.7
4822,Chris Lipuma,1997-98,26.0,6,0,1,1,0,0,0,1.0,,43,0,9,9,38.0,48,5.97,37,209,1408,10.2
4823,Chris Lipuma,1998-99,27.0,7,0,21,21,0,0,0,8.0,,64,0,9,9,46.0,82,6.29,74,413,2481,10.4
4824,Chris Lipuma,1999-00,28.0,8,0,8,8,0,0,0,4.0,,72,0,9,9,50.0,82,5.83,55,336,2444,9.8
4825,Chris Luongo,1993-94,26.0,4,1,4,4,0,1,1,4.0,,4,0,1,1,4.0,80,6.91,71,366,2385,11.6
4826,Chris Luongo,1995-96,28.0,5,12,76,76,3,9,12,76.0,,80,3,10,13,80.0,84,7.25,87,443,2603,11.7
4827,Chris Luongo,1996-97,29.0,6,4,17,17,1,3,4,16.0,,97,4,13,17,96.0,84,6.48,76,407,2545,10.7
4828,Chris Luongo,1997-98,30.0,7,4,47,47,1,3,4,44.0,,144,5,16,21,140.0,48,5.97,37,209,1408,10.2
4829,Chris Luongo,1998-99,31.0,8,10,74,74,3,7,10,46.0,,218,8,23,31,186.0,82,6.29,74,413,2481,10.4
4830,Chris Marinucci,1997-98,26.0,4,5,12,12,1,4,5,11.0,,12,1,4,5,11.0,48,5.97,37,209,1408,10.2
4831,Chris Marinucci,1999-00,28.0,5,0,1,1,0,0,0,1.0,,13,1,4,5,12.0,82,5.83,55,336,2444,9.8
4832,Chris McAllister,2000-01,25.0,4,3,36,36,1,2,3,15.0,,36,1,2,3,15.0,82,5.28,57,380,2242,9.6
4833,Chris McAllister,2001-02,26.0,5,4,48,48,1,3,4,18.0,444.0,84,2,5,7,33.0,82,5.27,57,359,2285,9.4
4834,Chris McAllister,2002-03,27.0,6,3,36,36,0,3,3,12.0,433.0,120,2,8,10,45.0,82,5.49,53,331,2294,9.8
4835,Chris McAllister,2003-04,28.0,7,4,60,60,2,2,4,33.0,696.0,180,4,10,14,78.0,82,5.51,63,376,2272,9.9
4836,Chris McAllister,2004-05,29.0,8,5,42,42,0,5,5,26.0,386.0,222,4,15,19,104.0,82,5.24,53,338,2262,9.5
4837,Chris McAllister,2005-06,30.0,9,1,33,33,0,1,1,13.0,294.0,255,4,16,20,117.0,82,5.31,60,363,2326,9.4
4838,Chris McAllister,2006-07,31.0,10,1,46,46,0,1,1,19.0,343.0,301,4,17,21,136.0,82,5.14,57,348,2300,9.2
4839,Chris McAlpine,1997-98,26.0,4,3,24,24,0,3,3,19.0,,24,0,3,3,19.0,48,5.97,37,209,1408,10.2
4840,Chris McAlpine,1999-00,28.0,5,0,15,15,0,0,0,3.0,,39,0,3,3,22.0,82,5.83,55,336,2444,9.8
4841,Chris McAlpine,2000-01,29.0,6,10,54,54,3,7,10,35.0,,93,3,10,13,57.0,82,5.28,57,380,2242,9.6
4842,Chris McAlpine,2001-02,30.0,7,2,51,51,1,1,2,56.0,655.0,144,4,11,15,113.0,82,5.27,57,359,2285,9.4
4843,Chris McAlpine,2002-03,31.0,8,4,34,34,2,2,4,34.0,488.0,178,6,13,19,147.0,82,5.49,53,331,2294,9.8
4844,Chris McAlpine,2003-04,32.0,9,6,50,50,0,6,6,61.0,884.0,228,6,19,25,208.0,82,5.51,63,376,2272,9.9
4845,Chris McAlpine,2004-05,33.0,10,3,40,40,0,3,3,40.0,614.0,268,6,22,28,248.0,82,5.24,53,338,2262,9.5
4846,Chris McAlpine,2005-06,34.0,11,2,21,21,0,2,2,15.0,267.0,289,6,24,30,263.0,82,5.31,60,363,2326,9.4
4847,Chris McRae,1990-91,25.0,4,0,11,11,0,0,0,0.0,,11,0,0,0,0.0,80,7.43,89,437,2435,12.2
4848,Chris McRae,1991-92,26.0,5,0,3,3,0,0,0,0.0,,14,0,0,0,0.0,80,7.48,85,403,2430,12.3
4849,Chris McRae,1992-93,27.0,6,1,7,7,1,0,1,1.0,,21,1,0,1,1.0,80,7.37,76,367,2421,12.2
4850,Chris Minard,2010-11,29.0,4,2,15,15,1,1,2,9.0,58.0,15,1,1,2,9.0,82,5.44,62,351,2383,9.4
4851,Chris Minard,2011-12,30.0,5,3,20,20,1,2,3,33.0,188.0,35,2,3,5,42.0,82,5.7,65,341,2477,9.4
4852,Chris Minard,2012-13,31.0,6,1,5,5,0,1,1,4.0,49.0,40,2,4,6,46.0,82,5.53,56,304,2486,9.1
4853,Chris Mueller,2013-14,27.0,4,3,15,15,0,3,3,7.0,130.0,15,0,3,3,7.0,82,5.46,52,291,2492,9.0
4854,Chris Mueller,2014-15,28.0,5,0,4,4,0,0,0,4.0,37.0,19,0,3,3,11.0,82,5.32,47,271,2439,8.9
4855,Chris Mueller,2015-16,29.0,6,5,18,18,2,3,5,22.0,193.0,37,2,6,8,33.0,48,5.31,29,160,1399,9.1
4856,Chris Mueller,2016-17,30.0,7,0,9,9,0,0,0,8.0,83.0,46,2,6,8,41.0,82,5.34,48,269,2463,8.9
4857,Chris Mueller,2017-18,31.0,8,2,7,7,1,1,2,10.0,73.0,53,3,7,10,51.0,82,5.32,47,251,2453,8.9
4858,Chris Murray,1997-98,23.0,4,0,3,3,0,0,0,0.0,,3,0,0,0,0.0,48,5.97,37,209,1408,10.2
4859,Chris Murray,1998-99,24.0,5,7,48,48,3,4,7,32.0,,51,3,4,7,32.0,82,6.29,74,413,2481,10.4
4860,Chris Murray,1999-00,25.0,6,8,64,64,5,3,8,41.0,,115,8,7,15,73.0,82,5.83,55,336,2444,9.8
4861,Chris Murray,2000-01,26.0,7,9,53,53,5,4,9,51.0,,168,13,11,24,124.0,82,5.28,57,380,2242,9.6
4862,Chris Murray,2001-02,27.0,8,7,42,42,1,6,7,37.0,299.0,210,14,17,31,161.0,82,5.27,57,359,2285,9.4
4863,Chris Murray,2002-03,28.0,9,3,32,32,2,1,3,25.0,170.0,242,16,18,34,186.0,82,5.49,53,331,2294,9.8
4864,Chris Neil,2004-05,25.0,4,17,72,72,10,7,17,56.0,602.0,72,10,7,17,56.0,82,5.24,53,338,2262,9.5
4865,Chris Neil,2005-06,26.0,5,10,68,68,6,4,10,62.0,521.0,140,16,11,27,118.0,82,5.31,60,363,2326,9.4
4866,Chris Neil,2006-07,27.0,6,16,82,82,8,8,16,76.0,726.0,222,24,19,43,194.0,82,5.14,57,348,2300,9.2
4867,Chris Neil,2008-09,29.0,7,33,79,79,16,17,33,126.0,972.0,301,40,36,76,320.0,82,6.05,85,480,2458,10.1
4868,Chris Neil,2009-10,30.0,8,28,82,82,12,16,28,139.0,1076.0,383,52,52,104,459.0,82,5.76,70,398,2426,9.7
4869,Chris Neil,2010-11,31.0,9,20,68,68,6,14,20,78.0,868.0,451,58,66,124,537.0,82,5.44,62,351,2383,9.4
4870,Chris Neil,2011-12,32.0,10,10,60,60,3,7,10,59.0,658.0,511,61,73,134,596.0,82,5.7,65,341,2477,9.4
4871,Chris Neil,2012-13,33.0,11,22,68,68,10,12,22,100.0,815.0,579,71,85,156,696.0,82,5.53,56,304,2486,9.1
4872,Chris Neil,2013-14,34.0,12,16,80,80,6,10,16,105.0,1021.0,659,77,95,172,801.0,82,5.46,52,291,2492,9.0
4873,Chris Neil,2014-15,35.0,13,28,72,72,13,15,28,127.0,921.0,731,90,110,200,928.0,82,5.32,47,271,2439,8.9
4874,Chris Neil,2015-16,36.0,14,12,48,48,4,8,12,87.0,665.0,779,94,118,212,1015.0,48,5.31,29,160,1399,9.1
4875,Chris Neil,2016-17,37.0,15,14,76,76,8,6,14,99.0,897.0,855,102,124,226,1114.0,82,5.34,48,269,2463,8.9
4876,Chris Neil,2017-18,38.0,16,7,38,38,4,3,7,23.0,370.0,893,106,127,233,1137.0,82,5.32,47,251,2453,8.9
4877,Chris Neil,2018-19,39.0,17,13,80,80,5,8,13,70.0,744.0,973,111,135,246,1207.0,82,5.34,48,255,2438,9.0
4878,Chris Neil,2019-20,40.0,18,4,53,53,1,3,4,42.0,401.0,1026,112,138,250,1249.0,82,5.45,47,245,2478,9.0
4879,Chris Nielsen,2003-04,23.0,4,9,29,29,4,5,9,36.0,305.0,29,4,5,9,36.0,82,5.51,63,376,2272,9.9
4880,Chris Nielsen,2004-05,24.0,5,5,23,23,2,3,5,28.0,248.0,52,6,8,14,64.0,82,5.24,53,338,2262,9.5
4881,Chris Nilan,1982-83,24.0,4,2,15,15,0,2,2,8.0,,15,0,2,2,8.0,80,7.03,61,280,2352,12.0
4882,Chris Nilan,1983-84,25.0,5,15,57,57,7,8,15,69.0,,72,7,10,17,77.0,80,7.69,77,340,2441,12.6
4883,Chris Nilan,1984-85,26.0,6,11,49,49,7,4,11,45.0,,121,14,14,28,122.0,80,8.03,73,320,2489,12.9
4884,Chris Nilan,1985-86,27.0,7,14,66,66,6,8,14,67.0,,187,20,22,42,189.0,80,7.73,71,310,2444,12.7
4885,Chris Nilan,1986-87,28.0,8,26,76,76,16,10,26,98.0,,263,36,32,68,287.0,80,7.89,74,336,2448,12.9
4886,Chris Nilan,1987-88,29.0,9,37,77,77,21,16,37,98.0,,340,57,48,105,385.0,80,7.77,71,321,2447,12.7
4887,Chris Nilan,1988-89,30.0,10,34,72,72,19,15,34,120.0,,412,76,63,139,505.0,80,7.94,82,370,2484,12.8
4888,Chris Nilan,1989-90,31.0,11,20,44,44,4,16,20,68.0,,456,80,79,159,573.0,80,7.34,72,344,2400,12.2
4889,Chris Nilan,1990-91,32.0,12,20,72,72,10,10,20,88.0,,528,90,89,179,661.0,80,7.43,89,437,2435,12.2
4890,Chris Nilan,1991-92,33.0,13,14,38,38,7,7,14,39.0,,566,97,96,193,700.0,80,7.48,85,403,2430,12.3
4891,Chris Nilan,1992-93,34.0,14,3,25,25,1,2,3,24.0,,591,98,98,196,724.0,80,7.37,76,367,2421,12.2
4892,Chris Nilan,1993-94,35.0,15,15,41,41,6,9,15,41.0,,632,104,107,211,765.0,80,6.91,71,366,2385,11.6
4893,Chris Nilan,1994-95,36.0,16,14,56,56,6,8,14,55.0,,688,110,115,225,820.0,80,6.96,77,402,2440,11.4
4894,Chris O'Sullivan,1999-00,25.0,4,10,27,27,2,8,10,41.0,,27,2,8,10,41.0,82,5.83,55,336,2444,9.8
4895,Chris O'Sullivan,2000-01,26.0,5,2,12,12,0,2,2,12.0,,39,2,10,12,53.0,82,5.28,57,380,2242,9.6
4896,Chris O'Sullivan,2001-02,27.0,6,1,10,10,0,1,1,10.0,91.0,49,2,11,13,63.0,82,5.27,57,359,2285,9.4
4897,Chris O'Sullivan,2002-03,28.0,7,5,11,11,0,5,5,16.0,196.0,60,2,16,18,79.0,82,5.49,53,331,2294,9.8
4898,Chris O'Sullivan,2005-06,31.0,8,1,2,2,0,1,1,3.0,26.0,62,2,17,19,82.0,82,5.31,60,363,2326,9.4
4899,Chris Phillips,2000-01,22.0,4,16,72,72,5,11,16,107.0,,72,5,11,16,107.0,82,5.28,57,380,2242,9.6
4900,Chris Phillips,2001-02,23.0,5,6,34,34,3,3,6,51.0,615.0,106,8,14,22,158.0,82,5.27,57,359,2285,9.4
4901,Chris Phillips,2002-03,24.0,6,19,65,65,5,14,19,96.0,1094.0,171,13,28,41,254.0,82,5.49,53,331,2294,9.8
4902,Chris Phillips,2003-04,25.0,7,14,73,73,2,12,14,77.0,1567.0,244,15,40,55,331.0,82,5.51,63,376,2272,9.9
4903,Chris Phillips,2004-05,26.0,8,22,63,63,6,16,22,103.0,1229.0,307,21,56,77,434.0,82,5.24,53,338,2262,9.5
4904,Chris Phillips,2005-06,27.0,9,19,78,78,3,16,19,97.0,1577.0,385,24,72,96,531.0,82,5.31,60,363,2326,9.4
4905,Chris Phillips,2006-07,28.0,10,23,82,82,7,16,23,93.0,1709.0,467,31,88,119,624.0,82,5.14,57,348,2300,9.2
4906,Chris Phillips,2008-09,30.0,11,19,69,69,1,18,19,79.0,1440.0,536,32,106,138,703.0,82,6.05,85,480,2458,10.1
4907,Chris Phillips,2009-10,31.0,12,26,82,82,8,18,26,94.0,1833.0,618,40,124,164,797.0,82,5.76,70,398,2426,9.7
4908,Chris Phillips,2010-11,32.0,13,18,81,81,5,13,18,80.0,1821.0,699,45,137,182,877.0,82,5.44,62,351,2383,9.4
4909,Chris Phillips,2011-12,33.0,14,22,82,82,6,16,22,88.0,1793.0,781,51,153,204,965.0,82,5.7,65,341,2477,9.4
4910,Chris Phillips,2012-13,34.0,15,24,82,82,8,16,24,82.0,1833.0,863,59,169,228,1047.0,82,5.53,56,304,2486,9.1
4911,Chris Phillips,2013-14,35.0,16,9,82,82,1,8,9,81.0,1765.0,945,60,177,237,1128.0,82,5.46,52,291,2492,9.0
4912,Chris Phillips,2014-15,36.0,17,19,80,80,5,14,19,85.0,1529.0,1025,65,191,256,1213.0,82,5.32,47,271,2439,8.9
4913,Chris Phillips,2015-16,37.0,18,14,48,48,5,9,14,89.0,1010.0,1073,70,200,270,1302.0,48,5.31,29,160,1399,9.1
4914,Chris Phillips,2016-17,38.0,19,15,70,70,1,14,15,90.0,1346.0,1143,71,214,285,1392.0,82,5.34,48,269,2463,8.9
4915,Chris Phillips,2017-18,39.0,20,3,36,36,0,3,3,29.0,752.0,1179,71,217,288,1421.0,82,5.32,47,251,2453,8.9
4916,Chris Porter,2011-12,27.0,4,2,6,6,1,1,2,7.0,63.0,6,1,1,2,7.0,82,5.7,65,341,2477,9.4
4917,Chris Porter,2013-14,29.0,5,7,45,45,3,4,7,55.0,467.0,51,4,5,9,62.0,82,5.46,52,291,2492,9.0
4918,Chris Porter,2014-15,30.0,6,7,47,47,4,3,7,61.0,488.0,98,8,8,16,123.0,82,5.32,47,271,2439,8.9
4919,Chris Porter,2015-16,31.0,7,8,29,29,2,6,8,46.0,337.0,127,10,14,24,169.0,48,5.31,29,160,1399,9.1
4920,Chris Porter,2016-17,32.0,8,1,22,22,0,1,1,24.0,228.0,149,10,15,25,193.0,82,5.34,48,269,2463,8.9
4921,Chris Porter,2017-18,33.0,9,2,24,24,1,1,2,24.0,229.0,173,11,16,27,217.0,82,5.32,47,251,2453,8.9
4922,Chris Porter,2018-19,34.0,10,7,61,61,4,3,7,45.0,588.0,234,15,19,34,262.0,82,5.34,48,255,2438,9.0
4923,Chris Pronger,1996-97,22.0,4,30,81,81,5,25,30,174.0,,81,5,25,30,174.0,84,6.48,76,407,2545,10.7
4924,Chris Pronger,1997-98,23.0,5,14,43,43,5,9,14,94.0,,124,10,34,44,268.0,48,5.97,37,209,1408,10.2
4925,Chris Pronger,1998-99,24.0,6,25,78,78,7,18,25,138.0,,202,17,52,69,406.0,82,6.29,74,413,2481,10.4
4926,Chris Pronger,1999-00,25.0,7,35,79,79,11,24,35,147.0,,281,28,76,104,553.0,82,5.83,55,336,2444,9.8
4927,Chris Pronger,2000-01,26.0,8,36,81,81,9,27,36,145.0,,362,37,103,140,698.0,82,5.28,57,380,2242,9.6
4928,Chris Pronger,2001-02,27.0,9,46,67,67,13,33,46,172.0,2050.0,429,50,136,186,870.0,82,5.27,57,359,2285,9.4
4929,Chris Pronger,2002-03,28.0,10,62,79,79,14,48,62,192.0,2389.0,508,64,184,248,1062.0,82,5.49,53,331,2294,9.8
4930,Chris Pronger,2003-04,29.0,11,47,51,51,8,39,47,121.0,1415.0,559,72,223,295,1183.0,82,5.51,63,376,2272,9.9
4931,Chris Pronger,2004-05,30.0,12,47,78,78,7,40,47,204.0,2299.0,637,79,263,342,1387.0,82,5.24,53,338,2262,9.5
4932,Chris Pronger,2005-06,31.0,13,4,5,5,1,3,4,11.0,108.0,642,80,266,346,1398.0,82,5.31,60,363,2326,9.4
4933,Chris Pronger,2006-07,32.0,14,54,80,80,14,40,54,203.0,2197.0,722,94,306,400,1601.0,82,5.14,57,348,2300,9.2
4934,Chris Pronger,2008-09,34.0,15,56,80,80,12,44,56,155.0,2239.0,802,106,350,456,1756.0,82,6.05,85,480,2458,10.1
4935,Chris Pronger,2009-10,35.0,16,59,66,66,13,46,59,166.0,1789.0,868,119,396,515,1922.0,82,5.76,70,398,2426,9.7
4936,Chris Pronger,2010-11,36.0,17,43,72,72,12,31,43,182.0,1872.0,940,131,427,558,2104.0,82,5.44,62,351,2383,9.4
4937,Chris Pronger,2011-12,37.0,18,48,82,82,11,37,48,196.0,2209.0,1022,142,464,606,2300.0,82,5.7,65,341,2477,9.4
4938,Chris Pronger,2012-13,38.0,19,55,82,82,10,45,55,175.0,2126.0,1104,152,509,661,2475.0,82,5.53,56,304,2486,9.1
4939,Chris Pronger,2013-14,39.0,20,25,50,50,4,21,25,112.0,1125.0,1154,156,530,686,2587.0,82,5.46,52,291,2492,9.0
4940,Chris Pronger,2014-15,40.0,21,12,13,13,1,11,12,23.0,292.0,1167,157,541,698,2610.0,82,5.32,47,271,2439,8.9
4941,Chris Pryor,1987-88,27.0,4,0,4,4,0,0,0,2.0,,4,0,0,0,2.0,80,7.77,71,321,2447,12.7
4942,Chris Pryor,1988-89,28.0,5,1,7,7,0,1,1,8.0,,11,0,1,1,10.0,80,7.94,82,370,2484,12.8
4943,Chris Pryor,1989-90,29.0,6,4,50,50,1,3,4,20.0,,61,1,4,5,30.0,80,7.34,72,344,2400,12.2
4944,Chris Pryor,1990-91,30.0,7,0,4,4,0,0,0,4.0,,65,1,4,5,34.0,80,7.43,89,437,2435,12.2
4945,Chris Pryor,1991-92,31.0,8,0,7,7,0,0,0,2.0,,72,1,4,5,36.0,80,7.48,85,403,2430,12.3
4946,Chris Pryor,1992-93,32.0,9,0,10,10,0,0,0,2.0,,82,1,4,5,38.0,80,7.37,76,367,2421,12.2
4947,Chris Schmidt,2005-06,29.0,4,2,10,10,0,2,2,10.0,100.0,10,0,2,2,10.0,82,5.31,60,363,2326,9.4
4948,Chris Simon,1995-96,24.0,4,2,16,16,1,1,2,15.0,,16,1,1,2,15.0,84,7.25,87,443,2603,11.7
4949,Chris Simon,1996-97,25.0,5,8,37,37,4,4,8,39.0,,53,5,5,10,54.0,84,6.48,76,407,2545,10.7
4950,Chris Simon,1997-98,26.0,6,12,29,29,3,9,12,33.0,,82,8,14,22,87.0,48,5.97,37,209,1408,10.2
4951,Chris Simon,1998-99,27.0,7,34,64,64,16,18,34,105.0,,146,24,32,56,192.0,82,6.29,74,413,2481,10.4
4952,Chris Simon,1999-00,28.0,8,22,42,42,9,13,22,89.0,,188,33,45,78,281.0,82,5.83,55,336,2444,9.8
4953,Chris Simon,2000-01,29.0,9,17,28,28,7,10,17,71.0,,216,40,55,95,352.0,82,5.28,57,380,2242,9.6
4954,Chris Simon,2001-02,30.0,10,10,23,23,3,7,10,29.0,279.0,239,43,62,105,381.0,82,5.27,57,359,2285,9.4
4955,Chris Simon,2002-03,31.0,11,49,75,75,29,20,49,201.0,1165.0,314,72,82,154,582.0,82,5.49,53,331,2294,9.8
4956,Chris Simon,2003-04,32.0,12,20,60,60,10,10,20,123.0,874.0,374,82,92,174,705.0,82,5.51,63,376,2272,9.9
4957,Chris Simon,2004-05,33.0,13,31,82,82,14,17,31,121.0,1000.0,456,96,109,205,826.0,82,5.24,53,338,2262,9.5
4958,Chris Simon,2005-06,34.0,14,20,71,71,12,8,20,88.0,765.0,527,108,117,225,914.0,82,5.31,60,363,2326,9.4
4959,Chris Simon,2006-07,35.0,15,28,78,78,17,11,28,147.0,992.0,605,125,128,253,1061.0,82,5.14,57,348,2300,9.2
4960,Chris Simon,2008-09,37.0,16,22,72,72,8,14,22,76.0,751.0,677,133,142,275,1137.0,82,6.05,85,480,2458,10.1
4961,Chris Simon,2009-10,38.0,17,27,67,67,10,17,27,82.0,737.0,744,143,159,302,1219.0,82,5.76,70,398,2426,9.7
4962,Chris Simon,2010-11,39.0,18,3,38,38,1,2,3,27.0,273.0,782,144,161,305,1246.0,82,5.44,62,351,2383,9.4
4963,Chris Snell,1996-97,25.0,4,0,2,2,0,0,0,4.0,,2,0,0,0,4.0,84,6.48,76,407,2545,10.7
4964,Chris Snell,1997-98,26.0,5,9,32,32,2,7,9,45.0,,34,2,7,9,49.0,48,5.97,37,209,1408,10.2
4965,Chris Stewart,2011-12,24.0,4,19,53,53,11,8,19,98.0,653.0,53,11,8,19,98.0,82,5.7,65,341,2477,9.4
4966,Chris Stewart,2012-13,25.0,5,64,77,77,28,36,64,221.0,1286.0,130,39,44,83,319.0,82,5.53,56,304,2486,9.1
4967,Chris Stewart,2013-14,26.0,6,53,62,62,28,25,53,162.0,1084.0,192,67,69,136,481.0,82,5.46,52,291,2492,9.0
4968,Chris Stewart,2014-15,27.0,7,30,79,79,15,15,30,166.0,1220.0,271,82,84,166,647.0,82,5.32,47,271,2439,8.9
4969,Chris Stewart,2015-16,28.0,8,36,48,48,18,18,36,97.0,759.0,319,100,102,202,744.0,48,5.31,29,160,1399,9.1
4970,Chris Stewart,2016-17,29.0,9,26,63,63,15,11,26,110.0,862.0,382,115,113,228,854.0,82,5.34,48,269,2463,8.9
4971,Chris Stewart,2017-18,30.0,10,36,81,81,14,22,36,155.0,1286.0,463,129,135,264,1009.0,82,5.32,47,251,2453,8.9
4972,Chris Stewart,2018-19,31.0,11,20,56,56,8,12,20,78.0,605.0,519,137,147,284,1087.0,82,5.34,48,255,2438,9.0
4973,Chris Stewart,2019-20,32.0,12,21,79,79,13,8,21,82.0,821.0,598,150,155,305,1169.0,82,5.45,47,245,2478,9.0
4974,Chris Stewart,2020-21,33.0,13,16,54,54,10,6,16,68.0,580.0,652,160,161,321,1237.0,82,5.86,50,250,2620,9.2
4975,Chris Stewart,2022-23,35.0,14,1,16,16,0,1,1,5.0,124.0,668,160,162,322,1242.0,70,5.96,42,208,2192,9.5
4976,Chris Summers,2013-14,25.0,4,0,2,2,0,0,0,0.0,28.0,2,0,0,0,0.0,82,5.46,52,291,2492,9.0
4977,Chris Summers,2014-15,26.0,5,3,21,21,0,3,3,10.0,261.0,23,0,3,3,10.0,82,5.32,47,271,2439,8.9
4978,Chris Summers,2015-16,27.0,6,0,6,6,0,0,0,5.0,76.0,29,0,3,3,15.0,48,5.31,29,160,1399,9.1
4979,Chris Summers,2016-17,28.0,7,3,18,18,2,1,3,17.0,269.0,47,2,4,6,32.0,82,5.34,48,269,2463,8.9
4980,Chris Summers,2017-18,29.0,8,3,20,20,0,3,3,15.0,285.0,67,2,7,9,47.0,82,5.32,47,251,2453,8.9
4981,Chris Summers,2018-19,30.0,9,0,3,3,0,0,0,5.0,46.0,70,2,7,9,52.0,82,5.34,48,255,2438,9.0
4982,Chris Tamer,1996-97,26.0,4,0,12,12,0,0,0,10.0,,12,0,0,0,10.0,84,6.48,76,407,2545,10.7
4983,Chris Tamer,1997-98,27.0,5,2,36,36,2,0,2,26.0,,48,2,0,2,36.0,48,5.97,37,209,1408,10.2
4984,Chris Tamer,1998-99,28.0,6,14,70,70,4,10,14,75.0,,118,6,10,16,111.0,82,6.29,74,413,2481,10.4
4985,Chris Tamer,1999-00,29.0,7,6,45,45,2,4,6,56.0,,163,8,14,22,167.0,82,5.83,55,336,2444,9.8
4986,Chris Tamer,2000-01,30.0,8,7,79,79,0,7,7,55.0,,242,8,21,29,222.0,82,5.28,57,380,2242,9.6
4987,Chris Tamer,2001-02,31.0,9,6,63,63,1,5,6,48.0,867.0,305,9,26,35,270.0,82,5.27,57,359,2285,9.4
4988,Chris Tamer,2002-03,32.0,10,10,69,69,2,8,10,61.0,1275.0,374,11,34,45,331.0,82,5.49,53,331,2294,9.8
4989,Chris Tamer,2003-04,33.0,11,17,82,82,4,13,17,90.0,1615.0,456,15,47,62,421.0,82,5.51,63,376,2272,9.9
4990,Chris Tamer,2004-05,34.0,12,6,78,78,3,3,6,66.0,1442.0,534,18,50,68,487.0,82,5.24,53,338,2262,9.5
4991,Chris Tamer,2005-06,35.0,13,10,72,72,1,9,10,53.0,1129.0,606,19,59,78,540.0,82,5.31,60,363,2326,9.4
4992,Chris Tamer,2006-07,36.0,14,7,38,38,2,5,7,40.0,683.0,644,21,64,85,580.0,82,5.14,57,348,2300,9.2
4993,Chris Tancill,1993-94,25.0,4,2,9,9,1,1,2,6.0,,9,1,1,2,6.0,80,6.91,71,366,2385,11.6
4994,Chris Tancill,1994-95,26.0,5,0,11,11,0,0,0,13.0,,20,1,1,2,19.0,80,6.96,77,402,2440,11.4
4995,Chris Tancill,1995-96,27.0,6,1,4,4,1,0,1,3.0,,24,2,1,3,22.0,84,7.25,87,443,2603,11.7
4996,Chris Tancill,1996-97,28.0,7,4,12,12,1,3,4,18.0,,36,3,4,7,40.0,84,6.48,76,407,2545,10.7
4997,Chris Tancill,1997-98,29.0,8,14,26,26,3,11,14,39.0,,62,6,15,21,79.0,48,5.97,37,209,1408,10.2
4998,Chris Tancill,1998-99,30.0,9,23,45,45,7,16,23,93.0,,107,13,31,44,172.0,82,6.29,74,413,2481,10.4
4999,Chris Tancill,1999-00,31.0,10,4,25,25,4,0,4,20.0,,132,17,31,48,192.0,82,5.83,55,336,2444,9.8
5000,Chris Tancill,2000-01,32.0,11,1,2,2,0,1,1,1.0,,134,17,32,49,193.0,82,5.28,57,380,2242,9.6
5001,Chris Tanev,2013-14,24.0,4,1,29,29,0,1,1,15.0,400.0,29,0,1,1,15.0,82,5.46,52,291,2492,9.0
5002,Chris Tanev,2014-15,25.0,5,2,25,25,0,2,2,15.0,418.0,54,0,3,3,30.0,82,5.32,47,271,2439,8.9
5003,Chris Tanev,2015-16,26.0,6,7,38,38,2,5,7,20.0,657.0,92,2,8,10,50.0,48,5.31,29,160,1399,9.1
5004,Chris Tanev,2016-17,27.0,7,17,64,64,6,11,17,65.0,1327.0,156,8,19,27,115.0,82,5.34,48,269,2463,8.9
5005,Chris Tanev,2017-18,28.0,8,20,70,70,2,18,20,53.0,1476.0,226,10,37,47,168.0,82,5.32,47,251,2453,8.9
5006,Chris Tanev,2018-19,29.0,9,18,69,69,4,14,18,42.0,1501.0,295,14,51,65,210.0,82,5.34,48,255,2438,9.0
5007,Chris Tanev,2019-20,30.0,10,10,53,53,2,8,10,39.0,1078.0,348,16,59,75,249.0,82,5.45,47,245,2478,9.0
5008,Chris Tanev,2020-21,31.0,11,11,42,42,2,9,11,31.0,831.0,390,18,68,86,280.0,82,5.86,50,250,2620,9.2
5009,Chris Tanev,2021-22,32.0,12,12,55,55,2,10,12,51.0,1109.0,445,20,78,98,331.0,82,5.96,47,239,2579,9.5
5010,Chris Tanev,2022-23,33.0,13,20,69,69,2,18,20,45.0,1348.0,514,22,96,118,376.0,70,5.96,42,208,2192,9.5
5011,Chris Taylor,1997-98,25.0,4,3,10,10,0,3,3,13.0,,10,0,3,3,13.0,48,5.97,37,209,1408,10.2
5012,Chris Taylor,1998-99,26.0,5,1,11,11,0,1,1,4.0,,21,0,4,4,17.0,82,6.29,74,413,2481,10.4
5013,Chris Taylor,1999-00,27.0,6,0,1,1,0,0,0,1.0,,22,0,4,4,18.0,82,5.83,55,336,2444,9.8
5014,Chris Taylor,2001-02,29.0,7,8,37,37,3,5,8,60.0,533.0,59,3,9,12,78.0,82,5.27,57,359,2285,9.4
5015,Chris Taylor,2002-03,30.0,8,2,11,11,1,1,2,15.0,120.0,70,4,10,14,93.0,82,5.49,53,331,2294,9.8
5016,Chris Taylor,2003-04,31.0,9,2,14,14,0,2,2,21.0,156.0,84,4,12,16,114.0,82,5.51,63,376,2272,9.9
5017,Chris Taylor,2005-06,33.0,10,4,11,11,1,3,4,10.0,153.0,95,5,15,20,124.0,82,5.31,60,363,2326,9.4
5018,Chris Taylor,2006-07,34.0,11,12,54,54,6,6,12,50.0,549.0,149,11,21,32,174.0,82,5.14,57,348,2300,9.2
5019,Chris Terry,2015-16,26.0,4,1,3,3,1,0,1,1.0,29.0,3,1,0,1,1.0,48,5.31,29,160,1399,9.1
5020,Chris Terry,2016-17,27.0,5,2,10,10,0,2,2,13.0,121.0,13,1,2,3,14.0,82,5.34,48,269,2463,8.9
5021,Chris Terry,2017-18,28.0,6,20,57,57,11,9,20,71.0,725.0,70,12,11,23,85.0,82,5.32,47,251,2453,8.9
5022,Chris Terry,2018-19,29.0,7,11,68,68,8,3,11,78.0,767.0,138,20,14,34,163.0,82,5.34,48,255,2438,9.0
5023,Chris Terry,2019-20,30.0,8,4,14,14,2,2,4,15.0,138.0,152,22,16,38,178.0,82,5.45,47,245,2478,9.0
5024,Chris Therien,1997-98,26.0,4,13,48,48,3,10,13,53.0,,48,3,10,13,53.0,48,5.97,37,209,1408,10.2
5025,Chris Therien,1998-99,27.0,5,23,82,82,6,17,23,123.0,,130,9,27,36,176.0,82,6.29,74,413,2481,10.4
5026,Chris Therien,1999-00,28.0,6,24,71,71,2,22,24,107.0,,201,11,49,60,283.0,82,5.83,55,336,2444,9.8
5027,Chris Therien,2000-01,29.0,7,19,78,78,3,16,19,102.0,,279,14,65,79,385.0,82,5.28,57,380,2242,9.6
5028,Chris Therien,2001-02,30.0,8,18,74,74,3,15,18,115.0,1536.0,353,17,80,97,500.0,82,5.27,57,359,2285,9.4
5029,Chris Therien,2002-03,31.0,9,13,80,80,4,9,13,126.0,1617.0,433,21,89,110,626.0,82,5.49,53,331,2294,9.8
5030,Chris Therien,2003-04,32.0,10,14,73,73,2,12,14,103.0,1507.0,506,23,101,124,729.0,82,5.51,63,376,2272,9.9
5031,Chris Therien,2004-05,33.0,11,14,77,77,4,10,14,105.0,1439.0,583,27,111,138,834.0,82,5.24,53,338,2262,9.5
5032,Chris Therien,2005-06,34.0,12,7,67,67,1,6,7,93.0,1166.0,650,28,117,145,927.0,82,5.31,60,363,2326,9.4
5033,Chris Therien,2006-07,35.0,13,10,67,67,1,9,10,68.0,1237.0,717,29,126,155,995.0,82,5.14,57,348,2300,9.2
5034,Chris Therien,2008-09,37.0,14,4,47,47,0,4,4,16.0,647.0,764,29,130,159,1011.0,82,6.05,85,480,2458,10.1
5035,Chris Thorburn,2008-09,25.0,4,1,2,2,0,1,1,1.0,14.0,2,0,1,1,1.0,82,6.05,85,480,2458,10.1
5036,Chris Thorburn,2009-10,26.0,5,5,39,39,3,2,5,40.0,308.0,41,3,3,6,41.0,82,5.76,70,398,2426,9.7
5037,Chris Thorburn,2010-11,27.0,6,18,73,73,5,13,18,72.0,652.0,114,8,16,24,113.0,82,5.44,62,351,2383,9.4
5038,Chris Thorburn,2011-12,28.0,7,15,82,82,7,8,15,85.0,786.0,196,15,24,39,198.0,82,5.7,65,341,2477,9.4
5039,Chris Thorburn,2012-13,29.0,8,13,76,76,4,9,13,63.0,759.0,272,19,33,52,261.0,82,5.53,56,304,2486,9.1
5040,Chris Thorburn,2013-14,30.0,9,19,82,82,9,10,19,114.0,1131.0,354,28,43,71,375.0,82,5.46,52,291,2492,9.0
5041,Chris Thorburn,2014-15,31.0,10,11,72,72,4,7,11,69.0,733.0,426,32,50,82,444.0,82,5.32,47,271,2439,8.9
5042,Chris Thorburn,2015-16,32.0,11,4,42,42,2,2,4,13.0,266.0,468,34,52,86,457.0,48,5.31,29,160,1399,9.1
5043,Chris Thorburn,2016-17,33.0,12,11,55,55,2,9,11,26.0,492.0,523,36,61,97,483.0,82,5.34,48,269,2463,8.9
5044,Chris Thorburn,2017-18,34.0,13,14,81,81,7,7,14,67.0,655.0,604,43,68,111,550.0,82,5.32,47,251,2453,8.9
5045,Chris Thorburn,2018-19,35.0,14,12,82,82,6,6,12,70.0,830.0,686,49,74,123,620.0,82,5.34,48,255,2438,9.0
5046,Chris Thorburn,2019-20,36.0,15,4,64,64,3,1,4,36.0,446.0,750,52,75,127,656.0,82,5.45,47,245,2478,9.0
5047,Chris Thorburn,2020-21,37.0,16,7,50,50,1,6,7,35.0,352.0,800,53,81,134,691.0,82,5.86,50,250,2620,9.2
5048,Chris Thorburn,2021-22,38.0,17,0,1,1,0,0,0,0.0,2.0,801,53,81,134,691.0,82,5.96,47,239,2579,9.5
5049,Chris Tierney,2017-18,23.0,4,21,43,43,6,15,21,48.0,527.0,43,6,15,21,48.0,82,5.32,47,251,2453,8.9
5050,Chris Tierney,2018-19,24.0,5,20,79,79,7,13,20,96.0,1042.0,122,13,28,41,144.0,82,5.34,48,255,2438,9.0
5051,Chris Tierney,2019-20,25.0,6,23,80,80,11,12,23,90.0,1168.0,202,24,40,64,234.0,82,5.45,47,245,2478,9.0
5052,Chris Tierney,2020-21,26.0,7,40,82,82,17,23,40,118.0,1312.0,284,41,63,104,352.0,82,5.86,50,250,2620,9.2
5053,Chris Tierney,2021-22,27.0,8,48,81,81,9,39,48,116.0,1379.0,365,50,102,152,468.0,82,5.96,47,239,2579,9.5
5054,Chris Tierney,2022-23,28.0,9,37,71,71,11,26,37,102.0,1220.0,436,61,128,189,570.0,70,5.96,42,208,2192,9.5
5055,Chris Valentine,1984-85,23.0,4,67,60,60,30,37,67,154.0,,60,30,37,67,154.0,80,8.03,73,320,2489,12.9
5056,Chris Valentine,1985-86,24.0,5,17,23,23,7,10,17,23.0,,83,37,47,84,177.0,80,7.73,71,310,2444,12.7
5057,Chris Valentine,1986-87,25.0,6,11,22,22,6,5,11,33.0,,105,43,52,95,210.0,80,7.89,74,336,2448,12.9
5058,Chris VandeVelde,2013-14,26.0,4,2,12,12,0,2,2,16.0,207.0,12,0,2,2,16.0,82,5.46,52,291,2492,9.0
5059,Chris VandeVelde,2014-15,27.0,5,1,5,5,1,0,1,1.0,49.0,17,1,2,3,17.0,82,5.32,47,271,2439,8.9
5060,Chris VandeVelde,2015-16,28.0,6,0,11,11,0,0,0,7.0,78.0,28,1,2,3,24.0,48,5.31,29,160,1399,9.1
5061,Chris VandeVelde,2016-17,29.0,7,1,18,18,0,1,1,8.0,139.0,46,1,3,4,32.0,82,5.34,48,269,2463,8.9
5062,Chris VandeVelde,2017-18,30.0,8,15,72,72,9,6,15,70.0,845.0,118,10,9,19,102.0,82,5.32,47,251,2453,8.9
5063,Chris VandeVelde,2018-19,31.0,9,14,79,79,2,12,14,77.0,1071.0,197,12,21,33,179.0,82,5.34,48,255,2438,9.0
5064,Chris VandeVelde,2019-20,32.0,10,15,81,81,6,9,15,69.0,936.0,278,18,30,48,248.0,82,5.45,47,245,2478,9.0
5065,Chris Wagner,2017-18,26.0,4,0,9,9,0,0,0,7.0,79.0,9,0,0,0,7.0,82,5.32,47,251,2453,8.9
5066,Chris Wagner,2018-19,27.0,5,6,43,43,4,2,6,55.0,394.0,52,4,2,6,62.0,82,5.34,48,255,2438,9.0
5067,Chris Wagner,2019-20,28.0,6,7,43,43,6,1,7,40.0,402.0,95,10,3,13,102.0,82,5.45,47,245,2478,9.0
5068,Chris Wagner,2020-21,29.0,7,16,79,79,7,9,16,93.0,1049.0,174,17,12,29,195.0,82,5.86,50,250,2620,9.2
5069,Chris Wagner,2021-22,30.0,8,19,76,76,12,7,19,135.0,1022.0,250,29,19,48,330.0,82,5.96,47,239,2579,9.5
5070,Chris Wagner,2022-23,31.0,9,10,67,67,6,4,10,78.0,834.0,317,35,23,58,408.0,70,5.96,42,208,2192,9.5
5071,Chris Wells,1998-99,23.0,4,4,54,54,2,2,4,25.0,,54,2,2,4,25.0,82,6.29,74,413,2481,10.4
5072,Chris Wells,1999-00,24.0,5,8,47,47,2,6,8,29.0,,101,4,8,12,54.0,82,5.83,55,336,2444,9.8
5073,Chris Wells,2000-01,25.0,6,15,61,61,5,10,15,57.0,,162,9,18,27,111.0,82,5.28,57,380,2242,9.6
5074,Chris Wells,2001-02,26.0,7,2,20,20,0,2,2,28.0,237.0,182,9,20,29,139.0,82,5.27,57,359,2285,9.4
5075,Chris Wells,2002-03,27.0,8,0,13,13,0,0,0,5.0,109.0,195,9,20,29,144.0,82,5.49,53,331,2294,9.8
5076,Chris Wideman,2018-19,29.0,4,13,64,64,6,7,13,87.0,893.0,64,6,7,13,87.0,82,5.34,48,255,2438,9.0
5077,Chris Wideman,2019-20,30.0,5,17,76,76,5,12,17,123.0,1061.0,140,11,19,30,210.0,82,5.45,47,245,2478,9.0
5078,Chris Wideman,2020-21,31.0,6,8,16,16,3,5,8,24.0,185.0,156,14,24,38,234.0,82,5.86,50,250,2620,9.2
5079,Chris Wideman,2021-22,32.0,7,7,25,25,2,5,7,27.0,326.0,181,16,29,45,261.0,82,5.96,47,239,2579,9.5
5080,Chris Winnes,1994-95,26.0,4,4,24,24,1,3,4,20.0,,24,1,3,4,20.0,80,6.96,77,402,2440,11.4
5081,Chris Winnes,1995-96,27.0,5,1,5,5,0,1,1,2.0,,29,1,4,5,22.0,84,7.25,87,443,2603,11.7
5082,Chris Winnes,1996-97,28.0,6,2,4,4,0,2,2,4.0,,33,1,6,7,26.0,84,6.48,76,407,2545,10.7
5083,Christer Kellgren,1984-85,26.0,4,0,5,5,0,0,0,4.0,,5,0,0,0,4.0,80,8.03,73,320,2489,12.9
5084,Christer Olsson,1998-99,28.0,4,10,26,26,2,8,10,32.0,,26,2,8,10,32.0,82,6.29,74,413,2481,10.4
5085,Christer Olsson,1999-00,29.0,5,6,30,30,2,4,6,26.0,,56,4,12,16,58.0,82,5.83,55,336,2444,9.8
5086,Christian Backman,2005-06,25.0,4,0,4,4,0,0,0,4.0,49.0,4,0,0,0,4.0,82,5.31,60,363,2326,9.4
5087,Christian Backman,2006-07,26.0,5,18,66,66,5,13,18,92.0,1276.0,70,5,13,18,96.0,82,5.14,57,348,2300,9.2
5088,Christian Backman,2008-09,28.0,6,18,52,52,6,12,18,70.0,1290.0,122,11,25,36,166.0,82,6.05,85,480,2458,10.1
5089,Christian Backman,2009-10,29.0,7,18,61,61,7,11,18,80.0,1352.0,183,18,36,54,246.0,82,5.76,70,398,2426,9.7
5090,Christian Backman,2010-11,30.0,8,18,63,63,3,15,18,51.0,1210.0,246,21,51,72,297.0,82,5.44,62,351,2383,9.4
5091,Christian Backman,2011-12,31.0,9,7,56,56,2,5,7,54.0,877.0,302,23,56,79,351.0,82,5.7,65,341,2477,9.4
5092,Christian Berglund,2004-05,24.0,4,9,15,15,2,7,9,22.0,187.0,15,2,7,9,22.0,82,5.24,53,338,2262,9.5
5093,Christian Berglund,2005-06,25.0,5,9,38,38,4,5,9,50.0,387.0,53,6,12,18,72.0,82,5.31,60,363,2326,9.4
5094,Christian Berglund,2006-07,26.0,6,9,33,33,5,4,9,50.0,382.0,86,11,16,27,122.0,82,5.14,57,348,2300,9.2
5095,Christian Djoos,2020-21,26.0,4,14,63,63,3,11,14,60.0,884.0,63,3,11,14,60.0,82,5.86,50,250,2620,9.2
5096,Christian Djoos,2021-22,27.0,5,10,45,45,1,9,10,33.0,611.0,108,4,20,24,93.0,82,5.96,47,239,2579,9.5
5097,Christian Djoos,2022-23,28.0,6,3,11,11,1,2,3,13.0,210.0,119,5,22,27,106.0,70,5.96,42,208,2192,9.5
5098,Christian Dube,1999-00,22.0,4,2,27,27,1,1,2,14.0,,27,1,1,2,14.0,82,5.83,55,336,2444,9.8
5099,Christian Dube,2001-02,24.0,5,0,6,6,0,0,0,0.0,16.0,33,1,1,2,14.0,82,5.27,57,359,2285,9.4
5100,Christian Dvorak,2019-20,23.0,4,33,78,78,15,18,33,88.0,1218.0,78,15,18,33,88.0,82,5.45,47,245,2478,9.0
5101,Christian Dvorak,2020-21,24.0,5,37,78,78,15,22,37,151.0,1282.0,156,30,40,70,239.0,82,5.86,50,250,2620,9.2
5102,Christian Dvorak,2021-22,25.0,6,7,20,20,2,5,7,25.0,288.0,176,32,45,77,264.0,82,5.96,47,239,2579,9.5
5103,Christian Dvorak,2022-23,26.0,7,38,70,70,18,20,38,134.0,1169.0,246,50,65,115,398.0,70,5.96,42,208,2192,9.5
5104,Christian Ehrhoff,2006-07,24.0,4,12,41,41,1,11,12,58.0,630.0,41,1,11,12,58.0,82,5.14,57,348,2300,9.2
5105,Christian Ehrhoff,2008-09,26.0,5,23,64,64,5,18,23,124.0,1140.0,105,6,29,35,182.0,82,6.05,85,480,2458,10.1
5106,Christian Ehrhoff,2009-10,27.0,6,33,82,82,10,23,33,164.0,1523.0,187,16,52,68,346.0,82,5.76,70,398,2426,9.7
5107,Christian Ehrhoff,2010-11,28.0,7,22,77,77,1,21,22,97.0,1673.0,264,17,73,90,443.0,82,5.44,62,351,2383,9.4
5108,Christian Ehrhoff,2011-12,29.0,8,42,77,77,8,34,42,165.0,1635.0,341,25,107,132,608.0,82,5.7,65,341,2477,9.4
5109,Christian Ehrhoff,2012-13,30.0,9,44,80,80,14,30,44,181.0,1823.0,421,39,137,176,789.0,82,5.53,56,304,2486,9.1
5110,Christian Ehrhoff,2013-14,31.0,10,50,79,79,14,36,50,209.0,1895.0,500,53,173,226,998.0,82,5.46,52,291,2492,9.0
5111,Christian Ehrhoff,2014-15,32.0,11,32,66,66,5,27,32,136.0,1522.0,566,58,200,258,1134.0,82,5.32,47,271,2439,8.9
5112,Christian Ehrhoff,2015-16,33.0,12,22,47,47,5,17,22,102.0,1184.0,613,63,217,280,1236.0,48,5.31,29,160,1399,9.1
5113,Christian Ehrhoff,2016-17,34.0,13,33,79,79,6,27,33,161.0,1889.0,692,69,244,313,1397.0,82,5.34,48,269,2463,8.9
5114,Christian Ehrhoff,2017-18,35.0,14,14,49,49,3,11,14,110.0,1066.0,741,72,255,327,1507.0,82,5.32,47,251,2453,8.9
5115,Christian Ehrhoff,2018-19,36.0,15,12,48,48,2,10,12,80.0,743.0,789,74,265,339,1587.0,82,5.34,48,255,2438,9.0
5116,Christian Fischer,2019-20,22.0,4,3,7,7,3,0,3,10.0,86.0,7,3,0,3,10.0,82,5.45,47,245,2478,9.0
5117,Christian Fischer,2020-21,23.0,5,33,79,79,15,18,33,154.0,1098.0,86,18,18,36,164.0,82,5.86,50,250,2620,9.2
5118,Christian Fischer,2021-22,24.0,6,18,71,71,11,7,18,116.0,935.0,157,29,25,54,280.0,82,5.96,47,239,2579,9.5
5119,Christian Fischer,2022-23,25.0,7,9,56,56,6,3,9,83.0,617.0,213,35,28,63,363.0,70,5.96,42,208,2192,9.5
5120,Christian Folin,2016-17,25.0,4,1,1,1,0,1,1,0.0,19.0,1,0,1,1,0.0,82,5.34,48,269,2463,8.9
5121,Christian Folin,2017-18,26.0,5,10,40,40,2,8,10,39.0,608.0,41,2,9,11,39.0,82,5.32,47,251,2453,8.9
5122,Christian Folin,2018-19,27.0,6,4,26,26,0,4,4,14.0,379.0,67,2,13,15,53.0,82,5.34,48,255,2438,9.0
5123,Christian Folin,2019-20,28.0,7,8,51,51,2,6,8,39.0,762.0,118,4,19,23,92.0,82,5.45,47,245,2478,9.0
5124,Christian Folin,2020-21,29.0,8,13,65,65,3,10,13,58.0,1018.0,183,7,29,36,150.0,82,5.86,50,250,2620,9.2
5125,Christian Folin,2021-22,30.0,9,6,45,45,0,6,6,47.0,705.0,228,7,35,42,197.0,82,5.96,47,239,2579,9.5
5126,Christian Folin,2022-23,31.0,10,2,16,16,1,1,2,13.0,231.0,244,8,36,44,210.0,70,5.96,42,208,2192,9.5
5127,Christian Hanson,2011-12,25.0,4,2,5,5,1,1,2,9.0,82.0,5,1,1,2,9.0,82,5.7,65,341,2477,9.4
5128,Christian Hanson,2012-13,26.0,5,7,31,31,2,5,7,45.0,415.0,36,3,6,9,54.0,82,5.53,56,304,2486,9.1
5129,Christian Hanson,2013-14,27.0,6,0,6,6,0,0,0,2.0,51.0,42,3,6,9,56.0,82,5.46,52,291,2492,9.0
5130,Christian Jaros,2020-21,24.0,4,0,2,2,0,0,0,0.0,16.0,2,0,0,0,0.0,82,5.86,50,250,2620,9.2
5131,Christian Jaros,2021-22,25.0,5,10,61,61,1,9,10,65.0,876.0,63,1,9,10,65.0,82,5.96,47,239,2579,9.5
5132,Christian Jaros,2022-23,26.0,6,3,13,13,0,3,3,5.0,137.0,76,1,12,13,70.0,70,5.96,42,208,2192,9.5
5133,Christian Laflamme,1999-00,23.0,4,1,4,4,0,1,1,3.0,,4,0,1,1,3.0,82,5.83,55,336,2444,9.8
5134,Christian Laflamme,2000-01,24.0,5,11,72,72,0,11,11,75.0,,76,0,12,12,78.0,82,5.28,57,380,2242,9.6
5135,Christian Laflamme,2001-02,25.0,6,14,73,73,2,12,14,68.0,1351.0,149,2,24,26,146.0,82,5.27,57,359,2285,9.4
5136,Christian Laflamme,2002-03,26.0,7,7,65,65,0,7,7,24.0,902.0,214,2,31,33,170.0,82,5.49,53,331,2294,9.8
5137,Christian Laflamme,2003-04,27.0,8,3,39,39,0,3,3,16.0,471.0,253,2,34,36,186.0,82,5.51,63,376,2272,9.9
5138,Christian Laflamme,2004-05,28.0,9,1,8,8,0,1,1,6.0,111.0,261,2,35,37,192.0,82,5.24,53,338,2262,9.5
5139,Christian Laflamme,2005-06,29.0,10,9,47,47,0,9,9,44.0,713.0,308,2,44,46,236.0,82,5.31,60,363,2326,9.4
5140,Christian Laflamme,2006-07,30.0,11,1,16,16,0,1,1,9.0,208.0,324,2,45,47,245.0,82,5.14,57,348,2300,9.2
5141,Christian Matte,1999-00,25.0,4,2,5,5,1,1,2,6.0,,5,1,1,2,6.0,82,5.83,55,336,2444,9.8
5142,Christian Matte,2000-01,26.0,5,0,5,5,0,0,0,5.0,,10,1,1,2,11.0,82,5.28,57,380,2242,9.6
5143,Christian Matte,2001-02,27.0,6,2,7,7,1,1,2,9.0,54.0,17,2,2,4,20.0,82,5.27,57,359,2285,9.4
5144,Christian Matte,2002-03,28.0,7,1,5,5,0,1,1,1.0,43.0,22,2,3,5,21.0,82,5.49,53,331,2294,9.8
5145,Christian Matte,2003-04,29.0,8,0,3,3,0,0,0,8.0,40.0,25,2,3,5,29.0,82,5.51,63,376,2272,9.9
5146,Christian Proulx,1996-97,23.0,4,3,7,7,1,2,3,11.0,,7,1,2,3,11.0,84,6.48,76,407,2545,10.7
5147,Christian Ruuttu,1989-90,25.0,4,65,76,76,22,43,65,168.0,,76,22,43,65,168.0,80,7.34,72,344,2400,12.2
5148,Christian Ruuttu,1990-91,26.0,5,71,73,73,26,45,71,185.0,,149,48,88,136,353.0,80,7.43,89,437,2435,12.2
5149,Christian Ruuttu,1991-92,27.0,6,60,67,67,14,46,60,149.0,,216,62,134,196,502.0,80,7.48,85,403,2430,12.3
5150,Christian Ruuttu,1992-93,28.0,7,60,75,75,19,41,60,160.0,,291,81,175,256,662.0,80,7.37,76,367,2421,12.2
5151,Christian Ruuttu,1993-94,29.0,8,50,77,77,16,34,50,155.0,,368,97,209,306,817.0,80,6.91,71,366,2385,11.6
5152,Christian Ruuttu,1994-95,30.0,9,25,70,70,4,21,25,108.0,,438,101,230,331,925.0,80,6.96,77,402,2440,11.4
5153,Christian Ruuttu,1995-96,31.0,10,54,84,84,17,37,54,187.0,,522,118,267,385,1112.0,84,7.25,87,443,2603,11.7
5154,Christian Ruuttu,1996-97,32.0,11,29,54,54,9,20,29,96.0,,576,127,287,414,1208.0,84,6.48,76,407,2545,10.7
5155,Christian Ruuttu,1997-98,33.0,12,18,45,45,7,11,18,69.0,,621,134,298,432,1277.0,48,5.97,37,209,1408,10.2
5156,Christian Tanguay,1984-85,22.0,4,0,2,2,0,0,0,0.0,,2,0,0,0,0.0,80,8.03,73,320,2489,12.9
5157,Christian Thomas,2015-16,23.0,4,0,1,1,0,0,0,2.0,13.0,1,0,0,0,2.0,48,5.31,29,160,1399,9.1
5158,Christian Thomas,2016-17,24.0,5,0,2,2,0,0,0,1.0,14.0,3,0,0,0,3.0,82,5.34,48,269,2463,8.9
5159,Christian Thomas,2017-18,25.0,6,1,18,18,1,0,1,26.0,164.0,21,1,0,1,29.0,82,5.32,47,251,2453,8.9
5160,Christian Thomas,2018-19,26.0,7,2,6,6,0,2,2,9.0,54.0,27,1,2,3,38.0,82,5.34,48,255,2438,9.0
5161,Christian Wolanin,2020-21,25.0,4,3,10,10,1,2,3,14.0,146.0,10,1,2,3,14.0,82,5.86,50,250,2620,9.2
5162,Christian Wolanin,2021-22,26.0,5,12,30,30,4,8,12,36.0,520.0,40,5,10,15,50.0,82,5.96,47,239,2579,9.5
5163,Christian Wolanin,2022-23,27.0,6,0,3,3,0,0,0,4.0,53.0,43,5,10,15,54.0,70,5.96,42,208,2192,9.5
5164,Christoffer Ehn,2021-22,25.0,4,9,60,60,3,6,9,49.0,637.0,60,3,6,9,49.0,82,5.96,47,239,2579,9.5
5165,Christoffer Ehn,2022-23,26.0,5,4,54,54,2,2,4,36.0,562.0,114,5,8,13,85.0,70,5.96,42,208,2192,9.5
5166,Christoph Bertschy,2018-19,24.0,4,0,3,3,0,0,0,3.0,21.0,3,0,0,0,3.0,82,5.34,48,255,2438,9.0
5167,Christoph Bertschy,2019-20,25.0,5,1,5,5,0,1,1,5.0,41.0,8,0,1,1,8.0,82,5.45,47,245,2478,9.0
5168,Christoph Bertschy,2020-21,26.0,6,0,1,1,0,0,0,0.0,5.0,9,0,1,1,8.0,82,5.86,50,250,2620,9.2
5169,Christoph Brandner,2006-07,31.0,4,9,35,35,4,5,9,50.0,467.0,35,4,5,9,50.0,82,5.14,57,348,2300,9.2
5170,Christoph Schubert,2008-09,26.0,4,10,56,56,4,6,10,72.0,622.0,56,4,6,10,72.0,82,6.05,85,480,2458,10.1
5171,Christoph Schubert,2009-10,27.0,5,25,80,80,8,17,25,97.0,898.0,136,12,23,35,169.0,82,5.76,70,398,2426,9.7
5172,Christoph Schubert,2010-11,28.0,6,24,82,82,8,16,24,137.0,1113.0,218,20,39,59,306.0,82,5.44,62,351,2383,9.4
5173,Christoph Schubert,2011-12,29.0,7,6,50,50,3,3,6,57.0,680.0,268,23,42,65,363.0,82,5.7,65,341,2477,9.4
5174,Christoph Schubert,2012-13,30.0,8,7,47,47,2,5,7,73.0,741.0,315,25,47,72,436.0,82,5.53,56,304,2486,9.1
5175,Christopher Breen,2016-17,27.0,4,2,9,9,0,2,2,4.0,84.0,9,0,2,2,4.0,82,5.34,48,269,2463,8.9
5176,Christopher Didomenico,2019-20,30.0,4,0,3,3,0,0,0,5.0,33.0,3,0,0,0,5.0,82,5.45,47,245,2478,9.0
5177,Christopher Didomenico,2020-21,31.0,5,10,24,24,6,4,10,23.0,283.0,27,6,4,10,28.0,82,5.86,50,250,2620,9.2
5178,Chuck Kobasew,2005-06,23.0,4,6,23,23,4,2,6,29.0,272.0,23,4,2,6,29.0,82,5.31,60,363,2326,9.4
5179,Chuck Kobasew,2006-07,24.0,5,17,70,70,6,11,17,78.0,726.0,93,10,13,23,107.0,82,5.14,57,348,2300,9.2
5180,Chuck Kobasew,2008-09,26.0,6,31,77,77,20,11,31,143.0,944.0,170,30,24,54,250.0,82,6.05,85,480,2458,10.1
5181,Chuck Kobasew,2009-10,27.0,7,19,50,50,5,14,19,93.0,717.0,220,35,38,73,343.0,82,5.76,70,398,2426,9.7
5182,Chuck Kobasew,2010-11,28.0,8,39,73,73,22,17,39,147.0,1290.0,293,57,55,112,490.0,82,5.44,62,351,2383,9.4
5183,Chuck Kobasew,2011-12,29.0,9,42,68,68,21,21,42,129.0,999.0,361,78,76,154,619.0,82,5.7,65,341,2477,9.4
5184,Chuck Kobasew,2012-13,30.0,10,15,49,49,9,6,15,71.0,682.0,410,87,82,169,690.0,82,5.53,56,304,2486,9.1
5185,Chuck Kobasew,2013-14,31.0,11,16,63,63,9,7,16,74.0,746.0,473,96,89,185,764.0,82,5.46,52,291,2492,9.0
5186,Chuck Kobasew,2014-15,32.0,12,14,58,58,7,7,14,65.0,687.0,531,103,96,199,829.0,82,5.32,47,271,2439,8.9
5187,Chuck Kobasew,2015-16,33.0,13,9,37,37,5,4,9,43.0,417.0,568,108,100,208,872.0,48,5.31,29,160,1399,9.1
5188,Chuck Kobasew,2016-17,34.0,14,2,33,33,2,0,2,37.0,370.0,601,110,100,210,909.0,82,5.34,48,269,2463,8.9
5189,Clark Bishop,2021-22,25.0,4,3,20,20,1,2,3,16.0,189.0,20,1,2,3,16.0,82,5.96,47,239,2579,9.5
5190,Clark Bishop,2022-23,26.0,5,1,5,5,0,1,1,4.0,38.0,25,1,3,4,20.0,70,5.96,42,208,2192,9.5
5191,Clark Donatelli,1992-93,27.0,4,6,25,25,3,3,6,25.0,,25,3,3,6,25.0,80,7.37,76,367,2421,12.2
5192,Clark Donatelli,1994-95,29.0,5,1,10,10,0,1,1,7.0,,35,3,4,7,32.0,80,6.96,77,402,2440,11.4
5193,Clarke MacArthur,2009-10,24.0,4,7,19,19,3,4,7,16.0,169.0,19,3,4,7,16.0,82,5.76,70,398,2426,9.7
5194,Clarke MacArthur,2010-11,25.0,5,15,37,37,8,7,15,51.0,539.0,56,11,11,22,67.0,82,5.44,62,351,2383,9.4
5195,Clarke MacArthur,2011-12,26.0,6,31,71,71,17,14,31,108.0,982.0,127,28,25,53,175.0,82,5.7,65,341,2477,9.4
5196,Clarke MacArthur,2012-13,27.0,7,35,81,81,16,19,35,129.0,1190.0,208,44,44,88,304.0,82,5.53,56,304,2486,9.1
5197,Clarke MacArthur,2013-14,28.0,8,62,82,82,21,41,62,154.0,1403.0,290,65,85,150,458.0,82,5.46,52,291,2492,9.0
5198,Clarke MacArthur,2014-15,29.0,9,43,73,73,20,23,43,148.0,1157.0,363,85,108,193,606.0,82,5.32,47,271,2439,8.9
5199,Clarke MacArthur,2015-16,30.0,10,20,40,40,8,12,20,62.0,596.0,403,93,120,213,668.0,48,5.31,29,160,1399,9.1
5200,Clarke MacArthur,2016-17,31.0,11,55,79,79,24,31,55,159.0,1393.0,482,117,151,268,827.0,82,5.34,48,269,2463,8.9
5201,Clarke MacArthur,2017-18,32.0,12,36,62,62,16,20,36,140.0,1054.0,544,133,171,304,967.0,82,5.32,47,251,2453,8.9
5202,Clarke MacArthur,2018-19,33.0,13,0,4,4,0,0,0,4.0,43.0,548,133,171,304,971.0,82,5.34,48,255,2438,9.0
5203,Clarke MacArthur,2019-20,34.0,14,0,4,4,0,0,0,5.0,54.0,552,133,171,304,976.0,82,5.45,47,245,2478,9.0
5204,Clarke Wilm,2001-02,25.0,4,18,78,78,10,8,18,94.0,900.0,78,10,8,18,94.0,82,5.27,57,359,2285,9.4
5205,Clarke Wilm,2002-03,26.0,5,22,78,78,10,12,22,81.0,986.0,156,20,20,40,175.0,82,5.49,53,331,2294,9.8
5206,Clarke Wilm,2003-04,27.0,6,15,81,81,7,8,15,85.0,1149.0,237,27,28,55,260.0,82,5.51,63,376,2272,9.9
5207,Clarke Wilm,2004-05,28.0,7,18,66,66,4,14,18,83.0,990.0,303,31,42,73,343.0,82,5.24,53,338,2262,9.5
5208,Clarke Wilm,2005-06,29.0,8,16,82,82,5,11,16,108.0,981.0,385,36,53,89,451.0,82,5.31,60,363,2326,9.4
5209,Clarke Wilm,2006-07,30.0,9,0,10,10,0,0,0,10.0,117.0,395,36,53,89,461.0,82,5.14,57,348,2300,9.2
5210,Clarke Wilm,2008-09,32.0,10,8,60,60,1,7,8,50.0,707.0,455,37,60,97,511.0,82,6.05,85,480,2458,10.1
5211,Claude Boivin,1994-95,24.0,4,18,58,58,5,13,18,46.0,,58,5,13,18,46.0,80,6.96,77,402,2440,11.4
5212,Claude Boivin,1995-96,25.0,5,9,30,30,5,4,9,21.0,,88,10,17,27,67.0,84,7.25,87,443,2603,11.7
5213,Claude Boivin,1996-97,26.0,6,3,41,41,2,1,3,17.0,,129,12,18,30,84.0,84,6.48,76,407,2545,10.7
5214,Claude Boivin,1997-98,27.0,7,1,3,3,0,1,1,0.0,,132,12,19,31,84.0,48,5.97,37,209,1408,10.2
5215,Claude Giroux,2010-11,23.0,4,0,2,2,0,0,0,2.0,19.0,2,0,0,0,2.0,82,5.44,62,351,2383,9.4
5216,Claude Giroux,2011-12,24.0,5,27,42,42,9,18,27,67.0,637.0,44,9,18,27,69.0,82,5.7,65,341,2477,9.4
5217,Claude Giroux,2012-13,25.0,6,47,82,82,16,31,47,145.0,1362.0,126,25,49,74,214.0,82,5.53,56,304,2486,9.1
5218,Claude Giroux,2013-14,26.0,7,76,82,82,25,51,76,169.0,1591.0,208,50,100,150,383.0,82,5.46,52,291,2492,9.0
5219,Claude Giroux,2014-15,27.0,8,93,77,77,28,65,93,242.0,1659.0,285,78,165,243,625.0,82,5.32,47,271,2439,8.9
5220,Claude Giroux,2015-16,28.0,9,48,48,48,13,35,48,137.0,1016.0,333,91,200,291,762.0,48,5.31,29,160,1399,9.1
5221,Claude Giroux,2016-17,29.0,10,86,82,82,28,58,86,223.0,1676.0,415,119,258,377,985.0,82,5.34,48,269,2463,8.9
5222,Claude Giroux,2017-18,30.0,11,73,81,81,25,48,73,279.0,1666.0,496,144,306,450,1264.0,82,5.32,47,251,2453,8.9
5223,Claude Giroux,2018-19,31.0,12,67,78,78,22,45,67,241.0,1603.0,574,166,351,517,1505.0,82,5.34,48,255,2438,9.0
5224,Claude Giroux,2019-20,32.0,13,58,82,82,14,44,58,199.0,1568.0,656,180,395,575,1704.0,82,5.45,47,245,2478,9.0
5225,Claude Giroux,2020-21,33.0,14,102,82,82,34,68,102,193.0,1670.0,738,214,463,677,1897.0,82,5.86,50,250,2620,9.2
5226,Claude Giroux,2021-22,34.0,15,85,82,82,22,63,85,229.0,1759.0,820,236,526,762,2126.0,82,5.96,47,239,2579,9.5
5227,Claude Giroux,2022-23,35.0,16,53,69,69,21,32,53,197.0,1310.0,889,257,558,815,2323.0,70,5.96,42,208,2192,9.5
5228,Claude Julien,1987-88,27.0,4,0,1,1,0,0,0,0.0,,1,0,0,0,0.0,80,7.77,71,321,2447,12.7
5229,Claude Julien,1988-89,28.0,5,1,13,13,0,1,1,4.0,,14,0,1,1,4.0,80,7.94,82,370,2484,12.8
5230,Claude Lapointe,1993-94,25.0,4,4,13,13,2,2,4,7.0,,13,2,2,4,7.0,80,6.91,71,366,2385,11.6
5231,Claude Lapointe,1994-95,26.0,5,33,78,78,13,20,33,95.0,,91,15,22,37,102.0,80,6.96,77,402,2440,11.4
5232,Claude Lapointe,1995-96,27.0,6,36,74,74,10,26,36,91.0,,165,25,48,73,193.0,84,7.25,87,443,2603,11.7
5233,Claude Lapointe,1996-97,28.0,7,28,59,59,11,17,28,73.0,,224,36,65,101,266.0,84,6.48,76,407,2545,10.7
5234,Claude Lapointe,1997-98,29.0,8,12,29,29,4,8,12,40.0,,253,40,73,113,306.0,48,5.97,37,209,1408,10.2
5235,Claude Lapointe,1998-99,30.0,9,9,35,35,4,5,9,44.0,,288,44,78,122,350.0,82,6.29,74,413,2481,10.4
5236,Claude Lapointe,1999-00,31.0,10,18,73,73,13,5,18,80.0,,361,57,83,140,430.0,82,5.83,55,336,2444,9.8
5237,Claude Lapointe,2000-01,32.0,11,20,78,78,10,10,20,82.0,,439,67,93,160,512.0,82,5.28,57,380,2242,9.6
5238,Claude Lapointe,2001-02,33.0,12,37,82,82,14,23,37,134.0,1587.0,521,81,116,197,646.0,82,5.27,57,359,2285,9.4
5239,Claude Lapointe,2002-03,34.0,13,31,76,76,15,16,31,129.0,1493.0,597,96,132,228,775.0,82,5.49,53,331,2294,9.8
5240,Claude Lapointe,2003-04,35.0,14,32,80,80,9,23,32,94.0,1494.0,677,105,155,260,869.0,82,5.51,63,376,2272,9.9
5241,Claude Lapointe,2004-05,36.0,15,21,80,80,9,12,21,74.0,1047.0,757,114,167,281,943.0,82,5.24,53,338,2262,9.5
5242,Claude Lapointe,2005-06,37.0,16,16,80,80,8,8,16,87.0,965.0,837,122,175,297,1030.0,82,5.31,60,363,2326,9.4
5243,Claude Lapointe,2006-07,38.0,17,8,42,42,5,3,8,26.0,465.0,879,127,178,305,1056.0,82,5.14,57,348,2300,9.2
5244,Claude Larose,1982-83,27.0,4,11,25,25,4,7,11,50.0,,25,4,7,11,50.0,80,7.03,61,280,2352,12.0
5245,Claude Lemieux,1986-87,21.0,4,2,8,8,1,1,2,7.0,,8,1,1,2,7.0,80,7.89,74,336,2448,12.9
5246,Claude Lemieux,1987-88,22.0,5,1,1,1,0,1,1,0.0,,9,1,2,3,7.0,80,7.77,71,321,2447,12.7
5247,Claude Lemieux,1988-89,23.0,6,3,10,10,1,2,3,16.0,,19,2,4,6,23.0,80,7.94,82,370,2484,12.8
5248,Claude Lemieux,1989-90,24.0,7,53,76,76,27,26,53,184.0,,95,29,30,59,207.0,80,7.34,72,344,2400,12.2
5249,Claude Lemieux,1990-91,25.0,8,61,78,78,31,30,61,241.0,,173,60,60,120,448.0,80,7.43,89,437,2435,12.2
5250,Claude Lemieux,1991-92,26.0,9,51,69,69,29,22,51,220.0,,242,89,82,171,668.0,80,7.48,85,403,2430,12.3
5251,Claude Lemieux,1992-93,27.0,10,18,39,39,8,10,18,104.0,,281,97,92,189,772.0,80,7.37,76,367,2421,12.2
5252,Claude Lemieux,1993-94,28.0,11,47,78,78,30,17,47,271.0,,359,127,109,236,1043.0,80,6.91,71,366,2385,11.6
5253,Claude Lemieux,1994-95,29.0,12,68,74,74,41,27,68,296.0,,433,168,136,304,1339.0,80,6.96,77,402,2440,11.4
5254,Claude Lemieux,1995-96,30.0,13,81,77,77,30,51,81,311.0,,510,198,187,385,1650.0,84,7.25,87,443,2603,11.7
5255,Claude Lemieux,1996-97,31.0,14,44,79,79,18,26,44,181.0,,589,216,213,429,1831.0,84,6.48,76,407,2545,10.7
5256,Claude Lemieux,1997-98,32.0,15,19,45,45,6,13,19,117.0,,634,222,226,448,1948.0,48,5.97,37,209,1408,10.2
5257,Claude Lemieux,1998-99,33.0,16,71,79,79,39,32,71,315.0,,713,261,258,519,2263.0,82,6.29,74,413,2481,10.4
5258,Claude Lemieux,1999-00,34.0,17,28,45,45,11,17,28,168.0,,758,272,275,547,2431.0,82,5.83,55,336,2444,9.8
5259,Claude Lemieux,2000-01,35.0,18,53,78,78,26,27,53,261.0,,836,298,302,600,2692.0,82,5.28,57,380,2242,9.6
5260,Claude Lemieux,2001-02,36.0,19,51,82,82,27,24,51,292.0,1741.0,918,325,326,651,2984.0,82,5.27,57,359,2285,9.4
5261,Claude Lemieux,2002-03,37.0,20,47,83,83,20,27,47,257.0,1497.0,1001,345,353,698,3241.0,82,5.49,53,331,2294,9.8
5262,Claude Lemieux,2003-04,38.0,21,26,46,46,10,16,26,99.0,791.0,1047,355,369,724,3340.0,82,5.51,63,376,2272,9.9
5263,Claude Lemieux,2004-05,39.0,22,41,82,82,16,25,41,174.0,1411.0,1129,371,394,765,3514.0,82,5.24,53,338,2262,9.5
5264,Claude Lemieux,2005-06,40.0,23,20,68,68,8,12,20,119.0,928.0,1197,379,406,785,3633.0,82,5.31,60,363,2326,9.4
5265,Claude Lemieux,2011-12,46.0,24,1,18,18,0,1,1,17.0,138.0,1215,379,407,786,3650.0,82,5.7,65,341,2477,9.4
5266,Claude Loiselle,1984-85,21.0,4,1,4,4,1,0,1,2.0,,4,1,0,1,2.0,80,8.03,73,320,2489,12.9
5267,Claude Loiselle,1985-86,22.0,5,2,18,18,2,0,2,24.0,,22,3,0,3,26.0,80,7.73,71,310,2444,12.7
5268,Claude Loiselle,1986-87,23.0,6,10,28,28,4,6,10,20.0,,50,7,6,13,46.0,80,7.89,74,336,2448,12.9
5269,Claude Loiselle,1987-88,24.0,7,9,30,30,8,1,9,30.0,,80,15,7,22,76.0,80,7.77,71,321,2447,12.7
5270,Claude Loiselle,1988-89,25.0,8,22,48,48,7,15,22,84.0,,128,22,22,44,160.0,80,7.94,82,370,2484,12.8
5271,Claude Loiselle,1989-90,26.0,9,40,75,75,16,24,40,145.0,,203,38,46,84,305.0,80,7.34,72,344,2400,12.2
5272,Claude Loiselle,1990-91,27.0,10,35,68,68,17,18,35,117.0,,271,55,64,119,422.0,80,7.43,89,437,2435,12.2
5273,Claude Loiselle,1991-92,28.0,11,21,74,74,7,14,21,92.0,,345,62,78,140,514.0,80,7.48,85,403,2430,12.3
5274,Claude Loiselle,1992-93,29.0,12,25,72,72,11,14,25,128.0,,417,73,92,165,642.0,80,7.37,76,367,2421,12.2
5275,Claude Loiselle,1993-94,30.0,13,17,66,66,6,11,17,89.0,,483,79,103,182,731.0,80,6.91,71,366,2385,11.6
5276,Claude Loiselle,1994-95,31.0,14,17,75,75,7,10,17,101.0,,558,86,113,199,832.0,80,6.96,77,402,2440,11.4
5277,Claude Loiselle,1995-96,32.0,15,8,41,41,5,3,8,41.0,,599,91,116,207,873.0,84,7.25,87,443,2603,11.7
5278,Claude Loiselle,1996-97,33.0,16,2,17,17,1,1,2,14.0,,616,92,117,209,887.0,84,6.48,76,407,2545,10.7
5279,Claude Noel,1982-83,27.0,4,0,7,7,0,0,0,5.0,,7,0,0,0,5.0,80,7.03,61,280,2352,12.0
5280,Claude Verret,1986-87,23.0,4,7,11,11,2,5,7,14.0,,11,2,5,7,14.0,80,7.89,74,336,2448,12.9
5281,Claude Verret,1987-88,24.0,5,0,3,3,0,0,0,5.0,,14,2,5,7,19.0,80,7.77,71,321,2447,12.7
5282,Claude Vilgrain,1990-91,27.0,4,2,6,6,1,1,2,7.0,,6,1,1,2,7.0,80,7.43,89,437,2435,12.2
5283,Claude Vilgrain,1992-93,29.0,5,3,6,6,1,2,3,13.0,,12,2,3,5,20.0,80,7.37,76,367,2421,12.2
5284,Claude Vilgrain,1994-95,31.0,6,46,71,71,19,27,46,88.0,,83,21,30,51,108.0,80,6.96,77,402,2440,11.4
5285,Claude Vilgrain,1995-96,32.0,7,2,4,4,0,2,2,2.0,,87,21,32,53,110.0,84,7.25,87,443,2603,11.7
5286,Claude Vilgrain,1996-97,33.0,8,0,2,2,0,0,0,0.0,,89,21,32,53,110.0,84,6.48,76,407,2545,10.7
5287,Claudio Scremin,1994-95,26.0,4,0,13,13,0,0,0,18.0,,13,0,0,0,18.0,80,6.96,77,402,2440,11.4
5288,Claudio Scremin,1995-96,27.0,5,1,4,4,0,1,1,4.0,,17,0,1,1,22.0,84,7.25,87,443,2603,11.7
5289,Clay Wilson,2010-11,27.0,4,2,7,7,1,1,2,12.0,118.0,7,1,1,2,12.0,82,5.44,62,351,2383,9.4
5290,Clay Wilson,2011-12,28.0,5,1,7,7,0,1,1,13.0,79.0,14,1,2,3,25.0,82,5.7,65,341,2477,9.4
5291,Clay Wilson,2012-13,29.0,6,0,2,2,0,0,0,0.0,22.0,16,1,2,3,25.0,82,5.53,56,304,2486,9.1
5292,Clay Wilson,2013-14,30.0,7,5,15,15,3,2,5,22.0,223.0,31,4,4,8,47.0,82,5.46,52,291,2492,9.0
5293,Clay Wilson,2014-15,31.0,8,0,5,5,0,0,0,7.0,66.0,36,4,4,8,54.0,82,5.32,47,271,2439,8.9
5294,Clayton Beddoes,1998-99,28.0,4,7,39,39,1,6,7,18.0,,39,1,6,7,18.0,82,6.29,74,413,2481,10.4
5295,Clayton Beddoes,1999-00,29.0,5,3,21,21,1,2,3,11.0,,60,2,8,10,29.0,82,5.83,55,336,2444,9.8
5296,Clayton Keller,2019-20,21.0,4,2,3,3,0,2,2,0.0,38.0,3,0,2,2,0.0,82,5.45,47,245,2478,9.0
5297,Clayton Keller,2020-21,22.0,5,65,82,82,23,42,65,212.0,1483.0,85,23,44,67,212.0,82,5.86,50,250,2620,9.2
5298,Clayton Keller,2021-22,23.0,6,47,82,82,14,33,47,200.0,1495.0,167,37,77,114,412.0,82,5.96,47,239,2579,9.5
5299,Clayton Keller,2022-23,24.0,7,44,70,70,17,27,44,184.0,1141.0,237,54,104,158,596.0,70,5.96,42,208,2192,9.5
5300,Clayton Stoner,2012-13,27.0,4,2,8,8,0,2,2,5.0,107.0,8,0,2,2,5.0,82,5.53,56,304,2486,9.1
5301,Clayton Stoner,2013-14,28.0,5,9,57,57,2,7,9,40.0,961.0,65,2,9,11,45.0,82,5.46,52,291,2492,9.0
5302,Clayton Stoner,2014-15,29.0,6,5,51,51,1,4,5,47.0,897.0,116,3,13,16,92.0,82,5.32,47,271,2439,8.9
5303,Clayton Stoner,2015-16,30.0,7,10,48,48,0,10,10,40.0,874.0,164,3,23,26,132.0,48,5.31,29,160,1399,9.1
5304,Clayton Stoner,2016-17,31.0,8,5,63,63,1,4,5,48.0,840.0,227,4,27,31,180.0,82,5.34,48,269,2463,8.9
5305,Clayton Stoner,2017-18,32.0,9,8,69,69,1,7,8,68.0,1217.0,296,5,34,39,248.0,82,5.32,47,251,2453,8.9
5306,Clayton Stoner,2018-19,33.0,10,6,50,50,1,5,6,32.0,768.0,346,6,39,45,280.0,82,5.34,48,255,2438,9.0
5307,Clayton Stoner,2019-20,34.0,11,3,14,14,1,2,3,16.0,246.0,360,7,41,48,296.0,82,5.45,47,245,2478,9.0
5308,Cliff Ronning,1989-90,24.0,4,25,42,42,11,14,25,66.0,,42,11,14,25,66.0,80,7.34,72,344,2400,12.2
5309,Cliff Ronning,1990-91,25.0,5,13,26,26,5,8,13,38.0,,68,16,22,38,104.0,80,7.43,89,437,2435,12.2
5310,Cliff Ronning,1991-92,26.0,6,55,64,64,24,31,55,150.0,,132,40,53,93,254.0,80,7.48,85,403,2430,12.3
5311,Cliff Ronning,1993-94,28.0,7,44,59,59,20,24,44,113.0,,191,60,77,137,367.0,80,6.91,71,366,2385,11.6
5312,Cliff Ronning,1994-95,29.0,8,71,80,80,24,47,71,216.0,,271,84,124,208,583.0,80,6.96,77,402,2440,11.4
5313,Cliff Ronning,1995-96,30.0,9,85,79,79,29,56,85,209.0,,350,113,180,293,792.0,84,7.25,87,443,2603,11.7
5314,Cliff Ronning,1996-97,31.0,10,68,76,76,25,43,68,197.0,,426,138,223,361,989.0,84,6.48,76,407,2545,10.7
5315,Cliff Ronning,1997-98,32.0,11,25,41,41,6,19,25,93.0,,467,144,242,386,1082.0,48,5.97,37,209,1408,10.2
5316,Cliff Ronning,1998-99,33.0,12,67,79,79,22,45,67,187.0,,546,166,287,453,1269.0,82,6.29,74,413,2481,10.4
5317,Cliff Ronning,1999-00,34.0,13,51,69,69,19,32,51,171.0,,615,185,319,504,1440.0,82,5.83,55,336,2444,9.8
5318,Cliff Ronning,2000-01,35.0,14,55,80,80,11,44,55,197.0,,695,196,363,559,1637.0,82,5.28,57,380,2242,9.6
5319,Cliff Ronning,2001-02,36.0,15,60,79,79,20,40,60,257.0,1526.0,774,216,403,619,1894.0,82,5.27,57,359,2285,9.4
5320,Cliff Ronning,2002-03,37.0,16,62,82,82,26,36,62,248.0,1490.0,856,242,439,681,2142.0,82,5.49,53,331,2294,9.8
5321,Cliff Ronning,2003-04,38.0,17,62,80,80,19,43,62,237.0,1390.0,936,261,482,743,2379.0,82,5.51,63,376,2272,9.9
5322,Cliff Ronning,2004-05,39.0,18,54,81,81,19,35,54,199.0,1357.0,1017,280,517,797,2578.0,82,5.24,53,338,2262,9.5
5323,Cliff Ronning,2005-06,40.0,19,48,80,80,17,31,48,171.0,1394.0,1097,297,548,845,2749.0,82,5.31,60,363,2326,9.4
5324,Cliff Ronning,2006-07,41.0,20,24,40,40,9,15,24,55.0,477.0,1137,306,563,869,2804.0,82,5.14,57,348,2300,9.2
5325,Cody Almond,2012-13,23.0,4,1,7,7,1,0,1,6.0,54.0,7,1,0,1,6.0,82,5.53,56,304,2486,9.1
5326,Cody Almond,2013-14,24.0,5,0,8,8,0,0,0,3.0,56.0,15,1,0,1,9.0,82,5.46,52,291,2492,9.0
5327,Cody Almond,2014-15,25.0,6,1,10,10,1,0,1,7.0,102.0,25,2,0,2,16.0,82,5.32,47,271,2439,8.9
5328,Cody Bass,2010-11,24.0,4,4,21,21,2,2,4,12.0,112.0,21,2,2,4,12.0,82,5.44,62,351,2383,9.4
5329,Cody Bass,2011-12,25.0,5,0,12,12,0,0,0,5.0,68.0,33,2,2,4,17.0,82,5.7,65,341,2477,9.4
5330,Cody Bass,2013-14,27.0,6,0,1,1,0,0,0,0.0,7.0,34,2,2,4,17.0,82,5.46,52,291,2492,9.0
5331,Cody Bass,2014-15,28.0,7,1,14,14,0,1,1,13.0,127.0,48,2,3,5,30.0,82,5.32,47,271,2439,8.9
5332,Cody Bass,2016-17,30.0,8,0,1,1,0,0,0,0.0,3.0,49,2,3,5,30.0,82,5.34,48,269,2463,8.9
5333,Cody Bass,2018-19,32.0,9,0,17,17,0,0,0,11.0,130.0,66,2,3,5,41.0,82,5.34,48,255,2438,9.0
5334,Cody Bass,2019-20,33.0,10,0,9,9,0,0,0,1.0,61.0,75,2,3,5,42.0,82,5.45,47,245,2478,9.0
5335,Cody Ceci,2016-17,23.0,4,9,49,49,3,6,9,82.0,843.0,49,3,6,9,82.0,82,5.34,48,269,2463,8.9
5336,Cody Ceci,2017-18,24.0,5,21,81,81,5,16,21,130.0,1562.0,130,8,22,30,212.0,82,5.32,47,251,2453,8.9
5337,Cody Ceci,2018-19,25.0,6,26,75,75,10,16,26,116.0,1448.0,205,18,38,56,328.0,82,5.34,48,255,2438,9.0
5338,Cody Ceci,2019-20,26.0,7,17,79,79,2,15,17,143.0,1833.0,284,20,53,73,471.0,82,5.45,47,245,2478,9.0
5339,Cody Ceci,2020-21,27.0,8,19,82,82,5,14,19,143.0,1914.0,366,25,67,92,614.0,82,5.86,50,250,2620,9.2
5340,Cody Ceci,2021-22,28.0,9,26,74,74,7,19,26,132.0,1670.0,440,32,86,118,746.0,82,5.96,47,239,2579,9.5
5341,Cody Ceci,2022-23,29.0,10,8,56,56,1,7,8,48.0,1150.0,496,33,93,126,794.0,70,5.96,42,208,2192,9.5
5342,Cody Eakin,2014-15,23.0,4,8,30,30,4,4,8,31.0,278.0,30,4,4,8,31.0,82,5.32,47,271,2439,8.9
5343,Cody Eakin,2015-16,24.0,5,24,48,48,7,17,24,67.0,724.0,78,11,21,32,98.0,48,5.31,29,160,1399,9.1
5344,Cody Eakin,2016-17,25.0,6,35,81,81,16,19,35,161.0,1404.0,159,27,40,67,259.0,82,5.34,48,269,2463,8.9
5345,Cody Eakin,2017-18,26.0,7,40,78,78,19,21,40,142.0,1341.0,237,46,61,107,401.0,82,5.32,47,251,2453,8.9
5346,Cody Eakin,2018-19,27.0,8,35,82,82,16,19,35,132.0,1342.0,319,62,80,142,533.0,82,5.34,48,255,2438,9.0
5347,Cody Eakin,2019-20,28.0,9,12,60,60,3,9,12,82.0,1009.0,379,65,89,154,615.0,82,5.45,47,245,2478,9.0
5348,Cody Eakin,2020-21,29.0,10,27,80,80,11,16,27,107.0,1163.0,459,76,105,181,722.0,82,5.86,50,250,2620,9.2
5349,Cody Eakin,2021-22,30.0,11,41,78,78,22,19,41,120.0,1200.0,537,98,124,222,842.0,82,5.96,47,239,2579,9.5
5350,Cody Eakin,2022-23,31.0,12,15,49,49,5,10,15,61.0,714.0,586,103,134,237,903.0,70,5.96,42,208,2192,9.5
5351,Cody Franson,2012-13,25.0,4,21,61,61,6,15,21,90.0,866.0,61,6,15,21,90.0,82,5.53,56,304,2486,9.1
5352,Cody Franson,2013-14,26.0,5,29,80,80,8,21,29,156.0,1214.0,141,14,36,50,246.0,82,5.46,52,291,2492,9.0
5353,Cody Franson,2014-15,27.0,6,21,57,57,5,16,21,65.0,923.0,198,19,52,71,311.0,82,5.32,47,271,2439,8.9
5354,Cody Franson,2015-16,28.0,7,29,45,45,4,25,29,70.0,845.0,243,23,77,100,381.0,48,5.31,29,160,1399,9.1
5355,Cody Franson,2016-17,29.0,8,33,79,79,5,28,33,115.0,1635.0,322,28,105,133,496.0,82,5.34,48,269,2463,8.9
5356,Cody Franson,2017-18,30.0,9,36,78,78,7,29,36,127.0,1531.0,400,35,134,169,623.0,82,5.32,47,251,2453,8.9
5357,Cody Franson,2018-19,31.0,10,17,59,59,4,13,17,92.0,993.0,459,39,147,186,715.0,82,5.34,48,255,2438,9.0
5358,Cody Franson,2019-20,32.0,11,19,68,68,3,16,19,93.0,1257.0,527,42,163,205,808.0,82,5.45,47,245,2478,9.0
5359,Cody Franson,2020-21,33.0,12,7,23,23,1,6,7,51.0,382.0,550,43,169,212,859.0,82,5.86,50,250,2620,9.2
5360,Cody Glass,2022-23,23.0,4,12,39,39,5,7,12,51.0,521.0,39,5,7,12,51.0,70,5.96,42,208,2192,9.5
5361,Cody Goloubef,2014-15,25.0,4,0,1,1,0,0,0,0.0,6.0,1,0,0,0,0.0,82,5.32,47,271,2439,8.9
5362,Cody Goloubef,2015-16,26.0,5,1,11,11,1,0,1,14.0,163.0,12,1,0,1,14.0,48,5.31,29,160,1399,9.1
5363,Cody Goloubef,2016-17,27.0,6,0,5,5,0,0,0,4.0,49.0,17,1,0,1,18.0,82,5.34,48,269,2463,8.9
5364,Cody Goloubef,2017-18,28.0,7,9,36,36,0,9,9,23.0,560.0,53,1,9,10,41.0,82,5.32,47,251,2453,8.9
5365,Cody Goloubef,2018-19,29.0,8,8,43,43,1,7,8,40.0,650.0,96,2,16,18,81.0,82,5.34,48,255,2438,9.0
5366,Cody Goloubef,2019-20,30.0,9,5,33,33,0,5,5,35.0,561.0,129,2,21,23,116.0,82,5.45,47,245,2478,9.0
5367,Cody Goloubef,2021-22,32.0,10,0,5,5,0,0,0,3.0,54.0,134,2,21,23,119.0,82,5.96,47,239,2579,9.5
5368,Cody Goloubef,2022-23,33.0,11,2,26,26,1,1,2,18.0,395.0,160,3,22,25,137.0,70,5.96,42,208,2192,9.5
5369,Cody Hodgson,2013-14,23.0,4,2,8,8,1,1,2,9.0,62.0,8,1,1,2,9.0,82,5.46,52,291,2492,9.0
5370,Cody Hodgson,2014-15,24.0,5,41,83,83,19,22,41,154.0,1147.0,91,20,23,43,163.0,82,5.32,47,271,2439,8.9
5371,Cody Hodgson,2015-16,25.0,6,34,48,48,15,19,34,114.0,883.0,139,35,42,77,277.0,48,5.31,29,160,1399,9.1
5372,Cody Hodgson,2016-17,26.0,7,44,72,72,20,24,44,182.0,1306.0,211,55,66,121,459.0,82,5.34,48,269,2463,8.9
5373,Cody Hodgson,2017-18,27.0,8,13,78,78,6,7,13,127.0,1002.0,289,61,73,134,586.0,82,5.32,47,251,2453,8.9
5374,Cody Hodgson,2018-19,28.0,9,8,39,39,3,5,8,65.0,419.0,328,64,78,142,651.0,82,5.34,48,255,2438,9.0
5375,Cody Kunyk,2016-17,26.0,4,0,1,1,0,0,0,2.0,10.0,1,0,0,0,2.0,82,5.34,48,269,2463,8.9
5376,Cody McCormick,2006-07,23.0,4,5,44,44,2,3,5,33.0,357.0,44,2,3,5,33.0,82,5.14,57,348,2300,9.2
5377,Cody McCormick,2008-09,25.0,5,8,45,45,4,4,8,43.0,347.0,89,6,7,13,76.0,82,6.05,85,480,2458,10.1
5378,Cody McCormick,2009-10,26.0,6,1,6,6,0,1,1,6.0,40.0,95,6,8,14,82.0,82,5.76,70,398,2426,9.7
5379,Cody McCormick,2010-11,27.0,7,4,40,40,2,2,4,45.0,439.0,135,8,10,18,127.0,82,5.44,62,351,2383,9.4
5380,Cody McCormick,2011-12,28.0,8,12,55,55,1,11,12,66.0,528.0,190,9,21,30,193.0,82,5.7,65,341,2477,9.4
5381,Cody McCormick,2013-14,30.0,9,20,81,81,8,12,20,104.0,887.0,271,17,33,50,297.0,82,5.46,52,291,2492,9.0
5382,Cody McCormick,2014-15,31.0,10,4,50,50,1,3,4,43.0,392.0,321,18,36,54,340.0,82,5.32,47,271,2439,8.9
5383,Cody McCormick,2015-16,32.0,11,0,8,8,0,0,0,6.0,52.0,329,18,36,54,346.0,48,5.31,29,160,1399,9.1
5384,Cody McCormick,2016-17,33.0,12,7,43,43,2,5,7,26.0,383.0,372,20,41,61,372.0,82,5.34,48,269,2463,8.9
5385,Cody McCormick,2017-18,34.0,13,4,33,33,1,3,4,31.0,387.0,405,21,44,65,403.0,82,5.32,47,251,2453,8.9
5386,Cody McLeod,2010-11,26.0,4,9,49,49,4,5,9,60.0,496.0,49,4,5,9,60.0,82,5.44,62,351,2383,9.4
5387,Cody McLeod,2011-12,27.0,5,20,79,79,15,5,20,118.0,915.0,128,19,10,29,178.0,82,5.7,65,341,2477,9.4
5388,Cody McLeod,2012-13,28.0,6,18,74,74,7,11,18,117.0,957.0,202,26,21,47,295.0,82,5.53,56,304,2486,9.1
5389,Cody McLeod,2013-14,29.0,7,8,71,71,5,3,8,73.0,694.0,273,31,24,55,368.0,82,5.46,52,291,2492,9.0
5390,Cody McLeod,2014-15,30.0,8,11,75,75,6,5,11,62.0,540.0,348,37,29,66,430.0,82,5.32,47,271,2439,8.9
5391,Cody McLeod,2015-16,31.0,9,12,48,48,8,4,12,79.0,628.0,396,45,33,78,509.0,48,5.31,29,160,1399,9.1
5392,Cody McLeod,2016-17,32.0,10,13,71,71,5,8,13,76.0,733.0,467,50,41,91,585.0,82,5.34,48,269,2463,8.9
5393,Cody McLeod,2017-18,33.0,11,12,82,82,7,5,12,94.0,917.0,549,57,46,103,679.0,82,5.32,47,251,2453,8.9
5394,Cody McLeod,2018-19,34.0,12,13,82,82,8,5,13,73.0,864.0,631,65,51,116,752.0,82,5.34,48,255,2438,9.0
5395,Cody McLeod,2019-20,35.0,13,6,59,59,5,1,6,30.0,423.0,690,70,52,122,782.0,82,5.45,47,245,2478,9.0
5396,Cody McLeod,2020-21,36.0,14,4,48,48,1,3,4,36.0,354.0,738,71,55,126,818.0,82,5.86,50,250,2620,9.2
5397,Cody McLeod,2021-22,37.0,15,1,38,38,1,0,1,22.0,246.0,776,72,55,127,840.0,82,5.96,47,239,2579,9.5
5398,Colby Armstrong,2008-09,26.0,4,40,47,47,16,24,40,86.0,896.0,47,16,24,40,86.0,82,6.05,85,480,2458,10.1
5399,Colby Armstrong,2009-10,27.0,5,34,80,80,12,22,34,145.0,1346.0,127,28,46,74,231.0,82,5.76,70,398,2426,9.7
5400,Colby Armstrong,2010-11,28.0,6,35,72,72,13,22,35,113.0,1157.0,199,41,68,109,344.0,82,5.44,62,351,2383,9.4
5401,Colby Armstrong,2011-12,29.0,7,40,82,82,22,18,40,141.0,1243.0,281,63,86,149,485.0,82,5.7,65,341,2477,9.4
5402,Colby Armstrong,2012-13,30.0,8,29,79,79,15,14,29,101.0,1169.0,360,78,100,178,586.0,82,5.53,56,304,2486,9.1
5403,Colby Armstrong,2013-14,31.0,9,23,50,50,8,15,23,69.0,806.0,410,86,115,201,655.0,82,5.46,52,291,2492,9.0
5404,Colby Armstrong,2014-15,32.0,10,3,29,29,1,2,3,14.0,270.0,439,87,117,204,669.0,82,5.32,47,271,2439,8.9
5405,Colby Armstrong,2015-16,33.0,11,5,37,37,2,3,5,33.0,414.0,476,89,120,209,702.0,48,5.31,29,160,1399,9.1
5406,Colby Cave,2020-21,26.0,4,0,3,3,0,0,0,2.0,34.0,3,0,0,0,2.0,82,5.86,50,250,2620,9.2
5407,Colby Cave,2021-22,27.0,5,8,53,53,3,5,8,58.0,653.0,56,3,5,8,60.0,82,5.96,47,239,2579,9.5
5408,Colby Cave,2022-23,28.0,6,1,11,11,1,0,1,5.0,106.0,67,4,5,9,65.0,70,5.96,42,208,2192,9.5
5409,Colby Cohen,2013-14,24.0,4,0,3,3,0,0,0,2.0,53.0,3,0,0,0,2.0,82,5.46,52,291,2492,9.0
5410,Colby Robak,2014-15,24.0,4,0,3,3,0,0,0,1.0,38.0,3,0,0,0,1.0,82,5.32,47,271,2439,8.9
5411,Colby Robak,2015-16,25.0,5,1,16,16,0,1,1,15.0,243.0,19,0,1,1,16.0,48,5.31,29,160,1399,9.1
5412,Colby Robak,2016-17,26.0,6,2,16,16,0,2,2,15.0,297.0,35,0,3,3,31.0,82,5.34,48,269,2463,8.9
5413,Colby Robak,2017-18,27.0,7,1,12,12,0,1,1,8.0,167.0,47,0,4,4,39.0,82,5.32,47,251,2453,8.9
5414,Cole Bardreau,2022-23,29.0,4,2,10,10,1,1,2,10.0,89.0,10,1,1,2,10.0,70,5.96,42,208,2192,9.5
5415,Cole Jarrett,2008-09,26.0,4,0,1,1,0,0,0,1.0,14.0,1,0,0,0,1.0,82,6.05,85,480,2458,10.1
5416,Cole Schneider,2018-19,28.0,4,0,2,2,0,0,0,5.0,25.0,2,0,0,0,5.0,82,5.34,48,255,2438,9.0
5417,Cole Schneider,2019-20,29.0,5,1,4,4,0,1,1,6.0,29.0,6,0,1,1,11.0,82,5.45,47,245,2478,9.0
5418,Colin Blackwell,2021-22,28.0,4,0,6,6,0,0,0,5.0,58.0,6,0,0,0,5.0,82,5.96,47,239,2579,9.5
5419,Colin Blackwell,2022-23,29.0,5,10,27,27,3,7,10,31.0,296.0,33,3,7,10,36.0,70,5.96,42,208,2192,9.5
5420,Colin Chisholm,1989-90,26.0,4,0,1,1,0,0,0,0.0,,1,0,0,0,0.0,80,7.34,72,344,2400,12.2
5421,Colin Forbes,1999-00,23.0,4,1,3,3,1,0,1,3.0,,3,1,0,1,3.0,82,5.83,55,336,2444,9.8
5422,Colin Forbes,2000-01,24.0,5,19,63,63,12,7,19,93.0,,66,13,7,20,96.0,82,5.28,57,380,2242,9.6
5423,Colin Forbes,2001-02,25.0,6,20,80,80,12,8,20,117.0,1076.0,146,25,15,40,213.0,82,5.27,57,359,2285,9.4
5424,Colin Forbes,2002-03,26.0,7,7,53,53,2,5,7,57.0,457.0,199,27,20,47,270.0,82,5.49,53,331,2294,9.8
5425,Colin Forbes,2003-04,27.0,8,6,58,58,1,5,6,46.0,390.0,257,28,25,53,316.0,82,5.51,63,376,2272,9.9
5426,Colin Forbes,2004-05,28.0,9,8,38,38,5,3,8,49.0,419.0,295,33,28,61,365.0,82,5.24,53,338,2262,9.5
5427,Colin Forbes,2005-06,29.0,10,0,5,5,0,0,0,3.0,48.0,300,33,28,61,368.0,82,5.31,60,363,2326,9.4
5428,Colin Forbes,2006-07,30.0,11,0,2,2,0,0,0,2.0,18.0,302,33,28,61,370.0,82,5.14,57,348,2300,9.2
5429,Colin Forbes,2008-09,32.0,12,0,9,9,0,0,0,10.0,74.0,311,33,28,61,380.0,82,6.05,85,480,2458,10.1
5430,Colin Fraser,2009-10,25.0,4,0,1,1,0,0,0,0.0,3.0,1,0,0,0,0.0,82,5.76,70,398,2426,9.7
5431,Colin Fraser,2010-11,26.0,5,0,5,5,0,0,0,4.0,52.0,6,0,0,0,4.0,82,5.44,62,351,2383,9.4
5432,Colin Fraser,2011-12,27.0,6,17,81,81,6,11,17,67.0,883.0,87,6,11,17,71.0,82,5.7,65,341,2477,9.4
5433,Colin Fraser,2012-13,28.0,7,19,70,70,7,12,19,92.0,672.0,157,13,23,36,163.0,82,5.53,56,304,2486,9.1
5434,Colin Fraser,2013-14,29.0,8,5,67,67,3,2,5,57.0,688.0,224,16,25,41,220.0,82,5.46,52,291,2492,9.0
5435,Colin Fraser,2014-15,30.0,9,8,67,67,2,6,8,54.0,652.0,291,18,31,49,274.0,82,5.32,47,271,2439,8.9
5436,Colin Fraser,2015-16,31.0,10,7,34,34,2,5,7,19.0,319.0,325,20,36,56,293.0,48,5.31,29,160,1399,9.1
5437,Colin Fraser,2016-17,32.0,11,2,33,33,0,2,2,22.0,297.0,358,20,38,58,315.0,82,5.34,48,269,2463,8.9
5438,Colin Fraser,2017-18,33.0,12,0,1,1,0,0,0,1.0,5.0,359,20,38,58,316.0,82,5.32,47,251,2453,8.9
5439,Colin Greening,2013-14,27.0,4,13,24,24,6,7,13,57.0,362.0,24,6,7,13,57.0,82,5.46,52,291,2492,9.0
5440,Colin Greening,2014-15,28.0,5,37,82,82,17,20,37,184.0,1278.0,106,23,27,50,241.0,82,5.32,47,271,2439,8.9
5441,Colin Greening,2015-16,29.0,6,19,47,47,8,11,19,80.0,692.0,153,31,38,69,321.0,48,5.31,29,160,1399,9.1
5442,Colin Greening,2016-17,30.0,7,17,76,76,6,11,17,108.0,1045.0,229,37,49,86,429.0,82,5.34,48,269,2463,8.9
5443,Colin Greening,2017-18,31.0,8,1,26,26,1,0,1,39.0,255.0,255,38,49,87,468.0,82,5.32,47,251,2453,8.9
5444,Colin Greening,2018-19,32.0,9,15,31,31,7,8,15,58.0,437.0,286,45,57,102,526.0,82,5.34,48,255,2438,9.0
5445,Colin Hemingway,2008-09,28.0,4,0,3,3,0,0,0,2.0,22.0,3,0,0,0,2.0,82,6.05,85,480,2458,10.1
5446,Colin McDonald,2012-13,28.0,4,1,2,2,1,0,1,3.0,13.0,2,1,0,1,3.0,82,5.53,56,304,2486,9.1
5447,Colin McDonald,2014-15,30.0,5,0,5,5,0,0,0,6.0,42.0,7,1,0,1,9.0,82,5.32,47,271,2439,8.9
5448,Colin McDonald,2015-16,31.0,6,17,45,45,7,10,17,82.0,512.0,52,8,10,18,91.0,48,5.31,29,160,1399,9.1
5449,Colin McDonald,2016-17,32.0,7,18,70,70,8,10,18,96.0,867.0,122,16,20,36,187.0,82,5.34,48,269,2463,8.9
5450,Colin McDonald,2017-18,33.0,8,8,18,18,2,6,8,29.0,189.0,140,18,26,44,216.0,82,5.32,47,251,2453,8.9
5451,Colin McDonald,2018-19,34.0,9,1,5,5,1,0,1,4.0,41.0,145,19,26,45,220.0,82,5.34,48,255,2438,9.0
5452,Colin McDonald,2019-20,35.0,10,1,3,3,1,0,1,5.0,27.0,148,20,26,46,225.0,82,5.45,47,245,2478,9.0
5453,Colin Miller,2018-19,26.0,4,16,42,42,3,13,16,59.0,663.0,42,3,13,16,59.0,82,5.34,48,255,2438,9.0
5454,Colin Miller,2019-20,27.0,5,13,61,61,6,7,13,85.0,965.0,103,9,20,29,144.0,82,5.45,47,245,2478,9.0
5455,Colin Miller,2020-21,28.0,6,41,82,82,10,31,41,177.0,1586.0,185,19,51,70,321.0,82,5.86,50,250,2620,9.2
5456,Colin Miller,2021-22,29.0,7,29,65,65,3,26,29,131.0,1277.0,250,22,77,99,452.0,82,5.96,47,239,2579,9.5
5457,Colin Miller,2022-23,30.0,8,11,51,51,1,10,11,79.0,874.0,301,23,87,110,531.0,70,5.96,42,208,2192,9.5
5458,Colin Patterson,1986-87,26.0,4,27,56,56,13,14,27,87.0,,56,13,14,27,87.0,80,7.89,74,336,2448,12.9
5459,Colin Patterson,1987-88,27.0,5,43,57,57,22,21,43,104.0,,113,35,35,70,191.0,80,7.77,71,321,2447,12.7
5460,Colin Patterson,1988-89,28.0,6,27,61,61,14,13,27,84.0,,174,49,48,97,275.0,80,7.94,82,370,2484,12.8
5461,Colin Patterson,1989-90,29.0,7,26,68,68,13,13,26,78.0,,242,62,61,123,353.0,80,7.34,72,344,2400,12.2
5462,Colin Patterson,1990-91,30.0,8,18,39,39,7,11,18,37.0,,281,69,72,141,390.0,80,7.43,89,437,2435,12.2
5463,Colin Patterson,1991-92,31.0,9,38,74,74,14,24,38,103.0,,355,83,96,179,493.0,80,7.48,85,403,2430,12.3
5464,Colin Patterson,1992-93,32.0,10,8,61,61,5,3,8,56.0,,416,88,99,187,549.0,80,7.37,76,367,2421,12.2
5465,Colin Patterson,1994-95,34.0,11,12,52,52,4,8,12,33.0,,468,92,107,199,582.0,80,6.96,77,402,2440,11.4
5466,Colin Patterson,1995-96,35.0,12,6,36,36,4,2,6,30.0,,504,96,109,205,612.0,84,7.25,87,443,2603,11.7
5467,Colin Smith,2017-18,24.0,4,0,1,1,0,0,0,1.0,6.0,1,0,0,0,1.0,82,5.32,47,251,2453,8.9
5468,Colin Stuart,2010-11,28.0,4,5,18,18,3,2,5,19.0,222.0,18,3,2,5,19.0,82,5.44,62,351,2383,9.4
5469,Colin Stuart,2011-12,29.0,5,8,33,33,5,3,8,54.0,412.0,51,8,5,13,73.0,82,5.7,65,341,2477,9.4
5470,Colin Stuart,2013-14,31.0,6,0,3,3,0,0,0,5.0,39.0,54,8,5,13,78.0,82,5.46,52,291,2492,9.0
5471,Colin Stuart,2014-15,32.0,7,0,2,2,0,0,0,0.0,12.0,56,8,5,13,78.0,82,5.32,47,271,2439,8.9
5472,Colin White,2002-03,25.0,4,3,21,21,2,1,3,29.0,310.0,21,2,1,3,29.0,82,5.49,53,331,2294,9.8
5473,Colin White,2003-04,26.0,5,20,82,82,1,19,20,114.0,1567.0,103,3,20,23,143.0,82,5.51,63,376,2272,9.9
5474,Colin White,2004-05,27.0,6,5,73,73,2,3,5,81.0,1467.0,176,5,23,28,224.0,82,5.24,53,338,2262,9.5
5475,Colin White,2005-06,28.0,7,13,72,72,5,8,13,81.0,1417.0,248,10,31,41,305.0,82,5.31,60,363,2326,9.4
5476,Colin White,2006-07,29.0,8,13,75,75,2,11,13,61.0,1577.0,323,12,42,54,366.0,82,5.14,57,348,2300,9.2
5477,Colin White,2008-09,31.0,9,17,73,73,3,14,17,60.0,1591.0,396,15,56,71,426.0,82,6.05,85,480,2458,10.1
5478,Colin White,2009-10,32.0,10,8,69,69,0,8,8,47.0,1550.0,465,15,64,79,473.0,82,5.76,70,398,2426,9.7
5479,Colin White,2010-11,33.0,11,10,57,57,2,8,10,27.0,1121.0,522,17,72,89,500.0,82,5.44,62,351,2383,9.4
5480,Colin White,2011-12,34.0,12,18,71,71,1,17,18,68.0,1350.0,593,18,89,107,568.0,82,5.7,65,341,2477,9.4
5481,Colin White,2012-13,35.0,13,12,81,81,2,10,12,47.0,1626.0,674,20,99,119,615.0,82,5.53,56,304,2486,9.1
5482,Colin White,2013-14,36.0,14,6,69,69,0,6,6,50.0,1301.0,743,20,105,125,665.0,82,5.46,52,291,2492,9.0
5483,Colin White,2014-15,37.0,15,4,54,54,1,3,4,33.0,807.0,797,21,108,129,698.0,82,5.32,47,271,2439,8.9
5484,Colin White0,2019-20,23.0,4,0,2,2,0,0,0,1.0,27.0,2,0,0,0,1.0,82,5.45,47,245,2478,9.0
5485,Colin White0,2020-21,24.0,5,6,21,21,2,4,6,24.0,280.0,23,2,4,6,25.0,82,5.86,50,250,2620,9.2
5486,Colin White0,2021-22,25.0,6,41,71,71,14,27,41,123.0,1150.0,94,16,31,47,148.0,82,5.96,47,239,2579,9.5
5487,Colin White0,2022-23,26.0,7,23,61,61,7,16,23,83.0,958.0,155,23,47,70,231.0,70,5.96,42,208,2192,9.5
5488,Colin Wilson,2012-13,23.0,4,15,35,35,8,7,15,58.0,531.0,35,8,7,15,58.0,82,5.53,56,304,2486,9.1
5489,Colin Wilson,2013-14,24.0,5,34,82,82,16,18,34,101.0,1090.0,117,24,25,49,159.0,82,5.46,52,291,2492,9.0
5490,Colin Wilson,2014-15,25.0,6,35,68,68,15,20,35,114.0,1097.0,185,39,45,84,273.0,82,5.32,47,271,2439,8.9
5491,Colin Wilson,2015-16,26.0,7,19,25,25,7,12,19,26.0,414.0,210,46,57,103,299.0,48,5.31,29,160,1399,9.1
5492,Colin Wilson,2016-17,27.0,8,33,81,81,11,22,33,112.0,1233.0,291,57,79,136,411.0,82,5.34,48,269,2463,8.9
5493,Colin Wilson,2017-18,28.0,9,42,77,77,20,22,42,172.0,1248.0,368,77,101,178,583.0,82,5.32,47,251,2453,8.9
5494,Colin Wilson,2018-19,29.0,10,24,64,64,6,18,24,108.0,925.0,432,83,119,202,691.0,82,5.34,48,255,2438,9.0
5495,Colin Wilson,2019-20,30.0,11,35,70,70,12,23,35,113.0,1047.0,502,95,142,237,804.0,82,5.45,47,245,2478,9.0
5496,Colin Wilson,2020-21,31.0,12,18,56,56,6,12,18,75.0,735.0,558,101,154,255,879.0,82,5.86,50,250,2620,9.2
5497,Colin Wilson,2021-22,32.0,13,27,65,65,12,15,27,104.0,882.0,623,113,169,282,983.0,82,5.96,47,239,2579,9.5
5498,Colin Wilson,2022-23,33.0,14,4,9,9,0,4,4,12.0,114.0,632,113,173,286,995.0,70,5.96,42,208,2192,9.5
5499,Colten Teubert,2014-15,24.0,4,1,24,24,0,1,1,13.0,303.0,24,0,1,1,13.0,82,5.32,47,271,2439,8.9
5500,Colton Gillies,2011-12,22.0,4,7,45,45,2,5,7,22.0,370.0,45,2,5,7,22.0,82,5.7,65,341,2477,9.4
5501,Colton Gillies,2013-14,24.0,5,1,7,7,1,0,1,3.0,73.0,52,3,5,8,25.0,82,5.46,52,291,2492,9.0
5502,Colton Gillies,2014-15,25.0,6,8,75,75,2,6,8,48.0,757.0,127,5,11,16,73.0,82,5.32,47,271,2439,8.9
5503,Colton Gillies,2015-16,26.0,7,2,27,27,1,1,2,17.0,224.0,154,6,12,18,90.0,48,5.31,29,160,1399,9.1
5504,Colton Orr,2006-07,24.0,4,0,1,1,0,0,0,0.0,2.0,1,0,0,0,0.0,82,5.14,57,348,2300,9.2
5505,Colton Orr,2008-09,26.0,5,1,35,35,0,1,1,1.0,101.0,36,0,1,1,1.0,82,6.05,85,480,2458,10.1
5506,Colton Orr,2009-10,27.0,6,3,53,53,2,1,3,23.0,282.0,89,2,2,4,24.0,82,5.76,70,398,2426,9.7
5507,Colton Orr,2010-11,28.0,7,2,74,74,1,1,2,24.0,579.0,163,3,3,6,48.0,82,5.44,62,351,2383,9.4
5508,Colton Orr,2011-12,29.0,8,5,82,82,1,4,5,40.0,532.0,245,4,7,11,88.0,82,5.7,65,341,2477,9.4
5509,Colton Orr,2012-13,30.0,9,6,82,82,4,2,6,43.0,563.0,327,8,9,17,131.0,82,5.53,56,304,2486,9.1
5510,Colton Orr,2013-14,31.0,10,2,46,46,2,0,2,14.0,233.0,373,10,9,19,145.0,82,5.46,52,291,2492,9.0
5511,Colton Orr,2014-15,32.0,11,1,5,5,1,0,1,3.0,22.0,378,11,9,20,148.0,82,5.32,47,271,2439,8.9
5512,Colton Orr,2015-16,33.0,12,4,44,44,1,3,4,13.0,281.0,422,12,12,24,161.0,48,5.31,29,160,1399,9.1
5513,Colton Orr,2016-17,34.0,13,0,54,54,0,0,0,12.0,290.0,476,12,12,24,173.0,82,5.34,48,269,2463,8.9
5514,Colton Orr,2017-18,35.0,14,0,1,1,0,0,0,0.0,6.0,477,12,12,24,173.0,82,5.32,47,251,2453,8.9
5515,Colton Parayko,2018-19,25.0,4,33,79,79,9,24,33,165.0,1532.0,79,9,24,33,165.0,82,5.34,48,255,2438,9.0
5516,Colton Parayko,2019-20,26.0,5,35,81,81,4,31,35,188.0,1717.0,160,13,55,68,353.0,82,5.45,47,245,2478,9.0
5517,Colton Parayko,2020-21,27.0,6,35,82,82,6,29,35,212.0,1854.0,242,19,84,103,565.0,82,5.86,50,250,2620,9.2
5518,Colton Parayko,2021-22,28.0,7,28,80,80,10,18,28,176.0,1823.0,322,29,102,131,741.0,82,5.96,47,239,2579,9.5
5519,Colton Parayko,2022-23,29.0,8,28,64,64,10,18,28,162.0,1472.0,386,39,120,159,903.0,70,5.96,42,208,2192,9.5
5520,Colton Sceviour,2013-14,24.0,4,0,1,1,0,0,0,0.0,5.0,1,0,0,0,0.0,82,5.46,52,291,2492,9.0
5521,Colton Sceviour,2015-16,26.0,5,1,1,1,0,1,1,0.0,5.0,2,0,1,1,0.0,48,5.31,29,160,1399,9.1
5522,Colton Sceviour,2016-17,27.0,6,12,26,26,8,4,12,69.0,387.0,28,8,5,13,69.0,82,5.34,48,269,2463,8.9
5523,Colton Sceviour,2017-18,28.0,7,26,71,71,9,17,26,113.0,903.0,99,17,22,39,182.0,82,5.32,47,251,2453,8.9
5524,Colton Sceviour,2018-19,29.0,8,23,71,71,11,12,23,125.0,900.0,170,28,34,62,307.0,82,5.34,48,255,2438,9.0
5525,Colton Sceviour,2019-20,30.0,9,24,80,80,9,15,24,172.0,1171.0,250,37,49,86,479.0,82,5.45,47,245,2478,9.0
5526,Colton Sceviour,2020-21,31.0,10,24,76,76,11,13,24,141.0,1021.0,326,48,62,110,620.0,82,5.86,50,250,2620,9.2
5527,Colton Sceviour,2021-22,32.0,11,15,59,59,5,10,15,116.0,725.0,385,53,72,125,736.0,82,5.96,47,239,2579,9.5
5528,Colton Sceviour,2022-23,33.0,12,16,69,69,6,10,16,114.0,914.0,454,59,82,141,850.0,70,5.96,42,208,2192,9.5
5529,Colton Sissons,2016-17,23.0,4,4,17,17,1,3,4,13.0,181.0,17,1,3,4,13.0,82,5.34,48,269,2463,8.9
5530,Colton Sissons,2018-19,25.0,5,6,34,34,4,2,6,25.0,339.0,51,5,5,10,38.0,82,5.34,48,255,2438,9.0
5531,Colton Sissons,2019-20,26.0,6,10,58,58,8,2,10,42.0,645.0,109,13,7,20,80.0,82,5.45,47,245,2478,9.0
5532,Colton Sissons,2020-21,27.0,7,27,81,81,9,18,27,120.0,1304.0,190,22,25,47,200.0,82,5.86,50,250,2620,9.2
5533,Colton Sissons,2021-22,28.0,8,30,75,75,15,15,30,110.0,1203.0,265,37,40,77,310.0,82,5.96,47,239,2579,9.5
5534,Colton Sissons,2022-23,29.0,9,15,57,57,9,6,15,52.0,817.0,322,46,46,92,362.0,70,5.96,42,208,2192,9.5
5535,Colton White,2021-22,24.0,4,0,3,3,0,0,0,1.0,43.0,3,0,0,0,1.0,82,5.96,47,239,2579,9.5
5536,Colton White,2022-23,25.0,5,0,6,6,0,0,0,2.0,84.0,9,0,0,0,3.0,70,5.96,42,208,2192,9.5
5537,Connor Brickley,2018-19,26.0,4,5,23,23,1,4,5,13.0,201.0,23,1,4,5,13.0,82,5.34,48,255,2438,9.0
5538,Connor Brickley,2020-21,28.0,5,12,44,44,4,8,12,62.0,523.0,67,5,12,17,75.0,82,5.86,50,250,2620,9.2
5539,Connor Brickley,2021-22,29.0,6,4,14,14,1,3,4,18.0,126.0,81,6,15,21,93.0,82,5.96,47,239,2579,9.5
5540,Connor Brown,2018-19,25.0,4,6,7,7,1,5,6,11.0,105.0,7,1,5,6,11.0,82,5.34,48,255,2438,9.0
5541,Connor Brown,2019-20,26.0,5,36,82,82,20,16,36,139.0,1329.0,89,21,21,42,150.0,82,5.45,47,245,2478,9.0
5542,Connor Brown,2020-21,27.0,6,28,82,82,14,14,28,119.0,1231.0,171,35,35,70,269.0,82,5.86,50,250,2620,9.2
5543,Connor Brown,2021-22,28.0,7,29,82,82,8,21,29,85.0,1131.0,253,43,56,99,354.0,82,5.96,47,239,2579,9.5
5544,Connor Brown,2022-23,29.0,8,43,71,71,16,27,43,173.0,1428.0,324,59,83,142,527.0,70,5.96,42,208,2192,9.5
5545,Connor Bunnaman,2022-23,24.0,4,2,21,21,1,1,2,18.0,195.0,21,1,1,2,18.0,70,5.96,42,208,2192,9.5
5546,Connor Carrick,2016-17,22.0,4,6,34,34,1,5,6,26.0,543.0,34,1,5,6,26.0,82,5.34,48,269,2463,8.9
5547,Connor Carrick,2018-19,24.0,5,4,19,19,2,2,4,21.0,295.0,53,3,7,10,47.0,82,5.34,48,255,2438,9.0
5548,Connor Carrick,2019-20,25.0,6,8,67,67,2,6,8,89.0,1095.0,120,5,13,18,136.0,82,5.45,47,245,2478,9.0
5549,Connor Carrick,2020-21,26.0,7,12,47,47,4,8,12,55.0,711.0,167,9,21,30,191.0,82,5.86,50,250,2620,9.2
5550,Connor Carrick,2021-22,27.0,8,11,34,34,2,9,11,42.0,571.0,201,11,30,41,233.0,82,5.96,47,239,2579,9.5
5551,Connor Carrick,2022-23,28.0,9,6,29,29,1,5,6,25.0,418.0,230,12,35,47,258.0,70,5.96,42,208,2192,9.5
5552,Connor Clifton,2021-22,26.0,4,1,19,19,0,1,1,22.0,336.0,19,0,1,1,22.0,82,5.96,47,239,2579,9.5
5553,Connor Clifton,2022-23,27.0,5,2,31,31,2,0,2,20.0,447.0,50,2,1,3,42.0,70,5.96,42,208,2192,9.5
5554,Connor James,2008-09,26.0,4,0,2,2,0,0,0,1.0,15.0,2,0,0,0,1.0,82,6.05,85,480,2458,10.1
5555,Connor James,2010-11,28.0,5,1,13,13,1,0,1,9.0,97.0,15,1,0,1,10.0,82,5.44,62,351,2383,9.4
5556,Connor James,2011-12,29.0,6,0,1,1,0,0,0,0.0,8.0,16,1,0,1,10.0,82,5.7,65,341,2477,9.4
5557,Connor Jones,2019-20,29.0,4,0,4,4,0,0,0,2.0,47.0,4,0,0,0,2.0,82,5.45,47,245,2478,9.0
5558,Connor McDavid,2018-19,22.0,4,48,45,45,16,32,48,105.0,850.0,45,16,32,48,105.0,82,5.34,48,255,2438,9.0
5559,Connor McDavid,2019-20,23.0,5,100,82,82,30,70,100,251.0,1733.0,127,46,102,148,356.0,82,5.45,47,245,2478,9.0
5560,Connor McDavid,2020-21,24.0,6,108,82,82,41,67,108,274.0,1767.0,209,87,169,256,630.0,82,5.86,50,250,2620,9.2
5561,Connor McDavid,2021-22,25.0,7,116,78,78,41,75,116,240.0,1781.0,287,128,244,372,870.0,82,5.96,47,239,2579,9.5
5562,Connor McDavid,2022-23,26.0,8,97,64,64,34,63,97,212.0,1399.0,351,162,307,469,1082.0,70,5.96,42,208,2192,9.5
5563,Connor Murphy,2016-17,23.0,4,8,30,30,1,7,8,30.0,539.0,30,1,7,8,30.0,82,5.34,48,269,2463,8.9
5564,Connor Murphy,2017-18,24.0,5,7,73,73,4,3,7,72.0,1226.0,103,5,10,15,102.0,82,5.32,47,251,2453,8.9
5565,Connor Murphy,2018-19,25.0,6,17,78,78,6,11,17,101.0,1599.0,181,11,21,32,203.0,82,5.34,48,255,2438,9.0
5566,Connor Murphy,2019-20,26.0,7,17,77,77,2,15,17,81.0,1477.0,258,13,36,49,284.0,82,5.45,47,245,2478,9.0
5567,Connor Murphy,2020-21,27.0,8,14,76,76,2,12,14,109.0,1244.0,334,15,48,63,393.0,82,5.86,50,250,2620,9.2
5568,Connor Murphy,2021-22,28.0,9,13,52,52,5,8,13,84.0,1013.0,386,20,56,76,477.0,82,5.96,47,239,2579,9.5
5569,Connor Murphy,2022-23,29.0,10,19,58,58,5,14,19,117.0,1233.0,444,25,70,95,594.0,70,5.96,42,208,2192,9.5
5570,Conor Allen,2016-17,27.0,4,0,3,3,0,0,0,2.0,43.0,3,0,0,0,2.0,82,5.34,48,269,2463,8.9
5571,Conor Allen,2017-18,28.0,5,0,4,4,0,0,0,2.0,49.0,7,0,0,0,4.0,82,5.32,47,251,2453,8.9
5572,Conor Garland,2021-22,25.0,4,18,47,47,13,5,18,118.0,601.0,47,13,5,18,118.0,82,5.96,47,239,2579,9.5
5573,Conor Garland,2022-23,26.0,5,39,68,68,22,17,39,158.0,962.0,115,35,22,57,276.0,70,5.96,42,208,2192,9.5
5574,Conor Sheary,2018-19,26.0,4,10,44,44,7,3,10,51.0,429.0,44,7,3,10,51.0,82,5.34,48,255,2438,9.0
5575,Conor Sheary,2019-20,27.0,5,53,61,61,23,30,53,154.0,972.0,105,30,33,63,205.0,82,5.45,47,245,2478,9.0
5576,Conor Sheary,2020-21,28.0,6,30,79,79,18,12,30,142.0,1102.0,184,48,45,93,347.0,82,5.86,50,250,2620,9.2
5577,Conor Sheary,2021-22,29.0,7,34,78,78,14,20,34,147.0,1140.0,262,62,65,127,494.0,82,5.96,47,239,2579,9.5
5578,Conor Sheary,2022-23,30.0,8,23,63,63,10,13,23,102.0,826.0,325,72,78,150,596.0,70,5.96,42,208,2192,9.5
5579,Conor Timmins,2022-23,24.0,4,0,2,2,0,0,0,1.0,21.0,2,0,0,0,1.0,70,5.96,42,208,2192,9.5
5580,Cooper Marody,2021-22,25.0,4,0,6,6,0,0,0,6.0,41.0,6,0,0,0,6.0,82,5.96,47,239,2579,9.5
5581,Corban Knight,2016-17,26.0,4,1,7,7,1,0,1,4.0,56.0,7,1,0,1,4.0,82,5.34,48,269,2463,8.9
5582,Corban Knight,2017-18,27.0,5,0,2,2,0,0,0,2.0,13.0,9,1,0,1,6.0,82,5.32,47,251,2453,8.9
5583,Corban Knight,2018-19,28.0,6,7,20,20,2,5,7,11.0,193.0,29,3,5,8,17.0,82,5.34,48,255,2438,9.0
5584,Corban Knight,2021-22,31.0,7,4,23,23,1,3,4,15.0,223.0,52,4,8,12,32.0,82,5.96,47,239,2579,9.5
5585,Corey Elkins,2012-13,27.0,4,1,3,3,1,0,1,5.0,36.0,3,1,0,1,5.0,82,5.53,56,304,2486,9.1
5586,Corey Foster,1991-92,22.0,4,0,2,2,0,0,0,2.0,,2,0,0,0,2.0,80,7.48,85,403,2430,12.3
5587,Corey Foster,1994-95,25.0,5,7,25,25,3,4,7,67.0,,27,3,4,7,69.0,80,6.96,77,402,2440,11.4
5588,Corey Foster,1998-99,29.0,6,4,11,11,2,2,4,8.0,,38,5,6,11,77.0,82,6.29,74,413,2481,10.4
5589,Corey Foster,1999-00,30.0,7,0,7,7,0,0,0,1.0,,45,5,6,11,78.0,82,5.83,55,336,2444,9.8
5590,Corey Locke,2010-11,26.0,4,0,1,1,0,0,0,1.0,6.0,1,0,0,0,1.0,82,5.44,62,351,2383,9.4
5591,Corey Locke,2012-13,28.0,5,0,3,3,0,0,0,2.0,19.0,4,0,0,0,3.0,82,5.53,56,304,2486,9.1
5592,Corey Locke,2013-14,29.0,6,1,5,5,0,1,1,6.0,46.0,9,0,1,1,9.0,82,5.46,52,291,2492,9.0
5593,Corey Millen,1992-93,28.0,4,0,4,4,0,0,0,4.0,,4,0,0,0,4.0,80,7.37,76,367,2421,12.2
5594,Corey Millen,1993-94,29.0,5,4,4,4,3,1,4,8.0,,8,3,1,4,12.0,80,6.91,71,366,2385,11.6
5595,Corey Millen,1994-95,30.0,6,46,57,57,21,25,46,109.0,,65,24,26,50,121.0,80,6.96,77,402,2440,11.4
5596,Corey Millen,1995-96,31.0,7,39,42,42,23,16,39,100.0,,107,47,42,89,221.0,84,7.25,87,443,2603,11.7
5597,Corey Millen,1996-97,32.0,8,50,78,78,20,30,50,132.0,,185,67,72,139,353.0,84,6.48,76,407,2545,10.7
5598,Corey Millen,1997-98,33.0,9,23,45,45,5,18,23,74.0,,230,72,90,162,427.0,48,5.97,37,209,1408,10.2
5599,Corey Millen,1998-99,34.0,10,21,44,44,7,14,21,73.0,,274,79,104,183,500.0,82,6.29,74,413,2481,10.4
5600,Corey Millen,1999-00,35.0,11,26,61,61,11,15,26,82.0,,335,90,119,209,582.0,82,5.83,55,336,2444,9.8
5601,Corey Perry,2008-09,23.0,4,25,56,56,13,12,25,98.0,648.0,56,13,12,25,98.0,82,6.05,85,480,2458,10.1
5602,Corey Perry,2009-10,24.0,5,44,82,82,17,27,44,194.0,1022.0,138,30,39,69,292.0,82,5.76,70,398,2426,9.7
5603,Corey Perry,2010-11,25.0,6,54,70,70,29,25,54,200.0,1257.0,208,59,64,123,492.0,82,5.44,62,351,2383,9.4
5604,Corey Perry,2011-12,26.0,7,72,78,78,32,40,72,283.0,1451.0,286,91,104,195,775.0,82,5.7,65,341,2477,9.4
5605,Corey Perry,2012-13,27.0,8,76,82,82,27,49,76,270.0,1727.0,368,118,153,271,1045.0,82,5.53,56,304,2486,9.1
5606,Corey Perry,2013-14,28.0,9,98,82,82,50,48,98,290.0,1830.0,450,168,201,369,1335.0,82,5.46,52,291,2492,9.0
5607,Corey Perry,2014-15,29.0,10,60,80,80,37,23,60,277.0,1710.0,530,205,224,429,1612.0,82,5.32,47,271,2439,8.9
5608,Corey Perry,2015-16,30.0,11,36,44,44,15,21,36,128.0,839.0,574,220,245,465,1740.0,48,5.31,29,160,1399,9.1
5609,Corey Perry,2016-17,31.0,12,82,81,81,43,39,82,280.0,1578.0,655,263,284,547,2020.0,82,5.34,48,269,2463,8.9
5610,Corey Perry,2017-18,32.0,13,55,67,67,33,22,55,193.0,1213.0,722,296,306,602,2213.0,82,5.32,47,251,2453,8.9
5611,Corey Perry,2018-19,33.0,14,62,82,82,34,28,62,215.0,1452.0,804,330,334,664,2428.0,82,5.34,48,255,2438,9.0
5612,Corey Perry,2019-20,34.0,15,53,82,82,19,34,53,215.0,1453.0,886,349,368,717,2643.0,82,5.45,47,245,2478,9.0
5613,Corey Perry,2020-21,35.0,16,49,71,71,17,32,49,168.0,1262.0,957,366,400,766,2811.0,82,5.86,50,250,2620,9.2
5614,Corey Perry,2021-22,36.0,17,10,31,31,6,4,10,59.0,460.0,988,372,404,776,2870.0,82,5.96,47,239,2579,9.5
5615,Corey Perry,2022-23,37.0,18,21,57,57,5,16,21,77.0,782.0,1045,377,420,797,2947.0,70,5.96,42,208,2192,9.5
5616,Corey Potter,2011-12,28.0,4,2,5,5,1,1,2,4.0,66.0,5,1,1,2,4.0,82,5.7,65,341,2477,9.4
5617,Corey Potter,2012-13,29.0,5,0,3,3,0,0,0,2.0,36.0,8,1,1,2,6.0,82,5.53,56,304,2486,9.1
5618,Corey Potter,2013-14,30.0,6,0,1,1,0,0,0,1.0,17.0,9,1,1,2,7.0,82,5.46,52,291,2492,9.0
5619,Corey Potter,2014-15,31.0,7,21,62,62,4,17,21,98.0,1237.0,71,5,18,23,105.0,82,5.32,47,271,2439,8.9
5620,Corey Potter,2015-16,32.0,8,4,33,33,3,1,4,36.0,576.0,104,8,19,27,141.0,48,5.31,29,160,1399,9.1
5621,Corey Potter,2016-17,33.0,9,5,19,19,0,5,5,17.0,262.0,123,8,24,32,158.0,82,5.34,48,269,2463,8.9
5622,Corey Potter,2017-18,34.0,10,0,6,6,0,0,0,2.0,58.0,129,8,24,32,160.0,82,5.32,47,251,2453,8.9
5623,Corey Potter,2018-19,35.0,11,0,1,1,0,0,0,0.0,15.0,130,8,24,32,160.0,82,5.34,48,255,2438,9.0
5624,Corey Spring,2000-01,29.0,4,1,8,8,1,0,1,12.0,,8,1,0,1,12.0,82,5.28,57,380,2242,9.6
5625,Corey Spring,2001-02,30.0,5,1,8,8,0,1,1,6.0,44.0,16,1,1,2,18.0,82,5.27,57,359,2285,9.4
5626,Corey Tropp,2014-15,25.0,4,8,34,34,3,5,8,32.0,343.0,34,3,5,8,32.0,82,5.32,47,271,2439,8.9
5627,Corey Tropp,2016-17,27.0,5,11,53,53,2,9,11,35.0,474.0,87,5,14,19,67.0,82,5.34,48,269,2463,8.9
5628,Corey Tropp,2017-18,28.0,6,8,61,61,1,7,8,22.0,534.0,148,6,21,27,89.0,82,5.32,47,251,2453,8.9
5629,Corey Tropp,2019-20,30.0,7,0,1,1,0,0,0,0.0,9.0,149,6,21,27,89.0,82,5.45,47,245,2478,9.0
5630,Cory Conacher,2015-16,26.0,4,29,47,47,11,18,29,67.0,657.0,47,11,18,29,67.0,48,5.31,29,160,1399,9.1
5631,Cory Conacher,2016-17,27.0,5,26,79,79,7,19,26,100.0,1022.0,126,18,37,55,167.0,82,5.34,48,269,2463,8.9
5632,Cory Conacher,2017-18,28.0,6,3,15,15,1,2,3,23.0,202.0,141,19,39,58,190.0,82,5.32,47,251,2453,8.9
5633,Cory Conacher,2019-20,30.0,7,4,11,11,1,3,4,16.0,127.0,152,20,42,62,206.0,82,5.45,47,245,2478,9.0
5634,Cory Conacher,2020-21,31.0,8,12,36,36,8,4,12,45.0,360.0,188,28,46,74,251.0,82,5.86,50,250,2620,9.2
5635,Cory Conacher,2021-22,32.0,9,0,1,1,0,0,0,1.0,9.0,189,28,46,74,252.0,82,5.96,47,239,2579,9.5
5636,Cory Conacher,2022-23,33.0,10,1,4,4,0,1,1,5.0,44.0,193,28,47,75,257.0,70,5.96,42,208,2192,9.5
5637,Cory Cross,1996-97,26.0,4,0,5,5,0,0,0,5.0,,5,0,0,0,5.0,84,6.48,76,407,2545,10.7
5638,Cory Cross,1997-98,27.0,5,6,43,43,1,5,6,35.0,,48,1,5,6,40.0,48,5.97,37,209,1408,10.2
5639,Cory Cross,1998-99,28.0,6,16,75,75,2,14,16,57.0,,123,3,19,22,97.0,82,6.29,74,413,2481,10.4
5640,Cory Cross,1999-00,29.0,7,9,72,72,4,5,9,75.0,,195,7,24,31,172.0,82,5.83,55,336,2444,9.8
5641,Cory Cross,2000-01,30.0,8,9,74,74,3,6,9,72.0,,269,10,30,40,244.0,82,5.28,57,380,2242,9.6
5642,Cory Cross,2001-02,31.0,9,18,67,67,2,16,18,96.0,1516.0,336,12,46,58,340.0,82,5.27,57,359,2285,9.4
5643,Cory Cross,2002-03,32.0,10,15,71,71,4,11,15,60.0,1135.0,407,16,57,73,400.0,82,5.49,53,331,2294,9.8
5644,Cory Cross,2003-04,33.0,11,8,41,41,3,5,8,34.0,738.0,448,19,62,81,434.0,82,5.51,63,376,2272,9.9
5645,Cory Cross,2004-05,34.0,12,12,50,50,3,9,12,39.0,765.0,498,22,71,93,473.0,82,5.24,53,338,2262,9.5
5646,Cory Cross,2005-06,35.0,13,9,37,37,2,7,9,29.0,644.0,535,24,78,102,502.0,82,5.31,60,363,2326,9.4
5647,Cory Cross,2006-07,36.0,14,21,68,68,7,14,21,83.0,1308.0,603,31,92,123,585.0,82,5.14,57,348,2300,9.2
5648,Cory Cross,2008-09,38.0,15,8,56,56,3,5,8,32.0,717.0,659,34,97,131,617.0,82,6.05,85,480,2458,10.1
5649,Cory Emmerton,2013-14,25.0,4,1,2,2,1,0,1,3.0,17.0,2,1,0,1,3.0,82,5.46,52,291,2492,9.0
5650,Cory Emmerton,2014-15,26.0,5,10,71,71,6,4,10,63.0,575.0,73,7,4,11,66.0,82,5.32,47,271,2439,8.9
5651,Cory Emmerton,2015-16,27.0,6,8,48,48,5,3,8,55.0,519.0,121,12,7,19,121.0,48,5.31,29,160,1399,9.1
5652,Cory Emmerton,2016-17,28.0,7,2,18,18,0,2,2,22.0,161.0,139,12,9,21,143.0,82,5.34,48,269,2463,8.9
5653,Cory Larose,2006-07,31.0,4,1,7,7,0,1,1,10.0,80.0,7,0,1,1,10.0,82,5.14,57,348,2300,9.2
5654,Cory Murphy,2010-11,32.0,4,17,47,47,2,15,17,65.0,723.0,47,2,15,17,65.0,82,5.44,62,351,2383,9.4
5655,Cory Murphy,2011-12,33.0,5,16,32,32,5,11,16,55.0,575.0,79,7,26,33,120.0,82,5.7,65,341,2477,9.4
5656,Cory Murphy,2012-13,34.0,6,3,12,12,2,1,3,9.0,149.0,91,9,27,36,129.0,82,5.53,56,304,2486,9.1
5657,Cory Sarich,2001-02,23.0,4,0,4,4,0,0,0,2.0,53.0,4,0,0,0,2.0,82,5.27,57,359,2285,9.4
5658,Cory Sarich,2002-03,24.0,5,6,59,59,0,6,6,69.0,1095.0,63,0,6,6,71.0,82,5.49,53,331,2294,9.8
5659,Cory Sarich,2003-04,25.0,6,9,73,73,1,8,9,66.0,1368.0,136,1,14,15,137.0,82,5.51,63,376,2272,9.9
5660,Cory Sarich,2004-05,26.0,7,11,72,72,0,11,11,55.0,1159.0,208,1,25,26,192.0,82,5.24,53,338,2262,9.5
5661,Cory Sarich,2005-06,27.0,8,14,82,82,5,9,14,79.0,1607.0,290,6,34,40,271.0,82,5.31,60,363,2326,9.4
5662,Cory Sarich,2006-07,28.0,9,19,82,82,3,16,19,93.0,1518.0,372,9,50,59,364.0,82,5.14,57,348,2300,9.2
5663,Cory Sarich,2008-09,30.0,10,15,82,82,1,14,15,88.0,1523.0,454,10,64,74,452.0,82,6.05,85,480,2458,10.1
5664,Cory Sarich,2009-10,31.0,11,15,82,82,0,15,15,64.0,1485.0,536,10,79,89,516.0,82,5.76,70,398,2426,9.7
5665,Cory Sarich,2010-11,32.0,12,7,80,80,2,5,7,57.0,1506.0,616,12,84,96,573.0,82,5.44,62,351,2383,9.4
5666,Cory Sarich,2011-12,33.0,13,20,76,76,2,18,20,57.0,1359.0,692,14,102,116,630.0,82,5.7,65,341,2477,9.4
5667,Cory Sarich,2012-13,34.0,14,6,57,57,1,5,6,46.0,909.0,749,15,107,122,676.0,82,5.53,56,304,2486,9.1
5668,Cory Sarich,2013-14,35.0,15,17,76,76,4,13,17,75.0,1359.0,825,19,120,139,751.0,82,5.46,52,291,2492,9.0
5669,Cory Sarich,2014-15,36.0,16,7,62,62,1,6,7,36.0,999.0,887,20,126,146,787.0,82,5.32,47,271,2439,8.9
5670,Cory Sarich,2015-16,37.0,17,2,28,28,0,2,2,14.0,416.0,915,20,128,148,801.0,48,5.31,29,160,1399,9.1
5671,Cory Sarich,2016-17,38.0,18,10,54,54,1,9,10,48.0,923.0,969,21,137,158,849.0,82,5.34,48,269,2463,8.9
5672,Cory Stillman,1997-98,24.0,4,2,10,10,0,2,2,7.0,,10,0,2,2,7.0,48,5.97,37,209,1408,10.2
5673,Cory Stillman,1998-99,25.0,5,35,74,74,16,19,35,132.0,,84,16,21,37,139.0,82,6.29,74,413,2481,10.4
5674,Cory Stillman,1999-00,26.0,6,26,58,58,6,20,26,112.0,,142,22,41,63,251.0,82,5.83,55,336,2444,9.8
5675,Cory Stillman,2000-01,27.0,7,49,72,72,27,22,49,178.0,,214,49,63,112,429.0,82,5.28,57,380,2242,9.6
5676,Cory Stillman,2001-02,28.0,8,57,76,76,27,30,57,175.0,1240.0,290,76,93,169,604.0,82,5.27,57,359,2285,9.4
5677,Cory Stillman,2002-03,29.0,9,21,37,37,12,9,21,59.0,657.0,327,88,102,190,663.0,82,5.49,53,331,2294,9.8
5678,Cory Stillman,2003-04,30.0,10,52,78,78,24,28,52,174.0,1467.0,405,112,130,242,837.0,82,5.51,63,376,2272,9.9
5679,Cory Stillman,2004-05,31.0,11,45,80,80,23,22,45,140.0,1204.0,485,135,152,287,977.0,82,5.24,53,338,2262,9.5
5680,Cory Stillman,2005-06,32.0,12,67,79,79,24,43,67,157.0,1448.0,564,159,195,354,1134.0,82,5.31,60,363,2326,9.4
5681,Cory Stillman,2006-07,33.0,13,80,81,81,25,55,80,178.0,1582.0,645,184,250,434,1312.0,82,5.14,57,348,2300,9.2
5682,Cory Stillman,2008-09,35.0,14,76,72,72,21,55,76,177.0,1344.0,717,205,305,510,1489.0,82,6.05,85,480,2458,10.1
5683,Cory Stillman,2009-10,36.0,15,27,43,43,5,22,27,85.0,749.0,760,210,327,537,1574.0,82,5.76,70,398,2426,9.7
5684,Cory Stillman,2010-11,37.0,16,65,79,79,24,41,65,166.0,1500.0,839,234,368,602,1740.0,82,5.44,62,351,2383,9.4
5685,Cory Stillman,2011-12,38.0,17,49,63,63,17,32,49,115.0,1045.0,902,251,400,651,1855.0,82,5.7,65,341,2477,9.4
5686,Cory Stillman,2012-13,39.0,18,37,58,58,15,22,37,126.0,1019.0,960,266,422,688,1981.0,82,5.53,56,304,2486,9.1
5687,Cory Stillman,2013-14,40.0,19,39,65,65,12,27,39,116.0,1099.0,1025,278,449,727,2097.0,82,5.46,52,291,2492,9.0
5688,Craig Adams,2003-04,26.0,4,1,44,44,1,0,1,15.0,198.0,44,1,0,1,15.0,82,5.51,63,376,2272,9.9
5689,Craig Adams,2004-05,27.0,5,1,33,33,0,1,1,17.0,195.0,77,1,1,2,32.0,82,5.24,53,338,2262,9.5
5690,Craig Adams,2005-06,28.0,6,18,81,81,6,12,18,107.0,988.0,158,7,13,20,139.0,82,5.31,60,363,2326,9.4
5691,Craig Adams,2006-07,29.0,7,17,80,80,7,10,17,110.0,1095.0,238,14,23,37,249.0,82,5.14,57,348,2300,9.2
5692,Craig Adams,2008-09,31.0,8,21,67,67,10,11,21,68.0,824.0,305,24,34,58,317.0,82,6.05,85,480,2458,10.1
5693,Craig Adams,2009-10,32.0,9,14,82,82,7,7,14,71.0,826.0,387,31,41,72,388.0,82,5.76,70,398,2426,9.7
5694,Craig Adams,2010-11,33.0,10,11,75,75,4,7,11,63.0,810.0,462,35,48,83,451.0,82,5.44,62,351,2383,9.4
5695,Craig Adams,2011-12,34.0,11,7,45,45,2,5,7,47.0,391.0,507,37,53,90,498.0,82,5.7,65,341,2477,9.4
5696,Craig Adams,2012-13,35.0,12,10,82,82,0,10,10,84.0,910.0,589,37,63,100,582.0,82,5.53,56,304,2486,9.1
5697,Craig Adams,2013-14,36.0,13,15,80,80,4,11,15,90.0,975.0,669,41,74,115,672.0,82,5.46,52,291,2492,9.0
5698,Craig Adams,2014-15,37.0,14,18,82,82,5,13,18,76.0,925.0,751,46,87,133,748.0,82,5.32,47,271,2439,8.9
5699,Craig Adams,2015-16,38.0,15,9,48,48,3,6,9,46.0,536.0,799,49,93,142,794.0,48,5.31,29,160,1399,9.1
5700,Craig Adams,2016-17,39.0,16,11,82,82,5,6,11,73.0,1022.0,881,54,99,153,867.0,82,5.34,48,269,2463,8.9
5701,Craig Adams,2017-18,40.0,17,7,70,70,1,6,7,51.0,682.0,951,55,105,160,918.0,82,5.32,47,251,2453,8.9
5702,Craig Berube,1989-90,24.0,4,0,7,7,0,0,0,4.0,,7,0,0,0,4.0,80,7.34,72,344,2400,12.2
5703,Craig Berube,1990-91,25.0,5,5,27,27,3,2,5,13.0,,34,3,2,5,17.0,80,7.43,89,437,2435,12.2
5704,Craig Berube,1991-92,26.0,6,2,53,53,1,1,2,31.0,,87,4,3,7,48.0,80,7.48,85,403,2430,12.3
5705,Craig Berube,1992-93,27.0,7,18,74,74,4,14,18,52.0,,161,8,17,25,100.0,80,7.37,76,367,2421,12.2
5706,Craig Berube,1993-94,28.0,8,17,74,74,8,9,17,46.0,,235,16,26,42,146.0,80,6.91,71,366,2385,11.6
5707,Craig Berube,1994-95,29.0,9,17,76,76,6,11,17,69.0,,311,22,37,59,215.0,80,6.96,77,402,2440,11.4
5708,Craig Berube,1995-96,30.0,10,12,77,77,4,8,12,58.0,,388,26,45,71,273.0,84,7.25,87,443,2603,11.7
5709,Craig Berube,1996-97,31.0,11,14,84,84,7,7,14,48.0,,472,33,52,85,321.0,84,6.48,76,407,2545,10.7
5710,Craig Berube,1997-98,32.0,12,6,43,43,2,4,6,22.0,,515,35,56,91,343.0,48,5.97,37,209,1408,10.2
5711,Craig Berube,1998-99,33.0,13,12,50,50,2,10,12,28.0,,565,37,66,103,371.0,82,6.29,74,413,2481,10.4
5712,Craig Berube,1999-00,34.0,14,7,80,80,4,3,7,55.0,,645,41,69,110,426.0,82,5.83,55,336,2444,9.8
5713,Craig Berube,2000-01,35.0,15,15,74,74,6,9,15,68.0,,719,47,78,125,494.0,82,5.28,57,380,2242,9.6
5714,Craig Berube,2001-02,36.0,16,9,77,77,5,4,9,52.0,538.0,796,52,82,134,546.0,82,5.27,57,359,2285,9.4
5715,Craig Berube,2002-03,37.0,17,12,77,77,4,8,12,63.0,616.0,873,56,90,146,609.0,82,5.49,53,331,2294,9.8
5716,Craig Berube,2003-04,38.0,18,3,60,60,0,3,3,35.0,352.0,933,56,93,149,644.0,82,5.51,63,376,2272,9.9
5717,Craig Berube,2004-05,39.0,19,4,66,66,3,1,4,34.0,430.0,999,59,94,153,678.0,82,5.24,53,338,2262,9.5
5718,Craig Berube,2005-06,40.0,20,6,55,55,2,4,6,21.0,289.0,1054,61,98,159,699.0,82,5.31,60,363,2326,9.4
5719,Craig Conroy,1997-98,26.0,4,1,6,6,1,0,1,4.0,,6,1,0,1,4.0,48,5.97,37,209,1408,10.2
5720,Craig Conroy,1998-99,27.0,5,0,7,7,0,0,0,1.0,,13,1,0,1,5.0,82,6.29,74,413,2481,10.4
5721,Craig Conroy,1999-00,28.0,6,17,61,61,6,11,17,74.0,,74,7,11,18,79.0,82,5.83,55,336,2444,9.8
5722,Craig Conroy,2000-01,29.0,7,43,81,81,14,29,43,118.0,,155,21,40,61,197.0,82,5.28,57,380,2242,9.6
5723,Craig Conroy,2001-02,30.0,8,39,69,69,14,25,39,134.0,1149.0,224,35,65,100,331.0,82,5.27,57,359,2285,9.4
5724,Craig Conroy,2002-03,31.0,9,27,79,79,12,15,27,98.0,1170.0,303,47,80,127,429.0,82,5.49,53,331,2294,9.8
5725,Craig Conroy,2003-04,32.0,10,32,83,83,14,18,32,133.0,1221.0,386,61,98,159,562.0,82,5.51,63,376,2272,9.9
5726,Craig Conroy,2004-05,33.0,11,75,81,81,27,48,75,146.0,1696.0,467,88,146,234,708.0,82,5.24,53,338,2262,9.5
5727,Craig Conroy,2005-06,34.0,12,59,79,79,22,37,59,143.0,1563.0,546,110,183,293,851.0,82,5.31,60,363,2326,9.4
5728,Craig Conroy,2006-07,35.0,13,47,63,63,8,39,47,112.0,1210.0,609,118,222,340,963.0,82,5.14,57,348,2300,9.2
5729,Craig Conroy,2008-09,37.0,14,66,78,78,22,44,66,154.0,1499.0,687,140,266,406,1117.0,82,6.05,85,480,2458,10.1
5730,Craig Conroy,2009-10,38.0,15,37,80,80,13,24,37,112.0,1253.0,767,153,290,443,1229.0,82,5.76,70,398,2426,9.7
5731,Craig Conroy,2010-11,39.0,16,34,79,79,12,22,34,116.0,1355.0,846,165,312,477,1345.0,82,5.44,62,351,2383,9.4
5732,Craig Conroy,2011-12,40.0,17,48,82,82,12,36,48,104.0,1261.0,928,177,348,525,1449.0,82,5.7,65,341,2477,9.4
5733,Craig Conroy,2012-13,41.0,18,15,63,63,3,12,15,52.0,855.0,991,180,360,540,1501.0,82,5.53,56,304,2486,9.1
5734,Craig Conroy,2013-14,42.0,19,2,18,18,2,0,2,11.0,167.0,1009,182,360,542,1512.0,82,5.46,52,291,2492,9.0
5735,Craig Coxe,1987-88,24.0,4,0,9,9,0,0,0,1.0,,9,0,0,0,1.0,80,7.77,71,321,2447,12.7
5736,Craig Coxe,1988-89,25.0,5,8,57,57,3,5,8,48.0,,66,3,5,8,49.0,80,7.94,82,370,2484,12.8
5737,Craig Coxe,1989-90,26.0,6,1,15,15,1,0,1,7.0,,81,4,5,9,56.0,80,7.34,72,344,2400,12.2
5738,Craig Coxe,1990-91,27.0,7,22,71,71,7,15,22,48.0,,152,11,20,31,104.0,80,7.43,89,437,2435,12.2
5739,Craig Coxe,1991-92,28.0,8,7,41,41,0,7,7,15.0,,193,11,27,38,119.0,80,7.48,85,403,2430,12.3
5740,Craig Coxe,1992-93,29.0,9,5,25,25,1,4,5,11.0,,218,12,31,43,130.0,80,7.37,76,367,2421,12.2
5741,Craig Coxe,1993-94,30.0,10,0,7,7,0,0,0,5.0,,225,12,31,43,135.0,80,6.91,71,366,2385,11.6
5742,Craig Coxe,1994-95,31.0,11,2,10,10,2,0,2,11.0,,235,14,31,45,146.0,80,6.96,77,402,2440,11.4
5743,Craig Cunningham,2016-17,26.0,4,0,2,2,0,0,0,4.0,19.0,2,0,0,0,4.0,82,5.34,48,269,2463,8.9
5744,Craig Cunningham,2017-18,27.0,5,7,51,51,3,4,7,54.0,534.0,53,3,4,7,58.0,82,5.32,47,251,2453,8.9
5745,Craig Cunningham,2018-19,28.0,6,1,10,10,0,1,1,13.0,101.0,63,3,5,8,71.0,82,5.34,48,255,2438,9.0
5746,Craig Darby,1997-98,25.0,4,2,13,13,0,2,2,5.0,,13,0,2,2,5.0,48,5.97,37,209,1408,10.2
5747,Craig Darby,1998-99,26.0,5,2,10,10,0,2,2,1.0,,23,0,4,4,6.0,82,6.29,74,413,2481,10.4
5748,Craig Darby,1999-00,27.0,6,5,9,9,1,4,5,13.0,,32,1,8,9,19.0,82,5.83,55,336,2444,9.8
5749,Craig Darby,2000-01,28.0,7,1,3,3,1,0,1,3.0,,35,2,8,10,22.0,82,5.28,57,380,2242,9.6
5750,Craig Darby,2002-03,30.0,8,17,76,76,7,10,17,90.0,1045.0,111,9,18,27,112.0,82,5.49,53,331,2294,9.8
5751,Craig Darby,2003-04,31.0,9,28,78,78,12,16,28,97.0,1239.0,189,21,34,55,209.0,82,5.51,63,376,2272,9.9
5752,Craig Darby,2004-05,32.0,10,0,2,2,0,0,0,0.0,11.0,191,21,34,55,209.0,82,5.24,53,338,2262,9.5
5753,Craig Darby,2005-06,33.0,11,1,3,3,0,1,1,1.0,32.0,194,21,35,56,210.0,82,5.31,60,363,2326,9.4
5754,Craig Darby,2006-07,34.0,12,0,2,2,0,0,0,0.0,14.0,196,21,35,56,210.0,82,5.14,57,348,2300,9.2
5755,Craig Duncanson,1988-89,21.0,4,1,2,2,0,1,1,0.0,,2,0,1,1,0.0,80,7.94,82,370,2484,12.8
5756,Craig Duncanson,1989-90,22.0,5,0,2,2,0,0,0,1.0,,4,0,1,1,1.0,80,7.34,72,344,2400,12.2
5757,Craig Duncanson,1990-91,23.0,6,0,9,9,0,0,0,8.0,,13,0,1,1,9.0,80,7.43,89,437,2435,12.2
5758,Craig Duncanson,1991-92,24.0,7,0,5,5,0,0,0,1.0,,18,0,1,1,10.0,80,7.48,85,403,2430,12.3
5759,Craig Duncanson,1992-93,25.0,8,5,10,10,3,2,5,12.0,,28,3,3,6,22.0,80,7.37,76,367,2421,12.2
5760,Craig Duncanson,1993-94,26.0,9,2,7,7,2,0,2,6.0,,35,5,3,8,28.0,80,6.91,71,366,2385,11.6
5761,Craig Duncanson,1995-96,28.0,10,1,3,3,0,1,1,1.0,,38,5,4,9,29.0,84,7.25,87,443,2603,11.7
5762,Craig Endean,1989-90,21.0,4,1,2,2,0,1,1,0.0,,2,0,1,1,0.0,80,7.34,72,344,2400,12.2
5763,Craig Ferguson,1996-97,26.0,4,1,2,2,0,1,1,0.0,,2,0,1,1,0.0,84,6.48,76,407,2545,10.7
5764,Craig Ferguson,1997-98,27.0,5,0,1,1,0,0,0,3.0,,3,0,1,1,3.0,48,5.97,37,209,1408,10.2
5765,Craig Ferguson,1998-99,28.0,6,1,18,18,1,0,1,20.0,,21,1,1,2,23.0,82,6.29,74,413,2481,10.4
5766,Craig Ferguson,1999-00,29.0,7,0,3,3,0,0,0,5.0,,24,1,1,2,28.0,82,5.83,55,336,2444,9.8
5767,Craig Ferguson,2002-03,32.0,8,0,3,3,0,0,0,2.0,17.0,27,1,1,2,30.0,82,5.49,53,331,2294,9.8
5768,Craig Fisher,1992-93,22.0,4,0,2,2,0,0,0,5.0,,2,0,0,0,5.0,80,7.37,76,367,2421,12.2
5769,Craig Fisher,1993-94,23.0,5,0,2,2,0,0,0,2.0,,4,0,0,0,7.0,80,6.91,71,366,2385,11.6
5770,Craig Fisher,1996-97,26.0,6,0,4,4,0,0,0,5.0,,8,0,0,0,12.0,84,6.48,76,407,2545,10.7
5771,Craig Fisher,1999-00,29.0,7,0,4,4,0,0,0,2.0,,12,0,0,0,14.0,82,5.83,55,336,2444,9.8
5772,Craig Hartsburg,1982-83,23.0,4,44,79,79,14,30,44,202.0,,79,14,30,44,202.0,80,7.03,61,280,2352,12.0
5773,Craig Hartsburg,1983-84,24.0,5,43,74,74,13,30,43,207.0,,153,27,60,87,409.0,80,7.69,77,340,2441,12.6
5774,Craig Hartsburg,1984-85,25.0,6,77,76,76,17,60,77,204.0,,229,44,120,164,613.0,80,8.03,73,320,2489,12.9
5775,Craig Hartsburg,1985-86,26.0,7,62,78,78,12,50,62,201.0,,307,56,170,226,814.0,80,7.73,71,310,2444,12.7
5776,Craig Hartsburg,1986-87,27.0,8,14,26,26,7,7,14,54.0,,333,63,177,240,868.0,80,7.89,74,336,2448,12.9
5777,Craig Hartsburg,1987-88,28.0,9,18,32,32,7,11,18,94.0,,365,70,188,258,962.0,80,7.77,71,321,2447,12.7
5778,Craig Hartsburg,1988-89,29.0,10,57,75,75,10,47,57,185.0,,440,80,235,315,1147.0,80,7.94,82,370,2484,12.8
5779,Craig Hartsburg,1989-90,30.0,11,61,73,73,11,50,61,189.0,,513,91,285,376,1336.0,80,7.34,72,344,2400,12.2
5780,Craig Hartsburg,1990-91,31.0,12,19,27,27,3,16,19,83.0,,540,94,301,395,1419.0,80,7.43,89,437,2435,12.2
5781,Craig Hartsburg,1991-92,32.0,13,18,30,30,4,14,18,75.0,,570,98,315,413,1494.0,80,7.48,85,403,2430,12.3
5782,Craig Janney,1990-91,23.0,4,16,15,15,7,9,16,29.0,,15,7,9,16,29.0,80,7.43,89,437,2435,12.2
5783,Craig Janney,1991-92,24.0,5,62,62,62,16,46,62,95.0,,77,23,55,78,124.0,80,7.48,85,403,2430,12.3
5784,Craig Janney,1992-93,25.0,6,62,55,55,24,38,62,105.0,,132,47,93,140,229.0,80,7.37,76,367,2421,12.2
5785,Craig Janney,1993-94,26.0,7,92,77,77,26,66,92,133.0,,209,73,159,232,362.0,80,6.91,71,366,2385,11.6
5786,Craig Janney,1994-95,27.0,8,87,78,78,18,69,87,127.0,,287,91,228,319,489.0,80,6.96,77,402,2440,11.4
5787,Craig Janney,1995-96,28.0,9,106,84,84,24,82,106,137.0,,371,115,310,425,626.0,84,7.25,87,443,2603,11.7
5788,Craig Janney,1996-97,29.0,10,84,69,69,16,68,84,95.0,,440,131,378,509,721.0,84,6.48,76,407,2545,10.7
5789,Craig Janney,1997-98,30.0,11,27,35,35,7,20,27,40.0,,475,138,398,536,761.0,48,5.97,37,209,1408,10.2
5790,Craig Janney,1998-99,31.0,12,82,84,84,20,62,82,91.0,,559,158,460,618,852.0,82,6.29,74,413,2481,10.4
5791,Craig Janney,1999-00,32.0,13,53,77,77,15,38,53,88.0,,636,173,498,671,940.0,82,5.83,55,336,2444,9.8
5792,Craig Janney,2000-01,33.0,14,53,68,68,10,43,53,72.0,,704,183,541,724,1012.0,82,5.28,57,380,2242,9.6
5793,Craig Janney,2001-02,34.0,15,27,56,56,5,22,27,45.0,799.0,760,188,563,751,1057.0,82,5.27,57,359,2285,9.4
5794,Craig Johnson,1997-98,25.0,4,6,15,15,3,3,6,19.0,,15,3,3,6,19.0,48,5.97,37,209,1408,10.2
5795,Craig Johnson,1998-99,26.0,5,24,60,60,13,11,24,97.0,,75,16,14,30,116.0,82,6.29,74,413,2481,10.4
5796,Craig Johnson,1999-00,27.0,6,7,31,31,4,3,7,30.0,,106,20,17,37,146.0,82,5.83,55,336,2444,9.8
5797,Craig Johnson,2000-01,28.0,7,38,74,74,17,21,38,125.0,,180,37,38,75,271.0,82,5.28,57,380,2242,9.6
5798,Craig Johnson,2001-02,29.0,8,19,69,69,7,12,19,94.0,830.0,249,44,50,94,365.0,82,5.27,57,359,2285,9.4
5799,Craig Johnson,2002-03,30.0,9,23,76,76,9,14,23,106.0,1059.0,325,53,64,117,471.0,82,5.49,53,331,2294,9.8
5800,Craig Johnson,2003-04,31.0,10,9,26,26,4,5,9,36.0,277.0,351,57,69,126,507.0,82,5.51,63,376,2272,9.9
5801,Craig Johnson,2004-05,32.0,11,27,72,72,13,14,27,102.0,1026.0,423,70,83,153,609.0,82,5.24,53,338,2262,9.5
5802,Craig Johnson,2005-06,33.0,12,9,70,70,3,6,9,87.0,986.0,493,73,89,162,696.0,82,5.31,60,363,2326,9.4
5803,Craig Johnson,2006-07,34.0,13,11,64,64,2,9,11,77.0,802.0,557,75,98,173,773.0,82,5.14,57,348,2300,9.2
5804,Craig Laughlin,1984-85,27.0,4,23,36,36,12,11,23,52.0,,36,12,11,23,52.0,80,8.03,73,320,2489,12.9
5805,Craig Laughlin,1985-86,28.0,5,44,75,75,17,27,44,128.0,,111,29,38,67,180.0,80,7.73,71,310,2444,12.7
5806,Craig Laughlin,1986-87,29.0,6,52,80,80,20,32,52,111.0,,191,49,70,119,291.0,80,7.89,74,336,2448,12.9
5807,Craig Laughlin,1987-88,30.0,7,50,78,78,16,34,50,104.0,,269,65,104,169,395.0,80,7.77,71,321,2447,12.7
5808,Craig Laughlin,1988-89,31.0,8,75,75,75,30,45,75,114.0,,344,95,149,244,509.0,80,7.94,82,370,2484,12.8
5809,Craig Laughlin,1989-90,32.0,9,52,80,80,22,30,52,109.0,,424,117,179,296,618.0,80,7.34,72,344,2400,12.2
5810,Craig Laughlin,1990-91,33.0,10,22,59,59,9,13,22,74.0,,483,126,192,318,692.0,80,7.43,89,437,2435,12.2
5811,Craig Laughlin,1991-92,34.0,11,23,66,66,10,13,23,87.0,,549,136,205,341,779.0,80,7.48,85,403,2430,12.3
5812,Craig Levie,1984-85,25.0,4,13,40,40,4,9,13,56.0,,40,4,9,13,56.0,80,8.03,73,320,2489,12.9
5813,Craig Levie,1985-86,26.0,5,9,22,22,4,5,9,31.0,,62,8,14,22,87.0,80,7.73,71,310,2444,12.7
5814,Craig Levie,1986-87,27.0,6,19,37,37,6,13,19,55.0,,99,14,27,41,142.0,80,7.89,74,336,2448,12.9
5815,Craig Levie,1987-88,28.0,7,29,61,61,6,23,29,95.0,,160,20,50,70,237.0,80,7.77,71,321,2447,12.7
5816,Craig Levie,1988-89,29.0,8,4,14,14,2,2,4,22.0,,174,22,52,74,259.0,80,7.94,82,370,2484,12.8
5817,Craig Levie,1989-90,30.0,9,1,9,9,0,1,1,8.0,,183,22,53,75,267.0,80,7.34,72,344,2400,12.2
5818,Craig Ludwig,1985-86,24.0,4,25,80,80,0,25,25,81.0,,80,0,25,25,81.0,80,7.73,71,310,2444,12.7
5819,Craig Ludwig,1986-87,25.0,5,25,80,80,7,18,25,116.0,,160,7,43,50,197.0,80,7.89,74,336,2448,12.9
5820,Craig Ludwig,1987-88,26.0,6,19,72,72,5,14,19,73.0,,232,12,57,69,270.0,80,7.77,71,321,2447,12.7
5821,Craig Ludwig,1988-89,27.0,7,6,69,69,2,4,6,61.0,,301,14,61,75,331.0,80,7.94,82,370,2484,12.8
5822,Craig Ludwig,1989-90,28.0,8,16,75,75,4,12,16,55.0,,376,18,73,91,386.0,80,7.34,72,344,2400,12.2
5823,Craig Ludwig,1990-91,29.0,9,14,74,74,4,10,14,82.0,,450,22,83,105,468.0,80,7.43,89,437,2435,12.2
5824,Craig Ludwig,1991-92,30.0,10,16,74,74,3,13,16,83.0,,524,25,96,121,551.0,80,7.48,85,403,2430,12.3
5825,Craig Ludwig,1992-93,31.0,11,16,73,73,1,15,16,49.0,,597,26,111,137,600.0,80,7.37,76,367,2421,12.2
5826,Craig Ludwig,1993-94,32.0,12,9,75,75,1,8,9,46.0,,672,27,119,146,646.0,80,6.91,71,366,2385,11.6
5827,Craig Ludwig,1994-95,33.0,13,11,73,73,2,9,11,51.0,,745,29,128,157,697.0,80,6.96,77,402,2440,11.4
5828,Craig Ludwig,1995-96,34.0,14,11,78,78,1,10,11,66.0,,823,30,138,168,763.0,84,7.25,87,443,2603,11.7
5829,Craig Ludwig,1996-97,35.0,15,14,84,84,1,13,14,65.0,,907,31,151,182,828.0,84,6.48,76,407,2545,10.7
5830,Craig Ludwig,1997-98,36.0,16,9,47,47,2,7,9,55.0,,954,33,158,191,883.0,48,5.97,37,209,1408,10.2
5831,Craig Ludwig,1998-99,37.0,17,3,65,65,1,2,3,47.0,,1019,34,160,194,930.0,82,6.29,74,413,2481,10.4
5832,Craig Ludwig,1999-00,38.0,18,13,77,77,2,11,13,59.0,,1096,36,171,207,989.0,82,5.83,55,336,2444,9.8
5833,Craig Ludwig,2000-01,39.0,19,7,80,80,0,7,7,46.0,,1176,36,178,214,1035.0,82,5.28,57,380,2242,9.6
5834,Craig Ludwig,2001-02,40.0,20,8,80,80,2,6,8,39.0,1161.0,1256,38,184,222,1074.0,82,5.27,57,359,2285,9.4
5835,Craig MacDonald,2001-02,24.0,4,0,11,11,0,0,0,5.0,27.0,11,0,0,0,5.0,82,5.27,57,359,2285,9.4
5836,Craig MacDonald,2004-05,27.0,5,2,12,12,1,1,2,15.0,122.0,23,1,1,2,20.0,82,5.24,53,338,2262,9.5
5837,Craig MacDonald,2005-06,28.0,6,4,35,35,1,3,4,43.0,327.0,58,2,4,6,63.0,82,5.31,60,363,2326,9.4
5838,Craig MacDonald,2006-07,29.0,7,6,52,52,0,6,6,59.0,582.0,110,2,10,12,122.0,82,5.14,57,348,2300,9.2
5839,Craig MacDonald,2008-09,31.0,8,5,25,25,3,2,5,27.0,257.0,135,5,12,17,149.0,82,6.05,85,480,2458,10.1
5840,Craig MacDonald,2009-10,32.0,9,5,25,25,3,2,5,30.0,280.0,160,8,14,22,179.0,82,5.76,70,398,2426,9.7
5841,Craig MacDonald,2010-11,33.0,10,11,65,65,2,9,11,84.0,707.0,225,10,23,33,263.0,82,5.44,62,351,2383,9.4
5842,Craig MacDonald,2011-12,34.0,11,2,8,8,1,1,2,6.0,85.0,233,11,24,35,269.0,82,5.7,65,341,2477,9.4
5843,Craig MacTavish,1982-83,24.0,4,28,46,46,11,17,28,61.0,,46,11,17,28,61.0,80,7.03,61,280,2352,12.0
5844,Craig MacTavish,1983-84,25.0,5,8,24,24,3,5,8,40.0,,70,14,22,36,101.0,80,7.69,77,340,2441,12.6
5845,Craig MacTavish,1984-85,26.0,6,1,2,2,0,1,1,1.0,,72,14,23,37,102.0,80,8.03,73,320,2489,12.9
5846,Craig MacTavish,1985-86,27.0,7,30,75,75,10,20,30,120.0,,147,24,43,67,222.0,80,7.73,71,310,2444,12.7
5847,Craig MacTavish,1986-87,28.0,8,43,70,70,20,23,43,135.0,,217,44,66,110,357.0,80,7.89,74,336,2448,12.9
5848,Craig MacTavish,1988-89,30.0,9,47,74,74,23,24,47,121.0,,291,67,90,157,478.0,80,7.94,82,370,2484,12.8
5849,Craig MacTavish,1989-90,31.0,10,39,79,79,20,19,39,139.0,,370,87,109,196,617.0,80,7.34,72,344,2400,12.2
5850,Craig MacTavish,1990-91,32.0,11,32,80,80,15,17,32,90.0,,450,102,126,228,707.0,80,7.43,89,437,2435,12.2
5851,Craig MacTavish,1991-92,33.0,12,52,80,80,21,31,52,120.0,,530,123,157,280,827.0,80,7.48,85,403,2430,12.3
5852,Craig MacTavish,1992-93,34.0,13,43,80,80,21,22,43,109.0,,610,144,179,323,936.0,80,7.37,76,367,2421,12.2
5853,Craig MacTavish,1993-94,35.0,14,32,80,80,17,15,32,113.0,,690,161,194,355,1049.0,80,6.91,71,366,2385,11.6
5854,Craig MacTavish,1994-95,36.0,15,30,80,80,12,18,30,86.0,,770,173,212,385,1135.0,80,6.96,77,402,2440,11.4
5855,Craig MacTavish,1995-96,37.0,16,30,82,82,10,20,30,101.0,,852,183,232,415,1236.0,84,7.25,87,443,2603,11.7
5856,Craig MacTavish,1996-97,38.0,17,32,78,78,20,12,32,122.0,,930,203,244,447,1358.0,84,6.48,76,407,2545,10.7
5857,Craig MacTavish,1997-98,39.0,18,12,45,45,3,9,12,38.0,,975,206,253,459,1396.0,48,5.97,37,209,1408,10.2
5858,Craig MacTavish,1998-99,40.0,19,14,68,68,5,9,14,58.0,,1043,211,262,473,1454.0,82,6.29,74,413,2481,10.4
5859,Craig MacTavish,1999-00,41.0,20,7,50,50,2,5,7,26.0,,1093,213,267,480,1480.0,82,5.83,55,336,2444,9.8
5860,Craig Martin,1997-98,27.0,4,1,20,20,0,1,1,3.0,,20,0,1,1,3.0,48,5.97,37,209,1408,10.2
5861,Craig Martin,1999-00,29.0,5,0,1,1,0,0,0,1.0,,21,0,1,1,4.0,82,5.83,55,336,2444,9.8
5862,Craig Millar,1999-00,23.0,4,0,1,1,0,0,0,1.0,,1,0,0,0,1.0,82,5.83,55,336,2444,9.8
5863,Craig Millar,2000-01,24.0,5,4,11,11,4,0,4,10.0,,12,4,0,4,11.0,82,5.28,57,380,2242,9.6
5864,Craig Millar,2001-02,25.0,6,2,24,24,0,2,2,18.0,364.0,36,4,2,6,29.0,82,5.27,57,359,2285,9.4
5865,Craig Millar,2002-03,26.0,7,14,57,57,3,11,14,50.0,962.0,93,7,13,20,79.0,82,5.49,53,331,2294,9.8
5866,Craig Millar,2003-04,27.0,8,2,21,21,1,1,2,12.0,301.0,114,8,14,22,91.0,82,5.51,63,376,2272,9.9
5867,Craig Mills,1998-99,22.0,4,2,4,4,0,2,2,0.0,,4,0,2,2,0.0,82,6.29,74,413,2481,10.4
5868,Craig Mills,2000-01,24.0,5,3,20,20,0,3,3,5.0,,24,0,5,5,5.0,82,5.28,57,380,2242,9.6
5869,Craig Mills,2001-02,25.0,6,0,7,7,0,0,0,1.0,41.0,31,0,5,5,6.0,82,5.27,57,359,2285,9.4
5870,Craig Muni,1984-85,22.0,4,0,3,3,0,0,0,0.0,,3,0,0,0,0.0,80,8.03,73,320,2489,12.9
5871,Craig Muni,1985-86,23.0,5,1,2,2,0,1,1,2.0,,5,0,1,1,2.0,80,7.73,71,310,2444,12.7
5872,Craig Muni,1987-88,25.0,6,0,8,8,0,0,0,1.0,,13,0,1,1,3.0,80,7.77,71,321,2447,12.7
5873,Craig Muni,1988-89,26.0,7,1,6,6,0,1,1,2.0,,19,0,2,2,5.0,80,7.94,82,370,2484,12.8
5874,Craig Muni,1989-90,27.0,8,29,79,79,7,22,29,69.0,,98,7,24,31,74.0,80,7.34,72,344,2400,12.2
5875,Craig Muni,1990-91,28.0,9,19,72,72,4,15,19,56.0,,170,11,39,50,130.0,80,7.43,89,437,2435,12.2
5876,Craig Muni,1991-92,29.0,10,18,69,69,5,13,18,40.0,,239,16,52,68,170.0,80,7.48,85,403,2430,12.3
5877,Craig Muni,1992-93,30.0,11,17,71,71,5,12,17,42.0,,310,21,64,85,212.0,80,7.37,76,367,2421,12.2
5878,Craig Muni,1993-94,31.0,12,10,76,76,1,9,10,47.0,,386,22,73,95,259.0,80,6.91,71,366,2385,11.6
5879,Craig Muni,1994-95,32.0,13,7,54,54,2,5,7,38.0,,440,24,78,102,297.0,80,6.96,77,402,2440,11.4
5880,Craig Muni,1995-96,33.0,14,11,81,81,0,11,11,60.0,,521,24,89,113,357.0,84,7.25,87,443,2603,11.7
5881,Craig Muni,1996-97,34.0,15,14,82,82,2,12,14,45.0,,603,26,101,127,402.0,84,6.48,76,407,2545,10.7
5882,Craig Muni,1997-98,35.0,16,6,40,40,0,6,6,32.0,,643,26,107,133,434.0,48,5.97,37,209,1408,10.2
5883,Craig Muni,1998-99,36.0,17,8,72,72,1,7,8,41.0,,715,27,114,141,475.0,82,6.29,74,413,2481,10.4
5884,Craig Muni,1999-00,37.0,18,4,64,64,0,4,4,19.0,,779,27,118,145,494.0,82,5.83,55,336,2444,9.8
5885,Craig Muni,2000-01,38.0,19,2,40,40,1,1,2,12.0,,819,28,119,147,506.0,82,5.28,57,380,2242,9.6
5886,Craig Norwich,1982-83,27.0,4,45,70,70,10,35,45,218.0,,70,10,35,45,218.0,80,7.03,61,280,2352,12.0
5887,Craig Norwich,1983-84,28.0,5,30,34,34,7,23,30,87.0,,104,17,58,75,305.0,80,7.69,77,340,2441,12.6
5888,Craig Redmond,1987-88,22.0,4,39,79,79,6,33,39,110.0,,79,6,33,39,110.0,80,7.77,71,321,2447,12.7
5889,Craig Redmond,1988-89,23.0,5,24,73,73,6,18,24,116.0,,152,12,51,63,226.0,80,7.94,82,370,2484,12.8
5890,Craig Redmond,1989-90,24.0,6,8,16,16,1,7,8,18.0,,168,13,58,71,244.0,80,7.34,72,344,2400,12.2
5891,Craig Redmond,1990-91,25.0,7,0,2,2,0,0,0,5.0,,170,13,58,71,249.0,80,7.43,89,437,2435,12.2
5892,Craig Redmond,1991-92,26.0,8,13,21,21,3,10,13,29.0,,191,16,68,84,278.0,80,7.48,85,403,2430,12.3
5893,Craig Reichert,1999-00,25.0,4,0,3,3,0,0,0,3.0,,3,0,0,0,3.0,82,5.83,55,336,2444,9.8
5894,Craig Rivet,1997-98,23.0,4,1,5,5,0,1,1,2.0,,5,0,1,1,2.0,48,5.97,37,209,1408,10.2
5895,Craig Rivet,1998-99,24.0,5,5,19,19,1,4,5,9.0,,24,1,5,6,11.0,82,6.29,74,413,2481,10.4
5896,Craig Rivet,1999-00,25.0,6,4,35,35,0,4,4,24.0,,59,1,9,10,35.0,82,5.83,55,336,2444,9.8
5897,Craig Rivet,2000-01,26.0,7,2,61,61,0,2,2,26.0,,120,1,11,12,61.0,82,5.28,57,380,2242,9.6
5898,Craig Rivet,2001-02,27.0,8,10,66,66,2,8,10,39.0,946.0,186,3,19,22,100.0,82,5.27,57,359,2285,9.4
5899,Craig Rivet,2002-03,28.0,9,17,61,61,3,14,17,71.0,1162.0,247,6,33,39,171.0,82,5.49,53,331,2294,9.8
5900,Craig Rivet,2003-04,29.0,10,3,26,26,1,2,3,22.0,496.0,273,7,35,42,193.0,82,5.51,63,376,2272,9.9
5901,Craig Rivet,2004-05,30.0,11,25,82,82,8,17,25,90.0,1558.0,355,15,52,67,283.0,82,5.24,53,338,2262,9.5
5902,Craig Rivet,2005-06,31.0,12,22,82,82,7,15,22,118.0,1803.0,437,22,67,89,401.0,82,5.31,60,363,2326,9.4
5903,Craig Rivet,2006-07,32.0,13,12,80,80,4,8,12,96.0,1557.0,517,26,75,101,497.0,82,5.14,57,348,2300,9.2
5904,Craig Rivet,2008-09,34.0,14,34,82,82,7,27,34,122.0,1840.0,599,33,102,135,619.0,82,6.05,85,480,2458,10.1
5905,Craig Rivet,2009-10,35.0,15,24,71,71,7,17,24,89.0,1537.0,670,40,119,159,708.0,82,5.76,70,398,2426,9.7
5906,Craig Rivet,2010-11,36.0,16,35,74,74,5,30,35,105.0,1569.0,744,45,149,194,813.0,82,5.44,62,351,2383,9.4
5907,Craig Rivet,2011-12,37.0,17,24,64,64,2,22,24,80.0,1295.0,808,47,171,218,893.0,82,5.7,65,341,2477,9.4
5908,Craig Rivet,2012-13,38.0,18,15,78,78,1,14,15,63.0,1421.0,886,48,185,233,956.0,82,5.53,56,304,2486,9.1
5909,Craig Rivet,2013-14,39.0,19,4,37,37,2,2,4,33.0,543.0,923,50,187,237,989.0,82,5.46,52,291,2492,9.0
5910,Craig Simpson,1988-89,21.0,4,28,76,76,11,17,28,74.0,,76,11,17,28,74.0,80,7.94,82,370,2484,12.8
5911,Craig Simpson,1989-90,22.0,5,51,72,72,26,25,51,133.0,,148,37,42,79,207.0,80,7.34,72,344,2400,12.2
5912,Craig Simpson,1990-91,23.0,6,90,80,80,56,34,90,177.0,,228,93,76,169,384.0,80,7.43,89,437,2435,12.2
5913,Craig Simpson,1991-92,24.0,7,76,66,66,35,41,76,121.0,,294,128,117,245,505.0,80,7.48,85,403,2430,12.3
5914,Craig Simpson,1992-93,25.0,8,61,80,80,29,32,61,129.0,,374,157,149,306,634.0,80,7.37,76,367,2421,12.2
5915,Craig Simpson,1993-94,26.0,9,57,75,75,30,27,57,143.0,,449,187,176,363,777.0,80,6.91,71,366,2385,11.6
5916,Craig Simpson,1994-95,27.0,10,61,79,79,24,37,61,128.0,,528,211,213,424,905.0,80,6.96,77,402,2440,11.4
5917,Craig Simpson,1995-96,28.0,11,46,60,60,24,22,46,91.0,,588,235,235,470,996.0,84,7.25,87,443,2603,11.7
5918,Craig Simpson,1996-97,29.0,12,16,22,22,8,8,16,28.0,,610,243,243,486,1024.0,84,6.48,76,407,2545,10.7
5919,Craig Simpson,1997-98,30.0,13,11,24,24,4,7,11,20.0,,634,247,250,497,1044.0,48,5.97,37,209,1408,10.2
5920,Craig Smith,2014-15,25.0,4,36,72,72,14,22,36,172.0,1022.0,72,14,22,36,172.0,82,5.32,47,271,2439,8.9
5921,Craig Smith,2015-16,26.0,5,12,44,44,4,8,12,83.0,610.0,116,18,30,48,255.0,48,5.31,29,160,1399,9.1
5922,Craig Smith,2016-17,27.0,6,52,79,79,24,28,52,215.0,1296.0,195,42,58,100,470.0,82,5.34,48,269,2463,8.9
5923,Craig Smith,2017-18,28.0,7,44,82,82,23,21,44,252.0,1291.0,277,65,79,144,722.0,82,5.32,47,251,2453,8.9
5924,Craig Smith,2018-19,29.0,8,37,82,82,21,16,37,199.0,1245.0,359,86,95,181,921.0,82,5.34,48,255,2438,9.0
5925,Craig Smith,2019-20,30.0,9,29,78,78,12,17,29,155.0,1078.0,437,98,112,210,1076.0,82,5.45,47,245,2478,9.0
5926,Craig Smith,2020-21,31.0,10,51,79,79,25,26,51,229.0,1215.0,516,123,138,261,1305.0,82,5.86,50,250,2620,9.2
5927,Craig Smith,2021-22,32.0,11,38,76,76,21,17,38,205.0,1150.0,592,144,155,299,1510.0,82,5.96,47,239,2579,9.5
5928,Craig Smith,2022-23,33.0,12,31,69,69,18,13,31,184.0,926.0,661,162,168,330,1694.0,70,5.96,42,208,2192,9.5
5929,Craig Weller,2010-11,30.0,4,11,59,59,3,8,11,72.0,613.0,59,3,8,11,72.0,82,5.44,62,351,2383,9.4
5930,Craig Weller,2011-12,31.0,5,3,36,36,1,2,3,27.0,250.0,95,4,10,14,99.0,82,5.7,65,341,2477,9.4
5931,Craig Wolanin,1988-89,21.0,4,18,44,44,2,16,18,45.0,,44,2,16,18,45.0,80,7.94,82,370,2484,12.8
5932,Craig Wolanin,1989-90,22.0,5,10,68,68,4,6,10,68.0,,112,6,22,28,113.0,80,7.34,72,344,2400,12.2
5933,Craig Wolanin,1990-91,23.0,6,31,78,78,6,25,31,113.0,,190,12,47,59,226.0,80,7.43,89,437,2435,12.2
5934,Craig Wolanin,1991-92,24.0,7,11,56,56,3,8,11,70.0,,246,15,55,70,296.0,80,7.48,85,403,2430,12.3
5935,Craig Wolanin,1992-93,25.0,8,11,50,50,1,10,11,60.0,,296,16,65,81,356.0,80,7.37,76,367,2421,12.2
5936,Craig Wolanin,1993-94,26.0,9,18,80,80,5,13,18,109.0,,376,21,78,99,465.0,80,6.91,71,366,2385,11.6
5937,Craig Wolanin,1994-95,27.0,10,13,69,69,2,11,13,71.0,,445,23,89,112,536.0,80,6.96,77,402,2440,11.4
5938,Craig Wolanin,1995-96,28.0,11,5,24,24,1,4,5,17.0,,469,24,93,117,553.0,84,7.25,87,443,2603,11.7
5939,Craig Wolanin,1996-97,29.0,12,16,63,63,6,10,16,78.0,,532,30,103,133,631.0,84,6.48,76,407,2545,10.7
5940,Craig Wolanin,1997-98,30.0,13,9,40,40,3,6,9,36.0,,572,33,109,142,667.0,48,5.97,37,209,1408,10.2
5941,Craig Wolanin,1998-99,31.0,14,27,75,75,7,20,27,73.0,,647,40,129,169,740.0,82,6.29,74,413,2481,10.4
5942,Craig Wolanin,1999-00,32.0,15,4,38,38,0,4,4,43.0,,685,40,133,173,783.0,82,5.83,55,336,2444,9.8
5943,Craig Wolanin,2000-01,33.0,16,0,10,10,0,0,0,5.0,,695,40,133,173,788.0,82,5.28,57,380,2242,9.6
5944,Curt Brackenbury,1982-83,31.0,4,14,63,63,6,8,14,42.0,,63,6,8,14,42.0,80,7.03,61,280,2352,12.0
5945,Curt Brackenbury,1983-84,32.0,5,9,58,58,2,7,9,20.0,,121,8,15,23,62.0,80,7.69,77,340,2441,12.6
5946,Curt Brackenbury,1984-85,33.0,6,2,14,14,0,2,2,2.0,,135,8,17,25,64.0,80,8.03,73,320,2489,12.9
5947,Curt Brackenbury,1985-86,34.0,7,1,6,6,1,0,1,2.0,,141,9,17,26,66.0,80,7.73,71,310,2444,12.7
5948,Curt Giles,1982-83,24.0,4,9,37,37,2,7,9,48.0,,37,2,7,9,48.0,80,7.03,61,280,2352,12.0
5949,Curt Giles,1983-84,25.0,5,27,67,67,5,22,27,82.0,,104,7,29,36,130.0,80,7.69,77,340,2441,12.6
5950,Curt Giles,1984-85,26.0,6,15,74,74,3,12,15,65.0,,178,10,41,51,195.0,80,8.03,73,320,2489,12.9
5951,Curt Giles,1985-86,27.0,7,23,76,76,2,21,23,78.0,,254,12,62,74,273.0,80,7.73,71,310,2444,12.7
5952,Curt Giles,1986-87,28.0,8,28,70,70,6,22,28,78.0,,324,18,84,102,351.0,80,7.89,74,336,2448,12.9
5953,Curt Giles,1987-88,29.0,9,30,77,77,5,25,30,98.0,,401,23,109,132,449.0,80,7.77,71,321,2447,12.7
5954,Curt Giles,1988-89,30.0,10,27,69,69,6,21,27,59.0,,470,29,130,159,508.0,80,7.94,82,370,2484,12.8
5955,Curt Giles,1989-90,31.0,11,22,72,72,2,20,22,57.0,,542,31,150,181,565.0,80,7.34,72,344,2400,12.2
5956,Curt Giles,1990-91,32.0,12,13,72,72,1,12,13,72.0,,614,32,162,194,637.0,80,7.43,89,437,2435,12.2
5957,Curt Giles,1991-92,33.0,13,15,76,76,5,10,15,64.0,,690,37,172,209,701.0,80,7.48,85,403,2430,12.3
5958,Curt Giles,1992-93,34.0,14,13,74,74,1,12,13,55.0,,764,38,184,222,756.0,80,7.37,76,367,2421,12.2
5959,Curt Giles,1993-94,35.0,15,14,70,70,4,10,14,53.0,,834,42,194,236,809.0,80,6.91,71,366,2385,11.6
5960,Curt Giles,1994-95,36.0,16,2,13,13,1,1,2,4.0,,847,43,195,238,813.0,80,6.96,77,402,2440,11.4
5961,Curt Giles,1995-96,37.0,17,4,48,48,0,4,4,23.0,,895,43,199,242,836.0,84,7.25,87,443,2603,11.7
5962,Curtis Brown,1997-98,21.0,4,2,1,1,1,1,2,4.0,,1,1,1,2,4.0,48,5.97,37,209,1408,10.2
5963,Curtis Brown,1998-99,22.0,5,0,4,4,0,0,0,1.0,,5,1,1,2,5.0,82,6.29,74,413,2481,10.4
5964,Curtis Brown,1999-00,23.0,6,7,28,28,4,3,7,31.0,,33,5,4,9,36.0,82,5.83,55,336,2444,9.8
5965,Curtis Brown,2000-01,24.0,7,24,63,63,12,12,24,91.0,,96,17,16,33,127.0,82,5.28,57,380,2242,9.6
5966,Curtis Brown,2001-02,25.0,8,47,78,78,16,31,47,128.0,1365.0,174,33,47,80,255.0,82,5.27,57,359,2285,9.4
5967,Curtis Brown,2002-03,26.0,9,51,74,74,22,29,51,149.0,1345.0,248,55,76,131,404.0,82,5.49,53,331,2294,9.8
5968,Curtis Brown,2003-04,27.0,10,32,70,70,10,22,32,105.0,1160.0,318,65,98,163,509.0,82,5.51,63,376,2272,9.9
5969,Curtis Brown,2004-05,28.0,11,37,82,82,20,17,37,171.0,1460.0,400,85,115,200,680.0,82,5.24,53,338,2262,9.5
5970,Curtis Brown,2005-06,29.0,12,31,74,74,15,16,31,144.0,1249.0,474,100,131,231,824.0,82,5.31,60,363,2326,9.4
5971,Curtis Brown,2006-07,30.0,13,25,80,80,11,14,25,138.0,1326.0,554,111,145,256,962.0,82,5.14,57,348,2300,9.2
5972,Curtis Brown,2008-09,32.0,14,15,71,71,5,10,15,84.0,969.0,625,116,155,271,1046.0,82,6.05,85,480,2458,10.1
5973,Curtis Brown,2009-10,33.0,15,20,78,78,8,12,20,84.0,1027.0,703,124,167,291,1130.0,82,5.76,70,398,2426,9.7
5974,Curtis Brown,2010-11,34.0,16,9,33,33,5,4,9,38.0,357.0,736,129,171,300,1168.0,82,5.44,62,351,2383,9.4
5975,Curtis Glencross,2009-10,27.0,4,1,9,9,1,0,1,8.0,82.0,9,1,0,1,8.0,82,5.76,70,398,2426,9.7
5976,Curtis Glencross,2010-11,28.0,5,25,62,62,15,10,25,104.0,705.0,71,16,10,26,112.0,82,5.44,62,351,2383,9.4
5977,Curtis Glencross,2011-12,29.0,6,40,74,74,13,27,40,152.0,1086.0,145,29,37,66,264.0,82,5.7,65,341,2477,9.4
5978,Curtis Glencross,2012-13,30.0,7,33,67,67,15,18,33,117.0,1053.0,212,44,55,99,381.0,82,5.53,56,304,2486,9.1
5979,Curtis Glencross,2013-14,31.0,8,43,79,79,24,19,43,149.0,1283.0,291,68,74,142,530.0,82,5.46,52,291,2492,9.0
5980,Curtis Glencross,2014-15,32.0,9,48,67,67,26,22,48,110.0,1208.0,358,94,96,190,640.0,82,5.32,47,271,2439,8.9
5981,Curtis Glencross,2015-16,33.0,10,26,40,40,15,11,26,92.0,729.0,398,109,107,216,732.0,48,5.31,29,160,1399,9.1
5982,Curtis Glencross,2016-17,34.0,11,24,38,38,12,12,24,77.0,669.0,436,121,119,240,809.0,82,5.34,48,269,2463,8.9
5983,Curtis Glencross,2017-18,35.0,12,35,71,71,13,22,35,108.0,1111.0,507,134,141,275,917.0,82,5.32,47,251,2453,8.9
5984,Curtis Hamilton,2017-18,26.0,4,0,1,1,0,0,0,0.0,8.0,1,0,0,0,0.0,82,5.32,47,251,2453,8.9
5985,Curtis Lazar,2017-18,22.0,4,15,67,67,6,9,15,92.0,864.0,67,6,9,15,92.0,82,5.32,47,251,2453,8.9
5986,Curtis Lazar,2018-19,23.0,5,20,76,76,6,14,20,78.0,1053.0,143,12,23,35,170.0,82,5.34,48,255,2438,9.0
5987,Curtis Lazar,2019-20,24.0,6,4,37,37,1,3,4,26.0,338.0,180,13,26,39,196.0,82,5.45,47,245,2478,9.0
5988,Curtis Lazar,2020-21,25.0,7,12,65,65,2,10,12,65.0,641.0,245,15,36,51,261.0,82,5.86,50,250,2620,9.2
5989,Curtis Lazar,2021-22,26.0,8,0,1,1,0,0,0,0.0,5.0,246,15,36,51,261.0,82,5.96,47,239,2579,9.5
5990,Curtis Lazar,2022-23,27.0,9,10,38,38,5,5,10,33.0,450.0,284,20,41,61,294.0,70,5.96,42,208,2192,9.5
5991,Curtis Leschyshyn,1991-92,22.0,4,13,71,71,4,9,13,58.0,,71,4,9,13,58.0,80,7.48,85,403,2430,12.3
5992,Curtis Leschyshyn,1992-93,23.0,5,8,68,68,2,6,8,42.0,,139,6,15,21,100.0,80,7.37,76,367,2421,12.2
5993,Curtis Leschyshyn,1993-94,24.0,6,10,55,55,3,7,10,57.0,,194,9,22,31,157.0,80,6.91,71,366,2385,11.6
5994,Curtis Leschyshyn,1994-95,25.0,7,17,42,42,5,12,17,61.0,,236,14,34,48,218.0,80,6.96,77,402,2440,11.4
5995,Curtis Leschyshyn,1995-96,26.0,8,32,82,82,9,23,32,73.0,,318,23,57,80,291.0,84,7.25,87,443,2603,11.7
5996,Curtis Leschyshyn,1996-97,27.0,9,22,72,72,5,17,22,97.0,,390,28,74,102,388.0,84,6.48,76,407,2545,10.7
5997,Curtis Leschyshyn,1997-98,28.0,10,15,44,44,2,13,15,43.0,,434,30,87,117,431.0,48,5.97,37,209,1408,10.2
5998,Curtis Leschyshyn,1998-99,29.0,11,19,77,77,4,15,19,76.0,,511,34,102,136,507.0,82,6.29,74,413,2481,10.4
5999,Curtis Leschyshyn,1999-00,30.0,12,22,77,77,4,18,22,102.0,,588,38,120,158,609.0,82,5.83,55,336,2444,9.8
6000,Curtis Leschyshyn,2000-01,31.0,13,12,73,73,2,10,12,53.0,,661,40,130,170,662.0,82,5.28,57,380,2242,9.6
6001,Curtis Leschyshyn,2001-02,32.0,14,9,65,65,2,7,9,35.0,1255.0,726,42,137,179,697.0,82,5.27,57,359,2285,9.4
6002,Curtis Leschyshyn,2002-03,33.0,15,2,53,53,0,2,2,31.0,943.0,779,42,139,181,728.0,82,5.49,53,331,2294,9.8
6003,Curtis Leschyshyn,2003-04,34.0,16,9,65,65,2,7,9,51.0,1263.0,844,44,146,190,779.0,82,5.51,63,376,2272,9.9
6004,Curtis Leschyshyn,2004-05,35.0,17,10,79,79,1,9,10,59.0,1459.0,923,45,155,200,838.0,82,5.24,53,338,2262,9.5
6005,Curtis Leschyshyn,2005-06,36.0,18,7,54,54,1,6,7,30.0,822.0,977,46,161,207,868.0,82,5.31,60,363,2326,9.4
6006,Curtis Leschyshyn,2006-07,37.0,19,5,56,56,1,4,5,30.0,778.0,1033,47,165,212,898.0,82,5.14,57,348,2300,9.2
6007,Curtis McKenzie,2017-18,26.0,4,5,36,36,4,1,5,41.0,415.0,36,4,1,5,41.0,82,5.32,47,251,2453,8.9
6008,Curtis McKenzie,2018-19,27.0,5,0,3,3,0,0,0,3.0,26.0,39,4,1,5,44.0,82,5.34,48,255,2438,9.0
6009,Curtis McKenzie,2019-20,28.0,6,16,53,53,6,10,16,66.0,575.0,92,10,11,21,110.0,82,5.45,47,245,2478,9.0
6010,Curtis McKenzie,2020-21,29.0,7,2,7,7,0,2,2,11.0,57.0,99,10,13,23,121.0,82,5.86,50,250,2620,9.2
6011,Curtis Murphy,2005-06,30.0,4,0,1,1,0,0,0,0.0,9.0,1,0,0,0,0.0,82,5.31,60,363,2326,9.4
6012,Curtis Valk,2020-21,27.0,4,0,1,1,0,0,0,0.0,3.0,1,0,0,0,0.0,82,5.86,50,250,2620,9.2
6013,D.J. King,2009-10,25.0,4,2,27,27,1,1,2,12.0,149.0,27,1,1,2,12.0,82,5.76,70,398,2426,9.7
6014,D.J. King,2010-11,26.0,5,6,61,61,3,3,6,36.0,342.0,88,4,4,8,48.0,82,5.44,62,351,2383,9.4
6015,D.J. King,2011-12,27.0,6,1,1,1,0,1,1,0.0,8.0,89,4,5,9,48.0,82,5.7,65,341,2477,9.4
6016,D.J. King,2012-13,28.0,7,0,12,12,0,0,0,5.0,54.0,101,4,5,9,53.0,82,5.53,56,304,2486,9.1
6017,D.J. King,2013-14,29.0,8,2,16,16,0,2,2,6.0,91.0,117,4,7,11,59.0,82,5.46,52,291,2492,9.0
6018,D.J. King,2014-15,30.0,9,0,1,1,0,0,0,1.0,7.0,118,4,7,11,60.0,82,5.32,47,271,2439,8.9
6019,D.J. Smith,1999-00,22.0,4,1,8,8,0,1,1,4.0,,8,0,1,1,4.0,82,5.83,55,336,2444,9.8
6020,D.J. Smith,2002-03,25.0,5,0,3,3,0,0,0,2.0,38.0,11,0,1,1,6.0,82,5.49,53,331,2294,9.8
6021,D.J. Smith,2005-06,28.0,6,1,34,34,1,0,1,7.0,130.0,45,1,1,2,13.0,82,5.31,60,363,2326,9.4
6022,Dainius Zubrus,1999-00,21.0,4,21,68,68,8,13,21,71.0,,68,8,13,21,71.0,82,5.83,55,336,2444,9.8
6023,Dainius Zubrus,2000-01,22.0,5,33,69,69,8,25,33,101.0,,137,16,38,54,172.0,82,5.28,57,380,2242,9.6
6024,Dainius Zubrus,2001-02,23.0,6,16,80,80,6,10,16,80.0,980.0,217,22,48,70,252.0,82,5.27,57,359,2285,9.4
6025,Dainius Zubrus,2002-03,24.0,7,42,73,73,14,28,42,139.0,1286.0,290,36,76,112,391.0,82,5.49,53,331,2294,9.8
6026,Dainius Zubrus,2003-04,25.0,8,26,61,61,13,13,26,83.0,1063.0,351,49,89,138,474.0,82,5.51,63,376,2272,9.9
6027,Dainius Zubrus,2004-05,26.0,9,43,71,71,17,26,43,138.0,1339.0,422,66,115,181,612.0,82,5.24,53,338,2262,9.5
6028,Dainius Zubrus,2005-06,27.0,10,35,63,63,13,22,35,104.0,1035.0,485,79,137,216,716.0,82,5.31,60,363,2326,9.4
6029,Dainius Zubrus,2006-07,28.0,11,27,54,54,12,15,27,115.0,1054.0,539,91,152,243,831.0,82,5.14,57,348,2300,9.2
6030,Dainius Zubrus,2008-09,30.0,12,57,71,71,23,34,57,181.0,1446.0,610,114,186,300,1012.0,82,6.05,85,480,2458,10.1
6031,Dainius Zubrus,2009-10,31.0,13,60,79,79,24,36,60,158.0,1540.0,689,138,222,360,1170.0,82,5.76,70,398,2426,9.7
6032,Dainius Zubrus,2010-11,32.0,14,38,82,82,13,25,38,128.0,1287.0,771,151,247,398,1298.0,82,5.44,62,351,2383,9.4
6033,Dainius Zubrus,2011-12,33.0,15,40,82,82,15,25,40,130.0,1252.0,853,166,272,438,1428.0,82,5.7,65,341,2477,9.4
6034,Dainius Zubrus,2012-13,34.0,16,27,51,51,10,17,27,86.0,840.0,904,176,289,465,1514.0,82,5.53,56,304,2486,9.1
6035,Dainius Zubrus,2013-14,35.0,17,30,79,79,13,17,30,115.0,1355.0,983,189,306,495,1629.0,82,5.46,52,291,2492,9.0
6036,Dainius Zubrus,2014-15,36.0,18,44,82,82,17,27,44,109.0,1532.0,1065,206,333,539,1738.0,82,5.32,47,271,2439,8.9
6037,Dainius Zubrus,2015-16,37.0,19,9,22,22,2,7,9,22.0,369.0,1087,208,340,548,1760.0,48,5.31,29,160,1399,9.1
6038,Dainius Zubrus,2016-17,38.0,20,26,82,82,13,13,26,121.0,1440.0,1169,221,353,574,1881.0,82,5.34,48,269,2463,8.9
6039,Dainius Zubrus,2017-18,39.0,21,10,74,74,4,6,10,72.0,1085.0,1243,225,359,584,1953.0,82,5.32,47,251,2453,8.9
6040,Dainius Zubrus,2018-19,40.0,22,7,50,50,3,4,7,33.0,579.0,1293,228,363,591,1986.0,82,5.34,48,255,2438,9.0
6041,Dakota Mermis,2020-21,27.0,4,0,9,9,0,0,0,7.0,99.0,9,0,0,0,7.0,82,5.86,50,250,2620,9.2
6042,Dakota Mermis,2021-22,28.0,5,0,1,1,0,0,0,0.0,11.0,10,0,0,0,7.0,82,5.96,47,239,2579,9.5
6043,Dakota Mermis,2022-23,29.0,6,4,10,10,1,3,4,17.0,192.0,20,1,3,4,24.0,70,5.96,42,208,2192,9.5
6044,Dale Clarke,2003-04,25.0,4,0,3,3,0,0,0,5.0,41.0,3,0,0,0,5.0,82,5.51,63,376,2272,9.9
6045,Dale Craigwell,1994-95,23.0,4,16,32,32,5,11,16,38.0,,32,5,11,16,38.0,80,6.96,77,402,2440,11.4
6046,Dale Craigwell,1995-96,24.0,5,4,8,8,3,1,4,7.0,,40,8,12,20,45.0,84,7.25,87,443,2603,11.7
6047,Dale Craigwell,1996-97,25.0,6,9,58,58,3,6,9,35.0,,98,11,18,29,80.0,84,6.48,76,407,2545,10.7
6048,Dale DeGray,1988-89,25.0,4,0,1,1,0,0,0,1.0,,1,0,0,0,1.0,80,7.94,82,370,2484,12.8
6049,Dale DeGray,1989-90,26.0,5,13,27,27,6,7,13,57.0,,28,6,7,13,58.0,80,7.34,72,344,2400,12.2
6050,Dale DeGray,1990-91,27.0,6,24,56,56,6,18,24,122.0,,84,12,25,37,180.0,80,7.43,89,437,2435,12.2
6051,Dale DeGray,1991-92,28.0,7,28,63,63,6,22,28,87.0,,147,18,47,65,267.0,80,7.48,85,403,2430,12.3
6052,Dale DeGray,1992-93,29.0,8,0,6,6,0,0,0,5.0,,153,18,47,65,272.0,80,7.37,76,367,2421,12.2
6053,Dale Dunbar,1988-89,27.0,4,0,1,1,0,0,0,0.0,,1,0,0,0,0.0,80,7.94,82,370,2484,12.8
6054,Dale Dunbar,1991-92,30.0,5,0,1,1,0,0,0,2.0,,2,0,0,0,2.0,80,7.48,85,403,2430,12.3
6055,Dale Hawerchuk,1984-85,21.0,4,103,80,80,45,58,103,339.0,,80,45,58,103,339.0,80,8.03,73,320,2489,12.9
6056,Dale Hawerchuk,1985-86,22.0,5,91,79,79,40,51,91,297.0,,159,85,109,194,636.0,80,7.73,71,310,2444,12.7
6057,Dale Hawerchuk,1986-87,23.0,6,102,80,80,37,65,102,256.0,,239,122,174,296,892.0,80,7.89,74,336,2448,12.9
6058,Dale Hawerchuk,1987-88,24.0,7,130,80,80,53,77,130,280.0,,319,175,251,426,1172.0,80,7.77,71,321,2447,12.7
6059,Dale Hawerchuk,1988-89,25.0,8,105,80,80,46,59,105,313.0,,399,221,310,531,1485.0,80,7.94,82,370,2484,12.8
6060,Dale Hawerchuk,1989-90,26.0,9,100,80,80,47,53,100,267.0,,479,268,363,631,1752.0,80,7.34,72,344,2400,12.2
6061,Dale Hawerchuk,1990-91,27.0,10,121,80,80,44,77,121,292.0,,559,312,440,752,2044.0,80,7.43,89,437,2435,12.2
6062,Dale Hawerchuk,1991-92,28.0,11,96,75,75,41,55,96,239.0,,634,353,495,848,2283.0,80,7.48,85,403,2430,12.3
6063,Dale Hawerchuk,1992-93,29.0,12,81,79,79,26,55,81,211.0,,713,379,550,929,2494.0,80,7.37,76,367,2421,12.2
6064,Dale Hawerchuk,1993-94,30.0,13,89,80,80,31,58,89,194.0,,793,410,608,1018,2688.0,80,6.91,71,366,2385,11.6
6065,Dale Hawerchuk,1994-95,31.0,14,98,77,77,23,75,98,242.0,,870,433,683,1116,2930.0,80,6.96,77,402,2440,11.4
6066,Dale Hawerchuk,1995-96,32.0,15,96,81,81,16,80,96,259.0,,951,449,763,1212,3189.0,84,7.25,87,443,2603,11.7
6067,Dale Hawerchuk,1996-97,33.0,16,86,81,81,35,51,86,227.0,,1032,484,814,1298,3416.0,84,6.48,76,407,2545,10.7
6068,Dale Hawerchuk,1997-98,34.0,17,16,23,23,5,11,16,56.0,,1055,489,825,1314,3472.0,48,5.97,37,209,1408,10.2
6069,Dale Hawerchuk,1998-99,35.0,18,61,82,82,17,44,61,180.0,,1137,506,869,1375,3652.0,82,6.29,74,413,2481,10.4
6070,Dale Hawerchuk,1999-00,36.0,19,34,51,51,12,22,34,102.0,,1188,518,891,1409,3754.0,82,5.83,55,336,2444,9.8
6071,Dale Henry,1987-88,23.0,4,3,16,16,2,1,3,9.0,,16,2,1,3,9.0,80,7.77,71,321,2447,12.7
6072,Dale Henry,1988-89,24.0,5,4,7,7,1,3,4,5.0,,23,3,4,7,14.0,80,7.94,82,370,2484,12.8
6073,Dale Henry,1989-90,25.0,6,6,19,19,3,3,6,14.0,,42,6,7,13,28.0,80,7.34,72,344,2400,12.2
6074,Dale Henry,1990-91,26.0,7,20,48,48,5,15,20,53.0,,90,11,22,33,81.0,80,7.43,89,437,2435,12.2
6075,Dale Henry,1991-92,27.0,8,4,22,22,2,2,4,20.0,,112,13,24,37,101.0,80,7.48,85,403,2430,12.3
6076,Dale Henry,1992-93,28.0,9,2,20,20,0,2,2,6.0,,132,13,26,39,107.0,80,7.37,76,367,2421,12.2
6077,Dale Hunter,1983-84,23.0,4,63,80,80,19,44,63,152.0,,80,19,44,63,152.0,80,7.69,77,340,2441,12.6
6078,Dale Hunter,1984-85,24.0,5,72,80,80,22,50,72,124.0,,160,41,94,135,276.0,80,8.03,73,320,2489,12.9
6079,Dale Hunter,1985-86,25.0,6,63,80,80,17,46,63,125.0,,240,58,140,198,401.0,80,7.73,71,310,2444,12.7
6080,Dale Hunter,1986-87,26.0,7,79,77,77,24,55,79,123.0,,317,82,195,277,524.0,80,7.89,74,336,2448,12.9
6081,Dale Hunter,1987-88,27.0,8,72,80,80,20,52,72,118.0,,397,102,247,349,642.0,80,7.77,71,321,2447,12.7
6082,Dale Hunter,1988-89,28.0,9,70,80,80,28,42,70,151.0,,477,130,289,419,793.0,80,7.94,82,370,2484,12.8
6083,Dale Hunter,1989-90,29.0,10,39,46,46,10,29,39,53.0,,523,140,318,458,846.0,80,7.34,72,344,2400,12.2
6084,Dale Hunter,1990-91,30.0,11,59,79,79,22,37,59,126.0,,602,162,355,517,972.0,80,7.43,89,437,2435,12.2
6085,Dale Hunter,1991-92,31.0,12,57,80,80,20,37,57,138.0,,682,182,392,574,1110.0,80,7.48,85,403,2430,12.3
6086,Dale Hunter,1992-93,32.0,13,62,80,80,23,39,62,123.0,,762,205,431,636,1233.0,80,7.37,76,367,2421,12.2
6087,Dale Hunter,1993-94,33.0,14,46,76,76,16,30,46,106.0,,838,221,461,682,1339.0,80,6.91,71,366,2385,11.6
6088,Dale Hunter,1994-95,34.0,15,78,80,80,28,50,78,110.0,,918,249,511,760,1449.0,80,6.96,77,402,2440,11.4
6089,Dale Hunter,1995-96,35.0,16,79,84,84,20,59,79,120.0,,1002,269,570,839,1569.0,84,7.25,87,443,2603,11.7
6090,Dale Hunter,1996-97,36.0,17,38,52,52,9,29,38,61.0,,1054,278,599,877,1630.0,84,6.48,76,407,2545,10.7
6091,Dale Hunter,1997-98,37.0,18,23,45,45,8,15,23,73.0,,1099,286,614,900,1703.0,48,5.97,37,209,1408,10.2
6092,Dale Hunter,1998-99,38.0,19,37,82,82,13,24,37,128.0,,1181,299,638,937,1831.0,82,6.29,74,413,2481,10.4
6093,Dale Hunter,1999-00,39.0,20,46,82,82,14,32,46,110.0,,1263,313,670,983,1941.0,82,5.83,55,336,2444,9.8
6094,Dale Hunter,2000-01,40.0,21,26,82,82,8,18,26,82.0,,1345,321,688,1009,2023.0,82,5.28,57,380,2242,9.6
6095,Dale Hunter,2001-02,41.0,22,11,62,62,2,9,11,24.0,563.0,1407,323,697,1020,2047.0,82,5.27,57,359,2285,9.4
6096,Dale Krentz,1989-90,28.0,4,0,8,8,0,0,0,5.0,,8,0,0,0,5.0,80,7.34,72,344,2400,12.2
6097,Dale Krentz,1990-91,29.0,5,2,6,6,2,0,2,5.0,,14,2,0,2,10.0,80,7.43,89,437,2435,12.2
6098,Dale Krentz,1991-92,30.0,6,6,16,16,3,3,6,27.0,,30,5,3,8,37.0,80,7.48,85,403,2430,12.3
6099,Dale Kushner,1992-93,26.0,4,0,2,2,0,0,0,0.0,,2,0,0,0,0.0,80,7.37,76,367,2421,12.2
6100,Dale Kushner,1993-94,27.0,5,18,63,63,7,11,18,59.0,,65,7,11,18,59.0,80,6.91,71,366,2385,11.6
6101,Dale Kushner,1994-95,28.0,6,5,19,19,3,2,5,19.0,,84,10,13,23,78.0,80,6.96,77,402,2440,11.4
6102,Dale McTavish,1999-00,27.0,4,3,9,9,1,2,3,14.0,,9,1,2,3,14.0,82,5.83,55,336,2444,9.8
6103,Dale Purinton,2002-03,26.0,4,0,1,1,0,0,0,1.0,13.0,1,0,0,0,1.0,82,5.49,53,331,2294,9.8
6104,Dale Purinton,2003-04,27.0,5,2,42,42,0,2,2,13.0,401.0,43,0,2,2,14.0,82,5.51,63,376,2272,9.9
6105,Dale Purinton,2004-05,28.0,6,4,40,40,0,4,4,11.0,305.0,83,0,6,6,25.0,82,5.24,53,338,2262,9.5
6106,Dale Purinton,2005-06,29.0,7,12,58,58,3,9,12,50.0,872.0,141,3,15,18,75.0,82,5.31,60,363,2326,9.4
6107,Dale Purinton,2006-07,30.0,8,2,40,40,1,1,2,31.0,511.0,181,4,16,20,106.0,82,5.14,57,348,2300,9.2
6108,Dale Rominski,2002-03,27.0,4,1,3,3,0,1,1,0.0,25.0,3,0,1,1,0.0,82,5.49,53,331,2294,9.8
6109,Dale Weise,2013-14,25.0,4,0,10,10,0,0,0,9.0,65.0,10,0,0,0,9.0,82,5.46,52,291,2492,9.0
6110,Dale Weise,2014-15,26.0,5,8,68,68,4,4,8,48.0,555.0,78,4,4,8,57.0,82,5.32,47,271,2439,8.9
6111,Dale Weise,2015-16,27.0,6,6,40,40,3,3,6,35.0,382.0,118,7,7,14,92.0,48,5.31,29,160,1399,9.1
6112,Dale Weise,2016-17,28.0,7,16,61,61,6,10,16,41.0,513.0,179,13,17,30,133.0,82,5.34,48,269,2463,8.9
6113,Dale Weise,2017-18,29.0,8,29,79,79,10,19,29,91.0,962.0,258,23,36,59,224.0,82,5.32,47,251,2453,8.9
6114,Dale Weise,2018-19,30.0,9,27,71,71,14,13,27,136.0,952.0,329,37,49,86,360.0,82,5.34,48,255,2438,9.0
6115,Dale Weise,2019-20,31.0,10,15,64,64,8,7,15,94.0,824.0,393,45,56,101,454.0,82,5.45,47,245,2478,9.0
6116,Dale Weise,2020-21,32.0,11,8,46,46,4,4,8,44.0,486.0,439,49,60,109,498.0,82,5.86,50,250,2620,9.2
6117,Dale Weise,2021-22,33.0,12,11,51,51,5,6,11,58.0,601.0,490,54,66,120,556.0,82,5.96,47,239,2579,9.5
6118,Dale Weise,2022-23,34.0,13,5,23,23,1,4,5,15.0,213.0,513,55,70,125,571.0,70,5.96,42,208,2192,9.5
6119,Dallas Drake,1995-96,26.0,4,44,72,72,18,26,44,89.0,,72,18,26,44,89.0,84,7.25,87,443,2603,11.7
6120,Dallas Drake,1996-97,27.0,5,40,62,62,13,27,40,112.0,,134,31,53,84,201.0,84,6.48,76,407,2545,10.7
6121,Dallas Drake,1997-98,28.0,6,26,43,43,8,18,26,66.0,,177,39,71,110,267.0,48,5.97,37,209,1408,10.2
6122,Dallas Drake,1998-99,29.0,7,39,69,69,19,20,39,121.0,,246,58,91,149,388.0,82,6.29,74,413,2481,10.4
6123,Dallas Drake,1999-00,30.0,8,36,63,63,17,19,36,113.0,,309,75,110,185,501.0,82,5.83,55,336,2444,9.8
6124,Dallas Drake,2000-01,31.0,9,40,60,60,11,29,40,112.0,,369,86,139,225,613.0,82,5.28,57,380,2242,9.6
6125,Dallas Drake,2001-02,32.0,10,31,53,53,9,22,31,105.0,829.0,422,95,161,256,718.0,82,5.27,57,359,2285,9.4
6126,Dallas Drake,2002-03,33.0,11,45,79,79,15,30,45,127.0,1248.0,501,110,191,301,845.0,82,5.49,53,331,2294,9.8
6127,Dallas Drake,2003-04,34.0,12,41,82,82,12,29,41,142.0,1208.0,583,122,220,342,987.0,82,5.51,63,376,2272,9.9
6128,Dallas Drake,2004-05,35.0,13,26,80,80,11,15,26,116.0,1075.0,663,133,235,368,1103.0,82,5.24,53,338,2262,9.5
6129,Dallas Drake,2005-06,36.0,14,30,80,80,20,10,30,113.0,1184.0,743,153,245,398,1216.0,82,5.31,60,363,2326,9.4
6130,Dallas Drake,2006-07,37.0,15,35,79,79,13,22,35,121.0,1340.0,822,166,267,433,1337.0,82,5.14,57,348,2300,9.2
6131,Dallas Drake,2008-09,39.0,16,26,62,62,2,24,26,88.0,1049.0,884,168,291,459,1425.0,82,6.05,85,480,2458,10.1
6132,Dallas Drake,2009-10,40.0,17,12,60,60,6,6,12,74.0,773.0,944,174,297,471,1499.0,82,5.76,70,398,2426,9.7
6133,Dallas Drake,2010-11,41.0,18,6,65,65,3,3,6,46.0,696.0,1009,177,300,477,1545.0,82,5.44,62,351,2383,9.4
6134,Dallas Eakins,1995-96,28.0,4,2,14,14,0,2,2,9.0,,14,0,2,2,9.0,84,7.25,87,443,2603,11.7
6135,Dallas Eakins,1996-97,29.0,5,0,1,1,0,0,0,2.0,,15,0,2,2,11.0,84,6.48,76,407,2545,10.7
6136,Dallas Eakins,1997-98,30.0,6,1,17,17,0,1,1,3.0,,32,0,3,3,14.0,48,5.97,37,209,1408,10.2
6137,Dallas Eakins,1998-99,31.0,7,1,18,18,0,1,1,6.0,,50,0,4,4,20.0,82,6.29,74,413,2481,10.4
6138,Dallas Eakins,1999-00,32.0,8,0,7,7,0,0,0,4.0,,57,0,4,4,24.0,82,5.83,55,336,2444,9.8
6139,Dallas Eakins,2000-01,33.0,9,1,23,23,0,1,1,16.0,,80,0,5,5,40.0,82,5.28,57,380,2242,9.6
6140,Dallas Eakins,2001-02,34.0,10,2,18,18,0,2,2,11.0,296.0,98,0,7,7,51.0,82,5.27,57,359,2285,9.4
6141,Dallas Eakins,2002-03,35.0,11,1,2,2,0,1,1,4.0,43.0,100,0,8,8,55.0,82,5.49,53,331,2294,9.8
6142,Dallas Eakins,2003-04,36.0,12,1,17,17,0,1,1,4.0,209.0,117,0,9,9,59.0,82,5.51,63,376,2272,9.9
6143,Dallas Eakins,2004-05,37.0,13,0,3,3,0,0,0,0.0,43.0,120,0,9,9,59.0,82,5.24,53,338,2262,9.5
6144,Dallas Gaume,1991-92,28.0,4,2,4,4,1,1,2,5.0,,4,1,1,2,5.0,80,7.48,85,403,2430,12.3
6145,Dalton Prout,2014-15,24.0,4,0,5,5,0,0,0,2.0,59.0,5,0,0,0,2.0,82,5.32,47,271,2439,8.9
6146,Dalton Prout,2015-16,25.0,5,7,28,28,1,6,7,16.0,519.0,33,1,6,7,18.0,48,5.31,29,160,1399,9.1
6147,Dalton Prout,2016-17,26.0,6,6,49,49,2,4,6,56.0,843.0,82,3,10,13,74.0,82,5.34,48,269,2463,8.9
6148,Dalton Prout,2017-18,27.0,7,8,63,63,0,8,8,64.0,1160.0,145,3,18,21,138.0,82,5.32,47,251,2453,8.9
6149,Dalton Prout,2018-19,28.0,8,9,64,64,3,6,9,69.0,1035.0,209,6,24,30,207.0,82,5.34,48,255,2438,9.0
6150,Dalton Prout,2019-20,29.0,9,6,29,29,0,6,6,13.0,405.0,238,6,30,36,220.0,82,5.45,47,245,2478,9.0
6151,Dalton Prout,2020-21,30.0,10,0,4,4,0,0,0,5.0,56.0,242,6,30,36,225.0,82,5.86,50,250,2620,9.2
6152,Dalton Prout,2021-22,31.0,11,2,20,20,1,1,2,14.0,262.0,262,7,31,38,239.0,82,5.96,47,239,2579,9.5
6153,Dalton Prout,2022-23,32.0,12,0,2,2,0,0,0,2.0,26.0,264,7,31,38,241.0,70,5.96,42,208,2192,9.5
6154,Dalton Smith,2022-23,30.0,4,0,1,1,0,0,0,0.0,1.0,1,0,0,0,0.0,70,5.96,42,208,2192,9.5
6155,Damian Surma,2005-06,25.0,4,1,1,1,1,0,1,1.0,7.0,1,1,0,1,1.0,82,5.31,60,363,2326,9.4
6156,Damian Surma,2006-07,26.0,5,1,1,1,0,1,1,0.0,9.0,2,1,1,2,1.0,82,5.14,57,348,2300,9.2
6157,Damien Brunner,2015-16,29.0,4,26,44,44,12,14,26,123.0,686.0,44,12,14,26,123.0,48,5.31,29,160,1399,9.1
6158,Damien Brunner,2016-17,30.0,5,25,60,60,11,14,25,110.0,812.0,104,23,28,51,233.0,82,5.34,48,269,2463,8.9
6159,Damien Brunner,2017-18,31.0,6,7,17,17,2,5,7,29.0,258.0,121,25,33,58,262.0,82,5.32,47,251,2453,8.9
6160,Damon Severson,2017-18,23.0,4,17,51,51,5,12,17,93.0,1120.0,51,5,12,17,93.0,82,5.32,47,251,2453,8.9
6161,Damon Severson,2018-19,24.0,5,21,72,72,1,20,21,94.0,1308.0,123,6,32,38,187.0,82,5.34,48,255,2438,9.0
6162,Damon Severson,2019-20,25.0,6,31,80,80,3,28,31,125.0,1628.0,203,9,60,69,312.0,82,5.45,47,245,2478,9.0
6163,Damon Severson,2020-21,26.0,7,24,76,76,9,15,24,121.0,1496.0,279,18,75,93,433.0,82,5.86,50,250,2620,9.2
6164,Damon Severson,2021-22,27.0,8,39,82,82,11,28,39,146.0,1808.0,361,29,103,132,579.0,82,5.96,47,239,2579,9.5
6165,Damon Severson,2022-23,28.0,9,31,69,69,8,23,31,114.0,1584.0,430,37,126,163,693.0,70,5.96,42,208,2192,9.5
6166,Dan Bonar,1983-84,27.0,4,26,71,71,11,15,26,64.0,,71,11,15,26,64.0,80,7.69,77,340,2441,12.6
6167,Dan Bonar,1984-85,28.0,5,36,79,79,13,23,36,123.0,,150,24,38,62,187.0,80,8.03,73,320,2489,12.9
6168,Dan Bonar,1985-86,29.0,6,2,20,20,1,1,2,15.0,,170,25,39,64,202.0,80,7.73,71,310,2444,12.7
6169,Dan Bourbonnais,1984-85,22.0,4,12,24,24,3,9,12,30.0,,24,3,9,12,30.0,80,8.03,73,320,2489,12.9
6170,Dan Bourbonnais,1986-87,24.0,5,16,35,35,0,16,16,42.0,,59,3,25,28,72.0,80,7.89,74,336,2448,12.9
6171,Dan Boyle,2001-02,25.0,4,8,22,22,3,5,8,31.0,414.0,22,3,5,8,31.0,82,5.27,57,359,2285,9.4
6172,Dan Boyle,2002-03,26.0,5,3,13,13,0,3,3,9.0,220.0,35,3,8,11,40.0,82,5.49,53,331,2294,9.8
6173,Dan Boyle,2003-04,27.0,6,22,69,69,4,18,22,83.0,1169.0,104,7,26,33,123.0,82,5.51,63,376,2272,9.9
6174,Dan Boyle,2004-05,28.0,7,26,66,66,8,18,26,99.0,1313.0,170,15,44,59,222.0,82,5.24,53,338,2262,9.5
6175,Dan Boyle,2005-06,29.0,8,53,77,77,13,40,53,136.0,1887.0,247,28,84,112,358.0,82,5.31,60,363,2326,9.4
6176,Dan Boyle,2006-07,30.0,9,39,78,78,9,30,39,137.0,1776.0,325,37,114,151,495.0,82,5.14,57,348,2300,9.2
6177,Dan Boyle,2008-09,32.0,10,53,79,79,15,38,53,153.0,1851.0,404,52,152,204,648.0,82,6.05,85,480,2458,10.1
6178,Dan Boyle,2009-10,33.0,11,63,82,82,20,43,63,203.0,2218.0,486,72,195,267,851.0,82,5.76,70,398,2426,9.7
6179,Dan Boyle,2010-11,34.0,12,25,37,37,4,21,25,74.0,1014.0,523,76,216,292,925.0,82,5.44,62,351,2383,9.4
6180,Dan Boyle,2011-12,35.0,13,57,77,77,16,41,57,213.0,1908.0,600,92,257,349,1138.0,82,5.7,65,341,2477,9.4
6181,Dan Boyle,2012-13,36.0,14,58,76,76,15,43,58,180.0,1992.0,676,107,300,407,1318.0,82,5.53,56,304,2486,9.1
6182,Dan Boyle,2013-14,37.0,15,50,76,76,9,41,50,199.0,1994.0,752,116,341,457,1517.0,82,5.46,52,291,2492,9.0
6183,Dan Boyle,2014-15,38.0,16,48,81,81,9,39,48,252.0,2072.0,833,125,380,505,1769.0,82,5.32,47,271,2439,8.9
6184,Dan Boyle,2015-16,39.0,17,20,46,46,7,13,20,97.0,1049.0,879,132,393,525,1866.0,48,5.31,29,160,1399,9.1
6185,Dan Boyle,2016-17,40.0,18,36,75,75,12,24,36,154.0,1596.0,954,144,417,561,2020.0,82,5.34,48,269,2463,8.9
6186,Dan Boyle,2017-18,41.0,19,20,65,65,9,11,20,116.0,1316.0,1019,153,428,581,2136.0,82,5.32,47,251,2453,8.9
6187,Dan Boyle,2018-19,42.0,20,24,74,74,10,14,24,95.0,1392.0,1093,163,442,605,2231.0,82,5.34,48,255,2438,9.0
6188,Dan Brennan,1986-87,24.0,4,0,2,2,0,0,0,1.0,,2,0,0,0,1.0,80,7.89,74,336,2448,12.9
6189,Dan Brennan,1988-89,26.0,5,1,6,6,0,1,1,6.0,,8,0,1,1,7.0,80,7.94,82,370,2484,12.8
6190,Dan Bylsma,1998-99,28.0,4,0,4,4,0,0,0,6.0,,4,0,0,0,6.0,82,6.29,74,413,2481,10.4
6191,Dan Bylsma,1999-00,29.0,5,9,79,79,3,6,9,86.0,,83,3,6,9,92.0,82,5.83,55,336,2444,9.8
6192,Dan Bylsma,2000-01,30.0,6,12,65,65,3,9,12,57.0,,148,6,15,21,149.0,82,5.28,57,380,2242,9.6
6193,Dan Bylsma,2001-02,31.0,7,0,8,8,0,0,0,3.0,79.0,156,6,15,21,152.0,82,5.27,57,359,2285,9.4
6194,Dan Bylsma,2002-03,32.0,8,9,64,64,3,6,9,43.0,665.0,220,9,21,30,195.0,82,5.49,53,331,2294,9.8
6195,Dan Bylsma,2003-04,33.0,9,10,82,82,1,9,10,50.0,963.0,302,10,30,40,245.0,82,5.51,63,376,2272,9.9
6196,Dan Bylsma,2004-05,34.0,10,17,77,77,8,9,17,72.0,893.0,379,18,39,57,317.0,82,5.24,53,338,2262,9.5
6197,Dan Bylsma,2005-06,35.0,11,5,39,39,1,4,5,23.0,370.0,418,19,43,62,340.0,82,5.31,60,363,2326,9.4
6198,Dan Bylsma,2006-07,36.0,12,0,11,11,0,0,0,6.0,78.0,429,19,43,62,346.0,82,5.14,57,348,2300,9.2
6199,Dan Cleary,2000-01,22.0,4,0,6,6,0,0,0,4.0,,6,0,0,0,4.0,82,5.28,57,380,2242,9.6
6200,Dan Cleary,2001-02,23.0,5,9,35,35,4,5,9,49.0,502.0,41,4,5,9,53.0,82,5.27,57,359,2285,9.4
6201,Dan Cleary,2002-03,24.0,6,5,17,17,3,2,5,18.0,166.0,58,7,7,14,71.0,82,5.49,53,331,2294,9.8
6202,Dan Cleary,2003-04,25.0,7,35,81,81,14,21,35,107.0,1051.0,139,21,28,49,178.0,82,5.51,63,376,2272,9.9
6203,Dan Cleary,2004-05,26.0,8,29,65,65,10,19,29,75.0,826.0,204,31,47,78,253.0,82,5.24,53,338,2262,9.5
6204,Dan Cleary,2005-06,27.0,9,17,57,57,4,13,17,89.0,682.0,261,35,60,95,342.0,82,5.31,60,363,2326,9.4
6205,Dan Cleary,2006-07,28.0,10,17,68,68,6,11,17,83.0,898.0,329,41,71,112,425.0,82,5.14,57,348,2300,9.2
6206,Dan Cleary,2008-09,30.0,11,15,77,77,3,12,15,106.0,808.0,406,44,83,127,531.0,82,6.05,85,480,2458,10.1
6207,Dan Cleary,2009-10,31.0,12,40,71,71,20,20,40,135.0,1098.0,477,64,103,167,666.0,82,5.76,70,398,2426,9.7
6208,Dan Cleary,2010-11,32.0,13,42,63,63,20,22,42,177.0,1095.0,540,84,125,209,843.0,82,5.44,62,351,2383,9.4
6209,Dan Cleary,2011-12,33.0,14,40,74,74,14,26,40,163.0,1253.0,614,98,151,249,1006.0,82,5.7,65,341,2477,9.4
6210,Dan Cleary,2012-13,34.0,15,34,64,64,15,19,34,140.0,1103.0,678,113,170,283,1146.0,82,5.53,56,304,2486,9.1
6211,Dan Cleary,2013-14,35.0,16,46,68,68,26,20,46,192.0,1131.0,746,139,190,329,1338.0,82,5.46,52,291,2492,9.0
6212,Dan Cleary,2014-15,36.0,17,33,75,75,12,21,33,199.0,1199.0,821,151,211,362,1537.0,82,5.32,47,271,2439,8.9
6213,Dan Cleary,2015-16,37.0,18,15,48,48,9,6,15,93.0,789.0,869,160,217,377,1630.0,48,5.31,29,160,1399,9.1
6214,Dan Cleary,2016-17,38.0,19,8,52,52,4,4,8,64.0,723.0,921,164,221,385,1694.0,82,5.34,48,269,2463,8.9
6215,Dan Cleary,2017-18,39.0,20,2,17,17,1,1,2,17.0,155.0,938,165,222,387,1711.0,82,5.32,47,251,2453,8.9
6216,Dan Currie,1993-94,25.0,4,0,5,5,0,0,0,5.0,,5,0,0,0,5.0,80,6.91,71,366,2385,11.6
6217,Dan Currie,1994-95,26.0,5,1,7,7,1,0,1,3.0,,12,1,0,1,8.0,80,6.96,77,402,2440,11.4
6218,Dan Currie,1995-96,27.0,6,0,5,5,0,0,0,11.0,,17,1,0,1,19.0,84,7.25,87,443,2603,11.7
6219,Dan Currie,1996-97,28.0,7,2,5,5,1,1,2,12.0,,22,2,1,3,31.0,84,6.48,76,407,2545,10.7
6220,Dan Daoust,1985-86,25.0,4,52,52,52,18,34,52,123.0,,52,18,34,52,123.0,80,7.73,71,310,2444,12.7
6221,Dan Daoust,1986-87,26.0,5,74,78,78,18,56,74,154.0,,130,36,90,126,277.0,80,7.89,74,336,2448,12.9
6222,Dan Daoust,1987-88,27.0,6,54,79,79,17,37,54,142.0,,209,53,127,180,419.0,80,7.77,71,321,2447,12.7
6223,Dan Daoust,1988-89,28.0,7,20,80,80,7,13,20,91.0,,289,60,140,200,510.0,80,7.94,82,370,2484,12.8
6224,Dan Daoust,1989-90,29.0,8,7,33,33,4,3,7,25.0,,322,64,143,207,535.0,80,7.34,72,344,2400,12.2
6225,Dan Daoust,1990-91,30.0,9,17,67,67,9,8,17,57.0,,389,73,151,224,592.0,80,7.43,89,437,2435,12.2
6226,Dan Daoust,1991-92,31.0,10,12,68,68,7,5,12,66.0,,457,80,156,236,658.0,80,7.48,85,403,2430,12.3
6227,Dan Daoust,1992-93,32.0,11,18,65,65,7,11,18,53.0,,522,87,167,254,711.0,80,7.37,76,367,2421,12.2
6228,Dan Dorion,1988-89,25.0,4,2,3,3,1,1,2,6.0,,3,1,1,2,6.0,80,7.94,82,370,2484,12.8
6229,Dan Dorion,1990-91,27.0,5,0,1,1,0,0,0,0.0,,4,1,1,2,6.0,80,7.43,89,437,2435,12.2
6230,Dan Focht,2004-05,27.0,4,0,8,8,0,0,0,5.0,99.0,8,0,0,0,5.0,82,5.24,53,338,2262,9.5
6231,Dan Focht,2005-06,28.0,5,3,22,22,0,3,3,12.0,305.0,30,0,3,3,17.0,82,5.31,60,363,2326,9.4
6232,Dan Focht,2006-07,29.0,6,5,52,52,2,3,5,56.0,863.0,82,2,6,8,73.0,82,5.14,57,348,2300,9.2
6233,Dan Frawley,1986-87,24.0,4,0,3,3,0,0,0,2.0,,3,0,0,0,2.0,80,7.89,74,336,2448,12.9
6234,Dan Frawley,1987-88,25.0,5,7,30,30,4,3,7,23.0,,33,4,3,7,25.0,80,7.77,71,321,2447,12.7
6235,Dan Frawley,1988-89,26.0,6,21,69,69,10,11,21,80.0,,102,14,14,28,105.0,80,7.94,82,370,2484,12.8
6236,Dan Frawley,1989-90,27.0,7,28,78,78,14,14,28,108.0,,180,28,28,56,213.0,80,7.34,72,344,2400,12.2
6237,Dan Frawley,1990-91,28.0,8,14,47,47,6,8,14,66.0,,227,34,36,70,279.0,80,7.43,89,437,2435,12.2
6238,Dan Frawley,1991-92,29.0,9,7,46,46,3,4,7,37.0,,273,37,40,77,316.0,80,7.48,85,403,2430,12.3
6239,Dan Fridgen,1984-85,25.0,4,1,2,2,0,1,1,5.0,,2,0,1,1,5.0,80,8.03,73,320,2489,12.9
6240,Dan Fridgen,1985-86,26.0,5,4,11,11,2,2,4,13.0,,13,2,3,5,18.0,80,7.73,71,310,2444,12.7
6241,Dan Fritsche,2006-07,21.0,4,1,19,19,1,0,1,19.0,160.0,19,1,0,1,19.0,82,5.14,57,348,2300,9.2
6242,Dan Fritsche,2008-09,23.0,5,13,59,59,6,7,13,93.0,607.0,78,7,7,14,112.0,82,6.05,85,480,2458,10.1
6243,Dan Fritsche,2009-10,24.0,6,27,59,59,12,15,27,81.0,828.0,137,19,22,41,193.0,82,5.76,70,398,2426,9.7
6244,Dan Fritsche,2010-11,25.0,7,22,69,69,10,12,22,109.0,852.0,206,29,34,63,302.0,82,5.44,62,351,2383,9.4
6245,Dan Fritsche,2011-12,26.0,8,13,50,50,5,8,13,54.0,532.0,256,34,42,76,356.0,82,5.7,65,341,2477,9.4
6246,Dan Girardi,2009-10,25.0,4,6,34,34,0,6,6,33.0,538.0,34,0,6,6,33.0,82,5.76,70,398,2426,9.7
6247,Dan Girardi,2010-11,26.0,5,28,82,82,10,18,28,147.0,1738.0,116,10,24,34,180.0,82,5.44,62,351,2383,9.4
6248,Dan Girardi,2011-12,27.0,6,22,82,82,4,18,22,122.0,1765.0,198,14,42,56,302.0,82,5.7,65,341,2477,9.4
6249,Dan Girardi,2012-13,28.0,7,24,82,82,6,18,24,108.0,1762.0,280,20,60,80,410.0,82,5.53,56,304,2486,9.1
6250,Dan Girardi,2013-14,29.0,8,31,80,80,4,27,31,110.0,1966.0,360,24,87,111,520.0,82,5.46,52,291,2492,9.0
6251,Dan Girardi,2014-15,30.0,9,29,82,82,5,24,29,122.0,2152.0,442,29,111,140,642.0,82,5.32,47,271,2439,8.9
6252,Dan Girardi,2015-16,31.0,10,14,46,46,2,12,14,81.0,1169.0,488,31,123,154,723.0,48,5.31,29,160,1399,9.1
6253,Dan Girardi,2016-17,32.0,11,24,81,81,5,19,24,100.0,1873.0,569,36,142,178,823.0,82,5.34,48,269,2463,8.9
6254,Dan Girardi,2017-18,33.0,12,20,82,82,4,16,20,111.0,1861.0,651,40,158,198,934.0,82,5.32,47,251,2453,8.9
6255,Dan Girardi,2018-19,34.0,13,17,74,74,2,15,17,77.0,1504.0,725,42,173,215,1011.0,82,5.34,48,255,2438,9.0
6256,Dan Girardi,2019-20,35.0,14,15,63,63,4,11,15,56.0,1203.0,788,46,184,230,1067.0,82,5.45,47,245,2478,9.0
6257,Dan Girardi,2020-21,36.0,15,18,77,77,6,12,18,93.0,1339.0,865,52,196,248,1160.0,82,5.86,50,250,2620,9.2
6258,Dan Girardi,2021-22,37.0,16,16,62,62,4,12,16,75.0,1104.0,927,56,208,264,1235.0,82,5.96,47,239,2579,9.5
6259,Dan Gratton,1990-91,24.0,4,1,7,7,1,0,1,3.0,,7,1,0,1,3.0,80,7.43,89,437,2435,12.2
6260,Dan Hamhuis,2006-07,24.0,4,26,80,80,7,19,26,115.0,1770.0,80,7,19,26,115.0,82,5.14,57,348,2300,9.2
6261,Dan Hamhuis,2008-09,26.0,5,38,82,82,7,31,38,135.0,1850.0,162,14,50,64,250.0,82,6.05,85,480,2458,10.1
6262,Dan Hamhuis,2009-10,27.0,6,20,81,81,6,14,20,84.0,1728.0,243,20,64,84,334.0,82,5.76,70,398,2426,9.7
6263,Dan Hamhuis,2010-11,28.0,7,27,80,80,4,23,27,127.0,1819.0,323,24,87,111,461.0,82,5.44,62,351,2383,9.4
6264,Dan Hamhuis,2011-12,29.0,8,26,82,82,3,23,26,135.0,1873.0,405,27,110,137,596.0,82,5.7,65,341,2477,9.4
6265,Dan Hamhuis,2012-13,30.0,9,24,78,78,5,19,24,115.0,1658.0,483,32,129,161,711.0,82,5.53,56,304,2486,9.1
6266,Dan Hamhuis,2013-14,31.0,10,23,64,64,6,17,23,109.0,1451.0,547,38,146,184,820.0,82,5.46,52,291,2492,9.0
6267,Dan Hamhuis,2014-15,32.0,11,37,82,82,4,33,37,140.0,1921.0,629,42,179,221,960.0,82,5.32,47,271,2439,8.9
6268,Dan Hamhuis,2015-16,33.0,12,24,47,47,4,20,24,61.0,1099.0,676,46,199,245,1021.0,48,5.31,29,160,1399,9.1
6269,Dan Hamhuis,2016-17,34.0,13,22,79,79,5,17,22,150.0,1893.0,755,51,216,267,1171.0,82,5.34,48,269,2463,8.9
6270,Dan Hamhuis,2017-18,35.0,14,23,59,59,1,22,23,82.0,1270.0,814,52,238,290,1253.0,82,5.32,47,251,2453,8.9
6271,Dan Hamhuis,2018-19,36.0,15,13,58,58,3,10,13,72.0,1242.0,872,55,248,303,1325.0,82,5.34,48,255,2438,9.0
6272,Dan Hamhuis,2019-20,37.0,16,16,79,79,1,15,16,83.0,1529.0,951,56,263,319,1408.0,82,5.45,47,245,2478,9.0
6273,Dan Hamhuis,2020-21,38.0,17,24,80,80,3,21,24,66.0,1615.0,1031,59,284,343,1474.0,82,5.86,50,250,2620,9.2
6274,Dan Hamhuis,2021-22,39.0,18,5,57,57,0,5,5,39.0,915.0,1088,59,289,348,1513.0,82,5.96,47,239,2579,9.5
6275,Dan Hamhuis,2022-23,40.0,19,8,60,60,0,8,8,44.0,871.0,1148,59,297,356,1557.0,70,5.96,42,208,2192,9.5
6276,Dan Hinote,2002-03,26.0,4,4,27,27,1,3,4,14.0,212.0,27,1,3,4,14.0,82,5.49,53,331,2294,9.8
6277,Dan Hinote,2003-04,27.0,5,15,76,76,5,10,15,69.0,787.0,103,6,13,19,83.0,82,5.51,63,376,2272,9.9
6278,Dan Hinote,2004-05,28.0,6,12,58,58,6,6,12,75.0,722.0,161,12,19,31,158.0,82,5.24,53,338,2262,9.5
6279,Dan Hinote,2005-06,29.0,7,10,60,60,6,4,10,65.0,636.0,221,18,23,41,223.0,82,5.31,60,363,2326,9.4
6280,Dan Hinote,2006-07,30.0,8,11,59,59,4,7,11,53.0,750.0,280,22,30,52,276.0,82,5.14,57,348,2300,9.2
6281,Dan Hinote,2008-09,32.0,9,13,73,73,5,8,13,70.0,780.0,353,27,38,65,346.0,82,6.05,85,480,2458,10.1
6282,Dan Hinote,2009-10,33.0,10,10,41,41,5,5,10,37.0,536.0,394,32,43,75,383.0,82,5.76,70,398,2426,9.7
6283,Dan Hinote,2010-11,34.0,11,10,58,58,5,5,10,42.0,610.0,452,37,48,85,425.0,82,5.44,62,351,2383,9.4
6284,Dan Hinote,2011-12,35.0,12,5,51,51,1,4,5,24.0,556.0,503,38,52,90,449.0,82,5.7,65,341,2477,9.4
6285,Dan Hodgson,1988-89,23.0,4,25,40,40,13,12,25,54.0,,40,13,12,25,54.0,80,7.94,82,370,2484,12.8
6286,Dan Hodgson,1989-90,24.0,5,22,43,43,9,13,22,42.0,,83,22,25,47,96.0,80,7.34,72,344,2400,12.2
6287,Dan Hodgson,1990-91,25.0,6,10,8,8,3,7,10,7.0,,91,25,32,57,103.0,80,7.43,89,437,2435,12.2
6288,Dan Hodgson,1991-92,26.0,7,17,23,23,4,13,17,38.0,,114,29,45,74,141.0,80,7.48,85,403,2430,12.3
6289,Dan Jancevski,2008-09,27.0,4,0,2,2,0,0,0,0.0,18.0,2,0,0,0,0.0,82,6.05,85,480,2458,10.1
6290,Dan Jancevski,2010-11,29.0,5,0,4,4,0,0,0,3.0,23.0,6,0,0,0,3.0,82,5.44,62,351,2383,9.4
6291,Dan Jancevski,2011-12,30.0,6,0,3,3,0,0,0,4.0,46.0,9,0,0,0,7.0,82,5.7,65,341,2477,9.4
6292,Dan Keczmer,1993-94,25.0,4,1,9,9,0,1,1,6.0,,9,0,1,1,6.0,80,6.91,71,366,2385,11.6
6293,Dan Keczmer,1994-95,26.0,5,0,1,1,0,0,0,2.0,,10,0,1,1,8.0,80,6.96,77,402,2440,11.4
6294,Dan Keczmer,1995-96,27.0,6,8,23,23,4,4,8,38.0,,33,4,5,9,46.0,84,7.25,87,443,2603,11.7
6295,Dan Keczmer,1996-97,28.0,7,22,69,69,1,21,22,116.0,,102,5,26,31,162.0,84,6.48,76,407,2545,10.7
6296,Dan Keczmer,1997-98,29.0,8,5,28,28,2,3,5,33.0,,130,7,29,36,195.0,48,5.97,37,209,1408,10.2
6297,Dan Keczmer,1998-99,30.0,9,0,13,13,0,0,0,13.0,,143,7,29,36,208.0,82,6.29,74,413,2481,10.4
6298,Dan Keczmer,1999-00,31.0,10,1,13,13,0,1,1,10.0,,156,7,30,37,218.0,82,5.83,55,336,2444,9.8
6299,Dan Keczmer,2000-01,32.0,11,3,17,17,1,2,3,9.0,,173,8,32,40,227.0,82,5.28,57,380,2242,9.6
6300,Dan Keczmer,2001-02,33.0,12,1,38,38,0,1,1,24.0,418.0,211,8,33,41,251.0,82,5.27,57,359,2285,9.4
6301,Dan Keczmer,2002-03,34.0,13,5,24,24,0,5,5,21.0,430.0,235,8,38,46,272.0,82,5.49,53,331,2294,9.8
6302,Dan Kesa,1996-97,25.0,4,6,19,19,2,4,6,18.0,,19,2,4,6,18.0,84,6.48,76,407,2545,10.7
6303,Dan Kesa,1998-99,27.0,5,0,3,3,0,0,0,0.0,,22,2,4,6,18.0,82,6.29,74,413,2481,10.4
6304,Dan Kesa,2001-02,30.0,6,10,67,67,2,8,10,33.0,678.0,89,4,12,16,51.0,82,5.27,57,359,2285,9.4
6305,Dan Kesa,2002-03,31.0,7,14,50,50,4,10,14,55.0,678.0,139,8,22,30,106.0,82,5.49,53,331,2294,9.8
6306,Dan Kordic,1994-95,23.0,4,4,46,46,1,3,4,27.0,,46,1,3,4,27.0,80,6.96,77,402,2440,11.4
6307,Dan Kordic,1996-97,25.0,5,0,4,4,0,0,0,0.0,,50,1,3,4,27.0,84,6.48,76,407,2545,10.7
6308,Dan Kordic,1998-99,27.0,6,1,9,9,1,0,1,2.0,,59,2,3,5,29.0,82,6.29,74,413,2481,10.4
6309,Dan Kordic,1999-00,28.0,7,5,75,75,1,4,5,21.0,,134,3,7,10,50.0,82,5.83,55,336,2444,9.8
6310,Dan Kordic,2000-01,29.0,8,2,61,61,1,1,2,12.0,,195,4,8,12,62.0,82,5.28,57,380,2242,9.6
6311,Dan Kordic,2001-02,30.0,9,0,2,2,0,0,0,0.0,5.0,197,4,8,12,62.0,82,5.27,57,359,2285,9.4
6312,Dan LaCouture,2001-02,24.0,4,0,3,3,0,0,0,0.0,20.0,3,0,0,0,0.0,82,5.27,57,359,2285,9.4
6313,Dan LaCouture,2002-03,25.0,5,0,5,5,0,0,0,2.0,35.0,8,0,0,0,2.0,82,5.49,53,331,2294,9.8
6314,Dan LaCouture,2003-04,26.0,6,6,48,48,2,4,6,23.0,328.0,56,2,4,6,25.0,82,5.51,63,376,2272,9.9
6315,Dan LaCouture,2004-05,27.0,7,17,82,82,6,11,17,77.0,1088.0,138,8,15,23,102.0,82,5.24,53,338,2262,9.5
6316,Dan LaCouture,2005-06,28.0,8,9,68,68,3,6,9,47.0,653.0,206,11,21,32,149.0,82,5.31,60,363,2326,9.4
6317,Dan LaCouture,2006-07,29.0,9,7,59,59,5,2,7,39.0,560.0,265,16,23,39,188.0,82,5.14,57,348,2300,9.2
6318,Dan LaCouture,2008-09,31.0,10,4,55,55,2,2,4,37.0,344.0,320,18,25,43,225.0,82,6.05,85,480,2458,10.1
6319,Dan LaCouture,2009-10,32.0,11,0,6,6,0,0,0,0.0,30.0,326,18,25,43,225.0,82,5.76,70,398,2426,9.7
6320,Dan LaCouture,2011-12,34.0,12,2,11,11,2,0,2,4.0,47.0,337,20,25,45,229.0,82,5.7,65,341,2477,9.4
6321,Dan Lambert,1993-94,24.0,4,0,1,1,0,0,0,0.0,,1,0,0,0,0.0,80,6.91,71,366,2385,11.6
6322,Dan Lambert,1994-95,25.0,5,15,28,28,6,9,15,42.0,,29,6,9,15,42.0,80,6.96,77,402,2440,11.4
6323,Dan Mandich,1985-86,25.0,4,7,67,67,3,4,7,49.0,,67,3,4,7,49.0,80,7.73,71,310,2444,12.7
6324,Dan Mandich,1986-87,26.0,5,9,31,31,2,7,9,29.0,,98,5,11,16,78.0,80,7.89,74,336,2448,12.9
6325,Dan Mandich,1987-88,27.0,6,0,10,10,0,0,0,4.0,,108,5,11,16,82.0,80,7.77,71,321,2447,12.7
6326,Dan Mandich,1988-89,28.0,7,0,3,3,0,0,0,0.0,,111,5,11,16,82.0,80,7.94,82,370,2484,12.8
6327,Dan McCarthy,1983-84,25.0,4,4,5,5,4,0,4,7.0,,5,4,0,4,7.0,80,7.69,77,340,2441,12.6
6328,Dan McFall,1987-88,24.0,4,0,2,2,0,0,0,2.0,,2,0,0,0,2.0,80,7.77,71,321,2447,12.7
6329,Dan McFall,1988-89,25.0,5,1,7,7,0,1,1,2.0,,9,0,1,1,4.0,80,7.94,82,370,2484,12.8
6330,Dan McGillis,1999-00,27.0,4,22,73,73,6,16,22,139.0,,73,6,16,22,139.0,82,5.83,55,336,2444,9.8
6331,Dan McGillis,2000-01,28.0,5,31,80,80,11,20,31,137.0,,153,17,36,53,276.0,82,5.28,57,380,2242,9.6
6332,Dan McGillis,2001-02,29.0,6,45,78,78,8,37,45,164.0,1691.0,231,25,73,98,440.0,82,5.27,57,359,2285,9.4
6333,Dan McGillis,2002-03,30.0,7,18,68,68,4,14,18,128.0,1365.0,299,29,87,116,568.0,82,5.49,53,331,2294,9.8
6334,Dan McGillis,2003-04,31.0,8,49,82,82,14,35,49,207.0,1918.0,381,43,122,165,775.0,82,5.51,63,376,2272,9.9
6335,Dan McGillis,2004-05,32.0,9,19,75,75,5,14,19,147.0,1580.0,456,48,136,184,922.0,82,5.24,53,338,2262,9.5
6336,Dan McGillis,2005-06,33.0,10,20,71,71,3,17,20,130.0,1460.0,527,51,153,204,1052.0,82,5.31,60,363,2326,9.4
6337,Dan McGillis,2006-07,34.0,11,28,80,80,5,23,28,117.0,1577.0,607,56,176,232,1169.0,82,5.14,57,348,2300,9.2
6338,Dan McGillis,2008-09,36.0,12,6,27,27,0,6,6,32.0,384.0,634,56,182,238,1201.0,82,6.05,85,480,2458,10.1
6339,Dan Plante,1996-97,25.0,4,1,12,12,0,1,1,9.0,,12,0,1,1,9.0,84,6.48,76,407,2545,10.7
6340,Dan Plante,1998-99,27.0,5,8,73,73,5,3,8,103.0,,85,5,4,9,112.0,82,6.29,74,413,2481,10.4
6341,Dan Plante,1999-00,28.0,6,13,67,67,4,9,13,61.0,,152,9,13,22,173.0,82,5.83,55,336,2444,9.8
6342,Dan Plante,2000-01,29.0,7,1,7,7,0,1,1,7.0,,159,9,14,23,180.0,82,5.28,57,380,2242,9.6
6343,Dan Quinn,1986-87,21.0,4,52,54,54,19,33,52,103.0,,54,19,33,52,103.0,80,7.89,74,336,2448,12.9
6344,Dan Quinn,1987-88,22.0,5,58,74,74,20,38,58,143.0,,128,39,71,110,246.0,80,7.77,71,321,2447,12.7
6345,Dan Quinn,1988-89,23.0,6,72,78,78,30,42,72,191.0,,206,69,113,182,437.0,80,7.94,82,370,2484,12.8
6346,Dan Quinn,1989-90,24.0,7,80,80,80,31,49,80,184.0,,286,100,162,262,621.0,80,7.34,72,344,2400,12.2
6347,Dan Quinn,1990-91,25.0,8,79,70,70,40,39,79,235.0,,356,140,201,341,856.0,80,7.43,89,437,2435,12.2
6348,Dan Quinn,1991-92,26.0,9,94,79,79,34,60,94,200.0,,435,174,261,435,1056.0,80,7.48,85,403,2430,12.3
6349,Dan Quinn,1992-93,27.0,10,63,78,78,25,38,63,181.0,,513,199,299,498,1237.0,80,7.37,76,367,2421,12.2
6350,Dan Quinn,1993-94,28.0,11,60,78,78,22,38,60,183.0,,591,221,337,558,1420.0,80,6.91,71,366,2385,11.6
6351,Dan Quinn,1994-95,29.0,12,37,67,67,11,26,37,101.0,,658,232,363,595,1521.0,80,6.96,77,402,2440,11.4
6352,Dan Quinn,1995-96,30.0,13,4,11,11,0,4,4,20.0,,669,232,367,599,1541.0,84,7.25,87,443,2603,11.7
6353,Dan Quinn,1996-97,31.0,14,7,13,13,7,0,7,31.0,,682,239,367,606,1572.0,84,6.48,76,407,2545,10.7
6354,Dan Quinn,1997-98,32.0,15,31,44,44,14,17,31,78.0,,726,253,384,637,1650.0,48,5.97,37,209,1408,10.2
6355,Dan Quinn,1998-99,33.0,16,45,63,63,13,32,45,109.0,,789,266,416,682,1759.0,82,6.29,74,413,2481,10.4
6356,Dan Quinn,1999-00,34.0,17,3,16,16,0,3,3,16.0,,805,266,419,685,1775.0,82,5.83,55,336,2444,9.8
6357,Dan Ratushny,1995-96,25.0,4,1,1,1,0,1,1,2.0,,1,0,1,1,2.0,84,7.25,87,443,2603,11.7
6358,Dan Renouf,2019-20,25.0,4,0,1,1,0,0,0,1.0,14.0,1,0,0,0,1.0,82,5.45,47,245,2478,9.0
6359,Dan Sexton,2012-13,25.0,4,19,41,41,9,10,19,93.0,553.0,41,9,10,19,93.0,82,5.53,56,304,2486,9.1
6360,Dan Sexton,2013-14,26.0,5,13,47,47,4,9,13,78.0,545.0,88,13,19,32,171.0,82,5.46,52,291,2492,9.0
6361,Dan Smith,2001-02,25.0,4,0,12,12,0,0,0,6.0,147.0,12,0,0,0,6.0,82,5.27,57,359,2285,9.4
6362,Dan Smith,2002-03,26.0,5,0,3,3,0,0,0,0.0,33.0,15,0,0,0,6.0,82,5.49,53,331,2294,9.8
6363,Dan Smith,2008-09,32.0,6,0,7,7,0,0,0,1.0,79.0,22,0,0,0,7.0,82,6.05,85,480,2458,10.1
6364,Dan Snyder,2003-04,25.0,4,0,2,2,0,0,0,2.0,14.0,2,0,0,0,2.0,82,5.51,63,376,2272,9.9
6365,Dan Snyder,2004-05,26.0,5,2,11,11,1,1,2,7.0,120.0,13,1,1,2,9.0,82,5.24,53,338,2262,9.5
6366,Dan Snyder,2005-06,27.0,6,14,36,36,10,4,14,41.0,392.0,49,11,5,16,50.0,82,5.31,60,363,2326,9.4
6367,Dan Trebil,1999-00,25.0,4,6,29,29,3,3,6,30.0,,29,3,3,6,30.0,82,5.83,55,336,2444,9.8
6368,Dan Trebil,2000-01,26.0,5,1,21,21,0,1,1,11.0,,50,3,4,7,41.0,82,5.28,57,380,2242,9.6
6369,Dan Trebil,2001-02,27.0,6,0,6,6,0,0,0,1.0,90.0,56,3,4,7,42.0,82,5.27,57,359,2285,9.4
6370,Dan Trebil,2002-03,28.0,7,1,3,3,1,0,1,2.0,38.0,59,4,4,8,44.0,82,5.49,53,331,2294,9.8
6371,Dan Trebil,2003-04,29.0,8,0,26,26,0,0,0,26.0,350.0,85,4,4,8,70.0,82,5.51,63,376,2272,9.9
6372,Dan Vincelette,1990-91,23.0,4,17,69,69,6,11,17,67.0,,69,6,11,17,67.0,80,7.43,89,437,2435,12.2
6373,Dan Vincelette,1991-92,24.0,5,15,66,66,11,4,15,76.0,,135,17,15,32,143.0,80,7.48,85,403,2430,12.3
6374,Dan Vincelette,1992-93,25.0,6,1,13,13,0,1,1,17.0,,148,17,16,33,160.0,80,7.37,76,367,2421,12.2
6375,Dan Vincelette,1993-94,26.0,7,1,16,16,0,1,1,16.0,,164,17,17,34,176.0,80,6.91,71,366,2385,11.6
6376,Dan Vincelette,1994-95,27.0,8,8,29,29,3,5,8,28.0,,193,20,22,42,204.0,80,6.96,77,402,2440,11.4
6377,Dan Woodley,1990-91,23.0,4,2,5,5,2,0,2,3.0,,5,2,0,2,3.0,80,7.43,89,437,2435,12.2
6378,Dana Murzyn,1988-89,22.0,4,26,78,78,3,23,26,80.0,,78,3,23,26,80.0,80,7.94,82,370,2484,12.8
6379,Dana Murzyn,1989-90,23.0,5,28,74,74,9,19,28,135.0,,152,12,42,54,215.0,80,7.34,72,344,2400,12.2
6380,Dana Murzyn,1990-91,24.0,6,18,74,74,7,11,18,107.0,,226,19,53,72,322.0,80,7.43,89,437,2435,12.2
6381,Dana Murzyn,1991-92,25.0,7,22,63,63,3,19,22,91.0,,289,22,72,94,413.0,80,7.48,85,403,2430,12.3
6382,Dana Murzyn,1992-93,26.0,8,20,78,78,7,13,20,97.0,,367,29,85,114,510.0,80,7.37,76,367,2421,12.2
6383,Dana Murzyn,1993-94,27.0,9,3,29,29,1,2,3,40.0,,396,30,87,117,550.0,80,6.91,71,366,2385,11.6
6384,Dana Murzyn,1994-95,28.0,10,14,70,70,3,11,14,99.0,,466,33,98,131,649.0,80,6.96,77,402,2440,11.4
6385,Dana Murzyn,1995-96,29.0,11,16,79,79,5,11,16,82.0,,545,38,109,147,731.0,84,7.25,87,443,2603,11.7
6386,Dana Murzyn,1996-97,30.0,12,20,80,80,6,14,20,79.0,,625,44,123,167,810.0,84,6.48,76,407,2545,10.7
6387,Dana Murzyn,1997-98,31.0,13,8,40,40,0,8,8,29.0,,665,44,131,175,839.0,48,5.97,37,209,1408,10.2
6388,Dana Murzyn,1998-99,32.0,14,12,69,69,2,10,12,68.0,,734,46,141,187,907.0,82,6.29,74,413,2481,10.4
6389,Dana Murzyn,1999-00,33.0,15,8,61,61,1,7,8,70.0,,795,47,148,195,977.0,82,5.83,55,336,2444,9.8
6390,Dana Murzyn,2000-01,34.0,16,7,31,31,5,2,7,29.0,,826,52,150,202,1006.0,82,5.28,57,380,2242,9.6
6391,Dana Murzyn,2001-02,35.0,17,2,12,12,0,2,2,7.0,180.0,838,52,152,204,1013.0,82,5.27,57,359,2285,9.4
6392,Dana Tyrell,2013-14,24.0,4,15,78,78,6,9,15,73.0,940.0,78,6,9,15,73.0,82,5.46,52,291,2492,9.0
6393,Dana Tyrell,2014-15,25.0,5,5,26,26,0,5,5,23.0,273.0,104,6,14,20,96.0,82,5.32,47,271,2439,8.9
6394,Dana Tyrell,2015-16,26.0,6,4,21,21,1,3,4,19.0,217.0,125,7,17,24,115.0,48,5.31,29,160,1399,9.1
6395,Dana Tyrell,2016-17,27.0,7,0,7,7,0,0,0,4.0,65.0,132,7,17,24,119.0,82,5.34,48,269,2463,8.9
6396,Dana Tyrell,2017-18,28.0,8,0,3,3,0,0,0,1.0,21.0,135,7,17,24,120.0,82,5.32,47,251,2453,8.9
6397,Dane Byers,2010-11,24.0,4,0,1,1,0,0,0,0.0,5.0,1,0,0,0,0.0,82,5.44,62,351,2383,9.4
6398,Dane Byers,2012-13,26.0,5,1,5,5,1,0,1,3.0,32.0,6,1,0,1,3.0,82,5.53,56,304,2486,9.1
6399,Dane Byers,2014-15,28.0,6,0,8,8,0,0,0,8.0,65.0,14,1,0,1,11.0,82,5.32,47,271,2439,8.9
6400,Dane Jackson,1996-97,26.0,4,6,12,12,5,1,6,18.0,,12,5,1,6,18.0,84,6.48,76,407,2545,10.7
6401,Dane Jackson,1997-98,27.0,5,1,3,3,1,0,1,6.0,,15,6,1,7,24.0,48,5.97,37,209,1408,10.2
6402,Dane Jackson,1998-99,28.0,6,9,22,22,5,4,9,20.0,,37,11,5,16,44.0,82,6.29,74,413,2481,10.4
6403,Dane Jackson,2000-01,30.0,7,2,8,8,1,1,2,5.0,,45,12,6,18,49.0,82,5.28,57,380,2242,9.6
6404,Danick Martel,2020-21,26.0,4,0,4,4,0,0,0,6.0,41.0,4,0,0,0,6.0,82,5.86,50,250,2620,9.2
6405,Danick Martel,2021-22,27.0,5,2,9,9,0,2,2,16.0,92.0,13,0,2,2,22.0,82,5.96,47,239,2579,9.5
6406,Daniel Alfredsson,1998-99,26.0,4,61,82,82,26,35,61,212.0,,82,26,35,61,212.0,82,6.29,74,413,2481,10.4
6407,Daniel Alfredsson,1999-00,27.0,5,71,76,76,24,47,71,247.0,,158,50,82,132,459.0,82,5.83,55,336,2444,9.8
6408,Daniel Alfredsson,2000-01,28.0,6,45,55,55,17,28,45,149.0,,213,67,110,177,608.0,82,5.28,57,380,2242,9.6
6409,Daniel Alfredsson,2001-02,29.0,7,33,58,58,11,22,33,163.0,1007.0,271,78,132,210,771.0,82,5.27,57,359,2285,9.4
6410,Daniel Alfredsson,2002-03,30.0,8,59,57,57,21,38,59,164.0,1069.0,328,99,170,269,935.0,82,5.49,53,331,2294,9.8
6411,Daniel Alfredsson,2003-04,31.0,9,70,68,68,24,46,70,206.0,1277.0,396,123,216,339,1141.0,82,5.51,63,376,2272,9.9
6412,Daniel Alfredsson,2004-05,32.0,10,71,78,78,37,34,71,243.0,1584.0,474,160,250,410,1384.0,82,5.24,53,338,2262,9.5
6413,Daniel Alfredsson,2005-06,33.0,11,78,78,78,27,51,78,240.0,1524.0,552,187,301,488,1624.0,82,5.31,60,363,2326,9.4
6414,Daniel Alfredsson,2006-07,34.0,12,80,77,77,32,48,80,230.0,1494.0,629,219,349,568,1854.0,82,5.14,57,348,2300,9.2
6415,Daniel Alfredsson,2008-09,36.0,13,103,77,77,43,60,103,249.0,1670.0,706,262,409,671,2103.0,82,6.05,85,480,2458,10.1
6416,Daniel Alfredsson,2009-10,37.0,14,87,77,77,29,58,87,240.0,1661.0,783,291,467,758,2343.0,82,5.76,70,398,2426,9.7
6417,Daniel Alfredsson,2010-11,38.0,15,89,70,70,40,49,89,217.0,1560.0,853,331,516,847,2560.0,82,5.44,62,351,2383,9.4
6418,Daniel Alfredsson,2011-12,39.0,16,74,79,79,24,50,74,204.0,1649.0,932,355,566,921,2764.0,82,5.7,65,341,2477,9.4
6419,Daniel Alfredsson,2012-13,40.0,17,71,70,70,20,51,71,168.0,1377.0,1002,375,617,992,2932.0,82,5.53,56,304,2486,9.1
6420,Daniel Alfredsson,2013-14,41.0,18,31,54,54,14,17,31,96.0,1041.0,1056,389,634,1023,3028.0,82,5.46,52,291,2492,9.0
6421,Daniel Alfredsson,2014-15,42.0,19,59,75,75,27,32,59,191.0,1421.0,1131,416,666,1082,3219.0,82,5.32,47,271,2439,8.9
6422,Daniel Alfredsson,2015-16,43.0,20,26,47,47,10,16,26,101.0,909.0,1178,426,682,1108,3320.0,48,5.31,29,160,1399,9.1
6423,Daniel Alfredsson,2016-17,44.0,21,49,68,68,18,31,49,151.0,1151.0,1246,444,713,1157,3471.0,82,5.34,48,269,2463,8.9
6424,Daniel Bang,2015-16,28.0,4,2,8,8,0,2,2,13.0,103.0,8,0,2,2,13.0,48,5.31,29,160,1399,9.1
6425,Daniel Brickley,2020-21,25.0,4,1,1,1,0,1,1,0.0,11.0,1,0,1,1,0.0,82,5.86,50,250,2620,9.2
6426,Daniel Brickley,2021-22,26.0,5,1,4,4,0,1,1,2.0,51.0,5,0,2,2,2.0,82,5.96,47,239,2579,9.5
6427,Daniel Briere,2000-01,23.0,4,1,5,5,1,0,1,4.0,,5,1,0,1,4.0,82,5.28,57,380,2242,9.6
6428,Daniel Briere,2001-02,24.0,5,22,64,64,8,14,22,90.0,718.0,69,9,14,23,94.0,82,5.27,57,359,2285,9.4
6429,Daniel Briere,2002-03,25.0,6,2,13,13,1,1,2,9.0,100.0,82,10,15,25,103.0,82,5.49,53,331,2294,9.8
6430,Daniel Briere,2003-04,26.0,7,15,30,30,11,4,15,43.0,325.0,112,21,19,40,146.0,82,5.51,63,376,2272,9.9
6431,Daniel Briere,2004-05,27.0,8,60,78,78,32,28,60,149.0,1228.0,190,53,47,100,295.0,82,5.24,53,338,2262,9.5
6432,Daniel Briere,2005-06,28.0,9,58,82,82,24,34,58,181.0,1407.0,272,77,81,158,476.0,82,5.31,60,363,2326,9.4
6433,Daniel Briere,2006-07,29.0,10,65,82,82,28,37,65,194.0,1503.0,354,105,118,223,670.0,82,5.14,57,348,2300,9.2
6434,Daniel Briere,2008-09,31.0,11,58,48,48,25,33,58,147.0,915.0,402,130,151,281,817.0,82,6.05,85,480,2458,10.1
6435,Daniel Briere,2009-10,32.0,12,95,81,81,32,63,95,234.0,1564.0,483,162,214,376,1051.0,82,5.76,70,398,2426,9.7
6436,Daniel Briere,2010-11,33.0,13,72,79,79,31,41,72,182.0,1490.0,562,193,255,448,1233.0,82,5.44,62,351,2383,9.4
6437,Daniel Briere,2011-12,34.0,14,25,29,29,11,14,25,54.0,454.0,591,204,269,473,1287.0,82,5.7,65,341,2477,9.4
6438,Daniel Briere,2012-13,35.0,15,53,75,75,26,27,53,193.0,1244.0,666,230,296,526,1480.0,82,5.53,56,304,2486,9.1
6439,Daniel Briere,2013-14,36.0,16,68,77,77,34,34,68,246.0,1410.0,743,264,330,594,1726.0,82,5.46,52,291,2492,9.0
6440,Daniel Briere,2014-15,37.0,17,49,70,70,16,33,49,174.0,1215.0,813,280,363,643,1900.0,82,5.32,47,271,2439,8.9
6441,Daniel Briere,2015-16,38.0,18,16,34,34,6,10,16,87.0,546.0,847,286,373,659,1987.0,48,5.31,29,160,1399,9.1
6442,Daniel Briere,2016-17,39.0,19,25,69,69,13,12,25,118.0,881.0,916,299,385,684,2105.0,82,5.34,48,269,2463,8.9
6443,Daniel Briere,2017-18,40.0,20,12,57,57,8,4,12,69.0,691.0,973,307,389,696,2174.0,82,5.32,47,251,2453,8.9
6444,Daniel Carcillo,2009-10,25.0,4,7,18,18,4,3,7,32.0,269.0,18,4,3,7,32.0,82,5.76,70,398,2426,9.7
6445,Daniel Carcillo,2010-11,26.0,5,24,57,57,13,11,24,106.0,725.0,75,17,14,31,138.0,82,5.44,62,351,2383,9.4
6446,Daniel Carcillo,2011-12,27.0,6,14,74,74,3,11,14,130.0,852.0,149,20,25,45,268.0,82,5.7,65,341,2477,9.4
6447,Daniel Carcillo,2012-13,28.0,7,22,76,76,12,10,22,105.0,855.0,225,32,35,67,373.0,82,5.53,56,304,2486,9.1
6448,Daniel Carcillo,2013-14,29.0,8,6,57,57,4,2,6,56.0,443.0,282,36,37,73,429.0,82,5.46,52,291,2492,9.0
6449,Daniel Carcillo,2014-15,30.0,9,11,28,28,2,9,11,27.0,319.0,310,38,46,84,456.0,82,5.32,47,271,2439,8.9
6450,Daniel Carcillo,2015-16,31.0,10,3,23,23,2,1,3,23.0,207.0,333,40,47,87,479.0,48,5.31,29,160,1399,9.1
6451,Daniel Carcillo,2016-17,32.0,11,5,57,57,4,1,5,44.0,529.0,390,44,48,92,523.0,82,5.34,48,269,2463,8.9
6452,Daniel Carcillo,2017-18,33.0,12,8,39,39,4,4,8,42.0,319.0,429,48,52,100,565.0,82,5.32,47,251,2453,8.9
6453,Daniel Carr,2018-19,27.0,4,9,23,23,6,3,9,39.0,278.0,23,6,3,9,39.0,82,5.34,48,255,2438,9.0
6454,Daniel Carr,2019-20,28.0,5,9,33,33,2,7,9,44.0,338.0,56,8,10,18,83.0,82,5.45,47,245,2478,9.0
6455,Daniel Carr,2020-21,29.0,6,16,38,38,6,10,16,52.0,461.0,94,14,20,34,135.0,82,5.86,50,250,2620,9.2
6456,Daniel Carr,2021-22,30.0,7,1,6,6,1,0,1,11.0,59.0,100,15,20,35,146.0,82,5.96,47,239,2579,9.5
6457,Daniel Carr,2022-23,31.0,8,1,11,11,1,0,1,14.0,114.0,111,16,20,36,160.0,70,5.96,42,208,2192,9.5
6458,Daniel Catenacci,2018-19,25.0,4,0,11,11,0,0,0,7.0,96.0,11,0,0,0,7.0,82,5.34,48,255,2438,9.0
6459,Daniel Catenacci,2020-21,27.0,5,0,1,1,0,0,0,1.0,11.0,12,0,0,0,8.0,82,5.86,50,250,2620,9.2
6460,Daniel Corso,2003-04,25.0,4,13,28,28,10,3,13,42.0,390.0,28,10,3,13,42.0,82,5.51,63,376,2272,9.9
6461,Daniel Corso,2004-05,26.0,5,11,41,41,4,7,11,25.0,460.0,69,14,10,24,67.0,82,5.24,53,338,2262,9.5
6462,Daniel Corso,2005-06,27.0,6,0,1,1,0,0,0,0.0,8.0,70,14,10,24,67.0,82,5.31,60,363,2326,9.4
6463,Daniel Corso,2006-07,28.0,7,1,7,7,0,1,1,2.0,91.0,77,14,11,25,69.0,82,5.14,57,348,2300,9.2
6464,Daniel Dore,1992-93,22.0,4,5,16,16,2,3,5,5.0,,16,2,3,5,5.0,80,7.37,76,367,2421,12.2
6465,Daniel Dore,1993-94,23.0,5,0,1,1,0,0,0,0.0,,17,2,3,5,5.0,80,6.91,71,366,2385,11.6
6466,Daniel Gauthier,1997-98,27.0,4,0,5,5,0,0,0,4.0,,5,0,0,0,4.0,48,5.97,37,209,1408,10.2
6467,Daniel Goneau,1999-00,24.0,4,13,41,41,10,3,13,44.0,,41,10,3,13,44.0,82,5.83,55,336,2444,9.8
6468,Daniel Goneau,2000-01,25.0,5,2,11,11,2,0,2,13.0,,52,12,3,15,57.0,82,5.28,57,380,2242,9.6
6469,Daniel Goneau,2002-03,27.0,6,0,1,1,0,0,0,3.0,14.0,53,12,3,15,60.0,82,5.49,53,331,2294,9.8
6470,Daniel Guerard,1997-98,23.0,4,0,2,2,0,0,0,0.0,,2,0,0,0,0.0,48,5.97,37,209,1408,10.2
6471,Daniel Lacroix,1996-97,27.0,4,0,4,4,0,0,0,0.0,,4,0,0,0,0.0,84,6.48,76,407,2545,10.7
6472,Daniel Lacroix,1997-98,28.0,5,1,24,24,1,0,1,14.0,,28,1,0,1,14.0,48,5.97,37,209,1408,10.2
6473,Daniel Lacroix,1998-99,29.0,6,4,25,25,2,2,4,14.0,,53,3,2,5,28.0,82,6.29,74,413,2481,10.4
6474,Daniel Lacroix,1999-00,30.0,7,8,74,74,7,1,8,54.0,,127,10,3,13,82.0,82,5.83,55,336,2444,9.8
6475,Daniel Lacroix,2000-01,31.0,8,5,56,56,1,4,5,28.0,,183,11,7,18,110.0,82,5.28,57,380,2242,9.6
6476,Daniel Lacroix,2001-02,32.0,9,0,4,4,0,0,0,5.0,25.0,187,11,7,18,115.0,82,5.27,57,359,2285,9.4
6477,Daniel Lacroix,2002-03,33.0,10,0,1,1,0,0,0,0.0,11.0,188,11,7,18,115.0,82,5.49,53,331,2294,9.8
6478,Daniel Laperriere,1995-96,26.0,4,1,5,5,0,1,1,7.0,,5,0,1,1,7.0,84,7.25,87,443,2603,11.7
6479,Daniel Laperriere,1996-97,27.0,5,4,20,20,1,3,4,20.0,,25,1,4,5,27.0,84,6.48,76,407,2545,10.7
6480,Daniel Laperriere,1997-98,28.0,6,2,17,17,1,1,2,18.0,,42,2,5,7,45.0,48,5.97,37,209,1408,10.2
6481,Daniel Laperriere,1998-99,29.0,7,0,6,6,0,0,0,12.0,,48,2,5,7,57.0,82,6.29,74,413,2481,10.4
6482,Daniel Marois,1991-92,23.0,4,54,76,76,31,23,54,146.0,,76,31,23,54,146.0,80,7.48,85,403,2430,12.3
6483,Daniel Marois,1992-93,24.0,5,76,68,68,39,37,76,183.0,,144,70,60,130,329.0,80,7.37,76,367,2421,12.2
6484,Daniel Marois,1993-94,25.0,6,30,78,78,21,9,30,152.0,,222,91,69,160,481.0,80,6.91,71,366,2385,11.6
6485,Daniel Marois,1994-95,26.0,7,33,75,75,17,16,33,159.0,,297,108,85,193,640.0,80,6.96,77,402,2440,11.4
6486,Daniel Marois,1995-96,27.0,8,7,28,28,2,5,7,41.0,,325,110,90,200,681.0,84,7.25,87,443,2603,11.7
6487,Daniel Marois,1996-97,28.0,9,10,22,22,7,3,10,32.0,,347,117,93,210,713.0,84,6.48,76,407,2545,10.7
6488,Daniel Marois,1998-99,30.0,10,0,3,3,0,0,0,1.0,,350,117,93,210,714.0,82,6.29,74,413,2481,10.4
6489,Daniel Paille,2008-09,24.0,4,3,14,14,1,2,3,15.0,145.0,14,1,2,3,15.0,82,6.05,85,480,2458,10.1
6490,Daniel Paille,2009-10,25.0,5,11,29,29,3,8,11,45.0,371.0,43,4,10,14,60.0,82,5.76,70,398,2426,9.7
6491,Daniel Paille,2010-11,26.0,6,35,77,77,19,16,35,110.0,1022.0,120,23,26,49,170.0,82,5.44,62,351,2383,9.4
6492,Daniel Paille,2011-12,27.0,7,27,73,73,12,15,27,80.0,869.0,193,35,41,76,250.0,82,5.7,65,341,2477,9.4
6493,Daniel Paille,2012-13,28.0,8,20,76,76,10,10,20,120.0,1043.0,269,45,51,96,370.0,82,5.53,56,304,2486,9.1
6494,Daniel Paille,2013-14,29.0,9,13,43,43,6,7,13,48.0,486.0,312,51,58,109,418.0,82,5.46,52,291,2492,9.0
6495,Daniel Paille,2014-15,30.0,10,15,69,69,9,6,15,86.0,793.0,381,60,64,124,504.0,82,5.32,47,271,2439,8.9
6496,Daniel Paille,2015-16,31.0,11,17,46,46,10,7,17,70.0,583.0,427,70,71,141,574.0,48,5.31,29,160,1399,9.1
6497,Daniel Paille,2016-17,32.0,12,18,72,72,9,9,18,71.0,789.0,499,79,80,159,645.0,82,5.34,48,269,2463,8.9
6498,Daniel Paille,2017-18,33.0,13,13,71,71,6,7,13,66.0,817.0,570,85,87,172,711.0,82,5.32,47,251,2453,8.9
6499,Daniel Paille,2018-19,34.0,14,0,12,12,0,0,0,11.0,137.0,582,85,87,172,722.0,82,5.34,48,255,2438,9.0
6500,Daniel Poudrier,1988-89,24.0,4,6,13,13,1,5,6,6.0,,13,1,5,6,6.0,80,7.94,82,370,2484,12.8
6501,Daniel Poudrier,1989-90,25.0,5,0,6,6,0,0,0,2.0,,19,1,5,6,8.0,80,7.34,72,344,2400,12.2
6502,Daniel Poudrier,1990-91,26.0,6,0,6,6,0,0,0,0.0,,25,1,5,6,8.0,80,7.43,89,437,2435,12.2
6503,Daniel Poulin,1984-85,27.0,4,2,3,3,1,1,2,8.0,,3,1,1,2,8.0,80,8.03,73,320,2489,12.9
6504,Daniel Sedin,2003-04,23.0,4,34,75,75,20,14,34,127.0,975.0,75,20,14,34,127.0,82,5.51,63,376,2272,9.9
6505,Daniel Sedin,2004-05,24.0,5,32,79,79,9,23,32,117.0,977.0,154,29,37,66,244.0,82,5.24,53,338,2262,9.5
6506,Daniel Sedin,2005-06,25.0,6,31,79,79,14,17,31,134.0,983.0,233,43,54,97,378.0,82,5.31,60,363,2326,9.4
6507,Daniel Sedin,2006-07,26.0,7,54,82,82,18,36,54,153.0,1111.0,315,61,90,151,531.0,82,5.14,57,348,2300,9.2
6508,Daniel Sedin,2008-09,28.0,8,71,82,82,22,49,71,204.0,1366.0,397,83,139,222,735.0,82,6.05,85,480,2458,10.1
6509,Daniel Sedin,2009-10,29.0,9,84,81,81,36,48,84,236.0,1463.0,478,119,187,306,971.0,82,5.76,70,398,2426,9.7
6510,Daniel Sedin,2010-11,30.0,10,74,82,82,29,45,74,247.0,1562.0,560,148,232,380,1218.0,82,5.44,62,351,2383,9.4
6511,Daniel Sedin,2011-12,31.0,11,82,82,82,31,51,82,285.0,1541.0,642,179,283,462,1503.0,82,5.7,65,341,2477,9.4
6512,Daniel Sedin,2012-13,32.0,12,85,63,63,29,56,85,225.0,1206.0,705,208,339,547,1728.0,82,5.53,56,304,2486,9.1
6513,Daniel Sedin,2013-14,33.0,13,104,82,82,41,63,104,266.0,1521.0,787,249,402,651,1994.0,82,5.46,52,291,2492,9.0
6514,Daniel Sedin,2014-15,34.0,14,67,72,72,30,37,67,229.0,1355.0,859,279,439,718,2223.0,82,5.32,47,271,2439,8.9
6515,Daniel Sedin,2015-16,35.0,15,40,47,47,12,28,40,138.0,894.0,906,291,467,758,2361.0,48,5.31,29,160,1399,9.1
6516,Daniel Sedin,2016-17,36.0,16,47,73,73,16,31,47,224.0,1504.0,979,307,498,805,2585.0,82,5.34,48,269,2463,8.9
6517,Daniel Sedin,2017-18,37.0,17,76,82,82,20,56,76,226.0,1505.0,1061,327,554,881,2811.0,82,5.32,47,251,2453,8.9
6518,Daniel Sedin,2018-19,38.0,18,61,82,82,28,33,61,258.0,1503.0,1143,355,587,942,3069.0,82,5.34,48,255,2438,9.0
6519,Daniel Sedin,2019-20,39.0,19,44,82,82,15,29,44,216.0,1508.0,1225,370,616,986,3285.0,82,5.45,47,245,2478,9.0
6520,Daniel Sedin,2020-21,40.0,20,55,81,81,23,32,55,189.0,1237.0,1306,393,648,1041,3474.0,82,5.86,50,250,2620,9.2
6521,Daniel Shank,1992-93,25.0,4,24,57,57,11,13,24,61.0,,57,11,13,24,61.0,80,7.37,76,367,2421,12.2
6522,Daniel Shank,1993-94,26.0,5,1,7,7,0,1,1,4.0,,64,11,14,25,65.0,80,6.91,71,366,2385,11.6
6523,Daniel Shank,1994-95,27.0,6,2,13,13,2,0,2,10.0,,77,13,14,27,75.0,80,6.96,77,402,2440,11.4
6524,Daniel Sprong,2018-19,21.0,4,2,18,18,2,0,2,23.0,157.0,18,2,0,2,23.0,82,5.34,48,255,2438,9.0
6525,Daniel Sprong,2020-21,23.0,5,3,8,8,2,1,3,22.0,112.0,26,4,1,5,45.0,82,5.86,50,250,2620,9.2
6526,Daniel Sprong,2021-22,24.0,6,23,63,63,14,9,23,125.0,753.0,89,18,10,28,170.0,82,5.96,47,239,2579,9.5
6527,Daniel Sprong,2022-23,25.0,7,2,8,8,1,1,2,17.0,113.0,97,19,11,30,187.0,70,5.96,42,208,2192,9.5
6528,Daniel Tjarnqvist,2004-05,28.0,4,18,75,75,2,16,18,68.0,1614.0,75,2,16,18,68.0,82,5.24,53,338,2262,9.5
6529,Daniel Tjarnqvist,2005-06,29.0,5,15,75,75,3,12,15,65.0,1642.0,150,5,28,33,133.0,82,5.31,60,363,2326,9.4
6530,Daniel Tjarnqvist,2006-07,30.0,6,20,68,68,5,15,20,65.0,1515.0,218,10,43,53,198.0,82,5.14,57,348,2300,9.2
6531,Daniel Tjarnqvist,2008-09,32.0,7,18,60,60,3,15,18,54.0,1186.0,278,13,58,71,252.0,82,6.05,85,480,2458,10.1
6532,Daniel Tjarnqvist,2009-10,33.0,8,15,37,37,3,12,15,33.0,840.0,315,16,70,86,285.0,82,5.76,70,398,2426,9.7
6533,Daniel Tjarnqvist,2011-12,35.0,9,4,37,37,2,2,4,19.0,542.0,352,18,72,90,304.0,82,5.7,65,341,2477,9.4
6534,Daniel Tkaczuk,2003-04,24.0,4,11,19,19,4,7,11,34.0,233.0,19,4,7,11,34.0,82,5.51,63,376,2272,9.9
6535,Daniel Winnik,2010-11,25.0,4,26,79,79,11,15,26,122.0,1114.0,79,11,15,26,122.0,82,5.44,62,351,2383,9.4
6536,Daniel Winnik,2011-12,26.0,5,7,49,49,3,4,7,66.0,641.0,128,14,19,33,188.0,82,5.7,65,341,2477,9.4
6537,Daniel Winnik,2012-13,27.0,6,19,74,74,4,15,19,83.0,973.0,202,18,34,52,271.0,82,5.53,56,304,2486,9.1
6538,Daniel Winnik,2013-14,28.0,7,26,80,80,11,15,26,167.0,1324.0,282,29,49,78,438.0,82,5.46,52,291,2492,9.0
6539,Daniel Winnik,2014-15,29.0,8,23,84,84,8,15,23,184.0,1402.0,366,37,64,101,622.0,82,5.32,47,271,2439,8.9
6540,Daniel Winnik,2015-16,30.0,9,19,48,48,6,13,19,95.0,808.0,414,43,77,120,717.0,48,5.31,29,160,1399,9.1
6541,Daniel Winnik,2016-17,31.0,10,30,76,76,6,24,30,115.0,1170.0,490,49,101,150,832.0,82,5.34,48,269,2463,8.9
6542,Daniel Winnik,2017-18,32.0,11,34,79,79,9,25,34,97.0,1315.0,569,58,126,184,929.0,82,5.32,47,251,2453,8.9
6543,Daniel Winnik,2018-19,33.0,12,19,76,76,6,13,19,101.0,1042.0,645,64,139,203,1030.0,82,5.34,48,255,2438,9.0
6544,Daniel Winnik,2019-20,34.0,13,25,72,72,12,13,25,82.0,930.0,717,76,152,228,1112.0,82,5.45,47,245,2478,9.0
6545,Daniel Winnik,2020-21,35.0,14,23,81,81,6,17,23,82.0,1099.0,798,82,169,251,1194.0,82,5.86,50,250,2620,9.2
6546,Daniil Tarasov,2017-18,26.0,4,1,5,5,0,1,1,5.0,38.0,5,0,1,1,5.0,82,5.32,47,251,2453,8.9
6547,Danil Yurtaykin,2022-23,25.0,4,0,4,4,0,0,0,2.0,52.0,4,0,0,0,2.0,70,5.96,42,208,2192,9.5
6548,Danny Biega,2017-18,26.0,4,2,10,10,0,2,2,7.0,161.0,10,0,2,2,7.0,82,5.32,47,251,2453,8.9
6549,Danny Bois,2009-10,26.0,4,0,1,1,0,0,0,1.0,4.0,1,0,0,0,1.0,82,5.76,70,398,2426,9.7
6550,Danny DeKeyser,2015-16,25.0,4,1,11,11,0,1,1,15.0,199.0,11,0,1,1,15.0,48,5.31,29,160,1399,9.1
6551,Danny DeKeyser,2016-17,26.0,5,23,65,65,4,19,23,84.0,1407.0,76,4,20,24,99.0,82,5.34,48,269,2463,8.9
6552,Danny DeKeyser,2017-18,27.0,6,31,80,80,2,29,31,89.0,1674.0,156,6,49,55,188.0,82,5.32,47,251,2453,8.9
6553,Danny DeKeyser,2018-19,28.0,7,20,78,78,8,12,20,72.0,1701.0,234,14,61,75,260.0,82,5.34,48,255,2438,9.0
6554,Danny DeKeyser,2019-20,29.0,8,12,82,82,4,8,12,85.0,1800.0,316,18,69,87,345.0,82,5.45,47,245,2478,9.0
6555,Danny DeKeyser,2020-21,30.0,9,12,65,65,6,6,12,65.0,1321.0,381,24,75,99,410.0,82,5.86,50,250,2620,9.2
6556,Danny DeKeyser,2021-22,31.0,10,20,52,52,5,15,20,59.0,1142.0,433,29,90,119,469.0,82,5.96,47,239,2579,9.5
6557,Danny DeKeyser,2022-23,32.0,11,4,8,8,0,4,4,12.0,176.0,441,29,94,123,481.0,70,5.96,42,208,2192,9.5
6558,Danny Geoffrion,1982-83,25.0,4,6,32,32,0,6,6,19.0,,32,0,6,6,19.0,80,7.03,61,280,2352,12.0
6559,Danny Geoffrion,1983-84,26.0,5,46,78,78,20,26,46,142.0,,110,20,32,52,161.0,80,7.69,77,340,2441,12.6
6560,Danny Geoffrion,1984-85,27.0,6,0,1,1,0,0,0,2.0,,111,20,32,52,163.0,80,8.03,73,320,2489,12.9
6561,Danny Irmen,2012-13,28.0,4,0,2,2,0,0,0,0.0,9.0,2,0,0,0,0.0,82,5.53,56,304,2486,9.1
6562,Danny Markov,2000-01,24.0,4,7,25,25,2,5,7,15.0,,25,2,5,7,15.0,82,5.28,57,380,2242,9.6
6563,Danny Markov,2001-02,25.0,5,12,57,57,4,8,12,34.0,1065.0,82,6,13,19,49.0,82,5.27,57,359,2285,9.4
6564,Danny Markov,2002-03,26.0,6,10,59,59,0,10,10,38.0,1188.0,141,6,23,29,87.0,82,5.49,53,331,2294,9.8
6565,Danny Markov,2003-04,27.0,7,16,59,59,3,13,16,49.0,1123.0,200,9,36,45,136.0,82,5.51,63,376,2272,9.9
6566,Danny Markov,2004-05,28.0,8,36,72,72,6,30,36,103.0,1650.0,272,15,66,81,239.0,82,5.24,53,338,2262,9.5
6567,Danny Markov,2005-06,29.0,9,20,64,64,4,16,20,105.0,1489.0,336,19,82,101,344.0,82,5.31,60,363,2326,9.4
6568,Danny Markov,2006-07,30.0,10,19,78,78,6,13,19,100.0,1764.0,414,25,95,120,444.0,82,5.14,57,348,2300,9.2
6569,Danny Markov,2008-09,32.0,11,11,58,58,0,11,11,59.0,1134.0,472,25,106,131,503.0,82,6.05,85,480,2458,10.1
6570,Danny Markov,2009-10,33.0,12,16,66,66,4,12,16,66.0,1246.0,538,29,118,147,569.0,82,5.76,70,398,2426,9.7
6571,Danny O'Regan,2019-20,26.0,4,1,3,3,1,0,1,5.0,35.0,3,1,0,1,5.0,82,5.45,47,245,2478,9.0
6572,Danny O'Regan,2020-21,27.0,5,4,21,21,0,4,4,17.0,209.0,24,1,4,5,22.0,82,5.86,50,250,2620,9.2
6573,Danny O'Regan,2021-22,28.0,6,0,1,1,0,0,0,2.0,12.0,25,1,4,5,24.0,82,5.96,47,239,2579,9.5
6574,Danny Richmond,2008-09,24.0,4,1,20,20,0,1,1,13.0,226.0,20,0,1,1,13.0,82,6.05,85,480,2458,10.1
6575,Danny Richmond,2009-10,25.0,5,2,22,22,0,2,2,13.0,271.0,42,0,3,3,26.0,82,5.76,70,398,2426,9.7
6576,Danny Richmond,2010-11,26.0,6,0,7,7,0,0,0,2.0,66.0,49,0,3,3,28.0,82,5.44,62,351,2383,9.4
6577,Danny Syvret,2008-09,23.0,4,0,10,10,0,0,0,8.0,123.0,10,0,0,0,8.0,82,6.05,85,480,2458,10.1
6578,Danny Syvret,2009-10,24.0,5,1,16,16,0,1,1,15.0,296.0,26,0,1,1,23.0,82,5.76,70,398,2426,9.7
6579,Danny Syvret,2011-12,26.0,6,0,2,2,0,0,0,0.0,19.0,28,0,1,1,23.0,82,5.7,65,341,2477,9.4
6580,Danny Syvret,2012-13,27.0,7,4,21,21,2,2,4,14.0,262.0,49,2,3,5,37.0,82,5.53,56,304,2486,9.1
6581,Danny Syvret,2013-14,28.0,8,2,10,10,1,1,2,11.0,151.0,59,3,4,7,48.0,82,5.46,52,291,2492,9.0
6582,Dante Fabbro,2021-22,23.0,4,1,4,4,1,0,1,5.0,51.0,4,1,0,1,5.0,82,5.96,47,239,2579,9.5
6583,Dante Fabbro,2022-23,24.0,5,11,64,64,5,6,11,92.0,1218.0,68,6,6,12,97.0,70,5.96,42,208,2192,9.5
6584,Danton Cole,1992-93,26.0,4,2,2,2,1,1,2,2.0,,2,1,1,2,2.0,80,7.37,76,367,2421,12.2
6585,Danton Cole,1993-94,27.0,5,24,66,66,13,11,24,109.0,,68,14,12,26,111.0,80,6.91,71,366,2385,11.6
6586,Danton Cole,1994-95,28.0,6,12,52,52,7,5,12,65.0,,120,21,17,38,176.0,80,6.96,77,402,2440,11.4
6587,Danton Cole,1995-96,29.0,7,27,67,67,12,15,27,100.0,,187,33,32,65,276.0,84,7.25,87,443,2603,11.7
6588,Danton Cole,1996-97,30.0,8,43,81,81,20,23,43,149.0,,268,53,55,108,425.0,84,6.48,76,407,2545,10.7
6589,Danton Cole,1997-98,31.0,9,9,38,38,4,5,9,76.0,,306,57,60,117,501.0,48,5.97,37,209,1408,10.2
6590,Danton Cole,1998-99,32.0,10,1,12,12,1,0,1,6.0,,318,58,60,118,507.0,82,6.29,74,413,2481,10.4
6591,Danton Heinen,2019-20,24.0,4,0,8,8,0,0,0,7.0,106.0,8,0,0,0,7.0,82,5.45,47,245,2478,9.0
6592,Danton Heinen,2020-21,25.0,5,47,77,77,16,31,47,135.0,1157.0,85,16,31,47,142.0,82,5.86,50,250,2620,9.2
6593,Danton Heinen,2021-22,26.0,6,34,77,77,11,23,34,114.0,1076.0,162,27,54,81,256.0,82,5.96,47,239,2579,9.5
6594,Danton Heinen,2022-23,27.0,7,26,67,67,10,16,26,109.0,969.0,229,37,70,107,365.0,70,5.96,42,208,2192,9.5
6595,Dany Heatley,2004-05,24.0,4,67,82,82,26,41,67,202.0,1631.0,82,26,41,67,202.0,82,5.24,53,338,2262,9.5
6596,Dany Heatley,2005-06,25.0,5,89,77,77,41,48,89,252.0,1690.0,159,67,89,156,454.0,82,5.31,60,363,2326,9.4
6597,Dany Heatley,2006-07,26.0,6,25,31,31,13,12,25,83.0,616.0,190,80,101,181,537.0,82,5.14,57,348,2300,9.2
6598,Dany Heatley,2008-09,28.0,7,103,82,82,50,53,103,300.0,1734.0,272,130,154,284,837.0,82,6.05,85,480,2458,10.1
6599,Dany Heatley,2009-10,29.0,8,105,82,82,50,55,105,310.0,1725.0,354,180,209,389,1147.0,82,5.76,70,398,2426,9.7
6600,Dany Heatley,2010-11,30.0,9,82,71,71,41,41,82,224.0,1543.0,425,221,250,471,1371.0,82,5.44,62,351,2383,9.4
6601,Dany Heatley,2011-12,31.0,10,72,82,82,39,33,72,258.0,1649.0,507,260,283,543,1629.0,82,5.7,65,341,2477,9.4
6602,Dany Heatley,2012-13,32.0,11,82,82,82,39,43,82,280.0,1659.0,589,299,326,625,1909.0,82,5.53,56,304,2486,9.1
6603,Dany Heatley,2013-14,33.0,12,64,80,80,26,38,64,217.0,1572.0,669,325,364,689,2126.0,82,5.46,52,291,2492,9.0
6604,Dany Heatley,2014-15,34.0,13,53,82,82,24,29,53,238.0,1717.0,751,349,393,742,2364.0,82,5.32,47,271,2439,8.9
6605,Dany Heatley,2015-16,35.0,14,21,36,36,11,10,21,83.0,667.0,787,360,403,763,2447.0,48,5.31,29,160,1399,9.1
6606,Dany Heatley,2016-17,36.0,15,28,76,76,12,16,28,110.0,1126.0,863,372,419,791,2557.0,82,5.34,48,269,2463,8.9
6607,Dany Heatley,2017-18,37.0,16,0,6,6,0,0,0,8.0,73.0,869,372,419,791,2565.0,82,5.32,47,251,2453,8.9
6608,Darby Hendrickson,1997-98,25.0,4,1,8,8,0,1,1,4.0,,8,0,1,1,4.0,48,5.97,37,209,1408,10.2
6609,Darby Hendrickson,1998-99,26.0,5,17,62,62,7,10,17,73.0,,70,7,11,18,77.0,82,6.29,74,413,2481,10.4
6610,Darby Hendrickson,1999-00,27.0,6,17,64,64,11,6,17,105.0,,134,18,17,35,182.0,82,5.83,55,336,2444,9.8
6611,Darby Hendrickson,2000-01,28.0,7,12,80,80,8,4,12,115.0,,214,26,21,47,297.0,82,5.28,57,380,2242,9.6
6612,Darby Hendrickson,2001-02,29.0,8,9,62,62,4,5,9,70.0,825.0,276,30,26,56,367.0,82,5.27,57,359,2285,9.4
6613,Darby Hendrickson,2002-03,30.0,9,9,40,40,5,4,9,39.0,461.0,316,35,30,65,406.0,82,5.49,53,331,2294,9.8
6614,Darby Hendrickson,2003-04,31.0,10,29,72,72,18,11,29,114.0,1140.0,388,53,41,94,520.0,82,5.51,63,376,2272,9.9
6615,Darby Hendrickson,2004-05,32.0,11,24,68,68,9,15,24,79.0,1137.0,456,62,56,118,599.0,82,5.24,53,338,2262,9.5
6616,Darby Hendrickson,2005-06,33.0,12,6,28,28,1,5,6,34.0,427.0,484,63,61,124,633.0,82,5.31,60,363,2326,9.4
6617,Darby Hendrickson,2006-07,34.0,13,5,34,34,2,3,5,35.0,456.0,518,65,64,129,668.0,82,5.14,57,348,2300,9.2
6618,Darcy Campbell,2009-10,25.0,4,0,1,1,0,0,0,0.0,6.0,1,0,0,0,0.0,82,5.76,70,398,2426,9.7
6619,Darcy Hordichuk,2003-04,23.0,4,0,11,11,0,0,0,6.0,80.0,11,0,0,0,6.0,82,5.51,63,376,2272,9.9
6620,Darcy Hordichuk,2004-05,24.0,5,2,34,34,1,1,2,8.0,207.0,45,1,1,2,14.0,82,5.24,53,338,2262,9.5
6621,Darcy Hordichuk,2005-06,25.0,6,0,28,28,0,0,0,7.0,149.0,73,1,1,2,21.0,82,5.31,60,363,2326,9.4
6622,Darcy Hordichuk,2006-07,26.0,7,4,57,57,3,1,4,27.0,386.0,130,4,2,6,48.0,82,5.14,57,348,2300,9.2
6623,Darcy Hordichuk,2008-09,28.0,8,13,74,74,7,6,13,52.0,455.0,204,11,8,19,100.0,82,6.05,85,480,2458,10.1
6624,Darcy Hordichuk,2009-10,29.0,9,4,53,53,1,3,4,22.0,255.0,257,12,11,23,122.0,82,5.76,70,398,2426,9.7
6625,Darcy Hordichuk,2010-11,30.0,10,3,45,45,1,2,3,18.0,232.0,302,13,13,26,140.0,82,5.44,62,351,2383,9.4
6626,Darcy Hordichuk,2011-12,31.0,11,5,73,73,4,1,5,26.0,404.0,375,17,14,31,166.0,82,5.7,65,341,2477,9.4
6627,Darcy Hordichuk,2012-13,32.0,12,2,56,56,1,1,2,21.0,338.0,431,18,15,33,187.0,82,5.53,56,304,2486,9.1
6628,Darcy Hordichuk,2013-14,33.0,13,5,64,64,1,4,5,32.0,324.0,495,19,19,38,219.0,82,5.46,52,291,2492,9.0
6629,Darcy Hordichuk,2014-15,34.0,14,3,43,43,1,2,3,27.0,187.0,538,20,21,41,246.0,82,5.32,47,271,2439,8.9
6630,Darcy Hordichuk,2015-16,35.0,15,0,4,4,0,0,0,0.0,8.0,542,20,21,41,246.0,48,5.31,29,160,1399,9.1
6631,Darcy Loewen,1992-93,23.0,4,0,4,4,0,0,0,1.0,,4,0,0,0,1.0,80,7.37,76,367,2421,12.2
6632,Darcy Loewen,1993-94,24.0,5,0,6,6,0,0,0,2.0,,10,0,0,0,3.0,80,6.91,71,366,2385,11.6
6633,Darcy Loewen,1994-95,25.0,6,0,2,2,0,0,0,1.0,,12,0,0,0,4.0,80,6.96,77,402,2440,11.4
6634,Darcy Loewen,1995-96,26.0,7,9,79,79,4,5,9,42.0,,91,4,5,9,46.0,84,7.25,87,443,2603,11.7
6635,Darcy Loewen,1996-97,27.0,8,3,44,44,0,3,3,39.0,,135,4,8,12,85.0,84,6.48,76,407,2545,10.7
6636,Darcy Martini,1996-97,28.0,4,0,2,2,0,0,0,0.0,,2,0,0,0,0.0,84,6.48,76,407,2545,10.7
6637,Darcy Tucker,1998-99,23.0,4,0,3,3,0,0,0,1.0,,3,0,0,0,1.0,82,6.29,74,413,2481,10.4
6638,Darcy Tucker,1999-00,24.0,5,20,73,73,7,13,20,62.0,,76,7,13,20,63.0,82,5.83,55,336,2444,9.8
6639,Darcy Tucker,2000-01,25.0,6,20,74,74,7,13,20,63.0,,150,14,26,40,126.0,82,5.28,57,380,2242,9.6
6640,Darcy Tucker,2001-02,26.0,7,43,82,82,21,22,43,178.0,1591.0,232,35,48,83,304.0,82,5.27,57,359,2285,9.4
6641,Darcy Tucker,2002-03,27.0,8,51,77,77,21,30,51,138.0,1449.0,309,56,78,134,442.0,82,5.49,53,331,2294,9.8
6642,Darcy Tucker,2003-04,28.0,9,37,82,82,16,21,37,122.0,1325.0,391,72,99,171,564.0,82,5.51,63,376,2272,9.9
6643,Darcy Tucker,2004-05,29.0,10,59,77,77,24,35,59,124.0,1307.0,468,96,134,230,688.0,82,5.24,53,338,2262,9.5
6644,Darcy Tucker,2005-06,30.0,11,36,77,77,10,26,36,108.0,1182.0,545,106,160,266,796.0,82,5.31,60,363,2326,9.4
6645,Darcy Tucker,2006-07,31.0,12,32,64,64,21,11,32,146.0,1142.0,609,127,171,298,942.0,82,5.14,57,348,2300,9.2
6646,Darcy Tucker,2008-09,33.0,13,61,74,74,28,33,61,189.0,1305.0,683,155,204,359,1131.0,82,6.05,85,480,2458,10.1
6647,Darcy Tucker,2009-10,34.0,14,43,56,56,24,19,43,143.0,996.0,739,179,223,402,1274.0,82,5.76,70,398,2426,9.7
6648,Darcy Tucker,2010-11,35.0,15,34,74,74,18,16,34,152.0,1216.0,813,197,239,436,1426.0,82,5.44,62,351,2383,9.4
6649,Darcy Tucker,2011-12,36.0,16,16,63,63,8,8,16,94.0,889.0,876,205,247,452,1520.0,82,5.7,65,341,2477,9.4
6650,Darcy Tucker,2012-13,37.0,17,24,71,71,10,14,24,73.0,860.0,947,215,261,476,1593.0,82,5.53,56,304,2486,9.1
6651,Darcy Verot,2006-07,30.0,4,2,37,37,0,2,2,11.0,326.0,37,0,2,2,11.0,82,5.14,57,348,2300,9.2
6652,Darin Kimble,1991-92,23.0,4,4,26,26,3,1,4,21.0,,26,3,1,4,21.0,80,7.48,85,403,2430,12.3
6653,Darin Kimble,1992-93,24.0,5,10,44,44,5,5,10,40.0,,70,8,6,14,61.0,80,7.37,76,367,2421,12.2
6654,Darin Kimble,1993-94,25.0,6,9,61,61,3,6,9,28.0,,131,11,12,23,89.0,80,6.91,71,366,2385,11.6
6655,Darin Kimble,1994-95,26.0,7,4,46,46,1,3,4,12.0,,177,12,15,27,101.0,80,6.96,77,402,2440,11.4
6656,Darin Kimble,1995-96,27.0,8,10,55,55,7,3,10,20.0,,232,19,18,37,121.0,84,7.25,87,443,2603,11.7
6657,Darin Kimble,1996-97,28.0,9,6,65,65,4,2,6,17.0,,297,23,20,43,138.0,84,6.48,76,407,2545,10.7
6658,Darin Kimble,1997-98,29.0,10,0,14,14,0,0,0,2.0,,311,23,20,43,140.0,48,5.97,37,209,1408,10.2
6659,Darin Sceviour,1989-90,24.0,4,0,1,1,0,0,0,1.0,,1,0,0,0,1.0,80,7.34,72,344,2400,12.2
6660,Darius Kasparaitis,1995-96,23.0,4,21,79,79,4,17,21,92.0,,79,4,17,21,92.0,84,7.25,87,443,2603,11.7
6661,Darius Kasparaitis,1996-97,24.0,5,11,76,76,1,10,11,81.0,,155,5,27,32,173.0,84,6.48,76,407,2545,10.7
6662,Darius Kasparaitis,1997-98,25.0,6,1,13,13,0,1,1,8.0,,168,5,28,33,181.0,48,5.97,37,209,1408,10.2
6663,Darius Kasparaitis,1998-99,26.0,7,8,46,46,1,7,8,34.0,,214,6,35,41,215.0,82,6.29,74,413,2481,10.4
6664,Darius Kasparaitis,1999-00,27.0,8,23,75,75,2,21,23,58.0,,289,8,56,64,273.0,82,5.83,55,336,2444,9.8
6665,Darius Kasparaitis,2000-01,28.0,9,12,81,81,4,8,12,71.0,,370,12,64,76,344.0,82,5.28,57,380,2242,9.6
6666,Darius Kasparaitis,2001-02,29.0,10,5,48,48,1,4,5,32.0,769.0,418,13,68,81,376.0,82,5.27,57,359,2285,9.4
6667,Darius Kasparaitis,2002-03,30.0,11,15,73,73,3,12,15,76.0,1322.0,491,16,80,96,452.0,82,5.49,53,331,2294,9.8
6668,Darius Kasparaitis,2003-04,31.0,12,19,77,77,3,16,19,81.0,1481.0,568,19,96,115,533.0,82,5.51,63,376,2272,9.9
6669,Darius Kasparaitis,2004-05,32.0,13,14,80,80,2,12,14,81.0,1634.0,648,21,108,129,614.0,82,5.24,53,338,2262,9.5
6670,Darius Kasparaitis,2005-06,33.0,14,14,80,80,3,11,14,84.0,1511.0,728,24,119,143,698.0,82,5.31,60,363,2326,9.4
6671,Darius Kasparaitis,2006-07,34.0,15,10,44,44,1,9,10,29.0,721.0,772,25,128,153,727.0,82,5.14,57,348,2300,9.2
6672,Darius Kasparaitis,2008-09,36.0,16,6,67,67,0,6,6,48.0,1171.0,839,25,134,159,775.0,82,6.05,85,480,2458,10.1
6673,Darius Kasparaitis,2009-10,37.0,17,4,24,24,2,2,4,9.0,357.0,863,27,136,163,784.0,82,5.76,70,398,2426,9.7
6674,Darnell Nurse,2017-18,22.0,4,0,2,2,0,0,0,2.0,34.0,2,0,0,0,2.0,82,5.32,47,251,2453,8.9
6675,Darnell Nurse,2018-19,23.0,5,10,69,69,3,7,10,120.0,1396.0,71,3,7,10,122.0,82,5.34,48,255,2438,9.0
6676,Darnell Nurse,2019-20,24.0,6,11,44,44,5,6,11,85.0,749.0,115,8,13,21,207.0,82,5.45,47,245,2478,9.0
6677,Darnell Nurse,2020-21,25.0,7,26,82,82,6,20,26,194.0,1824.0,197,14,33,47,401.0,82,5.86,50,250,2620,9.2
6678,Darnell Nurse,2021-22,26.0,8,41,82,82,10,31,41,196.0,1953.0,279,24,64,88,597.0,82,5.96,47,239,2579,9.5
6679,Darnell Nurse,2022-23,27.0,9,33,71,71,5,28,33,170.0,1665.0,350,29,92,121,767.0,70,5.96,42,208,2192,9.5
6680,Darrel Anholt,1986-87,24.0,4,0,1,1,0,0,0,0.0,,1,0,0,0,0.0,80,7.89,74,336,2448,12.9
6681,Darrel Scoville,2002-03,27.0,4,0,6,6,0,0,0,1.0,56.0,6,0,0,0,1.0,82,5.49,53,331,2294,9.8
6682,Darrel Scoville,2005-06,30.0,5,0,2,2,0,0,0,1.0,29.0,8,0,0,0,2.0,82,5.31,60,363,2326,9.4
6683,Darrel Scoville,2006-07,31.0,6,1,8,8,0,1,1,5.0,154.0,16,0,1,1,7.0,82,5.14,57,348,2300,9.2
6684,Darren Archibald,2016-17,26.0,4,3,16,16,1,2,3,11.0,125.0,16,1,2,3,11.0,82,5.34,48,269,2463,8.9
6685,Darren Archibald,2020-21,30.0,5,9,27,27,4,5,9,28.0,401.0,43,5,7,12,39.0,82,5.86,50,250,2620,9.2
6686,Darren Archibald,2021-22,31.0,6,2,12,12,1,1,2,10.0,89.0,55,6,8,14,49.0,82,5.96,47,239,2579,9.5
6687,Darren Banks,1995-96,29.0,4,3,16,16,2,1,3,15.0,,16,2,1,3,15.0,84,7.25,87,443,2603,11.7
6688,Darren Banks,1996-97,30.0,5,1,4,4,0,1,1,3.0,,20,2,2,4,18.0,84,6.48,76,407,2545,10.7
6689,Darren Boyko,1991-92,28.0,4,0,1,1,0,0,0,0.0,,1,0,0,0,0.0,80,7.48,85,403,2430,12.3
6690,Darren Dietz,2018-19,25.0,4,5,13,13,1,4,5,13.0,189.0,13,1,4,5,13.0,82,5.34,48,255,2438,9.0
6691,Darren Haydar,2005-06,26.0,4,0,2,2,0,0,0,1.0,18.0,2,0,0,0,1.0,82,5.31,60,363,2326,9.4
6692,Darren Haydar,2009-10,30.0,5,0,4,4,0,0,0,4.0,32.0,6,0,0,0,5.0,82,5.76,70,398,2426,9.7
6693,Darren Haydar,2010-11,31.0,6,8,16,16,1,7,8,14.0,188.0,22,1,7,8,19.0,82,5.44,62,351,2383,9.4
6694,Darren Haydar,2012-13,33.0,7,0,1,1,0,0,0,2.0,5.0,23,1,7,8,21.0,82,5.53,56,304,2486,9.1
6695,Darren Helm,2010-11,24.0,4,0,7,7,0,0,0,7.0,49.0,7,0,0,0,7.0,82,5.44,62,351,2383,9.4
6696,Darren Helm,2011-12,25.0,5,1,16,16,0,1,1,29.0,199.0,23,0,1,1,36.0,82,5.7,65,341,2477,9.4
6697,Darren Helm,2012-13,26.0,6,24,75,75,11,13,24,165.0,1087.0,98,11,14,25,201.0,82,5.53,56,304,2486,9.1
6698,Darren Helm,2013-14,27.0,7,32,82,82,12,20,32,177.0,1091.0,180,23,34,57,378.0,82,5.46,52,291,2492,9.0
6699,Darren Helm,2014-15,28.0,8,26,68,68,9,17,26,124.0,987.0,248,32,51,83,502.0,82,5.32,47,271,2439,8.9
6700,Darren Helm,2015-16,29.0,9,0,1,1,0,0,0,1.0,12.0,249,32,51,83,503.0,48,5.31,29,160,1399,9.1
6701,Darren Helm,2016-17,30.0,10,20,42,42,12,8,20,83.0,637.0,291,44,59,103,586.0,82,5.34,48,269,2463,8.9
6702,Darren Helm,2017-18,31.0,11,33,75,75,15,18,33,160.0,1188.0,366,59,77,136,746.0,82,5.32,47,251,2453,8.9
6703,Darren Helm,2018-19,32.0,12,26,77,77,13,13,26,165.0,1160.0,443,72,90,162,911.0,82,5.34,48,255,2438,9.0
6704,Darren Helm,2019-20,33.0,13,17,50,50,8,9,17,98.0,768.0,493,80,99,179,1009.0,82,5.45,47,245,2478,9.0
6705,Darren Helm,2020-21,34.0,14,31,75,75,13,18,31,141.0,1167.0,568,93,117,210,1150.0,82,5.86,50,250,2620,9.2
6706,Darren Helm,2021-22,35.0,15,17,61,61,7,10,17,107.0,889.0,629,100,127,227,1257.0,82,5.96,47,239,2579,9.5
6707,Darren Helm,2022-23,36.0,16,16,68,68,9,7,16,102.0,934.0,697,109,134,243,1359.0,70,5.96,42,208,2192,9.5
6708,Darren Langdon,1997-98,27.0,4,2,18,18,1,1,2,6.0,,18,1,1,2,6.0,48,5.97,37,209,1408,10.2
6709,Darren Langdon,1998-99,28.0,5,11,64,64,7,4,11,29.0,,82,8,5,13,35.0,82,6.29,74,413,2481,10.4
6710,Darren Langdon,1999-00,29.0,6,9,60,60,3,6,9,24.0,,142,11,11,22,59.0,82,5.83,55,336,2444,9.8
6711,Darren Langdon,2000-01,30.0,7,6,70,70,3,3,6,15.0,,212,14,14,28,74.0,82,5.28,57,380,2242,9.6
6712,Darren Langdon,2001-02,31.0,8,0,44,44,0,0,0,8.0,156.0,256,14,14,28,82.0,82,5.27,57,359,2285,9.4
6713,Darren Langdon,2002-03,32.0,9,1,21,21,0,1,1,13.0,118.0,277,14,15,29,95.0,82,5.49,53,331,2294,9.8
6714,Darren Langdon,2003-04,33.0,10,2,54,54,0,2,2,6.0,181.0,331,14,17,31,101.0,82,5.51,63,376,2272,9.9
6715,Darren Langdon,2004-05,34.0,11,3,58,58,2,1,3,12.0,242.0,389,16,18,34,113.0,82,5.24,53,338,2262,9.5
6716,Darren Langdon,2005-06,35.0,12,1,54,54,0,1,1,19.0,269.0,443,16,19,35,132.0,82,5.31,60,363,2326,9.4
6717,Darren Langdon,2006-07,36.0,13,3,64,64,0,3,3,22.0,401.0,507,16,22,38,154.0,82,5.14,57,348,2300,9.2
6718,Darren Langdon,2008-09,38.0,14,1,14,14,0,1,1,2.0,46.0,521,16,23,39,156.0,82,6.05,85,480,2458,10.1
6719,Darren Lowe,1986-87,26.0,4,3,8,8,1,2,3,14.0,,8,1,2,3,14.0,80,7.89,74,336,2448,12.9
6720,Darren McCarty,1996-97,24.0,4,26,67,67,9,17,26,81.0,,67,9,17,26,81.0,84,6.48,76,407,2545,10.7
6721,Darren McCarty,1997-98,25.0,5,13,31,31,5,8,13,27.0,,98,14,25,39,108.0,48,5.97,37,209,1408,10.2
6722,Darren McCarty,1998-99,26.0,6,29,63,63,15,14,29,102.0,,161,29,39,68,210.0,82,6.29,74,413,2481,10.4
6723,Darren McCarty,1999-00,27.0,7,49,68,68,19,30,49,171.0,,229,48,69,117,381.0,82,5.83,55,336,2444,9.8
6724,Darren McCarty,2000-01,28.0,8,37,71,71,15,22,37,166.0,,300,63,91,154,547.0,82,5.28,57,380,2242,9.6
6725,Darren McCarty,2001-02,29.0,9,40,69,69,14,26,40,140.0,1178.0,369,77,117,194,687.0,82,5.27,57,359,2285,9.4
6726,Darren McCarty,2002-03,30.0,10,12,24,24,6,6,12,40.0,328.0,393,83,123,206,727.0,82,5.49,53,331,2294,9.8
6727,Darren McCarty,2003-04,31.0,11,22,72,72,12,10,22,118.0,968.0,465,95,133,228,845.0,82,5.51,63,376,2272,9.9
6728,Darren McCarty,2004-05,32.0,12,12,62,62,5,7,12,74.0,731.0,527,100,140,240,919.0,82,5.24,53,338,2262,9.5
6729,Darren McCarty,2005-06,33.0,13,22,73,73,13,9,22,129.0,970.0,600,113,149,262,1048.0,82,5.31,60,363,2326,9.4
6730,Darren McCarty,2006-07,34.0,14,11,43,43,6,5,11,61.0,530.0,643,119,154,273,1109.0,82,5.14,57,348,2300,9.2
6731,Darren McCarty,2008-09,36.0,15,13,67,67,7,6,13,67.0,784.0,710,126,160,286,1176.0,82,6.05,85,480,2458,10.1
6732,Darren McCarty,2009-10,37.0,16,0,32,32,0,0,0,15.0,173.0,742,126,160,286,1191.0,82,5.76,70,398,2426,9.7
6733,Darren McCarty,2010-11,38.0,17,1,3,3,0,1,1,3.0,23.0,745,126,161,287,1194.0,82,5.44,62,351,2383,9.4
6734,Darren McCarty,2011-12,39.0,18,1,13,13,1,0,1,6.0,69.0,758,127,161,288,1200.0,82,5.7,65,341,2477,9.4
6735,Darren Reid,2008-09,25.0,4,1,7,7,0,1,1,3.0,40.0,7,0,1,1,3.0,82,6.05,85,480,2458,10.1
6736,Darren Reid,2009-10,26.0,5,0,14,14,0,0,0,8.0,114.0,21,0,1,1,11.0,82,5.76,70,398,2426,9.7
6737,Darren Rumble,1993-94,25.0,4,1,3,3,1,0,1,2.0,,3,1,0,1,2.0,80,6.91,71,366,2385,11.6
6738,Darren Rumble,1995-96,27.0,5,16,69,69,3,13,16,92.0,,72,4,13,17,94.0,84,7.25,87,443,2603,11.7
6739,Darren Rumble,1996-97,28.0,6,15,70,70,6,9,15,95.0,,142,10,22,32,189.0,84,6.48,76,407,2545,10.7
6740,Darren Rumble,1998-99,30.0,7,0,5,5,0,0,0,7.0,,147,10,22,32,196.0,82,6.29,74,413,2481,10.4
6741,Darren Rumble,1999-00,31.0,8,0,10,10,0,0,0,9.0,,157,10,22,32,205.0,82,5.83,55,336,2444,9.8
6742,Darren Rumble,2003-04,35.0,9,4,12,12,0,4,4,11.0,219.0,169,10,26,36,216.0,82,5.51,63,376,2272,9.9
6743,Darren Rumble,2005-06,37.0,10,0,19,19,0,0,0,10.0,211.0,188,10,26,36,226.0,82,5.31,60,363,2326,9.4
6744,Darren Rumble,2006-07,38.0,11,0,5,5,0,0,0,5.0,58.0,193,10,26,36,231.0,82,5.14,57,348,2300,9.2
6745,Darren Turcotte,1991-92,23.0,4,10,20,20,7,3,10,49.0,,20,7,3,10,49.0,80,7.48,85,403,2430,12.3
6746,Darren Turcotte,1992-93,24.0,5,66,76,76,32,34,66,205.0,,96,39,37,76,254.0,80,7.37,76,367,2421,12.2
6747,Darren Turcotte,1993-94,25.0,6,67,74,74,26,41,67,212.0,,170,65,78,143,466.0,80,6.91,71,366,2385,11.6
6748,Darren Turcotte,1994-95,26.0,7,53,71,71,30,23,53,216.0,,241,95,101,196,682.0,80,6.96,77,402,2440,11.4
6749,Darren Turcotte,1995-96,27.0,8,53,71,71,25,28,53,213.0,,312,120,129,249,895.0,84,7.25,87,443,2603,11.7
6750,Darren Turcotte,1996-97,28.0,9,19,32,32,4,15,19,60.0,,344,124,144,268,955.0,84,6.48,76,407,2545,10.7
6751,Darren Turcotte,1997-98,29.0,10,35,47,47,17,18,35,121.0,,391,141,162,303,1076.0,48,5.97,37,209,1408,10.2
6752,Darren Turcotte,1998-99,30.0,11,43,68,68,22,21,43,167.0,,459,163,183,346,1243.0,82,6.29,74,413,2481,10.4
6753,Darren Turcotte,1999-00,31.0,12,37,65,65,16,21,37,126.0,,524,179,204,383,1369.0,82,5.83,55,336,2444,9.8
6754,Darren Turcotte,2000-01,32.0,13,18,62,62,12,6,18,75.0,,586,191,210,401,1444.0,82,5.28,57,380,2242,9.6
6755,Darren Turcotte,2001-02,33.0,14,9,40,40,4,5,9,73.0,634.0,626,195,215,410,1517.0,82,5.27,57,359,2285,9.4
6756,Darren Turcotte,2002-03,34.0,15,1,9,9,0,1,1,13.0,83.0,635,195,216,411,1530.0,82,5.49,53,331,2294,9.8
6757,Darren Van Impe,1997-98,24.0,4,1,1,1,0,1,1,0.0,,1,0,1,1,0.0,48,5.97,37,209,1408,10.2
6758,Darren Van Impe,1998-99,25.0,5,3,16,16,1,2,3,13.0,,17,1,3,4,13.0,82,6.29,74,413,2481,10.4
6759,Darren Van Impe,1999-00,26.0,6,23,74,74,4,19,23,107.0,,91,5,22,27,120.0,82,5.83,55,336,2444,9.8
6760,Darren Van Impe,2000-01,27.0,7,14,69,69,3,11,14,71.0,,160,8,33,41,191.0,82,5.28,57,380,2242,9.6
6761,Darren Van Impe,2001-02,28.0,8,20,60,60,5,15,20,92.0,1074.0,220,13,48,61,283.0,82,5.27,57,359,2285,9.4
6762,Darren Van Impe,2002-03,29.0,9,28,79,79,5,23,28,97.0,1541.0,299,18,71,89,380.0,82,5.49,53,331,2294,9.8
6763,Darren Van Impe,2003-04,30.0,10,13,31,31,3,10,13,40.0,626.0,330,21,81,102,420.0,82,5.51,63,376,2272,9.9
6764,Darren Van Impe,2004-05,31.0,11,11,67,67,3,8,11,60.0,1237.0,397,24,89,113,480.0,82,5.24,53,338,2262,9.5
6765,Darren Van Impe,2005-06,32.0,12,2,14,14,1,1,2,11.0,259.0,411,25,90,115,491.0,82,5.31,60,363,2326,9.4
6766,Darren Veitch,1983-84,23.0,4,25,59,59,4,21,25,89.0,,59,4,21,25,89.0,80,7.69,77,340,2441,12.6
6767,Darren Veitch,1984-85,24.0,5,53,67,67,9,44,53,203.0,,126,13,65,78,292.0,80,8.03,73,320,2489,12.9
6768,Darren Veitch,1985-86,25.0,6,8,10,10,0,8,8,26.0,,136,13,73,86,318.0,80,7.73,71,310,2444,12.7
6769,Darren Veitch,1986-87,26.0,7,24,46,46,6,18,24,120.0,,182,19,91,110,438.0,80,7.89,74,336,2448,12.9
6770,Darren Veitch,1987-88,27.0,8,21,75,75,3,18,21,126.0,,257,22,109,131,564.0,80,7.77,71,321,2447,12.7
6771,Darren Veitch,1988-89,28.0,9,17,75,75,3,14,17,104.0,,332,25,123,148,668.0,80,7.94,82,370,2484,12.8
6772,Darren Veitch,1989-90,29.0,10,58,77,77,13,45,58,164.0,,409,38,168,206,832.0,80,7.34,72,344,2400,12.2
6773,Darren Veitch,1990-91,30.0,11,40,63,63,7,33,40,156.0,,472,45,201,246,988.0,80,7.43,89,437,2435,12.2
6774,Darren Veitch,1991-92,31.0,12,10,37,37,3,7,10,69.0,,509,48,208,256,1057.0,80,7.48,85,403,2430,12.3
6775,Darren Veitch,1993-94,33.0,13,1,2,2,0,1,1,2.0,,511,48,209,257,1059.0,80,6.91,71,366,2385,11.6
6776,Darrin Shannon,1991-92,22.0,4,0,3,3,0,0,0,0.0,,3,0,0,0,0.0,80,7.48,85,403,2430,12.3
6777,Darrin Shannon,1992-93,23.0,5,9,17,17,2,7,9,20.0,,20,2,7,9,20.0,80,7.37,76,367,2421,12.2
6778,Darrin Shannon,1993-94,24.0,6,14,34,34,8,6,14,56.0,,54,10,13,23,76.0,80,6.91,71,366,2385,11.6
6779,Darrin Shannon,1994-95,25.0,7,40,69,69,13,27,40,93.0,,123,23,40,63,169.0,80,6.96,77,402,2440,11.4
6780,Darrin Shannon,1995-96,26.0,8,60,84,84,20,40,60,116.0,,207,43,80,123,285.0,84,7.25,87,443,2603,11.7
6781,Darrin Shannon,1996-97,27.0,9,58,77,77,21,37,58,124.0,,284,64,117,181,409.0,84,6.48,76,407,2545,10.7
6782,Darrin Shannon,1997-98,28.0,10,8,19,19,5,3,8,26.0,,303,69,120,189,435.0,48,5.97,37,209,1408,10.2
6783,Darrin Shannon,1998-99,29.0,11,23,63,63,5,18,23,74.0,,366,74,138,212,509.0,82,6.29,74,413,2481,10.4
6784,Darrin Shannon,1999-00,30.0,12,24,82,82,11,13,24,104.0,,448,85,151,236,613.0,82,5.83,55,336,2444,9.8
6785,Darrin Shannon,2000-01,31.0,13,14,58,58,2,12,14,57.0,,506,87,163,250,670.0,82,5.28,57,380,2242,9.6
6786,Darroll Powe,2011-12,26.0,4,11,60,60,6,5,11,72.0,632.0,60,6,5,11,72.0,82,5.7,65,341,2477,9.4
6787,Darroll Powe,2012-13,27.0,5,15,63,63,9,6,15,103.0,761.0,123,15,11,26,175.0,82,5.53,56,304,2486,9.1
6788,Darroll Powe,2013-14,28.0,6,17,81,81,7,10,17,87.0,995.0,204,22,21,43,262.0,82,5.46,52,291,2492,9.0
6789,Darroll Powe,2014-15,29.0,7,13,82,82,6,7,13,109.0,1147.0,286,28,28,56,371.0,82,5.32,47,271,2439,8.9
6790,Darroll Powe,2015-16,30.0,8,0,42,42,0,0,0,23.0,378.0,328,28,28,56,394.0,48,5.31,29,160,1399,9.1
6791,Darroll Powe,2016-17,31.0,9,0,1,1,0,0,0,0.0,9.0,329,28,28,56,394.0,82,5.34,48,269,2463,8.9
6792,Darryl Bootland,2006-07,25.0,4,2,22,22,1,1,2,13.0,134.0,22,1,1,2,13.0,82,5.14,57,348,2300,9.2
6793,Darryl Bootland,2009-10,28.0,5,0,6,6,0,0,0,4.0,25.0,28,1,1,2,17.0,82,5.76,70,398,2426,9.7
6794,Darryl Bootland,2010-11,29.0,6,1,4,4,0,1,1,3.0,19.0,32,1,2,3,20.0,82,5.44,62,351,2383,9.4
6795,Darryl Boyce,2010-11,26.0,4,0,1,1,0,0,0,0.0,3.0,1,0,0,0,0.0,82,5.44,62,351,2383,9.4
6796,Darryl Boyce,2013-14,29.0,5,13,46,46,5,8,13,27.0,524.0,47,5,8,13,27.0,82,5.46,52,291,2492,9.0
6797,Darryl Boyce,2014-15,30.0,6,5,37,37,1,4,5,25.0,369.0,84,6,12,18,52.0,82,5.32,47,271,2439,8.9
6798,Darryl Laplante,2000-01,23.0,4,0,2,2,0,0,0,2.0,,2,0,0,0,2.0,82,5.28,57,380,2242,9.6
6799,Darryl Laplante,2001-02,24.0,5,0,3,3,0,0,0,0.0,6.0,5,0,0,0,2.0,82,5.27,57,359,2285,9.4
6800,Darryl Laplante,2002-03,25.0,6,6,30,30,0,6,6,19.0,287.0,35,0,6,6,21.0,82,5.49,53,331,2294,9.8
6801,Darryl Olsen,1994-95,28.0,4,0,1,1,0,0,0,3.0,,1,0,0,0,3.0,80,6.96,77,402,2440,11.4
6802,Darryl Shannon,1991-92,23.0,4,4,14,14,1,3,4,16.0,,14,1,3,4,16.0,80,7.48,85,403,2430,12.3
6803,Darryl Shannon,1992-93,24.0,5,1,10,10,0,1,1,16.0,,24,1,4,5,32.0,80,7.37,76,367,2421,12.2
6804,Darryl Shannon,1993-94,25.0,6,1,10,10,0,1,1,3.0,,34,1,5,6,35.0,80,6.91,71,366,2385,11.6
6805,Darryl Shannon,1994-95,26.0,7,10,48,48,2,8,10,50.0,,82,3,13,16,85.0,80,6.96,77,402,2440,11.4
6806,Darryl Shannon,1995-96,27.0,8,0,16,16,0,0,0,10.0,,98,3,13,16,95.0,84,7.25,87,443,2603,11.7
6807,Darryl Shannon,1996-97,28.0,9,4,20,20,0,4,4,14.0,,118,3,17,20,109.0,84,6.48,76,407,2545,10.7
6808,Darryl Shannon,1997-98,29.0,10,14,40,40,5,9,14,42.0,,158,8,26,34,151.0,48,5.97,37,209,1408,10.2
6809,Darryl Shannon,1998-99,30.0,11,17,74,74,4,13,17,59.0,,232,12,39,51,210.0,82,6.29,74,413,2481,10.4
6810,Darryl Shannon,1999-00,31.0,12,23,82,82,4,19,23,94.0,,314,16,58,74,304.0,82,5.83,55,336,2444,9.8
6811,Darryl Shannon,2000-01,32.0,13,22,76,76,3,19,22,85.0,,390,19,77,96,389.0,82,5.28,57,380,2242,9.6
6812,Darryl Shannon,2001-02,33.0,14,15,71,71,3,12,15,80.0,1432.0,461,22,89,111,469.0,82,5.27,57,359,2285,9.4
6813,Darryl Shannon,2002-03,34.0,15,27,76,76,6,21,27,112.0,1682.0,537,28,110,138,581.0,82,5.49,53,331,2294,9.8
6814,Darryl Shannon,2003-04,35.0,16,1,7,7,0,1,1,6.0,126.0,544,28,111,139,587.0,82,5.51,63,376,2272,9.9
6815,Darryl Sutter,1982-83,24.0,4,2,8,8,2,0,2,3.0,,8,2,0,2,3.0,80,7.03,61,280,2352,12.0
6816,Darryl Sutter,1983-84,25.0,5,62,76,76,40,22,62,179.0,,84,42,22,64,182.0,80,7.69,77,340,2441,12.6
6817,Darryl Sutter,1984-85,26.0,6,35,40,40,23,12,35,100.0,,124,65,34,99,282.0,80,8.03,73,320,2489,12.9
6818,Darryl Sutter,1985-86,27.0,7,61,80,80,31,30,61,168.0,,204,96,64,160,450.0,80,7.73,71,310,2444,12.7
6819,Darryl Sutter,1986-87,28.0,8,40,59,59,20,20,40,134.0,,263,116,84,200,584.0,80,7.89,74,336,2448,12.9
6820,Darryl Sutter,1987-88,29.0,9,38,49,49,20,18,38,91.0,,312,136,102,238,675.0,80,7.77,71,321,2447,12.7
6821,Darryl Sutter,1988-89,30.0,10,27,50,50,17,10,27,89.0,,362,153,112,265,764.0,80,7.94,82,370,2484,12.8
6822,Darryl Sutter,1989-90,31.0,11,14,44,44,8,6,14,62.0,,406,161,118,279,826.0,80,7.34,72,344,2400,12.2
6823,Darryl Sydor,1994-95,22.0,4,6,18,18,1,5,6,18.0,,18,1,5,6,18.0,80,6.96,77,402,2440,11.4
6824,Darryl Sydor,1995-96,23.0,5,29,80,80,6,23,29,112.0,,98,7,28,35,130.0,84,7.25,87,443,2603,11.7
6825,Darryl Sydor,1996-97,24.0,6,35,84,84,8,27,35,146.0,,182,15,55,70,276.0,84,6.48,76,407,2545,10.7
6826,Darryl Sydor,1997-98,25.0,7,23,48,48,4,19,23,96.0,,230,19,74,93,372.0,48,5.97,37,209,1408,10.2
6827,Darryl Sydor,1998-99,26.0,8,20,84,84,3,17,20,117.0,,314,22,91,113,489.0,82,6.29,74,413,2481,10.4
6828,Darryl Sydor,1999-00,27.0,9,48,82,82,8,40,48,142.0,,396,30,131,161,631.0,82,5.83,55,336,2444,9.8
6829,Darryl Sydor,2000-01,28.0,10,46,79,79,11,35,46,166.0,,475,41,166,207,797.0,82,5.28,57,380,2242,9.6
6830,Darryl Sydor,2001-02,29.0,11,48,74,74,14,34,48,163.0,1574.0,549,55,200,255,960.0,82,5.27,57,359,2285,9.4
6831,Darryl Sydor,2002-03,30.0,12,34,74,74,8,26,34,132.0,1713.0,623,63,226,289,1092.0,82,5.49,53,331,2294,9.8
6832,Darryl Sydor,2003-04,31.0,13,47,81,81,10,37,47,140.0,1735.0,704,73,263,336,1232.0,82,5.51,63,376,2272,9.9
6833,Darryl Sydor,2004-05,32.0,14,33,78,78,4,29,33,183.0,1647.0,782,77,292,369,1415.0,82,5.24,53,338,2262,9.5
6834,Darryl Sydor,2005-06,33.0,15,36,81,81,5,31,36,132.0,1484.0,863,82,323,405,1547.0,82,5.31,60,363,2326,9.4
6835,Darryl Sydor,2006-07,34.0,16,22,80,80,3,19,22,122.0,1665.0,943,85,342,427,1669.0,82,5.14,57,348,2300,9.2
6836,Darryl Sydor,2008-09,36.0,17,23,80,80,4,19,23,64.0,1527.0,1023,89,361,450,1733.0,82,6.05,85,480,2458,10.1
6837,Darryl Sydor,2009-10,37.0,18,21,74,74,5,16,21,75.0,1491.0,1097,94,377,471,1808.0,82,5.76,70,398,2426,9.7
6838,Darryl Sydor,2010-11,38.0,19,13,74,74,1,12,13,59.0,1299.0,1171,95,389,484,1867.0,82,5.44,62,351,2383,9.4
6839,Darryl Sydor,2011-12,39.0,20,15,73,73,3,12,15,73.0,1330.0,1244,98,401,499,1940.0,82,5.7,65,341,2477,9.4
6840,Darryl Sydor,2012-13,40.0,21,8,47,47,0,8,8,26.0,785.0,1291,98,409,507,1966.0,82,5.53,56,304,2486,9.1
6841,Darryl Williams,1995-96,27.0,4,0,2,2,0,0,0,1.0,,2,0,0,0,1.0,84,7.25,87,443,2603,11.7
6842,Darwin McCutcheon,1984-85,22.0,4,0,1,1,0,0,0,0.0,,1,0,0,0,0.0,80,8.03,73,320,2489,12.9
6843,Daryl Evans,1984-85,24.0,4,8,14,14,2,6,8,25.0,,14,2,6,8,25.0,80,8.03,73,320,2489,12.9
6844,Daryl Evans,1985-86,25.0,5,40,80,80,18,22,40,243.0,,94,20,28,48,268.0,80,7.73,71,310,2444,12.7
6845,Daryl Evans,1986-87,26.0,6,1,4,4,0,1,1,6.0,,98,20,29,49,274.0,80,7.89,74,336,2448,12.9
6846,Daryl Evans,1987-88,27.0,7,1,7,7,1,0,1,13.0,,105,21,29,50,287.0,80,7.77,71,321,2447,12.7
6847,Daryl Evans,1988-89,28.0,8,1,6,6,0,1,1,14.0,,111,21,30,51,301.0,80,7.94,82,370,2484,12.8
6848,Daryl Evans,1989-90,29.0,9,1,2,2,1,0,1,2.0,,113,22,30,52,303.0,80,7.34,72,344,2400,12.2
6849,Daryl Stanley,1986-87,24.0,4,5,23,23,1,4,5,14.0,,23,1,4,5,14.0,80,7.89,74,336,2448,12.9
6850,Daryl Stanley,1988-89,26.0,5,2,33,33,0,2,2,7.0,,56,1,6,7,21.0,80,7.94,82,370,2484,12.8
6851,Daryl Stanley,1989-90,27.0,6,3,33,33,1,2,3,20.0,,89,2,8,10,41.0,80,7.34,72,344,2400,12.2
6852,Daryl Stanley,1990-91,28.0,7,9,57,57,2,7,9,27.0,,146,4,15,19,68.0,80,7.43,89,437,2435,12.2
6853,Daryl Stanley,1991-92,29.0,8,4,20,20,3,1,4,12.0,,166,7,16,23,80.0,80,7.48,85,403,2430,12.3
6854,Daryl Stanley,1992-93,30.0,9,2,23,23,1,1,2,7.0,,189,8,17,25,87.0,80,7.37,76,367,2421,12.2
6855,Dave Allison,1986-87,27.0,4,0,3,3,0,0,0,2.0,,3,0,0,0,2.0,80,7.89,74,336,2448,12.9
6856,Dave Andreychuk,1985-86,22.0,4,37,43,43,14,23,37,65.0,,43,14,23,37,65.0,80,7.73,71,310,2444,12.7
6857,Dave Andreychuk,1986-87,23.0,5,80,78,78,38,42,80,179.0,,121,52,65,117,244.0,80,7.89,74,336,2448,12.9
6858,Dave Andreychuk,1987-88,24.0,6,61,64,64,31,30,61,153.0,,185,83,95,178,397.0,80,7.77,71,321,2447,12.7
6859,Dave Andreychuk,1988-89,25.0,7,87,80,80,36,51,87,226.0,,265,119,146,265,623.0,80,7.94,82,370,2484,12.8
6860,Dave Andreychuk,1989-90,26.0,8,73,77,77,25,48,73,254.0,,342,144,194,338,877.0,80,7.34,72,344,2400,12.2
6861,Dave Andreychuk,1990-91,27.0,9,78,80,80,30,48,78,253.0,,422,174,242,416,1130.0,80,7.43,89,437,2435,12.2
6862,Dave Andreychuk,1991-92,28.0,10,52,56,56,28,24,52,145.0,,478,202,266,468,1275.0,80,7.48,85,403,2430,12.3
6863,Dave Andreychuk,1992-93,29.0,11,82,73,73,40,42,82,206.0,,551,242,308,550,1481.0,80,7.37,76,367,2421,12.2
6864,Dave Andreychuk,1993-94,30.0,12,69,80,80,36,33,69,234.0,,631,278,341,619,1715.0,80,6.91,71,366,2385,11.6
6865,Dave Andreychuk,1994-95,31.0,13,91,80,80,41,50,91,337.0,,711,319,391,710,2052.0,80,6.96,77,402,2440,11.4
6866,Dave Andreychuk,1995-96,32.0,14,99,83,83,54,45,99,310.0,,794,373,436,809,2362.0,84,7.25,87,443,2603,11.7
6867,Dave Andreychuk,1996-97,33.0,15,99,83,83,53,46,99,333.0,,877,426,482,908,2695.0,84,6.48,76,407,2545,10.7
6868,Dave Andreychuk,1997-98,34.0,16,38,48,48,22,16,38,168.0,,925,448,498,946,2863.0,48,5.97,37,209,1408,10.2
6869,Dave Andreychuk,1998-99,35.0,17,57,76,76,28,29,57,241.0,,1001,476,527,1003,3104.0,82,6.29,74,413,2481,10.4
6870,Dave Andreychuk,1999-00,36.0,18,61,82,82,27,34,61,233.0,,1083,503,561,1064,3337.0,82,5.83,55,336,2444,9.8
6871,Dave Andreychuk,2000-01,37.0,19,48,75,75,14,34,48,180.0,,1158,517,595,1112,3517.0,82,5.28,57,380,2242,9.6
6872,Dave Andreychuk,2001-02,38.0,20,28,52,52,15,13,28,110.0,808.0,1210,532,608,1140,3627.0,82,5.27,57,359,2285,9.4
6873,Dave Andreychuk,2002-03,39.0,21,36,77,77,20,16,36,233.0,1491.0,1287,552,624,1176,3860.0,82,5.49,53,331,2294,9.8
6874,Dave Andreychuk,2003-04,40.0,22,33,74,74,20,13,33,119.0,887.0,1361,572,637,1209,3979.0,82,5.51,63,376,2272,9.9
6875,Dave Andreychuk,2004-05,41.0,23,38,82,82,21,17,38,161.0,1347.0,1443,593,654,1247,4140.0,82,5.24,53,338,2262,9.5
6876,Dave Andreychuk,2005-06,42.0,24,34,72,72,20,14,34,170.0,1184.0,1515,613,668,1281,4310.0,82,5.31,60,363,2326,9.4
6877,Dave Andreychuk,2006-07,43.0,25,39,82,82,21,18,39,165.0,1403.0,1597,634,686,1320,4475.0,82,5.14,57,348,2300,9.2
6878,Dave Andreychuk,2008-09,45.0,26,18,42,42,6,12,18,81.0,564.0,1639,640,698,1338,4556.0,82,6.05,85,480,2458,10.1
6879,Dave Archibald,1990-91,21.0,4,33,78,78,13,20,33,96.0,,78,13,20,33,96.0,80,7.43,89,437,2435,12.2
6880,Dave Archibald,1991-92,22.0,5,33,72,72,14,19,33,105.0,,150,27,39,66,201.0,80,7.48,85,403,2430,12.3
6881,Dave Archibald,1992-93,23.0,6,11,31,31,3,8,11,56.0,,181,30,47,77,257.0,80,7.37,76,367,2421,12.2
6882,Dave Archibald,1995-96,26.0,7,15,44,44,9,6,15,93.0,,225,39,53,92,350.0,84,7.25,87,443,2603,11.7
6883,Dave Archibald,1996-97,27.0,8,18,33,33,10,8,18,65.0,,258,49,61,110,415.0,84,6.48,76,407,2545,10.7
6884,Dave Archibald,1997-98,28.0,9,4,14,14,2,2,4,27.0,,272,51,63,114,442.0,48,5.97,37,209,1408,10.2
6885,Dave Archibald,1998-99,29.0,10,10,44,44,6,4,10,56.0,,316,57,67,124,498.0,82,6.29,74,413,2481,10.4
6886,Dave Archibald,1999-00,30.0,11,0,7,7,0,0,0,4.0,,323,57,67,124,502.0,82,5.83,55,336,2444,9.8
6887,Dave Babych,1983-84,22.0,4,44,69,69,6,38,44,209.0,,69,6,38,44,209.0,80,7.69,77,340,2441,12.6
6888,Dave Babych,1984-85,23.0,5,68,79,79,19,49,68,262.0,,148,25,87,112,471.0,80,8.03,73,320,2489,12.9
6889,Dave Babych,1985-86,24.0,6,74,79,79,13,61,74,252.0,,227,38,148,186,723.0,80,7.73,71,310,2444,12.7
6890,Dave Babych,1986-87,25.0,7,57,66,66,18,39,57,233.0,,293,56,187,243,956.0,80,7.89,74,336,2448,12.9
6891,Dave Babych,1987-88,26.0,8,62,78,78,13,49,62,240.0,,371,69,236,305,1196.0,80,7.77,71,321,2447,12.7
6892,Dave Babych,1988-89,27.0,9,69,81,81,14,55,69,205.0,,452,83,291,374,1401.0,80,7.94,82,370,2484,12.8
6893,Dave Babych,1989-90,28.0,10,41,66,66,8,33,41,157.0,,518,91,324,415,1558.0,80,7.34,72,344,2400,12.2
6894,Dave Babych,1990-91,29.0,11,50,71,71,14,36,50,233.0,,589,105,360,465,1791.0,80,7.43,89,437,2435,12.2
6895,Dave Babych,1991-92,30.0,12,47,70,70,6,41,47,172.0,,659,111,401,512,1963.0,80,7.48,85,403,2430,12.3
6896,Dave Babych,1992-93,31.0,13,43,72,72,6,37,43,164.0,,731,117,438,555,2127.0,80,7.37,76,367,2421,12.2
6897,Dave Babych,1993-94,32.0,14,6,8,8,0,6,6,15.0,,739,117,444,561,2142.0,80,6.91,71,366,2385,11.6
6898,Dave Babych,1994-95,33.0,15,29,75,75,5,24,29,148.0,,814,122,468,590,2290.0,80,6.96,77,402,2440,11.4
6899,Dave Babych,1995-96,34.0,16,19,43,43,3,16,19,78.0,,857,125,484,609,2368.0,84,7.25,87,443,2603,11.7
6900,Dave Babych,1996-97,35.0,17,32,73,73,4,28,32,96.0,,930,129,512,641,2464.0,84,6.48,76,407,2545,10.7
6901,Dave Babych,1997-98,36.0,18,14,40,40,3,11,14,58.0,,970,132,523,655,2522.0,48,5.97,37,209,1408,10.2
6902,Dave Babych,1998-99,37.0,19,24,53,53,3,21,24,69.0,,1023,135,544,679,2591.0,82,6.29,74,413,2481,10.4
6903,Dave Babych,1999-00,38.0,20,27,78,78,5,22,27,105.0,,1101,140,566,706,2696.0,82,5.83,55,336,2444,9.8
6904,Dave Babych,2000-01,39.0,21,9,53,53,0,9,9,46.0,,1154,140,575,715,2742.0,82,5.28,57,380,2242,9.6
6905,Dave Babych,2001-02,40.0,22,8,41,41,2,6,8,49.0,728.0,1195,142,581,723,2791.0,82,5.27,57,359,2285,9.4
6906,Dave Barr,1984-85,24.0,4,0,2,2,0,0,0,1.0,,2,0,0,0,1.0,80,8.03,73,320,2489,12.9
6907,Dave Barr,1985-86,25.0,5,2,10,10,1,1,2,11.0,,12,1,1,2,12.0,80,7.73,71,310,2444,12.7
6908,Dave Barr,1986-87,26.0,6,0,7,7,0,0,0,9.0,,19,1,1,2,21.0,80,7.89,74,336,2448,12.9
6909,Dave Barr,1987-88,27.0,7,34,75,75,16,18,34,75.0,,94,17,19,36,96.0,80,7.77,71,321,2447,12.7
6910,Dave Barr,1988-89,28.0,8,51,72,72,13,38,51,107.0,,166,30,57,87,203.0,80,7.94,82,370,2484,12.8
6911,Dave Barr,1989-90,29.0,9,32,69,69,15,17,32,83.0,,235,45,74,119,286.0,80,7.34,72,344,2400,12.2
6912,Dave Barr,1990-91,30.0,10,40,51,51,14,26,40,64.0,,286,59,100,159,350.0,80,7.43,89,437,2435,12.2
6913,Dave Barr,1991-92,31.0,11,59,73,73,27,32,59,140.0,,359,86,132,218,490.0,80,7.48,85,403,2430,12.3
6914,Dave Barr,1992-93,32.0,12,35,62,62,10,25,35,96.0,,421,96,157,253,586.0,80,7.37,76,367,2421,12.2
6915,Dave Barr,1993-94,33.0,13,40,70,70,18,22,40,98.0,,491,114,179,293,684.0,80,6.91,71,366,2385,11.6
6916,Dave Barr,1994-95,34.0,14,18,41,41,6,12,18,49.0,,532,120,191,311,733.0,80,6.96,77,402,2440,11.4
6917,Dave Barr,1995-96,35.0,15,14,62,62,6,8,14,41.0,,594,126,199,325,774.0,84,7.25,87,443,2603,11.7
6918,Dave Barr,1996-97,36.0,16,7,20,20,2,5,7,20.0,,614,128,204,332,794.0,84,6.48,76,407,2545,10.7
6919,Dave Bolland,2009-10,23.0,4,0,1,1,0,0,0,1.0,11.0,1,0,0,0,1.0,82,5.76,70,398,2426,9.7
6920,Dave Bolland,2010-11,24.0,5,17,39,39,4,13,17,49.0,535.0,40,4,13,17,50.0,82,5.44,62,351,2383,9.4
6921,Dave Bolland,2011-12,25.0,6,47,81,81,19,28,47,111.0,1333.0,121,23,41,64,161.0,82,5.7,65,341,2477,9.4
6922,Dave Bolland,2012-13,26.0,7,16,39,39,6,10,16,52.0,677.0,160,29,51,80,213.0,82,5.53,56,304,2486,9.1
6923,Dave Bolland,2013-14,27.0,8,37,61,61,15,22,37,102.0,1076.0,221,44,73,117,315.0,82,5.46,52,291,2492,9.0
6924,Dave Bolland,2014-15,28.0,9,37,76,76,19,18,37,126.0,1254.0,297,63,91,154,441.0,82,5.32,47,271,2439,8.9
6925,Dave Bolland,2015-16,29.0,10,14,35,35,7,7,14,46.0,572.0,332,70,98,168,487.0,48,5.31,29,160,1399,9.1
6926,Dave Bolland,2016-17,30.0,11,12,23,23,8,4,12,33.0,333.0,355,78,102,180,520.0,82,5.34,48,269,2463,8.9
6927,Dave Bolland,2017-18,31.0,12,23,53,53,6,17,23,76.0,867.0,408,84,119,203,596.0,82,5.32,47,251,2453,8.9
6928,Dave Bolland,2018-19,32.0,13,5,25,25,1,4,5,26.0,352.0,433,85,123,208,622.0,82,5.34,48,255,2438,9.0
6929,Dave Brown,1985-86,23.0,4,0,2,2,0,0,0,2.0,,2,0,0,0,2.0,80,7.73,71,310,2444,12.7
6930,Dave Brown,1986-87,24.0,5,6,19,19,1,5,6,9.0,,21,1,5,6,11.0,80,7.89,74,336,2448,12.9
6931,Dave Brown,1987-88,25.0,6,9,57,57,3,6,9,53.0,,78,4,11,15,64.0,80,7.77,71,321,2447,12.7
6932,Dave Brown,1988-89,26.0,7,17,76,76,10,7,17,74.0,,154,14,18,32,138.0,80,7.94,82,370,2484,12.8
6933,Dave Brown,1989-90,27.0,8,10,62,62,7,3,10,53.0,,216,21,21,42,191.0,80,7.34,72,344,2400,12.2
6934,Dave Brown,1990-91,28.0,9,17,47,47,12,5,17,41.0,,263,33,26,59,232.0,80,7.43,89,437,2435,12.2
6935,Dave Brown,1991-92,29.0,10,5,72,72,0,5,5,42.0,,335,33,31,64,274.0,80,7.48,85,403,2430,12.3
6936,Dave Brown,1992-93,30.0,11,6,60,60,0,6,6,32.0,,395,33,37,70,306.0,80,7.37,76,367,2421,12.2
6937,Dave Brown,1993-94,31.0,12,7,58,58,3,4,7,32.0,,453,36,41,77,338.0,80,6.91,71,366,2385,11.6
6938,Dave Brown,1994-95,32.0,13,6,70,70,4,2,6,50.0,,523,40,43,83,388.0,80,6.96,77,402,2440,11.4
6939,Dave Brown,1995-96,33.0,14,2,70,70,0,2,2,19.0,,593,40,45,85,407.0,84,7.25,87,443,2603,11.7
6940,Dave Brown,1996-97,34.0,15,5,71,71,1,4,5,16.0,,664,41,49,90,423.0,84,6.48,76,407,2545,10.7
6941,Dave Brown,1997-98,35.0,16,3,28,28,1,2,3,8.0,,692,42,51,93,431.0,48,5.97,37,209,1408,10.2
6942,Dave Brown,1998-99,36.0,17,4,37,37,3,1,4,8.0,,729,45,52,97,439.0,82,6.29,74,413,2481,10.4
6943,Dave Cameron,1984-85,26.0,4,23,66,66,11,12,23,65.0,,66,11,12,23,65.0,80,8.03,73,320,2489,12.9
6944,Dave Cameron,1985-86,27.0,5,9,35,35,5,4,9,31.0,,101,16,16,32,96.0,80,7.73,71,310,2444,12.7
6945,Dave Cameron,1986-87,28.0,6,21,67,67,9,12,21,79.0,,168,25,28,53,175.0,80,7.89,74,336,2448,12.9
6946,Dave Capuano,1992-93,24.0,4,8,33,33,3,5,8,26.0,,33,3,5,8,26.0,80,7.37,76,367,2421,12.2
6947,Dave Capuano,1993-94,25.0,5,44,61,61,13,31,44,77.0,,94,16,36,52,103.0,80,6.91,71,366,2385,11.6
6948,Dave Capuano,1995-96,27.0,6,2,6,6,1,1,2,10.0,,100,17,37,54,113.0,84,7.25,87,443,2603,11.7
6949,Dave Capuano,1996-97,28.0,7,1,4,4,0,1,1,5.0,,104,17,38,55,118.0,84,6.48,76,407,2545,10.7
6950,Dave Chartier,1983-84,22.0,4,0,1,1,0,0,0,0.0,,1,0,0,0,0.0,80,7.69,77,340,2441,12.6
6951,Dave Christian,1982-83,23.0,4,18,15,15,8,10,18,34.0,,15,8,10,18,34.0,80,7.03,61,280,2352,12.0
6952,Dave Christian,1983-84,24.0,5,71,80,80,28,43,71,185.0,,95,36,53,89,219.0,80,7.69,77,340,2441,12.6
6953,Dave Christian,1984-85,25.0,6,76,80,80,25,51,76,218.0,,175,61,104,165,437.0,80,8.03,73,320,2489,12.9
6954,Dave Christian,1985-86,26.0,7,44,55,55,18,26,44,133.0,,230,79,130,209,570.0,80,7.73,71,310,2444,12.7
6955,Dave Christian,1986-87,27.0,8,81,80,80,29,52,81,164.0,,310,108,182,290,734.0,80,7.89,74,336,2448,12.9
6956,Dave Christian,1987-88,28.0,9,69,80,80,26,43,69,152.0,,390,134,225,359,886.0,80,7.77,71,321,2447,12.7
6957,Dave Christian,1988-89,29.0,10,83,80,80,41,42,83,218.0,,470,175,267,442,1104.0,80,7.94,82,370,2484,12.8
6958,Dave Christian,1989-90,30.0,11,50,76,76,23,27,50,150.0,,546,198,294,492,1254.0,80,7.34,72,344,2400,12.2
6959,Dave Christian,1990-91,31.0,12,58,80,80,37,21,58,187.0,,626,235,315,550,1441.0,80,7.43,89,437,2435,12.2
6960,Dave Christian,1991-92,32.0,13,65,80,80,34,31,65,177.0,,706,269,346,615,1618.0,80,7.48,85,403,2430,12.3
6961,Dave Christian,1992-93,33.0,14,40,78,78,15,25,40,153.0,,784,284,371,655,1771.0,80,7.37,76,367,2421,12.2
6962,Dave Christian,1993-94,34.0,15,53,78,78,32,21,53,173.0,,862,316,392,708,1944.0,80,6.91,71,366,2385,11.6
6963,Dave Christian,1994-95,35.0,16,44,78,78,20,24,44,142.0,,940,336,416,752,2086.0,80,6.96,77,402,2440,11.4
6964,Dave Christian,1995-96,36.0,17,18,60,60,4,14,18,75.0,,1000,340,430,770,2161.0,84,7.25,87,443,2603,11.7
6965,Dave Christian,1996-97,37.0,18,3,9,9,0,3,3,6.0,,1009,340,433,773,2167.0,84,6.48,76,407,2545,10.7
6966,Dave Chyzowski,1992-93,21.0,4,14,34,34,8,6,14,59.0,,34,8,6,14,59.0,80,7.37,76,367,2421,12.2
6967,Dave Chyzowski,1993-94,22.0,5,14,56,56,5,9,14,66.0,,90,13,15,28,125.0,80,6.91,71,366,2385,11.6
6968,Dave Chyzowski,1994-95,23.0,6,2,12,12,1,1,2,18.0,,102,14,16,30,143.0,80,6.96,77,402,2440,11.4
6969,Dave Chyzowski,1996-97,25.0,7,1,3,3,1,0,1,4.0,,105,15,16,31,147.0,84,6.48,76,407,2545,10.7
6970,Dave Chyzowski,1997-98,26.0,8,0,13,13,0,0,0,11.0,,118,15,16,31,158.0,48,5.97,37,209,1408,10.2
6971,Dave Chyzowski,1999-00,28.0,9,0,8,8,0,0,0,6.0,,126,15,16,31,164.0,82,5.83,55,336,2444,9.8
6972,Dave Debol,1982-83,26.0,4,26,48,48,12,14,26,96.0,,48,12,14,26,96.0,80,7.03,61,280,2352,12.0
6973,Dave Debol,1983-84,27.0,5,26,44,44,14,12,26,70.0,,92,26,26,52,166.0,80,7.69,77,340,2441,12.6
6974,Dave Donnelly,1986-87,24.0,4,7,16,16,3,4,7,22.0,,16,3,4,7,22.0,80,7.89,74,336,2448,12.9
6975,Dave Donnelly,1987-88,25.0,5,14,38,38,6,8,14,33.0,,54,9,12,21,55.0,80,7.77,71,321,2447,12.7
6976,Dave Donnelly,1988-89,26.0,6,0,8,8,0,0,0,8.0,,62,9,12,21,63.0,80,7.94,82,370,2484,12.8
6977,Dave Donnelly,1989-90,27.0,7,18,71,71,6,12,18,64.0,,133,15,24,39,127.0,80,7.34,72,344,2400,12.2
6978,Dave Donnelly,1990-91,28.0,8,0,4,4,0,0,0,3.0,,137,15,24,39,130.0,80,7.43,89,437,2435,12.2
6979,Dave Duerden,2002-03,25.0,4,0,2,2,0,0,0,1.0,3.0,2,0,0,0,1.0,82,5.49,53,331,2294,9.8
6980,Dave Ellett,1987-88,23.0,4,38,80,80,11,27,38,152.0,,80,11,27,38,152.0,80,7.77,71,321,2447,12.7
6981,Dave Ellett,1988-89,24.0,5,46,80,80,15,31,46,167.0,,160,26,58,84,319.0,80,7.94,82,370,2484,12.8
6982,Dave Ellett,1989-90,25.0,6,44,78,78,13,31,44,159.0,,238,39,89,128,478.0,80,7.34,72,344,2400,12.2
6983,Dave Ellett,1990-91,26.0,7,58,68,68,13,45,58,198.0,,306,52,134,186,676.0,80,7.43,89,437,2435,12.2
6984,Dave Ellett,1991-92,27.0,8,56,75,75,22,34,56,209.0,,381,74,168,242,885.0,80,7.48,85,403,2430,12.3
6985,Dave Ellett,1992-93,28.0,9,46,77,77,17,29,46,205.0,,458,91,197,288,1090.0,80,7.37,76,367,2421,12.2
6986,Dave Ellett,1993-94,29.0,10,49,77,77,12,37,49,195.0,,535,103,234,337,1285.0,80,6.91,71,366,2385,11.6
6987,Dave Ellett,1994-95,30.0,11,51,79,79,18,33,51,225.0,,614,121,267,388,1510.0,80,6.96,77,402,2440,11.4
6988,Dave Ellett,1995-96,31.0,12,40,70,70,6,34,40,186.0,,684,127,301,428,1696.0,84,7.25,87,443,2603,11.7
6989,Dave Ellett,1996-97,32.0,13,43,68,68,7,36,43,146.0,,752,134,337,471,1842.0,84,6.48,76,407,2545,10.7
6990,Dave Ellett,1997-98,33.0,14,15,33,33,5,10,15,84.0,,785,139,347,486,1926.0,48,5.97,37,209,1408,10.2
6991,Dave Ellett,1998-99,34.0,15,22,80,80,3,19,22,153.0,,865,142,366,508,2079.0,82,6.29,74,413,2481,10.4
6992,Dave Ellett,1999-00,35.0,16,21,76,76,6,15,21,105.0,,941,148,381,529,2184.0,82,5.83,55,336,2444,9.8
6993,Dave Ellett,2000-01,36.0,17,23,82,82,3,20,23,129.0,,1023,151,401,552,2313.0,82,5.28,57,380,2242,9.6
6994,Dave Ellett,2001-02,37.0,18,6,54,54,0,6,6,45.0,799.0,1077,151,407,558,2358.0,82,5.27,57,359,2285,9.4
6995,Dave Ellett,2002-03,38.0,19,10,52,52,2,8,10,41.0,701.0,1129,153,415,568,2399.0,82,5.49,53,331,2294,9.8
6996,Dave Feamster,1984-85,26.0,4,2,29,29,0,2,2,25.0,,29,0,2,2,25.0,80,8.03,73,320,2489,12.9
6997,Dave Feamster,1985-86,27.0,5,18,78,78,6,12,18,64.0,,107,6,14,20,89.0,80,7.73,71,310,2444,12.7
6998,Dave Feamster,1986-87,28.0,6,13,46,46,6,7,13,44.0,,153,12,21,33,133.0,80,7.89,74,336,2448,12.9
6999,Dave Feamster,1987-88,29.0,7,4,16,16,1,3,4,10.0,,169,13,24,37,143.0,80,7.77,71,321,2447,12.7
7000,Dave Gagner,1987-88,23.0,4,12,38,38,6,6,12,52.0,,38,6,6,12,52.0,80,7.77,71,321,2447,12.7
7001,Dave Gagner,1988-89,24.0,5,10,32,32,4,6,10,41.0,,70,10,12,22,93.0,80,7.94,82,370,2484,12.8
7002,Dave Gagner,1989-90,25.0,6,5,10,10,1,4,5,16.0,,80,11,16,27,109.0,80,7.34,72,344,2400,12.2
7003,Dave Gagner,1990-91,26.0,7,19,51,51,8,11,19,87.0,,131,19,27,46,196.0,80,7.43,89,437,2435,12.2
7004,Dave Gagner,1991-92,27.0,8,78,75,75,35,43,78,183.0,,206,54,70,124,379.0,80,7.48,85,403,2430,12.3
7005,Dave Gagner,1992-93,28.0,9,78,79,79,40,38,78,238.0,,285,94,108,202,617.0,80,7.37,76,367,2421,12.2
7006,Dave Gagner,1993-94,29.0,10,82,73,73,40,42,82,223.0,,358,134,150,284,840.0,80,6.91,71,366,2385,11.6
7007,Dave Gagner,1994-95,30.0,11,71,78,78,31,40,71,229.0,,436,165,190,355,1069.0,80,6.96,77,402,2440,11.4
7008,Dave Gagner,1995-96,31.0,12,76,84,84,33,43,76,230.0,,520,198,233,431,1299.0,84,7.25,87,443,2603,11.7
7009,Dave Gagner,1996-97,32.0,13,61,76,76,32,29,61,213.0,,596,230,262,492,1512.0,84,6.48,76,407,2545,10.7
7010,Dave Gagner,1997-98,33.0,14,42,48,48,14,28,42,138.0,,644,244,290,534,1650.0,48,5.97,37,209,1408,10.2
7011,Dave Gagner,1998-99,34.0,15,49,73,73,21,28,49,215.0,,717,265,318,583,1865.0,82,6.29,74,413,2481,10.4
7012,Dave Gagner,1999-00,35.0,16,60,82,82,27,33,60,228.0,,799,292,351,643,2093.0,82,5.83,55,336,2444,9.8
7013,Dave Gagner,2000-01,36.0,17,48,78,78,20,28,48,165.0,,877,312,379,691,2258.0,82,5.28,57,380,2242,9.6
7014,Dave Gagner,2001-02,37.0,18,28,69,69,6,22,28,100.0,959.0,946,318,401,719,2358.0,82,5.27,57,359,2285,9.4
7015,Dave Gans,1985-86,21.0,4,0,3,3,0,0,0,0.0,,3,0,0,0,0.0,80,7.73,71,310,2444,12.7
7016,Dave Gans,1988-89,24.0,5,0,3,3,0,0,0,3.0,,6,0,0,0,3.0,80,7.94,82,370,2484,12.8
7017,Dave Goertz,1990-91,25.0,4,0,2,2,0,0,0,2.0,,2,0,0,0,2.0,80,7.43,89,437,2435,12.2
7018,Dave Gorman,1982-83,27.0,4,0,3,3,0,0,0,1.0,,3,0,0,0,1.0,80,7.03,61,280,2352,12.0
7019,Dave Hannan,1984-85,23.0,4,0,1,1,0,0,0,0.0,,1,0,0,0,0.0,80,8.03,73,320,2489,12.9
7020,Dave Hannan,1985-86,24.0,5,33,74,74,11,22,33,95.0,,75,11,22,33,95.0,80,7.73,71,310,2444,12.7
7021,Dave Hannan,1986-87,25.0,6,5,24,24,2,3,5,20.0,,99,13,25,38,115.0,80,7.89,74,336,2448,12.9
7022,Dave Hannan,1987-88,26.0,7,13,30,30,6,7,13,38.0,,129,19,32,51,153.0,80,7.77,71,321,2447,12.7
7023,Dave Hannan,1988-89,27.0,8,35,75,75,17,18,35,100.0,,204,36,50,86,253.0,80,7.94,82,370,2484,12.8
7024,Dave Hannan,1989-90,28.0,9,25,58,58,10,15,25,85.0,,262,46,65,111,338.0,80,7.34,72,344,2400,12.2
7025,Dave Hannan,1990-91,29.0,10,27,72,72,13,14,27,96.0,,334,59,79,138,434.0,80,7.43,89,437,2435,12.2
7026,Dave Hannan,1991-92,30.0,11,30,72,72,10,20,30,72.0,,406,69,99,168,506.0,80,7.48,85,403,2430,12.3
7027,Dave Hannan,1992-93,31.0,12,15,39,39,6,9,15,39.0,,445,75,108,183,545.0,80,7.37,76,367,2421,12.2
7028,Dave Hannan,1993-94,32.0,13,34,74,74,11,23,34,72.0,,519,86,131,217,617.0,80,6.91,71,366,2385,11.6
7029,Dave Hannan,1994-95,33.0,14,10,47,47,4,6,10,32.0,,566,90,137,227,649.0,80,6.96,77,402,2440,11.4
7030,Dave Hannan,1995-96,34.0,15,20,55,55,5,15,20,43.0,,621,95,152,247,692.0,84,7.25,87,443,2603,11.7
7031,Dave Hannan,1996-97,35.0,16,21,83,83,6,15,21,40.0,,704,101,167,268,732.0,84,6.48,76,407,2545,10.7
7032,Dave Hannan,1997-98,36.0,17,16,42,42,4,12,16,36.0,,746,105,179,284,768.0,48,5.97,37,209,1408,10.2
7033,Dave Hannan,1998-99,37.0,18,17,61,61,7,10,17,41.0,,807,112,189,301,809.0,82,6.29,74,413,2481,10.4
7034,Dave Hannan,1999-00,38.0,19,4,34,34,2,2,4,16.0,,841,114,191,305,825.0,82,5.83,55,336,2444,9.8
7035,Dave Hindmarch,1983-84,25.0,4,1,1,1,1,0,1,1.0,,1,1,0,1,1.0,80,7.69,77,340,2441,12.6
7036,Dave Hindmarch,1984-85,26.0,5,3,9,9,3,0,3,10.0,,10,4,0,4,11.0,80,8.03,73,320,2489,12.9
7037,Dave Hindmarch,1985-86,27.0,6,23,60,60,11,12,23,86.0,,70,15,12,27,97.0,80,7.73,71,310,2444,12.7
7038,Dave Hindmarch,1986-87,28.0,7,11,29,29,6,5,11,49.0,,99,21,17,38,146.0,80,7.89,74,336,2448,12.9
7039,Dave Hunter,1982-83,25.0,4,43,80,80,12,31,43,109.0,,80,12,31,43,109.0,80,7.03,61,280,2352,12.0
7040,Dave Hunter,1983-84,26.0,5,28,78,78,12,16,28,104.0,,158,24,47,71,213.0,80,7.69,77,340,2441,12.6
7041,Dave Hunter,1984-85,27.0,6,38,63,63,16,22,38,124.0,,221,40,69,109,337.0,80,8.03,73,320,2489,12.9
7042,Dave Hunter,1985-86,28.0,7,31,80,80,13,18,31,113.0,,301,53,87,140,450.0,80,7.73,71,310,2444,12.7
7043,Dave Hunter,1986-87,29.0,8,48,80,80,22,26,48,118.0,,381,75,113,188,568.0,80,7.89,74,336,2448,12.9
7044,Dave Hunter,1987-88,30.0,9,36,80,80,17,19,36,119.0,,461,92,132,224,687.0,80,7.77,71,321,2447,12.7
7045,Dave Hunter,1988-89,31.0,10,37,62,62,15,22,37,110.0,,523,107,154,261,797.0,80,7.94,82,370,2484,12.8
7046,Dave Hunter,1989-90,32.0,11,15,77,77,6,9,15,86.0,,600,113,163,276,883.0,80,7.34,72,344,2400,12.2
7047,Dave Hunter,1990-91,33.0,12,35,80,80,14,21,35,133.0,,680,127,184,311,1016.0,80,7.43,89,437,2435,12.2
7048,Dave Hunter,1991-92,34.0,13,12,66,66,6,6,12,87.0,,746,133,190,323,1103.0,80,7.48,85,403,2430,12.3
7049,Dave Karpa,1994-95,23.0,4,0,4,4,0,0,0,2.0,,4,0,0,0,2.0,80,6.96,77,402,2440,11.4
7050,Dave Karpa,1995-96,24.0,5,1,12,12,0,1,1,2.0,,16,0,1,1,4.0,84,7.25,87,443,2603,11.7
7051,Dave Karpa,1996-97,25.0,6,17,60,60,5,12,17,48.0,,76,5,13,18,52.0,84,6.48,76,407,2545,10.7
7052,Dave Karpa,1997-98,26.0,7,6,28,28,1,5,6,33.0,,104,6,18,24,85.0,48,5.97,37,209,1408,10.2
7053,Dave Karpa,1998-99,27.0,8,19,72,72,3,16,19,62.0,,176,9,34,43,147.0,82,6.29,74,413,2481,10.4
7054,Dave Karpa,1999-00,28.0,9,13,69,69,2,11,13,90.0,,245,11,45,56,237.0,82,5.83,55,336,2444,9.8
7055,Dave Karpa,2000-01,29.0,10,12,78,78,1,11,12,64.0,,323,12,56,68,301.0,82,5.28,57,380,2242,9.6
7056,Dave Karpa,2001-02,30.0,11,2,33,33,0,2,2,21.0,558.0,356,12,58,70,322.0,82,5.27,57,359,2285,9.4
7057,Dave Karpa,2002-03,31.0,12,5,27,27,1,4,5,24.0,469.0,383,13,62,75,346.0,82,5.49,53,331,2294,9.8
7058,Dave Karpa,2003-04,32.0,13,10,80,80,4,6,10,69.0,1601.0,463,17,68,85,415.0,82,5.51,63,376,2272,9.9
7059,Dave Karpa,2004-05,33.0,14,11,75,75,1,10,11,53.0,1267.0,538,18,78,96,468.0,82,5.24,53,338,2262,9.5
7060,Dave Karpa,2005-06,34.0,15,2,19,19,0,2,2,13.0,277.0,557,18,80,98,481.0,82,5.31,60,363,2326,9.4
7061,Dave Langevin,1982-83,28.0,4,16,76,76,3,13,16,82.0,,76,3,13,16,82.0,80,7.03,61,280,2352,12.0
7062,Dave Langevin,1983-84,29.0,5,17,75,75,1,16,17,68.0,,151,4,29,33,150.0,80,7.69,77,340,2441,12.6
7063,Dave Langevin,1984-85,30.0,6,21,73,73,1,20,21,73.0,,224,5,49,54,223.0,80,8.03,73,320,2489,12.9
7064,Dave Langevin,1985-86,31.0,7,21,73,73,4,17,21,107.0,,297,9,66,75,330.0,80,7.73,71,310,2444,12.7
7065,Dave Langevin,1986-87,32.0,8,19,69,69,3,16,19,89.0,,366,12,82,94,419.0,80,7.89,74,336,2448,12.9
7066,Dave Langevin,1987-88,33.0,9,13,56,56,0,13,13,33.0,,422,12,95,107,452.0,80,7.77,71,321,2447,12.7
7067,Dave Langevin,1988-89,34.0,10,8,80,80,0,8,8,46.0,,502,12,103,115,498.0,80,7.94,82,370,2484,12.8
7068,Dave Langevin,1989-90,35.0,11,4,11,11,0,4,4,5.0,,513,12,107,119,503.0,80,7.34,72,344,2400,12.2
7069,Dave Lowry,1988-89,23.0,4,18,73,73,10,8,18,66.0,,73,10,8,18,66.0,80,7.94,82,370,2484,12.8
7070,Dave Lowry,1989-90,24.0,5,18,70,70,8,10,18,74.0,,143,18,18,36,140.0,80,7.34,72,344,2400,12.2
7071,Dave Lowry,1990-91,25.0,6,4,22,22,1,3,4,14.0,,165,19,21,40,154.0,80,7.43,89,437,2435,12.2
7072,Dave Lowry,1991-92,26.0,7,6,21,21,3,3,6,22.0,,186,22,24,46,176.0,80,7.48,85,403,2430,12.3
7073,Dave Lowry,1992-93,27.0,8,25,78,78,19,6,25,98.0,,264,41,30,71,274.0,80,7.37,76,367,2421,12.2
7074,Dave Lowry,1993-94,28.0,9,40,79,79,19,21,40,123.0,,343,60,51,111,397.0,80,6.91,71,366,2385,11.6
7075,Dave Lowry,1994-95,29.0,10,20,75,75,7,13,20,85.0,,418,67,64,131,482.0,80,6.96,77,402,2440,11.4
7076,Dave Lowry,1995-96,30.0,11,13,58,58,5,8,13,59.0,,476,72,72,144,541.0,84,7.25,87,443,2603,11.7
7077,Dave Lowry,1996-97,31.0,12,37,80,80,15,22,37,122.0,,556,87,94,181,663.0,84,6.48,76,407,2545,10.7
7078,Dave Lowry,1997-98,32.0,13,20,45,45,10,10,20,70.0,,601,97,104,201,733.0,48,5.97,37,209,1408,10.2
7079,Dave Lowry,1998-99,33.0,14,24,63,63,10,14,24,83.0,,664,107,118,225,816.0,82,6.29,74,413,2481,10.4
7080,Dave Lowry,1999-00,34.0,15,29,77,77,15,14,29,96.0,,741,122,132,254,912.0,82,5.83,55,336,2444,9.8
7081,Dave Lowry,2000-01,35.0,16,8,57,57,4,4,8,51.0,,798,126,136,262,963.0,82,5.28,57,380,2242,9.6
7082,Dave Lowry,2001-02,36.0,17,15,61,61,6,9,15,58.0,563.0,859,132,145,277,1021.0,82,5.27,57,359,2285,9.4
7083,Dave Lowry,2002-03,37.0,18,5,32,32,1,4,5,25.0,294.0,891,133,149,282,1046.0,82,5.49,53,331,2294,9.8
7084,Dave Lowry,2003-04,38.0,19,35,79,79,18,17,35,108.0,1259.0,970,151,166,317,1154.0,82,5.51,63,376,2272,9.9
7085,Dave Lowry,2004-05,39.0,20,13,62,62,7,6,13,74.0,928.0,1032,158,172,330,1228.0,82,5.24,53,338,2262,9.5
7086,Dave Lowry,2005-06,40.0,21,19,34,34,5,14,19,40.0,486.0,1066,163,186,349,1268.0,82,5.31,60,363,2326,9.4
7087,Dave Lowry,2006-07,41.0,22,2,18,18,1,1,2,9.0,166.0,1084,164,187,351,1277.0,82,5.14,57,348,2300,9.2
7088,Dave Manson,1989-90,23.0,4,9,63,63,1,8,9,41.0,,63,1,8,9,41.0,80,7.34,72,344,2400,12.2
7089,Dave Manson,1990-91,24.0,5,7,54,54,1,6,7,47.0,,117,2,14,16,88.0,80,7.43,89,437,2435,12.2
7090,Dave Manson,1991-92,25.0,6,54,79,79,18,36,54,224.0,,196,20,50,70,312.0,80,7.48,85,403,2430,12.3
7091,Dave Manson,1992-93,26.0,7,28,59,59,5,23,28,126.0,,255,25,73,98,438.0,80,7.37,76,367,2421,12.2
7092,Dave Manson,1993-94,27.0,8,29,75,75,14,15,29,154.0,,330,39,88,127,592.0,80,6.91,71,366,2385,11.6
7093,Dave Manson,1994-95,28.0,9,47,79,79,15,32,47,206.0,,409,54,120,174,798.0,80,6.96,77,402,2440,11.4
7094,Dave Manson,1995-96,29.0,10,45,83,83,15,30,45,244.0,,492,69,150,219,1042.0,84,7.25,87,443,2603,11.7
7095,Dave Manson,1996-97,30.0,11,21,70,70,4,17,21,180.0,,562,73,167,240,1222.0,84,6.48,76,407,2545,10.7
7096,Dave Manson,1997-98,31.0,12,18,44,44,3,15,18,104.0,,606,76,182,258,1326.0,48,5.97,37,209,1408,10.2
7097,Dave Manson,1998-99,32.0,13,30,82,82,7,23,30,189.0,,688,83,205,288,1515.0,82,6.29,74,413,2481,10.4
7098,Dave Manson,1999-00,33.0,14,22,75,75,4,18,22,175.0,,763,87,223,310,1690.0,82,5.83,55,336,2444,9.8
7099,Dave Manson,2000-01,34.0,15,34,81,81,4,30,34,148.0,,844,91,253,344,1838.0,82,5.28,57,380,2242,9.6
7100,Dave Manson,2001-02,35.0,16,23,75,75,6,17,23,145.0,1638.0,919,97,270,367,1983.0,82,5.27,57,359,2285,9.4
7101,Dave Manson,2002-03,36.0,17,10,63,63,1,9,10,66.0,992.0,982,98,279,377,2049.0,82,5.49,53,331,2294,9.8
7102,Dave Manson,2003-04,37.0,18,11,74,74,4,7,11,70.0,1169.0,1056,102,286,388,2119.0,82,5.51,63,376,2272,9.9
7103,Dave Manson,2004-05,38.0,19,2,47,47,0,2,2,36.0,604.0,1103,102,288,390,2155.0,82,5.24,53,338,2262,9.5
7104,Dave Marcinyshyn,1993-94,26.0,4,1,9,9,0,1,1,4.0,,9,0,1,1,4.0,80,6.91,71,366,2385,11.6
7105,Dave Marcinyshyn,1994-95,27.0,5,0,5,5,0,0,0,3.0,,14,0,1,1,7.0,80,6.96,77,402,2440,11.4
7106,Dave Marcinyshyn,1995-96,28.0,6,0,2,2,0,0,0,1.0,,16,0,1,1,8.0,84,7.25,87,443,2603,11.7
7107,Dave McLlwain,1990-91,24.0,4,19,66,66,11,8,19,65.0,,66,11,8,19,65.0,80,7.43,89,437,2435,12.2
7108,Dave McLlwain,1991-92,25.0,5,3,24,24,1,2,3,14.0,,90,12,10,22,79.0,80,7.48,85,403,2430,12.3
7109,Dave McLlwain,1992-93,26.0,6,51,80,80,25,26,51,180.0,,170,37,36,73,259.0,80,7.37,76,367,2421,12.2
7110,Dave McLlwain,1993-94,27.0,7,25,60,60,14,11,25,104.0,,230,51,47,98,363.0,80,6.91,71,366,2385,11.6
7111,Dave McLlwain,1994-95,28.0,8,28,73,73,10,18,28,91.0,,303,61,65,126,454.0,80,6.96,77,402,2440,11.4
7112,Dave McLlwain,1995-96,29.0,9,18,66,66,14,4,18,85.0,,369,75,69,144,539.0,84,7.25,87,443,2603,11.7
7113,Dave McLlwain,1996-97,30.0,10,43,66,66,17,26,43,115.0,,435,92,95,187,654.0,84,6.48,76,407,2545,10.7
7114,Dave McLlwain,1997-98,31.0,11,11,43,43,5,6,11,48.0,,478,97,101,198,702.0,48,5.97,37,209,1408,10.2
7115,Dave McLlwain,1998-99,32.0,12,7,19,19,2,5,7,20.0,,497,99,106,205,722.0,82,6.29,74,413,2481,10.4
7116,Dave McLlwain,1999-00,33.0,13,2,4,4,1,1,2,3.0,,501,100,107,207,725.0,82,5.83,55,336,2444,9.8
7117,Dave Michayluk,1984-85,22.0,4,0,1,1,0,0,0,0.0,,1,0,0,0,0.0,80,8.03,73,320,2489,12.9
7118,Dave Michayluk,1985-86,23.0,5,8,13,13,2,6,8,18.0,,14,2,6,8,18.0,80,7.73,71,310,2444,12.7
7119,Dave Morisset,2004-05,23.0,4,0,4,4,0,0,0,2.0,45.0,4,0,0,0,2.0,82,5.24,53,338,2262,9.5
7120,Dave Morissette,2001-02,30.0,4,0,10,10,0,0,0,2.0,22.0,10,0,0,0,2.0,82,5.27,57,359,2285,9.4
7121,Dave Morissette,2002-03,31.0,5,0,1,1,0,0,0,0.0,4.0,11,0,0,0,2.0,82,5.49,53,331,2294,9.8
7122,Dave Morrison,1983-84,21.0,4,0,3,3,0,0,0,2.0,,3,0,0,0,2.0,80,7.69,77,340,2441,12.6
7123,Dave Morrison,1984-85,22.0,5,0,4,4,0,0,0,6.0,,7,0,0,0,8.0,80,8.03,73,320,2489,12.9
7124,Dave Morrison,1985-86,23.0,6,6,24,24,3,3,6,16.0,,31,3,3,6,24.0,80,7.73,71,310,2444,12.7
7125,Dave Morrison,1987-88,25.0,7,0,8,8,0,0,0,8.0,,39,3,3,6,32.0,80,7.77,71,321,2447,12.7
7126,Dave Moss,2009-10,28.0,4,18,41,41,10,8,18,70.0,460.0,41,10,8,18,70.0,82,5.76,70,398,2426,9.7
7127,Dave Moss,2010-11,29.0,5,11,41,41,4,7,11,60.0,508.0,82,14,15,29,130.0,82,5.44,62,351,2383,9.4
7128,Dave Moss,2011-12,30.0,6,39,81,81,20,19,39,194.0,1101.0,163,34,34,68,324.0,82,5.7,65,341,2477,9.4
7129,Dave Moss,2012-13,31.0,7,17,64,64,8,9,17,133.0,878.0,227,42,43,85,457.0,82,5.53,56,304,2486,9.1
7130,Dave Moss,2013-14,32.0,8,30,58,58,17,13,30,127.0,794.0,285,59,56,115,584.0,82,5.46,52,291,2492,9.0
7131,Dave Moss,2014-15,33.0,9,9,32,32,2,7,9,82.0,448.0,317,61,63,124,666.0,82,5.32,47,271,2439,8.9
7132,Dave Moss,2015-16,34.0,10,20,45,45,5,15,20,82.0,700.0,362,66,78,144,748.0,48,5.31,29,160,1399,9.1
7133,Dave Moss,2016-17,35.0,11,22,79,79,8,14,22,151.0,1158.0,441,74,92,166,899.0,82,5.34,48,269,2463,8.9
7134,Dave Moss,2017-18,36.0,12,12,60,60,4,8,12,96.0,775.0,501,78,100,178,995.0,82,5.32,47,251,2453,8.9
7135,Dave Orleski,1983-84,24.0,4,0,1,1,0,0,0,0.0,,1,0,0,0,0.0,80,7.69,77,340,2441,12.6
7136,Dave Orleski,1984-85,25.0,5,0,1,1,0,0,0,0.0,,2,0,0,0,0.0,80,8.03,73,320,2489,12.9
7137,Dave Pasin,1988-89,22.0,4,37,71,71,18,19,37,116.0,,71,18,19,37,116.0,80,7.94,82,370,2484,12.8
7138,Dave Pasin,1991-92,25.0,5,0,5,5,0,0,0,2.0,,76,18,19,37,118.0,80,7.48,85,403,2430,12.3
7139,Dave Pichette,1983-84,23.0,4,20,46,46,4,16,20,47.0,,46,4,16,20,47.0,80,7.69,77,340,2441,12.6
7140,Dave Pichette,1984-85,24.0,5,37,67,67,7,30,37,84.0,,113,11,46,57,131.0,80,8.03,73,320,2489,12.9
7141,Dave Pichette,1985-86,25.0,6,24,53,53,3,21,24,62.0,,166,14,67,81,193.0,80,7.73,71,310,2444,12.7
7142,Dave Pichette,1986-87,26.0,7,20,46,46,2,18,20,71.0,,212,16,85,101,264.0,80,7.89,74,336,2448,12.9
7143,Dave Pichette,1987-88,27.0,8,57,71,71,17,40,57,144.0,,283,33,125,158,408.0,80,7.77,71,321,2447,12.7
7144,Dave Pichette,1988-89,28.0,9,19,33,33,7,12,19,59.0,,316,40,137,177,467.0,80,7.94,82,370,2484,12.8
7145,Dave Pichette,1990-91,30.0,10,4,6,6,1,3,4,7.0,,322,41,140,181,474.0,80,7.43,89,437,2435,12.2
7146,Dave Poulin,1985-86,27.0,4,2,2,2,2,0,2,4.0,,2,2,0,2,4.0,80,7.73,71,310,2444,12.7
7147,Dave Poulin,1986-87,28.0,5,76,73,73,31,45,76,185.0,,75,33,45,78,189.0,80,7.89,74,336,2448,12.9
7148,Dave Poulin,1987-88,29.0,6,74,73,73,30,44,74,182.0,,148,63,89,152,371.0,80,7.77,71,321,2447,12.7
7149,Dave Poulin,1988-89,30.0,7,69,79,79,27,42,69,181.0,,227,90,131,221,552.0,80,7.94,82,370,2484,12.8
7150,Dave Poulin,1989-90,31.0,8,70,75,75,25,45,70,155.0,,302,115,176,291,707.0,80,7.34,72,344,2400,12.2
7151,Dave Poulin,1990-91,32.0,9,51,68,68,19,32,51,125.0,,370,134,208,342,832.0,80,7.43,89,437,2435,12.2
7152,Dave Poulin,1991-92,33.0,10,35,69,69,18,17,35,81.0,,439,152,225,377,913.0,80,7.48,85,403,2430,12.3
7153,Dave Poulin,1992-93,34.0,11,42,60,60,15,27,42,88.0,,499,167,252,419,1001.0,80,7.37,76,367,2421,12.2
7154,Dave Poulin,1993-94,35.0,12,20,31,31,8,12,20,60.0,,530,175,264,439,1061.0,80,6.91,71,366,2385,11.6
7155,Dave Poulin,1994-95,36.0,13,8,18,18,4,4,8,31.0,,548,179,268,447,1092.0,80,6.96,77,402,2440,11.4
7156,Dave Poulin,1995-96,37.0,14,49,84,84,16,33,49,112.0,,632,195,301,496,1204.0,84,7.25,87,443,2603,11.7
7157,Dave Poulin,1996-97,38.0,15,25,63,63,6,19,25,64.0,,695,201,320,521,1268.0,84,6.48,76,407,2545,10.7
7158,Dave Poulin,1997-98,39.0,16,9,29,29,4,5,9,30.0,,724,205,325,530,1298.0,48,5.97,37,209,1408,10.2
7159,Dave Reid,1986-87,22.0,4,1,8,8,1,0,1,4.0,,8,1,0,1,4.0,80,7.89,74,336,2448,12.9
7160,Dave Reid,1987-88,23.0,5,27,35,35,14,13,27,52.0,,43,15,13,28,56.0,80,7.77,71,321,2447,12.7
7161,Dave Reid,1988-89,24.0,6,20,37,37,10,10,20,53.0,,80,25,23,48,109.0,80,7.94,82,370,2484,12.8
7162,Dave Reid,1989-90,25.0,7,6,12,12,3,3,6,19.0,,92,28,26,54,128.0,80,7.34,72,344,2400,12.2
7163,Dave Reid,1990-91,26.0,8,0,3,3,0,0,0,2.0,,95,28,26,54,130.0,80,7.43,89,437,2435,12.2
7164,Dave Reid,1991-92,27.0,9,30,77,77,9,21,30,87.0,,172,37,47,84,217.0,80,7.48,85,403,2430,12.3
7165,Dave Reid,1992-93,28.0,10,28,70,70,9,19,28,97.0,,242,46,66,112,314.0,80,7.37,76,367,2421,12.2
7166,Dave Reid,1993-94,29.0,11,28,69,69,15,13,28,110.0,,311,61,79,140,424.0,80,6.91,71,366,2385,11.6
7167,Dave Reid,1994-95,30.0,12,14,43,43,7,7,14,70.0,,354,68,86,154,494.0,80,6.96,77,402,2440,11.4
7168,Dave Reid,1995-96,31.0,13,36,65,65,20,16,36,116.0,,419,88,102,190,610.0,84,7.25,87,443,2603,11.7
7169,Dave Reid,1996-97,32.0,14,23,83,83,6,17,23,145.0,,502,94,119,213,755.0,84,6.48,76,407,2545,10.7
7170,Dave Reid,1997-98,33.0,15,10,38,38,5,5,10,47.0,,540,99,124,223,802.0,48,5.97,37,209,1408,10.2
7171,Dave Reid,1998-99,34.0,16,44,63,63,23,21,44,160.0,,603,122,145,267,962.0,82,6.29,74,413,2481,10.4
7172,Dave Reid,1999-00,35.0,17,39,82,82,19,20,39,135.0,,685,141,165,306,1097.0,82,5.83,55,336,2444,9.8
7173,Dave Reid,2000-01,36.0,18,18,65,65,6,12,18,90.0,,750,147,177,324,1187.0,82,5.28,57,380,2242,9.6
7174,Dave Reid,2001-02,37.0,19,17,73,73,6,11,17,81.0,844.0,823,153,188,341,1268.0,82,5.27,57,359,2285,9.4
7175,Dave Reid,2002-03,38.0,20,18,65,65,11,7,18,86.0,971.0,888,164,195,359,1354.0,82,5.49,53,331,2294,9.8
7176,Dave Reid,2003-04,39.0,21,10,73,73,1,9,10,66.0,721.0,961,165,204,369,1420.0,82,5.51,63,376,2272,9.9
7177,Dave Reierson,1991-92,27.0,4,0,2,2,0,0,0,1.0,,2,0,0,0,1.0,80,7.48,85,403,2430,12.3
7178,Dave Richter,1984-85,24.0,4,0,3,3,0,0,0,1.0,,3,0,0,0,1.0,80,8.03,73,320,2489,12.9
7179,Dave Richter,1985-86,25.0,5,0,6,6,0,0,0,3.0,,9,0,0,0,4.0,80,7.73,71,310,2444,12.7
7180,Dave Richter,1986-87,26.0,6,5,42,42,2,3,5,22.0,,51,2,3,5,26.0,80,7.89,74,336,2448,12.9
7181,Dave Richter,1987-88,27.0,7,10,55,55,2,8,10,29.0,,106,4,11,15,55.0,80,7.77,71,321,2447,12.7
7182,Dave Richter,1988-89,28.0,8,5,64,64,0,5,5,22.0,,170,4,16,20,77.0,80,7.94,82,370,2484,12.8
7183,Dave Richter,1989-90,29.0,9,17,78,78,2,15,17,35.0,,248,6,31,37,112.0,80,7.34,72,344,2400,12.2
7184,Dave Richter,1990-91,30.0,10,6,49,49,2,4,6,18.0,,297,8,35,43,130.0,80,7.43,89,437,2435,12.2
7185,Dave Richter,1991-92,31.0,11,6,66,66,1,5,6,23.0,,363,9,40,49,153.0,80,7.48,85,403,2430,12.3
7186,Dave Richter,1992-93,32.0,12,0,2,2,0,0,0,3.0,,365,9,40,49,156.0,80,7.37,76,367,2421,12.2
7187,Dave Roche,1998-99,23.0,4,14,71,71,7,7,14,65.0,,71,7,7,14,65.0,82,6.29,74,413,2481,10.4
7188,Dave Roche,1999-00,24.0,5,10,61,61,5,5,10,53.0,,132,12,12,24,118.0,82,5.83,55,336,2444,9.8
7189,Dave Roche,2001-02,26.0,6,6,36,36,3,3,6,30.0,261.0,168,15,15,30,148.0,82,5.27,57,359,2285,9.4
7190,Dave Roche,2002-03,27.0,7,0,2,2,0,0,0,3.0,17.0,170,15,15,30,151.0,82,5.49,53,331,2294,9.8
7191,Dave Roche,2004-05,29.0,8,0,1,1,0,0,0,0.0,3.0,171,15,15,30,151.0,82,5.24,53,338,2262,9.5
7192,Dave Scatchard,2000-01,24.0,4,24,76,76,13,11,24,85.0,,76,13,11,24,85.0,82,5.28,57,380,2242,9.6
7193,Dave Scatchard,2001-02,25.0,5,26,82,82,13,13,26,130.0,1129.0,158,26,24,50,215.0,82,5.27,57,359,2285,9.4
7194,Dave Scatchard,2002-03,26.0,6,30,65,65,12,18,30,128.0,817.0,223,38,42,80,343.0,82,5.49,53,331,2294,9.8
7195,Dave Scatchard,2003-04,27.0,7,45,81,81,21,24,45,176.0,1363.0,304,59,66,125,519.0,82,5.51,63,376,2272,9.9
7196,Dave Scatchard,2004-05,28.0,8,27,80,80,12,15,27,117.0,1001.0,384,71,81,152,636.0,82,5.24,53,338,2262,9.5
7197,Dave Scatchard,2005-06,29.0,9,45,81,81,27,18,45,165.0,1174.0,465,98,99,197,801.0,82,5.31,60,363,2326,9.4
7198,Dave Scatchard,2006-07,30.0,10,25,61,61,9,16,25,111.0,989.0,526,107,115,222,912.0,82,5.14,57,348,2300,9.2
7199,Dave Scatchard,2008-09,32.0,11,33,63,63,15,18,33,121.0,964.0,589,122,133,255,1033.0,82,6.05,85,480,2458,10.1
7200,Dave Scatchard,2009-10,33.0,12,8,46,46,3,5,8,77.0,622.0,635,125,138,263,1110.0,82,5.76,70,398,2426,9.7
7201,Dave Scatchard,2012-13,36.0,13,5,16,16,3,2,5,25.0,171.0,651,128,140,268,1135.0,82,5.53,56,304,2486,9.1
7202,Dave Scatchard,2013-14,37.0,14,1,8,8,0,1,1,6.0,38.0,659,128,141,269,1141.0,82,5.46,52,291,2492,9.0
7203,Dave Semenko,1982-83,25.0,4,13,67,67,6,7,13,43.0,,67,6,7,13,43.0,80,7.03,61,280,2352,12.0
7204,Dave Semenko,1983-84,26.0,5,19,58,58,11,8,19,42.0,,125,17,15,32,85.0,80,7.69,77,340,2441,12.6
7205,Dave Semenko,1984-85,27.0,6,24,59,59,12,12,24,54.0,,184,29,27,56,139.0,80,8.03,73,320,2489,12.9
7206,Dave Semenko,1985-86,28.0,7,27,75,75,12,15,27,70.0,,259,41,42,83,209.0,80,7.73,71,310,2444,12.7
7207,Dave Semenko,1986-87,29.0,8,17,52,52,6,11,17,36.0,,311,47,53,100,245.0,80,7.89,74,336,2448,12.9
7208,Dave Semenko,1987-88,30.0,9,18,69,69,6,12,18,50.0,,380,53,65,118,295.0,80,7.77,71,321,2447,12.7
7209,Dave Semenko,1988-89,31.0,10,18,69,69,6,12,18,51.0,,449,59,77,136,346.0,80,7.94,82,370,2484,12.8
7210,Dave Semenko,1989-90,32.0,11,12,56,56,4,8,12,33.0,,505,63,85,148,379.0,80,7.34,72,344,2400,12.2
7211,Dave Semenko,1990-91,33.0,12,5,70,70,2,3,5,12.0,,575,65,88,153,391.0,80,7.43,89,437,2435,12.2
7212,Dave Silk,1982-83,25.0,4,0,2,2,0,0,0,4.0,,2,0,0,0,4.0,80,7.03,61,280,2352,12.0
7213,Dave Silk,1983-84,26.0,5,26,59,59,14,12,26,124.0,,61,14,12,26,128.0,80,7.69,77,340,2441,12.6
7214,Dave Silk,1984-85,27.0,6,35,64,64,15,20,35,111.0,,125,29,32,61,239.0,80,8.03,73,320,2489,12.9
7215,Dave Silk,1985-86,28.0,7,2,16,16,1,1,2,10.0,,141,30,33,63,249.0,80,7.73,71,310,2444,12.7
7216,Dave Silk,1986-87,29.0,8,30,35,35,13,17,30,62.0,,176,43,50,93,311.0,80,7.89,74,336,2448,12.9
7217,Dave Silk,1987-88,30.0,9,14,41,41,9,5,14,47.0,,217,52,55,107,358.0,80,7.77,71,321,2447,12.7
7218,Dave Silk,1988-89,31.0,10,6,32,32,2,4,6,30.0,,249,54,59,113,388.0,80,7.94,82,370,2484,12.8
7219,Dave Snuggerud,1992-93,26.0,4,30,80,80,14,16,30,120.0,,80,14,16,30,120.0,80,7.37,76,367,2421,12.2
7220,Dave Snuggerud,1993-94,27.0,5,24,80,80,9,15,24,128.0,,160,23,31,54,248.0,80,6.91,71,366,2385,11.6
7221,Dave Snuggerud,1994-95,28.0,6,19,66,66,3,16,19,94.0,,226,26,47,73,342.0,80,6.96,77,402,2440,11.4
7222,Dave Snuggerud,1995-96,29.0,7,11,39,39,4,7,11,61.0,,265,30,54,84,403.0,84,7.25,87,443,2603,11.7
7223,Dave Thomlinson,1992-93,26.0,4,3,19,19,1,2,3,17.0,,19,1,2,3,17.0,80,7.37,76,367,2421,12.2
7224,Dave Thomlinson,1993-94,27.0,5,0,3,3,0,0,0,0.0,,22,1,2,3,17.0,80,6.91,71,366,2385,11.6
7225,Dave Thomlinson,1994-95,28.0,6,1,12,12,0,1,1,12.0,,34,1,3,4,29.0,80,6.96,77,402,2440,11.4
7226,Dave Thomlinson,1996-97,30.0,7,0,7,7,0,0,0,6.0,,41,1,3,4,35.0,84,6.48,76,407,2545,10.7
7227,Dave Thomlinson,1997-98,31.0,8,0,1,1,0,0,0,0.0,,42,1,3,4,35.0,48,5.97,37,209,1408,10.2
7228,Dave Tippett,1986-87,25.0,4,6,17,17,4,2,6,25.0,,17,4,2,6,25.0,80,7.89,74,336,2448,12.9
7229,Dave Tippett,1987-88,26.0,5,19,80,80,7,12,19,98.0,,97,11,14,25,123.0,80,7.77,71,321,2447,12.7
7230,Dave Tippett,1988-89,27.0,6,34,80,80,14,20,34,117.0,,177,25,34,59,240.0,80,7.94,82,370,2484,12.8
7231,Dave Tippett,1989-90,28.0,7,31,80,80,9,22,31,120.0,,257,34,56,90,360.0,80,7.34,72,344,2400,12.2
7232,Dave Tippett,1990-91,29.0,8,37,80,80,16,21,37,126.0,,337,50,77,127,486.0,80,7.43,89,437,2435,12.2
7233,Dave Tippett,1991-92,30.0,9,41,80,80,17,24,41,165.0,,417,67,101,168,651.0,80,7.48,85,403,2430,12.3
7234,Dave Tippett,1992-93,31.0,10,27,66,66,8,19,27,91.0,,483,75,120,195,742.0,80,7.37,76,367,2421,12.2
7235,Dave Tippett,1993-94,32.0,11,15,61,61,6,9,15,68.0,,544,81,129,210,810.0,80,6.91,71,366,2385,11.6
7236,Dave Tippett,1994-95,33.0,12,12,30,30,2,10,12,26.0,,574,83,139,222,836.0,80,6.96,77,402,2440,11.4
7237,Dave Tippett,1995-96,34.0,13,25,74,74,6,19,25,64.0,,648,89,158,247,900.0,84,7.25,87,443,2603,11.7
7238,Dave Tippett,1996-97,35.0,14,15,73,73,4,11,15,45.0,,721,93,169,262,945.0,84,6.48,76,407,2545,10.7
7239,Dave Tomlinson,1994-95,25.0,4,0,3,3,0,0,0,6.0,,3,0,0,0,6.0,80,6.96,77,402,2440,11.4
7240,Dave Tomlinson,1995-96,26.0,5,0,3,3,0,0,0,1.0,,6,0,0,0,7.0,84,7.25,87,443,2603,11.7
7241,Dave Tomlinson,1996-97,27.0,6,4,31,31,1,3,4,29.0,,37,1,3,4,36.0,84,6.48,76,407,2545,10.7
7242,Dave Tomlinson,1997-98,28.0,7,0,5,5,0,0,0,0.0,,42,1,3,4,36.0,48,5.97,37,209,1408,10.2
7243,Dave Watson,1982-83,24.0,4,0,5,5,0,0,0,1.0,,5,0,0,0,1.0,80,7.03,61,280,2352,12.0
7244,Dave Watson,1983-84,25.0,5,1,13,13,0,1,1,6.0,,18,0,1,1,7.0,80,7.69,77,340,2441,12.6
7245,David Backes,2009-10,25.0,4,23,49,49,10,13,23,89.0,657.0,49,10,13,23,89.0,82,5.76,70,398,2426,9.7
7246,David Backes,2010-11,26.0,5,31,72,72,13,18,31,129.0,1057.0,121,23,31,54,218.0,82,5.44,62,351,2383,9.4
7247,David Backes,2011-12,27.0,6,54,82,82,31,23,54,208.0,1451.0,203,54,54,108,426.0,82,5.7,65,341,2477,9.4
7248,David Backes,2012-13,28.0,7,48,79,79,17,31,48,163.0,1446.0,282,71,85,156,589.0,82,5.53,56,304,2486,9.1
7249,David Backes,2013-14,29.0,8,62,82,82,31,31,62,211.0,1616.0,364,102,116,218,800.0,82,5.46,52,291,2492,9.0
7250,David Backes,2014-15,30.0,9,54,82,82,24,30,54,234.0,1640.0,446,126,146,272,1034.0,82,5.32,47,271,2439,8.9
7251,David Backes,2015-16,31.0,10,28,48,48,6,22,28,100.0,941.0,494,132,168,300,1134.0,48,5.31,29,160,1399,9.1
7252,David Backes,2016-17,32.0,11,57,74,74,27,30,57,165.0,1447.0,568,159,198,357,1299.0,82,5.34,48,269,2463,8.9
7253,David Backes,2017-18,33.0,12,58,80,80,26,32,58,183.0,1491.0,648,185,230,415,1482.0,82,5.32,47,251,2453,8.9
7254,David Backes,2018-19,34.0,13,45,79,79,21,24,45,168.0,1519.0,727,206,254,460,1650.0,82,5.34,48,255,2438,9.0
7255,David Backes,2019-20,35.0,14,38,74,74,17,21,38,175.0,1267.0,801,223,275,498,1825.0,82,5.45,47,245,2478,9.0
7256,David Backes,2020-21,36.0,15,33,57,57,14,19,33,160.0,878.0,858,237,294,531,1985.0,82,5.86,50,250,2620,9.2
7257,David Backes,2021-22,37.0,16,20,70,70,7,13,20,129.0,913.0,928,244,307,551,2114.0,82,5.96,47,239,2579,9.5
7258,David Backes,2022-23,38.0,17,6,22,22,1,5,6,34.0,207.0,950,245,312,557,2148.0,70,5.96,42,208,2192,9.5
7259,David Booth,2009-10,25.0,4,10,48,48,3,7,10,86.0,459.0,48,3,7,10,86.0,82,5.76,70,398,2426,9.7
7260,David Booth,2010-11,26.0,5,40,73,73,22,18,40,228.0,1181.0,121,25,25,50,314.0,82,5.44,62,351,2383,9.4
7261,David Booth,2011-12,27.0,6,60,72,72,31,29,60,246.0,1231.0,193,56,54,110,560.0,82,5.7,65,341,2477,9.4
7262,David Booth,2012-13,28.0,7,16,28,28,8,8,16,95.0,508.0,221,64,62,126,655.0,82,5.53,56,304,2486,9.1
7263,David Booth,2013-14,29.0,8,40,82,82,23,17,40,280.0,1550.0,303,87,79,166,935.0,82,5.46,52,291,2492,9.0
7264,David Booth,2014-15,30.0,9,30,62,62,16,14,30,159.0,926.0,365,103,93,196,1094.0,82,5.32,47,271,2439,8.9
7265,David Booth,2015-16,31.0,10,3,12,12,1,2,3,27.0,153.0,377,104,95,199,1121.0,48,5.31,29,160,1399,9.1
7266,David Booth,2016-17,32.0,11,19,66,66,9,10,19,117.0,889.0,443,113,105,218,1238.0,82,5.34,48,269,2463,8.9
7267,David Booth,2017-18,33.0,12,13,59,59,7,6,13,107.0,705.0,502,120,111,231,1345.0,82,5.32,47,251,2453,8.9
7268,David Booth,2020-21,36.0,13,5,28,28,4,1,5,33.0,195.0,530,124,112,236,1378.0,82,5.86,50,250,2620,9.2
7269,David Brine,2010-11,26.0,4,1,9,9,0,1,1,3.0,54.0,9,0,1,1,3.0,82,5.44,62,351,2383,9.4
7270,David Broll,2016-17,24.0,4,1,5,5,0,1,1,3.0,41.0,5,0,1,1,3.0,82,5.34,48,269,2463,8.9
7271,David Bruce,1988-89,24.0,4,1,12,12,0,1,1,17.0,,12,0,1,1,17.0,80,7.94,82,370,2484,12.8
7272,David Bruce,1989-90,25.0,5,16,50,50,9,7,16,76.0,,62,9,8,17,93.0,80,7.34,72,344,2400,12.2
7273,David Bruce,1990-91,26.0,6,10,28,28,7,3,10,46.0,,90,16,11,27,139.0,80,7.43,89,437,2435,12.2
7274,David Bruce,1991-92,27.0,7,14,53,53,7,7,14,86.0,,143,23,18,41,225.0,80,7.48,85,403,2430,12.3
7275,David Bruce,1993-94,29.0,8,3,12,12,1,2,3,23.0,,155,24,20,44,248.0,80,6.91,71,366,2385,11.6
7276,David Bruce,1994-95,30.0,9,38,60,60,22,16,38,137.0,,215,46,36,82,385.0,80,6.96,77,402,2440,11.4
7277,David Bruce,1995-96,31.0,10,5,17,17,2,3,5,36.0,,232,48,39,87,421.0,84,7.25,87,443,2603,11.7
7278,David Bruce,1996-97,32.0,11,0,2,2,0,0,0,5.0,,234,48,39,87,426.0,84,6.48,76,407,2545,10.7
7279,David Clarkson,2009-10,25.0,4,4,7,7,3,1,4,18.0,119.0,7,3,1,4,18.0,82,5.76,70,398,2426,9.7
7280,David Clarkson,2010-11,26.0,5,22,81,81,9,13,22,151.0,975.0,88,12,14,26,169.0,82,5.44,62,351,2383,9.4
7281,David Clarkson,2011-12,27.0,6,32,82,82,17,15,32,158.0,988.0,170,29,29,58,327.0,82,5.7,65,341,2477,9.4
7282,David Clarkson,2012-13,28.0,7,24,46,46,11,13,24,106.0,664.0,216,40,42,82,433.0,82,5.53,56,304,2486,9.1
7283,David Clarkson,2013-14,29.0,8,18,82,82,12,6,18,192.0,1117.0,298,52,48,100,625.0,82,5.46,52,291,2492,9.0
7284,David Clarkson,2014-15,30.0,9,46,80,80,30,16,46,228.0,1309.0,378,82,64,146,853.0,82,5.32,47,271,2439,8.9
7285,David Clarkson,2015-16,31.0,10,24,48,48,15,9,24,180.0,844.0,426,97,73,170,1033.0,48,5.31,29,160,1399,9.1
7286,David Clarkson,2016-17,32.0,11,11,60,60,5,6,11,102.0,906.0,486,102,79,181,1135.0,82,5.34,48,269,2463,8.9
7287,David Clarkson,2017-18,33.0,12,15,61,61,10,5,15,95.0,842.0,547,112,84,196,1230.0,82,5.32,47,251,2453,8.9
7288,David Clarkson,2018-19,34.0,13,4,23,23,2,2,4,24.0,212.0,570,114,86,200,1254.0,82,5.34,48,255,2438,9.0
7289,David Cooper,1999-00,26.0,4,6,19,19,3,3,6,23.0,,19,3,3,6,23.0,82,5.83,55,336,2444,9.8
7290,David Cooper,2000-01,27.0,5,4,9,9,0,4,4,13.0,,28,3,7,10,36.0,82,5.28,57,380,2242,9.6
7291,David Cooper,2003-04,30.0,6,0,2,2,0,0,0,3.0,23.0,30,3,7,10,39.0,82,5.51,63,376,2272,9.9
7292,David Cullen,2003-04,27.0,4,0,2,2,0,0,0,0.0,25.0,2,0,0,0,0.0,82,5.51,63,376,2272,9.9
7293,David Cullen,2004-05,28.0,5,0,17,17,0,0,0,3.0,215.0,19,0,0,0,3.0,82,5.24,53,338,2262,9.5
7294,David Desharnais,2012-13,26.0,4,1,6,6,0,1,1,2.0,51.0,6,0,1,1,2.0,82,5.53,56,304,2486,9.1
7295,David Desharnais,2013-14,27.0,5,22,43,43,8,14,22,55.0,553.0,49,8,15,23,57.0,82,5.46,52,291,2492,9.0
7296,David Desharnais,2014-15,28.0,6,60,81,81,16,44,60,98.0,1490.0,130,24,59,83,155.0,82,5.32,47,271,2439,8.9
7297,David Desharnais,2015-16,29.0,7,28,48,48,10,18,28,66.0,790.0,178,34,77,111,221.0,48,5.31,29,160,1399,9.1
7298,David Desharnais,2016-17,30.0,8,52,79,79,16,36,52,96.0,1359.0,257,50,113,163,317.0,82,5.34,48,269,2463,8.9
7299,David Desharnais,2017-18,31.0,9,48,82,82,14,34,48,90.0,1414.0,339,64,147,211,407.0,82,5.32,47,251,2453,8.9
7300,David Desharnais,2018-19,32.0,10,29,65,65,11,18,29,90.0,1040.0,404,75,165,240,497.0,82,5.34,48,255,2438,9.0
7301,David Desharnais,2019-20,33.0,11,14,49,49,6,8,14,46.0,610.0,453,81,173,254,543.0,82,5.45,47,245,2478,9.0
7302,David Desharnais,2020-21,34.0,12,28,71,71,6,22,28,55.0,927.0,524,87,195,282,598.0,82,5.86,50,250,2620,9.2
7303,David Dziurzynski,2015-16,26.0,4,2,12,12,2,0,2,20.0,151.0,12,2,0,2,20.0,48,5.31,29,160,1399,9.1
7304,David Dziurzynski,2018-19,29.0,5,4,14,14,1,3,4,14.0,141.0,26,3,3,6,34.0,82,5.34,48,255,2438,9.0
7305,David Emma,1995-96,27.0,4,0,2,2,0,0,0,2.0,,2,0,0,0,2.0,84,7.25,87,443,2603,11.7
7306,David Emma,1996-97,28.0,5,10,15,15,5,5,10,24.0,,17,5,5,10,26.0,84,6.48,76,407,2545,10.7
7307,David Emma,1997-98,29.0,6,1,6,6,0,1,1,4.0,,23,5,6,11,30.0,48,5.97,37,209,1408,10.2
7308,David Emma,1999-00,31.0,7,0,5,5,0,0,0,3.0,,28,5,6,11,33.0,82,5.83,55,336,2444,9.8
7309,David Emma,2003-04,35.0,8,0,6,6,0,0,0,6.0,44.0,34,5,6,11,39.0,82,5.51,63,376,2272,9.9
7310,David Fenyves,1985-86,25.0,4,8,24,24,0,8,8,20.0,,24,0,8,8,20.0,80,7.73,71,310,2444,12.7
7311,David Fenyves,1986-87,26.0,5,4,10,10,0,4,4,4.0,,34,0,12,12,24.0,80,7.89,74,336,2448,12.9
7312,David Fenyves,1987-88,27.0,6,9,60,60,1,8,9,50.0,,94,1,20,21,74.0,80,7.77,71,321,2447,12.7
7313,David Fenyves,1988-89,28.0,7,7,47,47,0,7,7,31.0,,141,1,27,28,105.0,80,7.94,82,370,2484,12.8
7314,David Fenyves,1989-90,29.0,8,1,7,7,1,0,1,3.0,,148,2,27,29,108.0,80,7.34,72,344,2400,12.2
7315,David Fenyves,1990-91,30.0,9,0,5,5,0,0,0,3.0,,153,2,27,29,111.0,80,7.43,89,437,2435,12.2
7316,David Fenyves,1991-92,31.0,10,1,1,1,0,1,1,0.0,,154,2,28,30,111.0,80,7.48,85,403,2430,12.3
7317,David Fenyves,1992-93,32.0,11,0,12,12,0,0,0,10.0,,166,2,28,30,121.0,80,7.37,76,367,2421,12.2
7318,David Fenyves,1993-94,33.0,12,5,40,40,1,4,5,32.0,,206,3,32,35,153.0,80,6.91,71,366,2385,11.6
7319,David Gosselin,2002-03,25.0,4,3,10,10,2,1,3,14.0,93.0,10,2,1,3,14.0,82,5.49,53,331,2294,9.8
7320,David Gosselin,2004-05,27.0,5,0,3,3,0,0,0,0.0,21.0,13,2,1,3,14.0,82,5.24,53,338,2262,9.5
7321,David Gove,2008-09,30.0,4,1,1,1,0,1,1,0.0,7.0,1,0,1,1,0.0,82,6.05,85,480,2458,10.1
7322,David Gove,2009-10,31.0,5,0,1,1,0,0,0,0.0,3.0,2,0,1,1,0.0,82,5.76,70,398,2426,9.7
7323,David Gustafsson,2022-23,22.0,4,1,22,22,1,0,1,4.0,135.0,22,1,0,1,4.0,70,5.96,42,208,2192,9.5
7324,David Haas,1993-94,25.0,4,1,5,5,1,0,1,4.0,,5,1,0,1,4.0,80,6.91,71,366,2385,11.6
7325,David Haas,1996-97,28.0,5,2,2,2,1,1,2,3.0,,7,2,1,3,7.0,84,6.48,76,407,2545,10.7
7326,David Hale,2006-07,25.0,4,4,65,65,0,4,4,45.0,976.0,65,0,4,4,45.0,82,5.14,57,348,2300,9.2
7327,David Hale,2008-09,27.0,5,4,38,38,0,4,4,19.0,458.0,103,0,8,8,64.0,82,6.05,85,480,2458,10.1
7328,David Hale,2009-10,28.0,6,1,54,54,0,1,1,33.0,590.0,157,0,9,9,97.0,82,5.76,70,398,2426,9.7
7329,David Hale,2010-11,29.0,7,2,58,58,0,2,2,35.0,805.0,215,0,11,11,132.0,82,5.44,62,351,2383,9.4
7330,David Hale,2011-12,30.0,8,9,48,48,3,6,9,22.0,727.0,263,3,17,20,154.0,82,5.7,65,341,2477,9.4
7331,David Hale,2012-13,31.0,9,4,39,39,0,4,4,25.0,548.0,302,3,21,24,179.0,82,5.53,56,304,2486,9.1
7332,David Hale,2013-14,32.0,10,5,25,25,1,4,5,20.0,408.0,327,4,25,29,199.0,82,5.46,52,291,2492,9.0
7333,David Harlock,1996-97,25.0,4,0,6,6,0,0,0,2.0,,6,0,0,0,2.0,84,6.48,76,407,2545,10.7
7334,David Harlock,1997-98,26.0,5,0,1,1,0,0,0,0.0,,7,0,0,0,2.0,48,5.97,37,209,1408,10.2
7335,David Harlock,1998-99,27.0,6,0,1,1,0,0,0,0.0,,8,0,0,0,2.0,82,6.29,74,413,2481,10.4
7336,David Harlock,2000-01,29.0,7,0,6,6,0,0,0,2.0,,14,0,0,0,4.0,82,5.28,57,380,2242,9.6
7337,David Harlock,2001-02,30.0,8,8,70,70,2,6,8,35.0,1278.0,84,2,6,8,39.0,82,5.27,57,359,2285,9.4
7338,David Harlock,2002-03,31.0,9,6,44,44,0,6,6,29.0,866.0,128,2,12,14,68.0,82,5.49,53,331,2294,9.8
7339,David Harlock,2003-04,32.0,10,1,65,65,0,1,1,26.0,1109.0,193,2,13,15,94.0,82,5.51,63,376,2272,9.9
7340,David Harlock,2004-05,33.0,11,1,19,19,0,1,1,12.0,283.0,212,2,14,16,106.0,82,5.24,53,338,2262,9.5
7341,David Jensen,1986-87,25.0,4,1,8,8,0,1,1,5.0,,8,0,1,1,5.0,80,7.89,74,336,2448,12.9
7342,David Jensen,1987-88,26.0,5,1,5,5,0,1,1,3.0,,13,0,2,2,8.0,80,7.77,71,321,2447,12.7
7343,David Jensen,1988-89,27.0,6,0,5,5,0,0,0,1.0,,18,0,2,2,9.0,80,7.94,82,370,2484,12.8
7344,David Jensen0,1987-88,22.0,4,4,13,13,0,4,4,11.0,,13,0,4,4,11.0,80,7.77,71,321,2447,12.7
7345,David Jensen0,1988-89,23.0,5,1,5,5,1,0,1,5.0,,18,1,4,5,16.0,80,7.94,82,370,2484,12.8
7346,David Jensen0,1989-90,24.0,6,16,46,46,8,8,16,48.0,,64,9,12,21,64.0,80,7.34,72,344,2400,12.2
7347,David Jensen0,1990-91,25.0,7,1,5,5,0,1,1,1.0,,69,9,13,22,65.0,80,7.43,89,437,2435,12.2
7348,David Jones,2010-11,26.0,4,6,27,27,2,4,6,37.0,307.0,27,2,4,6,37.0,82,5.44,62,351,2383,9.4
7349,David Jones,2011-12,27.0,5,13,40,40,8,5,13,47.0,509.0,67,10,9,19,84.0,82,5.7,65,341,2477,9.4
7350,David Jones,2012-13,28.0,6,16,23,23,10,6,16,39.0,412.0,90,20,15,35,123.0,82,5.53,56,304,2486,9.1
7351,David Jones,2013-14,29.0,7,45,77,77,27,18,45,153.0,1361.0,167,47,33,80,276.0,82,5.46,52,291,2492,9.0
7352,David Jones,2014-15,30.0,8,37,72,72,20,17,37,136.0,1134.0,239,67,50,117,412.0,82,5.32,47,271,2439,8.9
7353,David Jones,2015-16,31.0,9,9,33,33,3,6,9,62.0,555.0,272,70,56,126,474.0,48,5.31,29,160,1399,9.1
7354,David Jones,2016-17,32.0,10,17,48,48,9,8,17,104.0,742.0,320,79,64,143,578.0,82,5.34,48,269,2463,8.9
7355,David Jones,2017-18,33.0,11,30,67,67,14,16,30,114.0,961.0,387,93,80,173,692.0,82,5.32,47,251,2453,8.9
7356,David Jones,2018-19,34.0,12,18,75,75,11,7,18,84.0,933.0,462,104,87,191,776.0,82,5.34,48,255,2438,9.0
7357,David Kampf,2020-21,26.0,4,11,46,46,4,7,11,46.0,589.0,46,4,7,11,46.0,82,5.86,50,250,2620,9.2
7358,David Kampf,2021-22,27.0,5,19,63,63,4,15,19,72.0,877.0,109,8,22,30,118.0,82,5.96,47,239,2579,9.5
7359,David Kampf,2022-23,28.0,6,16,70,70,8,8,16,90.0,957.0,179,16,30,46,208.0,70,5.96,42,208,2192,9.5
7360,David Kase,2022-23,26.0,4,1,6,6,1,0,1,5.0,59.0,6,1,0,1,5.0,70,5.96,42,208,2192,9.5
7361,David Koci,2009-10,28.0,4,0,9,9,0,0,0,3.0,43.0,9,0,0,0,3.0,82,5.76,70,398,2426,9.7
7362,David Koci,2010-11,29.0,5,0,18,18,0,0,0,2.0,65.0,27,0,0,0,5.0,82,5.44,62,351,2383,9.4
7363,David Koci,2011-12,30.0,6,2,37,37,1,1,2,13.0,220.0,64,1,1,2,18.0,82,5.7,65,341,2477,9.4
7364,David Koci,2012-13,31.0,7,1,43,43,1,0,1,6.0,131.0,107,2,1,3,24.0,82,5.53,56,304,2486,9.1
7365,David Koci,2013-14,32.0,8,1,35,35,1,0,1,9.0,143.0,142,3,1,4,33.0,82,5.46,52,291,2492,9.0
7366,David Krejci,2009-10,23.0,4,0,6,6,0,0,0,2.0,26.0,6,0,0,0,2.0,82,5.76,70,398,2426,9.7
7367,David Krejci,2010-11,24.0,5,27,56,56,6,21,27,73.0,835.0,62,6,21,27,75.0,82,5.44,62,351,2383,9.4
7368,David Krejci,2011-12,25.0,6,73,82,82,22,51,73,146.0,1382.0,144,28,72,100,221.0,82,5.7,65,341,2477,9.4
7369,David Krejci,2012-13,26.0,7,52,79,79,17,35,52,156.0,1441.0,223,45,107,152,377.0,82,5.53,56,304,2486,9.1
7370,David Krejci,2013-14,27.0,8,62,75,75,13,49,62,157.0,1414.0,298,58,156,214,534.0,82,5.46,52,291,2492,9.0
7371,David Krejci,2014-15,28.0,9,62,79,79,23,39,62,145.0,1455.0,377,81,195,276,679.0,82,5.32,47,271,2439,8.9
7372,David Krejci,2015-16,29.0,10,33,47,47,10,23,33,93.0,870.0,424,91,218,309,772.0,48,5.31,29,160,1399,9.1
7373,David Krejci,2016-17,30.0,11,69,80,80,19,50,69,169.0,1530.0,504,110,268,378,941.0,82,5.34,48,269,2463,8.9
7374,David Krejci,2017-18,31.0,12,31,47,47,7,24,31,70.0,854.0,551,117,292,409,1011.0,82,5.32,47,251,2453,8.9
7375,David Krejci,2018-19,32.0,13,63,72,72,17,46,63,143.0,1462.0,623,134,338,472,1154.0,82,5.34,48,255,2438,9.0
7376,David Krejci,2019-20,33.0,14,54,82,82,23,31,54,158.0,1498.0,705,157,369,526,1312.0,82,5.45,47,245,2478,9.0
7377,David Krejci,2020-21,34.0,15,44,64,64,17,27,44,119.0,1080.0,769,174,396,570,1431.0,82,5.86,50,250,2620,9.2
7378,David Krejci,2021-22,35.0,16,73,81,81,20,53,73,139.0,1432.0,850,194,449,643,1570.0,82,5.96,47,239,2579,9.5
7379,David Krejci,2022-23,36.0,17,43,61,61,13,30,43,83.0,1048.0,911,207,479,686,1653.0,70,5.96,42,208,2192,9.5
7380,David Laliberte,2012-13,26.0,4,3,11,11,2,1,3,8.0,86.0,11,2,1,3,8.0,82,5.53,56,304,2486,9.1
7381,David Latta,1988-89,22.0,4,0,1,1,0,0,0,1.0,,1,0,0,0,1.0,80,7.94,82,370,2484,12.8
7382,David Latta,1990-91,24.0,5,0,10,10,0,0,0,13.0,,11,0,0,0,14.0,80,7.43,89,437,2435,12.2
7383,David Latta,1991-92,25.0,6,12,24,24,4,8,12,30.0,,35,4,8,12,44.0,80,7.48,85,403,2430,12.3
7384,David Latta,1993-94,27.0,7,0,1,1,0,0,0,1.0,,36,4,8,12,45.0,80,6.91,71,366,2385,11.6
7385,David Legwand,2001-02,21.0,4,0,1,1,0,0,0,2.0,13.0,1,0,0,0,2.0,82,5.27,57,359,2285,9.4
7386,David Legwand,2002-03,22.0,5,28,71,71,13,15,28,111.0,1045.0,72,13,15,28,113.0,82,5.49,53,331,2294,9.8
7387,David Legwand,2003-04,23.0,6,41,81,81,13,28,41,172.0,1234.0,153,26,43,69,285.0,82,5.51,63,376,2272,9.9
7388,David Legwand,2004-05,24.0,7,30,63,63,11,19,30,121.0,1034.0,216,37,62,99,406.0,82,5.24,53,338,2262,9.5
7389,David Legwand,2005-06,25.0,8,48,64,64,17,31,48,167.0,1231.0,280,54,93,147,573.0,82,5.31,60,363,2326,9.4
7390,David Legwand,2006-07,26.0,9,47,82,82,18,29,47,165.0,1417.0,362,72,122,194,738.0,82,5.14,57,348,2300,9.2
7391,David Legwand,2008-09,28.0,10,26,44,44,7,19,26,109.0,741.0,406,79,141,220,847.0,82,6.05,85,480,2458,10.1
7392,David Legwand,2009-10,29.0,11,63,78,78,27,36,63,153.0,1432.0,484,106,177,283,1000.0,82,5.76,70,398,2426,9.7
7393,David Legwand,2010-11,30.0,12,44,65,65,15,29,44,144.0,1171.0,549,121,206,327,1144.0,82,5.44,62,351,2383,9.4
7394,David Legwand,2011-12,31.0,13,42,73,73,20,22,42,175.0,1419.0,622,141,228,369,1319.0,82,5.7,65,341,2477,9.4
7395,David Legwand,2012-13,32.0,14,38,82,82,11,27,38,151.0,1534.0,704,152,255,407,1470.0,82,5.53,56,304,2486,9.1
7396,David Legwand,2013-14,33.0,15,41,64,64,17,24,41,130.0,1204.0,768,169,279,448,1600.0,82,5.46,52,291,2492,9.0
7397,David Legwand,2014-15,34.0,16,53,78,78,19,34,53,140.0,1445.0,846,188,313,501,1740.0,82,5.32,47,271,2439,8.9
7398,David Legwand,2015-16,35.0,17,25,48,48,12,13,25,78.0,884.0,894,200,326,526,1818.0,48,5.31,29,160,1399,9.1
7399,David Legwand,2016-17,36.0,18,51,83,83,14,37,51,146.0,1409.0,977,214,363,577,1964.0,82,5.34,48,269,2463,8.9
7400,David Legwand,2017-18,37.0,19,27,80,80,9,18,27,91.0,1112.0,1057,223,381,604,2055.0,82,5.32,47,251,2453,8.9
7401,David Legwand,2018-19,38.0,20,14,79,79,5,9,14,61.0,767.0,1136,228,390,618,2116.0,82,5.34,48,255,2438,9.0
7402,David Liffiton,2008-09,24.0,4,0,1,1,0,0,0,0.0,9.0,1,0,0,0,0.0,82,6.05,85,480,2458,10.1
7403,David Liffiton,2009-10,25.0,5,0,2,2,0,0,0,2.0,23.0,3,0,0,0,2.0,82,5.76,70,398,2426,9.7
7404,David Liffiton,2013-14,29.0,6,1,4,4,1,0,1,2.0,30.0,7,1,0,1,4.0,82,5.46,52,291,2492,9.0
7405,David Ling,1999-00,25.0,4,0,2,2,0,0,0,0.0,,2,0,0,0,0.0,82,5.83,55,336,2444,9.8
7406,David Ling,2000-01,26.0,5,0,1,1,0,0,0,1.0,,3,0,0,0,1.0,82,5.28,57,380,2242,9.6
7407,David Ling,2004-05,30.0,6,0,5,5,0,0,0,5.0,49.0,8,0,0,0,6.0,82,5.24,53,338,2262,9.5
7408,David Ling,2005-06,31.0,7,5,35,35,3,2,5,37.0,278.0,43,3,2,5,43.0,82,5.31,60,363,2326,9.4
7409,David Ling,2006-07,32.0,8,3,50,50,1,2,3,45.0,388.0,93,4,4,8,88.0,82,5.14,57,348,2300,9.2
7410,David Mackey,1990-91,24.0,4,4,23,23,1,3,4,23.0,,23,1,3,4,23.0,80,7.43,89,437,2435,12.2
7411,David Mackey,1991-92,25.0,5,3,23,23,1,2,3,15.0,,46,2,5,7,38.0,80,7.48,85,403,2430,12.3
7412,David Mackey,1992-93,26.0,6,2,16,16,2,0,2,8.0,,62,4,5,9,46.0,80,7.37,76,367,2421,12.2
7413,David Mackey,1994-95,28.0,7,1,19,19,1,0,1,12.0,,81,5,5,10,58.0,80,6.96,77,402,2440,11.4
7414,David Mackey,1995-96,29.0,8,5,15,15,1,4,5,17.0,,96,6,9,15,75.0,84,7.25,87,443,2603,11.7
7415,David Mackey,1996-97,30.0,9,5,30,30,2,3,5,21.0,,126,8,12,20,96.0,84,6.48,76,407,2545,10.7
7416,David Maley,1988-89,25.0,4,0,3,3,0,0,0,0.0,,3,0,0,0,0.0,80,7.94,82,370,2484,12.8
7417,David Maley,1989-90,26.0,5,18,48,48,6,12,18,44.0,,51,6,12,18,44.0,80,7.34,72,344,2400,12.2
7418,David Maley,1990-91,27.0,6,6,44,44,4,2,6,44.0,,95,10,14,24,88.0,80,7.43,89,437,2435,12.2
7419,David Maley,1991-92,28.0,7,11,68,68,5,6,11,63.0,,163,15,20,35,151.0,80,7.48,85,403,2430,12.3
7420,David Maley,1992-93,29.0,8,25,67,67,8,17,25,82.0,,230,23,37,60,233.0,80,7.37,76,367,2421,12.2
7421,David Maley,1993-94,30.0,9,22,64,64,8,14,22,67.0,,294,31,51,82,300.0,80,6.91,71,366,2385,11.6
7422,David Maley,1994-95,31.0,10,27,60,60,10,17,27,73.0,,354,41,68,109,373.0,80,6.96,77,402,2440,11.4
7423,David Maley,1995-96,32.0,11,9,56,56,2,7,9,57.0,,410,43,75,118,430.0,84,7.25,87,443,2603,11.7
7424,David Maley,1996-97,33.0,12,6,56,56,0,6,6,23.0,,466,43,81,124,453.0,84,6.48,76,407,2545,10.7
7425,David McIntyre,2014-15,27.0,4,2,7,7,1,1,2,6.0,76.0,7,1,1,2,6.0,82,5.32,47,271,2439,8.9
7426,David Moravec,2002-03,29.0,4,0,1,1,0,0,0,2.0,15.0,1,0,0,0,2.0,82,5.49,53,331,2294,9.8
7427,David Musil,2017-18,24.0,4,2,4,4,0,2,2,3.0,79.0,4,0,2,2,3.0,82,5.32,47,251,2453,8.9
7428,David Nemirovsky,1998-99,22.0,4,2,9,9,0,2,2,6.0,,9,0,2,2,6.0,82,6.29,74,413,2481,10.4
7429,David Nemirovsky,1999-00,23.0,5,14,39,39,7,7,14,53.0,,48,7,9,16,59.0,82,5.83,55,336,2444,9.8
7430,David Nemirovsky,2000-01,24.0,6,21,41,41,9,12,21,62.0,,89,16,21,37,121.0,82,5.28,57,380,2242,9.6
7431,David Nemirovsky,2001-02,25.0,7,1,2,2,0,1,1,2.0,18.0,91,16,22,38,123.0,82,5.27,57,359,2285,9.4
7432,David Oliver,1997-98,26.0,4,30,44,44,16,14,30,79.0,,44,16,14,30,79.0,48,5.97,37,209,1408,10.2
7433,David Oliver,1998-99,27.0,5,39,80,80,20,19,39,131.0,,124,36,33,69,210.0,82,6.29,74,413,2481,10.4
7434,David Oliver,1999-00,28.0,6,6,31,31,3,3,6,35.0,,155,39,36,75,245.0,82,5.83,55,336,2444,9.8
7435,David Oliver,2001-02,30.0,7,7,17,17,2,5,7,18.0,180.0,172,41,41,82,263.0,82,5.27,57,359,2285,9.4
7436,David Oliver,2002-03,31.0,8,1,9,9,1,0,1,6.0,69.0,181,42,41,83,269.0,82,5.49,53,331,2294,9.8
7437,David Oliver,2003-04,32.0,9,0,7,7,0,0,0,2.0,39.0,188,42,41,83,271.0,82,5.51,63,376,2272,9.9
7438,David Oliver,2005-06,34.0,10,3,6,6,0,3,3,5.0,55.0,194,42,44,86,276.0,82,5.31,60,363,2326,9.4
7439,David Oliver,2006-07,35.0,11,12,36,36,7,5,12,30.0,355.0,230,49,49,98,306.0,82,5.14,57,348,2300,9.2
7440,David Oliver,2008-09,37.0,12,0,3,3,0,0,0,1.0,23.0,233,49,49,98,307.0,82,6.05,85,480,2458,10.1
7441,David Pastrnak,2017-18,21.0,4,27,46,46,10,17,27,93.0,643.0,46,10,17,27,93.0,82,5.32,47,251,2453,8.9
7442,David Pastrnak,2018-19,22.0,5,26,51,51,15,11,26,108.0,711.0,97,25,28,53,201.0,82,5.34,48,255,2438,9.0
7443,David Pastrnak,2019-20,23.0,6,70,75,75,34,36,70,262.0,1349.0,172,59,64,123,463.0,82,5.45,47,245,2478,9.0
7444,David Pastrnak,2020-21,24.0,7,80,82,82,35,45,80,246.0,1473.0,254,94,109,203,709.0,82,5.86,50,250,2620,9.2
7445,David Pastrnak,2021-22,25.0,8,81,66,66,38,43,81,235.0,1238.0,320,132,152,284,944.0,82,5.96,47,239,2579,9.5
7446,David Pastrnak,2022-23,26.0,9,95,70,70,48,47,95,279.0,1327.0,390,180,199,379,1223.0,70,5.96,42,208,2192,9.5
7447,David Perron,2010-11,22.0,4,27,62,62,13,14,27,68.0,778.0,62,13,14,27,68.0,82,5.44,62,351,2383,9.4
7448,David Perron,2011-12,23.0,5,50,81,81,15,35,50,161.0,1177.0,143,28,49,77,229.0,82,5.7,65,341,2477,9.4
7449,David Perron,2012-13,24.0,6,47,82,82,20,27,47,166.0,1325.0,225,48,76,124,395.0,82,5.53,56,304,2486,9.1
7450,David Perron,2013-14,25.0,7,7,10,10,5,2,7,29.0,184.0,235,53,78,131,424.0,82,5.46,52,291,2492,9.0
7451,David Perron,2014-15,26.0,8,42,57,57,21,21,42,114.0,1042.0,292,74,99,173,538.0,82,5.32,47,271,2439,8.9
7452,David Perron,2015-16,27.0,9,25,48,48,10,15,25,84.0,864.0,340,84,114,198,622.0,48,5.31,29,160,1399,9.1
7453,David Perron,2016-17,28.0,10,57,78,78,28,29,57,220.0,1492.0,418,112,143,255,842.0,82,5.34,48,269,2463,8.9
7454,David Perron,2017-18,29.0,11,41,81,81,17,24,41,196.0,1404.0,499,129,167,296,1038.0,82,5.32,47,251,2453,8.9
7455,David Perron,2018-19,30.0,12,36,71,71,12,24,36,147.0,1080.0,570,141,191,332,1185.0,82,5.34,48,255,2438,9.0
7456,David Perron,2019-20,31.0,13,46,82,82,18,28,46,151.0,1418.0,652,159,219,378,1336.0,82,5.45,47,245,2478,9.0
7457,David Perron,2020-21,32.0,14,66,70,70,16,50,66,125.0,1247.0,722,175,269,444,1461.0,82,5.86,50,250,2620,9.2
7458,David Perron,2021-22,33.0,15,46,57,57,23,23,46,112.0,974.0,779,198,292,490,1573.0,82,5.96,47,239,2579,9.5
7459,David Perron,2022-23,34.0,16,60,71,71,25,35,60,166.0,1300.0,850,223,327,550,1739.0,70,5.96,42,208,2192,9.5
7460,David Printz,2008-09,28.0,4,0,1,1,0,0,0,0.0,6.0,1,0,0,0,0.0,82,6.05,85,480,2458,10.1
7461,David Printz,2009-10,29.0,5,0,12,12,0,0,0,1.0,79.0,13,0,0,0,1.0,82,5.76,70,398,2426,9.7
7462,David Roberts,1996-97,26.0,4,0,1,1,0,0,0,1.0,,1,0,0,0,1.0,84,6.48,76,407,2545,10.7
7463,David Roberts,1997-98,27.0,5,11,19,19,6,5,11,41.0,,20,6,5,11,42.0,48,5.97,37,209,1408,10.2
7464,David Roberts,1998-99,28.0,6,13,34,34,3,10,13,47.0,,54,9,15,24,89.0,82,6.29,74,413,2481,10.4
7465,David Roberts,1999-00,29.0,7,27,58,58,10,17,27,74.0,,112,19,32,51,163.0,82,5.83,55,336,2444,9.8
7466,David Roberts,2000-01,30.0,8,2,13,13,1,1,2,14.0,,125,20,33,53,177.0,82,5.28,57,380,2242,9.6
7467,David Rundblad,2014-15,24.0,4,7,30,30,1,6,7,34.0,450.0,30,1,6,7,34.0,82,5.32,47,271,2439,8.9
7468,David Rundblad,2015-16,25.0,5,1,8,8,0,1,1,9.0,110.0,38,1,7,8,43.0,48,5.31,29,160,1399,9.1
7469,David Rundblad,2016-17,26.0,6,1,17,17,0,1,1,21.0,234.0,55,1,8,9,64.0,82,5.34,48,269,2463,8.9
7470,David Rundblad,2017-18,27.0,7,14,49,49,3,11,14,58.0,627.0,104,4,19,23,122.0,82,5.32,47,251,2453,8.9
7471,David Rundblad,2018-19,28.0,8,2,9,9,0,2,2,13.0,129.0,113,4,21,25,135.0,82,5.34,48,255,2438,9.0
7472,David Sacco,1996-97,26.0,4,2,4,4,1,1,2,4.0,,4,1,1,2,4.0,84,6.48,76,407,2545,10.7
7473,David Sacco,1997-98,27.0,5,2,8,8,0,2,2,5.0,,12,1,3,4,9.0,48,5.97,37,209,1408,10.2
7474,David Sacco,1998-99,28.0,6,14,23,23,4,10,14,26.0,,35,5,13,18,35.0,82,6.29,74,413,2481,10.4
7475,David Saunders,1990-91,24.0,4,20,56,56,7,13,20,100.0,,56,7,13,20,100.0,80,7.43,89,437,2435,12.2
7476,David Savard,2014-15,24.0,4,10,31,31,2,8,10,34.0,514.0,31,2,8,10,34.0,82,5.32,47,271,2439,8.9
7477,David Savard,2015-16,25.0,5,0,4,4,0,0,0,1.0,53.0,35,2,8,10,35.0,48,5.31,29,160,1399,9.1
7478,David Savard,2016-17,26.0,6,15,70,70,5,10,15,63.0,1248.0,105,7,18,25,98.0,82,5.34,48,269,2463,8.9
7479,David Savard,2017-18,27.0,7,36,82,82,11,25,36,112.0,1881.0,187,18,43,61,210.0,82,5.32,47,251,2453,8.9
7480,David Savard,2018-19,28.0,8,25,65,65,4,21,25,122.0,1506.0,252,22,64,86,332.0,82,5.34,48,255,2438,9.0
7481,David Savard,2019-20,29.0,9,23,74,74,6,17,23,135.0,1616.0,326,28,81,109,467.0,82,5.45,47,245,2478,9.0
7482,David Savard,2020-21,30.0,10,16,81,81,4,12,16,145.0,1570.0,407,32,93,125,612.0,82,5.86,50,250,2620,9.2
7483,David Savard,2021-22,31.0,11,24,82,82,8,16,24,124.0,1619.0,489,40,109,149,736.0,82,5.96,47,239,2579,9.5
7484,David Savard,2022-23,32.0,12,11,68,68,0,11,11,97.0,1407.0,557,40,120,160,833.0,70,5.96,42,208,2192,9.5
7485,David Schlemko,2011-12,24.0,4,1,3,3,0,1,1,3.0,58.0,3,0,1,1,3.0,82,5.7,65,341,2477,9.4
7486,David Schlemko,2012-13,25.0,5,5,17,17,1,4,5,19.0,303.0,20,1,5,6,22.0,82,5.53,56,304,2486,9.1
7487,David Schlemko,2013-14,26.0,6,14,43,43,4,10,14,47.0,690.0,63,5,15,20,69.0,82,5.46,52,291,2492,9.0
7488,David Schlemko,2014-15,27.0,7,11,46,46,1,10,11,58.0,844.0,109,6,25,31,127.0,82,5.32,47,271,2439,8.9
7489,David Schlemko,2015-16,28.0,8,6,30,30,1,5,6,35.0,517.0,139,7,30,37,162.0,48,5.31,29,160,1399,9.1
7490,David Schlemko,2016-17,29.0,9,9,48,48,1,8,9,61.0,787.0,187,8,38,46,223.0,82,5.34,48,269,2463,8.9
7491,David Schlemko,2017-18,30.0,10,4,44,44,1,3,4,45.0,675.0,231,9,41,50,268.0,82,5.32,47,251,2453,8.9
7492,David Schlemko,2018-19,31.0,11,19,67,67,6,13,19,104.0,1249.0,298,15,54,69,372.0,82,5.34,48,255,2438,9.0
7493,David Schlemko,2019-20,32.0,12,18,62,62,2,16,18,118.0,1038.0,360,17,70,87,490.0,82,5.45,47,245,2478,9.0
7494,David Schlemko,2020-21,33.0,13,5,37,37,1,4,5,38.0,668.0,397,18,74,92,528.0,82,5.86,50,250,2620,9.2
7495,David Schlemko,2021-22,34.0,14,2,18,18,0,2,2,29.0,357.0,415,18,76,94,557.0,82,5.96,47,239,2579,9.5
7496,David Shaw,1985-86,21.0,4,0,2,2,0,0,0,0.0,,2,0,0,0,0.0,80,7.73,71,310,2444,12.7
7497,David Shaw,1986-87,22.0,5,0,3,3,0,0,0,3.0,,5,0,0,0,3.0,80,7.89,74,336,2448,12.9
7498,David Shaw,1987-88,23.0,6,0,14,14,0,0,0,10.0,,19,0,0,0,13.0,80,7.77,71,321,2447,12.7
7499,David Shaw,1988-89,24.0,7,26,73,73,7,19,26,128.0,,92,7,19,26,141.0,80,7.94,82,370,2484,12.8
7500,David Shaw,1989-90,25.0,8,19,75,75,0,19,19,136.0,,167,7,38,45,277.0,80,7.34,72,344,2400,12.2
7501,David Shaw,1990-91,26.0,9,32,68,68,7,25,32,141.0,,235,14,63,77,418.0,80,7.43,89,437,2435,12.2
7502,David Shaw,1991-92,27.0,10,17,63,63,6,11,17,85.0,,298,20,74,94,503.0,80,7.48,85,403,2430,12.3
7503,David Shaw,1992-93,28.0,11,12,22,22,2,10,12,24.0,,320,22,84,106,527.0,80,7.37,76,367,2421,12.2
7504,David Shaw,1993-94,29.0,12,12,77,77,2,10,12,61.0,,397,24,94,118,588.0,80,6.91,71,366,2385,11.6
7505,David Shaw,1994-95,30.0,13,10,59,59,1,9,10,70.0,,456,25,103,128,658.0,80,6.96,77,402,2440,11.4
7506,David Shaw,1995-96,31.0,14,24,77,77,10,14,24,122.0,,533,35,117,152,780.0,84,7.25,87,443,2603,11.7
7507,David Shaw,1996-97,32.0,15,10,55,55,1,9,10,107.0,,588,36,126,162,887.0,84,6.48,76,407,2545,10.7
7508,David Shaw,1997-98,33.0,16,7,44,44,3,4,7,58.0,,632,39,130,169,945.0,48,5.97,37,209,1408,10.2
7509,David Shaw,1998-99,34.0,17,12,66,66,1,11,12,90.0,,698,40,141,181,1035.0,82,6.29,74,413,2481,10.4
7510,David Shaw,1999-00,35.0,18,11,57,57,1,10,11,59.0,,755,41,151,192,1094.0,82,5.83,55,336,2444,9.8
7511,David Shaw,2000-01,36.0,19,2,14,14,0,2,2,12.0,,769,41,153,194,1106.0,82,5.28,57,380,2242,9.6
7512,David Sloane,2011-12,26.0,4,0,1,1,0,0,0,0.0,7.0,1,0,0,0,0.0,82,5.7,65,341,2477,9.4
7513,David Steckel,2008-09,26.0,4,0,7,7,0,0,0,6.0,54.0,7,0,0,0,6.0,82,6.05,85,480,2458,10.1
7514,David Steckel,2009-10,27.0,5,0,5,5,0,0,0,4.0,62.0,12,0,0,0,10.0,82,5.76,70,398,2426,9.7
7515,David Steckel,2010-11,28.0,6,12,67,67,5,7,12,66.0,909.0,79,5,7,12,76.0,82,5.44,62,351,2383,9.4
7516,David Steckel,2011-12,29.0,7,19,76,76,8,11,19,103.0,1050.0,155,13,18,31,179.0,82,5.7,65,341,2477,9.4
7517,David Steckel,2012-13,30.0,8,16,79,79,5,11,16,90.0,980.0,234,18,29,47,269.0,82,5.53,56,304,2486,9.1
7518,David Steckel,2013-14,31.0,9,12,75,75,6,6,12,79.0,891.0,309,24,35,59,348.0,82,5.46,52,291,2492,9.0
7519,David Steckel,2014-15,32.0,10,13,76,76,8,5,13,79.0,975.0,385,32,40,72,427.0,82,5.32,47,271,2439,8.9
7520,David Steckel,2015-16,33.0,11,7,34,34,1,6,7,23.0,315.0,419,33,46,79,450.0,48,5.31,29,160,1399,9.1
7521,David Steckel,2016-17,34.0,12,0,6,6,0,0,0,8.0,65.0,425,33,46,79,458.0,82,5.34,48,269,2463,8.9
7522,David Struch,1996-97,25.0,4,0,4,4,0,0,0,3.0,,4,0,0,0,3.0,84,6.48,76,407,2545,10.7
7523,David Tanabe,2002-03,22.0,4,4,31,31,4,0,4,28.0,400.0,31,4,0,4,28.0,82,5.49,53,331,2294,9.8
7524,David Tanabe,2003-04,23.0,5,29,74,74,7,22,29,130.0,1326.0,105,11,22,33,158.0,82,5.51,63,376,2272,9.9
7525,David Tanabe,2004-05,24.0,6,16,78,78,1,15,16,113.0,1439.0,183,12,37,49,271.0,82,5.24,53,338,2262,9.5
7526,David Tanabe,2005-06,25.0,7,13,68,68,3,10,13,104.0,1237.0,251,15,47,62,375.0,82,5.31,60,363,2326,9.4
7527,David Tanabe,2006-07,26.0,8,12,45,45,5,7,12,88.0,1037.0,296,20,54,74,463.0,82,5.14,57,348,2300,9.2
7528,David Tanabe,2008-09,28.0,9,20,75,75,4,16,20,103.0,1531.0,371,24,70,94,566.0,82,6.05,85,480,2458,10.1
7529,David Tanabe,2009-10,29.0,10,17,60,60,5,12,17,83.0,1068.0,431,29,82,111,649.0,82,5.76,70,398,2426,9.7
7530,David Tanabe,2010-11,30.0,11,3,18,18,1,2,3,12.0,216.0,449,30,84,114,661.0,82,5.44,62,351,2383,9.4
7531,David Ullstrom,2014-15,25.0,4,8,29,29,4,4,8,40.0,318.0,29,4,4,8,40.0,82,5.32,47,271,2439,8.9
7532,David Ullstrom,2015-16,26.0,5,5,20,20,2,3,5,28.0,190.0,49,6,7,13,68.0,48,5.31,29,160,1399,9.1
7533,David Van Der Gulik,2011-12,28.0,4,2,6,6,0,2,2,11.0,51.0,6,0,2,2,11.0,82,5.7,65,341,2477,9.4
7534,David Van Der Gulik,2013-14,30.0,5,3,6,6,1,2,3,12.0,41.0,12,1,4,5,23.0,82,5.46,52,291,2492,9.0
7535,David Van Der Gulik,2014-15,31.0,6,6,25,25,1,5,6,20.0,205.0,37,2,9,11,43.0,82,5.32,47,271,2439,8.9
7536,David Van Der Gulik,2015-16,32.0,7,2,9,9,0,2,2,10.0,85.0,46,2,11,13,53.0,48,5.31,29,160,1399,9.1
7537,David Van Der Gulik,2016-17,33.0,8,0,2,2,0,0,0,3.0,11.0,48,2,11,13,56.0,82,5.34,48,269,2463,8.9
7538,David Van Der Gulik,2017-18,34.0,9,0,1,1,0,0,0,1.0,5.0,49,2,11,13,57.0,82,5.32,47,251,2453,8.9
7539,David Van Drunen,2002-03,27.0,4,0,1,1,0,0,0,0.0,5.0,1,0,0,0,0.0,82,5.49,53,331,2294,9.8
7540,David Volek,1991-92,25.0,4,59,77,77,25,34,59,229.0,,77,25,34,59,229.0,80,7.48,85,403,2430,12.3
7541,David Volek,1992-93,26.0,5,39,80,80,17,22,39,181.0,,157,42,56,98,410.0,80,7.37,76,367,2421,12.2
7542,David Volek,1993-94,27.0,6,56,77,77,22,34,56,224.0,,234,64,90,154,634.0,80,6.91,71,366,2385,11.6
7543,David Volek,1994-95,28.0,7,60,74,74,18,42,60,167.0,,308,82,132,214,801.0,80,6.96,77,402,2440,11.4
7544,David Volek,1995-96,29.0,8,21,56,56,8,13,21,118.0,,364,90,145,235,919.0,84,7.25,87,443,2603,11.7
7545,David Volek,1996-97,30.0,9,14,32,32,5,9,14,56.0,,396,95,154,249,975.0,84,6.48,76,407,2545,10.7
7546,David Vyborny,2003-04,29.0,4,32,79,79,13,19,32,125.0,1219.0,79,13,19,32,125.0,82,5.51,63,376,2272,9.9
7547,David Vyborny,2004-05,30.0,5,31,75,75,13,18,31,103.0,1159.0,154,26,37,63,228.0,82,5.24,53,338,2262,9.5
7548,David Vyborny,2005-06,31.0,6,46,79,79,20,26,46,125.0,1291.0,233,46,63,109,353.0,82,5.31,60,363,2326,9.4
7549,David Vyborny,2006-07,32.0,7,53,82,82,22,31,53,158.0,1671.0,315,68,94,162,511.0,82,5.14,57,348,2300,9.2
7550,David Vyborny,2008-09,34.0,8,65,80,80,22,43,65,145.0,1655.0,395,90,137,227,656.0,82,6.05,85,480,2458,10.1
7551,David Vyborny,2009-10,35.0,9,64,82,82,16,48,64,158.0,1668.0,477,106,185,291,814.0,82,5.76,70,398,2426,9.7
7552,David Vyborny,2010-11,36.0,10,26,66,66,7,19,26,106.0,1022.0,543,113,204,317,920.0,82,5.44,62,351,2383,9.4
7553,David Warsofsky,2016-17,26.0,4,2,6,6,1,1,2,10.0,97.0,6,1,1,2,10.0,82,5.34,48,269,2463,8.9
7554,David Warsofsky,2017-18,27.0,5,1,4,4,0,1,1,7.0,71.0,10,1,2,3,17.0,82,5.32,47,251,2453,8.9
7555,David Warsofsky,2018-19,28.0,6,2,22,22,1,1,2,40.0,377.0,32,2,3,5,57.0,82,5.34,48,255,2438,9.0
7556,David Warsofsky,2019-20,29.0,7,1,7,7,0,1,1,14.0,110.0,39,2,4,6,71.0,82,5.45,47,245,2478,9.0
7557,David Warsofsky,2020-21,30.0,8,5,16,16,0,5,5,18.0,214.0,55,2,9,11,89.0,82,5.86,50,250,2620,9.2
7558,David Wilkie,1997-98,23.0,4,0,1,1,0,0,0,0.0,,1,0,0,0,0.0,48,5.97,37,209,1408,10.2
7559,David Wilkie,1998-99,24.0,5,6,24,24,1,5,6,39.0,,25,1,5,6,39.0,82,6.29,74,413,2481,10.4
7560,David Wilkie,1999-00,25.0,6,15,61,61,6,9,15,65.0,,86,7,14,21,104.0,82,5.83,55,336,2444,9.8
7561,David Wilkie,2000-01,26.0,7,7,34,34,2,5,7,48.0,,120,9,19,28,152.0,82,5.28,57,380,2242,9.6
7562,David Wilkie,2001-02,27.0,8,8,46,46,1,7,8,35.0,566.0,166,10,26,36,187.0,82,5.27,57,359,2285,9.4
7563,David Wilkie,2003-04,29.0,9,0,1,1,0,0,0,1.0,12.0,167,10,26,36,188.0,82,5.51,63,376,2272,9.9
7564,David Williams,1994-95,27.0,4,28,56,56,3,25,28,91.0,,56,3,25,28,91.0,80,6.96,77,402,2440,11.4
7565,David Williams,1995-96,28.0,5,12,40,40,1,11,12,60.0,,96,4,36,40,151.0,84,7.25,87,443,2603,11.7
7566,David Williams,1996-97,29.0,6,20,56,56,5,15,20,74.0,,152,9,51,60,225.0,84,6.48,76,407,2545,10.7
7567,David Williams,1997-98,30.0,7,4,21,21,2,2,4,30.0,,173,11,53,64,255.0,48,5.97,37,209,1408,10.2
7568,David Wolf,2017-18,28.0,4,0,3,3,0,0,0,1.0,28.0,3,0,0,0,1.0,82,5.32,47,251,2453,8.9
7569,Davis Drewiske,2011-12,27.0,4,3,17,17,0,3,3,21.0,294.0,17,0,3,3,21.0,82,5.7,65,341,2477,9.4
7570,Davis Drewiske,2012-13,28.0,5,8,42,42,1,7,8,32.0,640.0,59,1,10,11,53.0,82,5.53,56,304,2486,9.1
7571,Davis Drewiske,2013-14,29.0,6,5,38,38,0,5,5,27.0,545.0,97,1,15,16,80.0,82,5.46,52,291,2492,9.0
7572,Davis Drewiske,2014-15,30.0,7,2,9,9,2,0,2,11.0,113.0,106,3,15,18,91.0,82,5.32,47,271,2439,8.9
7573,Davis Drewiske,2015-16,31.0,8,7,29,29,2,5,7,28.0,441.0,135,5,20,25,119.0,48,5.31,29,160,1399,9.1
7574,Davis Payne,1998-99,28.0,4,0,7,7,0,0,0,2.0,,7,0,0,0,2.0,82,6.29,74,413,2481,10.4
7575,Davis Payne,1999-00,29.0,5,1,15,15,0,1,1,8.0,,22,0,1,1,10.0,82,5.83,55,336,2444,9.8
7576,Daymond Langkow,1998-99,22.0,4,1,4,4,0,1,1,4.0,,4,0,1,1,4.0,82,6.29,74,413,2481,10.4
7577,Daymond Langkow,1999-00,23.0,5,28,79,79,15,13,28,170.0,,83,15,14,29,174.0,82,5.83,55,336,2444,9.8
7578,Daymond Langkow,2000-01,24.0,6,22,68,68,8,14,22,156.0,,151,23,28,51,330.0,82,5.28,57,380,2242,9.6
7579,Daymond Langkow,2001-02,25.0,7,33,78,78,14,19,33,149.0,1229.0,229,37,47,84,479.0,82,5.27,57,359,2285,9.4
7580,Daymond Langkow,2002-03,26.0,8,50,82,82,18,32,50,222.0,1390.0,311,55,79,134,701.0,82,5.49,53,331,2294,9.8
7581,Daymond Langkow,2003-04,27.0,9,54,71,71,13,41,54,190.0,1323.0,382,68,120,188,891.0,82,5.51,63,376,2272,9.9
7582,Daymond Langkow,2004-05,28.0,10,62,80,80,27,35,62,171.0,1534.0,462,95,155,250,1062.0,82,5.24,53,338,2262,9.5
7583,Daymond Langkow,2005-06,29.0,11,52,82,82,20,32,52,196.0,1722.0,544,115,187,302,1258.0,82,5.31,60,363,2326,9.4
7584,Daymond Langkow,2006-07,30.0,12,52,81,81,21,31,52,174.0,1711.0,625,136,218,354,1432.0,82,5.14,57,348,2300,9.2
7585,Daymond Langkow,2008-09,32.0,13,59,82,82,25,34,59,171.0,1485.0,707,161,252,413,1603.0,82,6.05,85,480,2458,10.1
7586,Daymond Langkow,2009-10,33.0,14,77,81,81,33,44,77,247.0,1630.0,788,194,296,490,1850.0,82,5.76,70,398,2426,9.7
7587,Daymond Langkow,2010-11,34.0,15,65,80,80,30,35,65,201.0,1506.0,868,224,331,555,2051.0,82,5.44,62,351,2383,9.4
7588,Daymond Langkow,2011-12,35.0,16,49,73,73,21,28,49,161.0,1255.0,941,245,359,604,2212.0,82,5.7,65,341,2477,9.4
7589,Daymond Langkow,2012-13,36.0,17,37,72,72,14,23,37,126.0,1362.0,1013,259,382,641,2338.0,82,5.53,56,304,2486,9.1
7590,Daymond Langkow,2013-14,37.0,18,1,4,4,0,1,1,6.0,59.0,1017,259,383,642,2344.0,82,5.46,52,291,2492,9.0
7591,Daymond Langkow,2014-15,38.0,19,30,73,73,11,19,30,112.0,1150.0,1090,270,402,672,2456.0,82,5.32,47,271,2439,8.9
7592,Dean Arsene,2012-13,32.0,4,0,13,13,0,0,0,4.0,168.0,13,0,0,0,4.0,82,5.53,56,304,2486,9.1
7593,Dean Chynoweth,1991-92,23.0,4,0,6,6,0,0,0,0.0,,6,0,0,0,0.0,80,7.48,85,403,2430,12.3
7594,Dean Chynoweth,1992-93,24.0,5,2,20,20,0,2,2,8.0,,26,0,2,2,8.0,80,7.37,76,367,2421,12.2
7595,Dean Chynoweth,1993-94,25.0,6,2,25,25,1,1,2,14.0,,51,1,3,4,22.0,80,6.91,71,366,2385,11.6
7596,Dean Chynoweth,1994-95,26.0,7,1,11,11,1,0,1,6.0,,62,2,3,5,28.0,80,6.96,77,402,2440,11.4
7597,Dean Chynoweth,1996-97,28.0,8,4,39,39,0,4,4,26.0,,101,2,7,9,54.0,84,6.48,76,407,2545,10.7
7598,Dean Chynoweth,1997-98,29.0,9,2,32,32,0,2,2,22.0,,133,2,9,11,76.0,48,5.97,37,209,1408,10.2
7599,Dean Chynoweth,1998-99,30.0,10,8,49,49,2,6,8,38.0,,182,4,15,19,114.0,82,6.29,74,413,2481,10.4
7600,Dean Chynoweth,1999-00,31.0,11,3,57,57,0,3,3,30.0,,239,4,18,22,144.0,82,5.83,55,336,2444,9.8
7601,Dean Chynoweth,2000-01,32.0,12,0,2,2,0,0,0,1.0,,241,4,18,22,145.0,82,5.28,57,380,2242,9.6
7602,Dean Clark,1986-87,23.0,4,0,1,1,0,0,0,0.0,,1,0,0,0,0.0,80,7.89,74,336,2448,12.9
7603,Dean Defazio,1986-87,23.0,4,2,22,22,0,2,2,12.0,,22,0,2,2,12.0,80,7.89,74,336,2448,12.9
7604,Dean Evason,1986-87,22.0,4,0,2,2,0,0,0,0.0,,2,0,0,0,0.0,80,7.89,74,336,2448,12.9
7605,Dean Evason,1987-88,23.0,5,7,17,17,3,4,7,21.0,,19,3,4,7,21.0,80,7.77,71,321,2447,12.7
7606,Dean Evason,1988-89,24.0,6,48,55,55,20,28,48,101.0,,74,23,32,55,122.0,80,7.94,82,370,2484,12.8
7607,Dean Evason,1989-90,25.0,7,59,80,80,22,37,59,123.0,,154,45,69,114,245.0,80,7.34,72,344,2400,12.2
7608,Dean Evason,1990-91,26.0,8,28,77,77,10,18,28,126.0,,231,55,87,142,371.0,80,7.43,89,437,2435,12.2
7609,Dean Evason,1991-92,27.0,9,28,67,67,11,17,28,95.0,,298,66,104,170,466.0,80,7.48,85,403,2430,12.3
7610,Dean Evason,1992-93,28.0,10,43,78,78,18,25,43,150.0,,376,84,129,213,616.0,80,7.37,76,367,2421,12.2
7611,Dean Evason,1993-94,29.0,11,29,75,75,6,23,29,85.0,,451,90,152,242,701.0,80,6.91,71,366,2385,11.6
7612,Dean Evason,1994-95,30.0,12,26,74,74,11,15,26,88.0,,525,101,167,268,789.0,80,6.96,77,402,2440,11.4
7613,Dean Evason,1995-96,31.0,13,31,84,84,12,19,31,107.0,,609,113,186,299,896.0,84,7.25,87,443,2603,11.7
7614,Dean Evason,1996-97,32.0,14,44,80,80,11,33,44,118.0,,689,124,219,343,1014.0,84,6.48,76,407,2545,10.7
7615,Dean Evason,1997-98,33.0,15,15,47,47,8,7,15,53.0,,736,132,226,358,1067.0,48,5.97,37,209,1408,10.2
7616,Dean Evason,1998-99,34.0,16,14,67,67,7,7,14,68.0,,803,139,233,372,1135.0,82,6.29,74,413,2481,10.4
7617,Dean Hopkins,1982-83,23.0,4,14,60,60,8,6,14,57.0,,60,8,6,14,57.0,80,7.03,61,280,2352,12.0
7618,Dean Hopkins,1983-84,24.0,5,26,67,67,8,18,26,60.0,,127,16,24,40,117.0,80,7.69,77,340,2441,12.6
7619,Dean Hopkins,1984-85,25.0,6,15,41,41,2,13,15,55.0,,168,18,37,55,172.0,80,8.03,73,320,2489,12.9
7620,Dean Hopkins,1985-86,26.0,7,17,49,49,5,12,17,50.0,,217,23,49,72,222.0,80,7.73,71,310,2444,12.7
7621,Dean Hopkins,1988-89,29.0,8,0,1,1,0,0,0,0.0,,218,23,49,72,222.0,80,7.94,82,370,2484,12.8
7622,Dean Hopkins,1991-92,32.0,9,2,5,5,0,2,2,6.0,,223,23,51,74,228.0,80,7.48,85,403,2430,12.3
7623,Dean Jenkins,1986-87,27.0,4,0,5,5,0,0,0,3.0,,5,0,0,0,3.0,80,7.89,74,336,2448,12.9
7624,Dean Kennedy,1985-86,23.0,4,12,55,55,0,12,12,53.0,,55,0,12,12,53.0,80,7.73,71,310,2444,12.7
7625,Dean Kennedy,1986-87,24.0,5,6,37,37,1,5,6,22.0,,92,1,17,18,75.0,80,7.89,74,336,2448,12.9
7626,Dean Kennedy,1988-89,26.0,6,12,78,78,2,10,12,59.0,,170,3,27,30,134.0,80,7.94,82,370,2484,12.8
7627,Dean Kennedy,1989-90,27.0,7,20,66,66,6,14,20,59.0,,236,9,41,50,193.0,80,7.34,72,344,2400,12.2
7628,Dean Kennedy,1990-91,28.0,8,12,58,58,1,11,12,40.0,,294,10,52,62,233.0,80,7.43,89,437,2435,12.2
7629,Dean Kennedy,1991-92,29.0,9,14,67,67,3,11,14,45.0,,361,13,63,76,278.0,80,7.48,85,403,2430,12.3
7630,Dean Kennedy,1992-93,30.0,10,14,80,80,2,12,14,51.0,,441,15,75,90,329.0,80,7.37,76,367,2421,12.2
7631,Dean Kennedy,1993-94,31.0,11,12,64,64,4,8,12,46.0,,505,19,83,102,375.0,80,6.91,71,366,2385,11.6
7632,Dean Kennedy,1994-95,32.0,12,6,18,18,2,4,6,20.0,,523,21,87,108,395.0,80,6.96,77,402,2440,11.4
7633,Dean Kennedy,1995-96,33.0,13,8,78,78,1,7,8,50.0,,601,22,94,116,445.0,84,7.25,87,443,2603,11.7
7634,Dean Kennedy,1996-97,34.0,14,10,76,76,2,8,10,38.0,,677,24,102,126,483.0,84,6.48,76,407,2545,10.7
7635,Dean Kennedy,1997-98,35.0,15,10,40,40,2,8,10,45.0,,717,26,110,136,528.0,48,5.97,37,209,1408,10.2
7636,Dean Kolstad,1991-92,23.0,4,6,25,25,1,5,6,41.0,,25,1,5,6,41.0,80,7.48,85,403,2430,12.3
7637,Dean Kolstad,1993-94,25.0,5,0,5,5,0,0,0,9.0,,30,1,5,6,50.0,80,6.91,71,366,2385,11.6
7638,Dean Kolstad,1995-96,27.0,6,2,10,10,0,2,2,22.0,,40,1,7,8,72.0,84,7.25,87,443,2603,11.7
7639,Dean Kukan,2018-19,25.0,4,0,8,8,0,0,0,3.0,139.0,8,0,0,0,3.0,82,5.34,48,255,2438,9.0
7640,Dean Kukan,2020-21,27.0,5,4,11,11,0,4,4,12.0,136.0,19,0,4,4,15.0,82,5.86,50,250,2620,9.2
7641,Dean Kukan,2021-22,28.0,6,5,25,25,0,5,5,16.0,337.0,44,0,9,9,31.0,82,5.96,47,239,2579,9.5
7642,Dean Kukan,2022-23,29.0,7,5,33,33,1,4,5,51.0,527.0,77,1,13,14,82.0,70,5.96,42,208,2192,9.5
7643,Dean Malkoc,1998-99,29.0,4,2,41,41,0,2,2,8.0,,41,0,2,2,8.0,82,6.29,74,413,2481,10.4
7644,Dean Malkoc,1999-00,30.0,5,0,33,33,0,0,0,7.0,,74,0,2,2,15.0,82,5.83,55,336,2444,9.8
7645,Dean Malkoc,2000-01,31.0,6,1,40,40,1,0,1,15.0,,114,1,2,3,30.0,82,5.28,57,380,2242,9.6
7646,Dean Malkoc,2001-02,32.0,7,1,2,2,0,1,1,1.0,31.0,116,1,3,4,31.0,82,5.27,57,359,2285,9.4
7647,Dean McAmmond,1994-95,21.0,4,2,5,5,0,2,2,4.0,,5,0,2,2,4.0,80,6.96,77,402,2440,11.4
7648,Dean McAmmond,1996-97,23.0,5,27,45,45,6,21,27,52.0,,50,6,23,29,56.0,84,6.48,76,407,2545,10.7
7649,Dean McAmmond,1997-98,24.0,6,0,6,6,0,0,0,3.0,,56,6,23,29,59.0,48,5.97,37,209,1408,10.2
7650,Dean McAmmond,1998-99,25.0,7,30,53,53,15,15,30,79.0,,109,21,38,59,138.0,82,6.29,74,413,2481,10.4
7651,Dean McAmmond,1999-00,26.0,8,29,57,57,12,17,29,106.0,,166,33,55,88,244.0,82,5.83,55,336,2444,9.8
7652,Dean McAmmond,2000-01,27.0,9,50,77,77,19,31,50,128.0,,243,52,86,138,372.0,82,5.28,57,380,2242,9.6
7653,Dean McAmmond,2001-02,28.0,10,30,77,77,10,20,30,138.0,1115.0,320,62,106,168,510.0,82,5.27,57,359,2285,9.4
7654,Dean McAmmond,2002-03,29.0,11,32,76,76,14,18,32,118.0,1248.0,396,76,124,200,628.0,82,5.49,53,331,2294,9.8
7655,Dean McAmmond,2003-04,30.0,12,28,71,71,11,17,28,112.0,1065.0,467,87,141,228,740.0,82,5.51,63,376,2272,9.9
7656,Dean McAmmond,2004-05,31.0,13,51,73,73,21,30,51,152.0,1382.0,540,108,171,279,892.0,82,5.24,53,338,2262,9.5
7657,Dean McAmmond,2005-06,32.0,14,18,41,41,10,8,18,72.0,591.0,581,118,179,297,964.0,82,5.31,60,363,2326,9.4
7658,Dean McAmmond,2006-07,33.0,15,30,64,64,17,13,30,101.0,1080.0,645,135,192,327,1065.0,82,5.14,57,348,2300,9.2
7659,Dean McAmmond,2008-09,35.0,16,37,78,78,15,22,37,116.0,1251.0,723,150,214,364,1181.0,82,6.05,85,480,2458,10.1
7660,Dean McAmmond,2009-10,36.0,17,29,81,81,14,15,29,86.0,901.0,804,164,229,393,1267.0,82,5.76,70,398,2426,9.7
7661,Dean McAmmond,2010-11,37.0,18,22,68,68,9,13,22,67.0,785.0,872,173,242,415,1334.0,82,5.44,62,351,2383,9.4
7662,Dean McAmmond,2011-12,38.0,19,16,62,62,5,11,16,59.0,698.0,934,178,253,431,1393.0,82,5.7,65,341,2477,9.4
7663,Dean McAmmond,2012-13,39.0,20,17,62,62,8,9,17,87.0,797.0,996,186,262,448,1480.0,82,5.53,56,304,2486,9.1
7664,Dean Melanson,1997-98,24.0,4,0,5,5,0,0,0,1.0,,5,0,0,0,1.0,48,5.97,37,209,1408,10.2
7665,Dean Melanson,2004-05,31.0,5,0,4,4,0,0,0,6.0,50.0,9,0,0,0,7.0,82,5.24,53,338,2262,9.5
7666,Dean Morton,1992-93,24.0,4,1,1,1,1,0,1,2.0,,1,1,0,1,2.0,80,7.37,76,367,2421,12.2
7667,Dean Sylvester,2001-02,29.0,4,0,1,1,0,0,0,1.0,15.0,1,0,0,0,1.0,82,5.27,57,359,2285,9.4
7668,Dean Sylvester,2002-03,30.0,5,26,52,52,16,10,26,98.0,714.0,53,16,10,26,99.0,82,5.49,53,331,2294,9.8
7669,Dean Sylvester,2003-04,31.0,6,11,43,43,5,6,11,82.0,605.0,96,21,16,37,181.0,82,5.51,63,376,2272,9.9
7670,Denis Arkhipov,2003-04,24.0,4,13,40,40,6,7,13,42.0,397.0,40,6,7,13,42.0,82,5.51,63,376,2272,9.9
7671,Denis Arkhipov,2004-05,25.0,5,42,82,82,20,22,42,118.0,1289.0,122,26,29,55,160.0,82,5.24,53,338,2262,9.5
7672,Denis Arkhipov,2005-06,26.0,6,35,79,79,11,24,35,148.0,1196.0,201,37,53,90,308.0,82,5.31,60,363,2326,9.4
7673,Denis Arkhipov,2006-07,27.0,7,21,72,72,9,12,21,91.0,1006.0,273,46,65,111,399.0,82,5.14,57,348,2300,9.2
7674,Denis Arkhipov,2009-10,30.0,8,27,79,79,10,17,27,112.0,1241.0,352,56,82,138,511.0,82,5.76,70,398,2426,9.7
7675,Denis Chasse,1996-97,26.0,4,1,3,3,0,1,1,5.0,,3,0,1,1,5.0,84,6.48,76,407,2545,10.7
7676,Denis Chasse,1997-98,27.0,5,16,47,47,7,9,16,48.0,,50,7,10,17,53.0,48,5.97,37,209,1408,10.2
7677,Denis Chasse,1998-99,28.0,6,3,60,60,3,0,3,31.0,,110,10,10,20,84.0,82,6.29,74,413,2481,10.4
7678,Denis Chasse,1999-00,29.0,7,5,22,22,1,4,5,12.0,,132,11,14,25,96.0,82,5.83,55,336,2444,9.8
7679,Denis Chervyakov,1995-96,25.0,4,0,2,2,0,0,0,2.0,,2,0,0,0,2.0,84,7.25,87,443,2603,11.7
7680,Denis Cyr,1983-84,22.0,4,5,10,10,1,4,5,10.0,,10,1,4,5,10.0,80,7.69,77,340,2441,12.6
7681,Denis Cyr,1984-85,23.0,5,22,45,45,12,10,22,71.0,,55,13,14,27,81.0,80,8.03,73,320,2489,12.9
7682,Denis Cyr,1985-86,24.0,6,17,52,52,8,9,17,51.0,,107,21,23,44,132.0,80,7.73,71,310,2444,12.7
7683,Denis Cyr,1986-87,25.0,7,25,46,46,12,13,25,72.0,,153,33,36,69,204.0,80,7.89,74,336,2448,12.9
7684,Denis Cyr,1987-88,26.0,8,8,9,9,5,3,8,12.0,,162,38,39,77,216.0,80,7.77,71,321,2447,12.7
7685,Denis Cyr,1988-89,27.0,9,7,31,31,3,4,7,21.0,,193,41,43,84,237.0,80,7.94,82,370,2484,12.8
7686,Denis Gauthier,2000-01,24.0,4,0,10,10,0,0,0,3.0,,10,0,0,0,3.0,82,5.28,57,380,2242,9.6
7687,Denis Gauthier,2001-02,25.0,5,7,55,55,3,4,7,40.0,698.0,65,3,4,7,43.0,82,5.27,57,359,2285,9.4
7688,Denis Gauthier,2002-03,26.0,6,2,39,39,1,1,2,29.0,754.0,104,4,5,9,72.0,82,5.49,53,331,2294,9.8
7689,Denis Gauthier,2003-04,27.0,7,8,62,62,2,6,8,33.0,1030.0,166,6,11,17,105.0,82,5.51,63,376,2272,9.9
7690,Denis Gauthier,2004-05,28.0,8,13,66,66,5,8,13,76.0,1275.0,232,11,19,30,181.0,82,5.24,53,338,2262,9.5
7691,Denis Gauthier,2005-06,29.0,9,12,72,72,1,11,12,50.0,1431.0,304,12,30,42,231.0,82,5.31,60,363,2326,9.4
7692,Denis Gauthier,2006-07,30.0,10,16,80,80,1,15,16,90.0,1498.0,384,13,45,58,321.0,82,5.14,57,348,2300,9.2
7693,Denis Gauthier,2008-09,32.0,11,11,62,62,2,9,11,56.0,1024.0,446,15,54,69,377.0,82,6.05,85,480,2458,10.1
7694,Denis Gauthier,2009-10,33.0,12,4,43,43,0,4,4,23.0,716.0,489,15,58,73,400.0,82,5.76,70,398,2426,9.7
7695,Denis Gauthier,2011-12,35.0,13,4,65,65,2,2,4,36.0,945.0,554,17,60,77,436.0,82,5.7,65,341,2477,9.4
7696,Denis Grebeshkov,2006-07,23.0,4,1,4,4,0,1,1,5.0,74.0,4,0,1,1,5.0,82,5.14,57,348,2300,9.2
7697,Denis Grebeshkov,2008-09,25.0,5,5,29,29,0,5,5,24.0,483.0,33,0,6,6,29.0,82,6.05,85,480,2458,10.1
7698,Denis Grebeshkov,2010-11,27.0,6,18,71,71,3,15,18,34.0,1198.0,104,3,21,24,63.0,82,5.44,62,351,2383,9.4
7699,Denis Grebeshkov,2011-12,28.0,7,39,72,72,7,32,39,62.0,1524.0,176,10,53,63,125.0,82,5.7,65,341,2477,9.4
7700,Denis Grebeshkov,2012-13,29.0,8,21,51,51,7,14,21,47.0,1092.0,227,17,67,84,172.0,82,5.53,56,304,2486,9.1
7701,Denis Grebeshkov,2016-17,33.0,9,1,7,7,0,1,1,3.0,96.0,234,17,68,85,175.0,82,5.34,48,269,2463,8.9
7702,Denis Gurianov,2019-20,22.0,4,0,1,1,0,0,0,0.0,13.0,1,0,0,0,0.0,82,5.45,47,245,2478,9.0
7703,Denis Gurianov,2021-22,24.0,5,4,21,21,1,3,4,23.0,228.0,22,1,3,4,23.0,82,5.96,47,239,2579,9.5
7704,Denis Gurianov,2022-23,25.0,6,29,64,64,20,9,29,132.0,831.0,86,21,12,33,155.0,70,5.96,42,208,2192,9.5
7705,Denis Hamel,2002-03,25.0,4,1,3,3,1,0,1,3.0,29.0,3,1,0,1,3.0,82,5.49,53,331,2294,9.8
7706,Denis Hamel,2003-04,26.0,5,11,41,41,8,3,11,55.0,450.0,44,9,3,12,58.0,82,5.51,63,376,2272,9.9
7707,Denis Hamel,2004-05,27.0,6,8,61,61,2,6,8,80.0,671.0,105,11,9,20,138.0,82,5.24,53,338,2262,9.5
7708,Denis Hamel,2005-06,28.0,7,2,25,25,2,0,2,41.0,317.0,130,13,9,22,179.0,82,5.31,60,363,2326,9.4
7709,Denis Hamel,2006-07,29.0,8,0,5,5,0,0,0,6.0,31.0,135,13,9,22,185.0,82,5.14,57,348,2300,9.2
7710,Denis Hamel,2008-09,31.0,9,1,4,4,1,0,1,9.0,37.0,139,14,9,23,194.0,82,6.05,85,480,2458,10.1
7711,Denis Hamel,2009-10,32.0,10,8,53,53,5,3,8,42.0,322.0,192,19,12,31,236.0,82,5.76,70,398,2426,9.7
7712,Denis Larocque,1990-91,23.0,4,1,8,8,0,1,1,2.0,,8,0,1,1,2.0,80,7.43,89,437,2435,12.2
7713,Denis Malgin,2019-20,23.0,4,10,47,47,6,4,10,67.0,528.0,47,6,4,10,67.0,82,5.45,47,245,2478,9.0
7714,Denis Malgin,2020-21,24.0,5,22,51,51,11,11,22,79.0,707.0,98,17,15,32,146.0,82,5.86,50,250,2620,9.2
7715,Denis Malgin,2021-22,25.0,6,16,50,50,7,9,16,66.0,644.0,148,24,24,48,212.0,82,5.96,47,239,2579,9.5
7716,Denis Malgin,2022-23,26.0,7,12,44,44,4,8,12,50.0,528.0,192,28,32,60,262.0,70,5.96,42,208,2192,9.5
7717,Denis Pederson,1998-99,23.0,4,4,10,10,3,1,4,6.0,,10,3,1,4,6.0,82,6.29,74,413,2481,10.4
7718,Denis Pederson,1999-00,24.0,5,32,70,70,12,20,32,106.0,,80,15,21,36,112.0,82,5.83,55,336,2444,9.8
7719,Denis Pederson,2000-01,25.0,6,28,80,80,15,13,28,135.0,,160,30,34,64,247.0,82,5.28,57,380,2242,9.6
7720,Denis Pederson,2001-02,26.0,7,23,76,76,11,12,23,145.0,1164.0,236,41,46,87,392.0,82,5.27,57,359,2285,9.4
7721,Denis Pederson,2002-03,27.0,8,11,47,47,6,5,11,56.0,527.0,283,47,51,98,448.0,82,5.49,53,331,2294,9.8
7722,Denis Pederson,2003-04,28.0,9,12,61,61,4,8,12,70.0,713.0,344,51,59,110,518.0,82,5.51,63,376,2272,9.9
7723,Denis Pederson,2004-05,29.0,10,8,48,48,2,6,8,42.0,441.0,392,53,65,118,560.0,82,5.24,53,338,2262,9.5
7724,Denis Pederson,2005-06,30.0,11,10,43,43,4,6,10,64.0,551.0,435,57,71,128,624.0,82,5.31,60,363,2326,9.4
7725,Denis Savard,1983-84,22.0,4,75,76,76,28,47,75,159.0,,76,28,47,75,159.0,80,7.69,77,340,2441,12.6
7726,Denis Savard,1984-85,23.0,5,119,80,80,32,87,119,231.0,,156,60,134,194,390.0,80,8.03,73,320,2489,12.9
7727,Denis Savard,1985-86,24.0,6,121,78,78,35,86,121,212.0,,234,95,220,315,602.0,80,7.73,71,310,2444,12.7
7728,Denis Savard,1986-87,25.0,7,94,75,75,37,57,94,211.0,,309,132,277,409,813.0,80,7.89,74,336,2448,12.9
7729,Denis Savard,1987-88,26.0,8,105,79,79,38,67,105,265.0,,388,170,344,514,1078.0,80,7.77,71,321,2447,12.7
7730,Denis Savard,1988-89,27.0,9,116,80,80,47,69,116,281.0,,468,217,413,630,1359.0,80,7.94,82,370,2484,12.8
7731,Denis Savard,1989-90,28.0,10,90,70,70,40,50,90,235.0,,538,257,463,720,1594.0,80,7.34,72,344,2400,12.2
7732,Denis Savard,1990-91,29.0,11,131,80,80,44,87,131,270.0,,618,301,550,851,1864.0,80,7.43,89,437,2435,12.2
7733,Denis Savard,1991-92,30.0,12,82,58,58,23,59,82,182.0,,676,324,609,933,2046.0,80,7.48,85,403,2430,12.3
7734,Denis Savard,1992-93,31.0,13,80,60,60,27,53,80,181.0,,736,351,662,1013,2227.0,80,7.37,76,367,2421,12.2
7735,Denis Savard,1993-94,32.0,14,59,70,70,28,31,59,187.0,,806,379,693,1072,2414.0,80,6.91,71,366,2385,11.6
7736,Denis Savard,1994-95,33.0,15,70,77,77,28,42,70,174.0,,883,407,735,1142,2588.0,80,6.96,77,402,2440,11.4
7737,Denis Savard,1995-96,34.0,16,50,63,63,16,34,50,99.0,,946,423,769,1192,2687.0,84,7.25,87,443,2603,11.7
7738,Denis Savard,1996-97,35.0,17,46,74,74,18,28,46,181.0,,1020,441,797,1238,2868.0,84,6.48,76,407,2545,10.7
7739,Denis Savard,1997-98,36.0,18,25,43,43,10,15,25,82.0,,1063,451,812,1263,2950.0,48,5.97,37,209,1408,10.2
7740,Denis Savard,1998-99,37.0,19,48,69,69,13,35,48,110.0,,1132,464,847,1311,3060.0,82,6.29,74,413,2481,10.4
7741,Denis Savard,1999-00,38.0,20,27,64,64,9,18,27,82.0,,1196,473,865,1338,3142.0,82,5.83,55,336,2444,9.8
7742,Denis Shvidki,2003-04,23.0,4,16,43,43,6,10,16,28.0,445.0,43,6,10,16,28.0,82,5.51,63,376,2272,9.9
7743,Denis Shvidki,2004-05,24.0,5,3,8,8,1,2,3,11.0,96.0,51,7,12,19,39.0,82,5.24,53,338,2262,9.5
7744,Denis Shvidki,2005-06,25.0,6,6,23,23,4,2,6,29.0,327.0,74,11,14,25,68.0,82,5.31,60,363,2326,9.4
7745,Denis Shvidki,2006-07,26.0,7,0,2,2,0,0,0,4.0,28.0,76,11,14,25,72.0,82,5.14,57,348,2300,9.2
7746,Denis Tolpeko,2010-11,26.0,4,6,26,26,1,5,6,24.0,215.0,26,1,5,6,24.0,82,5.44,62,351,2383,9.4
7747,Denis Tsygurov,1996-97,25.0,4,0,8,8,0,0,0,3.0,,8,0,0,0,3.0,84,6.48,76,407,2545,10.7
7748,Denis Tsygurov,1997-98,26.0,5,0,25,25,0,0,0,20.0,,33,0,0,0,23.0,48,5.97,37,209,1408,10.2
7749,Denis Tsygurov,1998-99,27.0,6,6,18,18,1,5,6,21.0,,51,1,5,6,44.0,82,6.29,74,413,2481,10.4
7750,Dennis Bonvie,1997-98,24.0,4,0,2,2,0,0,0,0.0,,2,0,0,0,0.0,48,5.97,37,209,1408,10.2
7751,Dennis Bonvie,1998-99,25.0,5,0,8,8,0,0,0,0.0,,10,0,0,0,0.0,82,6.29,74,413,2481,10.4
7752,Dennis Bonvie,2000-01,27.0,6,0,4,4,0,0,0,0.0,,14,0,0,0,0.0,82,5.28,57,380,2242,9.6
7753,Dennis Bonvie,2001-02,28.0,7,0,11,11,0,0,0,1.0,44.0,25,0,0,0,1.0,82,5.27,57,359,2285,9.4
7754,Dennis Bonvie,2002-03,29.0,8,0,28,28,0,0,0,6.0,91.0,53,0,0,0,7.0,82,5.49,53,331,2294,9.8
7755,Dennis Bonvie,2003-04,30.0,9,0,3,3,0,0,0,1.0,10.0,56,0,0,0,8.0,82,5.51,63,376,2272,9.9
7756,Dennis Bonvie,2004-05,31.0,10,3,23,23,1,2,3,5.0,117.0,79,1,2,3,13.0,82,5.24,53,338,2262,9.5
7757,Dennis Bonvie,2005-06,32.0,11,0,12,12,0,0,0,3.0,37.0,91,1,2,3,16.0,82,5.31,60,363,2326,9.4
7758,Dennis Bonvie,2006-07,33.0,12,0,1,1,0,0,0,1.0,7.0,92,1,2,3,17.0,82,5.14,57,348,2300,9.2
7759,Dennis Cholowski,2021-22,23.0,4,16,52,52,7,9,16,71.0,949.0,52,7,9,16,71.0,82,5.96,47,239,2579,9.5
7760,Dennis Cholowski,2022-23,24.0,5,8,36,36,2,6,8,51.0,692.0,88,9,15,24,122.0,70,5.96,42,208,2192,9.5
7761,Dennis Everberg,2017-18,26.0,4,12,55,55,3,9,12,62.0,649.0,55,3,9,12,62.0,82,5.32,47,251,2453,8.9
7762,Dennis Everberg,2018-19,27.0,5,0,15,15,0,0,0,9.0,134.0,70,3,9,12,71.0,82,5.34,48,255,2438,9.0
7763,Dennis Gilbert,2021-22,25.0,4,0,1,1,0,0,0,0.0,13.0,1,0,0,0,0.0,82,5.96,47,239,2579,9.5
7764,Dennis Gilbert,2022-23,26.0,5,3,21,21,1,2,3,12.0,330.0,22,1,2,3,12.0,70,5.96,42,208,2192,9.5
7765,Dennis Rasmussen,2018-19,28.0,4,9,44,44,4,5,9,42.0,403.0,44,4,5,9,42.0,82,5.34,48,255,2438,9.0
7766,Dennis Rasmussen,2019-20,29.0,5,8,68,68,4,4,8,77.0,804.0,112,8,9,17,119.0,82,5.45,47,245,2478,9.0
7767,Dennis Rasmussen,2020-21,30.0,6,4,27,27,1,3,4,19.0,241.0,139,9,12,21,138.0,82,5.86,50,250,2620,9.2
7768,Dennis Seidenberg,2005-06,24.0,4,13,58,58,4,9,13,123.0,976.0,58,4,9,13,123.0,82,5.31,60,363,2326,9.4
7769,Dennis Seidenberg,2006-07,25.0,5,0,5,5,0,0,0,14.0,87.0,63,4,9,13,137.0,82,5.14,57,348,2300,9.2
7770,Dennis Seidenberg,2008-09,27.0,6,18,63,63,3,15,18,83.0,1070.0,126,7,24,31,220.0,82,6.05,85,480,2458,10.1
7771,Dennis Seidenberg,2009-10,28.0,7,8,52,52,2,6,8,83.0,841.0,178,9,30,39,303.0,82,5.76,70,398,2426,9.7
7772,Dennis Seidenberg,2010-11,29.0,8,15,47,47,0,15,15,80.0,885.0,225,9,45,54,383.0,82,5.44,62,351,2383,9.4
7773,Dennis Seidenberg,2011-12,30.0,9,30,70,70,5,25,30,129.0,1563.0,295,14,70,84,512.0,82,5.7,65,341,2477,9.4
7774,Dennis Seidenberg,2012-13,31.0,10,32,79,79,4,28,32,153.0,1811.0,374,18,98,116,665.0,82,5.53,56,304,2486,9.1
7775,Dennis Seidenberg,2013-14,32.0,11,32,81,81,7,25,32,166.0,1907.0,455,25,123,148,831.0,82,5.46,52,291,2492,9.0
7776,Dennis Seidenberg,2014-15,33.0,12,23,80,80,5,18,23,174.0,1923.0,535,30,141,171,1005.0,82,5.32,47,271,2439,8.9
7777,Dennis Seidenberg,2015-16,34.0,13,17,46,46,4,13,17,83.0,1094.0,581,34,154,188,1088.0,48,5.31,29,160,1399,9.1
7778,Dennis Seidenberg,2016-17,35.0,14,10,34,34,1,9,10,53.0,742.0,615,35,163,198,1141.0,82,5.34,48,269,2463,8.9
7779,Dennis Seidenberg,2017-18,36.0,15,14,82,82,3,11,14,103.0,1812.0,697,38,174,212,1244.0,82,5.32,47,251,2453,8.9
7780,Dennis Seidenberg,2018-19,37.0,16,12,61,61,1,11,12,66.0,1183.0,758,39,185,224,1310.0,82,5.34,48,255,2438,9.0
7781,Dennis Seidenberg,2019-20,38.0,17,22,73,73,5,17,22,89.0,1418.0,831,44,202,246,1399.0,82,5.45,47,245,2478,9.0
7782,Dennis Seidenberg,2020-21,39.0,18,5,28,28,0,5,5,31.0,501.0,859,44,207,251,1430.0,82,5.86,50,250,2620,9.2
7783,Dennis Smith,1992-93,28.0,4,0,4,4,0,0,0,0.0,,4,0,0,0,0.0,80,7.37,76,367,2421,12.2
7784,Dennis Smith,1993-94,29.0,5,0,4,4,0,0,0,1.0,,8,0,0,0,1.0,80,6.91,71,366,2385,11.6
7785,Dennis Sobchuk,1982-83,29.0,4,10,33,33,4,6,10,47.0,,33,4,6,10,47.0,80,7.03,61,280,2352,12.0
7786,Dennis Sobchuk,1985-86,32.0,5,1,2,2,1,0,1,2.0,,35,5,6,11,49.0,80,7.73,71,310,2444,12.7
7787,Dennis Vaske,1993-94,26.0,4,0,5,5,0,0,0,3.0,,5,0,0,0,3.0,80,6.91,71,366,2385,11.6
7788,Dennis Vaske,1994-95,27.0,5,1,39,39,0,1,1,26.0,,44,0,1,1,29.0,80,6.96,77,402,2440,11.4
7789,Dennis Vaske,1995-96,28.0,6,6,27,27,1,5,6,15.0,,71,1,6,7,44.0,84,7.25,87,443,2603,11.7
7790,Dennis Vaske,1996-97,29.0,7,13,65,65,2,11,13,71.0,,136,3,17,20,115.0,84,6.48,76,407,2545,10.7
7791,Dennis Vaske,1997-98,30.0,8,12,41,41,1,11,12,48.0,,177,4,28,32,163.0,48,5.97,37,209,1408,10.2
7792,Dennis Vaske,1998-99,31.0,9,7,19,19,1,6,7,19.0,,196,5,34,39,182.0,82,6.29,74,413,2481,10.4
7793,Dennis Vaske,1999-00,32.0,10,4,17,17,0,4,4,19.0,,213,5,38,43,201.0,82,5.83,55,336,2444,9.8
7794,Dennis Vaske,2000-01,33.0,11,3,19,19,0,3,3,16.0,,232,5,41,46,217.0,82,5.28,57,380,2242,9.6
7795,Dennis Vaske,2001-02,34.0,12,0,3,3,0,0,0,0.0,25.0,235,5,41,46,217.0,82,5.27,57,359,2285,9.4
7796,Dennis Vial,1993-94,24.0,4,0,30,30,0,0,0,8.0,,30,0,0,0,8.0,80,6.91,71,366,2385,11.6
7797,Dennis Vial,1994-95,25.0,5,1,27,27,1,0,1,6.0,,57,1,0,1,14.0,80,6.96,77,402,2440,11.4
7798,Dennis Vial,1995-96,26.0,6,1,9,9,0,1,1,5.0,,66,1,1,2,19.0,84,7.25,87,443,2603,11.7
7799,Dennis Vial,1996-97,27.0,7,7,55,55,2,5,7,37.0,,121,3,6,9,56.0,84,6.48,76,407,2545,10.7
7800,Dennis Vial,1997-98,28.0,8,4,27,27,0,4,4,9.0,,148,3,10,13,65.0,48,5.97,37,209,1408,10.2
7801,Dennis Vial,1998-99,29.0,9,5,64,64,1,4,5,33.0,,212,4,14,18,98.0,82,6.29,74,413,2481,10.4
7802,Dennis Vial,1999-00,30.0,10,1,11,11,0,1,1,4.0,,223,4,15,19,102.0,82,5.83,55,336,2444,9.8
7803,Dennis Vial,2000-01,31.0,11,0,19,19,0,0,0,9.0,,242,4,15,19,111.0,82,5.28,57,380,2242,9.6
7804,Dennis Wideman,2008-09,25.0,4,24,67,67,8,16,24,150.0,1453.0,67,8,16,24,150.0,82,6.05,85,480,2458,10.1
7805,Dennis Wideman,2009-10,26.0,5,25,75,75,6,19,25,122.0,1458.0,142,14,35,49,272.0,82,5.76,70,398,2426,9.7
7806,Dennis Wideman,2010-11,27.0,6,36,81,81,13,23,36,171.0,2038.0,223,27,58,85,443.0,82,5.44,62,351,2383,9.4
7807,Dennis Wideman,2011-12,28.0,7,50,79,79,13,37,50,169.0,1947.0,302,40,95,135,612.0,82,5.7,65,341,2477,9.4
7808,Dennis Wideman,2012-13,29.0,8,30,76,76,6,24,30,146.0,1790.0,378,46,119,165,758.0,82,5.53,56,304,2486,9.1
7809,Dennis Wideman,2013-14,30.0,9,40,75,75,10,30,40,160.0,1799.0,453,56,149,205,918.0,82,5.46,52,291,2492,9.0
7810,Dennis Wideman,2014-15,31.0,10,46,82,82,11,35,46,175.0,1960.0,535,67,184,251,1093.0,82,5.32,47,271,2439,8.9
7811,Dennis Wideman,2015-16,32.0,11,22,46,46,6,16,22,94.0,1151.0,581,73,200,273,1187.0,48,5.31,29,160,1399,9.1
7812,Dennis Wideman,2016-17,33.0,12,21,46,46,4,17,21,102.0,1044.0,627,77,217,294,1289.0,82,5.34,48,269,2463,8.9
7813,Dennis Wideman,2017-18,34.0,13,56,80,80,15,41,56,173.0,1971.0,707,92,258,350,1462.0,82,5.32,47,251,2453,8.9
7814,Dennis Wideman,2018-19,35.0,14,19,51,51,2,17,19,75.0,1051.0,758,94,275,369,1537.0,82,5.34,48,255,2438,9.0
7815,Dennis Wideman,2019-20,36.0,15,18,57,57,5,13,18,87.0,1153.0,815,99,288,387,1624.0,82,5.45,47,245,2478,9.0
7816,Denny Felsner,1994-95,24.0,4,1,3,3,0,1,1,2.0,,3,0,1,1,2.0,80,6.96,77,402,2440,11.4
7817,Denny Felsner,1995-96,25.0,5,3,6,6,0,3,3,4.0,,9,0,4,4,6.0,84,7.25,87,443,2603,11.7
7818,Denny Felsner,1996-97,26.0,6,1,6,6,1,0,1,6.0,,15,1,4,5,12.0,84,6.48,76,407,2545,10.7
7819,Denny Felsner,1997-98,27.0,7,0,3,3,0,0,0,2.0,,18,1,4,5,14.0,48,5.97,37,209,1408,10.2
7820,Denny Lambert,1997-98,28.0,4,4,13,13,1,3,4,14.0,,13,1,3,4,14.0,48,5.97,37,209,1408,10.2
7821,Denny Lambert,1998-99,29.0,5,8,33,33,0,8,8,28.0,,46,1,11,12,42.0,82,6.29,74,413,2481,10.4
7822,Denny Lambert,1999-00,30.0,6,20,80,80,4,16,20,58.0,,126,5,27,32,100.0,82,5.83,55,336,2444,9.8
7823,Denny Lambert,2000-01,31.0,7,19,72,72,9,10,19,76.0,,198,14,37,51,176.0,82,5.28,57,380,2242,9.6
7824,Denny Lambert,2001-02,32.0,8,16,76,76,5,11,16,66.0,785.0,274,19,48,67,242.0,82,5.27,57,359,2285,9.4
7825,Denny Lambert,2002-03,33.0,9,11,73,73,5,6,11,83.0,850.0,347,24,54,78,325.0,82,5.49,53,331,2294,9.8
7826,Denny Lambert,2003-04,34.0,10,8,67,67,1,7,8,44.0,612.0,414,25,61,86,369.0,82,5.51,63,376,2272,9.9
7827,Denny Lambert,2004-05,35.0,11,7,73,73,2,5,7,51.0,510.0,487,27,66,93,420.0,82,5.24,53,338,2262,9.5
7828,Derek Armstrong,1996-97,23.0,4,0,1,1,0,0,0,2.0,,1,0,0,0,2.0,84,6.48,76,407,2545,10.7
7829,Derek Armstrong,1998-99,25.0,5,4,19,19,1,3,4,23.0,,20,1,3,4,25.0,82,6.29,74,413,2481,10.4
7830,Derek Armstrong,1999-00,26.0,6,13,50,50,6,7,13,36.0,,70,7,10,17,61.0,82,5.83,55,336,2444,9.8
7831,Derek Armstrong,2000-01,27.0,7,2,9,9,2,0,2,8.0,,79,9,10,19,69.0,82,5.28,57,380,2242,9.6
7832,Derek Armstrong,2001-02,28.0,8,0,3,3,0,0,0,1.0,9.0,82,9,10,19,70.0,82,5.27,57,359,2285,9.4
7833,Derek Armstrong,2002-03,29.0,9,0,1,1,0,0,0,1.0,3.0,83,9,10,19,71.0,82,5.49,53,331,2294,9.8
7834,Derek Armstrong,2003-04,30.0,10,0,3,3,0,0,0,6.0,34.0,86,9,10,19,77.0,82,5.51,63,376,2272,9.9
7835,Derek Armstrong,2005-06,32.0,11,38,66,66,12,26,38,106.0,1034.0,152,21,36,57,183.0,82,5.31,60,363,2326,9.4
7836,Derek Armstrong,2006-07,33.0,12,35,57,57,14,21,35,101.0,969.0,209,35,57,92,284.0,82,5.14,57,348,2300,9.2
7837,Derek Armstrong,2008-09,35.0,13,41,62,62,13,28,41,100.0,962.0,271,48,85,133,384.0,82,6.05,85,480,2458,10.1
7838,Derek Armstrong,2009-10,36.0,14,44,67,67,11,33,44,109.0,1009.0,338,59,118,177,493.0,82,5.76,70,398,2426,9.7
7839,Derek Armstrong,2010-11,37.0,15,35,77,77,8,27,35,118.0,1023.0,415,67,145,212,611.0,82,5.44,62,351,2383,9.4
7840,Derek Armstrong,2011-12,38.0,16,9,56,56,5,4,9,42.0,475.0,471,72,149,221,653.0,82,5.7,65,341,2477,9.4
7841,Derek Armstrong,2012-13,39.0,17,0,6,6,0,0,0,6.0,42.0,477,72,149,221,659.0,82,5.53,56,304,2486,9.1
7842,Derek Bekar,2002-03,27.0,4,0,1,1,0,0,0,0.0,5.0,1,0,0,0,0.0,82,5.49,53,331,2294,9.8
7843,Derek Bekar,2005-06,30.0,5,0,6,6,0,0,0,4.0,45.0,7,0,0,0,4.0,82,5.31,60,363,2326,9.4
7844,Derek Bekar,2006-07,31.0,6,0,4,4,0,0,0,3.0,22.0,11,0,0,0,7.0,82,5.14,57,348,2300,9.2
7845,Derek Boogaard,2008-09,26.0,4,6,65,65,2,4,6,15.0,350.0,65,2,4,6,15.0,82,6.05,85,480,2458,10.1
7846,Derek Boogaard,2009-10,27.0,5,1,48,48,0,1,1,11.0,222.0,113,2,5,7,26.0,82,5.76,70,398,2426,9.7
7847,Derek Boogaard,2010-11,28.0,6,0,34,34,0,0,0,6.0,134.0,147,2,5,7,32.0,82,5.44,62,351,2383,9.4
7848,Derek Boogaard,2011-12,29.0,7,3,51,51,0,3,3,13.0,255.0,198,2,8,10,45.0,82,5.7,65,341,2477,9.4
7849,Derek Boogaard,2012-13,30.0,8,4,57,57,0,4,4,26.0,351.0,255,2,12,14,71.0,82,5.53,56,304,2486,9.1
7850,Derek Boogaard,2013-14,31.0,9,2,22,22,1,1,2,4.0,100.0,277,3,13,16,75.0,82,5.46,52,291,2492,9.0
7851,Derek Dorsett,2011-12,25.0,4,5,52,52,4,1,5,59.0,462.0,52,4,1,5,59.0,82,5.7,65,341,2477,9.4
7852,Derek Dorsett,2012-13,26.0,5,14,51,51,4,10,14,57.0,555.0,103,8,11,19,116.0,82,5.53,56,304,2486,9.1
7853,Derek Dorsett,2013-14,27.0,6,17,76,76,4,13,17,112.0,1004.0,179,12,24,36,228.0,82,5.46,52,291,2492,9.0
7854,Derek Dorsett,2014-15,28.0,7,20,77,77,12,8,20,137.0,1131.0,256,24,32,56,365.0,82,5.32,47,271,2439,8.9
7855,Derek Dorsett,2015-16,29.0,8,9,24,24,3,6,9,38.0,384.0,280,27,38,65,403.0,48,5.31,29,160,1399,9.1
7856,Derek Dorsett,2016-17,30.0,9,8,51,51,4,4,8,67.0,562.0,331,31,42,73,470.0,82,5.34,48,269,2463,8.9
7857,Derek Dorsett,2017-18,31.0,10,25,79,79,7,18,25,89.0,952.0,410,38,60,98,559.0,82,5.32,47,251,2453,8.9
7858,Derek Dorsett,2018-19,32.0,11,16,71,71,5,11,16,91.0,894.0,481,43,71,114,650.0,82,5.34,48,255,2438,9.0
7859,Derek Dorsett,2019-20,33.0,12,4,14,14,1,3,4,24.0,139.0,495,44,74,118,674.0,82,5.45,47,245,2478,9.0
7860,Derek Dorsett,2020-21,34.0,13,9,20,20,7,2,9,26.0,306.0,515,51,76,127,700.0,82,5.86,50,250,2620,9.2
7861,Derek Forbort,2018-19,26.0,4,2,14,14,1,1,2,14.0,155.0,14,1,1,2,14.0,82,5.34,48,255,2438,9.0
7862,Derek Forbort,2019-20,27.0,5,18,82,82,2,16,18,100.0,1650.0,96,3,17,20,114.0,82,5.45,47,245,2478,9.0
7863,Derek Forbort,2020-21,28.0,6,18,78,78,1,17,18,78.0,1621.0,174,4,34,38,192.0,82,5.86,50,250,2620,9.2
7864,Derek Forbort,2021-22,29.0,7,14,81,81,2,12,14,75.0,1680.0,255,6,46,52,267.0,82,5.96,47,239,2579,9.5
7865,Derek Forbort,2022-23,30.0,8,1,20,20,0,1,1,22.0,356.0,275,6,47,53,289.0,70,5.96,42,208,2192,9.5
7866,Derek Grant,2015-16,25.0,4,0,5,5,0,0,0,5.0,43.0,5,0,0,0,5.0,48,5.31,29,160,1399,9.1
7867,Derek Grant,2016-17,26.0,5,2,20,20,0,2,2,31.0,191.0,25,0,2,2,36.0,82,5.34,48,269,2463,8.9
7868,Derek Grant,2018-19,28.0,6,1,15,15,0,1,1,22.0,163.0,40,0,3,3,58.0,82,5.34,48,255,2438,9.0
7869,Derek Grant,2019-20,29.0,7,4,46,46,0,4,4,40.0,449.0,86,0,7,7,98.0,82,5.45,47,245,2478,9.0
7870,Derek Grant,2020-21,30.0,8,24,66,66,12,12,24,65.0,732.0,152,12,19,31,163.0,82,5.86,50,250,2620,9.2
7871,Derek Grant,2021-22,31.0,9,14,56,56,4,10,14,74.0,654.0,208,16,29,45,237.0,82,5.96,47,239,2579,9.5
7872,Derek Grant,2022-23,32.0,10,25,56,56,15,10,25,94.0,779.0,264,31,39,70,331.0,70,5.96,42,208,2192,9.5
7873,Derek Joslin,2011-12,24.0,4,0,12,12,0,0,0,9.0,136.0,12,0,0,0,9.0,82,5.7,65,341,2477,9.4
7874,Derek Joslin,2012-13,25.0,5,3,24,24,0,3,3,19.0,333.0,36,0,3,3,28.0,82,5.53,56,304,2486,9.1
7875,Derek Joslin,2013-14,26.0,6,9,34,34,2,7,9,34.0,519.0,70,2,10,12,62.0,82,5.46,52,291,2492,9.0
7876,Derek Joslin,2014-15,27.0,7,4,44,44,2,2,4,36.0,466.0,114,4,12,16,98.0,82,5.32,47,271,2439,8.9
7877,Derek Joslin,2015-16,28.0,8,0,2,2,0,0,0,2.0,34.0,116,4,12,16,100.0,48,5.31,29,160,1399,9.1
7878,Derek King,1989-90,22.0,4,0,2,2,0,0,0,5.0,,2,0,0,0,5.0,80,7.34,72,344,2400,12.2
7879,Derek King,1990-91,23.0,5,36,55,55,12,24,36,94.0,,57,12,24,36,99.0,80,7.43,89,437,2435,12.2
7880,Derek King,1991-92,24.0,6,43,60,60,14,29,43,103.0,,117,26,53,79,202.0,80,7.48,85,403,2430,12.3
7881,Derek King,1992-93,25.0,7,40,46,46,13,27,40,91.0,,163,39,80,119,293.0,80,7.37,76,367,2421,12.2
7882,Derek King,1993-94,26.0,8,45,66,66,19,26,45,130.0,,229,58,106,164,423.0,80,6.91,71,366,2385,11.6
7883,Derek King,1994-95,27.0,9,78,80,80,40,38,78,189.0,,309,98,144,242,612.0,80,6.96,77,402,2440,11.4
7884,Derek King,1995-96,28.0,10,76,77,77,38,38,76,201.0,,386,136,182,318,813.0,84,7.25,87,443,2603,11.7
7885,Derek King,1996-97,29.0,11,70,78,78,30,40,70,171.0,,464,166,222,388,984.0,84,6.48,76,407,2545,10.7
7886,Derek King,1997-98,30.0,12,26,43,43,10,16,26,118.0,,507,176,238,414,1102.0,48,5.97,37,209,1408,10.2
7887,Derek King,1998-99,31.0,13,32,61,61,12,20,32,154.0,,568,188,258,446,1256.0,82,6.29,74,413,2481,10.4
7888,Derek King,1999-00,32.0,14,59,82,82,26,33,59,181.0,,650,214,291,505,1437.0,82,5.83,55,336,2444,9.8
7889,Derek King,2000-01,33.0,15,46,77,77,21,25,46,166.0,,727,235,316,551,1603.0,82,5.28,57,380,2242,9.6
7890,Derek King,2001-02,34.0,16,52,81,81,24,28,52,150.0,1137.0,808,259,344,603,1753.0,82,5.27,57,359,2285,9.4
7891,Derek King,2002-03,35.0,17,9,22,22,2,7,9,33.0,276.0,830,261,351,612,1786.0,82,5.49,53,331,2294,9.8
7892,Derek Laxdal,1987-88,21.0,4,0,3,3,0,0,0,3.0,,3,0,0,0,3.0,80,7.77,71,321,2447,12.7
7893,Derek Laxdal,1989-90,23.0,5,0,2,2,0,0,0,0.0,,5,0,0,0,3.0,80,7.34,72,344,2400,12.2
7894,Derek Laxdal,1990-91,24.0,6,0,5,5,0,0,0,2.0,,10,0,0,0,5.0,80,7.43,89,437,2435,12.2
7895,Derek Laxdal,1991-92,25.0,7,15,41,41,9,6,15,41.0,,51,9,6,15,46.0,80,7.48,85,403,2430,12.3
7896,Derek Laxdal,1992-93,26.0,8,4,12,12,3,1,4,20.0,,63,12,7,19,66.0,80,7.37,76,367,2421,12.2
7897,Derek Laxdal,1993-94,27.0,9,0,4,4,0,0,0,3.0,,67,12,7,19,69.0,80,6.91,71,366,2385,11.6
7898,Derek MacKenzie,2004-05,23.0,4,0,1,1,0,0,0,1.0,14.0,1,0,0,0,1.0,82,5.24,53,338,2262,9.5
7899,Derek MacKenzie,2006-07,25.0,5,1,12,12,0,1,1,7.0,80.0,13,0,1,1,8.0,82,5.14,57,348,2300,9.2
7900,Derek MacKenzie,2008-09,27.0,6,1,11,11,0,1,1,11.0,72.0,24,0,2,2,19.0,82,6.05,85,480,2458,10.1
7901,Derek MacKenzie,2009-10,28.0,7,0,4,4,0,0,0,3.0,20.0,28,0,2,2,22.0,82,5.76,70,398,2426,9.7
7902,Derek MacKenzie,2010-11,29.0,8,2,17,17,2,0,2,19.0,132.0,45,2,2,4,41.0,82,5.44,62,351,2383,9.4
7903,Derek MacKenzie,2011-12,30.0,9,0,1,1,0,0,0,1.0,7.0,46,2,2,4,42.0,82,5.7,65,341,2477,9.4
7904,Derek MacKenzie,2012-13,31.0,10,4,18,18,1,3,4,14.0,156.0,64,3,5,8,56.0,82,5.53,56,304,2486,9.1
7905,Derek MacKenzie,2013-14,32.0,11,23,63,63,9,14,23,76.0,683.0,127,12,19,31,132.0,82,5.46,52,291,2492,9.0
7906,Derek MacKenzie,2014-15,33.0,12,14,66,66,7,7,14,61.0,693.0,193,19,26,45,193.0,82,5.32,47,271,2439,8.9
7907,Derek MacKenzie,2015-16,34.0,13,8,43,43,3,5,8,33.0,445.0,236,22,31,53,226.0,48,5.31,29,160,1399,9.1
7908,Derek MacKenzie,2016-17,35.0,14,18,71,71,9,9,18,70.0,800.0,307,31,40,71,296.0,82,5.34,48,269,2463,8.9
7909,Derek MacKenzie,2017-18,36.0,15,11,82,82,5,6,11,72.0,1021.0,389,36,46,82,368.0,82,5.32,47,251,2453,8.9
7910,Derek MacKenzie,2018-19,37.0,16,13,64,64,6,7,13,79.0,842.0,453,42,53,95,447.0,82,5.34,48,255,2438,9.0
7911,Derek MacKenzie,2019-20,38.0,17,16,82,82,6,10,16,91.0,1030.0,535,48,63,111,538.0,82,5.45,47,245,2478,9.0
7912,Derek MacKenzie,2020-21,39.0,18,14,75,75,3,11,14,86.0,848.0,610,51,74,125,624.0,82,5.86,50,250,2620,9.2
7913,Derek MacKenzie,2021-22,40.0,19,0,1,1,0,0,0,0.0,3.0,611,51,74,125,624.0,82,5.96,47,239,2579,9.5
7914,Derek Mayer,1996-97,29.0,4,4,17,17,2,2,4,29.0,,17,2,2,4,29.0,84,6.48,76,407,2545,10.7
7915,Derek Meech,2009-10,25.0,4,0,4,4,0,0,0,3.0,23.0,4,0,0,0,3.0,82,5.76,70,398,2426,9.7
7916,Derek Meech,2010-11,26.0,5,3,32,32,0,3,3,44.0,388.0,36,0,3,3,47.0,82,5.44,62,351,2383,9.4
7917,Derek Meech,2011-12,27.0,6,7,41,41,2,5,7,44.0,412.0,77,2,8,10,91.0,82,5.7,65,341,2477,9.4
7918,Derek Meech,2012-13,28.0,7,6,49,49,2,4,6,57.0,584.0,126,4,12,16,148.0,82,5.53,56,304,2486,9.1
7919,Derek Meech,2014-15,30.0,8,0,2,2,0,0,0,2.0,23.0,128,4,12,16,150.0,82,5.32,47,271,2439,8.9
7920,Derek Meech,2015-16,31.0,9,1,16,16,0,1,1,5.0,235.0,144,4,13,17,155.0,48,5.31,29,160,1399,9.1
7921,Derek Morris,2000-01,22.0,4,29,82,82,9,20,29,120.0,,82,9,20,29,120.0,82,5.28,57,380,2242,9.6
7922,Derek Morris,2001-02,23.0,5,34,71,71,7,27,34,150.0,1472.0,153,16,47,63,270.0,82,5.27,57,359,2285,9.4
7923,Derek Morris,2002-03,24.0,6,38,78,78,9,29,38,193.0,1938.0,231,25,76,101,463.0,82,5.49,53,331,2294,9.8
7924,Derek Morris,2003-04,25.0,7,28,51,51,5,23,28,142.0,1318.0,282,30,99,129,605.0,82,5.51,63,376,2272,9.9
7925,Derek Morris,2004-05,26.0,8,34,61,61,4,30,34,166.0,1505.0,343,34,129,163,771.0,82,5.24,53,338,2262,9.5
7926,Derek Morris,2005-06,27.0,9,48,75,75,11,37,48,191.0,1787.0,418,45,166,211,962.0,82,5.31,60,363,2326,9.4
7927,Derek Morris,2006-07,28.0,10,32,83,83,6,26,32,167.0,1792.0,501,51,192,243,1129.0,82,5.14,57,348,2300,9.2
7928,Derek Morris,2008-09,30.0,11,27,53,53,6,21,27,91.0,1106.0,554,57,213,270,1220.0,82,6.05,85,480,2458,10.1
7929,Derek Morris,2009-10,31.0,12,25,82,82,6,19,25,129.0,1680.0,636,63,232,295,1349.0,82,5.76,70,398,2426,9.7
7930,Derek Morris,2010-11,32.0,13,25,82,82,8,17,25,135.0,1781.0,718,71,249,320,1484.0,82,5.44,62,351,2383,9.4
7931,Derek Morris,2011-12,33.0,14,20,75,75,5,15,20,120.0,1567.0,793,76,264,340,1604.0,82,5.7,65,341,2477,9.4
7932,Derek Morris,2012-13,34.0,15,29,76,76,4,25,29,120.0,1630.0,869,80,289,369,1724.0,82,5.53,56,304,2486,9.1
7933,Derek Morris,2013-14,35.0,16,16,77,77,5,11,16,83.0,1622.0,946,85,300,385,1807.0,82,5.46,52,291,2492,9.0
7934,Derek Morris,2014-15,36.0,17,11,59,59,2,9,11,72.0,1120.0,1005,87,309,396,1879.0,82,5.32,47,271,2439,8.9
7935,Derek Morris,2015-16,37.0,18,11,39,39,0,11,11,68.0,834.0,1044,87,320,407,1947.0,48,5.31,29,160,1399,9.1
7936,Derek Morris,2016-17,38.0,19,17,63,63,5,12,17,82.0,1225.0,1107,92,332,424,2029.0,82,5.34,48,269,2463,8.9
7937,Derek Peltier,2011-12,26.0,4,0,11,11,0,0,0,7.0,146.0,11,0,0,0,7.0,82,5.7,65,341,2477,9.4
7938,Derek Peltier,2012-13,27.0,5,0,3,3,0,0,0,1.0,27.0,14,0,0,0,8.0,82,5.53,56,304,2486,9.1
7939,Derek Plante,1996-97,26.0,4,56,77,77,21,35,56,147.0,,77,21,35,56,147.0,84,6.48,76,407,2545,10.7
7940,Derek Plante,1997-98,27.0,5,22,47,47,3,19,22,94.0,,124,24,54,78,241.0,48,5.97,37,209,1408,10.2
7941,Derek Plante,1998-99,28.0,6,56,76,76,23,33,56,203.0,,200,47,87,134,444.0,82,6.29,74,413,2481,10.4
7942,Derek Plante,1999-00,29.0,7,53,82,82,27,26,53,191.0,,282,74,113,187,635.0,82,5.83,55,336,2444,9.8
7943,Derek Plante,2000-01,30.0,8,34,72,72,13,21,34,150.0,,354,87,134,221,785.0,82,5.28,57,380,2242,9.6
7944,Derek Plante,2001-02,31.0,9,20,51,51,6,14,20,90.0,773.0,405,93,148,241,875.0,82,5.27,57,359,2285,9.4
7945,Derek Plante,2002-03,32.0,10,4,33,33,2,2,4,31.0,294.0,438,95,150,245,906.0,82,5.49,53,331,2294,9.8
7946,Derek Plante,2003-04,33.0,11,3,12,12,1,2,3,20.0,198.0,450,96,152,248,926.0,82,5.51,63,376,2272,9.9
7947,Derek Roy,2006-07,23.0,4,19,49,49,9,10,19,71.0,750.0,49,9,10,19,71.0,82,5.14,57,348,2300,9.2
7948,Derek Roy,2008-09,25.0,5,46,70,70,18,28,46,151.0,1192.0,119,27,38,65,222.0,82,6.05,85,480,2458,10.1
7949,Derek Roy,2009-10,26.0,6,63,75,75,21,42,63,130.0,1385.0,194,48,80,128,352.0,82,5.76,70,398,2426,9.7
7950,Derek Roy,2010-11,27.0,7,81,78,78,32,49,81,218.0,1636.0,272,80,129,209,570.0,82,5.44,62,351,2383,9.4
7951,Derek Roy,2011-12,28.0,8,70,82,82,28,42,70,221.0,1738.0,354,108,171,279,791.0,82,5.7,65,341,2477,9.4
7952,Derek Roy,2012-13,29.0,9,69,80,80,26,43,69,215.0,1551.0,434,134,214,348,1006.0,82,5.53,56,304,2486,9.1
7953,Derek Roy,2013-14,30.0,10,35,35,35,10,25,35,89.0,684.0,469,144,239,383,1095.0,82,5.46,52,291,2492,9.0
7954,Derek Roy,2014-15,31.0,11,44,80,80,17,27,44,176.0,1546.0,549,161,266,427,1271.0,82,5.32,47,271,2439,8.9
7955,Derek Roy,2015-16,32.0,12,28,42,42,7,21,28,85.0,781.0,591,168,287,455,1356.0,48,5.31,29,160,1399,9.1
7956,Derek Roy,2016-17,33.0,13,37,75,75,9,28,37,114.0,1022.0,666,177,315,492,1470.0,82,5.34,48,269,2463,8.9
7957,Derek Roy,2017-18,34.0,14,32,72,72,12,20,32,113.0,1128.0,738,189,335,524,1583.0,82,5.32,47,251,2453,8.9
7958,Derek Ryan,2018-19,32.0,4,2,6,6,2,0,2,5.0,73.0,6,2,0,2,5.0,82,5.34,48,255,2438,9.0
7959,Derek Ryan,2019-20,33.0,5,29,67,67,11,18,29,73.0,998.0,73,13,18,31,78.0,82,5.45,47,245,2478,9.0
7960,Derek Ryan,2020-21,34.0,6,38,80,80,15,23,38,135.0,1248.0,153,28,41,69,213.0,82,5.86,50,250,2620,9.2
7961,Derek Ryan,2021-22,35.0,7,38,81,81,13,25,38,103.0,1118.0,234,41,66,107,316.0,82,5.96,47,239,2579,9.5
7962,Derek Ryan,2022-23,36.0,8,29,68,68,10,19,29,102.0,989.0,302,51,85,136,418.0,70,5.96,42,208,2192,9.5
7963,Derek Smith,2012-13,28.0,4,0,2,2,0,0,0,4.0,25.0,2,0,0,0,4.0,82,5.53,56,304,2486,9.1
7964,Derek Smith,2013-14,29.0,5,1,9,9,0,1,1,13.0,138.0,11,0,1,1,17.0,82,5.46,52,291,2492,9.0
7965,Derek Smith,2014-15,30.0,6,11,47,47,2,9,11,44.0,749.0,58,2,10,12,61.0,82,5.32,47,271,2439,8.9
7966,Derek Smith,2015-16,31.0,7,1,22,22,0,1,1,18.0,269.0,80,2,11,13,79.0,48,5.31,29,160,1399,9.1
7967,Derek Smith,2016-17,32.0,8,1,14,14,0,1,1,12.0,133.0,94,2,12,14,91.0,82,5.34,48,269,2463,8.9
7968,Derek Stepan,2013-14,23.0,4,45,82,82,21,24,45,166.0,1348.0,82,21,24,45,166.0,82,5.46,52,291,2492,9.0
7969,Derek Stepan,2014-15,24.0,5,51,82,82,17,34,51,169.0,1554.0,164,38,58,96,335.0,82,5.32,47,271,2439,8.9
7970,Derek Stepan,2015-16,25.0,6,44,48,48,18,26,44,108.0,1004.0,212,56,84,140,443.0,48,5.31,29,160,1399,9.1
7971,Derek Stepan,2016-17,26.0,7,57,82,82,17,40,57,199.0,1481.0,294,73,124,197,642.0,82,5.34,48,269,2463,8.9
7972,Derek Stepan,2017-18,27.0,8,55,68,68,16,39,55,155.0,1236.0,362,89,163,252,797.0,82,5.32,47,251,2453,8.9
7973,Derek Stepan,2018-19,28.0,9,53,72,72,22,31,53,192.0,1278.0,434,111,194,305,989.0,82,5.34,48,255,2438,9.0
7974,Derek Stepan,2019-20,29.0,10,55,81,81,17,38,55,209.0,1507.0,515,128,232,360,1198.0,82,5.45,47,245,2478,9.0
7975,Derek Stepan,2020-21,30.0,11,56,82,82,14,42,56,209.0,1580.0,597,142,274,416,1407.0,82,5.86,50,250,2620,9.2
7976,Derek Stepan,2021-22,31.0,12,35,72,72,15,20,35,195.0,1384.0,669,157,294,451,1602.0,82,5.96,47,239,2579,9.5
7977,Derek Stepan,2022-23,32.0,13,28,70,70,10,18,28,158.0,1235.0,739,167,312,479,1760.0,70,5.96,42,208,2192,9.5
7978,Derek Whitmore,2014-15,30.0,4,0,2,2,0,0,0,2.0,25.0,2,0,0,0,2.0,82,5.32,47,271,2439,8.9
7979,Derian Hatcher,1994-95,22.0,4,12,43,43,8,4,12,51.0,,43,8,4,12,51.0,80,6.96,77,402,2440,11.4
7980,Derian Hatcher,1995-96,23.0,5,19,67,67,4,15,19,73.0,,110,12,19,31,124.0,84,7.25,87,443,2603,11.7
7981,Derian Hatcher,1996-97,24.0,6,31,83,83,12,19,31,132.0,,193,24,38,62,256.0,84,6.48,76,407,2545,10.7
7982,Derian Hatcher,1997-98,25.0,7,16,43,43,5,11,16,74.0,,236,29,49,78,330.0,48,5.97,37,209,1408,10.2
7983,Derian Hatcher,1998-99,26.0,8,31,79,79,8,23,31,125.0,,315,37,72,109,455.0,82,6.29,74,413,2481,10.4
7984,Derian Hatcher,1999-00,27.0,9,22,63,63,3,19,22,96.0,,378,40,91,131,551.0,82,5.83,55,336,2444,9.8
7985,Derian Hatcher,2000-01,28.0,10,31,70,70,6,25,31,74.0,,448,46,116,162,625.0,82,5.28,57,380,2242,9.6
7986,Derian Hatcher,2001-02,29.0,11,30,80,80,9,21,30,125.0,1979.0,528,55,137,192,750.0,82,5.27,57,359,2285,9.4
7987,Derian Hatcher,2002-03,30.0,12,24,57,57,2,22,24,90.0,1570.0,585,57,159,216,840.0,82,5.49,53,331,2294,9.8
7988,Derian Hatcher,2003-04,31.0,13,23,80,80,2,21,23,97.0,2070.0,665,59,180,239,937.0,82,5.51,63,376,2272,9.9
7989,Derian Hatcher,2004-05,32.0,14,25,80,80,4,21,25,111.0,2134.0,745,63,201,264,1048.0,82,5.24,53,338,2262,9.5
7990,Derian Hatcher,2005-06,33.0,15,30,82,82,8,22,30,159.0,2120.0,827,71,223,294,1207.0,82,5.31,60,363,2326,9.4
7991,Derian Hatcher,2006-07,34.0,16,4,15,15,0,4,4,18.0,295.0,842,71,227,298,1225.0,82,5.14,57,348,2300,9.2
7992,Derian Hatcher,2008-09,36.0,17,17,77,77,4,13,17,98.0,1809.0,919,75,240,315,1323.0,82,6.05,85,480,2458,10.1
7993,Derian Hatcher,2009-10,37.0,18,9,82,82,3,6,9,81.0,1941.0,1001,78,246,324,1404.0,82,5.76,70,398,2426,9.7
7994,Derian Hatcher,2010-11,38.0,19,7,44,44,2,5,7,27.0,928.0,1045,80,251,331,1431.0,82,5.44,62,351,2383,9.4
7995,Derick Brassard,2010-11,23.0,4,2,17,17,1,1,2,13.0,154.0,17,1,1,2,13.0,82,5.44,62,351,2383,9.4
7996,Derick Brassard,2011-12,24.0,5,25,31,31,10,15,25,59.0,447.0,48,11,16,27,72.0,82,5.7,65,341,2477,9.4
7997,Derick Brassard,2012-13,25.0,6,36,79,79,9,27,36,125.0,1180.0,127,20,43,63,197.0,82,5.53,56,304,2486,9.1
7998,Derick Brassard,2013-14,26.0,7,47,74,74,17,30,47,183.0,1260.0,201,37,73,110,380.0,82,5.46,52,291,2492,9.0
7999,Derick Brassard,2014-15,27.0,8,41,74,74,14,27,41,125.0,1209.0,275,51,100,151,505.0,82,5.32,47,271,2439,8.9
8000,Derick Brassard,2015-16,28.0,9,29,47,47,12,17,29,88.0,778.0,322,63,117,180,593.0,48,5.31,29,160,1399,9.1
8001,Derick Brassard,2016-17,29.0,10,45,81,81,18,27,45,159.0,1280.0,403,81,144,225,752.0,82,5.34,48,269,2463,8.9
8002,Derick Brassard,2017-18,30.0,11,60,80,80,19,41,60,168.0,1392.0,483,100,185,285,920.0,82,5.32,47,251,2453,8.9
8003,Derick Brassard,2018-19,31.0,12,58,80,80,27,31,58,182.0,1431.0,563,127,216,343,1102.0,82,5.34,48,255,2438,9.0
8004,Derick Brassard,2019-20,32.0,13,39,81,81,14,25,39,195.0,1408.0,644,141,241,382,1297.0,82,5.45,47,245,2478,9.0
8005,Derick Brassard,2020-21,33.0,14,46,72,72,21,25,46,197.0,1277.0,716,162,266,428,1494.0,82,5.86,50,250,2620,9.2
8006,Derick Brassard,2021-22,34.0,15,23,70,70,14,9,23,110.0,1050.0,786,176,275,451,1604.0,82,5.96,47,239,2579,9.5
8007,Derick Brassard,2022-23,35.0,16,32,66,66,10,22,32,110.0,904.0,852,186,297,483,1714.0,70,5.96,42,208,2192,9.5
8008,Deron Quint,1998-99,22.0,4,18,51,51,5,13,18,97.0,,51,5,13,18,97.0,82,6.29,74,413,2481,10.4
8009,Deron Quint,1999-00,23.0,5,14,27,27,3,11,14,63.0,,78,8,24,32,160.0,82,5.83,55,336,2444,9.8
8010,Deron Quint,2000-01,24.0,6,11,32,32,4,7,11,61.0,,110,12,31,43,221.0,82,5.28,57,380,2242,9.6
8011,Deron Quint,2001-02,25.0,7,13,60,60,5,8,13,94.0,972.0,170,17,39,56,315.0,82,5.27,57,359,2285,9.4
8012,Deron Quint,2002-03,26.0,8,11,54,54,4,7,11,94.0,898.0,224,21,46,67,409.0,82,5.49,53,331,2294,9.8
8013,Deron Quint,2003-04,27.0,9,23,57,57,7,16,23,148.0,1373.0,281,28,62,90,557.0,82,5.51,63,376,2272,9.9
8014,Deron Quint,2004-05,28.0,10,25,75,75,7,18,25,169.0,1651.0,356,35,80,115,726.0,82,5.24,53,338,2262,9.5
8015,Deron Quint,2005-06,29.0,11,17,51,51,7,10,17,85.0,809.0,407,42,90,132,811.0,82,5.31,60,363,2326,9.4
8016,Deron Quint,2006-07,30.0,12,11,51,51,4,7,11,72.0,925.0,458,46,97,143,883.0,82,5.14,57,348,2300,9.2
8017,Deron Quint,2009-10,33.0,13,0,5,5,0,0,0,2.0,53.0,463,46,97,143,885.0,82,5.76,70,398,2426,9.7
8018,Derrick Pouliot,2017-18,24.0,4,7,34,34,2,5,7,56.0,597.0,34,2,5,7,56.0,82,5.32,47,251,2453,8.9
8019,Derrick Pouliot,2018-19,25.0,5,7,22,22,0,7,7,25.0,340.0,56,2,12,14,81.0,82,5.34,48,255,2438,9.0
8020,Derrick Pouliot,2019-20,26.0,6,0,11,11,0,0,0,11.0,164.0,67,2,12,14,92.0,82,5.45,47,245,2478,9.0
8021,Derrick Pouliot,2020-21,27.0,7,22,71,71,3,19,22,78.0,1267.0,138,5,31,36,170.0,82,5.86,50,250,2620,9.2
8022,Derrick Pouliot,2021-22,28.0,8,12,62,62,3,9,12,58.0,1064.0,200,8,40,48,228.0,82,5.96,47,239,2579,9.5
8023,Derrick Pouliot,2022-23,29.0,9,0,2,2,0,0,0,1.0,17.0,202,8,40,48,229.0,70,5.96,42,208,2192,9.5
8024,Derrick Smith,1987-88,23.0,4,39,77,77,17,22,39,142.0,,77,17,22,39,142.0,80,7.77,71,321,2447,12.7
8025,Derrick Smith,1988-89,24.0,5,12,69,69,6,6,12,107.0,,146,23,28,51,249.0,80,7.94,82,370,2484,12.8
8026,Derrick Smith,1989-90,25.0,6,32,71,71,11,21,32,150.0,,217,34,49,83,399.0,80,7.34,72,344,2400,12.2
8027,Derrick Smith,1990-91,26.0,7,24,76,76,16,8,24,155.0,,293,50,57,107,554.0,80,7.43,89,437,2435,12.2
8028,Derrick Smith,1991-92,27.0,8,30,74,74,16,14,30,115.0,,367,66,71,137,669.0,80,7.48,85,403,2430,12.3
8029,Derrick Smith,1992-93,28.0,9,9,55,55,3,6,9,72.0,,422,69,77,146,741.0,80,7.37,76,367,2421,12.2
8030,Derrick Smith,1993-94,29.0,10,21,72,72,11,10,21,100.0,,494,80,87,167,841.0,80,6.91,71,366,2385,11.6
8031,Derrick Smith,1994-95,30.0,11,6,33,33,2,4,6,29.0,,527,82,91,173,870.0,80,6.96,77,402,2440,11.4
8032,Derrick Smith,1995-96,31.0,12,1,9,9,0,1,1,3.0,,536,82,92,174,873.0,84,7.25,87,443,2603,11.7
8033,Derrick Smith,1996-97,32.0,13,0,1,1,0,0,0,1.0,,537,82,92,174,874.0,84,6.48,76,407,2545,10.7
8034,Derrick Walser,2004-05,26.0,4,1,2,2,1,0,1,2.0,33.0,2,1,0,1,2.0,82,5.24,53,338,2262,9.5
8035,Derrick Walser,2005-06,27.0,5,17,53,53,4,13,17,86.0,788.0,55,5,13,18,88.0,82,5.31,60,363,2326,9.4
8036,Derrick Walser,2006-07,28.0,6,9,27,27,1,8,9,35.0,496.0,82,6,21,27,123.0,82,5.14,57,348,2300,9.2
8037,Derrick Walser,2009-10,31.0,7,2,9,9,2,0,2,10.0,110.0,91,8,21,29,133.0,82,5.76,70,398,2426,9.7
8038,Deryk Engelland,2012-13,30.0,4,2,9,9,0,2,2,4.0,145.0,9,0,2,2,4.0,82,5.53,56,304,2486,9.1
8039,Deryk Engelland,2013-14,31.0,5,10,63,63,3,7,10,49.0,840.0,72,3,9,12,53.0,82,5.46,52,291,2492,9.0
8040,Deryk Engelland,2014-15,32.0,6,17,73,73,4,13,17,86.0,1179.0,145,7,22,29,139.0,82,5.32,47,271,2439,8.9
8041,Deryk Engelland,2015-16,33.0,7,6,42,42,0,6,6,31.0,585.0,187,7,28,35,170.0,48,5.31,29,160,1399,9.1
8042,Deryk Engelland,2016-17,34.0,8,12,56,56,6,6,12,59.0,730.0,243,13,34,47,229.0,82,5.34,48,269,2463,8.9
8043,Deryk Engelland,2017-18,35.0,9,11,76,76,2,9,11,51.0,1093.0,319,15,43,58,280.0,82,5.32,47,251,2453,8.9
8044,Deryk Engelland,2018-19,36.0,10,12,69,69,3,9,12,71.0,1051.0,388,18,52,70,351.0,82,5.34,48,255,2438,9.0
8045,Deryk Engelland,2019-20,37.0,11,16,81,81,4,12,16,107.0,1485.0,469,22,64,86,458.0,82,5.45,47,245,2478,9.0
8046,Deryk Engelland,2020-21,38.0,12,23,79,79,5,18,23,108.0,1602.0,548,27,82,109,566.0,82,5.86,50,250,2620,9.2
8047,Deryk Engelland,2021-22,39.0,13,12,74,74,2,10,12,105.0,1471.0,622,29,92,121,671.0,82,5.96,47,239,2579,9.5
8048,Deryk Engelland,2022-23,40.0,14,6,49,49,1,5,6,59.0,860.0,671,30,97,127,730.0,70,5.96,42,208,2192,9.5
8049,Devante Smith-Pelly,2014-15,22.0,4,13,49,49,7,6,13,66.0,590.0,49,7,6,13,66.0,82,5.32,47,271,2439,8.9
8050,Devante Smith-Pelly,2015-16,23.0,5,0,7,7,0,0,0,5.0,63.0,56,7,6,13,71.0,48,5.31,29,160,1399,9.1
8051,Devante Smith-Pelly,2016-17,24.0,6,10,19,19,2,8,10,23.0,240.0,75,9,14,23,94.0,82,5.34,48,269,2463,8.9
8052,Devante Smith-Pelly,2017-18,25.0,7,20,74,74,6,14,20,104.0,1057.0,149,15,28,43,198.0,82,5.32,47,251,2453,8.9
8053,Devante Smith-Pelly,2018-19,26.0,8,25,64,64,14,11,25,94.0,787.0,213,29,39,68,292.0,82,5.34,48,255,2438,9.0
8054,Devante Smith-Pelly,2019-20,27.0,9,9,53,53,4,5,9,76.0,716.0,266,33,44,77,368.0,82,5.45,47,245,2478,9.0
8055,Devante Smith-Pelly,2020-21,28.0,10,16,75,75,7,9,16,103.0,926.0,341,40,53,93,471.0,82,5.86,50,250,2620,9.2
8056,Devante Smith-Pelly,2021-22,29.0,11,8,54,54,4,4,8,60.0,586.0,395,44,57,101,531.0,82,5.96,47,239,2579,9.5
8057,Devin Setoguchi,2010-11,24.0,4,17,44,44,11,6,17,105.0,627.0,44,11,6,17,105.0,82,5.44,62,351,2383,9.4
8058,Devin Setoguchi,2011-12,25.0,5,65,81,81,31,34,65,246.0,1313.0,125,42,40,82,351.0,82,5.7,65,341,2477,9.4
8059,Devin Setoguchi,2012-13,26.0,6,36,70,70,20,16,36,165.0,1071.0,195,62,56,118,516.0,82,5.53,56,304,2486,9.1
8060,Devin Setoguchi,2013-14,27.0,7,41,72,72,22,19,41,199.0,1095.0,267,84,75,159,715.0,82,5.46,52,291,2492,9.0
8061,Devin Setoguchi,2014-15,28.0,8,36,69,69,19,17,36,174.0,1214.0,336,103,92,195,889.0,82,5.32,47,271,2439,8.9
8062,Devin Setoguchi,2015-16,29.0,9,27,48,48,13,14,27,97.0,693.0,384,116,106,222,986.0,48,5.31,29,160,1399,9.1
8063,Devin Setoguchi,2016-17,30.0,10,27,75,75,11,16,27,129.0,1129.0,459,127,122,249,1115.0,82,5.34,48,269,2463,8.9
8064,Devin Setoguchi,2017-18,31.0,11,0,12,12,0,0,0,12.0,146.0,471,127,122,249,1127.0,82,5.32,47,251,2453,8.9
8065,Devin Setoguchi,2019-20,33.0,12,12,45,45,4,8,12,60.0,560.0,516,131,130,261,1187.0,82,5.45,47,245,2478,9.0
8066,Devin Shore,2018-19,24.0,4,0,3,3,0,0,0,1.0,36.0,3,0,0,0,1.0,82,5.34,48,255,2438,9.0
8067,Devin Shore,2019-20,25.0,5,33,82,82,13,20,33,115.0,1159.0,85,13,20,33,116.0,82,5.45,47,245,2478,9.0
8068,Devin Shore,2020-21,26.0,6,32,82,82,11,21,32,123.0,1265.0,167,24,41,65,239.0,82,5.86,50,250,2620,9.2
8069,Devin Shore,2021-22,27.0,7,29,76,76,10,19,29,82.0,1084.0,243,34,60,94,321.0,82,5.96,47,239,2579,9.5
8070,Devin Shore,2022-23,28.0,8,12,45,45,5,7,12,50.0,524.0,288,39,67,106,371.0,70,5.96,42,208,2192,9.5
8071,Devon Toews,2021-22,27.0,4,18,48,48,5,13,18,81.0,859.0,48,5,13,18,81.0,82,5.96,47,239,2579,9.5
8072,Devon Toews,2022-23,28.0,5,28,68,68,6,22,28,122.0,1395.0,116,11,35,46,203.0,70,5.96,42,208,2192,9.5
8073,Dick Tarnstrom,2004-05,30.0,4,19,62,62,3,16,19,59.0,1094.0,62,3,16,19,59.0,82,5.24,53,338,2262,9.5
8074,Dick Tarnstrom,2005-06,31.0,5,41,61,61,7,34,41,115.0,1458.0,123,10,50,60,174.0,82,5.31,60,363,2326,9.4
8075,Dick Tarnstrom,2006-07,32.0,6,52,80,80,16,36,52,158.0,1924.0,203,26,86,112,332.0,82,5.14,57,348,2300,9.2
8076,Dick Tarnstrom,2008-09,34.0,7,14,55,55,6,8,14,60.0,931.0,258,32,94,126,392.0,82,6.05,85,480,2458,10.1
8077,Dick Tarnstrom,2010-11,36.0,8,14,48,48,3,11,14,44.0,930.0,306,35,105,140,436.0,82,5.44,62,351,2383,9.4
8078,Dillon Dube,2021-22,23.0,4,5,25,25,1,4,5,22.0,252.0,25,1,4,5,22.0,82,5.96,47,239,2579,9.5
8079,Dillon Dube,2022-23,24.0,5,16,45,45,6,10,16,60.0,571.0,70,7,14,21,82.0,70,5.96,42,208,2192,9.5
8080,Dillon Heatherington,2020-21,25.0,4,1,6,6,0,1,1,6.0,65.0,6,0,1,1,6.0,82,5.86,50,250,2620,9.2
8081,Dillon Heatherington,2021-22,26.0,5,1,5,5,0,1,1,5.0,51.0,11,0,2,2,11.0,82,5.96,47,239,2579,9.5
8082,Dillon Simpson,2019-20,26.0,4,0,3,3,0,0,0,2.0,33.0,3,0,0,0,2.0,82,5.45,47,245,2478,9.0
8083,Dino Ciccarelli,1983-84,23.0,4,30,32,32,18,12,30,126.0,,32,18,12,30,126.0,80,7.69,77,340,2441,12.6
8084,Dino Ciccarelli,1984-85,24.0,5,106,76,76,55,51,106,289.0,,108,73,63,136,415.0,80,8.03,73,320,2489,12.9
8085,Dino Ciccarelli,1985-86,25.0,6,75,77,77,37,38,75,210.0,,185,110,101,211,625.0,80,7.73,71,310,2444,12.7
8086,Dino Ciccarelli,1986-87,26.0,7,71,79,79,38,33,71,211.0,,264,148,134,282,836.0,80,7.89,74,336,2448,12.9
8087,Dino Ciccarelli,1987-88,27.0,8,32,51,51,15,17,32,133.0,,315,163,151,314,969.0,80,7.77,71,321,2447,12.7
8088,Dino Ciccarelli,1988-89,28.0,9,89,75,75,44,45,89,262.0,,390,207,196,403,1231.0,80,7.94,82,370,2484,12.8
8089,Dino Ciccarelli,1989-90,29.0,10,103,80,80,52,51,103,255.0,,470,259,247,506,1486.0,80,7.34,72,344,2400,12.2
8090,Dino Ciccarelli,1990-91,30.0,11,86,67,67,41,45,86,262.0,,537,300,292,592,1748.0,80,7.43,89,437,2435,12.2
8091,Dino Ciccarelli,1991-92,31.0,12,74,76,76,44,30,74,247.0,,613,344,322,666,1995.0,80,7.48,85,403,2430,12.3
8092,Dino Ciccarelli,1992-93,32.0,13,79,80,80,41,38,79,267.0,,693,385,360,745,2262.0,80,7.37,76,367,2421,12.2
8093,Dino Ciccarelli,1993-94,33.0,14,39,54,54,21,18,39,186.0,,747,406,378,784,2448.0,80,6.91,71,366,2385,11.6
8094,Dino Ciccarelli,1994-95,34.0,15,76,78,78,38,38,76,279.0,,825,444,416,860,2727.0,80,6.96,77,402,2440,11.4
8095,Dino Ciccarelli,1995-96,35.0,16,97,82,82,41,56,97,200.0,,907,485,472,957,2927.0,84,7.25,87,443,2603,11.7
8096,Dino Ciccarelli,1996-97,36.0,17,57,66,66,28,29,57,153.0,,973,513,501,1014,3080.0,84,6.48,76,407,2545,10.7
8097,Dino Ciccarelli,1997-98,37.0,18,43,42,42,16,27,43,106.0,,1015,529,528,1057,3186.0,48,5.97,37,209,1408,10.2
8098,Dino Ciccarelli,1998-99,38.0,19,43,64,64,22,21,43,107.0,,1079,551,549,1100,3293.0,82,6.29,74,413,2481,10.4
8099,Dino Ciccarelli,1999-00,39.0,20,60,77,77,35,25,60,229.0,,1156,586,574,1160,3522.0,82,5.83,55,336,2444,9.8
8100,Dino Ciccarelli,2000-01,40.0,21,33,62,62,16,17,33,161.0,,1218,602,591,1193,3683.0,82,5.28,57,380,2242,9.6
8101,Dino Ciccarelli,2001-02,41.0,22,7,14,14,6,1,7,23.0,186.0,1232,608,592,1200,3706.0,82,5.27,57,359,2285,9.4
8102,Dion Phaneuf,2008-09,23.0,4,49,82,82,20,29,49,242.0,1782.0,82,20,29,49,242.0,82,6.05,85,480,2458,10.1
8103,Dion Phaneuf,2009-10,24.0,5,50,79,79,17,33,50,230.0,2027.0,161,37,62,99,472.0,82,5.76,70,398,2426,9.7
8104,Dion Phaneuf,2010-11,25.0,6,60,82,82,17,43,60,263.0,2167.0,243,54,105,159,735.0,82,5.44,62,351,2383,9.4
8105,Dion Phaneuf,2011-12,26.0,7,47,80,80,11,36,47,277.0,2122.0,323,65,141,206,1012.0,82,5.7,65,341,2477,9.4
8106,Dion Phaneuf,2012-13,27.0,8,32,81,81,12,20,32,225.0,1964.0,404,77,161,238,1237.0,82,5.53,56,304,2486,9.1
8107,Dion Phaneuf,2013-14,28.0,9,30,66,66,8,22,30,190.0,1670.0,470,85,183,268,1427.0,82,5.46,52,291,2492,9.0
8108,Dion Phaneuf,2014-15,29.0,10,44,82,82,12,32,44,202.0,2074.0,552,97,215,312,1629.0,82,5.32,47,271,2439,8.9
8109,Dion Phaneuf,2015-16,30.0,11,28,48,48,9,19,28,88.0,1209.0,600,106,234,340,1717.0,48,5.31,29,160,1399,9.1
8110,Dion Phaneuf,2016-17,31.0,12,31,80,80,8,23,31,145.0,1885.0,680,114,257,371,1862.0,82,5.34,48,269,2463,8.9
8111,Dion Phaneuf,2017-18,32.0,13,29,70,70,3,26,29,138.0,1660.0,750,117,283,400,2000.0,82,5.32,47,251,2453,8.9
8112,Dion Phaneuf,2018-19,33.0,14,32,71,71,4,28,32,144.0,1587.0,821,121,311,432,2144.0,82,5.34,48,255,2438,9.0
8113,Dion Phaneuf,2019-20,34.0,15,30,81,81,9,21,30,156.0,1866.0,902,130,332,462,2300.0,82,5.45,47,245,2478,9.0
8114,Dion Phaneuf,2020-21,35.0,16,26,79,79,6,20,26,134.0,1580.0,981,136,352,488,2434.0,82,5.86,50,250,2620,9.2
8115,Dion Phaneuf,2021-22,36.0,17,6,67,67,1,5,6,80.0,1005.0,1048,137,357,494,2514.0,82,5.96,47,239,2579,9.5
8116,Dirk Graham,1986-87,27.0,4,2,6,6,1,1,2,10.0,,6,1,1,2,10.0,80,7.89,74,336,2448,12.9
8117,Dirk Graham,1987-88,28.0,5,23,36,36,12,11,23,81.0,,42,13,12,25,91.0,80,7.77,71,321,2447,12.7
8118,Dirk Graham,1988-89,29.0,6,55,80,80,22,33,55,173.0,,122,35,45,80,264.0,80,7.94,82,370,2484,12.8
8119,Dirk Graham,1989-90,30.0,7,54,76,76,25,29,54,197.0,,198,60,74,134,461.0,80,7.34,72,344,2400,12.2
8120,Dirk Graham,1990-91,31.0,8,48,70,70,24,24,48,173.0,,268,84,98,182,634.0,80,7.43,89,437,2435,12.2
8121,Dirk Graham,1991-92,32.0,9,78,80,80,33,45,78,217.0,,348,117,143,260,851.0,80,7.48,85,403,2430,12.3
8122,Dirk Graham,1992-93,33.0,10,54,73,73,22,32,54,180.0,,421,139,175,314,1031.0,80,7.37,76,367,2421,12.2
8123,Dirk Graham,1993-94,34.0,11,45,80,80,24,21,45,189.0,,501,163,196,359,1220.0,80,6.91,71,366,2385,11.6
8124,Dirk Graham,1994-95,35.0,12,47,80,80,17,30,47,222.0,,581,180,226,406,1442.0,80,6.96,77,402,2440,11.4
8125,Dirk Graham,1995-96,36.0,13,37,84,84,20,17,37,187.0,,665,200,243,443,1629.0,84,7.25,87,443,2603,11.7
8126,Dirk Graham,1996-97,37.0,14,33,67,67,15,18,33,122.0,,732,215,261,476,1751.0,84,6.48,76,407,2545,10.7
8127,Dirk Graham,1997-98,38.0,15,13,40,40,4,9,13,68.0,,772,219,270,489,1819.0,48,5.97,37,209,1408,10.2
8128,Dixon Ward,1995-96,27.0,4,52,70,70,22,30,52,111.0,,70,22,30,52,111.0,84,7.25,87,443,2603,11.7
8129,Dixon Ward,1996-97,28.0,5,15,67,67,12,3,15,90.0,,137,34,33,67,201.0,84,6.48,76,407,2545,10.7
8130,Dixon Ward,1997-98,29.0,6,3,22,22,0,3,3,15.0,,159,34,36,70,216.0,48,5.97,37,209,1408,10.2
8131,Dixon Ward,1998-99,30.0,7,4,8,8,2,2,4,12.0,,167,36,38,74,228.0,82,6.29,74,413,2481,10.4
8132,Dixon Ward,1999-00,31.0,8,45,79,79,13,32,45,93.0,,246,49,70,119,321.0,82,5.83,55,336,2444,9.8
8133,Dixon Ward,2000-01,32.0,9,23,71,71,10,13,23,99.0,,317,59,83,142,420.0,82,5.28,57,380,2242,9.6
8134,Dixon Ward,2001-02,33.0,10,44,78,78,20,24,44,101.0,1231.0,395,79,107,186,521.0,82,5.27,57,359,2285,9.4
8135,Dixon Ward,2002-03,34.0,11,20,71,71,11,9,20,101.0,992.0,466,90,116,206,622.0,82,5.49,53,331,2294,9.8
8136,Dixon Ward,2003-04,35.0,12,18,63,63,5,13,18,88.0,796.0,529,95,129,224,710.0,82,5.51,63,376,2272,9.9
8137,Dixon Ward,2005-06,37.0,13,0,8,8,0,0,0,7.0,70.0,537,95,129,224,717.0,82,5.31,60,363,2326,9.4
8138,Dmitri Bykov,2005-06,28.0,4,12,71,71,2,10,12,58.0,1304.0,71,2,10,12,58.0,82,5.31,60,363,2326,9.4
8139,Dmitri Filimonov,1996-97,25.0,4,5,30,30,1,4,5,15.0,,30,1,4,5,15.0,84,6.48,76,407,2545,10.7
8140,Dmitri Kalinin,2002-03,22.0,4,0,4,4,0,0,0,3.0,68.0,4,0,0,0,3.0,82,5.49,53,331,2294,9.8
8141,Dmitri Kalinin,2003-04,23.0,5,22,79,79,4,18,22,88.0,1566.0,83,4,18,22,91.0,82,5.51,63,376,2272,9.9
8142,Dmitri Kalinin,2004-05,24.0,6,13,58,58,2,11,13,67.0,1047.0,141,6,29,35,158.0,82,5.24,53,338,2262,9.5
8143,Dmitri Kalinin,2005-06,25.0,7,21,65,65,8,13,21,83.0,1409.0,206,14,42,56,241.0,82,5.31,60,363,2326,9.4
8144,Dmitri Kalinin,2006-07,26.0,8,34,77,77,10,24,34,118.0,1778.0,283,24,66,90,359.0,82,5.14,57,348,2300,9.2
8145,Dmitri Kalinin,2008-09,28.0,9,18,55,55,2,16,18,47.0,922.0,338,26,82,108,406.0,82,6.05,85,480,2458,10.1
8146,Dmitri Kalinin,2009-10,29.0,10,29,82,82,7,22,29,86.0,1600.0,420,33,104,137,492.0,82,5.76,70,398,2426,9.7
8147,Dmitri Kalinin,2010-11,30.0,11,8,46,46,1,7,8,60.0,798.0,466,34,111,145,552.0,82,5.44,62,351,2383,9.4
8148,Dmitri Kalinin,2011-12,31.0,12,17,73,73,2,15,17,67.0,1290.0,539,36,126,162,619.0,82,5.7,65,341,2477,9.4
8149,Dmitri Khristich,1993-94,24.0,4,27,40,40,13,14,27,77.0,,40,13,14,27,77.0,80,6.91,71,366,2385,11.6
8150,Dmitri Khristich,1994-95,25.0,5,73,80,80,36,37,73,188.0,,120,49,51,100,265.0,80,6.96,77,402,2440,11.4
8151,Dmitri Khristich,1995-96,26.0,6,66,64,64,31,35,66,127.0,,184,80,86,166,392.0,84,7.25,87,443,2603,11.7
8152,Dmitri Khristich,1996-97,27.0,7,58,83,83,29,29,58,195.0,,267,109,115,224,587.0,84,6.48,76,407,2545,10.7
8153,Dmitri Khristich,1997-98,28.0,8,26,48,48,12,14,26,92.0,,315,121,129,250,679.0,48,5.97,37,209,1408,10.2
8154,Dmitri Khristich,1998-99,29.0,9,64,76,76,27,37,64,204.0,,391,148,166,314,883.0,82,6.29,74,413,2481,10.4
8155,Dmitri Khristich,1999-00,30.0,10,56,75,75,19,37,56,135.0,,466,167,203,370,1018.0,82,5.83,55,336,2444,9.8
8156,Dmitri Khristich,2000-01,31.0,11,66,82,82,29,37,66,144.0,,548,196,240,436,1162.0,82,5.28,57,380,2242,9.6
8157,Dmitri Khristich,2001-02,32.0,12,71,79,79,29,42,71,144.0,1562.0,627,225,282,507,1306.0,82,5.27,57,359,2285,9.4
8158,Dmitri Khristich,2002-03,33.0,13,30,53,53,12,18,30,79.0,857.0,680,237,300,537,1385.0,82,5.49,53,331,2294,9.8
8159,Dmitri Khristich,2003-04,34.0,14,38,70,70,13,25,38,77.0,1046.0,750,250,325,575,1462.0,82,5.51,63,376,2272,9.9
8160,Dmitri Khristich,2004-05,35.0,15,21,61,61,9,12,21,54.0,854.0,811,259,337,596,1516.0,82,5.24,53,338,2262,9.5
8161,Dmitri Kvartalnov,1995-96,29.0,4,72,73,73,30,42,72,226.0,,73,30,42,72,226.0,84,7.25,87,443,2603,11.7
8162,Dmitri Kvartalnov,1996-97,30.0,5,19,39,39,12,7,19,68.0,,112,42,49,91,294.0,84,6.48,76,407,2545,10.7
8163,Dmitri Mironov,1994-95,29.0,4,1,7,7,1,0,1,7.0,,7,1,0,1,7.0,80,6.96,77,402,2440,11.4
8164,Dmitri Mironov,1995-96,30.0,5,31,59,59,7,24,31,105.0,,66,8,24,32,112.0,84,7.25,87,443,2603,11.7
8165,Dmitri Mironov,1996-97,31.0,6,36,76,76,9,27,36,147.0,,142,17,51,68,259.0,84,6.48,76,407,2545,10.7
8166,Dmitri Mironov,1997-98,32.0,7,17,33,33,5,12,17,68.0,,175,22,63,85,327.0,48,5.97,37,209,1408,10.2
8167,Dmitri Mironov,1998-99,33.0,8,34,72,72,3,31,34,86.0,,247,25,94,119,413.0,82,6.29,74,413,2481,10.4
8168,Dmitri Mironov,1999-00,34.0,9,52,77,77,13,39,52,177.0,,324,38,133,171,590.0,82,5.83,55,336,2444,9.8
8169,Dmitri Mironov,2000-01,35.0,10,43,77,77,8,35,43,170.0,,401,46,168,214,760.0,82,5.28,57,380,2242,9.6
8170,Dmitri Mironov,2001-02,36.0,11,16,46,46,2,14,16,86.0,913.0,447,48,182,230,846.0,82,5.27,57,359,2285,9.4
8171,Dmitri Mironov,2002-03,37.0,12,22,73,73,3,19,22,99.0,1487.0,520,51,201,252,945.0,82,5.49,53,331,2294,9.8
8172,Dmitri Mironov,2003-04,38.0,13,8,36,36,3,5,8,33.0,595.0,556,54,206,260,978.0,82,5.51,63,376,2272,9.9
8173,Dmitri Nabokov,2000-01,24.0,4,11,25,25,7,4,11,34.0,,25,7,4,11,34.0,82,5.28,57,380,2242,9.6
8174,Dmitri Nabokov,2001-02,25.0,5,2,4,4,0,2,2,4.0,47.0,29,7,6,13,38.0,82,5.27,57,359,2285,9.4
8175,Dmitri Nabokov,2002-03,26.0,6,11,26,26,4,7,11,40.0,352.0,55,11,13,24,78.0,82,5.49,53,331,2294,9.8
8176,Dmitri Tertyshny,2001-02,25.0,4,10,62,62,2,8,10,68.0,1150.0,62,2,8,10,68.0,82,5.27,57,359,2285,9.4
8177,Dmitri Yakushin,2002-03,25.0,4,0,2,2,0,0,0,1.0,20.0,2,0,0,0,1.0,82,5.49,53,331,2294,9.8
8178,Dmitrij Jaskin,2015-16,22.0,4,0,2,2,0,0,0,2.0,15.0,2,0,0,0,2.0,48,5.31,29,160,1399,9.1
8179,Dmitrij Jaskin,2016-17,23.0,5,2,18,18,1,1,2,18.0,191.0,20,1,1,2,20.0,82,5.34,48,269,2463,8.9
8180,Dmitrij Jaskin,2017-18,24.0,6,18,54,54,13,5,18,108.0,727.0,74,14,6,20,128.0,82,5.32,47,251,2453,8.9
8181,Dmitrij Jaskin,2018-19,25.0,7,13,65,65,4,9,13,92.0,771.0,139,18,15,33,220.0,82,5.34,48,255,2438,9.0
8182,Dmitrij Jaskin,2019-20,26.0,8,11,51,51,1,10,11,55.0,589.0,190,19,25,44,275.0,82,5.45,47,245,2478,9.0
8183,Dmitrij Jaskin,2020-21,27.0,9,17,76,76,6,11,17,124.0,946.0,266,25,36,61,399.0,82,5.86,50,250,2620,9.2
8184,Dmitrij Jaskin,2021-22,28.0,10,8,37,37,2,6,8,48.0,373.0,303,27,42,69,447.0,82,5.96,47,239,2579,9.5
8185,Dmitry Afanasenkov,2003-04,23.0,4,2,9,9,1,1,2,8.0,103.0,9,1,1,2,8.0,82,5.51,63,376,2272,9.9
8186,Dmitry Afanasenkov,2004-05,24.0,5,0,5,5,0,0,0,1.0,25.0,14,1,1,2,9.0,82,5.24,53,338,2262,9.5
8187,Dmitry Afanasenkov,2006-07,26.0,6,16,71,71,6,10,16,98.0,877.0,85,7,11,18,107.0,82,5.14,57,348,2300,9.2
8188,Dmitry Afanasenkov,2008-09,28.0,7,15,68,68,9,6,15,78.0,662.0,153,16,17,33,185.0,82,6.05,85,480,2458,10.1
8189,Dmitry Afanasenkov,2009-10,29.0,8,21,74,74,11,10,21,96.0,779.0,227,27,27,54,281.0,82,5.76,70,398,2426,9.7
8190,Dmitry Korobov,2016-17,27.0,4,1,3,3,0,1,1,0.0,32.0,3,0,1,1,0.0,82,5.34,48,269,2463,8.9
8191,Dmitry Kulikov,2012-13,22.0,4,16,68,68,3,13,16,87.0,1220.0,68,3,13,16,87.0,82,5.53,56,304,2486,9.1
8192,Dmitry Kulikov,2013-14,23.0,5,26,72,72,6,20,26,83.0,1436.0,140,9,33,42,170.0,82,5.46,52,291,2492,9.0
8193,Dmitry Kulikov,2014-15,24.0,6,28,58,58,4,24,28,104.0,1268.0,198,13,57,70,274.0,82,5.32,47,271,2439,8.9
8194,Dmitry Kulikov,2015-16,25.0,7,10,34,34,3,7,10,52.0,713.0,232,16,64,80,326.0,48,5.31,29,160,1399,9.1
8195,Dmitry Kulikov,2016-17,26.0,8,19,81,81,8,11,19,127.0,1757.0,313,24,75,99,453.0,82,5.34,48,269,2463,8.9
8196,Dmitry Kulikov,2017-18,27.0,9,22,73,73,3,19,22,83.0,1556.0,386,27,94,121,536.0,82,5.32,47,251,2453,8.9
8197,Dmitry Kulikov,2018-19,28.0,10,17,74,74,1,16,17,99.0,1557.0,460,28,110,138,635.0,82,5.34,48,255,2438,9.0
8198,Dmitry Kulikov,2019-20,29.0,11,5,47,47,2,3,5,42.0,1029.0,507,30,113,143,677.0,82,5.45,47,245,2478,9.0
8199,Dmitry Kulikov,2020-21,30.0,12,11,62,62,3,8,11,48.0,1058.0,569,33,121,154,725.0,82,5.86,50,250,2620,9.2
8200,Dmitry Kulikov,2021-22,31.0,13,6,57,57,0,6,6,40.0,893.0,626,33,127,160,765.0,82,5.96,47,239,2579,9.5
8201,Dmitry Kulikov,2022-23,32.0,14,10,51,51,2,8,10,54.0,1021.0,677,35,135,170,819.0,70,5.96,42,208,2192,9.5
8202,Dmitry Orlov,2014-15,23.0,4,19,60,60,3,16,19,51.0,1012.0,60,3,16,19,51.0,82,5.32,47,271,2439,8.9
8203,Dmitry Orlov,2015-16,24.0,5,1,5,5,0,1,1,1.0,75.0,65,3,17,20,52.0,48,5.31,29,160,1399,9.1
8204,Dmitry Orlov,2016-17,25.0,6,11,54,54,3,8,11,59.0,1058.0,119,6,25,31,111.0,82,5.34,48,269,2463,8.9
8205,Dmitry Orlov,2018-19,27.0,7,29,82,82,8,21,29,90.0,1314.0,201,14,46,60,201.0,82,5.34,48,255,2438,9.0
8206,Dmitry Orlov,2019-20,28.0,8,33,82,82,6,27,33,125.0,1602.0,283,20,73,93,326.0,82,5.45,47,245,2478,9.0
8207,Dmitry Orlov,2020-21,29.0,9,31,82,82,10,21,31,125.0,1897.0,365,30,94,124,451.0,82,5.86,50,250,2620,9.2
8208,Dmitry Orlov,2021-22,30.0,10,29,82,82,3,26,29,101.0,1774.0,447,33,120,153,552.0,82,5.96,47,239,2579,9.5
8209,Dmitry Orlov,2022-23,31.0,11,27,69,69,4,23,27,105.0,1530.0,516,37,143,180,657.0,70,5.96,42,208,2192,9.5
8210,Dmitry Yushkevich,1995-96,24.0,4,32,82,82,5,27,32,155.0,,82,5,27,32,155.0,84,7.25,87,443,2603,11.7
8211,Dmitry Yushkevich,1996-97,25.0,5,30,75,75,5,25,30,136.0,,157,10,52,62,291.0,84,6.48,76,407,2545,10.7
8212,Dmitry Yushkevich,1997-98,26.0,6,14,40,40,5,9,14,80.0,,197,15,61,76,371.0,48,5.97,37,209,1408,10.2
8213,Dmitry Yushkevich,1998-99,27.0,7,11,69,69,1,10,11,96.0,,266,16,71,87,467.0,82,6.29,74,413,2481,10.4
8214,Dmitry Yushkevich,1999-00,28.0,8,14,74,74,4,10,14,99.0,,340,20,81,101,566.0,82,5.83,55,336,2444,9.8
8215,Dmitry Yushkevich,2000-01,29.0,9,12,72,72,0,12,12,92.0,,412,20,93,113,658.0,82,5.28,57,380,2242,9.6
8216,Dmitry Yushkevich,2001-02,30.0,10,28,78,78,6,22,28,95.0,1742.0,490,26,115,141,753.0,82,5.27,57,359,2285,9.4
8217,Dmitry Yushkevich,2002-03,31.0,11,27,77,77,3,24,27,103.0,1794.0,567,29,139,168,856.0,82,5.49,53,331,2294,9.8
8218,Dmitry Yushkevich,2003-04,32.0,12,24,81,81,5,19,24,110.0,1963.0,648,34,158,192,966.0,82,5.51,63,376,2272,9.9
8219,Dmitry Yushkevich,2004-05,33.0,13,19,55,55,6,13,19,79.0,1288.0,703,40,171,211,1045.0,82,5.24,53,338,2262,9.5
8220,Dmitry Yushkevich,2005-06,34.0,14,14,83,83,3,11,14,75.0,1708.0,786,43,182,225,1120.0,82,5.31,60,363,2326,9.4
8221,Dmytro Timashov,2022-23,26.0,4,9,44,44,4,5,9,37.0,375.0,44,4,5,9,37.0,70,5.96,42,208,2192,9.5
8222,Dody Wood,1995-96,23.0,4,2,13,13,1,1,2,10.0,,13,1,1,2,10.0,84,7.25,87,443,2603,11.7
8223,Dody Wood,1997-98,25.0,5,2,9,9,1,1,2,5.0,,22,2,2,4,15.0,48,5.97,37,209,1408,10.2
8224,Dody Wood,1998-99,26.0,6,9,32,32,3,6,9,33.0,,54,5,8,13,48.0,82,6.29,74,413,2481,10.4
8225,Dody Wood,1999-00,27.0,7,5,44,44,3,2,5,43.0,,98,8,10,18,91.0,82,5.83,55,336,2444,9.8
8226,Dody Wood,2000-01,28.0,8,0,8,8,0,0,0,4.0,,106,8,10,18,95.0,82,5.28,57,380,2242,9.6
8227,Dom Campedelli,1988-89,24.0,4,0,2,2,0,0,0,1.0,,2,0,0,0,1.0,80,7.94,82,370,2484,12.8
8228,Domenic Pittis,1999-00,25.0,4,0,1,1,0,0,0,0.0,,1,0,0,0,0.0,82,5.83,55,336,2444,9.8
8229,Domenic Pittis,2001-02,27.0,5,0,3,3,0,0,0,1.0,26.0,4,0,0,0,1.0,82,5.27,57,359,2285,9.4
8230,Domenic Pittis,2002-03,28.0,6,1,7,7,1,0,1,6.0,80.0,11,1,0,1,7.0,82,5.49,53,331,2294,9.8
8231,Domenic Pittis,2003-04,29.0,7,9,47,47,4,5,9,42.0,506.0,58,5,5,10,49.0,82,5.51,63,376,2272,9.9
8232,Domenic Pittis,2004-05,30.0,8,6,22,22,0,6,6,18.0,251.0,80,5,11,16,67.0,82,5.24,53,338,2262,9.5
8233,Domenic Pittis,2005-06,31.0,9,0,2,2,0,0,0,1.0,10.0,82,5,11,16,68.0,82,5.31,60,363,2326,9.4
8234,Domenic Pittis,2006-07,32.0,10,0,4,4,0,0,0,3.0,46.0,86,5,11,16,71.0,82,5.14,57,348,2300,9.2
8235,Dominic Lavoie,1991-92,24.0,4,0,1,1,0,0,0,1.0,,1,0,0,0,1.0,80,7.48,85,403,2430,12.3
8236,Dominic Lavoie,1992-93,25.0,5,2,13,13,1,1,2,20.0,,14,1,1,2,21.0,80,7.37,76,367,2421,12.2
8237,Dominic Lavoie,1993-94,26.0,6,3,6,6,1,2,3,11.0,,20,2,3,5,32.0,80,6.91,71,366,2385,11.6
8238,Dominic Lavoie,1994-95,27.0,7,1,6,6,0,1,1,11.0,,26,2,4,6,43.0,80,6.96,77,402,2440,11.4
8239,Dominic Lavoie,1995-96,28.0,8,1,4,4,0,1,1,15.0,,30,2,5,7,58.0,84,7.25,87,443,2603,11.7
8240,Dominic Lavoie,1996-97,29.0,9,6,8,8,3,3,6,21.0,,38,5,8,13,79.0,84,6.48,76,407,2545,10.7
8241,Dominic Moore,2006-07,26.0,4,3,5,5,0,3,3,3.0,47.0,5,0,3,3,3.0,82,5.14,57,348,2300,9.2
8242,Dominic Moore,2008-09,28.0,5,18,82,82,9,9,18,139.0,1022.0,87,9,12,21,142.0,82,6.05,85,480,2458,10.1
8243,Dominic Moore,2009-10,29.0,6,17,69,69,8,9,17,111.0,873.0,156,17,21,38,253.0,82,5.76,70,398,2426,9.7
8244,Dominic Moore,2010-11,30.0,7,17,68,68,5,12,17,100.0,904.0,224,22,33,55,353.0,82,5.44,62,351,2383,9.4
8245,Dominic Moore,2011-12,31.0,8,45,81,81,13,32,45,165.0,1364.0,305,35,65,100,518.0,82,5.7,65,341,2477,9.4
8246,Dominic Moore,2012-13,32.0,9,28,69,69,10,18,28,119.0,1024.0,374,45,83,128,637.0,82,5.53,56,304,2486,9.1
8247,Dominic Moore,2013-14,33.0,10,32,77,77,18,14,32,175.0,1201.0,451,63,97,160,812.0,82,5.46,52,291,2492,9.0
8248,Dominic Moore,2014-15,34.0,11,25,79,79,4,21,25,103.0,1227.0,530,67,118,185,915.0,82,5.32,47,271,2439,8.9
8249,Dominic Moore,2016-17,36.0,12,18,73,73,6,12,18,96.0,856.0,603,73,130,203,1011.0,82,5.34,48,269,2463,8.9
8250,Dominic Moore,2017-18,37.0,13,27,82,82,10,17,27,116.0,1132.0,685,83,147,230,1127.0,82,5.32,47,251,2453,8.9
8251,Dominic Moore,2018-19,38.0,14,15,80,80,6,9,15,94.0,1064.0,765,89,156,245,1221.0,82,5.34,48,255,2438,9.0
8252,Dominic Moore,2019-20,39.0,15,25,82,82,11,14,25,96.0,1061.0,847,100,170,270,1317.0,82,5.45,47,245,2478,9.0
8253,Dominic Moore,2020-21,40.0,16,12,50,50,6,6,12,46.0,515.0,897,106,176,282,1363.0,82,5.86,50,250,2620,9.2
8254,Dominic Toninato,2020-21,26.0,4,2,37,37,0,2,2,25.0,292.0,37,0,2,2,25.0,82,5.86,50,250,2620,9.2
8255,Dominic Toninato,2021-22,27.0,5,1,2,2,1,0,1,1.0,13.0,39,1,2,3,26.0,82,5.96,47,239,2579,9.5
8256,Dominic Toninato,2022-23,28.0,6,11,46,46,4,7,11,38.0,513.0,85,5,9,14,64.0,70,5.96,42,208,2192,9.5
8257,Dominic Turgeon,2020-21,24.0,4,0,5,5,0,0,0,3.0,46.0,5,0,0,0,3.0,82,5.86,50,250,2620,9.2
8258,Dominic Turgeon,2021-22,25.0,5,0,4,4,0,0,0,2.0,50.0,9,0,0,0,5.0,82,5.96,47,239,2579,9.5
8259,Dominik Kahun,2021-22,26.0,4,37,82,82,13,24,37,137.0,1160.0,82,13,24,37,137.0,82,5.96,47,239,2579,9.5
8260,Dominik Kahun,2022-23,27.0,5,31,56,56,12,19,31,87.0,744.0,138,25,43,68,224.0,70,5.96,42,208,2192,9.5
8261,Dominik Kubalík,2022-23,27.0,4,46,68,68,30,16,46,157.0,977.0,68,30,16,46,157.0,70,5.96,42,208,2192,9.5
8262,Dominik Simon,2018-19,24.0,4,1,3,3,0,1,1,2.0,18.0,3,0,1,1,2.0,82,5.34,48,255,2438,9.0
8263,Dominik Simon,2019-20,25.0,5,1,2,2,0,1,1,2.0,26.0,5,0,2,2,4.0,82,5.45,47,245,2478,9.0
8264,Dominik Simon,2020-21,26.0,6,12,33,33,4,8,12,36.0,377.0,38,4,10,14,40.0,82,5.86,50,250,2620,9.2
8265,Dominik Simon,2021-22,27.0,7,28,71,71,8,20,28,121.0,946.0,109,12,30,42,161.0,82,5.96,47,239,2579,9.5
8266,Dominik Simon,2022-23,28.0,8,22,64,64,7,15,22,102.0,922.0,173,19,45,64,263.0,70,5.96,42,208,2192,9.5
8267,Dominik Uher,2017-18,25.0,4,0,2,2,0,0,0,0.0,13.0,2,0,0,0,0.0,82,5.32,47,251,2453,8.9
8268,Don Barber,1991-92,27.0,4,13,23,23,8,5,13,42.0,,23,8,5,13,42.0,80,7.48,85,403,2430,12.3
8269,Don Barber,1992-93,28.0,5,34,44,44,15,19,34,100.0,,67,23,24,47,142.0,80,7.37,76,367,2421,12.2
8270,Don Barber,1993-94,29.0,6,3,23,23,1,2,3,29.0,,90,24,26,50,171.0,80,6.91,71,366,2385,11.6
8271,Don Barber,1994-95,30.0,7,7,25,25,1,6,7,24.0,,115,25,32,57,195.0,80,6.96,77,402,2440,11.4
8272,Don Biggs,1987-88,22.0,4,0,1,1,0,0,0,0.0,,1,0,0,0,0.0,80,7.77,71,321,2447,12.7
8273,Don Biggs,1992-93,27.0,5,2,11,11,2,0,2,14.0,,12,2,0,2,14.0,80,7.37,76,367,2421,12.2
8274,Don Dietrich,1986-87,25.0,4,5,17,17,0,5,5,22.0,,17,0,5,5,22.0,80,7.89,74,336,2448,12.9
8275,Don Dietrich,1988-89,27.0,5,2,11,11,0,2,2,14.0,,28,0,7,7,36.0,80,7.94,82,370,2484,12.8
8276,Don Gibson,1993-94,26.0,4,3,14,14,0,3,3,9.0,,14,0,3,3,9.0,80,6.91,71,366,2385,11.6
8277,Don Gillen,1982-83,22.0,4,1,1,1,1,0,1,2.0,,1,1,0,1,2.0,80,7.03,61,280,2352,12.0
8278,Don Gillen,1984-85,24.0,5,5,34,34,1,4,5,25.0,,35,2,4,6,27.0,80,8.03,73,320,2489,12.9
8279,Don Howse,1982-83,30.0,4,7,33,33,2,5,7,46.0,,33,2,5,7,46.0,80,7.03,61,280,2352,12.0
8280,Don MacIver,1982-83,27.0,4,0,6,6,0,0,0,2.0,,6,0,0,0,2.0,80,7.03,61,280,2352,12.0
8281,Don MacLean,2000-01,24.0,4,7,22,22,5,2,7,25.0,,22,5,2,7,25.0,82,5.28,57,380,2242,9.6
8282,Don MacLean,2003-04,27.0,5,1,3,3,0,1,1,2.0,29.0,25,5,3,8,27.0,82,5.51,63,376,2272,9.9
8283,Don MacLean,2006-07,30.0,6,1,4,4,1,0,1,10.0,47.0,29,6,3,9,37.0,82,5.14,57,348,2300,9.2
8284,Don MacLean,2008-09,32.0,7,2,3,3,1,1,2,3.0,38.0,32,7,4,11,40.0,82,6.05,85,480,2458,10.1
8285,Don MacLean,2009-10,33.0,8,2,9,9,1,1,2,12.0,114.0,41,8,5,13,52.0,82,5.76,70,398,2426,9.7
8286,Don McSween,1990-91,26.0,4,1,5,5,0,1,1,4.0,,5,0,1,1,4.0,80,7.43,89,437,2435,12.2
8287,Don McSween,1992-93,28.0,5,0,4,4,0,0,0,4.0,,9,0,1,1,8.0,80,7.37,76,367,2421,12.2
8288,Don McSween,1996-97,32.0,6,12,32,32,3,9,12,43.0,,41,3,10,13,51.0,84,6.48,76,407,2545,10.7
8289,Don McSween,1997-98,33.0,7,0,2,2,0,0,0,1.0,,43,3,10,13,52.0,48,5.97,37,209,1408,10.2
8290,Don McSween,1998-99,34.0,8,0,4,4,0,0,0,1.0,,47,3,10,13,53.0,82,6.29,74,413,2481,10.4
8291,Don Nachbaur,1983-84,25.0,4,33,77,77,16,17,33,70.0,,77,16,17,33,70.0,80,7.69,77,340,2441,12.6
8292,Don Nachbaur,1984-85,26.0,5,26,77,77,5,21,26,113.0,,154,21,38,59,183.0,80,8.03,73,320,2489,12.9
8293,Don Nachbaur,1985-86,27.0,6,0,4,4,0,0,0,0.0,,158,21,38,59,183.0,80,7.73,71,310,2444,12.7
8294,Don Nachbaur,1988-89,30.0,7,2,5,5,1,1,2,4.0,,163,22,39,61,187.0,80,7.94,82,370,2484,12.8
8295,Don Nachbaur,1989-90,31.0,8,2,23,23,0,2,2,12.0,,186,22,41,63,199.0,80,7.34,72,344,2400,12.2
8296,Don Nachbaur,1990-91,32.0,9,4,20,20,0,4,4,11.0,,206,22,45,67,210.0,80,7.43,89,437,2435,12.2
8297,Don Nachbaur,1991-92,33.0,10,1,15,15,1,0,1,10.0,,221,23,45,68,220.0,80,7.48,85,403,2430,12.3
8298,Don Nachbaur,1992-93,34.0,11,1,2,2,0,1,1,0.0,,223,23,46,69,220.0,80,7.37,76,367,2421,12.2
8299,Don Spring,1983-84,24.0,4,19,80,80,1,18,19,51.0,,80,1,18,19,51.0,80,7.69,77,340,2441,12.6
8300,Don Spring,1984-85,25.0,5,16,78,78,0,16,16,67.0,,158,1,34,35,118.0,80,8.03,73,320,2489,12.9
8301,Don Spring,1985-86,26.0,6,16,80,80,0,16,16,50.0,,238,1,50,51,168.0,80,7.73,71,310,2444,12.7
8302,Don Spring,1986-87,27.0,7,4,21,21,0,4,4,11.0,,259,1,54,55,179.0,80,7.89,74,336,2448,12.9
8303,Don Sweeney,1991-92,25.0,4,8,36,36,3,5,8,35.0,,36,3,5,8,35.0,80,7.48,85,403,2430,12.3
8304,Don Sweeney,1992-93,26.0,5,8,58,58,3,5,8,49.0,,94,6,10,16,84.0,80,7.37,76,367,2421,12.2
8305,Don Sweeney,1993-94,27.0,6,21,77,77,8,13,21,102.0,,171,14,23,37,186.0,80,6.91,71,366,2385,11.6
8306,Don Sweeney,1994-95,28.0,7,14,75,75,3,11,14,92.0,,246,17,34,51,278.0,80,6.96,77,402,2440,11.4
8307,Don Sweeney,1995-96,29.0,8,34,84,84,7,27,34,107.0,,330,24,61,85,385.0,84,7.25,87,443,2603,11.7
8308,Don Sweeney,1996-97,30.0,9,21,75,75,6,15,21,136.0,,405,30,76,106,521.0,84,6.48,76,407,2545,10.7
8309,Don Sweeney,1997-98,31.0,10,22,47,47,3,19,22,102.0,,452,33,95,128,623.0,48,5.97,37,209,1408,10.2
8310,Don Sweeney,1998-99,32.0,11,28,77,77,4,24,28,142.0,,529,37,119,156,765.0,82,6.29,74,413,2481,10.4
8311,Don Sweeney,1999-00,33.0,12,26,82,82,3,23,26,113.0,,611,40,142,182,878.0,82,5.83,55,336,2444,9.8
8312,Don Sweeney,2000-01,34.0,13,16,59,59,1,15,16,55.0,,670,41,157,198,933.0,82,5.28,57,380,2242,9.6
8313,Don Sweeney,2001-02,35.0,14,12,81,81,2,10,12,79.0,1581.0,751,43,167,210,1012.0,82,5.27,57,359,2285,9.4
8314,Don Sweeney,2002-03,36.0,15,14,81,81,1,13,14,82.0,1712.0,832,44,180,224,1094.0,82,5.49,53,331,2294,9.8
8315,Don Sweeney,2003-04,37.0,16,12,72,72,2,10,12,60.0,1387.0,904,46,190,236,1154.0,82,5.51,63,376,2272,9.9
8316,Don Sweeney,2004-05,38.0,17,18,81,81,3,15,18,70.0,1632.0,985,49,205,254,1224.0,82,5.24,53,338,2262,9.5
8317,Don Sweeney,2005-06,39.0,18,8,67,67,3,5,8,55.0,885.0,1052,52,210,262,1279.0,82,5.31,60,363,2326,9.4
8318,Don Sweeney,2006-07,40.0,19,11,63,63,0,11,11,39.0,1001.0,1115,52,221,273,1318.0,82,5.14,57,348,2300,9.2
8319,Don Waddell,1983-84,25.0,4,0,1,1,0,0,0,0.0,,1,0,0,0,0.0,80,7.69,77,340,2441,12.6
8320,Donald Audette,1993-94,24.0,4,7,8,8,4,3,7,17.0,,8,4,3,7,17.0,80,6.91,71,366,2385,11.6
8321,Donald Audette,1994-95,25.0,5,48,63,63,31,17,48,153.0,,71,35,20,55,170.0,80,6.96,77,402,2440,11.4
8322,Donald Audette,1995-96,26.0,6,19,44,44,12,7,19,92.0,,115,47,27,74,262.0,84,7.25,87,443,2603,11.7
8323,Donald Audette,1996-97,27.0,7,59,77,77,29,30,59,207.0,,192,76,57,133,469.0,84,6.48,76,407,2545,10.7
8324,Donald Audette,1997-98,28.0,8,37,46,46,24,13,37,124.0,,238,100,70,170,593.0,48,5.97,37,209,1408,10.2
8325,Donald Audette,1998-99,29.0,9,25,23,23,12,13,25,92.0,,261,112,83,195,685.0,82,6.29,74,413,2481,10.4
8326,Donald Audette,1999-00,30.0,10,50,73,73,28,22,50,182.0,,334,140,105,245,867.0,82,5.83,55,336,2444,9.8
8327,Donald Audette,2000-01,31.0,11,44,75,75,24,20,44,198.0,,409,164,125,289,1065.0,82,5.28,57,380,2242,9.6
8328,Donald Audette,2001-02,32.0,12,36,49,49,18,18,36,152.0,825.0,458,182,143,325,1217.0,82,5.27,57,359,2285,9.4
8329,Donald Audette,2002-03,33.0,13,43,63,63,19,24,43,162.0,1034.0,521,201,167,368,1379.0,82,5.49,53,331,2294,9.8
8330,Donald Audette,2003-04,34.0,14,79,76,76,34,45,79,225.0,1508.0,597,235,212,447,1604.0,82,5.51,63,376,2272,9.9
8331,Donald Audette,2004-05,35.0,15,18,33,33,5,13,18,82.0,479.0,630,240,225,465,1686.0,82,5.24,53,338,2262,9.5
8332,Donald Audette,2005-06,36.0,16,23,54,54,11,12,23,118.0,837.0,684,251,237,488,1804.0,82,5.31,60,363,2326,9.4
8333,Donald Audette,2006-07,37.0,17,21,51,51,9,12,21,107.0,759.0,735,260,249,509,1911.0,82,5.14,57,348,2300,9.2
8334,Donald Brashear,1996-97,25.0,4,4,14,14,2,2,4,15.0,,14,2,2,4,15.0,84,6.48,76,407,2545,10.7
8335,Donald Brashear,1997-98,26.0,5,2,20,20,1,1,2,10.0,,34,3,3,6,25.0,48,5.97,37,209,1408,10.2
8336,Donald Brashear,1998-99,27.0,6,4,67,67,0,4,4,25.0,,101,3,7,10,50.0,82,6.29,74,413,2481,10.4
8337,Donald Brashear,1999-00,28.0,7,13,69,69,8,5,13,61.0,,170,11,12,23,111.0,82,5.83,55,336,2444,9.8
8338,Donald Brashear,2000-01,29.0,8,18,77,77,9,9,18,64.0,,247,20,21,41,175.0,82,5.28,57,380,2242,9.6
8339,Donald Brashear,2001-02,30.0,9,18,82,82,8,10,18,112.0,1100.0,329,28,31,59,287.0,82,5.27,57,359,2285,9.4
8340,Donald Brashear,2002-03,31.0,10,13,60,60,11,2,13,83.0,787.0,389,39,33,72,370.0,82,5.49,53,331,2294,9.8
8341,Donald Brashear,2003-04,32.0,11,28,79,79,9,19,28,127.0,1063.0,468,48,52,100,497.0,82,5.51,63,376,2272,9.9
8342,Donald Brashear,2004-05,33.0,12,32,81,81,9,23,32,107.0,1082.0,549,57,75,132,604.0,82,5.24,53,338,2262,9.5
8343,Donald Brashear,2005-06,34.0,13,25,80,80,8,17,25,99.0,1070.0,629,65,92,157,703.0,82,5.31,60,363,2326,9.4
8344,Donald Brashear,2006-07,35.0,14,13,64,64,6,7,13,72.0,706.0,693,71,99,170,775.0,82,5.14,57,348,2300,9.2
8345,Donald Brashear,2008-09,37.0,15,9,76,76,4,5,9,73.0,653.0,769,75,104,179,848.0,82,6.05,85,480,2458,10.1
8346,Donald Brashear,2009-10,38.0,16,13,77,77,4,9,13,47.0,614.0,846,79,113,192,895.0,82,5.76,70,398,2426,9.7
8347,Donald Brashear,2010-11,39.0,17,8,80,80,5,3,8,59.0,629.0,926,84,116,200,954.0,82,5.44,62,351,2383,9.4
8348,Donald Brashear,2011-12,40.0,18,4,63,63,1,3,4,43.0,520.0,989,85,119,204,997.0,82,5.7,65,341,2477,9.4
8349,Donald Brashear,2012-13,41.0,19,1,36,36,0,1,1,18.0,225.0,1025,85,120,205,1015.0,82,5.53,56,304,2486,9.1
8350,Donald Dufresne,1991-92,24.0,4,1,13,13,0,1,1,5.0,,13,0,1,1,5.0,80,7.48,85,403,2430,12.3
8351,Donald Dufresne,1992-93,25.0,5,4,18,18,0,4,4,6.0,,31,0,5,5,11.0,80,7.37,76,367,2421,12.2
8352,Donald Dufresne,1993-94,26.0,6,15,53,53,2,13,15,32.0,,84,2,18,20,43.0,80,6.91,71,366,2385,11.6
8353,Donald Dufresne,1994-95,27.0,7,0,3,3,0,0,0,2.0,,87,2,18,20,45.0,80,6.96,77,402,2440,11.4
8354,Donald Dufresne,1995-96,28.0,8,3,32,32,1,2,3,13.0,,119,3,20,23,58.0,84,7.25,87,443,2603,11.7
8355,Donald Dufresne,1996-97,29.0,9,8,60,60,2,6,8,56.0,,179,5,26,31,114.0,84,6.48,76,407,2545,10.7
8356,Donald Dufresne,1997-98,30.0,10,3,22,22,0,3,3,11.0,,201,5,29,34,125.0,48,5.97,37,209,1408,10.2
8357,Donald Dufresne,1998-99,31.0,11,7,45,45,1,6,7,21.0,,246,6,35,41,146.0,82,6.29,74,413,2481,10.4
8358,Donald Dufresne,1999-00,32.0,12,1,22,22,0,1,1,10.0,,268,6,36,42,156.0,82,5.83,55,336,2444,9.8
8359,Doug Barrault,1995-96,25.0,4,0,2,2,0,0,0,0.0,,2,0,0,0,0.0,84,7.25,87,443,2603,11.7
8360,Doug Barrault,1996-97,26.0,5,0,2,2,0,0,0,2.0,,4,0,0,0,2.0,84,6.48,76,407,2545,10.7
8361,Doug Berry,1982-83,25.0,4,30,75,75,7,23,30,66.0,,75,7,23,30,66.0,80,7.03,61,280,2352,12.0
8362,Doug Berry,1983-84,26.0,5,13,46,46,3,10,13,44.0,,121,10,33,43,110.0,80,7.69,77,340,2441,12.6
8363,Doug Bodger,1987-88,21.0,4,31,65,65,5,26,31,119.0,,65,5,26,31,119.0,80,7.77,71,321,2447,12.7
8364,Doug Bodger,1988-89,22.0,5,37,79,79,4,33,37,140.0,,144,9,59,68,259.0,80,7.94,82,370,2484,12.8
8365,Doug Bodger,1989-90,23.0,6,49,76,76,11,38,49,176.0,,220,20,97,117,435.0,80,7.34,72,344,2400,12.2
8366,Doug Bodger,1990-91,24.0,7,45,69,69,14,31,45,184.0,,289,34,128,162,619.0,80,7.43,89,437,2435,12.2
8367,Doug Bodger,1991-92,25.0,8,52,71,71,8,44,52,156.0,,360,42,172,214,775.0,80,7.48,85,403,2430,12.3
8368,Doug Bodger,1992-93,26.0,9,48,71,71,12,36,48,167.0,,431,54,208,262,942.0,80,7.37,76,367,2421,12.2
8369,Doug Bodger,1993-94,27.0,10,28,58,58,5,23,28,139.0,,489,59,231,290,1081.0,80,6.91,71,366,2385,11.6
8370,Doug Bodger,1994-95,28.0,11,46,73,73,11,35,46,180.0,,562,70,266,336,1261.0,80,6.96,77,402,2440,11.4
8371,Doug Bodger,1995-96,29.0,12,54,81,81,9,45,54,154.0,,643,79,311,390,1415.0,84,7.25,87,443,2603,11.7
8372,Doug Bodger,1996-97,30.0,13,39,75,75,7,32,39,144.0,,718,86,343,429,1559.0,84,6.48,76,407,2545,10.7
8373,Doug Bodger,1997-98,31.0,14,20,44,44,3,17,20,87.0,,762,89,360,449,1646.0,48,5.97,37,209,1408,10.2
8374,Doug Bodger,1998-99,32.0,15,28,73,73,4,24,28,121.0,,835,93,384,477,1767.0,82,6.29,74,413,2481,10.4
8375,Doug Bodger,1999-00,33.0,16,16,81,81,1,15,16,96.0,,916,94,399,493,1863.0,82,5.83,55,336,2444,9.8
8376,Doug Bodger,2000-01,34.0,17,20,77,77,9,11,20,96.0,,993,103,410,513,1959.0,82,5.28,57,380,2242,9.6
8377,Doug Bodger,2001-02,35.0,18,14,65,65,3,11,14,67.0,1264.0,1058,106,421,527,2026.0,82,5.27,57,359,2285,9.4
8378,Doug Bodger,2002-03,36.0,19,1,13,13,0,1,1,11.0,212.0,1071,106,422,528,2037.0,82,5.49,53,331,2294,9.8
8379,Doug Brown,1989-90,25.0,4,1,4,4,0,1,1,10.0,,4,0,1,1,10.0,80,7.34,72,344,2400,12.2
8380,Doug Brown,1990-91,26.0,5,25,70,70,14,11,25,112.0,,74,14,12,26,122.0,80,7.43,89,437,2435,12.2
8381,Doug Brown,1991-92,27.0,6,25,63,63,15,10,25,110.0,,137,29,22,51,232.0,80,7.48,85,403,2430,12.3
8382,Doug Brown,1992-93,28.0,7,34,69,69,14,20,34,135.0,,206,43,42,85,367.0,80,7.37,76,367,2421,12.2
8383,Doug Brown,1993-94,29.0,8,30,58,58,14,16,30,122.0,,264,57,58,115,489.0,80,6.91,71,366,2385,11.6
8384,Doug Brown,1994-95,30.0,9,28,71,71,11,17,28,140.0,,335,68,75,143,629.0,80,6.96,77,402,2440,11.4
8385,Doug Brown,1995-96,31.0,10,5,15,15,0,5,5,17.0,,350,68,80,148,646.0,84,7.25,87,443,2603,11.7
8386,Doug Brown,1996-97,32.0,11,55,77,77,18,37,55,152.0,,427,86,117,203,798.0,84,6.48,76,407,2545,10.7
8387,Doug Brown,1997-98,33.0,12,21,45,45,9,12,21,69.0,,472,95,129,224,867.0,48,5.97,37,209,1408,10.2
8388,Doug Brown,1998-99,34.0,13,27,62,62,12,15,27,115.0,,534,107,144,251,982.0,82,6.29,74,413,2481,10.4
8389,Doug Brown,1999-00,35.0,14,13,49,49,6,7,13,69.0,,583,113,151,264,1051.0,82,5.83,55,336,2444,9.8
8390,Doug Brown,2000-01,36.0,15,42,80,80,19,23,42,145.0,,663,132,174,306,1196.0,82,5.28,57,380,2242,9.6
8391,Doug Brown,2001-02,37.0,16,28,80,80,9,19,28,180.0,1103.0,743,141,193,334,1376.0,82,5.27,57,359,2285,9.4
8392,Doug Brown,2002-03,38.0,17,18,51,51,10,8,18,67.0,657.0,794,151,201,352,1443.0,82,5.49,53,331,2294,9.8
8393,Doug Brown,2003-04,39.0,18,22,60,60,9,13,22,91.0,674.0,854,160,214,374,1534.0,82,5.51,63,376,2272,9.9
8394,Doug Crossman,1983-84,23.0,4,2,9,9,0,2,2,16.0,,9,0,2,2,16.0,80,7.69,77,340,2441,12.6
8395,Doug Crossman,1984-85,24.0,5,40,70,70,12,28,40,127.0,,79,12,30,42,143.0,80,8.03,73,320,2489,12.9
8396,Doug Crossman,1985-86,25.0,6,53,80,80,13,40,53,135.0,,159,25,70,95,278.0,80,7.73,71,310,2444,12.7
8397,Doug Crossman,1986-87,26.0,7,35,78,78,7,28,35,159.0,,237,32,98,130,437.0,80,7.89,74,336,2448,12.9
8398,Doug Crossman,1987-88,27.0,8,37,80,80,4,33,37,114.0,,317,36,131,167,551.0,80,7.77,71,321,2447,12.7
8399,Doug Crossman,1988-89,28.0,9,43,80,80,6,37,43,134.0,,397,42,168,210,685.0,80,7.94,82,370,2484,12.8
8400,Doug Crossman,1989-90,29.0,10,40,78,78,9,31,40,122.0,,475,51,199,250,807.0,80,7.34,72,344,2400,12.2
8401,Doug Crossman,1990-91,30.0,11,38,76,76,9,29,38,153.0,,551,60,228,288,960.0,80,7.43,89,437,2435,12.2
8402,Doug Crossman,1991-92,31.0,12,25,74,74,10,15,25,137.0,,625,70,243,313,1097.0,80,7.48,85,403,2430,12.3
8403,Doug Crossman,1992-93,32.0,13,59,80,80,15,44,59,159.0,,705,85,287,372,1256.0,80,7.37,76,367,2421,12.2
8404,Doug Crossman,1993-94,33.0,14,37,74,74,8,29,37,108.0,,779,93,316,409,1364.0,80,6.91,71,366,2385,11.6
8405,Doug Crossman,1994-95,34.0,15,8,26,26,0,8,8,21.0,,805,93,324,417,1385.0,80,6.96,77,402,2440,11.4
8406,Doug Crossman,1995-96,35.0,16,38,59,59,10,28,38,78.0,,864,103,352,455,1463.0,84,7.25,87,443,2603,11.7
8407,Doug Crossman,1996-97,36.0,17,9,50,50,2,7,9,30.0,,914,105,359,464,1493.0,84,6.48,76,407,2545,10.7
8408,Doug Doull,2006-07,32.0,4,1,35,35,0,1,1,4.0,99.0,35,0,1,1,4.0,82,5.14,57,348,2300,9.2
8409,Doug Doull,2008-09,34.0,5,0,2,2,0,0,0,0.0,8.0,37,0,1,1,4.0,82,6.05,85,480,2458,10.1
8410,Doug Evans,1988-89,25.0,4,1,13,13,1,0,1,12.0,,13,1,0,1,12.0,80,7.94,82,370,2484,12.8
8411,Doug Evans,1989-90,26.0,5,16,53,53,3,13,16,51.0,,66,4,13,17,63.0,80,7.34,72,344,2400,12.2
8412,Doug Evans,1990-91,27.0,6,12,41,41,5,7,12,32.0,,107,9,20,29,95.0,80,7.43,89,437,2435,12.2
8413,Doug Evans,1991-92,28.0,7,19,53,53,7,12,19,48.0,,160,16,32,48,143.0,80,7.48,85,403,2430,12.3
8414,Doug Evans,1992-93,29.0,8,18,30,30,10,8,18,37.0,,190,26,40,66,180.0,80,7.37,76,367,2421,12.2
8415,Doug Evans,1993-94,30.0,9,34,70,70,7,27,34,70.0,,260,33,67,100,250.0,80,6.91,71,366,2385,11.6
8416,Doug Evans,1994-95,31.0,10,14,30,30,7,7,14,39.0,,290,40,74,114,289.0,80,6.96,77,402,2440,11.4
8417,Doug Evans,1995-96,32.0,11,21,65,65,8,13,21,60.0,,355,48,87,135,349.0,84,7.25,87,443,2603,11.7
8418,Doug Friedman,2000-01,29.0,4,0,16,16,0,0,0,8.0,,16,0,0,0,8.0,82,5.28,57,380,2242,9.6
8419,Doug Friedman,2001-02,30.0,5,1,2,2,0,1,1,3.0,14.0,18,0,1,1,11.0,82,5.27,57,359,2285,9.4
8420,Doug Gilmour,1986-87,23.0,4,53,80,80,25,28,53,157.0,,80,25,28,53,157.0,80,7.89,74,336,2448,12.9
8421,Doug Gilmour,1987-88,24.0,5,57,78,78,21,36,57,162.0,,158,46,64,110,319.0,80,7.77,71,321,2447,12.7
8422,Doug Gilmour,1988-89,25.0,6,53,74,74,25,28,53,183.0,,232,71,92,163,502.0,80,7.94,82,370,2484,12.8
8423,Doug Gilmour,1989-90,26.0,7,105,80,80,42,63,105,208.0,,312,113,155,268,710.0,80,7.34,72,344,2400,12.2
8424,Doug Gilmour,1990-91,27.0,8,86,72,72,36,50,86,163.0,,384,149,205,354,873.0,80,7.43,89,437,2435,12.2
8425,Doug Gilmour,1991-92,28.0,9,85,72,72,26,59,85,161.0,,456,175,264,439,1034.0,80,7.48,85,403,2430,12.3
8426,Doug Gilmour,1992-93,29.0,10,91,78,78,24,67,91,152.0,,534,199,331,530,1186.0,80,7.37,76,367,2421,12.2
8427,Doug Gilmour,1993-94,30.0,11,81,78,78,20,61,81,135.0,,612,219,392,611,1321.0,80,6.91,71,366,2385,11.6
8428,Doug Gilmour,1994-95,31.0,12,87,78,78,26,61,87,168.0,,690,245,453,698,1489.0,80,6.96,77,402,2440,11.4
8429,Doug Gilmour,1995-96,32.0,13,127,83,83,32,95,127,211.0,,773,277,548,825,1700.0,84,7.25,87,443,2603,11.7
8430,Doug Gilmour,1996-97,33.0,14,111,83,83,27,84,111,167.0,,856,304,632,936,1867.0,84,6.48,76,407,2545,10.7
8431,Doug Gilmour,1997-98,34.0,15,33,44,44,10,23,33,73.0,,900,314,655,969,1940.0,48,5.97,37,209,1408,10.2
8432,Doug Gilmour,1998-99,35.0,16,72,81,81,32,40,72,180.0,,981,346,695,1041,2120.0,82,6.29,74,413,2481,10.4
8433,Doug Gilmour,1999-00,36.0,17,82,81,81,22,60,82,143.0,,1062,368,755,1123,2263.0,82,5.83,55,336,2444,9.8
8434,Doug Gilmour,2000-01,37.0,18,53,63,63,13,40,53,94.0,,1125,381,795,1176,2357.0,82,5.28,57,380,2242,9.6
8435,Doug Gilmour,2001-02,38.0,19,56,72,72,16,40,56,110.0,1619.0,1197,397,835,1232,2467.0,82,5.27,57,359,2285,9.4
8436,Doug Gilmour,2002-03,39.0,20,73,74,74,25,48,73,113.0,1468.0,1271,422,883,1305,2580.0,82,5.49,53,331,2294,9.8
8437,Doug Gilmour,2003-04,40.0,21,38,71,71,7,31,38,91.0,1281.0,1342,429,914,1343,2671.0,82,5.51,63,376,2272,9.9
8438,Doug Gilmour,2004-05,41.0,22,41,70,70,10,31,41,78.0,1306.0,1412,439,945,1384,2749.0,82,5.24,53,338,2262,9.5
8439,Doug Gilmour,2005-06,42.0,23,30,62,62,11,19,30,85.0,1027.0,1474,450,964,1414,2834.0,82,5.31,60,363,2326,9.4
8440,Doug Houda,1988-89,22.0,4,0,6,6,0,0,0,5.0,,6,0,0,0,5.0,80,7.94,82,370,2484,12.8
8441,Doug Houda,1990-91,24.0,5,2,11,11,1,1,2,10.0,,17,1,1,2,15.0,80,7.43,89,437,2435,12.2
8442,Doug Houda,1991-92,25.0,6,13,57,57,2,11,13,38.0,,74,3,12,15,53.0,80,7.48,85,403,2430,12.3
8443,Doug Houda,1992-93,26.0,7,11,73,73,2,9,11,59.0,,147,5,21,26,112.0,80,7.37,76,367,2421,12.2
8444,Doug Houda,1993-94,27.0,8,7,41,41,1,6,7,42.0,,188,6,27,33,154.0,80,6.91,71,366,2385,11.6
8445,Doug Houda,1994-95,28.0,9,9,56,56,3,6,9,40.0,,244,9,33,42,194.0,80,6.96,77,402,2440,11.4
8446,Doug Houda,1995-96,29.0,10,8,60,60,2,6,8,43.0,,304,11,39,50,237.0,84,7.25,87,443,2603,11.7
8447,Doug Houda,1996-97,30.0,11,8,61,61,2,6,8,32.0,,365,13,45,58,269.0,84,6.48,76,407,2545,10.7
8448,Doug Houda,1997-98,31.0,12,3,28,28,1,2,3,21.0,,393,14,47,61,290.0,48,5.97,37,209,1408,10.2
8449,Doug Houda,1998-99,32.0,13,4,38,38,1,3,4,21.0,,431,15,50,65,311.0,82,6.29,74,413,2481,10.4
8450,Doug Houda,1999-00,33.0,14,10,70,70,2,8,10,29.0,,501,17,58,75,340.0,82,5.83,55,336,2444,9.8
8451,Doug Houda,2000-01,34.0,15,6,55,55,2,4,6,24.0,,556,19,62,81,364.0,82,5.28,57,380,2242,9.6
8452,Doug Houda,2001-02,35.0,16,1,3,3,0,1,1,1.0,21.0,559,19,63,82,365.0,82,5.27,57,359,2285,9.4
8453,Doug Houda,2002-03,36.0,17,0,1,1,0,0,0,0.0,9.0,560,19,63,82,365.0,82,5.49,53,331,2294,9.8
8454,Doug Houda,2005-06,39.0,18,0,1,1,0,0,0,1.0,13.0,561,19,63,82,366.0,82,5.31,60,363,2326,9.4
8455,Doug Janik,2005-06,25.0,4,0,6,6,0,0,0,1.0,46.0,6,0,0,0,1.0,82,5.31,60,363,2326,9.4
8456,Doug Janik,2006-07,26.0,5,0,4,4,0,0,0,3.0,34.0,10,0,0,0,4.0,82,5.14,57,348,2300,9.2
8457,Doug Janik,2009-10,29.0,6,11,75,75,2,9,11,49.0,1085.0,85,2,9,11,53.0,82,5.76,70,398,2426,9.7
8458,Doug Janik,2010-11,30.0,7,4,61,61,1,3,4,23.0,569.0,146,3,12,15,76.0,82,5.44,62,351,2383,9.4
8459,Doug Janik,2011-12,31.0,8,1,15,15,0,1,1,1.0,154.0,161,3,13,16,77.0,82,5.7,65,341,2477,9.4
8460,Doug Janik,2012-13,32.0,9,2,13,13,0,2,2,5.0,175.0,174,3,15,18,82.0,82,5.53,56,304,2486,9.1
8461,Doug Janik,2013-14,33.0,10,0,7,7,0,0,0,8.0,93.0,181,3,15,18,90.0,82,5.46,52,291,2492,9.0
8462,Doug Janik,2014-15,34.0,11,1,9,9,0,1,1,6.0,131.0,190,3,16,19,96.0,82,5.32,47,271,2439,8.9
8463,Doug Kostynski,1986-87,23.0,4,4,9,9,3,1,4,8.0,,9,3,1,4,8.0,80,7.89,74,336,2448,12.9
8464,Doug Kostynski,1987-88,24.0,5,0,6,6,0,0,0,4.0,,15,3,1,4,12.0,80,7.77,71,321,2447,12.7
8465,Doug Lidster,1986-87,26.0,4,0,8,8,0,0,0,7.0,,8,0,0,0,7.0,80,7.89,74,336,2448,12.9
8466,Doug Lidster,1987-88,27.0,5,30,78,78,6,24,30,126.0,,86,6,24,30,133.0,80,7.77,71,321,2447,12.7
8467,Doug Lidster,1988-89,28.0,6,28,78,78,12,16,28,152.0,,164,18,40,58,285.0,80,7.94,82,370,2484,12.8
8468,Doug Lidster,1989-90,29.0,7,63,80,80,12,51,63,176.0,,244,30,91,121,461.0,80,7.34,72,344,2400,12.2
8469,Doug Lidster,1990-91,30.0,8,36,64,64,4,32,36,133.0,,308,34,123,157,594.0,80,7.43,89,437,2435,12.2
8470,Doug Lidster,1991-92,31.0,9,22,63,63,5,17,22,116.0,,371,39,140,179,710.0,80,7.48,85,403,2430,12.3
8471,Doug Lidster,1992-93,32.0,10,36,80,80,8,28,36,143.0,,451,47,168,215,853.0,80,7.37,76,367,2421,12.2
8472,Doug Lidster,1993-94,33.0,11,38,78,78,6,32,38,157.0,,529,53,200,253,1010.0,80,6.91,71,366,2385,11.6
8473,Doug Lidster,1994-95,34.0,12,29,66,66,6,23,29,89.0,,595,59,223,282,1099.0,80,6.96,77,402,2440,11.4
8474,Doug Lidster,1995-96,35.0,13,25,71,71,6,19,25,76.0,,666,65,242,307,1175.0,84,7.25,87,443,2603,11.7
8475,Doug Lidster,1996-97,36.0,14,2,34,34,0,2,2,25.0,,700,65,244,309,1200.0,84,6.48,76,407,2545,10.7
8476,Doug Lidster,1997-98,37.0,15,9,37,37,2,7,9,37.0,,737,67,251,318,1237.0,48,5.97,37,209,1408,10.2
8477,Doug Lidster,1998-99,38.0,16,14,59,59,5,9,14,73.0,,796,72,260,332,1310.0,82,6.29,74,413,2481,10.4
8478,Doug Lidster,1999-00,39.0,17,7,48,48,3,4,7,42.0,,844,75,264,339,1352.0,82,5.83,55,336,2444,9.8
8479,Doug Lidster,2000-01,40.0,18,4,36,36,0,4,4,25.0,,880,75,268,343,1377.0,82,5.28,57,380,2242,9.6
8480,Doug Lidster,2001-02,41.0,19,0,17,17,0,0,0,7.0,226.0,897,75,268,343,1384.0,82,5.27,57,359,2285,9.4
8481,Doug Lynch,2006-07,23.0,4,0,2,2,0,0,0,2.0,21.0,2,0,0,0,2.0,82,5.14,57,348,2300,9.2
8482,Doug MacDonald,1995-96,26.0,4,1,5,5,1,0,1,1.0,,5,1,0,1,1.0,84,7.25,87,443,2603,11.7
8483,Doug MacDonald,1996-97,27.0,5,0,4,4,0,0,0,3.0,,9,1,0,1,4.0,84,6.48,76,407,2545,10.7
8484,Doug MacDonald,1997-98,28.0,6,0,2,2,0,0,0,0.0,,11,1,0,1,4.0,48,5.97,37,209,1408,10.2
8485,Doug Morrison,1982-83,22.0,4,0,1,1,0,0,0,1.0,,1,0,0,0,1.0,80,7.03,61,280,2352,12.0
8486,Doug Morrison,1983-84,23.0,5,10,18,18,7,3,10,30.0,,19,7,3,10,31.0,80,7.69,77,340,2441,12.6
8487,Doug Morrison,1984-85,24.0,6,0,3,3,0,0,0,1.0,,22,7,3,10,32.0,80,8.03,73,320,2489,12.9
8488,Doug Morrison,1987-88,27.0,7,0,1,1,0,0,0,1.0,,23,7,3,10,33.0,80,7.77,71,321,2447,12.7
8489,Doug O'Brien,2008-09,24.0,4,0,5,5,0,0,0,2.0,39.0,5,0,0,0,2.0,82,6.05,85,480,2458,10.1
8490,Doug Shedden,1984-85,23.0,4,25,38,38,10,15,25,76.0,,38,10,15,25,76.0,80,8.03,73,320,2489,12.9
8491,Doug Shedden,1985-86,24.0,5,67,80,80,24,43,67,173.0,,118,34,58,92,249.0,80,7.73,71,310,2444,12.7
8492,Doug Shedden,1986-87,25.0,6,57,67,67,22,35,57,160.0,,185,56,93,149,409.0,80,7.89,74,336,2448,12.9
8493,Doug Shedden,1987-88,26.0,7,67,80,80,35,32,67,203.0,,265,91,125,216,612.0,80,7.77,71,321,2447,12.7
8494,Doug Shedden,1988-89,27.0,8,71,78,78,34,37,71,212.0,,343,125,162,287,824.0,80,7.94,82,370,2484,12.8
8495,Doug Shedden,1989-90,28.0,9,20,49,49,6,14,20,80.0,,392,131,176,307,904.0,80,7.34,72,344,2400,12.2
8496,Doug Shedden,1991-92,30.0,10,0,1,1,0,0,0,2.0,,393,131,176,307,906.0,80,7.48,85,403,2430,12.3
8497,Doug Shedden,1993-94,32.0,11,18,23,23,8,10,18,35.0,,416,139,186,325,941.0,80,6.91,71,366,2385,11.6
8498,Doug Smail,1983-84,26.0,4,18,30,30,10,8,18,58.0,,30,10,8,18,58.0,80,7.69,77,340,2441,12.6
8499,Doug Smail,1984-85,27.0,5,35,72,72,17,18,35,97.0,,102,27,26,53,155.0,80,8.03,73,320,2489,12.9
8500,Doug Smail,1985-86,28.0,6,44,80,80,15,29,44,114.0,,182,42,55,97,269.0,80,7.73,71,310,2444,12.7
8501,Doug Smail,1986-87,29.0,7,37,66,66,20,17,37,122.0,,248,62,72,134,391.0,80,7.89,74,336,2448,12.9
8502,Doug Smail,1987-88,30.0,8,66,80,80,31,35,66,154.0,,328,93,107,200,545.0,80,7.77,71,321,2447,12.7
8503,Doug Smail,1988-89,31.0,9,42,73,73,16,26,42,150.0,,401,109,133,242,695.0,80,7.94,82,370,2484,12.8
8504,Doug Smail,1989-90,32.0,10,43,78,78,25,18,43,131.0,,479,134,151,285,826.0,80,7.34,72,344,2400,12.2
8505,Doug Smail,1990-91,33.0,11,31,71,71,15,16,31,110.0,,550,149,167,316,936.0,80,7.43,89,437,2435,12.2
8506,Doug Smail,1991-92,34.0,12,29,47,47,14,15,29,68.0,,597,163,182,345,1004.0,80,7.48,85,403,2430,12.3
8507,Doug Smail,1992-93,35.0,13,49,79,79,25,24,49,165.0,,676,188,206,394,1169.0,80,7.37,76,367,2421,12.2
8508,Doug Smail,1993-94,36.0,14,23,72,72,8,15,23,107.0,,748,196,221,417,1276.0,80,6.91,71,366,2385,11.6
8509,Doug Smail,1994-95,37.0,15,28,46,46,10,18,28,72.0,,794,206,239,445,1348.0,80,6.96,77,402,2440,11.4
8510,Doug Smail,1995-96,38.0,16,14,51,51,4,10,14,73.0,,845,210,249,459,1421.0,84,7.25,87,443,2603,11.7
8511,Doug Smith,1984-85,21.0,4,30,80,80,16,14,30,141.0,,80,16,14,30,141.0,80,8.03,73,320,2489,12.9
8512,Doug Smith,1985-86,22.0,5,22,42,42,11,11,22,91.0,,122,27,25,52,232.0,80,7.73,71,310,2444,12.7
8513,Doug Smith,1986-87,23.0,6,36,72,72,16,20,36,146.0,,194,43,45,88,378.0,80,7.89,74,336,2448,12.9
8514,Doug Smith,1987-88,24.0,7,41,62,62,21,20,41,147.0,,256,64,65,129,525.0,80,7.77,71,321,2447,12.7
8515,Doug Smith,1988-89,25.0,8,38,78,78,18,20,38,187.0,,334,82,85,167,712.0,80,7.94,82,370,2484,12.8
8516,Doug Smith,1989-90,26.0,9,40,62,62,16,24,40,158.0,,396,98,109,207,870.0,80,7.34,72,344,2400,12.2
8517,Doug Smith,1990-91,27.0,10,28,70,70,9,19,28,136.0,,466,107,128,235,1006.0,80,7.43,89,437,2435,12.2
8518,Doug Smith,1991-92,28.0,11,9,29,29,4,5,9,27.0,,495,111,133,244,1033.0,80,7.48,85,403,2430,12.3
8519,Doug Smith,1992-93,29.0,12,9,40,40,4,5,9,51.0,,535,115,138,253,1084.0,80,7.37,76,367,2421,12.2
8520,Doug Sulliman,1982-83,23.0,4,11,31,31,4,7,11,26.0,,31,4,7,11,26.0,80,7.03,61,280,2352,12.0
8521,Doug Sulliman,1983-84,24.0,5,5,32,32,4,1,5,56.0,,63,8,8,16,82.0,80,7.69,77,340,2441,12.6
8522,Doug Sulliman,1984-85,25.0,6,69,77,77,29,40,69,197.0,,140,37,48,85,279.0,80,8.03,73,320,2489,12.9
8523,Doug Sulliman,1985-86,26.0,7,41,77,77,22,19,41,162.0,,217,59,67,126,441.0,80,7.73,71,310,2444,12.7
8524,Doug Sulliman,1986-87,27.0,8,19,67,67,6,13,19,130.0,,284,65,80,145,571.0,80,7.89,74,336,2448,12.9
8525,Doug Sulliman,1987-88,28.0,9,38,57,57,22,16,38,112.0,,341,87,96,183,683.0,80,7.77,71,321,2447,12.7
8526,Doug Sulliman,1988-89,29.0,10,43,73,73,21,22,43,139.0,,414,108,118,226,822.0,80,7.94,82,370,2484,12.8
8527,Doug Sulliman,1989-90,30.0,11,53,78,78,27,26,53,148.0,,492,135,144,279,970.0,80,7.34,72,344,2400,12.2
8528,Doug Sulliman,1990-91,31.0,12,30,59,59,16,14,30,89.0,,551,151,158,309,1059.0,80,7.43,89,437,2435,12.2
8529,Doug Sulliman,1991-92,32.0,13,12,52,52,6,6,12,52.0,,603,157,164,321,1111.0,80,7.48,85,403,2430,12.3
8530,Doug Sulliman,1992-93,33.0,14,7,28,28,3,4,7,28.0,,631,160,168,328,1139.0,80,7.37,76,367,2421,12.2
8531,Doug Trapp,1989-90,24.0,4,0,2,2,0,0,0,1.0,,2,0,0,0,1.0,80,7.34,72,344,2400,12.2
8532,Doug Weight,1994-95,24.0,4,30,53,53,8,22,30,72.0,,53,8,22,30,72.0,80,6.96,77,402,2440,11.4
8533,Doug Weight,1995-96,25.0,5,48,78,78,17,31,48,125.0,,131,25,53,78,197.0,84,7.25,87,443,2603,11.7
8534,Doug Weight,1996-97,26.0,6,74,84,84,24,50,74,188.0,,215,49,103,152,385.0,84,6.48,76,407,2545,10.7
8535,Doug Weight,1997-98,27.0,7,40,48,48,7,33,40,104.0,,263,56,136,192,489.0,48,5.97,37,209,1408,10.2
8536,Doug Weight,1998-99,28.0,8,104,82,82,25,79,104,204.0,,345,81,215,296,693.0,82,6.29,74,413,2481,10.4
8537,Doug Weight,1999-00,29.0,9,82,80,80,21,61,82,235.0,,425,102,276,378,928.0,82,5.83,55,336,2444,9.8
8538,Doug Weight,2000-01,30.0,10,70,79,79,26,44,70,205.0,,504,128,320,448,1133.0,82,5.28,57,380,2242,9.6
8539,Doug Weight,2001-02,31.0,11,37,43,43,6,31,37,79.0,854.0,547,134,351,485,1212.0,82,5.27,57,359,2285,9.4
8540,Doug Weight,2002-03,32.0,12,72,77,77,21,51,72,167.0,1585.0,624,155,402,557,1379.0,82,5.49,53,331,2294,9.8
8541,Doug Weight,2003-04,33.0,13,90,82,82,25,65,90,188.0,1815.0,706,180,467,647,1567.0,82,5.51,63,376,2272,9.9
8542,Doug Weight,2004-05,34.0,14,49,61,61,15,34,49,131.0,1208.0,767,195,501,696,1698.0,82,5.24,53,338,2262,9.5
8543,Doug Weight,2005-06,35.0,15,67,70,70,15,52,67,182.0,1426.0,837,210,553,763,1880.0,82,5.31,60,363,2326,9.4
8544,Doug Weight,2006-07,36.0,16,65,75,75,14,51,65,198.0,1532.0,912,224,604,828,2078.0,82,5.14,57,348,2300,9.2
8545,Doug Weight,2008-09,38.0,17,57,70,70,15,42,57,175.0,1452.0,982,239,646,885,2253.0,82,6.05,85,480,2458,10.1
8546,Doug Weight,2009-10,39.0,18,59,82,82,16,43,59,123.0,1500.0,1064,255,689,944,2376.0,82,5.76,70,398,2426,9.7
8547,Doug Weight,2010-11,40.0,19,25,67,67,10,15,25,96.0,979.0,1131,265,704,969,2472.0,82,5.44,62,351,2383,9.4
8548,Doug Weight,2011-12,41.0,20,38,53,53,10,28,38,96.0,969.0,1184,275,732,1007,2568.0,82,5.7,65,341,2477,9.4
8549,Doug Weight,2012-13,42.0,21,17,36,36,1,16,17,61.0,570.0,1220,276,748,1024,2629.0,82,5.53,56,304,2486,9.1
8550,Doug Weight,2013-14,43.0,22,9,18,18,2,7,9,26.0,315.0,1238,278,755,1033,2655.0,82,5.46,52,291,2492,9.0
8551,Doug Wickenheiser,1983-84,22.0,4,15,41,41,7,8,15,56.0,,41,7,8,15,56.0,80,7.69,77,340,2441,12.6
8552,Doug Wickenheiser,1984-85,23.0,5,35,56,56,12,23,35,94.0,,97,19,31,50,150.0,80,8.03,73,320,2489,12.9
8553,Doug Wickenheiser,1985-86,24.0,6,55,78,78,25,30,55,160.0,,175,44,61,105,310.0,80,7.73,71,310,2444,12.7
8554,Doug Wickenheiser,1986-87,25.0,7,38,73,73,12,26,38,143.0,,248,56,87,143,453.0,80,7.89,74,336,2448,12.9
8555,Doug Wickenheiser,1987-88,26.0,8,43,68,68,23,20,43,155.0,,316,79,107,186,608.0,80,7.77,71,321,2447,12.7
8556,Doug Wickenheiser,1988-89,27.0,9,19,36,36,8,11,19,53.0,,352,87,118,205,661.0,80,7.94,82,370,2484,12.8
8557,Doug Wickenheiser,1989-90,28.0,10,28,80,80,13,15,28,131.0,,432,100,133,233,792.0,80,7.34,72,344,2400,12.2
8558,Doug Wickenheiser,1990-91,29.0,11,26,80,80,7,19,26,123.0,,512,107,152,259,915.0,80,7.43,89,437,2435,12.2
8559,Doug Wickenheiser,1991-92,30.0,12,8,17,17,3,5,8,33.0,,529,110,157,267,948.0,80,7.48,85,403,2430,12.3
8560,Doug Wickenheiser,1992-93,31.0,13,9,27,27,1,8,9,44.0,,556,111,165,276,992.0,80,7.37,76,367,2421,12.2
8561,Doug Zmolek,1995-96,25.0,4,15,84,84,5,10,15,94.0,,84,5,10,15,94.0,84,7.25,87,443,2603,11.7
8562,Doug Zmolek,1996-97,26.0,5,5,75,75,1,4,5,32.0,,159,6,14,20,126.0,84,6.48,76,407,2545,10.7
8563,Doug Zmolek,1997-98,27.0,6,5,42,42,0,5,5,28.0,,201,6,19,25,154.0,48,5.97,37,209,1408,10.2
8564,Doug Zmolek,1998-99,28.0,7,7,58,58,2,5,7,36.0,,259,8,24,32,190.0,82,6.29,74,413,2481,10.4
8565,Doug Zmolek,1999-00,29.0,8,1,57,57,1,0,1,28.0,,316,9,24,33,218.0,82,5.83,55,336,2444,9.8
8566,Doug Zmolek,2000-01,30.0,9,8,46,46,0,8,8,23.0,,362,9,32,41,241.0,82,5.28,57,380,2242,9.6
8567,Doug Zmolek,2001-02,31.0,10,14,62,62,0,14,14,33.0,1062.0,424,9,46,55,274.0,82,5.27,57,359,2285,9.4
8568,Doug Zmolek,2002-03,32.0,11,9,43,43,2,7,9,24.0,656.0,467,11,53,64,298.0,82,5.49,53,331,2294,9.8
8569,Dougie Hamilton,2015-16,22.0,4,16,42,42,5,11,16,83.0,719.0,42,5,11,16,83.0,48,5.31,29,160,1399,9.1
8570,Dougie Hamilton,2016-17,23.0,5,25,64,64,7,18,25,114.0,1223.0,106,12,29,41,197.0,82,5.34,48,269,2463,8.9
8571,Dougie Hamilton,2017-18,24.0,6,42,72,72,10,32,42,188.0,1536.0,178,22,61,83,385.0,82,5.32,47,251,2453,8.9
8572,Dougie Hamilton,2018-19,25.0,7,43,82,82,12,31,43,190.0,1621.0,260,34,92,126,575.0,82,5.34,48,255,2438,9.0
8573,Dougie Hamilton,2019-20,26.0,8,50,81,81,13,37,50,222.0,1594.0,341,47,129,176,797.0,82,5.45,47,245,2478,9.0
8574,Dougie Hamilton,2020-21,27.0,9,44,82,82,17,27,44,270.0,1766.0,423,64,156,220,1067.0,82,5.86,50,250,2620,9.2
8575,Dougie Hamilton,2021-22,28.0,10,39,82,82,18,21,39,259.0,1613.0,505,82,177,259,1326.0,82,5.96,47,239,2579,9.5
8576,Dougie Hamilton,2022-23,29.0,11,40,47,47,14,26,40,170.0,1094.0,552,96,203,299,1496.0,70,5.96,42,208,2192,9.5
8577,Douglas Murray,2008-09,28.0,4,1,34,34,0,1,1,21.0,472.0,34,0,1,1,21.0,82,6.05,85,480,2458,10.1
8578,Douglas Murray,2009-10,29.0,5,3,35,35,0,3,3,18.0,377.0,69,0,4,4,39.0,82,5.76,70,398,2426,9.7
8579,Douglas Murray,2010-11,30.0,6,10,66,66,1,9,10,48.0,1153.0,135,1,13,14,87.0,82,5.44,62,351,2383,9.4
8580,Douglas Murray,2011-12,31.0,7,7,75,75,0,7,7,56.0,1249.0,210,1,20,21,143.0,82,5.7,65,341,2477,9.4
8581,Douglas Murray,2012-13,32.0,8,17,79,79,4,13,17,85.0,1607.0,289,5,33,38,228.0,82,5.53,56,304,2486,9.1
8582,Douglas Murray,2013-14,33.0,9,14,73,73,1,13,14,102.0,1432.0,362,6,46,52,330.0,82,5.46,52,291,2492,9.0
8583,Douglas Murray,2014-15,34.0,10,4,60,60,0,4,4,71.0,1103.0,422,6,50,56,401.0,82,5.32,47,271,2439,8.9
8584,Douglas Murray,2015-16,35.0,11,6,43,43,1,5,6,27.0,756.0,465,7,55,62,428.0,48,5.31,29,160,1399,9.1
8585,Douglas Murray,2016-17,36.0,12,2,53,53,0,2,2,26.0,761.0,518,7,57,64,454.0,82,5.34,48,269,2463,8.9
8586,Drake Batherson,2021-22,23.0,4,9,20,20,3,6,9,18.0,268.0,20,3,6,9,18.0,82,5.96,47,239,2579,9.5
8587,Drake Batherson,2022-23,24.0,5,10,23,23,3,7,10,32.0,358.0,43,6,13,19,50.0,70,5.96,42,208,2192,9.5
8588,Drake Berehowsky,1993-94,22.0,4,1,8,8,0,1,1,4.0,,8,0,1,1,4.0,80,6.91,71,366,2385,11.6
8589,Drake Berehowsky,1994-95,23.0,5,0,1,1,0,0,0,0.0,,9,0,1,1,4.0,80,6.96,77,402,2440,11.4
8590,Drake Berehowsky,1995-96,24.0,6,19,41,41,4,15,19,41.0,,50,4,16,20,45.0,84,7.25,87,443,2603,11.7
8591,Drake Berehowsky,1996-97,25.0,7,10,49,49,2,8,10,29.0,,99,6,24,30,74.0,84,6.48,76,407,2545,10.7
8592,Drake Berehowsky,1997-98,26.0,8,2,29,29,0,2,2,14.0,,128,6,26,32,88.0,48,5.97,37,209,1408,10.2
8593,Drake Berehowsky,1998-99,27.0,9,0,1,1,0,0,0,0.0,,129,6,26,32,88.0,82,6.29,74,413,2481,10.4
8594,Drake Berehowsky,2000-01,29.0,10,7,67,67,1,6,7,58.0,,196,7,32,39,146.0,82,5.28,57,380,2242,9.6
8595,Drake Berehowsky,2001-02,30.0,11,17,74,74,2,15,17,79.0,1607.0,270,9,47,56,225.0,82,5.27,57,359,2285,9.4
8596,Drake Berehowsky,2002-03,31.0,12,32,79,79,12,20,32,102.0,1790.0,349,21,67,88,327.0,82,5.49,53,331,2294,9.8
8597,Drake Berehowsky,2003-04,32.0,13,26,80,80,7,19,26,107.0,1668.0,429,28,86,114,434.0,82,5.51,63,376,2272,9.9
8598,Drake Berehowsky,2004-05,33.0,14,8,57,57,2,6,8,38.0,731.0,486,30,92,122,472.0,82,5.24,53,338,2262,9.5
8599,Drake Berehowsky,2005-06,34.0,15,3,7,7,1,2,3,8.0,76.0,493,31,94,125,480.0,82,5.31,60,363,2326,9.4
8600,Drake Berehowsky,2006-07,35.0,16,24,56,56,6,18,24,70.0,1144.0,549,37,112,149,550.0,82,5.14,57,348,2300,9.2
8601,Drake Caggiula,2019-20,25.0,4,18,60,60,7,11,18,93.0,794.0,60,7,11,18,93.0,82,5.45,47,245,2478,9.0
8602,Drake Caggiula,2020-21,26.0,5,20,67,67,13,7,20,104.0,908.0,127,20,18,38,197.0,82,5.86,50,250,2620,9.2
8603,Drake Caggiula,2021-22,27.0,6,23,55,55,12,11,23,96.0,794.0,182,32,29,61,293.0,82,5.96,47,239,2579,9.5
8604,Drake Caggiula,2022-23,28.0,7,15,40,40,9,6,15,56.0,473.0,222,41,35,76,349.0,70,5.96,42,208,2192,9.5
8605,Drayson Bowman,2012-13,23.0,4,2,9,9,2,0,2,17.0,108.0,9,2,0,2,17.0,82,5.53,56,304,2486,9.1
8606,Drayson Bowman,2013-14,24.0,5,1,23,23,0,1,1,28.0,226.0,32,2,1,3,45.0,82,5.46,52,291,2492,9.0
8607,Drayson Bowman,2014-15,25.0,6,13,37,37,6,7,13,70.0,494.0,69,8,8,16,115.0,82,5.32,47,271,2439,8.9
8608,Drayson Bowman,2015-16,26.0,7,5,37,37,3,2,5,68.0,433.0,106,11,10,21,183.0,48,5.31,29,160,1399,9.1
8609,Drayson Bowman,2016-17,27.0,8,12,70,70,4,8,12,80.0,725.0,176,15,18,33,263.0,82,5.34,48,269,2463,8.9
8610,Drayson Bowman,2017-18,28.0,9,0,3,3,0,0,0,0.0,20.0,179,15,18,33,263.0,82,5.32,47,251,2453,8.9
8611,Drew Bagnall,2013-14,30.0,4,0,2,2,0,0,0,1.0,26.0,2,0,0,0,1.0,82,5.46,52,291,2492,9.0
8612,Drew Bannister,1998-99,24.0,4,1,13,13,0,1,1,10.0,,13,0,1,1,10.0,82,6.29,74,413,2481,10.4
8613,Drew Bannister,1999-00,25.0,5,18,65,65,4,14,18,59.0,,78,4,15,19,69.0,82,5.83,55,336,2444,9.8
8614,Drew Bannister,2000-01,26.0,6,8,61,61,0,8,8,50.0,,139,4,23,27,119.0,82,5.28,57,380,2242,9.6
8615,Drew Bannister,2001-02,27.0,7,3,21,21,1,2,3,29.0,332.0,160,5,25,30,148.0,82,5.27,57,359,2285,9.4
8616,Drew Bannister,2003-04,29.0,8,0,3,3,0,0,0,3.0,32.0,163,5,25,30,151.0,82,5.51,63,376,2272,9.9
8617,Drew Bannister,2004-05,30.0,9,0,1,1,0,0,0,1.0,13.0,164,5,25,30,152.0,82,5.24,53,338,2262,9.5
8618,Drew Doughty,2011-12,22.0,4,27,81,81,6,21,27,126.0,1930.0,81,6,21,27,126.0,82,5.7,65,341,2477,9.4
8619,Drew Doughty,2012-13,23.0,5,59,82,82,16,43,59,142.0,2048.0,163,22,64,86,268.0,82,5.53,56,304,2486,9.1
8620,Drew Doughty,2013-14,24.0,6,40,76,76,11,29,40,139.0,1949.0,239,33,93,126,407.0,82,5.46,52,291,2492,9.0
8621,Drew Doughty,2014-15,25.0,7,36,77,77,10,26,36,168.0,1917.0,316,43,119,162,575.0,82,5.32,47,271,2439,8.9
8622,Drew Doughty,2015-16,26.0,8,22,48,48,6,16,22,114.0,1267.0,364,49,135,184,689.0,48,5.31,29,160,1399,9.1
8623,Drew Doughty,2016-17,27.0,9,37,78,78,10,27,37,177.0,2006.0,442,59,162,221,866.0,82,5.34,48,269,2463,8.9
8624,Drew Doughty,2017-18,28.0,10,46,82,82,7,39,46,219.0,2378.0,524,66,201,267,1085.0,82,5.32,47,251,2453,8.9
8625,Drew Doughty,2018-19,29.0,11,51,82,82,14,37,51,197.0,2297.0,606,80,238,318,1282.0,82,5.34,48,255,2438,9.0
8626,Drew Doughty,2019-20,30.0,12,44,82,82,12,32,44,181.0,2226.0,688,92,270,362,1463.0,82,5.45,47,245,2478,9.0
8627,Drew Doughty,2020-21,31.0,13,60,82,82,10,50,60,205.0,2201.0,770,102,320,422,1668.0,82,5.86,50,250,2620,9.2
8628,Drew Doughty,2021-22,32.0,14,45,82,82,8,37,45,154.0,2181.0,852,110,357,467,1822.0,82,5.96,47,239,2579,9.5
8629,Drew Doughty,2022-23,33.0,15,35,67,67,7,28,35,141.0,1730.0,919,117,385,502,1963.0,70,5.96,42,208,2192,9.5
8630,Drew Fata,2009-10,26.0,4,1,3,3,1,0,1,1.0,31.0,3,1,0,1,1.0,82,5.76,70,398,2426,9.7
8631,Drew Fata,2010-11,27.0,5,1,5,5,0,1,1,4.0,88.0,8,1,1,2,5.0,82,5.44,62,351,2383,9.4
8632,Drew Larman,2009-10,24.0,4,2,16,16,2,0,2,15.0,118.0,16,2,0,2,15.0,82,5.76,70,398,2426,9.7
8633,Drew Larman,2010-11,25.0,5,1,6,6,0,1,1,1.0,36.0,22,2,1,3,16.0,82,5.44,62,351,2383,9.4
8634,Drew Larman,2012-13,27.0,6,0,4,4,0,0,0,5.0,32.0,26,2,1,3,21.0,82,5.53,56,304,2486,9.1
8635,Drew LeBlanc,2015-16,26.0,4,0,2,2,0,0,0,3.0,27.0,2,0,0,0,3.0,48,5.31,29,160,1399,9.1
8636,Drew Miller,2010-11,26.0,4,5,26,26,2,3,5,30.0,291.0,26,2,3,5,30.0,82,5.44,62,351,2383,9.4
8637,Drew Miller,2011-12,27.0,5,10,27,27,4,6,10,45.0,351.0,53,6,9,15,75.0,82,5.7,65,341,2477,9.4
8638,Drew Miller,2012-13,28.0,6,19,80,80,10,9,19,103.0,1010.0,133,16,18,34,178.0,82,5.53,56,304,2486,9.1
8639,Drew Miller,2013-14,29.0,7,18,67,67,10,8,18,85.0,787.0,200,26,26,52,263.0,82,5.46,52,291,2492,9.0
8640,Drew Miller,2014-15,30.0,8,25,80,80,14,11,25,131.0,1030.0,280,40,37,77,394.0,82,5.32,47,271,2439,8.9
8641,Drew Miller,2015-16,31.0,9,8,44,44,4,4,8,54.0,608.0,324,44,41,85,448.0,48,5.31,29,160,1399,9.1
8642,Drew Miller,2016-17,32.0,10,15,82,82,7,8,15,117.0,1159.0,406,51,49,100,565.0,82,5.34,48,269,2463,8.9
8643,Drew Miller,2017-18,33.0,11,13,82,82,5,8,13,98.0,1102.0,488,56,57,113,663.0,82,5.32,47,251,2453,8.9
8644,Drew Miller,2018-19,34.0,12,2,28,28,1,1,2,27.0,363.0,516,57,58,115,690.0,82,5.34,48,255,2438,9.0
8645,Drew Miller,2019-20,35.0,13,7,55,55,5,2,7,43.0,565.0,571,62,60,122,733.0,82,5.45,47,245,2478,9.0
8646,Drew Shore,2015-16,25.0,4,13,43,43,3,10,13,96.0,680.0,43,3,10,13,96.0,48,5.31,29,160,1399,9.1
8647,Drew Shore,2016-17,26.0,5,7,24,24,5,2,7,23.0,288.0,67,8,12,20,119.0,82,5.34,48,269,2463,8.9
8648,Drew Shore,2017-18,27.0,6,3,11,11,1,2,3,13.0,117.0,78,9,14,23,132.0,82,5.32,47,251,2453,8.9
8649,Drew Shore,2018-19,28.0,7,1,2,2,0,1,1,3.0,28.0,80,9,15,24,135.0,82,5.34,48,255,2438,9.0
8650,Drew Shore,2019-20,29.0,8,2,14,14,0,2,2,11.0,168.0,94,9,17,26,146.0,82,5.45,47,245,2478,9.0
8651,Drew Stafford,2009-10,24.0,4,27,41,41,13,14,27,67.0,539.0,41,13,14,27,67.0,82,5.76,70,398,2426,9.7
8652,Drew Stafford,2010-11,25.0,5,38,64,64,16,22,38,103.0,866.0,105,29,36,65,170.0,82,5.44,62,351,2383,9.4
8653,Drew Stafford,2011-12,26.0,6,45,79,79,20,25,45,183.0,1235.0,184,49,61,110,353.0,82,5.7,65,341,2477,9.4
8654,Drew Stafford,2012-13,27.0,7,34,71,71,14,20,34,181.0,1027.0,255,63,81,144,534.0,82,5.53,56,304,2486,9.1
8655,Drew Stafford,2013-14,28.0,8,52,62,62,31,21,52,179.0,1025.0,317,94,102,196,713.0,82,5.46,52,291,2492,9.0
8656,Drew Stafford,2014-15,29.0,9,50,80,80,20,30,50,226.0,1412.0,397,114,132,246,939.0,82,5.32,47,271,2439,8.9
8657,Drew Stafford,2015-16,30.0,10,18,46,46,6,12,18,121.0,783.0,443,120,144,264,1060.0,48,5.31,29,160,1399,9.1
8658,Drew Stafford,2016-17,31.0,11,34,70,70,16,18,34,185.0,1305.0,513,136,162,298,1245.0,82,5.34,48,269,2463,8.9
8659,Drew Stafford,2017-18,32.0,12,43,76,76,18,25,43,147.0,1254.0,589,154,187,341,1392.0,82,5.32,47,251,2453,8.9
8660,Drew Stafford,2018-19,33.0,13,38,78,78,21,17,38,187.0,1394.0,667,175,204,379,1579.0,82,5.34,48,255,2438,9.0
8661,Drew Stafford,2019-20,34.0,14,21,58,58,8,13,21,109.0,789.0,725,183,217,400,1688.0,82,5.45,47,245,2478,9.0
8662,Drew Stafford,2020-21,35.0,15,15,59,59,8,7,15,102.0,818.0,784,191,224,415,1790.0,82,5.86,50,250,2620,9.2
8663,Drew Stafford,2021-22,36.0,16,13,57,57,5,8,13,77.0,699.0,841,196,232,428,1867.0,82,5.96,47,239,2579,9.5
8664,Dryden Hunt,2020-21,25.0,4,1,11,11,0,1,1,12.0,116.0,11,0,1,1,12.0,82,5.86,50,250,2620,9.2
8665,Dryden Hunt,2021-22,26.0,5,10,31,31,3,7,10,53.0,343.0,42,3,8,11,65.0,82,5.96,47,239,2579,9.5
8666,Dryden Hunt,2022-23,27.0,6,4,21,21,0,4,4,33.0,220.0,63,3,12,15,98.0,70,5.96,42,208,2192,9.5
8667,Duane Joyce,1996-97,31.0,4,0,3,3,0,0,0,1.0,,3,0,0,0,1.0,84,6.48,76,407,2545,10.7
8668,Duane Sutter,1982-83,22.0,4,24,56,56,15,9,24,75.0,,56,15,9,24,75.0,80,7.03,61,280,2352,12.0
8669,Duane Sutter,1983-84,23.0,5,18,23,23,7,11,18,48.0,,79,22,20,42,123.0,80,7.69,77,340,2441,12.6
8670,Duane Sutter,1984-85,24.0,6,53,77,77,18,35,53,140.0,,156,40,55,95,263.0,80,8.03,73,320,2489,12.9
8671,Duane Sutter,1985-86,25.0,7,32,75,75,13,19,32,120.0,,231,53,74,127,383.0,80,7.73,71,310,2444,12.7
8672,Duane Sutter,1986-87,26.0,8,40,78,78,17,23,40,137.0,,309,70,97,167,520.0,80,7.89,74,336,2448,12.9
8673,Duane Sutter,1987-88,27.0,9,41,78,78,17,24,41,125.0,,387,87,121,208,645.0,80,7.77,71,321,2447,12.7
8674,Duane Sutter,1988-89,28.0,10,53,80,80,20,33,53,151.0,,467,107,154,261,796.0,80,7.94,82,370,2484,12.8
8675,Duane Sutter,1989-90,29.0,11,31,80,80,14,17,31,152.0,,547,121,171,292,948.0,80,7.34,72,344,2400,12.2
8676,Duane Sutter,1990-91,30.0,12,16,37,37,7,9,16,74.0,,584,128,180,308,1022.0,80,7.43,89,437,2435,12.2
8677,Duane Sutter,1991-92,31.0,13,16,75,75,7,9,16,83.0,,659,135,189,324,1105.0,80,7.48,85,403,2430,12.3
8678,Duane Sutter,1992-93,32.0,14,18,72,72,4,14,18,70.0,,731,139,203,342,1175.0,80,7.37,76,367,2421,12.2
8679,Duncan Keith,2008-09,25.0,4,21,81,81,9,12,21,134.0,1898.0,81,9,12,21,134.0,82,6.05,85,480,2458,10.1
8680,Duncan Keith,2009-10,26.0,5,31,82,82,2,29,31,122.0,1935.0,163,11,41,52,256.0,82,5.76,70,398,2426,9.7
8681,Duncan Keith,2010-11,27.0,6,32,82,82,12,20,32,148.0,2096.0,245,23,61,84,404.0,82,5.44,62,351,2383,9.4
8682,Duncan Keith,2011-12,28.0,7,44,77,77,8,36,44,173.0,1969.0,322,31,97,128,577.0,82,5.7,65,341,2477,9.4
8683,Duncan Keith,2012-13,29.0,8,69,82,82,14,55,69,213.0,2181.0,404,45,152,197,790.0,82,5.53,56,304,2486,9.1
8684,Duncan Keith,2013-14,30.0,9,45,82,82,7,38,45,173.0,2205.0,486,52,190,242,963.0,82,5.46,52,291,2492,9.0
8685,Duncan Keith,2014-15,31.0,10,40,74,74,4,36,40,162.0,1990.0,560,56,226,282,1125.0,82,5.32,47,271,2439,8.9
8686,Duncan Keith,2015-16,32.0,11,27,47,47,3,24,27,91.0,1133.0,607,59,250,309,1216.0,48,5.31,29,160,1399,9.1
8687,Duncan Keith,2016-17,33.0,12,61,79,79,6,55,61,198.0,1947.0,686,65,305,370,1414.0,82,5.34,48,269,2463,8.9
8688,Duncan Keith,2017-18,34.0,13,45,80,80,10,35,45,171.0,2045.0,766,75,340,415,1585.0,82,5.32,47,251,2453,8.9
8689,Duncan Keith,2018-19,35.0,14,43,67,67,9,34,43,130.0,1691.0,833,84,374,458,1715.0,82,5.34,48,255,2438,9.0
8690,Duncan Keith,2019-20,36.0,15,53,80,80,6,47,53,183.0,2049.0,913,90,421,511,1898.0,82,5.45,47,245,2478,9.0
8691,Duncan Keith,2020-21,37.0,16,32,82,82,2,30,32,187.0,1954.0,995,92,451,543,2085.0,82,5.86,50,250,2620,9.2
8692,Duncan Keith,2021-22,38.0,17,40,82,82,6,34,40,141.0,1887.0,1077,98,485,583,2226.0,82,5.96,47,239,2579,9.5
8693,Duncan Keith,2022-23,39.0,18,27,61,61,3,24,27,111.0,1488.0,1138,101,509,610,2337.0,70,5.96,42,208,2192,9.5
8694,Duncan Milroy,2009-10,26.0,4,1,5,5,0,1,1,6.0,65.0,5,0,1,1,6.0,82,5.76,70,398,2426,9.7
8695,Duncan Siemens,2017-18,24.0,4,0,1,1,0,0,0,0.0,14.0,1,0,0,0,0.0,82,5.32,47,251,2453,8.9
8696,Duncan Siemens,2019-20,26.0,5,0,3,3,0,0,0,2.0,37.0,4,0,0,0,2.0,82,5.45,47,245,2478,9.0
8697,Duncan Siemens,2020-21,27.0,6,2,16,16,1,1,2,14.0,197.0,20,1,1,2,16.0,82,5.86,50,250,2620,9.2
8698,Dusan Pasek,1991-92,31.0,4,14,48,48,4,10,14,86.0,,48,4,10,14,86.0,80,7.48,85,403,2430,12.3
8699,Dustin Boyd,2009-10,23.0,4,4,13,13,2,2,4,8.0,132.0,13,2,2,4,8.0,82,5.76,70,398,2426,9.7
8700,Dustin Boyd,2010-11,24.0,5,12,48,48,7,5,12,46.0,471.0,61,9,7,16,54.0,82,5.44,62,351,2383,9.4
8701,Dustin Boyd,2011-12,25.0,6,22,71,71,11,11,22,74.0,914.0,132,20,18,38,128.0,82,5.7,65,341,2477,9.4
8702,Dustin Boyd,2012-13,26.0,7,24,78,78,11,13,24,112.0,954.0,210,31,31,62,240.0,82,5.53,56,304,2486,9.1
8703,Dustin Boyd,2013-14,27.0,8,1,10,10,1,0,1,8.0,98.0,220,32,31,63,248.0,82,5.46,52,291,2492,9.0
8704,Dustin Brown,2006-07,22.0,4,5,31,31,1,4,5,40.0,325.0,31,1,4,5,40.0,82,5.14,57,348,2300,9.2
8705,Dustin Brown,2008-09,24.0,5,28,79,79,14,14,28,159.0,1104.0,110,15,18,33,199.0,82,6.05,85,480,2458,10.1
8706,Dustin Brown,2009-10,25.0,6,46,81,81,17,29,46,195.0,1516.0,191,32,47,79,394.0,82,5.76,70,398,2426,9.7
8707,Dustin Brown,2010-11,26.0,7,60,78,78,33,27,60,219.0,1583.0,269,65,74,139,613.0,82,5.44,62,351,2383,9.4
8708,Dustin Brown,2011-12,27.0,8,53,80,80,24,29,53,292.0,1552.0,349,89,103,192,905.0,82,5.7,65,341,2477,9.4
8709,Dustin Brown,2012-13,28.0,9,56,82,82,24,32,56,248.0,1579.0,431,113,135,248,1153.0,82,5.53,56,304,2486,9.1
8710,Dustin Brown,2013-14,29.0,10,57,82,82,28,29,57,228.0,1588.0,513,141,164,305,1381.0,82,5.46,52,291,2492,9.0
8711,Dustin Brown,2014-15,30.0,11,54,82,82,22,32,54,214.0,1654.0,595,163,196,359,1595.0,82,5.32,47,271,2439,8.9
8712,Dustin Brown,2015-16,31.0,12,29,46,46,18,11,29,142.0,897.0,641,181,207,388,1737.0,48,5.31,29,160,1399,9.1
8713,Dustin Brown,2016-17,32.0,13,27,79,79,15,12,27,195.0,1251.0,720,196,219,415,1932.0,82,5.34,48,269,2463,8.9
8714,Dustin Brown,2017-18,33.0,14,27,82,82,11,16,27,189.0,1354.0,802,207,235,442,2121.0,82,5.32,47,251,2453,8.9
8715,Dustin Brown,2018-19,34.0,15,28,82,82,11,17,28,218.0,1326.0,884,218,252,470,2339.0,82,5.34,48,255,2438,9.0
8716,Dustin Brown,2019-20,35.0,16,36,80,80,14,22,36,175.0,1280.0,964,232,274,506,2514.0,82,5.45,47,245,2478,9.0
8717,Dustin Brown,2020-21,36.0,17,61,81,81,28,33,61,222.0,1607.0,1045,260,307,567,2736.0,82,5.86,50,250,2620,9.2
8718,Dustin Brown,2021-22,37.0,18,51,72,72,22,29,51,180.0,1469.0,1117,282,336,618,2916.0,82,5.96,47,239,2579,9.5
8719,Dustin Brown,2022-23,38.0,19,35,66,66,17,18,35,169.0,1215.0,1183,299,354,653,3085.0,70,5.96,42,208,2192,9.5
8720,Dustin Byfuglien,2008-09,23.0,4,5,25,25,3,2,5,45.0,433.0,25,3,2,5,45.0,82,6.05,85,480,2458,10.1
8721,Dustin Byfuglien,2009-10,24.0,5,3,9,9,1,2,3,18.0,156.0,34,4,4,8,63.0,82,5.76,70,398,2426,9.7
8722,Dustin Byfuglien,2010-11,25.0,6,36,67,67,19,17,36,163.0,1141.0,101,23,21,44,226.0,82,5.44,62,351,2383,9.4
8723,Dustin Byfuglien,2011-12,26.0,7,31,77,77,15,16,31,202.0,1145.0,178,38,37,75,428.0,82,5.7,65,341,2477,9.4
8724,Dustin Byfuglien,2012-13,27.0,8,34,82,82,17,17,34,211.0,1346.0,260,55,54,109,639.0,82,5.53,56,304,2486,9.1
8725,Dustin Byfuglien,2013-14,28.0,9,53,81,81,20,33,53,347.0,1888.0,341,75,87,162,986.0,82,5.46,52,291,2492,9.0
8726,Dustin Byfuglien,2014-15,29.0,10,53,66,66,12,41,53,223.0,1592.0,407,87,128,215,1209.0,82,5.32,47,271,2439,8.9
8727,Dustin Byfuglien,2015-16,30.0,11,28,43,43,8,20,28,142.0,1049.0,450,95,148,243,1351.0,48,5.31,29,160,1399,9.1
8728,Dustin Byfuglien,2016-17,31.0,12,56,78,78,20,36,56,256.0,1801.0,528,115,184,299,1607.0,82,5.34,48,269,2463,8.9
8729,Dustin Byfuglien,2017-18,32.0,13,45,69,69,18,27,45,209.0,1565.0,597,133,211,344,1816.0,82,5.32,47,251,2453,8.9
8730,Dustin Byfuglien,2018-19,33.0,14,53,81,81,19,34,53,247.0,2041.0,678,152,245,397,2063.0,82,5.34,48,255,2438,9.0
8731,Dustin Byfuglien,2019-20,34.0,15,52,80,80,13,39,52,241.0,2196.0,758,165,284,449,2304.0,82,5.45,47,245,2478,9.0
8732,Dustin Byfuglien,2020-21,35.0,16,45,69,69,8,37,45,193.0,1679.0,827,173,321,494,2497.0,82,5.86,50,250,2620,9.2
8733,Dustin Byfuglien,2021-22,36.0,17,31,42,42,4,27,31,115.0,1023.0,869,177,348,525,2612.0,82,5.96,47,239,2579,9.5
8734,Dustin Jeffrey,2011-12,23.0,4,3,14,14,1,2,3,18.0,151.0,14,1,2,3,18.0,82,5.7,65,341,2477,9.4
8735,Dustin Jeffrey,2012-13,24.0,5,0,1,1,0,0,0,0.0,9.0,15,1,2,3,18.0,82,5.53,56,304,2486,9.1
8736,Dustin Jeffrey,2013-14,25.0,6,12,25,25,7,5,12,39.0,324.0,40,8,7,15,57.0,82,5.46,52,291,2492,9.0
8737,Dustin Jeffrey,2014-15,26.0,7,6,26,26,4,2,6,33.0,315.0,66,12,9,21,90.0,82,5.32,47,271,2439,8.9
8738,Dustin Jeffrey,2015-16,27.0,8,6,24,24,3,3,6,26.0,276.0,90,15,12,27,116.0,48,5.31,29,160,1399,9.1
8739,Dustin Jeffrey,2016-17,28.0,9,4,34,34,2,2,4,30.0,325.0,124,17,14,31,146.0,82,5.34,48,269,2463,8.9
8740,Dustin Jeffrey,2018-19,30.0,10,2,7,7,1,1,2,5.0,80.0,131,18,15,33,151.0,82,5.34,48,255,2438,9.0
8741,Dustin Kohn,2012-13,25.0,4,4,22,22,0,4,4,7.0,255.0,22,0,4,4,7.0,82,5.53,56,304,2486,9.1
8742,Dustin Penner,2008-09,26.0,4,7,19,19,4,3,7,46.0,227.0,19,4,3,7,46.0,82,6.05,85,480,2458,10.1
8743,Dustin Penner,2009-10,27.0,5,45,82,82,29,16,45,204.0,1147.0,101,33,19,52,250.0,82,5.76,70,398,2426,9.7
8744,Dustin Penner,2010-11,28.0,6,47,82,82,23,24,47,201.0,1411.0,183,56,43,99,451.0,82,5.44,62,351,2383,9.4
8745,Dustin Penner,2011-12,29.0,7,37,78,78,17,20,37,137.0,1200.0,261,73,63,136,588.0,82,5.7,65,341,2477,9.4
8746,Dustin Penner,2012-13,30.0,8,63,82,82,32,31,63,203.0,1507.0,343,105,94,199,791.0,82,5.53,56,304,2486,9.1
8747,Dustin Penner,2013-14,31.0,9,45,81,81,23,22,45,173.0,1468.0,424,128,116,244,964.0,82,5.46,52,291,2492,9.0
8748,Dustin Penner,2014-15,32.0,10,17,65,65,7,10,17,119.0,931.0,489,135,126,261,1083.0,82,5.32,47,271,2439,8.9
8749,Dustin Penner,2015-16,33.0,11,14,33,33,2,12,14,61.0,419.0,522,137,138,275,1144.0,48,5.31,29,160,1399,9.1
8750,Dustin Penner,2016-17,34.0,12,35,67,67,14,21,35,119.0,969.0,589,151,159,310,1263.0,82,5.34,48,269,2463,8.9
8751,Duvie Westcott,2004-05,27.0,4,0,4,4,0,0,0,3.0,61.0,4,0,0,0,3.0,82,5.24,53,338,2262,9.5
8752,Duvie Westcott,2005-06,28.0,5,7,39,39,0,7,7,27.0,728.0,43,0,7,7,30.0,82,5.31,60,363,2326,9.4
8753,Duvie Westcott,2006-07,29.0,6,7,34,34,0,7,7,43.0,720.0,77,0,14,14,73.0,82,5.14,57,348,2300,9.2
8754,Duvie Westcott,2008-09,31.0,7,28,78,78,6,22,28,113.0,1761.0,155,6,36,42,186.0,82,6.05,85,480,2458,10.1
8755,Duvie Westcott,2009-10,32.0,8,10,23,23,4,6,10,34.0,509.0,178,10,42,52,220.0,82,5.76,70,398,2426,9.7
8756,Duvie Westcott,2010-11,33.0,9,4,23,23,1,3,4,27.0,378.0,201,11,45,56,247.0,82,5.44,62,351,2383,9.4
8757,Dwayne Hay,2000-01,23.0,4,0,2,2,0,0,0,1.0,,2,0,0,0,1.0,82,5.28,57,380,2242,9.6
8758,Dwayne Hay,2001-02,24.0,5,0,9,9,0,0,0,3.0,59.0,11,0,0,0,4.0,82,5.27,57,359,2285,9.4
8759,Dwayne Hay,2002-03,25.0,6,2,19,19,1,1,2,14.0,118.0,30,1,1,2,18.0,82,5.49,53,331,2294,9.8
8760,Dwayne Hay,2003-04,26.0,7,4,49,49,1,3,4,39.0,412.0,79,2,4,6,57.0,82,5.51,63,376,2272,9.9
8761,Dwayne Lowdermilk,1983-84,26.0,4,1,2,2,0,1,1,2.0,,2,0,1,1,2.0,80,7.69,77,340,2441,12.6
8762,Dwayne Norris,1996-97,27.0,4,2,4,4,1,1,2,7.0,,4,1,1,2,7.0,84,6.48,76,407,2545,10.7
8763,Dwayne Norris,1997-98,28.0,5,3,13,13,1,2,3,7.0,,17,2,3,5,14.0,48,5.97,37,209,1408,10.2
8764,Dwayne Norris,1998-99,29.0,6,1,3,3,0,1,1,3.0,,20,2,4,6,17.0,82,6.29,74,413,2481,10.4
8765,Dwayne Zinger,2006-07,30.0,4,1,7,7,0,1,1,0.0,38.0,7,0,1,1,0.0,82,5.14,57,348,2300,9.2
8766,Dwight Helminen,2011-12,28.0,4,2,23,23,1,1,2,15.0,157.0,23,1,1,2,15.0,82,5.7,65,341,2477,9.4
8767,Dwight Helminen,2012-13,29.0,5,1,4,4,1,0,1,1.0,44.0,27,2,1,3,16.0,82,5.53,56,304,2486,9.1
8768,Dwight King,2013-14,24.0,4,0,6,6,0,0,0,3.0,70.0,6,0,0,0,3.0,82,5.46,52,291,2492,9.0
8769,Dwight King,2014-15,25.0,5,14,27,27,5,9,14,42.0,395.0,33,5,9,14,45.0,82,5.32,47,271,2439,8.9
8770,Dwight King,2015-16,26.0,6,10,47,47,4,6,10,60.0,600.0,80,9,15,24,105.0,48,5.31,29,160,1399,9.1
8771,Dwight King,2016-17,27.0,7,30,77,77,15,15,30,111.0,1158.0,157,24,30,54,216.0,82,5.34,48,269,2463,8.9
8772,Dwight King,2017-18,28.0,8,26,81,81,13,13,26,127.0,1166.0,238,37,43,80,343.0,82,5.32,47,251,2453,8.9
8773,Dwight King,2018-19,29.0,9,13,47,47,7,6,13,48.0,679.0,285,44,49,93,391.0,82,5.34,48,255,2438,9.0
8774,Dwight King,2019-20,30.0,10,16,80,80,9,7,16,110.0,1153.0,365,53,56,109,501.0,82,5.45,47,245,2478,9.0
8775,Dwight Mathiasen,1988-89,25.0,4,1,4,4,1,0,1,4.0,,4,1,0,1,4.0,80,7.94,82,370,2484,12.8
8776,Dwight Mathiasen,1989-90,26.0,5,1,6,6,0,1,1,4.0,,10,1,1,2,8.0,80,7.34,72,344,2400,12.2
8777,Dwight Mathiasen,1990-91,27.0,6,6,23,23,0,6,6,29.0,,33,1,7,8,37.0,80,7.43,89,437,2435,12.2
8778,Dylan DeMelo,2018-19,25.0,4,4,45,45,2,2,4,42.0,613.0,45,2,2,4,42.0,82,5.34,48,255,2438,9.0
8779,Dylan DeMelo,2019-20,26.0,5,8,25,25,1,7,8,32.0,397.0,70,3,9,12,74.0,82,5.45,47,245,2478,9.0
8780,Dylan DeMelo,2020-21,27.0,6,20,63,63,0,20,20,67.0,895.0,133,3,29,32,141.0,82,5.86,50,250,2620,9.2
8781,Dylan DeMelo,2021-22,28.0,7,22,77,77,4,18,22,109.0,1485.0,210,7,47,54,250.0,82,5.96,47,239,2579,9.5
8782,Dylan DeMelo,2022-23,29.0,8,10,59,59,0,10,10,74.0,1188.0,269,7,57,64,324.0,70,5.96,42,208,2192,9.5
8783,Dylan Gambrell,2020-21,24.0,4,0,3,3,0,0,0,1.0,32.0,3,0,0,0,1.0,82,5.86,50,250,2620,9.2
8784,Dylan Gambrell,2021-22,25.0,5,0,8,8,0,0,0,6.0,69.0,11,0,0,0,7.0,82,5.96,47,239,2579,9.5
8785,Dylan Gambrell,2022-23,26.0,6,11,50,50,5,6,11,43.0,598.0,61,5,6,11,50.0,70,5.96,42,208,2192,9.5
8786,Dylan Larkin,2018-19,22.0,4,45,80,80,23,22,45,221.0,1324.0,80,23,22,45,221.0,82,5.34,48,255,2438,9.0
8787,Dylan Larkin,2019-20,23.0,5,32,80,80,17,15,32,178.0,1292.0,160,40,37,77,399.0,82,5.45,47,245,2478,9.0
8788,Dylan Larkin,2020-21,24.0,6,63,82,82,16,47,63,232.0,1627.0,242,56,84,140,631.0,82,5.86,50,250,2620,9.2
8789,Dylan Larkin,2021-22,25.0,7,73,76,76,32,41,73,287.0,1660.0,318,88,125,213,918.0,82,5.96,47,239,2579,9.5
8790,Dylan Larkin,2022-23,26.0,8,53,71,71,19,34,53,223.0,1509.0,389,107,159,266,1141.0,70,5.96,42,208,2192,9.5
8791,Dylan McIlrath,2016-17,24.0,4,0,2,2,0,0,0,0.0,14.0,2,0,0,0,0.0,82,5.34,48,269,2463,8.9
8792,Dylan McIlrath,2017-18,25.0,5,0,1,1,0,0,0,0.0,8.0,3,0,0,0,0.0,82,5.32,47,251,2453,8.9
8793,Dylan McIlrath,2018-19,26.0,6,4,34,34,2,2,4,28.0,480.0,37,2,2,4,28.0,82,5.34,48,255,2438,9.0
8794,Dylan McIlrath,2019-20,27.0,7,1,6,6,1,0,1,3.0,57.0,43,3,2,5,31.0,82,5.45,47,245,2478,9.0
8795,Dylan McIlrath,2021-22,29.0,8,0,7,7,0,0,0,6.0,106.0,50,3,2,5,37.0,82,5.96,47,239,2579,9.5
8796,Dylan McIlrath,2022-23,30.0,9,0,16,16,0,0,0,14.0,237.0,66,3,2,5,51.0,70,5.96,42,208,2192,9.5
8797,Dylan Olsen,2014-15,24.0,4,1,28,28,0,1,1,16.0,365.0,28,0,1,1,16.0,82,5.32,47,271,2439,8.9
8798,Dylan Olsen,2016-17,26.0,5,12,44,44,3,9,12,60.0,679.0,72,3,10,13,76.0,82,5.34,48,269,2463,8.9
8799,Dylan Olsen,2017-18,27.0,6,8,44,44,2,6,8,44.0,700.0,116,5,16,21,120.0,82,5.32,47,251,2453,8.9
8800,Dylan Olsen,2018-19,28.0,7,1,8,8,0,1,1,9.0,110.0,124,5,17,22,129.0,82,5.34,48,255,2438,9.0
8801,Dylan Reese,2012-13,28.0,4,4,19,19,2,2,4,16.0,286.0,19,2,2,4,16.0,82,5.53,56,304,2486,9.1
8802,Dylan Reese,2013-14,29.0,5,6,27,27,0,6,6,23.0,400.0,46,2,8,10,39.0,82,5.46,52,291,2492,9.0
8803,Dylan Reese,2014-15,30.0,6,7,28,28,1,6,7,26.0,478.0,74,3,14,17,65.0,82,5.32,47,271,2439,8.9
8804,Dylan Reese,2015-16,31.0,7,0,3,3,0,0,0,1.0,46.0,77,3,14,17,66.0,48,5.31,29,160,1399,9.1
8805,Dylan Reese,2017-18,33.0,8,0,1,1,0,0,0,3.0,20.0,78,3,14,17,69.0,82,5.32,47,251,2453,8.9
8806,Dylan Sikura,2020-21,25.0,4,3,5,5,0,3,3,9.0,67.0,5,0,3,3,9.0,82,5.86,50,250,2620,9.2
8807,Dylan Sikura,2021-22,26.0,5,8,33,33,0,8,8,52.0,372.0,38,0,11,11,61.0,82,5.96,47,239,2579,9.5
8808,Dylan Sikura,2022-23,27.0,6,3,9,9,1,2,3,10.0,89.0,47,1,13,14,71.0,70,5.96,42,208,2192,9.5
8809,Dylan Strome,2019-20,22.0,4,1,7,7,0,1,1,6.0,96.0,7,0,1,1,6.0,82,5.45,47,245,2478,9.0
8810,Dylan Strome,2020-21,23.0,5,9,21,21,4,5,9,30.0,272.0,28,4,6,10,36.0,82,5.86,50,250,2620,9.2
8811,Dylan Strome,2021-22,24.0,6,57,78,78,20,37,57,145.0,1260.0,106,24,43,67,181.0,82,5.96,47,239,2579,9.5
8812,Dylan Strome,2022-23,25.0,7,38,58,58,12,26,38,97.0,925.0,164,36,69,105,278.0,70,5.96,42,208,2192,9.5
8813,Earl Ingarfield,1982-83,24.0,4,0,1,1,0,0,0,7.0,,1,0,0,0,7.0,80,7.03,61,280,2352,12.0
8814,Earl Ingarfield,1983-84,25.0,5,8,38,38,4,4,8,37.0,,39,4,4,8,44.0,80,7.69,77,340,2441,12.6
8815,Ed Cooper,1983-84,23.0,4,14,47,47,7,7,14,52.0,,47,7,7,14,52.0,80,7.69,77,340,2441,12.6
8816,Ed Cooper,1984-85,24.0,5,1,2,2,1,0,1,1.0,,49,8,7,15,53.0,80,8.03,73,320,2489,12.9
8817,Ed Courtenay,1994-95,26.0,4,0,5,5,0,0,0,7.0,,5,0,0,0,7.0,80,6.96,77,402,2440,11.4
8818,Ed Courtenay,1995-96,27.0,5,20,39,39,7,13,20,56.0,,44,7,13,20,63.0,84,7.25,87,443,2603,11.7
8819,Ed Cristofoli,1992-93,25.0,4,1,9,9,0,1,1,6.0,,9,0,1,1,6.0,80,7.37,76,367,2421,12.2
8820,Ed Hospodar,1982-83,23.0,4,1,20,20,0,1,1,9.0,,20,0,1,1,9.0,80,7.03,61,280,2352,12.0
8821,Ed Hospodar,1983-84,24.0,5,19,61,61,5,14,19,49.0,,81,5,15,20,58.0,80,7.69,77,340,2441,12.6
8822,Ed Hospodar,1984-85,25.0,6,11,41,41,3,8,11,29.0,,122,8,23,31,87.0,80,8.03,73,320,2489,12.9
8823,Ed Hospodar,1985-86,26.0,7,10,72,72,1,9,10,55.0,,194,9,32,41,142.0,80,7.73,71,310,2444,12.7
8824,Ed Hospodar,1986-87,27.0,8,9,59,59,0,9,9,56.0,,253,9,41,50,198.0,80,7.89,74,336,2448,12.9
8825,Ed Hospodar,1987-88,28.0,9,7,50,50,3,4,7,50.0,,303,12,45,57,248.0,80,7.77,71,321,2447,12.7
8826,Ed Hospodar,1988-89,29.0,10,6,60,60,3,3,6,44.0,,363,15,48,63,292.0,80,7.94,82,370,2484,12.8
8827,Ed Hospodar,1989-90,30.0,11,4,45,45,2,2,4,17.0,,408,17,50,67,309.0,80,7.34,72,344,2400,12.2
8828,Ed Hospodar,1990-91,31.0,12,1,42,42,0,1,1,15.0,,450,17,51,68,324.0,80,7.43,89,437,2435,12.2
8829,Ed Jovanovski,1998-99,22.0,4,21,70,70,10,11,21,116.0,,70,10,11,21,116.0,82,6.29,74,413,2481,10.4
8830,Ed Jovanovski,1999-00,23.0,5,23,61,61,7,16,23,80.0,,131,17,27,44,196.0,82,5.83,55,336,2444,9.8
8831,Ed Jovanovski,2000-01,24.0,6,23,81,81,9,14,23,142.0,,212,26,41,67,338.0,82,5.28,57,380,2242,9.6
8832,Ed Jovanovski,2001-02,25.0,7,27,72,72,5,22,27,109.0,1585.0,284,31,63,94,447.0,82,5.27,57,359,2285,9.4
8833,Ed Jovanovski,2002-03,26.0,8,26,75,75,5,21,26,109.0,1803.0,359,36,84,120,556.0,82,5.49,53,331,2294,9.8
8834,Ed Jovanovski,2003-04,27.0,9,47,79,79,12,35,47,193.0,1971.0,438,48,119,167,749.0,82,5.51,63,376,2272,9.9
8835,Ed Jovanovski,2004-05,28.0,10,48,82,82,17,31,48,202.0,2065.0,520,65,150,215,951.0,82,5.24,53,338,2262,9.5
8836,Ed Jovanovski,2005-06,29.0,11,46,67,67,6,40,46,145.0,1625.0,587,71,190,261,1096.0,82,5.31,60,363,2326,9.4
8837,Ed Jovanovski,2006-07,30.0,12,23,56,56,7,16,23,143.0,1299.0,643,78,206,284,1239.0,82,5.14,57,348,2300,9.2
8838,Ed Jovanovski,2008-09,32.0,13,33,44,44,8,25,33,87.0,1075.0,687,86,231,317,1326.0,82,6.05,85,480,2458,10.1
8839,Ed Jovanovski,2009-10,33.0,14,29,54,54,11,18,29,135.0,1250.0,741,97,249,346,1461.0,82,5.76,70,398,2426,9.7
8840,Ed Jovanovski,2010-11,34.0,15,51,80,80,12,39,51,240.0,1804.0,821,109,288,397,1701.0,82,5.44,62,351,2383,9.4
8841,Ed Jovanovski,2011-12,35.0,16,36,82,82,9,27,36,194.0,1817.0,903,118,315,433,1895.0,82,5.7,65,341,2477,9.4
8842,Ed Jovanovski,2012-13,36.0,17,34,66,66,10,24,34,117.0,1428.0,969,128,339,467,2012.0,82,5.53,56,304,2486,9.1
8843,Ed Jovanovski,2013-14,37.0,18,14,50,50,5,9,14,73.0,1024.0,1019,133,348,481,2085.0,82,5.46,52,291,2492,9.0
8844,Ed Jovanovski,2014-15,38.0,19,13,66,66,3,10,13,58.0,1102.0,1085,136,358,494,2143.0,82,5.32,47,271,2439,8.9
8845,Ed Jovanovski,2015-16,39.0,20,1,6,6,0,1,1,6.0,94.0,1091,136,359,495,2149.0,48,5.31,29,160,1399,9.1
8846,Ed Jovanovski,2016-17,40.0,21,5,37,37,1,4,5,44.0,598.0,1128,137,363,500,2193.0,82,5.34,48,269,2463,8.9
8847,Ed Kastelic,1988-89,25.0,4,0,15,15,0,0,0,2.0,,15,0,0,0,2.0,80,7.94,82,370,2484,12.8
8848,Ed Kastelic,1989-90,26.0,5,2,23,23,1,1,2,15.0,,38,1,1,2,17.0,80,7.34,72,344,2400,12.2
8849,Ed Kastelic,1990-91,27.0,6,1,35,35,1,0,1,20.0,,73,2,1,3,37.0,80,7.43,89,437,2435,12.2
8850,Ed Kastelic,1991-92,28.0,7,2,10,10,0,2,2,6.0,,83,2,3,5,43.0,80,7.48,85,403,2430,12.3
8851,Ed Kastelic,1992-93,29.0,8,8,67,67,6,2,8,35.0,,150,8,5,13,78.0,80,7.37,76,367,2421,12.2
8852,Ed Kastelic,1993-94,30.0,9,4,45,45,2,2,4,15.0,,195,10,7,17,93.0,80,6.91,71,366,2385,11.6
8853,Ed Kastelic,1994-95,31.0,10,4,25,25,1,3,4,4.0,,220,11,10,21,97.0,80,6.96,77,402,2440,11.4
8854,Ed Olczyk,1987-88,21.0,4,50,70,70,20,30,50,134.0,,70,20,30,50,134.0,80,7.77,71,321,2447,12.7
8855,Ed Olczyk,1988-89,22.0,5,79,79,79,29,50,79,218.0,,149,49,80,129,352.0,80,7.94,82,370,2484,12.8
8856,Ed Olczyk,1989-90,23.0,6,51,79,79,16,35,51,181.0,,228,65,115,180,533.0,80,7.34,72,344,2400,12.2
8857,Ed Olczyk,1990-91,24.0,7,75,80,80,42,33,75,243.0,,308,107,148,255,776.0,80,7.43,89,437,2435,12.2
8858,Ed Olczyk,1991-92,25.0,8,90,80,80,38,52,90,249.0,,388,145,200,345,1025.0,80,7.48,85,403,2430,12.3
8859,Ed Olczyk,1992-93,26.0,9,88,79,79,32,56,88,208.0,,467,177,256,433,1233.0,80,7.37,76,367,2421,12.2
8860,Ed Olczyk,1993-94,27.0,10,71,79,79,30,41,71,226.0,,546,207,297,504,1459.0,80,6.91,71,366,2385,11.6
8861,Ed Olczyk,1994-95,28.0,11,65,64,64,32,33,65,245.0,,610,239,330,569,1704.0,80,6.96,77,402,2440,11.4
8862,Ed Olczyk,1995-96,29.0,12,49,71,71,21,28,49,190.0,,681,260,358,618,1894.0,84,7.25,87,443,2603,11.7
8863,Ed Olczyk,1996-97,30.0,13,8,37,37,3,5,8,40.0,,718,263,363,626,1934.0,84,6.48,76,407,2545,10.7
8864,Ed Olczyk,1997-98,31.0,14,13,33,33,4,9,13,56.0,,751,267,372,639,1990.0,48,5.97,37,209,1408,10.2
8865,Ed Olczyk,1998-99,32.0,15,49,51,51,27,22,49,147.0,,802,294,394,688,2137.0,82,6.29,74,413,2481,10.4
8866,Ed Olczyk,1999-00,33.0,16,55,79,79,25,30,55,195.0,,881,319,424,743,2332.0,82,5.83,55,336,2444,9.8
8867,Ed Olczyk,2000-01,34.0,17,22,56,56,11,11,22,123.0,,937,330,435,765,2455.0,82,5.28,57,380,2242,9.6
8868,Ed Olczyk,2001-02,35.0,18,25,61,61,10,15,25,88.0,899.0,998,340,450,790,2543.0,82,5.27,57,359,2285,9.4
8869,Ed Olczyk,2002-03,36.0,19,4,33,33,2,2,4,33.0,307.0,1031,342,452,794,2576.0,82,5.49,53,331,2294,9.8
8870,Ed Patterson,1996-97,24.0,4,4,27,27,3,1,4,15.0,,27,3,1,4,15.0,84,6.48,76,407,2545,10.7
8871,Ed Patterson,1998-99,26.0,5,2,35,35,0,2,2,17.0,,62,3,3,6,32.0,82,6.29,74,413,2481,10.4
8872,Ed Patterson,1999-00,27.0,6,0,6,6,0,0,0,2.0,,68,3,3,6,34.0,82,5.83,55,336,2444,9.8
8873,Ed Ronan,1994-95,26.0,4,0,3,3,0,0,0,1.0,,3,0,0,0,1.0,80,6.96,77,402,2440,11.4
8874,Ed Ronan,1995-96,27.0,5,12,53,53,5,7,12,54.0,,56,5,7,12,55.0,84,7.25,87,443,2603,11.7
8875,Ed Ronan,1996-97,28.0,6,14,61,61,6,8,14,49.0,,117,11,15,26,104.0,84,6.48,76,407,2545,10.7
8876,Ed Ronan,1997-98,29.0,7,5,30,30,1,4,5,14.0,,147,12,19,31,118.0,48,5.97,37,209,1408,10.2
8877,Ed Ronan,1998-99,30.0,8,0,17,17,0,0,0,13.0,,164,12,19,31,131.0,82,6.29,74,413,2481,10.4
8878,Ed Ronan,1999-00,31.0,9,5,18,18,1,4,5,10.0,,182,13,23,36,141.0,82,5.83,55,336,2444,9.8
8879,Ed Ward,1996-97,27.0,4,1,7,7,1,0,1,3.0,,7,1,0,1,3.0,84,6.48,76,407,2545,10.7
8880,Ed Ward,1997-98,28.0,5,2,2,2,1,1,2,1.0,,9,2,1,3,4.0,48,5.97,37,209,1408,10.2
8881,Ed Ward,1998-99,29.0,6,8,41,41,3,5,8,33.0,,50,5,6,11,37.0,82,6.29,74,413,2481,10.4
8882,Ed Ward,1999-00,30.0,7,13,40,40,5,8,13,33.0,,90,10,14,24,70.0,82,5.83,55,336,2444,9.8
8883,Ed Ward,2000-01,31.0,8,9,64,64,4,5,9,52.0,,154,14,19,33,122.0,82,5.28,57,380,2242,9.6
8884,Ed Ward,2001-02,32.0,9,8,68,68,3,5,8,56.0,546.0,222,17,24,41,178.0,82,5.27,57,359,2285,9.4
8885,Ed Ward,2002-03,33.0,10,7,52,52,6,1,7,56.0,559.0,274,23,25,48,234.0,82,5.49,53,331,2294,9.8
8886,Ed Ward,2003-04,34.0,11,1,4,4,0,1,1,4.0,19.0,278,23,26,49,238.0,82,5.51,63,376,2272,9.9
8887,Eddy Beers,1984-85,25.0,4,2,5,5,1,1,2,7.0,,5,1,1,2,7.0,80,8.03,73,320,2489,12.9
8888,Eddy Beers,1985-86,26.0,5,26,41,41,11,15,26,74.0,,46,12,16,28,81.0,80,7.73,71,310,2444,12.7
8889,Eddy Beers,1986-87,27.0,6,75,73,73,36,39,75,189.0,,119,48,55,103,270.0,80,7.89,74,336,2448,12.9
8890,Eddy Beers,1987-88,28.0,7,68,74,74,28,40,68,171.0,,193,76,95,171,441.0,80,7.77,71,321,2447,12.7
8891,Eddy Beers,1988-89,29.0,8,39,57,57,18,21,39,135.0,,250,94,116,210,576.0,80,7.94,82,370,2484,12.8
8892,Edward Lee,1987-88,26.0,4,0,2,2,0,0,0,2.0,,2,0,0,0,2.0,80,7.77,71,321,2447,12.7
8893,Eeli Tolvanen,2020-21,21.0,4,0,3,3,0,0,0,3.0,36.0,3,0,0,0,3.0,82,5.86,50,250,2620,9.2
8894,Eeli Tolvanen,2021-22,22.0,5,2,4,4,1,1,2,2.0,53.0,7,1,1,2,5.0,82,5.96,47,239,2579,9.5
8895,Eetu Luostarinen,2022-23,24.0,4,1,8,8,0,1,1,9.0,80.0,8,0,1,1,9.0,70,5.96,42,208,2192,9.5
8896,Egor Korshkov,2022-23,26.0,4,1,1,1,1,0,1,1.0,10.0,1,1,0,1,1.0,70,5.96,42,208,2192,9.5
8897,Egor Yakovlev,2021-22,30.0,4,7,25,25,2,5,7,24.0,392.0,25,2,5,7,24.0,82,5.96,47,239,2579,9.5
8898,Elias Lindholm,2016-17,22.0,4,21,58,58,9,12,21,70.0,843.0,58,9,12,21,70.0,82,5.34,48,269,2463,8.9
8899,Elias Lindholm,2017-18,23.0,5,39,81,81,17,22,39,170.0,1330.0,139,26,34,60,240.0,82,5.32,47,251,2453,8.9
8900,Elias Lindholm,2018-19,24.0,6,39,82,82,11,28,39,176.0,1485.0,221,37,62,99,416.0,82,5.34,48,255,2438,9.0
8901,Elias Lindholm,2019-20,25.0,7,45,72,72,11,34,45,151.0,1309.0,293,48,96,144,567.0,82,5.45,47,245,2478,9.0
8902,Elias Lindholm,2020-21,26.0,8,44,81,81,16,28,44,153.0,1449.0,374,64,124,188,720.0,82,5.86,50,250,2620,9.2
8903,Elias Lindholm,2021-22,27.0,9,78,81,81,27,51,78,182.0,1623.0,455,91,175,266,902.0,82,5.96,47,239,2579,9.5
8904,Elias Lindholm,2022-23,28.0,10,54,70,70,29,25,54,169.0,1381.0,525,120,200,320,1071.0,70,5.96,42,208,2192,9.5
8905,Elias Pettersson,2021-22,23.0,4,66,71,71,28,38,66,144.0,1294.0,71,28,38,66,144.0,82,5.96,47,239,2579,9.5
8906,Elias Pettersson,2022-23,24.0,5,66,68,68,27,39,66,162.0,1260.0,139,55,77,132,306.0,70,5.96,42,208,2192,9.5
8907,Emanuel Viveiros,1988-89,23.0,4,1,4,4,0,1,1,4.0,,4,0,1,1,4.0,80,7.94,82,370,2484,12.8
8908,Emanuel Viveiros,1989-90,24.0,5,1,1,1,0,1,1,1.0,,5,0,2,2,5.0,80,7.34,72,344,2400,12.2
8909,Emanuel Viveiros,1990-91,25.0,6,10,24,24,1,9,10,35.0,,29,1,11,12,40.0,80,7.43,89,437,2435,12.2
8910,Emerson Etem,2015-16,23.0,4,10,38,38,3,7,10,48.0,436.0,38,3,7,10,48.0,48,5.31,29,160,1399,9.1
8911,Emerson Etem,2016-17,24.0,5,11,29,29,7,4,11,44.0,371.0,67,10,11,21,92.0,82,5.34,48,269,2463,8.9
8912,Emerson Etem,2017-18,25.0,6,10,45,45,5,5,10,77.0,551.0,112,15,16,31,169.0,82,5.32,47,251,2453,8.9
8913,Emerson Etem,2018-19,26.0,7,15,58,58,7,8,15,100.0,763.0,170,22,24,46,269.0,82,5.34,48,255,2438,9.0
8914,Emerson Etem,2019-20,27.0,8,0,3,3,0,0,0,0.0,26.0,173,22,24,46,269.0,82,5.45,47,245,2478,9.0
8915,Emil Bemstrom,2022-23,23.0,4,20,56,56,10,10,20,97.0,687.0,56,10,10,20,97.0,70,5.96,42,208,2192,9.5
8916,Emile Poirier,2017-18,23.0,4,1,6,6,0,1,1,2.0,48.0,6,0,1,1,2.0,82,5.32,47,251,2453,8.9
8917,Emile Poirier,2018-19,24.0,5,0,2,2,0,0,0,3.0,28.0,8,0,1,1,5.0,82,5.34,48,255,2438,9.0
8918,Enrico Ciccone,1994-95,24.0,4,0,11,11,0,0,0,2.0,,11,0,0,0,2.0,80,6.96,77,402,2440,11.4
8919,Enrico Ciccone,1995-96,25.0,5,1,31,31,0,1,1,13.0,,42,0,1,1,15.0,84,7.25,87,443,2603,11.7
8920,Enrico Ciccone,1996-97,26.0,6,3,57,57,1,2,3,33.0,,99,1,3,4,48.0,84,6.48,76,407,2545,10.7
8921,Enrico Ciccone,1997-98,27.0,7,6,41,41,2,4,6,43.0,,140,3,7,10,91.0,48,5.97,37,209,1408,10.2
8922,Enrico Ciccone,1998-99,28.0,8,6,66,66,2,4,6,60.0,,206,5,11,16,151.0,82,6.29,74,413,2481,10.4
8923,Enrico Ciccone,1999-00,29.0,9,4,67,67,2,2,4,65.0,,273,7,13,20,216.0,82,5.83,55,336,2444,9.8
8924,Enrico Ciccone,2000-01,30.0,10,4,39,39,0,4,4,22.0,,312,7,17,24,238.0,82,5.28,57,380,2242,9.6
8925,Enrico Ciccone,2001-02,31.0,11,4,59,59,3,1,4,52.0,659.0,371,10,18,28,290.0,82,5.27,57,359,2285,9.4
8926,Enrico Ciccone,2003-04,33.0,12,0,3,3,0,0,0,0.0,9.0,374,10,18,28,290.0,82,5.51,63,376,2272,9.9
8927,Enver Lisin,2009-10,23.0,4,2,17,17,1,1,2,35.0,256.0,17,1,1,2,35.0,82,5.76,70,398,2426,9.7
8928,Enver Lisin,2010-11,24.0,5,5,13,13,4,1,5,27.0,188.0,30,5,2,7,62.0,82,5.44,62,351,2383,9.4
8929,Enver Lisin,2011-12,25.0,6,21,48,48,13,8,21,105.0,712.0,78,18,10,28,167.0,82,5.7,65,341,2477,9.4
8930,Enver Lisin,2012-13,26.0,7,14,57,57,6,8,14,91.0,637.0,135,24,18,42,258.0,82,5.53,56,304,2486,9.1
8931,Eriah Hayes,2016-17,28.0,4,1,15,15,1,0,1,17.0,118.0,15,1,0,1,17.0,82,5.34,48,269,2463,8.9
8932,Eriah Hayes,2017-18,29.0,5,0,4,4,0,0,0,10.0,40.0,19,1,0,1,27.0,82,5.32,47,251,2453,8.9
8933,Eric Beaudoin,2004-05,24.0,4,4,8,8,1,3,4,11.0,140.0,8,1,3,4,11.0,82,5.24,53,338,2262,9.5
8934,Eric Beaudoin,2005-06,25.0,5,1,15,15,0,1,1,11.0,148.0,23,1,4,5,22.0,82,5.31,60,363,2326,9.4
8935,Eric Beaudoin,2006-07,26.0,6,6,30,30,2,4,6,30.0,309.0,53,3,8,11,52.0,82,5.14,57,348,2300,9.2
8936,Eric Belanger,2003-04,26.0,4,21,62,62,9,12,21,80.0,832.0,62,9,12,21,80.0,82,5.51,63,376,2272,9.9
8937,Eric Belanger,2004-05,27.0,5,24,53,53,8,16,24,67.0,771.0,115,17,28,45,147.0,82,5.24,53,338,2262,9.5
8938,Eric Belanger,2005-06,28.0,6,35,62,62,16,19,35,114.0,1097.0,177,33,47,80,261.0,82,5.31,60,363,2326,9.4
8939,Eric Belanger,2006-07,29.0,7,33,81,81,13,20,33,132.0,1378.0,258,46,67,113,393.0,82,5.14,57,348,2300,9.2
8940,Eric Belanger,2008-09,31.0,8,37,65,65,17,20,37,119.0,1141.0,323,63,87,150,512.0,82,6.05,85,480,2458,10.1
8941,Eric Belanger,2009-10,32.0,9,35,80,80,17,18,35,149.0,1299.0,403,80,105,185,661.0,82,5.76,70,398,2426,9.7
8942,Eric Belanger,2010-11,33.0,10,37,75,75,13,24,37,115.0,1291.0,478,93,129,222,776.0,82,5.44,62,351,2383,9.4
8943,Eric Belanger,2011-12,34.0,11,36,79,79,13,23,36,147.0,1409.0,557,106,152,258,923.0,82,5.7,65,341,2477,9.4
8944,Eric Belanger,2012-13,35.0,12,41,77,77,15,26,41,151.0,1194.0,634,121,178,299,1074.0,82,5.53,56,304,2486,9.1
8945,Eric Belanger,2013-14,36.0,13,40,82,82,13,27,40,127.0,1422.0,716,134,205,339,1201.0,82,5.46,52,291,2492,9.0
8946,Eric Belanger,2014-15,37.0,14,16,78,78,4,12,16,118.0,1149.0,794,138,217,355,1319.0,82,5.32,47,271,2439,8.9
8947,Eric Belanger,2015-16,38.0,15,3,26,26,0,3,3,31.0,367.0,820,138,220,358,1350.0,48,5.31,29,160,1399,9.1
8948,Eric Bertrand,2002-03,27.0,4,0,12,12,0,0,0,12.0,111.0,12,0,0,0,12.0,82,5.49,53,331,2294,9.8
8949,Eric Bertrand,2003-04,28.0,5,0,3,3,0,0,0,0.0,13.0,15,0,0,0,12.0,82,5.51,63,376,2272,9.9
8950,Eric Boguniecki,2002-03,27.0,4,0,4,4,0,0,0,5.0,34.0,4,0,0,0,5.0,82,5.49,53,331,2294,9.8
8951,Eric Boguniecki,2003-04,28.0,5,0,1,1,0,0,0,1.0,14.0,5,0,0,0,6.0,82,5.51,63,376,2272,9.9
8952,Eric Boguniecki,2004-05,29.0,6,1,8,8,0,1,1,10.0,94.0,13,0,1,1,16.0,82,5.24,53,338,2262,9.5
8953,Eric Boguniecki,2005-06,30.0,7,49,80,80,22,27,49,117.0,1121.0,93,22,28,50,133.0,82,5.31,60,363,2326,9.4
8954,Eric Boguniecki,2006-07,31.0,8,10,27,27,6,4,10,40.0,397.0,120,28,32,60,173.0,82,5.14,57,348,2300,9.2
8955,Eric Boguniecki,2008-09,33.0,9,16,47,47,6,10,16,48.0,522.0,167,34,42,76,221.0,82,6.05,85,480,2458,10.1
8956,Eric Boguniecki,2009-10,34.0,10,0,11,11,0,0,0,2.0,54.0,178,34,42,76,223.0,82,5.76,70,398,2426,9.7
8957,Eric Boulton,2003-04,27.0,4,3,35,35,1,2,3,20.0,199.0,35,1,2,3,20.0,82,5.51,63,376,2272,9.9
8958,Eric Boulton,2004-05,28.0,5,5,35,35,2,3,5,21.0,215.0,70,3,5,8,41.0,82,5.24,53,338,2262,9.5
8959,Eric Boulton,2005-06,29.0,6,6,58,58,1,5,6,33.0,382.0,128,4,10,14,74.0,82,5.31,60,363,2326,9.4
8960,Eric Boulton,2006-07,30.0,7,3,44,44,1,2,3,20.0,214.0,172,5,12,17,94.0,82,5.14,57,348,2300,9.2
8961,Eric Boulton,2008-09,32.0,8,9,51,51,4,5,9,28.0,250.0,223,9,17,26,122.0,82,6.05,85,480,2458,10.1
8962,Eric Boulton,2009-10,33.0,9,7,45,45,3,4,7,42.0,282.0,268,12,21,33,164.0,82,5.76,70,398,2426,9.7
8963,Eric Boulton,2010-11,34.0,10,9,74,74,4,5,9,64.0,551.0,342,16,26,42,228.0,82,5.44,62,351,2383,9.4
8964,Eric Boulton,2011-12,35.0,11,13,76,76,3,10,13,71.0,574.0,418,19,36,55,299.0,82,5.7,65,341,2477,9.4
8965,Eric Boulton,2012-13,36.0,12,8,62,62,2,6,8,39.0,425.0,480,21,42,63,338.0,82,5.53,56,304,2486,9.1
8966,Eric Boulton,2013-14,37.0,13,10,69,69,6,4,10,51.0,618.0,549,27,46,73,389.0,82,5.46,52,291,2492,9.0
8967,Eric Boulton,2014-15,38.0,14,0,51,51,0,0,0,25.0,336.0,600,27,46,73,414.0,82,5.32,47,271,2439,8.9
8968,Eric Boulton,2015-16,39.0,15,0,15,15,0,0,0,5.0,85.0,615,27,46,73,419.0,48,5.31,29,160,1399,9.1
8969,Eric Boulton,2016-17,40.0,16,4,23,23,2,2,4,21.0,147.0,638,29,48,77,440.0,82,5.34,48,269,2463,8.9
8970,Eric Boulton,2017-18,41.0,17,2,10,10,2,0,2,9.0,72.0,648,31,48,79,449.0,82,5.32,47,251,2453,8.9
8971,Eric Boulton,2018-19,42.0,18,0,6,6,0,0,0,3.0,57.0,654,31,48,79,452.0,82,5.34,48,255,2438,9.0
8972,Eric Brewer,2001-02,22.0,4,11,63,63,5,6,11,63.0,974.0,63,5,6,11,63.0,82,5.27,57,359,2285,9.4
8973,Eric Brewer,2002-03,23.0,5,2,26,26,0,2,2,30.0,482.0,89,5,8,13,93.0,82,5.49,53,331,2294,9.8
8974,Eric Brewer,2003-04,24.0,6,21,77,77,7,14,21,91.0,1425.0,166,12,22,34,184.0,82,5.51,63,376,2272,9.9
8975,Eric Brewer,2004-05,25.0,7,25,81,81,7,18,25,165.0,1938.0,247,19,40,59,349.0,82,5.24,53,338,2262,9.5
8976,Eric Brewer,2005-06,26.0,8,29,80,80,8,21,29,147.0,1994.0,327,27,61,88,496.0,82,5.31,60,363,2326,9.4
8977,Eric Brewer,2006-07,27.0,9,25,77,77,7,18,25,135.0,1899.0,404,34,79,113,631.0,82,5.14,57,348,2300,9.2
8978,Eric Brewer,2008-09,29.0,10,9,32,32,6,3,9,64.0,751.0,436,40,82,122,695.0,82,6.05,85,480,2458,10.1
8979,Eric Brewer,2009-10,30.0,11,29,82,82,6,23,29,111.0,2011.0,518,46,105,151,806.0,82,5.76,70,398,2426,9.7
8980,Eric Brewer,2010-11,31.0,12,22,77,77,1,21,22,101.0,1896.0,595,47,126,173,907.0,82,5.44,62,351,2383,9.4
8981,Eric Brewer,2011-12,32.0,13,6,28,28,1,5,6,49.0,703.0,623,48,131,179,956.0,82,5.7,65,341,2477,9.4
8982,Eric Brewer,2012-13,33.0,14,15,59,59,8,7,15,84.0,1265.0,682,56,138,194,1040.0,82,5.53,56,304,2486,9.1
8983,Eric Brewer,2013-14,34.0,15,16,76,76,9,7,16,110.0,1675.0,758,65,145,210,1150.0,82,5.46,52,291,2492,9.0
8984,Eric Brewer,2014-15,35.0,16,21,82,82,1,20,21,83.0,1908.0,840,66,165,231,1233.0,82,5.32,47,271,2439,8.9
8985,Eric Brewer,2015-16,36.0,17,12,48,48,4,8,12,56.0,985.0,888,70,173,243,1289.0,48,5.31,29,160,1399,9.1
8986,Eric Brewer,2016-17,37.0,18,17,77,77,4,13,17,83.0,1352.0,965,74,186,260,1372.0,82,5.34,48,269,2463,8.9
8987,Eric Brewer,2017-18,38.0,19,11,44,44,3,8,11,33.0,822.0,1009,77,194,271,1405.0,82,5.32,47,251,2453,8.9
8988,Eric Cairns,1999-00,25.0,4,1,40,40,0,1,1,17.0,,40,0,1,1,17.0,82,5.83,55,336,2444,9.8
8989,Eric Cairns,2000-01,26.0,5,3,39,39,0,3,3,17.0,,79,0,4,4,34.0,82,5.28,57,380,2242,9.6
8990,Eric Cairns,2001-02,27.0,6,3,9,9,0,3,3,2.0,92.0,88,0,7,7,36.0,82,5.27,57,359,2285,9.4
8991,Eric Cairns,2002-03,28.0,7,9,67,67,2,7,9,55.0,1187.0,155,2,14,16,91.0,82,5.49,53,331,2294,9.8
8992,Eric Cairns,2003-04,29.0,8,4,45,45,2,2,4,21.0,738.0,200,4,16,20,112.0,82,5.51,63,376,2272,9.9
8993,Eric Cairns,2004-05,30.0,9,7,74,74,2,5,7,34.0,825.0,274,6,21,27,146.0,82,5.24,53,338,2262,9.5
8994,Eric Cairns,2005-06,31.0,10,5,60,60,1,4,5,31.0,710.0,334,7,25,32,177.0,82,5.31,60,363,2326,9.4
8995,Eric Cairns,2006-07,32.0,11,8,72,72,2,6,8,24.0,845.0,406,9,31,40,201.0,82,5.14,57,348,2300,9.2
8996,Eric Cairns,2008-09,34.0,12,2,50,50,1,1,2,19.0,327.0,456,10,32,42,220.0,82,6.05,85,480,2458,10.1
8997,Eric Cairns,2009-10,35.0,13,0,1,1,0,0,0,0.0,1.0,457,10,32,42,220.0,82,5.76,70,398,2426,9.7
8998,Eric Calder,1984-85,21.0,4,0,1,1,0,0,0,0.0,,1,0,0,0,0.0,80,8.03,73,320,2489,12.9
8999,Eric Calder,1985-86,22.0,5,0,1,1,0,0,0,0.0,,2,0,0,0,0.0,80,7.73,71,310,2444,12.7
9000,Eric Charron,1995-96,26.0,4,0,3,3,0,0,0,0.0,,3,0,0,0,0.0,84,7.25,87,443,2603,11.7
9001,Eric Charron,1996-97,27.0,5,0,4,4,0,0,0,1.0,,7,0,0,0,1.0,84,6.48,76,407,2545,10.7
9002,Eric Charron,1997-98,28.0,6,5,45,45,1,4,5,33.0,,52,1,4,5,34.0,48,5.97,37,209,1408,10.2
9003,Eric Charron,1998-99,29.0,7,1,18,18,0,1,1,13.0,,70,1,5,6,47.0,82,6.29,74,413,2481,10.4
9004,Eric Charron,1999-00,30.0,8,2,25,25,1,1,2,11.0,,95,2,6,8,58.0,82,5.83,55,336,2444,9.8
9005,Eric Charron,2000-01,31.0,9,0,2,2,0,0,0,1.0,,97,2,6,8,59.0,82,5.28,57,380,2242,9.6
9006,Eric Charron,2001-02,32.0,10,1,12,12,0,1,1,9.0,165.0,109,2,7,9,68.0,82,5.27,57,359,2285,9.4
9007,Eric Charron,2002-03,33.0,11,0,21,21,0,0,0,8.0,220.0,130,2,7,9,76.0,82,5.49,53,331,2294,9.8
9008,Eric Chouinard,2003-04,23.0,4,4,13,13,1,3,4,11.0,143.0,13,1,3,4,11.0,82,5.51,63,376,2272,9.9
9009,Eric Chouinard,2005-06,25.0,5,8,28,28,4,4,8,45.0,270.0,41,5,7,12,56.0,82,5.31,60,363,2326,9.4
9010,Eric Chouinard,2006-07,26.0,6,10,48,48,6,4,10,60.0,557.0,89,11,11,22,116.0,82,5.14,57,348,2300,9.2
9011,Eric Chouinard,2008-09,28.0,7,0,1,1,0,0,0,0.0,5.0,90,11,11,22,116.0,82,6.05,85,480,2458,10.1
9012,Eric Daze,1997-98,22.0,4,2,4,4,1,1,2,1.0,,4,1,1,2,1.0,48,5.97,37,209,1408,10.2
9013,Eric Daze,1998-99,23.0,5,53,80,80,30,23,53,167.0,,84,31,24,55,168.0,82,6.29,74,413,2481,10.4
9014,Eric Daze,1999-00,24.0,6,41,71,71,22,19,41,176.0,,155,53,43,96,344.0,82,5.83,55,336,2444,9.8
9015,Eric Daze,2000-01,25.0,7,42,80,80,31,11,42,216.0,,235,84,54,138,560.0,82,5.28,57,380,2242,9.6
9016,Eric Daze,2001-02,26.0,8,42,72,72,22,20,42,189.0,1171.0,307,106,74,180,749.0,82,5.27,57,359,2285,9.4
9017,Eric Daze,2002-03,27.0,9,36,59,59,23,13,36,143.0,959.0,366,129,87,216,892.0,82,5.49,53,331,2294,9.8
9018,Eric Daze,2003-04,28.0,10,57,79,79,33,24,57,205.0,1402.0,445,162,111,273,1097.0,82,5.51,63,376,2272,9.9
9019,Eric Daze,2004-05,29.0,11,70,82,82,38,32,70,264.0,1404.0,527,200,143,343,1361.0,82,5.24,53,338,2262,9.5
9020,Eric Daze,2005-06,30.0,12,44,54,54,22,22,44,170.0,879.0,581,222,165,387,1531.0,82,5.31,60,363,2326,9.4
9021,Eric Daze,2006-07,31.0,13,11,19,19,4,7,11,76.0,360.0,600,226,172,398,1607.0,82,5.14,57,348,2300,9.2
9022,Eric Daze,2008-09,33.0,14,0,1,1,0,0,0,0.0,12.0,601,226,172,398,1607.0,82,6.05,85,480,2458,10.1
9023,Eric Desjardins,1991-92,22.0,4,14,36,36,2,12,14,39.0,,36,2,12,14,39.0,80,7.48,85,403,2430,12.3
9024,Eric Desjardins,1992-93,23.0,5,16,55,55,3,13,16,48.0,,91,5,25,30,87.0,80,7.37,76,367,2421,12.2
9025,Eric Desjardins,1993-94,24.0,6,25,62,62,7,18,25,114.0,,153,12,43,55,201.0,80,6.91,71,366,2385,11.6
9026,Eric Desjardins,1994-95,25.0,7,38,77,77,6,32,38,141.0,,230,18,75,93,342.0,80,6.96,77,402,2440,11.4
9027,Eric Desjardins,1995-96,26.0,8,45,82,82,13,32,45,163.0,,312,31,107,138,505.0,84,7.25,87,443,2603,11.7
9028,Eric Desjardins,1996-97,27.0,9,35,84,84,12,23,35,193.0,,396,43,130,173,698.0,84,6.48,76,407,2545,10.7
9029,Eric Desjardins,1997-98,28.0,10,29,43,43,5,24,29,93.0,,439,48,154,202,791.0,48,5.97,37,209,1408,10.2
9030,Eric Desjardins,1998-99,29.0,11,47,80,80,7,40,47,184.0,,519,55,194,249,975.0,82,6.29,74,413,2481,10.4
9031,Eric Desjardins,1999-00,30.0,12,46,82,82,12,34,46,183.0,,601,67,228,295,1158.0,82,5.83,55,336,2444,9.8
9032,Eric Desjardins,2000-01,31.0,13,33,77,77,6,27,33,150.0,,678,73,255,328,1308.0,82,5.28,57,380,2242,9.6
9033,Eric Desjardins,2001-02,32.0,14,51,68,68,15,36,51,190.0,1754.0,746,88,291,379,1498.0,82,5.27,57,359,2285,9.4
9034,Eric Desjardins,2002-03,33.0,15,55,81,81,14,41,55,207.0,2188.0,827,102,332,434,1705.0,82,5.49,53,331,2294,9.8
9035,Eric Desjardins,2003-04,34.0,16,48,79,79,15,33,48,187.0,2089.0,906,117,365,482,1892.0,82,5.51,63,376,2272,9.9
9036,Eric Desjardins,2004-05,35.0,17,25,65,65,6,19,25,117.0,1443.0,971,123,384,507,2009.0,82,5.24,53,338,2262,9.5
9037,Eric Desjardins,2005-06,36.0,18,32,79,79,8,24,32,197.0,1810.0,1050,131,408,539,2206.0,82,5.31,60,363,2326,9.4
9038,Eric Desjardins,2006-07,37.0,19,12,48,48,1,11,12,92.0,1079.0,1098,132,419,551,2298.0,82,5.14,57,348,2300,9.2
9039,Eric Desjardins,2008-09,39.0,20,24,45,45,4,20,24,88.0,1062.0,1143,136,439,575,2386.0,82,6.05,85,480,2458,10.1
9040,Eric Fehr,2008-09,23.0,4,0,11,11,0,0,0,10.0,63.0,11,0,0,0,10.0,82,6.05,85,480,2458,10.1
9041,Eric Fehr,2009-10,24.0,5,3,14,14,2,1,3,25.0,150.0,25,2,1,3,35.0,82,5.76,70,398,2426,9.7
9042,Eric Fehr,2010-11,25.0,6,6,23,23,1,5,6,40.0,242.0,48,3,6,9,75.0,82,5.44,62,351,2383,9.4
9043,Eric Fehr,2011-12,26.0,7,25,61,61,12,13,25,134.0,686.0,109,15,19,34,209.0,82,5.7,65,341,2477,9.4
9044,Eric Fehr,2012-13,27.0,8,39,69,69,21,18,39,145.0,837.0,178,36,37,73,354.0,82,5.53,56,304,2486,9.1
9045,Eric Fehr,2013-14,28.0,9,20,52,52,10,10,20,120.0,655.0,230,46,47,93,474.0,82,5.46,52,291,2492,9.0
9046,Eric Fehr,2014-15,29.0,10,3,35,35,2,1,3,54.0,339.0,265,48,48,96,528.0,82,5.32,47,271,2439,8.9
9047,Eric Fehr,2015-16,30.0,11,17,41,41,9,8,17,72.0,548.0,306,57,56,113,600.0,48,5.31,29,160,1399,9.1
9048,Eric Fehr,2016-17,31.0,12,31,73,73,13,18,31,137.0,1077.0,379,70,74,144,737.0,82,5.34,48,269,2463,8.9
9049,Eric Fehr,2017-18,32.0,13,33,75,75,19,14,33,142.0,1114.0,454,89,88,177,879.0,82,5.32,47,251,2453,8.9
9050,Eric Fehr,2018-19,33.0,14,14,55,55,8,6,14,74.0,718.0,509,97,94,191,953.0,82,5.34,48,255,2438,9.0
9051,Eric Fehr,2019-20,34.0,15,11,53,53,6,5,11,62.0,579.0,562,103,99,202,1015.0,82,5.45,47,245,2478,9.0
9052,Eric Fehr,2020-21,35.0,16,4,18,18,3,1,4,27.0,212.0,580,106,100,206,1042.0,82,5.86,50,250,2620,9.2
9053,Eric Fehr,2021-22,36.0,17,15,72,72,7,8,15,67.0,795.0,652,113,108,221,1109.0,82,5.96,47,239,2579,9.5
9054,Eric Gelinas,2015-16,24.0,4,0,1,1,0,0,0,1.0,16.0,1,0,0,0,1.0,48,5.31,29,160,1399,9.1
9055,Eric Gelinas,2016-17,25.0,5,29,60,60,7,22,29,124.0,1015.0,61,7,22,29,125.0,82,5.34,48,269,2463,8.9
9056,Eric Gelinas,2017-18,26.0,6,19,61,61,6,13,19,112.0,1004.0,122,13,35,48,237.0,82,5.32,47,251,2453,8.9
9057,Eric Gelinas,2018-19,27.0,7,6,40,40,1,5,6,55.0,553.0,162,14,40,54,292.0,82,5.34,48,255,2438,9.0
9058,Eric Gelinas,2019-20,28.0,8,1,27,27,0,1,1,29.0,313.0,189,14,41,55,321.0,82,5.45,47,245,2478,9.0
9059,Eric Germain,1990-91,24.0,4,1,4,4,0,1,1,2.0,,4,0,1,1,2.0,80,7.43,89,437,2435,12.2
9060,Eric Godard,2005-06,25.0,4,0,19,19,0,0,0,6.0,86.0,19,0,0,0,6.0,82,5.31,60,363,2326,9.4
9061,Eric Godard,2006-07,26.0,5,1,31,31,0,1,1,5.0,117.0,50,0,1,1,11.0,82,5.14,57,348,2300,9.2
9062,Eric Godard,2008-09,28.0,6,4,57,57,2,2,4,17.0,203.0,107,2,3,5,28.0,82,6.05,85,480,2458,10.1
9063,Eric Godard,2009-10,29.0,7,1,19,19,0,1,1,3.0,72.0,126,2,4,6,31.0,82,5.76,70,398,2426,9.7
9064,Eric Godard,2010-11,30.0,8,2,74,74,1,1,2,14.0,349.0,200,3,5,8,45.0,82,5.44,62,351,2383,9.4
9065,Eric Godard,2011-12,31.0,9,4,71,71,2,2,4,20.0,289.0,271,5,7,12,65.0,82,5.7,65,341,2477,9.4
9066,Eric Godard,2012-13,32.0,10,3,45,45,1,2,3,17.0,188.0,316,6,9,15,82.0,82,5.53,56,304,2486,9.1
9067,Eric Godard,2013-14,33.0,11,3,19,19,0,3,3,1.0,98.0,335,6,12,18,83.0,82,5.46,52,291,2492,9.0
9068,Eric Gryba,2015-16,27.0,4,6,33,33,2,4,6,51.0,669.0,33,2,4,6,51.0,48,5.31,29,160,1399,9.1
9069,Eric Gryba,2016-17,28.0,5,11,57,57,2,9,11,57.0,999.0,90,4,13,17,108.0,82,5.34,48,269,2463,8.9
9070,Eric Gryba,2017-18,29.0,6,12,75,75,0,12,12,64.0,1174.0,165,4,25,29,172.0,82,5.32,47,251,2453,8.9
9071,Eric Gryba,2018-19,30.0,7,6,53,53,1,5,6,58.0,948.0,218,5,30,35,230.0,82,5.34,48,255,2438,9.0
9072,Eric Gryba,2019-20,31.0,8,6,40,40,2,4,6,45.0,646.0,258,7,34,41,275.0,82,5.45,47,245,2478,9.0
9073,Eric Gryba,2020-21,32.0,9,2,21,21,0,2,2,19.0,309.0,279,7,36,43,294.0,82,5.86,50,250,2620,9.2
9074,Eric Gryba,2021-22,33.0,10,0,10,10,0,0,0,11.0,153.0,289,7,36,43,305.0,82,5.96,47,239,2579,9.5
9075,Eric Healey,2008-09,34.0,4,0,2,2,0,0,0,1.0,17.0,2,0,0,0,1.0,82,6.05,85,480,2458,10.1
9076,Eric Houde,1999-00,23.0,4,2,13,13,0,2,2,1.0,,13,0,2,2,1.0,82,5.83,55,336,2444,9.8
9077,Eric Houde,2000-01,24.0,5,1,9,9,1,0,1,4.0,,22,1,2,3,5.0,82,5.28,57,380,2242,9.6
9078,Eric Houde,2001-02,25.0,6,2,8,8,1,1,2,4.0,57.0,30,2,3,5,9.0,82,5.27,57,359,2285,9.4
9079,Eric Lacroix,1996-97,25.0,4,0,3,3,0,0,0,3.0,,3,0,0,0,3.0,84,6.48,76,407,2545,10.7
9080,Eric Lacroix,1997-98,26.0,5,16,45,45,9,7,16,64.0,,48,9,7,16,67.0,48,5.97,37,209,1408,10.2
9081,Eric Lacroix,1998-99,27.0,6,32,72,72,16,16,32,107.0,,120,25,23,48,174.0,82,6.29,74,413,2481,10.4
9082,Eric Lacroix,1999-00,28.0,7,36,81,81,18,18,36,141.0,,201,43,41,84,315.0,82,5.83,55,336,2444,9.8
9083,Eric Lacroix,2000-01,29.0,8,31,82,82,16,15,31,126.0,,283,59,56,115,441.0,82,5.28,57,380,2242,9.6
9084,Eric Lacroix,2001-02,30.0,9,4,64,64,2,2,4,38.0,439.0,347,61,58,119,479.0,82,5.27,57,359,2285,9.4
9085,Eric Lacroix,2002-03,31.0,10,12,70,70,4,8,12,46.0,702.0,417,65,66,131,525.0,82,5.49,53,331,2294,9.8
9086,Eric Lacroix,2003-04,32.0,11,6,55,55,2,4,6,32.0,363.0,472,67,70,137,557.0,82,5.51,63,376,2272,9.9
9087,Eric Landry,2000-01,26.0,4,1,12,12,1,0,1,7.0,,12,1,0,1,7.0,82,5.28,57,380,2242,9.6
9088,Eric Landry,2001-02,27.0,5,1,3,3,0,1,1,1.0,30.0,15,1,1,2,8.0,82,5.27,57,359,2285,9.4
9089,Eric Landry,2003-04,29.0,6,11,51,51,4,7,11,54.0,475.0,66,5,8,13,62.0,82,5.51,63,376,2272,9.9
9090,Eric Landry,2004-05,30.0,7,1,2,2,0,1,1,0.0,15.0,68,5,9,14,62.0,82,5.24,53,338,2262,9.5
9091,Eric Lavigne,1997-98,25.0,4,0,1,1,0,0,0,0.0,,1,0,0,0,0.0,48,5.97,37,209,1408,10.2
9092,Eric Lindros,1995-96,22.0,4,75,61,61,41,34,75,180.0,,61,41,34,75,180.0,84,7.25,87,443,2603,11.7
9093,Eric Lindros,1996-97,23.0,5,97,65,65,44,53,97,197.0,,126,85,87,172,377.0,84,6.48,76,407,2545,10.7
9094,Eric Lindros,1997-98,24.0,6,70,46,46,29,41,70,144.0,,172,114,128,242,521.0,48,5.97,37,209,1408,10.2
9095,Eric Lindros,1998-99,25.0,7,115,73,73,47,68,115,294.0,,245,161,196,357,815.0,82,6.29,74,413,2481,10.4
9096,Eric Lindros,1999-00,26.0,8,79,52,52,32,47,79,198.0,,297,193,243,436,1013.0,82,5.83,55,336,2444,9.8
9097,Eric Lindros,2000-01,27.0,9,71,63,63,30,41,71,202.0,,360,223,284,507,1215.0,82,5.28,57,380,2242,9.6
9098,Eric Lindros,2001-02,28.0,10,93,71,71,40,53,93,242.0,1628.0,431,263,337,600,1457.0,82,5.27,57,359,2285,9.4
9099,Eric Lindros,2002-03,29.0,11,59,55,55,27,32,59,187.0,1212.0,486,290,369,659,1644.0,82,5.49,53,331,2294,9.8
9100,Eric Lindros,2004-05,31.0,12,73,72,72,37,36,73,196.0,1516.0,558,327,405,732,1840.0,82,5.24,53,338,2262,9.5
9101,Eric Lindros,2005-06,32.0,13,53,81,81,19,34,53,235.0,1640.0,639,346,439,785,2075.0,82,5.31,60,363,2326,9.4
9102,Eric Lindros,2006-07,33.0,14,32,39,39,10,22,32,83.0,623.0,678,356,461,817,2158.0,82,5.14,57,348,2300,9.2
9103,Eric Lindros,2008-09,35.0,15,22,33,33,11,11,22,59.0,574.0,711,367,472,839,2217.0,82,6.05,85,480,2458,10.1
9104,Eric Lindros,2009-10,36.0,16,26,49,49,5,21,26,95.0,718.0,760,372,493,865,2312.0,82,5.76,70,398,2426,9.7
9105,Eric Manlow,2003-04,28.0,4,1,8,8,0,1,1,3.0,59.0,8,0,1,1,3.0,82,5.51,63,376,2272,9.9
9106,Eric Manlow,2004-05,29.0,5,0,3,3,0,0,0,2.0,18.0,11,0,1,1,5.0,82,5.24,53,338,2262,9.5
9107,Eric Manlow,2005-06,30.0,6,3,8,8,2,1,3,7.0,100.0,19,2,2,4,12.0,82,5.31,60,363,2326,9.4
9108,Eric Manlow,2006-07,31.0,7,2,18,18,0,2,2,10.0,184.0,37,2,4,6,22.0,82,5.14,57,348,2300,9.2
9109,Eric Meloche,2004-05,28.0,4,1,23,23,0,1,1,29.0,234.0,23,0,1,1,29.0,82,5.24,53,338,2262,9.5
9110,Eric Meloche,2005-06,29.0,5,6,13,13,5,1,6,34.0,219.0,36,5,2,7,63.0,82,5.31,60,363,2326,9.4
9111,Eric Meloche,2006-07,30.0,6,10,25,25,3,7,10,28.0,370.0,61,8,9,17,91.0,82,5.14,57,348,2300,9.2
9112,Eric Meloche,2009-10,33.0,7,3,13,13,1,2,3,12.0,109.0,74,9,11,20,103.0,82,5.76,70,398,2426,9.7
9113,Eric Messier,1999-00,26.0,4,0,21,21,0,0,0,11.0,,21,0,0,0,11.0,82,5.83,55,336,2444,9.8
9114,Eric Messier,2000-01,27.0,5,16,62,62,4,12,16,66.0,,83,4,12,16,77.0,82,5.28,57,380,2242,9.6
9115,Eric Messier,2001-02,28.0,6,6,31,31,4,2,6,30.0,425.0,114,8,14,22,107.0,82,5.27,57,359,2285,9.4
9116,Eric Messier,2002-03,29.0,7,9,61,61,3,6,9,28.0,637.0,175,11,20,31,135.0,82,5.49,53,331,2294,9.8
9117,Eric Messier,2003-04,30.0,8,12,64,64,5,7,12,60.0,786.0,239,16,27,43,195.0,82,5.51,63,376,2272,9.9
9118,Eric Messier,2004-05,31.0,9,15,74,74,5,10,15,84.0,1128.0,313,21,37,58,279.0,82,5.24,53,338,2262,9.5
9119,Eric Messier,2005-06,32.0,10,14,72,72,4,10,14,52.0,888.0,385,25,47,72,331.0,82,5.31,60,363,2326,9.4
9120,Eric Messier,2006-07,33.0,11,3,21,21,0,3,3,13.0,237.0,406,25,50,75,344.0,82,5.14,57,348,2300,9.2
9121,Eric Nickulas,2001-02,26.0,4,0,2,2,0,0,0,0.0,7.0,2,0,0,0,0.0,82,5.27,57,359,2285,9.4
9122,Eric Nickulas,2002-03,27.0,5,11,20,20,5,6,11,28.0,224.0,22,5,6,11,28.0,82,5.49,53,331,2294,9.8
9123,Eric Nickulas,2003-04,28.0,6,0,7,7,0,0,0,6.0,50.0,29,5,6,11,34.0,82,5.51,63,376,2272,9.9
9124,Eric Nickulas,2005-06,30.0,7,1,8,8,0,1,1,3.0,76.0,37,5,7,12,37.0,82,5.31,60,363,2326,9.4
9125,Eric Nickulas,2006-07,31.0,8,20,65,65,8,12,20,121.0,854.0,102,13,19,32,158.0,82,5.14,57,348,2300,9.2
9126,Eric Nickulas,2008-09,33.0,9,6,16,16,2,4,6,14.0,130.0,118,15,23,38,172.0,82,6.05,85,480,2458,10.1
9127,Eric Nystrom,2008-09,25.0,4,0,2,2,0,0,0,0.0,24.0,2,0,0,0,0.0,82,6.05,85,480,2458,10.1
9128,Eric Nystrom,2010-11,27.0,5,10,44,44,3,7,10,42.0,506.0,46,3,7,10,42.0,82,5.44,62,351,2383,9.4
9129,Eric Nystrom,2011-12,28.0,6,10,76,76,5,5,10,83.0,704.0,122,8,12,20,125.0,82,5.7,65,341,2477,9.4
9130,Eric Nystrom,2012-13,29.0,7,19,82,82,11,8,19,91.0,1080.0,204,19,20,39,216.0,82,5.53,56,304,2486,9.1
9131,Eric Nystrom,2013-14,30.0,8,12,82,82,4,8,12,83.0,1091.0,286,23,28,51,299.0,82,5.46,52,291,2492,9.0
9132,Eric Nystrom,2014-15,31.0,9,21,74,74,16,5,21,102.0,1017.0,360,39,33,72,401.0,82,5.32,47,271,2439,8.9
9133,Eric Nystrom,2015-16,32.0,10,11,48,48,7,4,11,49.0,689.0,408,46,37,83,450.0,48,5.31,29,160,1399,9.1
9134,Eric Nystrom,2016-17,33.0,11,21,79,79,15,6,21,120.0,1174.0,487,61,43,104,570.0,82,5.34,48,269,2463,8.9
9135,Eric Nystrom,2017-18,34.0,12,12,60,60,7,5,12,60.0,792.0,547,68,48,116,630.0,82,5.32,47,251,2453,8.9
9136,Eric Nystrom,2018-19,35.0,13,7,46,46,7,0,7,27.0,528.0,593,75,48,123,657.0,82,5.34,48,255,2438,9.0
9137,Eric O'Dell,2016-17,26.0,4,7,30,30,3,4,7,17.0,291.0,30,3,4,7,17.0,82,5.34,48,269,2463,8.9
9138,Eric O'Dell,2017-18,27.0,5,1,11,11,0,1,1,6.0,82.0,41,3,5,8,23.0,82,5.32,47,251,2453,8.9
9139,Eric Perrin,2006-07,31.0,4,0,4,4,0,0,0,3.0,34.0,4,0,0,0,3.0,82,5.14,57,348,2300,9.2
9140,Eric Perrin,2009-10,34.0,5,36,82,82,13,23,36,151.0,1394.0,86,13,23,36,154.0,82,5.76,70,398,2426,9.7
9141,Eric Perrin,2010-11,35.0,6,45,81,81,12,33,45,121.0,1444.0,167,25,56,81,275.0,82,5.44,62,351,2383,9.4
9142,Eric Perrin,2011-12,36.0,7,23,78,78,7,16,23,109.0,1106.0,245,32,72,104,384.0,82,5.7,65,341,2477,9.4
9143,Eric Robinson,2020-21,25.0,4,0,1,1,0,0,0,2.0,11.0,1,0,0,0,2.0,82,5.86,50,250,2620,9.2
9144,Eric Robinson,2021-22,26.0,5,0,13,13,0,0,0,18.0,154.0,14,0,0,0,20.0,82,5.96,47,239,2579,9.5
9145,Eric Robinson,2022-23,27.0,6,12,50,50,7,5,12,69.0,548.0,64,7,5,12,89.0,70,5.96,42,208,2192,9.5
9146,Eric Selleck,2015-16,28.0,4,1,2,2,0,1,1,2.0,16.0,2,0,1,1,2.0,48,5.31,29,160,1399,9.1
9147,Eric Selleck,2018-19,31.0,5,0,1,1,0,0,0,1.0,10.0,3,0,1,1,3.0,82,5.34,48,255,2438,9.0
9148,Eric Staal,2006-07,22.0,4,31,81,81,11,20,31,164.0,1350.0,81,11,20,31,164.0,82,5.14,57,348,2300,9.2
9149,Eric Staal,2008-09,24.0,5,100,82,82,45,55,100,279.0,1611.0,163,56,75,131,443.0,82,6.05,85,480,2458,10.1
9150,Eric Staal,2009-10,25.0,6,70,82,82,30,40,70,288.0,1650.0,245,86,115,201,731.0,82,5.76,70,398,2426,9.7
9151,Eric Staal,2010-11,26.0,7,82,82,82,38,44,82,310.0,1774.0,327,124,159,283,1041.0,82,5.44,62,351,2383,9.4
9152,Eric Staal,2011-12,27.0,8,75,82,82,40,35,75,372.0,1726.0,409,164,194,358,1413.0,82,5.7,65,341,2477,9.4
9153,Eric Staal,2012-13,28.0,9,70,70,70,29,41,70,277.0,1450.0,479,193,235,428,1690.0,82,5.53,56,304,2486,9.1
9154,Eric Staal,2013-14,29.0,10,76,81,81,33,43,76,296.0,1777.0,560,226,278,504,1986.0,82,5.46,52,291,2492,9.0
9155,Eric Staal,2014-15,30.0,11,70,82,82,24,46,70,262.0,1767.0,642,250,324,574,2248.0,82,5.32,47,271,2439,8.9
9156,Eric Staal,2015-16,31.0,12,53,48,48,18,35,53,152.0,1008.0,690,268,359,627,2400.0,48,5.31,29,160,1399,9.1
9157,Eric Staal,2016-17,32.0,13,61,79,79,21,40,61,230.0,1603.0,769,289,399,688,2630.0,82,5.34,48,269,2463,8.9
9158,Eric Staal,2017-18,33.0,14,54,77,77,23,31,54,244.0,1451.0,846,312,430,742,2874.0,82,5.32,47,251,2453,8.9
9159,Eric Staal,2018-19,34.0,15,39,83,83,13,26,39,199.0,1540.0,929,325,456,781,3073.0,82,5.34,48,255,2438,9.0
9160,Eric Staal,2019-20,35.0,16,65,82,82,28,37,65,211.0,1526.0,1011,353,493,846,3284.0,82,5.45,47,245,2478,9.0
9161,Eric Staal,2020-21,36.0,17,76,82,82,42,34,76,241.0,1461.0,1093,395,527,922,3525.0,82,5.86,50,250,2620,9.2
9162,Eric Staal,2021-22,37.0,18,52,81,81,22,30,52,215.0,1468.0,1174,417,557,974,3740.0,82,5.96,47,239,2579,9.5
9163,Eric Staal,2022-23,38.0,19,47,66,66,19,28,47,113.0,1131.0,1240,436,585,1021,3853.0,70,5.96,42,208,2192,9.5
9164,Eric Tangradi,2012-13,23.0,4,0,1,1,0,0,0,3.0,14.0,1,0,0,0,3.0,82,5.53,56,304,2486,9.1
9165,Eric Tangradi,2013-14,24.0,5,3,15,15,1,2,3,18.0,168.0,16,1,2,3,21.0,82,5.46,52,291,2492,9.0
9166,Eric Tangradi,2014-15,25.0,6,2,24,24,0,2,2,20.0,215.0,40,1,4,5,41.0,82,5.32,47,271,2439,8.9
9167,Eric Tangradi,2015-16,26.0,7,4,41,41,1,3,4,48.0,413.0,81,2,7,9,89.0,48,5.31,29,160,1399,9.1
9168,Eric Tangradi,2016-17,27.0,8,6,55,55,3,3,6,52.0,475.0,136,5,10,15,141.0,82,5.34,48,269,2463,8.9
9169,Eric Tangradi,2017-18,28.0,9,0,7,7,0,0,0,5.0,54.0,143,5,10,15,146.0,82,5.32,47,251,2453,8.9
9170,Eric Tangradi,2018-19,29.0,10,0,1,1,0,0,0,0.0,7.0,144,5,10,15,146.0,82,5.34,48,255,2438,9.0
9171,Eric Tangradi,2021-22,32.0,11,1,6,6,0,1,1,10.0,83.0,150,5,11,16,156.0,82,5.96,47,239,2579,9.5
9172,Eric Weinrich,1991-92,25.0,4,0,2,2,0,0,0,3.0,,2,0,0,0,3.0,80,7.48,85,403,2430,12.3
9173,Eric Weinrich,1992-93,26.0,5,9,19,19,2,7,9,16.0,,21,2,7,9,19.0,80,7.37,76,367,2421,12.2
9174,Eric Weinrich,1993-94,27.0,6,38,76,76,4,34,38,96.0,,97,6,41,47,115.0,80,6.91,71,366,2385,11.6
9175,Eric Weinrich,1994-95,28.0,7,32,76,76,7,25,32,97.0,,173,13,66,79,212.0,80,6.96,77,402,2440,11.4
9176,Eric Weinrich,1995-96,29.0,8,36,79,79,7,29,36,104.0,,252,20,95,115,316.0,84,7.25,87,443,2603,11.7
9177,Eric Weinrich,1996-97,30.0,9,28,62,62,4,24,28,115.0,,314,24,119,143,431.0,84,6.48,76,407,2545,10.7
9178,Eric Weinrich,1997-98,31.0,10,13,48,48,3,10,13,50.0,,362,27,129,156,481.0,48,5.97,37,209,1408,10.2
9179,Eric Weinrich,1998-99,32.0,11,15,77,77,5,10,15,76.0,,439,32,139,171,557.0,82,6.29,74,413,2481,10.4
9180,Eric Weinrich,1999-00,33.0,12,32,81,81,7,25,32,115.0,,520,39,164,203,672.0,82,5.83,55,336,2444,9.8
9181,Eric Weinrich,2000-01,34.0,13,23,82,82,2,21,23,85.0,,602,41,185,226,757.0,82,5.28,57,380,2242,9.6
9182,Eric Weinrich,2001-02,35.0,14,22,80,80,7,15,22,119.0,1915.0,682,48,200,248,876.0,82,5.27,57,359,2285,9.4
9183,Eric Weinrich,2002-03,36.0,15,29,77,77,4,25,29,120.0,1952.0,759,52,225,277,996.0,82,5.49,53,331,2294,9.8
9184,Eric Weinrich,2003-04,37.0,16,31,82,82,7,24,31,109.0,2036.0,841,59,249,308,1105.0,82,5.51,63,376,2272,9.9
9185,Eric Weinrich,2004-05,38.0,17,24,80,80,4,20,24,102.0,1750.0,921,63,269,332,1207.0,82,5.24,53,338,2262,9.5
9186,Eric Weinrich,2005-06,39.0,18,20,81,81,2,18,20,103.0,1733.0,1002,65,287,352,1310.0,82,5.31,60,363,2326,9.4
9187,Eric Weinrich,2006-07,40.0,19,19,80,80,4,15,19,83.0,1723.0,1082,69,302,371,1393.0,82,5.14,57,348,2300,9.2
9188,Eric Weinrich,2008-09,42.0,20,17,75,75,1,16,17,68.0,1612.0,1157,70,318,388,1461.0,82,6.05,85,480,2458,10.1
9189,Eric Wellwood,2013-14,23.0,4,1,3,3,0,1,1,8.0,40.0,3,0,1,1,8.0,82,5.46,52,291,2492,9.0
9190,Eric Wellwood,2014-15,24.0,5,9,24,24,5,4,9,36.0,263.0,27,5,5,10,44.0,82,5.32,47,271,2439,8.9
9191,Eric Wellwood,2015-16,25.0,6,0,4,4,0,0,0,2.0,38.0,31,5,5,10,46.0,48,5.31,29,160,1399,9.1
9192,Erich Goldmann,2002-03,26.0,4,0,1,1,0,0,0,0.0,10.0,1,0,0,0,0.0,82,5.49,53,331,2294,9.8
9193,Erik Andersson,2000-01,29.0,4,3,12,12,2,1,3,11.0,,12,2,1,3,11.0,82,5.28,57,380,2242,9.6
9194,Erik Brannstrom,2021-22,22.0,4,0,2,2,0,0,0,0.0,36.0,2,0,0,0,0.0,82,5.96,47,239,2579,9.5
9195,Erik Brannstrom,2022-23,23.0,5,4,31,31,0,4,4,38.0,460.0,33,0,4,4,38.0,70,5.96,42,208,2192,9.5
9196,Erik Burgdoerfer,2019-20,31.0,4,0,2,2,0,0,0,2.0,22.0,2,0,0,0,2.0,82,5.45,47,245,2478,9.0
9197,Erik Burgdoerfer,2020-21,32.0,5,1,2,2,0,1,1,2.0,27.0,4,0,1,1,4.0,82,5.86,50,250,2620,9.2
9198,Erik Burgdoerfer,2021-22,33.0,6,0,4,4,0,0,0,2.0,43.0,8,0,1,1,6.0,82,5.96,47,239,2579,9.5
9199,Erik Cernak,2021-22,24.0,4,16,58,58,5,11,16,107.0,1117.0,58,5,11,16,107.0,82,5.96,47,239,2579,9.5
9200,Erik Cernak,2022-23,25.0,5,12,67,67,5,7,12,125.0,1270.0,125,10,18,28,232.0,70,5.96,42,208,2192,9.5
9201,Erik Christensen,2008-09,25.0,4,13,33,33,6,7,13,85.0,471.0,33,6,7,13,85.0,82,6.05,85,480,2458,10.1
9202,Erik Christensen,2009-10,26.0,5,33,61,61,18,15,33,133.0,709.0,94,24,22,46,218.0,82,5.76,70,398,2426,9.7
9203,Erik Christensen,2010-11,27.0,6,24,59,59,11,13,24,132.0,788.0,153,35,35,70,350.0,82,5.44,62,351,2383,9.4
9204,Erik Christensen,2011-12,28.0,7,28,64,64,7,21,28,122.0,873.0,217,42,56,98,472.0,82,5.7,65,341,2477,9.4
9205,Erik Christensen,2012-13,29.0,8,26,58,58,8,18,26,86.0,861.0,275,50,74,124,558.0,82,5.53,56,304,2486,9.1
9206,Erik Christensen,2013-14,30.0,9,27,63,63,11,16,27,86.0,804.0,338,61,90,151,644.0,82,5.46,52,291,2492,9.0
9207,Erik Christensen,2014-15,31.0,10,12,49,49,7,5,12,44.0,510.0,387,68,95,163,688.0,82,5.32,47,271,2439,8.9
9208,Erik Cole,2004-05,26.0,4,40,81,81,16,24,40,159.0,1301.0,81,16,24,40,159.0,82,5.24,53,338,2262,9.5
9209,Erik Cole,2005-06,27.0,5,27,53,53,14,13,27,125.0,908.0,134,30,37,67,284.0,82,5.31,60,363,2326,9.4
9210,Erik Cole,2006-07,28.0,6,42,80,80,18,24,42,172.0,1448.0,214,48,61,109,456.0,82,5.14,57,348,2300,9.2
9211,Erik Cole,2008-09,30.0,7,59,60,60,30,29,59,164.0,1158.0,274,78,90,168,620.0,82,6.05,85,480,2458,10.1
9212,Erik Cole,2009-10,31.0,8,61,71,71,29,32,61,166.0,1279.0,345,107,122,229,786.0,82,5.76,70,398,2426,9.7
9213,Erik Cole,2010-11,32.0,9,51,73,73,22,29,51,216.0,1413.0,418,129,151,280,1002.0,82,5.44,62,351,2383,9.4
9214,Erik Cole,2011-12,33.0,10,42,80,80,18,24,42,178.0,1409.0,498,147,175,322,1180.0,82,5.7,65,341,2477,9.4
9215,Erik Cole,2012-13,34.0,11,16,40,40,11,5,16,81.0,656.0,538,158,180,338,1261.0,82,5.53,56,304,2486,9.1
9216,Erik Cole,2013-14,35.0,12,52,82,82,26,26,52,201.0,1514.0,620,184,206,390,1462.0,82,5.46,52,291,2492,9.0
9217,Erik Cole,2014-15,36.0,13,61,82,82,35,26,61,241.0,1519.0,702,219,232,451,1703.0,82,5.32,47,271,2439,8.9
9218,Erik Cole,2015-16,37.0,14,13,47,47,9,4,13,86.0,770.0,749,228,236,464,1789.0,48,5.31,29,160,1399,9.1
9219,Erik Cole,2016-17,38.0,15,29,75,75,16,13,29,139.0,1137.0,824,244,249,493,1928.0,82,5.34,48,269,2463,8.9
9220,Erik Cole,2017-18,39.0,16,39,68,68,21,18,39,122.0,989.0,892,265,267,532,2050.0,82,5.32,47,251,2453,8.9
9221,Erik Condra,2013-14,27.0,4,11,26,26,6,5,11,48.0,413.0,26,6,5,11,48.0,82,5.46,52,291,2492,9.0
9222,Erik Condra,2014-15,28.0,5,25,81,81,8,17,25,140.0,1147.0,107,14,22,36,188.0,82,5.32,47,271,2439,8.9
9223,Erik Condra,2015-16,29.0,6,12,48,48,4,8,12,73.0,632.0,155,18,30,48,261.0,48,5.31,29,160,1399,9.1
9224,Erik Condra,2016-17,30.0,7,16,76,76,6,10,16,85.0,885.0,231,24,40,64,346.0,82,5.34,48,269,2463,8.9
9225,Erik Condra,2017-18,31.0,8,23,68,68,9,14,23,106.0,983.0,299,33,54,87,452.0,82,5.32,47,251,2453,8.9
9226,Erik Condra,2018-19,32.0,9,11,54,54,6,5,11,58.0,578.0,353,39,59,98,510.0,82,5.34,48,255,2438,9.0
9227,Erik Condra,2019-20,33.0,10,0,13,13,0,0,0,8.0,125.0,366,39,59,98,518.0,82,5.45,47,245,2478,9.0
9228,Erik Condra,2021-22,35.0,11,1,6,6,1,0,1,10.0,76.0,372,40,59,99,528.0,82,5.96,47,239,2579,9.5
9229,Erik Gudbranson,2014-15,23.0,4,8,72,72,2,6,8,76.0,1022.0,72,2,6,8,76.0,82,5.32,47,271,2439,8.9
9230,Erik Gudbranson,2015-16,24.0,5,4,32,32,0,4,4,49.0,600.0,104,2,10,12,125.0,48,5.31,29,160,1399,9.1
9231,Erik Gudbranson,2016-17,25.0,6,9,65,65,3,6,9,92.0,1169.0,169,5,16,21,217.0,82,5.34,48,269,2463,8.9
9232,Erik Gudbranson,2017-18,26.0,7,13,76,76,4,9,13,110.0,1414.0,245,9,25,34,327.0,82,5.32,47,251,2453,8.9
9233,Erik Gudbranson,2018-19,27.0,8,9,64,64,2,7,9,73.0,1287.0,309,11,32,43,400.0,82,5.34,48,255,2438,9.0
9234,Erik Gudbranson,2019-20,28.0,9,6,30,30,1,5,6,40.0,610.0,339,12,37,49,440.0,82,5.45,47,245,2478,9.0
9235,Erik Gudbranson,2020-21,29.0,10,5,52,52,2,3,5,53.0,958.0,391,14,40,54,493.0,82,5.86,50,250,2620,9.2
9236,Erik Gudbranson,2021-22,30.0,11,10,76,76,2,8,10,94.0,1386.0,467,16,48,64,587.0,82,5.96,47,239,2579,9.5
9237,Erik Gudbranson,2022-23,31.0,12,9,51,51,4,5,9,78.0,988.0,518,20,53,73,665.0,70,5.96,42,208,2192,9.5
9238,Erik Gustafsson,2013-14,25.0,4,0,3,3,0,0,0,2.0,33.0,3,0,0,0,2.0,82,5.46,52,291,2492,9.0
9239,Erik Gustafsson,2014-15,26.0,5,5,30,30,1,4,5,18.0,504.0,33,1,4,5,20.0,82,5.32,47,271,2439,8.9
9240,Erik Gustafsson,2015-16,27.0,6,8,27,27,3,5,8,36.0,544.0,60,4,9,13,56.0,48,5.31,29,160,1399,9.1
9241,Erik Gustafsson,2016-17,28.0,7,10,31,31,2,8,10,30.0,543.0,91,6,17,23,86.0,82,5.34,48,269,2463,8.9
9242,Erik Gustafsson0,2018-19,26.0,4,14,41,41,0,14,14,58.0,633.0,41,0,14,14,58.0,82,5.34,48,255,2438,9.0
9243,Erik Gustafsson0,2020-21,28.0,5,16,35,35,5,11,16,71.0,649.0,76,5,25,30,129.0,82,5.86,50,250,2620,9.2
9244,Erik Gustafsson0,2021-22,29.0,6,60,79,79,17,43,60,160.0,1784.0,155,22,68,90,289.0,82,5.96,47,239,2579,9.5
9245,Erik Gustafsson0,2022-23,30.0,7,29,66,66,6,23,29,103.0,1345.0,221,28,91,119,392.0,70,5.96,42,208,2192,9.5
9246,Erik Haula,2016-17,25.0,4,15,46,46,6,9,15,56.0,467.0,46,6,9,15,56.0,82,5.34,48,269,2463,8.9
9247,Erik Haula,2017-18,26.0,5,14,72,72,7,7,14,92.0,875.0,118,13,16,29,148.0,82,5.32,47,251,2453,8.9
9248,Erik Haula,2018-19,27.0,6,34,76,76,14,20,34,99.0,967.0,194,27,36,63,247.0,82,5.34,48,255,2438,9.0
9249,Erik Haula,2019-20,28.0,7,26,72,72,15,11,26,134.0,995.0,266,42,47,89,381.0,82,5.45,47,245,2478,9.0
9250,Erik Haula,2020-21,29.0,8,55,76,76,29,26,55,175.0,1320.0,342,71,73,144,556.0,82,5.86,50,250,2620,9.2
9251,Erik Haula,2021-22,30.0,9,7,15,15,2,5,7,26.0,249.0,357,73,78,151,582.0,82,5.96,47,239,2579,9.5
9252,Erik Haula,2022-23,31.0,10,24,48,48,12,12,24,92.0,760.0,405,85,90,175,674.0,70,5.96,42,208,2192,9.5
9253,Erik Johnson,2010-11,22.0,4,33,69,69,5,28,33,105.0,1255.0,69,5,28,33,105.0,82,5.44,62,351,2383,9.4
9254,Erik Johnson,2012-13,24.0,5,39,79,79,10,29,39,186.0,1694.0,148,15,57,72,291.0,82,5.53,56,304,2486,9.1
9255,Erik Johnson,2013-14,25.0,6,29,77,77,8,21,29,161.0,1757.0,225,23,78,101,452.0,82,5.46,52,291,2492,9.0
9256,Erik Johnson,2014-15,26.0,7,26,73,73,4,22,26,155.0,1521.0,298,27,100,127,607.0,82,5.32,47,271,2439,8.9
9257,Erik Johnson,2015-16,27.0,8,4,31,31,0,4,4,64.0,643.0,329,27,104,131,671.0,48,5.31,29,160,1399,9.1
9258,Erik Johnson,2016-17,28.0,9,39,80,80,9,30,39,157.0,1841.0,409,36,134,170,828.0,82,5.34,48,269,2463,8.9
9259,Erik Johnson,2017-18,29.0,10,23,47,47,12,11,23,115.0,1148.0,456,48,145,193,943.0,82,5.32,47,251,2453,8.9
9260,Erik Johnson,2018-19,30.0,11,27,73,73,11,16,27,175.0,1711.0,529,59,161,220,1118.0,82,5.34,48,255,2438,9.0
9261,Erik Johnson,2019-20,31.0,12,17,46,46,2,15,17,96.0,1016.0,575,61,176,237,1214.0,82,5.45,47,245,2478,9.0
9262,Erik Johnson,2020-21,32.0,13,25,62,62,9,16,25,168.0,1577.0,637,70,192,262,1382.0,82,5.86,50,250,2620,9.2
9263,Erik Johnson,2021-22,33.0,14,25,80,80,7,18,25,144.0,1745.0,717,77,210,287,1526.0,82,5.96,47,239,2579,9.5
9264,Erik Johnson,2022-23,34.0,15,16,59,59,3,13,16,99.0,1242.0,776,80,223,303,1625.0,70,5.96,42,208,2192,9.5
9265,Erik Karlsson,2012-13,22.0,4,26,60,60,5,21,26,112.0,1207.0,60,5,21,26,112.0,82,5.53,56,304,2486,9.1
9266,Erik Karlsson,2013-14,23.0,5,45,75,75,13,32,45,182.0,1764.0,135,18,53,71,294.0,82,5.46,52,291,2492,9.0
9267,Erik Karlsson,2014-15,24.0,6,78,81,81,19,59,78,261.0,2051.0,216,37,112,149,555.0,82,5.32,47,271,2439,8.9
9268,Erik Karlsson,2015-16,25.0,7,14,17,17,6,8,14,79.0,462.0,233,43,120,163,634.0,48,5.31,29,160,1399,9.1
9269,Erik Karlsson,2016-17,26.0,8,74,82,82,20,54,74,257.0,2220.0,315,63,174,237,891.0,82,5.34,48,269,2463,8.9
9270,Erik Karlsson,2017-18,27.0,9,66,82,82,21,45,66,292.0,2235.0,397,84,219,303,1183.0,82,5.32,47,251,2453,8.9
9271,Erik Karlsson,2018-19,28.0,10,82,82,82,16,66,82,248.0,2375.0,479,100,285,385,1431.0,82,5.34,48,255,2438,9.0
9272,Erik Karlsson,2019-20,29.0,11,71,77,77,17,54,71,218.0,2066.0,556,117,339,456,1649.0,82,5.45,47,245,2478,9.0
9273,Erik Karlsson,2020-21,30.0,12,62,71,71,9,53,62,196.0,1899.0,627,126,392,518,1845.0,82,5.86,50,250,2620,9.2
9274,Erik Karlsson,2021-22,31.0,13,45,53,53,3,42,45,169.0,1298.0,680,129,434,563,2014.0,82,5.96,47,239,2579,9.5
9275,Erik Karlsson,2022-23,32.0,14,40,56,56,6,34,40,120.0,1373.0,736,135,468,603,2134.0,70,5.96,42,208,2192,9.5
9276,Erik Rasmussen,2000-01,23.0,4,5,21,21,2,3,5,28.0,,21,2,3,5,28.0,82,5.28,57,380,2242,9.6
9277,Erik Rasmussen,2001-02,24.0,5,10,42,42,3,7,10,40.0,519.0,63,5,10,15,68.0,82,5.27,57,359,2285,9.4
9278,Erik Rasmussen,2002-03,25.0,6,14,67,67,8,6,14,76.0,767.0,130,13,16,29,144.0,82,5.49,53,331,2294,9.8
9279,Erik Rasmussen,2003-04,26.0,7,31,82,82,12,19,31,95.0,1130.0,212,25,35,60,239.0,82,5.51,63,376,2272,9.9
9280,Erik Rasmussen,2004-05,27.0,8,19,69,69,8,11,19,89.0,900.0,281,33,46,79,328.0,82,5.24,53,338,2262,9.5
9281,Erik Rasmussen,2005-06,28.0,9,16,57,57,4,12,16,75.0,778.0,338,37,58,95,403.0,82,5.31,60,363,2326,9.4
9282,Erik Rasmussen,2006-07,29.0,10,13,69,69,7,6,13,68.0,798.0,407,44,64,108,471.0,82,5.14,57,348,2300,9.2
9283,Erik Rasmussen,2008-09,31.0,11,10,67,67,5,5,10,45.0,473.0,474,49,69,118,516.0,82,6.05,85,480,2458,10.1
9284,Erik Rasmussen,2009-10,32.0,12,10,71,71,3,7,10,80.0,672.0,545,52,76,128,596.0,82,5.76,70,398,2426,9.7
9285,Erik Reitz,2008-09,26.0,4,0,5,5,0,0,0,0.0,66.0,5,0,0,0,0.0,82,6.05,85,480,2458,10.1
9286,Erik Reitz,2009-10,27.0,5,0,1,1,0,0,0,0.0,11.0,6,0,0,0,0.0,82,5.76,70,398,2426,9.7
9287,Erik Reitz,2011-12,29.0,6,2,42,42,1,1,2,22.0,419.0,48,1,1,2,22.0,82,5.7,65,341,2477,9.4
9288,Erik Westrum,2006-07,27.0,4,2,15,15,1,1,2,29.0,240.0,15,1,1,2,29.0,82,5.14,57,348,2300,9.2
9289,Erik Westrum,2008-09,29.0,5,1,10,10,0,1,1,16.0,108.0,25,1,2,3,45.0,82,6.05,85,480,2458,10.1
9290,Erik Westrum,2009-10,30.0,6,0,2,2,0,0,0,0.0,7.0,27,1,2,3,45.0,82,5.76,70,398,2426,9.7
9291,Ernie Godden,1984-85,23.0,4,2,5,5,1,1,2,5.0,,5,1,1,2,5.0,80,8.03,73,320,2489,12.9
9292,Errol Rausse,1982-83,23.0,4,8,24,24,6,2,8,24.0,,24,6,2,8,24.0,80,7.03,61,280,2352,12.0
9293,Errol Rausse,1983-84,24.0,5,2,5,5,1,1,2,3.0,,29,7,3,10,27.0,80,7.69,77,340,2441,12.6
9294,Errol Rausse,1984-85,25.0,6,0,2,2,0,0,0,0.0,,31,7,3,10,27.0,80,8.03,73,320,2489,12.9
9295,Esa Lindell,2018-19,24.0,4,0,4,4,0,0,0,2.0,56.0,4,0,0,0,2.0,82,5.34,48,255,2438,9.0
9296,Esa Lindell,2019-20,25.0,5,18,73,73,6,12,18,99.0,1597.0,77,6,12,18,101.0,82,5.45,47,245,2478,9.0
9297,Esa Lindell,2020-21,26.0,6,27,80,80,7,20,27,137.0,1766.0,157,13,32,45,238.0,82,5.86,50,250,2620,9.2
9298,Esa Lindell,2021-22,27.0,7,32,82,82,11,21,32,132.0,1995.0,239,24,53,77,370.0,82,5.96,47,239,2579,9.5
9299,Esa Lindell,2022-23,28.0,8,23,69,69,3,20,23,98.0,1615.0,308,27,73,100,468.0,70,5.96,42,208,2192,9.5
9300,Esa Pirnes,2006-07,29.0,4,11,57,57,3,8,11,57.0,670.0,57,3,8,11,57.0,82,5.14,57,348,2300,9.2
9301,Esa Tikkanen,1988-89,24.0,4,13,35,35,7,6,13,47.0,,35,7,6,13,47.0,80,7.94,82,370,2484,12.8
9302,Esa Tikkanen,1989-90,25.0,5,78,76,76,34,44,78,126.0,,111,41,50,91,173.0,80,7.34,72,344,2400,12.2
9303,Esa Tikkanen,1990-91,26.0,6,74,80,80,23,51,74,142.0,,191,64,101,165,315.0,80,7.43,89,437,2435,12.2
9304,Esa Tikkanen,1991-92,27.0,7,78,67,67,31,47,78,151.0,,258,95,148,243,466.0,80,7.48,85,403,2430,12.3
9305,Esa Tikkanen,1992-93,28.0,8,63,79,79,30,33,63,199.0,,337,125,181,306,665.0,80,7.37,76,367,2421,12.2
9306,Esa Tikkanen,1993-94,29.0,9,69,79,79,27,42,69,235.0,,416,152,223,375,900.0,80,6.91,71,366,2385,11.6
9307,Esa Tikkanen,1994-95,30.0,10,28,40,40,12,16,28,117.0,,456,164,239,403,1017.0,80,6.96,77,402,2440,11.4
9308,Esa Tikkanen,1995-96,31.0,11,40,81,81,16,24,40,202.0,,537,180,263,443,1219.0,84,7.25,87,443,2603,11.7
9309,Esa Tikkanen,1996-97,32.0,12,54,83,83,22,32,54,257.0,,620,202,295,497,1476.0,84,6.48,76,407,2545,10.7
9310,Esa Tikkanen,1997-98,33.0,13,35,43,43,12,23,35,107.0,,663,214,318,532,1583.0,48,5.97,37,209,1408,10.2
9311,Esa Tikkanen,1998-99,34.0,14,44,58,58,14,30,44,95.0,,721,228,348,576,1678.0,82,6.29,74,413,2481,10.4
9312,Esa Tikkanen,1999-00,35.0,15,30,76,76,13,17,30,133.0,,797,241,365,606,1811.0,82,5.83,55,336,2444,9.8
9313,Esa Tikkanen,2000-01,36.0,16,21,48,48,3,18,21,67.0,,845,244,383,627,1878.0,82,5.28,57,380,2242,9.6
9314,Esa Tikkanen,2001-02,37.0,17,3,32,32,0,3,3,25.0,436.0,877,244,386,630,1903.0,82,5.27,57,359,2285,9.4
9315,Espen Knutsen,2000-01,29.0,4,3,19,19,3,0,3,21.0,,19,3,0,3,21.0,82,5.28,57,380,2242,9.6
9316,Espen Knutsen,2003-04,32.0,5,53,66,66,11,42,53,62.0,1054.0,85,14,42,56,83.0,82,5.51,63,376,2272,9.9
9317,Espen Knutsen,2004-05,33.0,6,42,77,77,11,31,42,102.0,1559.0,162,25,73,98,185.0,82,5.24,53,338,2262,9.5
9318,Espen Knutsen,2005-06,34.0,7,9,31,31,5,4,9,28.0,519.0,193,30,77,107,213.0,82,5.31,60,363,2326,9.4
9319,Espen Knutsen,2006-07,35.0,8,4,14,14,0,4,4,11.0,216.0,207,30,81,111,224.0,82,5.14,57,348,2300,9.2
9320,Ethan Bear,2020-21,23.0,4,4,18,18,1,3,4,20.0,335.0,18,1,3,4,20.0,82,5.86,50,250,2620,9.2
9321,Ethan Bear,2022-23,25.0,5,21,71,71,5,16,21,99.0,1560.0,89,6,19,25,119.0,70,5.96,42,208,2192,9.5
9322,Ethan Moreau,1998-99,23.0,4,1,8,8,0,1,1,1.0,,8,0,1,1,1.0,82,6.29,74,413,2481,10.4
9323,Ethan Moreau,1999-00,24.0,5,31,82,82,15,16,31,114.0,,90,15,17,32,115.0,82,5.83,55,336,2444,9.8
9324,Ethan Moreau,2000-01,25.0,6,18,54,54,9,9,18,87.0,,144,24,26,50,202.0,82,5.28,57,380,2242,9.6
9325,Ethan Moreau,2001-02,26.0,7,21,80,80,10,11,21,96.0,990.0,224,34,37,71,298.0,82,5.27,57,359,2285,9.4
9326,Ethan Moreau,2002-03,27.0,8,27,73,73,17,10,27,106.0,1103.0,297,51,47,98,404.0,82,5.49,53,331,2294,9.8
9327,Ethan Moreau,2003-04,28.0,9,19,68,68,9,10,19,97.0,964.0,365,60,57,117,501.0,82,5.51,63,376,2272,9.9
9328,Ethan Moreau,2004-05,29.0,10,16,80,80,11,5,16,129.0,1017.0,445,71,62,133,630.0,82,5.24,53,338,2262,9.5
9329,Ethan Moreau,2005-06,30.0,11,31,78,78,14,17,31,137.0,1054.0,523,85,79,164,767.0,82,5.31,60,363,2326,9.4
9330,Ethan Moreau,2006-07,31.0,12,32,81,81,20,12,32,180.0,1221.0,604,105,91,196,947.0,82,5.14,57,348,2300,9.2
9331,Ethan Moreau,2008-09,33.0,13,27,74,74,11,16,27,151.0,1183.0,678,116,107,223,1098.0,82,6.05,85,480,2458,10.1
9332,Ethan Moreau,2009-10,34.0,14,1,7,7,1,0,1,18.0,106.0,685,117,107,224,1116.0,82,5.76,70,398,2426,9.7
9333,Ethan Moreau,2010-11,35.0,15,9,25,25,5,4,9,54.0,398.0,710,122,111,233,1170.0,82,5.44,62,351,2383,9.4
9334,Ethan Moreau,2011-12,36.0,16,26,77,77,14,12,26,159.0,1183.0,787,136,123,259,1329.0,82,5.7,65,341,2477,9.4
9335,Ethan Moreau,2012-13,37.0,17,18,76,76,9,9,18,143.0,1095.0,863,145,132,277,1472.0,82,5.53,56,304,2486,9.1
9336,Ethan Moreau,2013-14,38.0,18,6,37,37,1,5,6,56.0,462.0,900,146,137,283,1528.0,82,5.46,52,291,2492,9.0
9337,Ethan Moreau,2014-15,39.0,19,4,28,28,1,3,4,29.0,295.0,928,147,140,287,1557.0,82,5.32,47,271,2439,8.9
9338,Evan Bouchard,2021-22,22.0,4,1,7,7,1,0,1,10.0,86.0,7,1,0,1,10.0,82,5.96,47,239,2579,9.5
9339,Evan Brophey,2013-14,27.0,4,0,1,1,0,0,0,1.0,7.0,1,0,0,0,1.0,82,5.46,52,291,2492,9.0
9340,Evan Brophey,2014-15,28.0,5,0,3,3,0,0,0,0.0,13.0,4,0,0,0,1.0,82,5.32,47,271,2439,8.9
9341,Evan McEneny,2019-20,25.0,4,0,1,1,0,0,0,1.0,15.0,1,0,0,0,1.0,82,5.45,47,245,2478,9.0
9342,Evan Oberg,2012-13,24.0,4,0,2,2,0,0,0,0.0,13.0,2,0,0,0,0.0,82,5.53,56,304,2486,9.1
9343,Evan Oberg,2013-14,25.0,5,0,2,2,0,0,0,1.0,20.0,4,0,0,0,1.0,82,5.46,52,291,2492,9.0
9344,Evan Oberg,2014-15,26.0,6,0,3,3,0,0,0,3.0,30.0,7,0,0,0,4.0,82,5.32,47,271,2439,8.9
9345,Evan Rodrigues,2018-19,25.0,4,2,2,2,1,1,2,8.0,24.0,2,1,1,2,8.0,82,5.34,48,255,2438,9.0
9346,Evan Rodrigues,2019-20,26.0,5,6,30,30,4,2,6,51.0,388.0,32,5,3,8,59.0,82,5.45,47,245,2478,9.0
9347,Evan Rodrigues,2020-21,27.0,6,25,48,48,7,18,25,91.0,669.0,80,12,21,33,150.0,82,5.86,50,250,2620,9.2
9348,Evan Rodrigues,2021-22,28.0,7,29,74,74,9,20,29,168.0,1171.0,154,21,41,62,318.0,82,5.96,47,239,2579,9.5
9349,Evan Rodrigues,2022-23,29.0,8,10,45,45,6,4,10,75.0,508.0,199,27,45,72,393.0,70,5.96,42,208,2192,9.5
9350,Evander Kane,2012-13,21.0,4,26,66,66,14,12,26,127.0,924.0,66,14,12,26,127.0,82,5.53,56,304,2486,9.1
9351,Evander Kane,2013-14,22.0,5,43,73,73,19,24,43,234.0,1304.0,139,33,36,69,361.0,82,5.46,52,291,2492,9.0
9352,Evander Kane,2014-15,23.0,6,57,74,74,30,27,57,287.0,1296.0,213,63,63,126,648.0,82,5.32,47,271,2439,8.9
9353,Evander Kane,2015-16,24.0,7,33,48,48,17,16,33,190.0,982.0,261,80,79,159,838.0,48,5.31,29,160,1399,9.1
9354,Evander Kane,2016-17,25.0,8,41,63,63,19,22,41,250.0,1278.0,324,99,101,200,1088.0,82,5.34,48,269,2463,8.9
9355,Evander Kane,2017-18,26.0,9,22,37,37,10,12,22,126.0,715.0,361,109,113,222,1214.0,82,5.32,47,251,2453,8.9
9356,Evander Kane,2018-19,27.0,10,35,65,65,20,15,35,271.0,1367.0,426,129,128,257,1485.0,82,5.34,48,255,2438,9.0
9357,Evander Kane,2019-20,28.0,11,43,70,70,28,15,43,260.0,1344.0,496,157,143,300,1745.0,82,5.45,47,245,2478,9.0
9358,Evander Kane,2020-21,29.0,12,54,78,78,29,25,54,307.0,1527.0,574,186,168,354,2052.0,82,5.86,50,250,2620,9.2
9359,Evander Kane,2021-22,30.0,13,56,75,75,30,26,56,268.0,1381.0,649,216,194,410,2320.0,82,5.96,47,239,2579,9.5
9360,Evander Kane,2022-23,31.0,14,47,64,64,26,21,47,216.0,1250.0,713,242,215,457,2536.0,70,5.96,42,208,2192,9.5
9361,Everett Sanipass,1989-90,21.0,4,4,7,7,1,3,4,9.0,,7,1,3,4,9.0,80,7.34,72,344,2400,12.2
9362,Everett Sanipass,1990-91,22.0,5,20,57,57,8,12,20,55.0,,64,9,15,24,64.0,80,7.43,89,437,2435,12.2
9363,Everett Sanipass,1991-92,23.0,6,15,50,50,6,9,15,51.0,,114,15,24,39,115.0,80,7.48,85,403,2430,12.3
9364,Everett Sanipass,1992-93,24.0,7,10,21,21,5,5,10,32.0,,135,20,29,49,147.0,80,7.37,76,367,2421,12.2
9365,Everett Sanipass,1993-94,25.0,8,10,29,29,5,5,10,38.0,,164,25,34,59,185.0,80,6.91,71,366,2385,11.6
9366,Evgeni Malkin,2009-10,23.0,4,85,78,78,33,52,85,242.0,1494.0,78,33,52,85,242.0,82,5.76,70,398,2426,9.7
9367,Evgeni Malkin,2010-11,24.0,5,106,82,82,47,59,106,272.0,1748.0,160,80,111,191,514.0,82,5.44,62,351,2383,9.4
9368,Evgeni Malkin,2011-12,25.0,6,113,82,82,35,78,113,290.0,1846.0,242,115,189,304,804.0,82,5.7,65,341,2477,9.4
9369,Evgeni Malkin,2012-13,26.0,7,77,67,67,28,49,77,268.0,1397.0,309,143,238,381,1072.0,82,5.53,56,304,2486,9.1
9370,Evgeni Malkin,2013-14,27.0,8,37,43,43,15,22,37,182.0,852.0,352,158,260,418,1254.0,82,5.46,52,291,2492,9.0
9371,Evgeni Malkin,2014-15,28.0,9,109,75,75,50,59,109,339.0,1577.0,427,208,319,527,1593.0,82,5.32,47,271,2439,8.9
9372,Evgeni Malkin,2015-16,29.0,10,33,31,31,9,24,33,99.0,611.0,458,217,343,560,1692.0,48,5.31,29,160,1399,9.1
9373,Evgeni Malkin,2016-17,30.0,11,72,60,60,23,49,72,191.0,1204.0,518,240,392,632,1883.0,82,5.34,48,269,2463,8.9
9374,Evgeni Malkin,2017-18,31.0,12,70,69,69,28,42,70,212.0,1309.0,587,268,434,702,2095.0,82,5.32,47,251,2453,8.9
9375,Evgeni Malkin,2018-19,32.0,13,58,57,57,27,31,58,162.0,1104.0,644,295,465,760,2257.0,82,5.34,48,255,2438,9.0
9376,Evgeni Malkin,2019-20,33.0,14,72,62,62,33,39,72,191.0,1154.0,706,328,504,832,2448.0,82,5.45,47,245,2478,9.0
9377,Evgeni Malkin,2020-21,34.0,15,98,78,78,42,56,98,239.0,1481.0,784,370,560,930,2687.0,82,5.86,50,250,2620,9.2
9378,Evgeni Malkin,2021-22,35.0,16,72,68,68,21,51,72,187.0,1279.0,852,391,611,1002,2874.0,82,5.96,47,239,2579,9.5
9379,Evgeni Malkin,2022-23,36.0,17,74,55,55,25,49,74,171.0,1074.0,907,416,660,1076,3045.0,70,5.96,42,208,2192,9.5
9380,Evgenii Dadonov,2012-13,23.0,4,0,4,4,0,0,0,4.0,53.0,4,0,0,0,4.0,82,5.53,56,304,2486,9.1
9381,Evgenii Dadonov,2013-14,24.0,5,17,36,36,8,9,17,60.0,513.0,40,8,9,17,64.0,82,5.46,52,291,2492,9.0
9382,Evgenii Dadonov,2014-15,25.0,6,3,15,15,2,1,3,21.0,151.0,55,10,10,20,85.0,82,5.32,47,271,2439,8.9
9383,Evgenii Dadonov,2020-21,31.0,7,65,74,74,28,37,65,188.0,1384.0,129,38,47,85,273.0,82,5.86,50,250,2620,9.2
9384,Evgenii Dadonov,2021-22,32.0,8,70,82,82,28,42,70,195.0,1506.0,211,66,89,155,468.0,82,5.96,47,239,2579,9.5
9385,Evgenii Dadonov,2022-23,33.0,9,47,69,69,25,22,47,167.0,1180.0,280,91,111,202,635.0,70,5.96,42,208,2192,9.5
9386,Evgeny Artyukhin,2008-09,25.0,4,17,72,72,4,13,17,79.0,628.0,72,4,13,17,79.0,82,6.05,85,480,2458,10.1
9387,Evgeny Artyukhin,2011-12,28.0,5,16,73,73,6,10,16,100.0,779.0,145,10,23,33,179.0,82,5.7,65,341,2477,9.4
9388,Evgeny Artyukhin,2012-13,29.0,6,16,54,54,9,7,16,42.0,482.0,199,19,30,49,221.0,82,5.53,56,304,2486,9.1
9389,Evgeny Davydov,1994-95,27.0,4,7,12,12,4,3,7,32.0,,12,4,3,7,32.0,80,6.96,77,402,2440,11.4
9390,Evgeny Davydov,1995-96,28.0,5,49,79,79,28,21,49,176.0,,91,32,24,56,208.0,84,7.25,87,443,2603,11.7
9391,Evgeny Davydov,1996-97,29.0,6,20,61,61,7,13,20,66.0,,152,39,37,76,274.0,84,6.48,76,407,2545,10.7
9392,Evgeny Davydov,1997-98,30.0,7,3,3,3,1,2,3,2.0,,155,40,39,79,276.0,48,5.97,37,209,1408,10.2
9393,Evgeny Grachev,2013-14,23.0,4,0,8,8,0,0,0,3.0,62.0,8,0,0,0,3.0,82,5.46,52,291,2492,9.0
9394,Evgeny Grachev,2014-15,24.0,5,4,26,26,1,3,4,14.0,243.0,34,1,3,4,17.0,82,5.32,47,271,2439,8.9
9395,Evgeny Korolev,2002-03,24.0,4,3,17,17,1,2,3,7.0,275.0,17,1,2,3,7.0,82,5.49,53,331,2294,9.8
9396,Evgeny Korolev,2003-04,25.0,5,0,8,8,0,0,0,11.0,133.0,25,1,2,3,18.0,82,5.51,63,376,2272,9.9
9397,Evgeny Korolev,2004-05,26.0,6,2,17,17,0,2,2,9.0,176.0,42,1,4,5,27.0,82,5.24,53,338,2262,9.5
9398,Evgeny Kuznetsov,2016-17,24.0,4,9,17,17,3,6,9,22.0,229.0,17,3,6,9,22.0,82,5.34,48,269,2463,8.9
9399,Evgeny Kuznetsov,2017-18,25.0,5,37,80,80,11,26,37,127.0,1066.0,97,14,32,46,149.0,82,5.32,47,251,2453,8.9
9400,Evgeny Kuznetsov,2018-19,26.0,6,77,82,82,20,57,77,193.0,1428.0,179,34,89,123,342.0,82,5.34,48,255,2438,9.0
9401,Evgeny Kuznetsov,2019-20,27.0,7,59,82,82,19,40,59,170.0,1390.0,261,53,129,182,512.0,82,5.45,47,245,2478,9.0
9402,Evgeny Kuznetsov,2020-21,28.0,8,83,79,79,27,56,83,187.0,1486.0,340,80,185,265,699.0,82,5.86,50,250,2620,9.2
9403,Evgeny Kuznetsov,2021-22,29.0,9,72,76,76,21,51,72,193.0,1428.0,416,101,236,337,892.0,82,5.96,47,239,2579,9.5
9404,Evgeny Kuznetsov,2022-23,30.0,10,52,63,63,19,33,52,129.0,1124.0,479,120,269,389,1021.0,70,5.96,42,208,2192,9.5
9405,Evgeny Medvedev,2018-19,36.0,4,12,45,45,4,8,12,71.0,847.0,45,4,8,12,71.0,82,5.34,48,255,2438,9.0
9406,Evgeny Namestnikov,1996-97,25.0,4,5,17,17,0,5,5,11.0,,17,0,5,5,11.0,84,6.48,76,407,2545,10.7
9407,Evgeny Namestnikov,1997-98,26.0,5,3,16,16,0,3,3,18.0,,33,0,8,8,29.0,48,5.97,37,209,1408,10.2
9408,Evgeny Namestnikov,1999-00,28.0,6,0,2,2,0,0,0,1.0,,35,0,8,8,30.0,82,5.83,55,336,2444,9.8
9409,Evgeny Namestnikov,2000-01,29.0,7,1,6,6,0,1,1,2.0,,41,0,9,9,32.0,82,5.28,57,380,2242,9.6
9410,Evgeny Namestnikov,2002-03,31.0,8,0,2,2,0,0,0,3.0,32.0,43,0,9,9,35.0,82,5.49,53,331,2294,9.8
9411,Evgeny Svechnikov,2019-20,23.0,4,0,2,2,0,0,0,4.0,26.0,2,0,0,0,4.0,82,5.45,47,245,2478,9.0
9412,Evgeny Svechnikov,2020-21,24.0,5,4,14,14,2,2,4,15.0,123.0,16,2,2,4,19.0,82,5.86,50,250,2620,9.2
9413,Evgeny Svechnikov,2022-23,26.0,6,0,4,4,0,0,0,7.0,33.0,20,2,2,4,26.0,70,5.96,42,208,2192,9.5
9414,Fabian Brunnstrom,2011-12,26.0,4,29,55,55,17,12,29,81.0,639.0,55,17,12,29,81.0,82,5.7,65,341,2477,9.4
9415,Fabian Brunnstrom,2012-13,27.0,5,11,44,44,2,9,11,38.0,469.0,99,19,21,40,119.0,82,5.53,56,304,2486,9.1
9416,Fabian Brunnstrom,2014-15,29.0,6,1,5,5,0,1,1,6.0,45.0,104,19,22,41,125.0,82,5.32,47,271,2439,8.9
9417,Fedor Fedorov,2005-06,24.0,4,1,7,7,0,1,1,2.0,64.0,7,0,1,1,2.0,82,5.31,60,363,2326,9.4
9418,Fedor Fedorov,2006-07,25.0,5,1,8,8,0,1,1,10.0,88.0,15,0,2,2,12.0,82,5.14,57,348,2300,9.2
9419,Fedor Fedorov,2008-09,27.0,6,0,3,3,0,0,0,2.0,29.0,18,0,2,2,14.0,82,6.05,85,480,2458,10.1
9420,Fedor Tyutin,2006-07,23.0,4,7,25,25,2,5,7,33.0,503.0,25,2,5,7,33.0,82,5.14,57,348,2300,9.2
9421,Fedor Tyutin,2008-09,25.0,5,25,77,77,6,19,25,102.0,1583.0,102,8,24,32,135.0,82,6.05,85,480,2458,10.1
9422,Fedor Tyutin,2009-10,26.0,6,14,66,66,2,12,14,75.0,1322.0,168,10,36,46,210.0,82,5.76,70,398,2426,9.7
9423,Fedor Tyutin,2010-11,27.0,7,20,82,82,5,15,20,131.0,1676.0,250,15,51,66,341.0,82,5.44,62,351,2383,9.4
9424,Fedor Tyutin,2011-12,28.0,8,34,82,82,9,25,34,167.0,1928.0,332,24,76,100,508.0,82,5.7,65,341,2477,9.4
9425,Fedor Tyutin,2012-13,29.0,9,32,80,80,6,26,32,149.0,1882.0,412,30,102,132,657.0,82,5.53,56,304,2486,9.1
9426,Fedor Tyutin,2013-14,30.0,10,27,80,80,7,20,27,128.0,1816.0,492,37,122,159,785.0,82,5.46,52,291,2492,9.0
9427,Fedor Tyutin,2014-15,31.0,11,26,66,66,5,21,26,124.0,1593.0,558,42,143,185,909.0,82,5.32,47,271,2439,8.9
9428,Fedor Tyutin,2015-16,32.0,12,22,48,48,4,18,22,56.0,1157.0,606,46,161,207,965.0,48,5.31,29,160,1399,9.1
9429,Fedor Tyutin,2016-17,33.0,13,26,69,69,4,22,26,87.0,1477.0,675,50,183,233,1052.0,82,5.34,48,269,2463,8.9
9430,Fedor Tyutin,2017-18,34.0,14,15,67,67,3,12,15,56.0,1335.0,742,53,195,248,1108.0,82,5.32,47,251,2453,8.9
9431,Fedor Tyutin,2018-19,35.0,15,3,61,61,1,2,3,25.0,1073.0,803,54,197,251,1133.0,82,5.34,48,255,2438,9.0
9432,Fedor Tyutin,2019-20,36.0,16,13,69,69,1,12,13,46.0,1307.0,872,55,209,264,1179.0,82,5.45,47,245,2478,9.0
9433,Fernando Pisani,2005-06,29.0,4,13,35,35,8,5,13,32.0,375.0,35,8,5,13,32.0,82,5.31,60,363,2326,9.4
9434,Fernando Pisani,2006-07,30.0,5,30,76,76,16,14,30,99.0,971.0,111,24,19,43,131.0,82,5.14,57,348,2300,9.2
9435,Fernando Pisani,2008-09,32.0,6,37,80,80,18,19,37,131.0,1108.0,191,42,38,80,262.0,82,6.05,85,480,2458,10.1
9436,Fernando Pisani,2009-10,33.0,7,28,77,77,14,14,28,142.0,1301.0,268,56,52,108,404.0,82,5.76,70,398,2426,9.7
9437,Fernando Pisani,2010-11,34.0,8,22,56,56,13,9,22,96.0,926.0,324,69,61,130,500.0,82,5.44,62,351,2383,9.4
9438,Fernando Pisani,2011-12,35.0,9,15,38,38,7,8,15,72.0,582.0,362,76,69,145,572.0,82,5.7,65,341,2477,9.4
9439,Fernando Pisani,2012-13,36.0,10,8,40,40,4,4,8,54.0,583.0,402,80,73,153,626.0,82,5.53,56,304,2486,9.1
9440,Fernando Pisani,2013-14,37.0,11,16,60,60,7,9,16,72.0,754.0,462,87,82,169,698.0,82,5.46,52,291,2492,9.0
9441,Filip Chlapik,2020-21,23.0,4,4,20,20,1,3,4,21.0,201.0,20,1,3,4,21.0,82,5.86,50,250,2620,9.2
9442,Filip Chlapik,2021-22,24.0,5,1,5,5,1,0,1,9.0,69.0,25,2,3,5,30.0,82,5.96,47,239,2579,9.5
9443,Filip Chlapik,2022-23,25.0,6,6,31,31,3,3,6,27.0,272.0,56,5,6,11,57.0,70,5.96,42,208,2192,9.5
9444,Filip Chytil,2020-21,21.0,4,3,9,9,1,2,3,21.0,122.0,9,1,2,3,21.0,82,5.86,50,250,2620,9.2
9445,Filip Chytil,2021-22,22.0,5,23,75,75,11,12,23,133.0,1034.0,84,12,14,26,154.0,82,5.96,47,239,2579,9.5
9446,Filip Chytil,2022-23,23.0,6,23,60,60,14,9,23,114.0,890.0,144,26,23,49,268.0,70,5.96,42,208,2192,9.5
9447,Filip Forsberg,2015-16,21.0,4,1,5,5,0,1,1,14.0,77.0,5,0,1,1,14.0,48,5.31,29,160,1399,9.1
9448,Filip Forsberg,2016-17,22.0,5,5,13,13,1,4,5,20.0,148.0,18,1,5,6,34.0,82,5.34,48,269,2463,8.9
9449,Filip Forsberg,2017-18,23.0,6,63,82,82,26,37,63,237.0,1421.0,100,27,42,69,271.0,82,5.32,47,251,2453,8.9
9450,Filip Forsberg,2018-19,24.0,7,64,82,82,33,31,64,247.0,1562.0,182,60,73,133,518.0,82,5.34,48,255,2438,9.0
9451,Filip Forsberg,2019-20,25.0,8,58,82,82,31,27,58,234.0,1518.0,264,91,100,191,752.0,82,5.45,47,245,2478,9.0
9452,Filip Forsberg,2020-21,26.0,9,64,67,67,26,38,64,179.0,1171.0,331,117,138,255,931.0,82,5.86,50,250,2620,9.2
9453,Filip Forsberg,2021-22,27.0,10,50,64,64,28,22,50,217.0,1191.0,395,145,160,305,1148.0,82,5.96,47,239,2579,9.5
9454,Filip Forsberg,2022-23,28.0,11,48,63,63,21,27,48,198.0,1093.0,458,166,187,353,1346.0,70,5.96,42,208,2192,9.5
9455,Filip Hronek,2021-22,24.0,4,23,46,46,5,18,23,73.0,918.0,46,5,18,23,73.0,82,5.96,47,239,2579,9.5
9456,Filip Hronek,2022-23,25.0,5,31,65,65,9,22,31,125.0,1553.0,111,14,40,54,198.0,70,5.96,42,208,2192,9.5
9457,Filip Kuba,2001-02,25.0,4,1,5,5,0,1,1,5.0,112.0,5,0,1,1,5.0,82,5.27,57,359,2285,9.4
9458,Filip Kuba,2002-03,26.0,5,6,13,13,1,5,6,16.0,180.0,18,1,6,7,21.0,82,5.49,53,331,2294,9.8
9459,Filip Kuba,2003-04,27.0,6,30,75,75,9,21,30,141.0,1820.0,93,10,27,37,162.0,82,5.51,63,376,2272,9.9
9460,Filip Kuba,2004-05,28.0,7,24,62,62,5,19,24,101.0,1581.0,155,15,46,61,263.0,82,5.24,53,338,2262,9.5
9461,Filip Kuba,2005-06,29.0,8,29,78,78,8,21,29,129.0,1867.0,233,23,67,90,392.0,82,5.31,60,363,2326,9.4
9462,Filip Kuba,2006-07,30.0,9,24,77,77,5,19,24,114.0,1856.0,310,28,86,114,506.0,82,5.14,57,348,2300,9.2
9463,Filip Kuba,2008-09,32.0,10,25,65,65,6,19,25,69.0,1415.0,375,34,105,139,575.0,82,6.05,85,480,2458,10.1
9464,Filip Kuba,2009-10,33.0,11,37,81,81,15,22,37,106.0,1637.0,456,49,127,176,681.0,82,5.76,70,398,2426,9.7
9465,Filip Kuba,2010-11,34.0,12,31,75,75,6,25,31,113.0,1872.0,531,55,152,207,794.0,82,5.44,62,351,2383,9.4
9466,Filip Kuba,2011-12,35.0,13,40,71,71,3,37,40,111.0,1653.0,602,58,189,247,905.0,82,5.7,65,341,2477,9.4
9467,Filip Kuba,2012-13,36.0,14,28,53,53,3,25,28,90.0,1211.0,655,61,214,275,995.0,82,5.53,56,304,2486,9.1
9468,Filip Kuba,2013-14,37.0,15,16,64,64,2,14,16,76.0,1327.0,719,63,228,291,1071.0,82,5.46,52,291,2492,9.0
9469,Filip Kuba,2014-15,38.0,16,32,73,73,6,26,32,78.0,1724.0,792,69,254,323,1149.0,82,5.32,47,271,2439,8.9
9470,Filip Kuba,2015-16,39.0,17,10,44,44,1,9,10,50.0,934.0,836,70,263,333,1199.0,48,5.31,29,160,1399,9.1
9471,Filip Novak,2008-09,26.0,4,0,11,11,0,0,0,5.0,104.0,11,0,0,0,5.0,82,6.05,85,480,2458,10.1
9472,Filip Novak,2009-10,27.0,5,0,6,6,0,0,0,3.0,60.0,17,0,0,0,8.0,82,5.76,70,398,2426,9.7
9473,Filip Zadina,2021-22,22.0,4,3,9,9,1,2,3,18.0,138.0,9,1,2,3,18.0,82,5.96,47,239,2579,9.5
9474,Filip Zadina,2022-23,23.0,5,15,28,28,8,7,15,60.0,425.0,37,9,9,18,78.0,70,5.96,42,208,2192,9.5
9475,Florent Robidoux,1983-84,23.0,4,8,39,39,6,2,8,31.0,,39,6,2,8,31.0,80,7.69,77,340,2441,12.6
9476,Florent Robidoux,1984-85,24.0,5,3,4,4,1,2,3,4.0,,43,7,4,11,35.0,80,8.03,73,320,2489,12.9
9477,Florent Robidoux,1986-87,26.0,6,0,9,9,0,0,0,2.0,,52,7,4,11,37.0,80,7.89,74,336,2448,12.9
9478,Francis Belanger,2003-04,26.0,4,0,10,10,0,0,0,2.0,45.0,10,0,0,0,2.0,82,5.51,63,376,2272,9.9
9479,Francis Bouillon,2002-03,27.0,4,16,74,74,3,13,16,76.0,1174.0,74,3,13,16,76.0,82,5.49,53,331,2294,9.8
9480,Francis Bouillon,2003-04,28.0,5,6,29,29,0,6,6,24.0,389.0,103,3,19,22,100.0,82,5.51,63,376,2272,9.9
9481,Francis Bouillon,2004-05,29.0,6,5,28,28,0,5,5,24.0,526.0,131,3,24,27,124.0,82,5.24,53,338,2262,9.5
9482,Francis Bouillon,2005-06,30.0,7,4,24,24,3,1,4,30.0,459.0,155,6,25,31,154.0,82,5.31,60,363,2326,9.4
9483,Francis Bouillon,2006-07,31.0,8,18,73,73,2,16,18,86.0,1435.0,228,8,41,49,240.0,82,5.14,57,348,2300,9.2
9484,Francis Bouillon,2008-09,33.0,9,22,67,67,3,19,22,75.0,1392.0,295,11,60,71,315.0,82,6.05,85,480,2458,10.1
9485,Francis Bouillon,2009-10,34.0,10,14,62,62,3,11,14,56.0,1135.0,357,14,71,85,371.0,82,5.76,70,398,2426,9.7
9486,Francis Bouillon,2010-11,35.0,11,8,74,74,2,6,8,60.0,1285.0,431,16,77,93,431.0,82,5.44,62,351,2383,9.4
9487,Francis Bouillon,2011-12,36.0,12,9,54,54,5,4,9,51.0,891.0,485,21,81,102,482.0,82,5.7,65,341,2477,9.4
9488,Francis Bouillon,2012-13,37.0,13,11,81,81,3,8,11,86.0,1564.0,566,24,89,113,568.0,82,5.53,56,304,2486,9.1
9489,Francis Bouillon,2013-14,38.0,14,10,44,44,1,9,10,47.0,890.0,610,25,98,123,615.0,82,5.46,52,291,2492,9.0
9490,Francis Bouillon,2014-15,39.0,15,11,66,66,4,7,11,38.0,1158.0,676,29,105,134,653.0,82,5.32,47,271,2439,8.9
9491,Francis Bouillon,2015-16,40.0,16,9,48,48,1,8,9,46.0,868.0,724,30,113,143,699.0,48,5.31,29,160,1399,9.1
9492,Francis Bouillon,2016-17,41.0,17,6,52,52,2,4,6,34.0,920.0,776,32,117,149,733.0,82,5.34,48,269,2463,8.9
9493,Francis Breault,1993-94,26.0,4,5,17,17,1,4,5,12.0,,17,1,4,5,12.0,80,6.91,71,366,2385,11.6
9494,Francis Breault,1994-95,27.0,5,1,6,6,1,0,1,6.0,,23,2,4,6,18.0,80,6.96,77,402,2440,11.4
9495,Francis Breault,1995-96,28.0,6,0,4,4,0,0,0,0.0,,27,2,4,6,18.0,84,7.25,87,443,2603,11.7
9496,Francis Lessard,2004-05,25.0,4,0,5,5,0,0,0,2.0,64.0,5,0,0,0,2.0,82,5.24,53,338,2262,9.5
9497,Francis Lessard,2005-06,26.0,5,2,18,18,0,2,2,7.0,102.0,23,0,2,2,9.0,82,5.31,60,363,2326,9.4
9498,Francis Lessard,2006-07,27.0,6,2,62,62,1,1,2,19.0,277.0,85,1,3,4,28.0,82,5.14,57,348,2300,9.2
9499,Francis Lessard,2008-09,29.0,7,0,6,6,0,0,0,0.0,15.0,91,1,3,4,28.0,82,6.05,85,480,2458,10.1
9500,Francis Lessard,2013-14,34.0,8,0,24,24,0,0,0,6.0,93.0,115,1,3,4,34.0,82,5.46,52,291,2492,9.0
9501,Francis Wathier,2012-13,28.0,4,0,5,5,0,0,0,4.0,26.0,5,0,0,0,4.0,82,5.53,56,304,2486,9.1
9502,Francis Wathier,2013-14,29.0,5,0,3,3,0,0,0,0.0,12.0,8,0,0,0,4.0,82,5.46,52,291,2492,9.0
9503,Francis Wathier,2014-15,30.0,6,0,1,1,0,0,0,0.0,5.0,9,0,0,0,4.0,82,5.32,47,271,2439,8.9
9504,Francis Wathier,2015-16,31.0,7,0,1,1,0,0,0,0.0,6.0,10,0,0,0,4.0,48,5.31,29,160,1399,9.1
9505,Francois Beauchemin,2005-06,25.0,4,0,1,1,0,0,0,1.0,17.0,1,0,0,0,1.0,82,5.31,60,363,2326,9.4
9506,Francois Beauchemin,2008-09,28.0,5,36,72,72,8,28,36,137.0,1668.0,73,8,28,36,138.0,82,6.05,85,480,2458,10.1
9507,Francois Beauchemin,2009-10,29.0,6,28,71,71,7,21,28,128.0,1809.0,144,15,49,64,266.0,82,5.76,70,398,2426,9.7
9508,Francois Beauchemin,2010-11,30.0,7,21,82,82,2,19,21,144.0,2093.0,226,17,68,85,410.0,82,5.44,62,351,2383,9.4
9509,Francois Beauchemin,2011-12,31.0,8,5,20,20,4,1,5,45.0,498.0,246,21,69,90,455.0,82,5.7,65,341,2477,9.4
9510,Francois Beauchemin,2012-13,32.0,9,26,82,82,5,21,26,170.0,2088.0,328,26,90,116,625.0,82,5.53,56,304,2486,9.1
9511,Francois Beauchemin,2013-14,33.0,10,17,81,81,5,12,17,106.0,1869.0,409,31,102,133,731.0,82,5.46,52,291,2492,9.0
9512,Francois Beauchemin,2014-15,34.0,11,22,82,82,8,14,22,139.0,2095.0,491,39,116,155,870.0,82,5.32,47,271,2439,8.9
9513,Francois Beauchemin,2015-16,35.0,12,24,48,48,6,18,24,74.0,1126.0,539,45,134,179,944.0,48,5.31,29,160,1399,9.1
9514,Francois Beauchemin,2016-17,36.0,13,17,70,70,4,13,17,100.0,1617.0,609,49,147,196,1044.0,82,5.34,48,269,2463,8.9
9515,Francois Beauchemin,2017-18,37.0,14,23,64,64,11,12,23,110.0,1456.0,673,60,159,219,1154.0,82,5.32,47,251,2453,8.9
9516,Francois Beauchemin,2018-19,38.0,15,34,82,82,8,26,34,127.0,2057.0,755,68,185,253,1281.0,82,5.34,48,255,2438,9.0
9517,Francois Beauchemin,2019-20,39.0,16,18,81,81,5,13,18,132.0,1743.0,836,73,198,271,1413.0,82,5.45,47,245,2478,9.0
9518,Francois Beauchemin,2020-21,40.0,17,17,67,67,3,14,17,93.0,1160.0,903,76,212,288,1506.0,82,5.86,50,250,2620,9.2
9519,Francois Groleau,1998-99,26.0,4,1,2,2,0,1,1,1.0,,2,0,1,1,1.0,82,6.29,74,413,2481,10.4
9520,Francois Groleau,1999-00,27.0,5,0,5,5,0,0,0,3.0,,7,0,1,1,4.0,82,5.83,55,336,2444,9.8
9521,Francois Groleau,2000-01,28.0,6,0,1,1,0,0,0,3.0,,8,0,1,1,7.0,82,5.28,57,380,2242,9.6
9522,Francois Guay,1992-93,24.0,4,0,1,1,0,0,0,0.0,,1,0,0,0,0.0,80,7.37,76,367,2421,12.2
9523,Francois Leroux,1991-92,21.0,4,0,2,2,0,0,0,0.0,,2,0,0,0,0.0,80,7.48,85,403,2430,12.3
9524,Francois Leroux,1992-93,22.0,5,1,3,3,0,1,1,0.0,,5,0,1,1,0.0,80,7.37,76,367,2421,12.2
9525,Francois Leroux,1993-94,23.0,6,2,1,1,0,2,2,1.0,,6,0,3,3,1.0,80,6.91,71,366,2385,11.6
9526,Francois Leroux,1994-95,24.0,7,0,4,4,0,0,0,0.0,,10,0,3,3,1.0,80,6.96,77,402,2440,11.4
9527,Francois Leroux,1995-96,25.0,8,0,1,1,0,0,0,0.0,,11,0,3,3,1.0,84,7.25,87,443,2603,11.7
9528,Francois Leroux,1996-97,26.0,9,1,23,23,0,1,1,8.0,,34,0,4,4,9.0,84,6.48,76,407,2545,10.7
9529,Francois Leroux,1997-98,27.0,10,2,40,40,0,2,2,19.0,,74,0,6,6,28.0,48,5.97,37,209,1408,10.2
9530,Francois Leroux,1998-99,28.0,11,11,66,66,2,9,11,43.0,,140,2,15,17,71.0,82,6.29,74,413,2481,10.4
9531,Francois Leroux,1999-00,29.0,12,3,59,59,0,3,3,5.0,,199,2,18,20,76.0,82,5.83,55,336,2444,9.8
9532,Francois Leroux,2000-01,30.0,13,3,50,50,1,2,3,14.0,,249,3,20,23,90.0,82,5.28,57,380,2242,9.6
9533,Frank Banham,1999-00,24.0,4,0,3,3,0,0,0,1.0,,3,0,0,0,1.0,82,5.83,55,336,2444,9.8
9534,Frank Banham,2000-01,25.0,5,11,21,21,9,2,11,43.0,,24,9,2,11,44.0,82,5.28,57,380,2242,9.6
9535,Frank Banham,2002-03,27.0,6,0,3,3,0,0,0,4.0,20.0,27,9,2,11,48.0,82,5.49,53,331,2294,9.8
9536,Frank Banham,2005-06,30.0,7,0,5,5,0,0,0,5.0,39.0,32,9,2,11,53.0,82,5.31,60,363,2326,9.4
9537,Frank Bialowas,1996-97,27.0,4,0,3,3,0,0,0,1.0,,3,0,0,0,1.0,84,6.48,76,407,2545,10.7
9538,Frank Corrado,2015-16,22.0,4,0,3,3,0,0,0,4.0,58.0,3,0,0,0,4.0,48,5.31,29,160,1399,9.1
9539,Frank Corrado,2016-17,23.0,5,1,15,15,1,0,1,20.0,188.0,18,1,0,1,24.0,82,5.34,48,269,2463,8.9
9540,Frank Corrado,2017-18,24.0,6,1,10,10,1,0,1,8.0,157.0,28,2,0,2,32.0,82,5.32,47,251,2453,8.9
9541,Frank Corrado,2018-19,25.0,7,6,39,39,1,5,6,46.0,564.0,67,3,5,8,78.0,82,5.34,48,255,2438,9.0
9542,Frank Corrado,2019-20,26.0,8,0,4,4,0,0,0,3.0,43.0,71,3,5,8,81.0,82,5.45,47,245,2478,9.0
9543,Frank Corrado,2020-21,27.0,9,0,5,5,0,0,0,6.0,58.0,76,3,5,8,87.0,82,5.86,50,250,2620,9.2
9544,Frank Nigro,1985-86,25.0,4,21,51,51,6,15,21,77.0,,51,6,15,21,77.0,80,7.73,71,310,2444,12.7
9545,Frank Nigro,1986-87,26.0,5,5,17,17,2,3,5,18.0,,68,8,18,26,95.0,80,7.89,74,336,2448,12.9
9546,Frank Simonetti,1987-88,25.0,4,6,43,43,1,5,6,36.0,,43,1,5,6,36.0,80,7.77,71,321,2447,12.7
9547,Frank Simonetti,1988-89,26.0,5,1,17,17,1,0,1,8.0,,60,2,5,7,44.0,80,7.94,82,370,2484,12.8
9548,Frank Simonetti,1989-90,27.0,6,1,25,25,1,0,1,11.0,,85,3,5,8,55.0,80,7.34,72,344,2400,12.2
9549,Frank Simonetti,1990-91,28.0,7,5,30,30,2,3,5,20.0,,115,5,8,13,75.0,80,7.43,89,437,2435,12.2
9550,Frank Vatrano,2018-19,24.0,4,11,39,39,8,3,11,99.0,463.0,39,8,3,11,99.0,82,5.34,48,255,2438,9.0
9551,Frank Vatrano,2019-20,25.0,5,18,44,44,10,8,18,116.0,593.0,83,18,11,29,215.0,82,5.45,47,245,2478,9.0
9552,Frank Vatrano,2020-21,26.0,6,10,41,41,7,3,10,72.0,444.0,124,25,14,39,287.0,82,5.86,50,250,2620,9.2
9553,Frank Vatrano,2021-22,27.0,7,39,81,81,24,15,39,208.0,1188.0,205,49,29,78,495.0,82,5.96,47,239,2579,9.5
9554,Frank Vatrano,2022-23,28.0,8,34,69,69,16,18,34,162.0,1036.0,274,65,47,112,657.0,70,5.96,42,208,2192,9.5
9555,Frans Nielsen,2009-10,25.0,4,2,15,15,1,1,2,16.0,78.0,15,1,1,2,16.0,82,5.76,70,398,2426,9.7
9556,Frans Nielsen,2010-11,26.0,5,3,16,16,2,1,3,17.0,139.0,31,3,2,5,33.0,82,5.44,62,351,2383,9.4
9557,Frans Nielsen,2011-12,27.0,6,33,59,59,9,24,33,101.0,976.0,90,12,26,38,134.0,82,5.7,65,341,2477,9.4
9558,Frans Nielsen,2012-13,28.0,7,38,76,76,12,26,38,136.0,1308.0,166,24,52,76,270.0,82,5.53,56,304,2486,9.1
9559,Frans Nielsen,2013-14,29.0,8,44,71,71,13,31,44,156.0,1261.0,237,37,83,120,426.0,82,5.46,52,291,2492,9.0
9560,Frans Nielsen,2014-15,30.0,9,47,82,82,17,30,47,133.0,1431.0,319,54,113,167,559.0,82,5.32,47,271,2439,8.9
9561,Frans Nielsen,2015-16,31.0,10,29,48,48,6,23,29,93.0,865.0,367,60,136,196,652.0,48,5.31,29,160,1399,9.1
9562,Frans Nielsen,2016-17,32.0,11,58,80,80,25,33,58,167.0,1467.0,447,85,169,254,819.0,82,5.34,48,269,2463,8.9
9563,Frans Nielsen,2017-18,33.0,12,43,78,78,14,29,43,157.0,1293.0,525,99,198,297,976.0,82,5.32,47,251,2453,8.9
9564,Frans Nielsen,2018-19,34.0,13,52,81,81,20,32,52,181.0,1435.0,606,119,230,349,1157.0,82,5.34,48,255,2438,9.0
9565,Frans Nielsen,2019-20,35.0,14,41,79,79,17,24,41,162.0,1355.0,685,136,254,390,1319.0,82,5.45,47,245,2478,9.0
9566,Frans Nielsen,2020-21,36.0,15,33,79,79,16,17,33,134.0,1250.0,764,152,271,423,1453.0,82,5.86,50,250,2620,9.2
9567,Frans Nielsen,2021-22,37.0,16,35,72,72,10,25,35,120.0,1201.0,836,162,296,458,1573.0,82,5.96,47,239,2579,9.5
9568,Frans Nielsen,2022-23,38.0,17,9,60,60,4,5,9,86.0,821.0,896,166,301,467,1659.0,70,5.96,42,208,2192,9.5
9569,Frantisek Cernik,1987-88,34.0,4,9,49,49,5,4,9,50.0,,49,5,4,9,50.0,80,7.77,71,321,2447,12.7
9570,Frantisek Kaberle,2002-03,29.0,4,16,51,51,1,15,16,76.0,977.0,51,1,15,16,76.0,82,5.49,53,331,2294,9.8
9571,Frantisek Kaberle,2003-04,30.0,5,15,51,51,4,11,15,99.0,1136.0,102,5,26,31,175.0,82,5.51,63,376,2272,9.9
9572,Frantisek Kaberle,2004-05,31.0,6,25,61,61,5,20,25,82.0,1316.0,163,10,46,56,257.0,82,5.24,53,338,2262,9.5
9573,Frantisek Kaberle,2005-06,32.0,7,26,79,79,7,19,26,105.0,1734.0,242,17,65,82,362.0,82,5.31,60,363,2326,9.4
9574,Frantisek Kaberle,2006-07,33.0,8,29,67,67,3,26,29,94.0,1563.0,309,20,91,111,456.0,82,5.14,57,348,2300,9.2
9575,Frantisek Kaberle,2008-09,35.0,9,44,77,77,6,38,44,126.0,1510.0,386,26,129,155,582.0,82,6.05,85,480,2458,10.1
9576,Frantisek Kaberle,2009-10,36.0,10,8,27,27,2,6,8,33.0,419.0,413,28,135,163,615.0,82,5.76,70,398,2426,9.7
9577,Frantisek Kaberle,2010-11,37.0,11,22,80,80,0,22,22,89.0,1372.0,493,28,157,185,704.0,82,5.44,62,351,2383,9.4
9578,Frantisek Kaberle,2011-12,38.0,12,8,30,30,1,7,8,28.0,422.0,523,29,164,193,732.0,82,5.7,65,341,2477,9.4
9579,Frantisek Kucera,1993-94,25.0,4,14,40,40,2,12,14,65.0,,40,2,12,14,65.0,80,6.91,71,366,2385,11.6
9580,Frantisek Kucera,1994-95,26.0,5,13,61,61,3,10,13,82.0,,101,5,22,27,147.0,80,6.96,77,402,2440,11.4
9581,Frantisek Kucera,1995-96,27.0,6,19,71,71,5,14,19,117.0,,172,10,36,46,264.0,84,7.25,87,443,2603,11.7
9582,Frantisek Kucera,1996-97,28.0,7,21,76,76,5,16,21,122.0,,248,15,52,67,386.0,84,6.48,76,407,2545,10.7
9583,Frantisek Kucera,1997-98,29.0,8,20,48,48,3,17,20,73.0,,296,18,69,87,459.0,48,5.97,37,209,1408,10.2
9584,Frantisek Kucera,1998-99,30.0,9,9,54,54,3,6,9,77.0,,350,21,75,96,536.0,82,6.29,74,413,2481,10.4
9585,Frantisek Kucera,1999-00,31.0,10,0,4,4,0,0,0,5.0,,354,21,75,96,541.0,82,5.83,55,336,2444,9.8
9586,Frantisek Kucera,2003-04,35.0,11,9,55,55,2,7,9,60.0,965.0,409,23,82,105,601.0,82,5.51,63,376,2272,9.9
9587,Frantisek Kucera,2004-05,36.0,12,14,56,56,1,13,14,67.0,1157.0,465,24,95,119,668.0,82,5.24,53,338,2262,9.5
9588,Frantisek Musil,1989-90,25.0,4,11,72,72,2,9,11,83.0,,72,2,9,11,83.0,80,7.34,72,344,2400,12.2
9589,Frantisek Musil,1990-91,26.0,5,17,80,80,9,8,17,78.0,,152,11,17,28,161.0,80,7.43,89,437,2435,12.2
9590,Frantisek Musil,1991-92,27.0,6,20,55,55,1,19,20,78.0,,207,12,36,48,239.0,80,7.48,85,403,2430,12.3
9591,Frantisek Musil,1992-93,28.0,7,10,56,56,2,8,10,78.0,,263,14,44,58,317.0,80,7.37,76,367,2421,12.2
9592,Frantisek Musil,1993-94,29.0,8,23,75,75,7,16,23,73.0,,338,21,60,81,390.0,80,6.91,71,366,2385,11.6
9593,Frantisek Musil,1994-95,30.0,9,12,78,78,4,8,12,71.0,,416,25,68,93,461.0,80,6.96,77,402,2440,11.4
9594,Frantisek Musil,1995-96,31.0,10,16,80,80,6,10,16,87.0,,496,31,78,109,548.0,84,7.25,87,443,2603,11.7
9595,Frantisek Musil,1996-97,32.0,11,9,75,75,1,8,9,65.0,,571,32,86,118,613.0,84,6.48,76,407,2545,10.7
9596,Frantisek Musil,1997-98,33.0,12,5,35,35,0,5,5,18.0,,606,32,91,123,631.0,48,5.97,37,209,1408,10.2
9597,Frantisek Musil,1998-99,34.0,13,4,65,65,1,3,4,37.0,,671,33,94,127,668.0,82,6.29,74,413,2481,10.4
9598,Frantisek Musil,1999-00,35.0,14,5,57,57,0,5,5,24.0,,728,33,99,132,692.0,82,5.83,55,336,2444,9.8
9599,Frantisek Musil,2000-01,36.0,15,3,17,17,1,2,3,8.0,,745,34,101,135,700.0,82,5.28,57,380,2242,9.6
9600,Frantisek Musil,2001-02,37.0,16,3,39,39,0,3,3,9.0,560.0,784,34,104,138,709.0,82,5.27,57,359,2285,9.4
9601,Frantisek Musil,2003-04,39.0,17,2,13,13,0,2,2,0.0,145.0,797,34,106,140,709.0,82,5.51,63,376,2272,9.9
9602,Frazer McLaren,2012-13,25.0,4,6,23,23,1,5,6,13.0,139.0,23,1,5,6,13.0,82,5.53,56,304,2486,9.1
9603,Frazer McLaren,2013-14,26.0,5,0,9,9,0,0,0,1.0,38.0,32,1,5,6,14.0,82,5.46,52,291,2492,9.0
9604,Frazer McLaren,2014-15,27.0,6,0,7,7,0,0,0,2.0,34.0,39,1,5,6,16.0,82,5.32,47,271,2439,8.9
9605,Frazer McLaren,2015-16,28.0,7,5,36,36,3,2,5,20.0,187.0,75,4,7,11,36.0,48,5.31,29,160,1399,9.1
9606,Frazer McLaren,2016-17,29.0,8,0,27,27,0,0,0,4.0,108.0,102,4,7,11,40.0,82,5.34,48,269,2463,8.9
9607,Fred Arthur,1983-84,22.0,4,0,3,3,0,0,0,3.0,,3,0,0,0,3.0,80,7.69,77,340,2441,12.6
9608,Fred Arthur,1984-85,23.0,5,8,74,74,1,7,8,33.0,,77,1,7,8,36.0,80,8.03,73,320,2489,12.9
9609,Fred Arthur,1985-86,24.0,6,1,3,3,0,1,1,1.0,,80,1,8,9,37.0,80,7.73,71,310,2444,12.7
9610,Fred Boimistruck,1984-85,23.0,4,13,57,57,2,11,13,48.0,,57,2,11,13,48.0,80,8.03,73,320,2489,12.9
9611,Fred Boimistruck,1985-86,24.0,5,5,26,26,2,3,5,26.0,,83,4,14,18,74.0,80,7.73,71,310,2444,12.7
9612,Fred Knipscheer,1996-97,27.0,4,5,11,11,3,2,5,15.0,,11,3,2,5,15.0,84,6.48,76,407,2545,10.7
9613,Fred Knipscheer,1997-98,28.0,5,4,16,16,3,1,4,20.0,,27,6,3,9,35.0,48,5.97,37,209,1408,10.2
9614,Fred Knipscheer,1998-99,29.0,6,0,1,1,0,0,0,2.0,,28,6,3,9,37.0,82,6.29,74,413,2481,10.4
9615,Fred Perlini,1984-85,22.0,4,5,7,7,2,3,5,12.0,,7,2,3,5,12.0,80,8.03,73,320,2489,12.9
9616,Fred Perlini,1986-87,24.0,5,0,1,1,0,0,0,3.0,,8,2,3,5,15.0,80,7.89,74,336,2448,12.9
9617,Freddie Hamilton,2016-17,25.0,4,0,11,11,0,0,0,13.0,114.0,11,0,0,0,13.0,82,5.34,48,269,2463,8.9
9618,Freddie Hamilton,2017-18,26.0,5,1,18,18,1,0,1,11.0,136.0,29,1,0,1,24.0,82,5.32,47,251,2453,8.9
9619,Freddie Hamilton,2018-19,27.0,6,2,4,4,1,1,2,7.0,51.0,33,2,1,3,31.0,82,5.34,48,255,2438,9.0
9620,Freddie Hamilton,2019-20,28.0,7,2,26,26,2,0,2,30.0,254.0,59,4,1,5,61.0,82,5.45,47,245,2478,9.0
9621,Freddie Hamilton,2020-21,29.0,8,1,16,16,0,1,1,12.0,144.0,75,4,2,6,73.0,82,5.86,50,250,2620,9.2
9622,Freddy Meyer,2006-07,26.0,4,0,1,1,0,0,0,1.0,15.0,1,0,0,0,1.0,82,5.14,57,348,2300,9.2
9623,Freddy Meyer,2008-09,28.0,5,27,57,57,6,21,27,68.0,1023.0,58,6,21,27,69.0,82,6.05,85,480,2458,10.1
9624,Freddy Meyer,2009-10,29.0,6,8,60,60,2,6,8,41.0,1048.0,118,8,27,35,110.0,82,5.76,70,398,2426,9.7
9625,Freddy Meyer,2010-11,30.0,7,12,57,57,3,9,12,51.0,1069.0,175,11,36,47,161.0,82,5.44,62,351,2383,9.4
9626,Freddy Meyer,2011-12,31.0,8,9,27,27,4,5,9,36.0,567.0,202,15,41,56,197.0,82,5.7,65,341,2477,9.4
9627,Freddy Meyer,2012-13,32.0,9,15,64,64,4,11,15,56.0,1073.0,266,19,52,71,253.0,82,5.53,56,304,2486,9.1
9628,Freddy Meyer,2013-14,33.0,10,2,15,15,1,1,2,11.0,229.0,281,20,53,73,264.0,82,5.46,52,291,2492,9.0
9629,Frederick Gaudreau,2019-20,26.0,4,1,9,9,0,1,1,8.0,78.0,9,0,1,1,8.0,82,5.45,47,245,2478,9.0
9630,Frederick Gaudreau,2020-21,27.0,5,3,20,20,0,3,3,14.0,183.0,29,0,4,4,22.0,82,5.86,50,250,2620,9.2
9631,Frederick Gaudreau,2021-22,28.0,6,4,55,55,3,1,4,43.0,496.0,84,3,5,8,65.0,82,5.96,47,239,2579,9.5
9632,Frederik Gauthier,2018-19,23.0,4,1,7,7,0,1,1,3.0,97.0,7,0,1,1,3.0,82,5.34,48,255,2438,9.0
9633,Frederik Gauthier,2019-20,24.0,5,3,21,21,2,1,3,15.0,204.0,28,2,2,4,18.0,82,5.45,47,245,2478,9.0
9634,Frederik Gauthier,2020-21,25.0,6,1,9,9,1,0,1,12.0,79.0,37,3,2,5,30.0,82,5.86,50,250,2620,9.2
9635,Frederik Gauthier,2021-22,26.0,7,14,70,70,3,11,14,46.0,586.0,107,6,13,19,76.0,82,5.96,47,239,2579,9.5
9636,Frederik Gauthier,2022-23,27.0,8,12,61,61,7,5,12,42.0,573.0,168,13,18,31,118.0,70,5.96,42,208,2192,9.5
9637,Fredrik Bremberg,2001-02,28.0,4,0,8,8,0,0,0,6.0,98.0,8,0,0,0,6.0,82,5.27,57,359,2285,9.4
9638,Fredrik Claesson,2018-19,26.0,4,2,16,16,0,2,2,15.0,309.0,16,0,2,2,15.0,82,5.34,48,255,2438,9.0
9639,Fredrik Claesson,2019-20,27.0,5,11,33,33,3,8,11,25.0,434.0,49,3,10,13,40.0,82,5.45,47,245,2478,9.0
9640,Fredrik Claesson,2020-21,28.0,6,7,64,64,1,6,7,60.0,982.0,113,4,16,20,100.0,82,5.86,50,250,2620,9.2
9641,Fredrik Claesson,2021-22,29.0,7,6,37,37,2,4,6,44.0,638.0,150,6,20,26,144.0,82,5.96,47,239,2579,9.5
9642,Fredrik Claesson,2022-23,30.0,8,2,5,5,1,1,2,1.0,72.0,155,7,21,28,145.0,70,5.96,42,208,2192,9.5
9643,Fredrik Modin,1999-00,25.0,4,13,76,76,6,7,13,85.0,,76,6,7,13,85.0,82,5.83,55,336,2444,9.8
9644,Fredrik Modin,2000-01,26.0,5,32,74,74,16,16,32,137.0,,150,22,23,45,222.0,82,5.28,57,380,2242,9.6
9645,Fredrik Modin,2001-02,27.0,6,31,67,67,16,15,31,108.0,909.0,217,38,38,76,330.0,82,5.27,57,359,2285,9.4
9646,Fredrik Modin,2002-03,28.0,7,48,80,80,22,26,48,167.0,1243.0,297,60,64,124,497.0,82,5.49,53,331,2294,9.8
9647,Fredrik Modin,2003-04,29.0,8,56,76,76,32,24,56,217.0,1312.0,373,92,88,180,714.0,82,5.51,63,376,2272,9.9
9648,Fredrik Modin,2004-05,30.0,9,31,54,54,14,17,31,141.0,1031.0,427,106,105,211,855.0,82,5.24,53,338,2262,9.5
9649,Fredrik Modin,2005-06,31.0,10,40,76,76,17,23,40,179.0,1336.0,503,123,128,251,1034.0,82,5.31,60,363,2326,9.4
9650,Fredrik Modin,2006-07,32.0,11,57,82,82,29,28,57,206.0,1492.0,585,152,156,308,1240.0,82,5.14,57,348,2300,9.2
9651,Fredrik Modin,2008-09,34.0,12,54,77,77,31,23,54,221.0,1508.0,662,183,179,362,1461.0,82,6.05,85,480,2458,10.1
9652,Fredrik Modin,2009-10,35.0,13,42,79,79,22,20,42,220.0,1510.0,741,205,199,404,1681.0,82,5.76,70,398,2426,9.7
9653,Fredrik Modin,2010-11,36.0,14,12,23,23,6,6,12,41.0,387.0,764,211,205,416,1722.0,82,5.44,62,351,2383,9.4
9654,Fredrik Modin,2011-12,37.0,15,25,50,50,9,16,25,113.0,844.0,814,220,221,441,1835.0,82,5.7,65,341,2477,9.4
9655,Fredrik Modin,2012-13,38.0,16,11,44,44,5,6,11,67.0,650.0,858,225,227,452,1902.0,82,5.53,56,304,2486,9.1
9656,Fredrik Modin,2013-14,39.0,17,10,40,40,7,3,10,54.0,464.0,898,232,230,462,1956.0,82,5.46,52,291,2492,9.0
9657,Fredrik Olausson,1989-90,23.0,4,36,72,72,7,29,36,119.0,,72,7,29,36,119.0,80,7.34,72,344,2400,12.2
9658,Fredrik Olausson,1990-91,24.0,5,15,38,38,5,10,15,65.0,,110,12,39,51,184.0,80,7.43,89,437,2435,12.2
9659,Fredrik Olausson,1991-92,25.0,6,62,75,75,15,47,62,178.0,,185,27,86,113,362.0,80,7.48,85,403,2430,12.3
9660,Fredrik Olausson,1992-93,26.0,7,55,77,77,9,46,55,147.0,,262,36,132,168,509.0,80,7.37,76,367,2421,12.2
9661,Fredrik Olausson,1993-94,27.0,8,41,71,71,12,29,41,168.0,,333,48,161,209,677.0,80,6.91,71,366,2385,11.6
9662,Fredrik Olausson,1994-95,28.0,9,62,77,77,20,42,62,227.0,,410,68,203,271,904.0,80,6.96,77,402,2440,11.4
9663,Fredrik Olausson,1995-96,29.0,10,57,68,68,16,41,57,165.0,,478,84,244,328,1069.0,84,7.25,87,443,2603,11.7
9664,Fredrik Olausson,1996-97,30.0,11,35,73,73,11,24,35,126.0,,551,95,268,363,1195.0,84,6.48,76,407,2545,10.7
9665,Fredrik Olausson,1997-98,31.0,12,10,33,33,0,10,10,52.0,,584,95,278,373,1247.0,48,5.97,37,209,1408,10.2
9666,Fredrik Olausson,1998-99,32.0,13,24,56,56,2,22,24,83.0,,640,97,300,397,1330.0,82,6.29,74,413,2481,10.4
9667,Fredrik Olausson,1999-00,33.0,14,38,71,71,9,29,38,110.0,,711,106,329,435,1440.0,82,5.83,55,336,2444,9.8
9668,Fredrik Olausson,2000-01,34.0,15,33,76,76,6,27,33,89.0,,787,112,356,468,1529.0,82,5.28,57,380,2242,9.6
9669,Fredrik Olausson,2001-02,35.0,16,56,74,74,16,40,56,121.0,1464.0,861,128,396,524,1650.0,82,5.27,57,359,2285,9.4
9670,Fredrik Olausson,2002-03,36.0,17,34,70,70,15,19,34,120.0,1401.0,931,143,415,558,1770.0,82,5.49,53,331,2294,9.8
9671,Fredrik Olausson,2004-05,38.0,18,15,47,47,2,13,15,61.0,781.0,978,145,428,573,1831.0,82,5.24,53,338,2262,9.5
9672,Fredrik Olausson,2005-06,39.0,19,8,44,44,2,6,8,38.0,635.0,1022,147,434,581,1869.0,82,5.31,60,363,2326,9.4
9673,Fredrik Sjostrom,2006-07,23.0,4,13,57,57,7,6,13,73.0,661.0,57,7,6,13,73.0,82,5.14,57,348,2300,9.2
9674,Fredrik Sjostrom,2008-09,25.0,5,23,75,75,6,17,23,109.0,999.0,132,13,23,36,182.0,82,6.05,85,480,2458,10.1
9675,Fredrik Sjostrom,2009-10,26.0,6,18,78,78,9,9,18,125.0,1101.0,210,22,32,54,307.0,82,5.76,70,398,2426,9.7
9676,Fredrik Sjostrom,2010-11,27.0,7,21,69,69,12,9,21,110.0,837.0,279,34,41,75,417.0,82,5.44,62,351,2383,9.4
9677,Fredrik Sjostrom,2011-12,28.0,8,13,79,79,7,6,13,95.0,961.0,358,41,47,88,512.0,82,5.7,65,341,2477,9.4
9678,Fredrik Sjostrom,2012-13,29.0,9,11,65,65,3,8,11,64.0,701.0,423,44,55,99,576.0,82,5.53,56,304,2486,9.1
9679,Fredrik Sjostrom,2013-14,30.0,10,5,66,66,2,3,5,62.0,740.0,489,46,58,104,638.0,82,5.46,52,291,2492,9.0
9680,Frédéric St. Denis,2014-15,29.0,4,3,17,17,1,2,3,11.0,247.0,17,1,2,3,11.0,82,5.32,47,271,2439,8.9
9681,Frédéric St. Denis,2017-18,32.0,5,1,4,4,0,1,1,2.0,53.0,21,1,3,4,13.0,82,5.32,47,251,2453,8.9
9682,Gabe Gauthier,2009-10,26.0,4,0,5,5,0,0,0,6.0,50.0,5,0,0,0,6.0,82,5.76,70,398,2426,9.7
9683,Gabe Gauthier,2010-11,27.0,5,0,3,3,0,0,0,2.0,21.0,8,0,0,0,8.0,82,5.44,62,351,2383,9.4
9684,Gabriel Bourque,2014-15,24.0,4,19,43,43,7,12,19,59.0,550.0,43,7,12,19,59.0,82,5.32,47,271,2439,8.9
9685,Gabriel Bourque,2015-16,25.0,5,16,34,34,11,5,16,50.0,538.0,77,18,17,35,109.0,48,5.31,29,160,1399,9.1
9686,Gabriel Bourque,2016-17,26.0,6,26,74,74,9,17,26,108.0,1024.0,151,27,34,61,217.0,82,5.34,48,269,2463,8.9
9687,Gabriel Bourque,2017-18,27.0,7,13,69,69,3,10,13,76.0,829.0,220,30,44,74,293.0,82,5.32,47,251,2453,8.9
9688,Gabriel Bourque,2018-19,28.0,8,4,22,22,1,3,4,25.0,272.0,242,31,47,78,318.0,82,5.34,48,255,2438,9.0
9689,Gabriel Bourque,2019-20,29.0,9,0,6,6,0,0,0,4.0,67.0,248,31,47,78,322.0,82,5.45,47,245,2478,9.0
9690,Gabriel Bourque,2020-21,30.0,10,11,58,58,5,6,11,44.0,632.0,306,36,53,89,366.0,82,5.86,50,250,2620,9.2
9691,Gabriel Bourque,2021-22,31.0,11,8,55,55,2,6,8,34.0,536.0,361,38,59,97,400.0,82,5.96,47,239,2579,9.5
9692,Gabriel Bourque,2022-23,32.0,12,6,52,52,2,4,6,33.0,447.0,413,40,63,103,433.0,70,5.96,42,208,2192,9.5
9693,Gabriel Carlsson,2019-20,23.0,4,1,2,2,0,1,1,3.0,34.0,2,0,1,1,3.0,82,5.45,47,245,2478,9.0
9694,Gabriel Carlsson,2020-21,24.0,5,2,14,14,0,2,2,18.0,159.0,16,0,3,3,21.0,82,5.86,50,250,2620,9.2
9695,Gabriel Carlsson,2021-22,25.0,6,0,1,1,0,0,0,1.0,9.0,17,0,3,3,22.0,82,5.96,47,239,2579,9.5
9696,Gabriel Carlsson,2022-23,26.0,7,0,6,6,0,0,0,3.0,65.0,23,0,3,3,25.0,70,5.96,42,208,2192,9.5
9697,Gabriel Dumont,2014-15,24.0,4,0,3,3,0,0,0,1.0,26.0,3,0,0,0,1.0,82,5.32,47,271,2439,8.9
9698,Gabriel Dumont,2015-16,25.0,5,3,10,10,1,2,3,20.0,97.0,13,1,2,3,21.0,48,5.31,29,160,1399,9.1
9699,Gabriel Dumont,2016-17,26.0,6,0,2,2,0,0,0,1.0,14.0,15,1,2,3,22.0,82,5.34,48,269,2463,8.9
9700,Gabriel Dumont,2017-18,27.0,7,0,3,3,0,0,0,4.0,27.0,18,1,2,3,26.0,82,5.32,47,251,2453,8.9
9701,Gabriel Dumont,2019-20,29.0,8,4,39,39,2,2,4,34.0,377.0,57,3,4,7,60.0,82,5.45,47,245,2478,9.0
9702,Gabriel Dumont,2020-21,30.0,9,2,30,30,1,1,2,38.0,271.0,87,4,5,9,98.0,82,5.86,50,250,2620,9.2
9703,Gabriel Dumont,2022-23,32.0,10,0,3,3,0,0,0,3.0,35.0,90,4,5,9,101.0,70,5.96,42,208,2192,9.5
9704,Gabriel Landeskog,2014-15,22.0,4,52,82,82,22,30,52,270.0,1526.0,82,22,30,52,270.0,82,5.32,47,271,2439,8.9
9705,Gabriel Landeskog,2015-16,23.0,5,17,36,36,9,8,17,109.0,696.0,118,31,38,69,379.0,48,5.31,29,160,1399,9.1
9706,Gabriel Landeskog,2016-17,24.0,6,65,81,81,26,39,65,222.0,1513.0,199,57,77,134,601.0,82,5.34,48,269,2463,8.9
9707,Gabriel Landeskog,2017-18,25.0,7,59,82,82,23,36,59,214.0,1517.0,281,80,113,193,815.0,82,5.32,47,251,2453,8.9
9708,Gabriel Landeskog,2018-19,26.0,8,53,75,75,20,33,53,169.0,1419.0,356,100,146,246,984.0,82,5.34,48,255,2438,9.0
9709,Gabriel Landeskog,2019-20,27.0,9,33,72,72,18,15,33,169.0,1352.0,428,118,161,279,1153.0,82,5.45,47,245,2478,9.0
9710,Gabriel Landeskog,2020-21,28.0,10,62,78,78,25,37,62,183.0,1571.0,506,143,198,341,1336.0,82,5.86,50,250,2620,9.2
9711,Gabriel Landeskog,2021-22,29.0,11,75,73,73,34,41,75,243.0,1544.0,579,177,239,416,1579.0,82,5.96,47,239,2579,9.5
9712,Gabriel Landeskog,2022-23,30.0,12,44,54,54,21,23,44,145.0,1082.0,633,198,262,460,1724.0,70,5.96,42,208,2192,9.5
9713,Gabriel Vilardi,2022-23,23.0,4,7,10,10,3,4,7,19.0,129.0,10,3,4,7,19.0,70,5.96,42,208,2192,9.5
9714,Gaetan Duchesne,1984-85,22.0,4,23,74,74,9,14,23,78.0,,74,9,14,23,78.0,80,8.03,73,320,2489,12.9
9715,Gaetan Duchesne,1985-86,23.0,5,37,77,77,18,19,37,126.0,,151,27,33,60,204.0,80,7.73,71,310,2444,12.7
9716,Gaetan Duchesne,1986-87,24.0,6,36,79,79,17,19,36,116.0,,230,44,52,96,320.0,80,7.89,74,336,2448,12.9
9717,Gaetan Duchesne,1987-88,25.0,7,38,67,67,15,23,38,84.0,,297,59,75,134,404.0,80,7.77,71,321,2447,12.7
9718,Gaetan Duchesne,1988-89,26.0,8,39,80,80,11,28,39,119.0,,377,70,103,173,523.0,80,7.94,82,370,2484,12.8
9719,Gaetan Duchesne,1989-90,27.0,9,52,74,74,17,35,52,108.0,,451,87,138,225,631.0,80,7.34,72,344,2400,12.2
9720,Gaetan Duchesne,1990-91,28.0,10,47,80,80,24,23,47,138.0,,531,111,161,272,769.0,80,7.43,89,437,2435,12.2
9721,Gaetan Duchesne,1991-92,29.0,11,29,70,70,8,21,29,110.0,,601,119,182,301,879.0,80,7.48,85,403,2430,12.3
9722,Gaetan Duchesne,1992-93,30.0,12,20,72,72,12,8,20,93.0,,673,131,190,321,972.0,80,7.37,76,367,2421,12.2
9723,Gaetan Duchesne,1993-94,31.0,13,18,68,68,9,9,18,100.0,,741,140,199,339,1072.0,80,6.91,71,366,2385,11.6
9724,Gaetan Duchesne,1994-95,32.0,14,23,73,73,8,15,23,106.0,,814,148,214,362,1178.0,80,6.96,77,402,2440,11.4
9725,Gaetan Duchesne,1995-96,33.0,15,29,84,84,16,13,29,134.0,,898,164,227,391,1312.0,84,7.25,87,443,2603,11.7
9726,Gaetan Duchesne,1996-97,34.0,16,30,84,84,12,18,30,121.0,,982,176,245,421,1433.0,84,6.48,76,407,2545,10.7
9727,Gaetan Duchesne,1997-98,35.0,17,12,46,46,3,9,12,62.0,,1028,179,254,433,1495.0,48,5.97,37,209,1408,10.2
9728,Gaetan Haas,2022-23,31.0,4,10,58,58,5,5,10,54.0,562.0,58,5,5,10,54.0,70,5.96,42,208,2192,9.5
9729,Gaetan Royer,2004-05,28.0,4,0,3,3,0,0,0,0.0,15.0,3,0,0,0,0.0,82,5.24,53,338,2262,9.5
9730,Gage Quinney,2022-23,27.0,4,1,3,3,0,1,1,2.0,29.0,3,0,1,1,2.0,70,5.96,42,208,2192,9.5
9731,Garnet Exelby,2005-06,24.0,4,2,15,15,0,2,2,9.0,271.0,15,0,2,2,9.0,82,5.31,60,363,2326,9.4
9732,Garnet Exelby,2006-07,25.0,5,10,71,71,1,9,10,42.0,1387.0,86,1,11,12,51.0,82,5.14,57,348,2300,9.2
9733,Garnet Exelby,2008-09,27.0,6,10,75,75,1,9,10,44.0,1176.0,161,2,20,22,95.0,82,6.05,85,480,2458,10.1
9734,Garnet Exelby,2009-10,28.0,7,10,58,58,2,8,10,57.0,1044.0,219,4,28,32,152.0,82,5.76,70,398,2426,9.7
9735,Garnet Exelby,2010-11,29.0,8,7,79,79,2,5,7,37.0,1492.0,298,6,33,39,189.0,82,5.44,62,351,2383,9.4
9736,Garnet Exelby,2011-12,30.0,9,7,59,59,0,7,7,42.0,987.0,357,6,40,46,231.0,82,5.7,65,341,2477,9.4
9737,Garnet Exelby,2012-13,31.0,10,4,51,51,1,3,4,14.0,515.0,408,7,43,50,245.0,82,5.53,56,304,2486,9.1
9738,Garnet Hathaway,2018-19,27.0,4,3,14,14,0,3,3,11.0,168.0,14,0,3,3,11.0,82,5.34,48,255,2438,9.0
9739,Garnet Hathaway,2019-20,28.0,5,5,26,26,1,4,5,22.0,238.0,40,1,7,8,33.0,82,5.45,47,245,2478,9.0
9740,Garnet Hathaway,2020-21,29.0,6,13,59,59,4,9,13,68.0,680.0,99,5,16,21,101.0,82,5.86,50,250,2620,9.2
9741,Garnet Hathaway,2021-22,30.0,7,19,76,76,11,8,19,77.0,800.0,175,16,24,40,178.0,82,5.96,47,239,2579,9.5
9742,Garnet Hathaway,2022-23,31.0,8,16,66,66,9,7,16,80.0,711.0,241,25,31,56,258.0,70,5.96,42,208,2192,9.5
9743,Garret Stroshein,2006-07,26.0,4,0,3,3,0,0,0,2.0,22.0,3,0,0,0,2.0,82,5.14,57,348,2300,9.2
9744,Garrett Burnett,2006-07,31.0,4,3,39,39,1,2,3,24.0,140.0,39,1,2,3,24.0,82,5.14,57,348,2300,9.2
9745,Garrett Mitchell,2019-20,28.0,4,0,1,1,0,0,0,0.0,9.0,1,0,0,0,0.0,82,5.45,47,245,2478,9.0
9746,Garrett Stafford,2010-11,31.0,4,0,2,2,0,0,0,1.0,14.0,2,0,0,0,1.0,82,5.44,62,351,2383,9.4
9747,Garrett Stafford,2011-12,32.0,5,2,3,3,0,2,2,5.0,54.0,5,0,2,2,6.0,82,5.7,65,341,2477,9.4
9748,Garrett Stafford,2013-14,34.0,6,0,2,2,0,0,0,2.0,25.0,7,0,2,2,8.0,82,5.46,52,291,2492,9.0
9749,Garrett Wilson,2016-17,25.0,4,0,3,3,0,0,0,4.0,31.0,3,0,0,0,4.0,82,5.34,48,269,2463,8.9
9750,Garrett Wilson,2017-18,26.0,5,0,2,2,0,0,0,5.0,18.0,5,0,0,0,9.0,82,5.32,47,251,2453,8.9
9751,Garrett Wilson,2018-19,27.0,6,0,29,29,0,0,0,28.0,272.0,34,0,0,0,37.0,82,5.34,48,255,2438,9.0
9752,Garrett Wilson,2021-22,30.0,7,8,50,50,2,6,8,54.0,381.0,84,2,6,8,91.0,82,5.96,47,239,2579,9.5
9753,Garry Galley,1987-88,24.0,4,38,78,78,8,30,38,133.0,,78,8,30,38,133.0,80,7.77,71,321,2447,12.7
9754,Garry Galley,1988-89,25.0,5,22,49,49,9,13,22,57.0,,127,17,43,60,190.0,80,7.94,82,370,2484,12.8
9755,Garry Galley,1989-90,26.0,6,27,48,48,6,21,27,72.0,,175,23,64,87,262.0,80,7.34,72,344,2400,12.2
9756,Garry Galley,1990-91,27.0,7,30,58,58,7,23,30,100.0,,233,30,87,117,362.0,80,7.43,89,437,2435,12.2
9757,Garry Galley,1991-92,28.0,8,30,78,78,8,22,30,145.0,,311,38,109,147,507.0,80,7.48,85,403,2430,12.3
9758,Garry Galley,1992-93,29.0,9,35,71,71,8,27,35,142.0,,382,46,136,182,649.0,80,7.37,76,367,2421,12.2
9759,Garry Galley,1993-94,30.0,10,27,70,70,6,21,27,128.0,,452,52,157,209,777.0,80,6.91,71,366,2385,11.6
9760,Garry Galley,1994-95,31.0,11,32,77,77,5,27,32,125.0,,529,57,184,241,902.0,80,6.96,77,402,2440,11.4
9761,Garry Galley,1995-96,32.0,12,62,83,83,13,49,62,231.0,,612,70,233,303,1133.0,84,7.25,87,443,2603,11.7
9762,Garry Galley,1996-97,33.0,13,70,81,81,10,60,70,186.0,,693,80,293,373,1319.0,84,6.48,76,407,2545,10.7
9763,Garry Galley,1997-98,34.0,14,32,47,47,3,29,32,97.0,,740,83,322,405,1416.0,48,5.97,37,209,1408,10.2
9764,Garry Galley,1998-99,35.0,15,54,78,78,10,44,54,175.0,,818,93,366,459,1591.0,82,6.29,74,413,2481,10.4
9765,Garry Galley,1999-00,36.0,16,38,71,71,4,34,38,84.0,,889,97,400,497,1675.0,82,5.83,55,336,2444,9.8
9766,Garry Galley,2000-01,37.0,17,37,74,74,9,28,37,128.0,,963,106,428,534,1803.0,82,5.28,57,380,2242,9.6
9767,Garry Galley,2001-02,38.0,18,16,60,60,4,12,16,77.0,1036.0,1023,110,440,550,1880.0,82,5.27,57,359,2285,9.4
9768,Garry Galley,2002-03,39.0,19,30,70,70,9,21,30,96.0,1417.0,1093,119,461,580,1976.0,82,5.49,53,331,2294,9.8
9769,Garry Galley,2003-04,40.0,20,20,56,56,6,14,20,94.0,1167.0,1149,125,475,600,2070.0,82,5.51,63,376,2272,9.9
9770,Garry Lariviere,1982-83,28.0,4,21,75,75,2,19,21,73.0,,75,2,19,21,73.0,80,7.03,61,280,2352,12.0
9771,Garry Lariviere,1983-84,29.0,5,18,65,65,3,15,18,66.0,,140,5,34,39,139.0,80,7.69,77,340,2441,12.6
9772,Garry Lariviere,1984-85,30.0,6,22,62,62,1,21,22,46.0,,202,6,55,61,185.0,80,8.03,73,320,2489,12.9
9773,Garry Lariviere,1985-86,31.0,7,2,17,17,0,2,2,15.0,,219,6,57,63,200.0,80,7.73,71,310,2444,12.7
9774,Garry Valk,1993-94,26.0,4,21,59,59,10,11,21,90.0,,59,10,11,21,90.0,80,6.91,71,366,2385,11.6
9775,Garry Valk,1994-95,27.0,5,25,65,65,8,17,25,93.0,,124,18,28,46,183.0,80,6.96,77,402,2440,11.4
9776,Garry Valk,1995-96,28.0,6,13,48,48,6,7,13,46.0,,172,24,35,59,229.0,84,7.25,87,443,2603,11.7
9777,Garry Valk,1996-97,29.0,7,45,78,78,18,27,45,165.0,,250,42,62,104,394.0,84,6.48,76,407,2545,10.7
9778,Garry Valk,1997-98,30.0,8,9,36,36,3,6,9,53.0,,286,45,68,113,447.0,48,5.97,37,209,1408,10.2
9779,Garry Valk,1998-99,31.0,9,24,79,79,12,12,24,108.0,,365,57,80,137,555.0,82,6.29,74,413,2481,10.4
9780,Garry Valk,1999-00,32.0,10,21,70,70,10,11,21,100.0,,435,67,91,158,655.0,82,5.83,55,336,2444,9.8
9781,Garry Valk,2000-01,33.0,11,3,39,39,2,1,3,32.0,,474,69,92,161,687.0,82,5.28,57,380,2242,9.6
9782,Garry Valk,2001-02,34.0,12,29,77,77,8,21,29,93.0,1069.0,551,77,113,190,780.0,82,5.27,57,359,2285,9.4
9783,Garry Valk,2002-03,35.0,13,24,73,73,10,14,24,91.0,938.0,624,87,127,214,871.0,82,5.49,53,331,2294,9.8
9784,Garry Valk,2003-04,36.0,14,26,74,74,8,18,26,87.0,854.0,698,95,145,240,958.0,82,5.51,63,376,2272,9.9
9785,Garry Valk,2004-05,37.0,15,15,63,63,5,10,15,80.0,680.0,761,100,155,255,1038.0,82,5.24,53,338,2262,9.5
9786,Garry Valk,2005-06,38.0,16,1,16,16,0,1,1,9.0,157.0,777,100,156,256,1047.0,82,5.31,60,363,2326,9.4
9787,Garth Butcher,1984-85,22.0,4,0,5,5,0,0,0,7.0,,5,0,0,0,7.0,80,8.03,73,320,2489,12.9
9788,Garth Butcher,1985-86,23.0,5,14,55,55,1,13,14,60.0,,60,1,13,14,67.0,80,7.73,71,310,2444,12.7
9789,Garth Butcher,1986-87,24.0,6,2,28,28,2,0,2,33.0,,88,3,13,16,100.0,80,7.89,74,336,2448,12.9
9790,Garth Butcher,1987-88,25.0,7,12,75,75,3,9,12,59.0,,163,6,22,28,159.0,80,7.77,71,321,2447,12.7
9791,Garth Butcher,1988-89,26.0,8,11,70,70,4,7,11,57.0,,233,10,29,39,216.0,80,7.94,82,370,2484,12.8
9792,Garth Butcher,1989-90,27.0,9,20,70,70,5,15,20,97.0,,303,15,44,59,313.0,80,7.34,72,344,2400,12.2
9793,Garth Butcher,1990-91,28.0,10,23,80,80,6,17,23,77.0,,383,21,61,82,390.0,80,7.43,89,437,2435,12.2
9794,Garth Butcher,1991-92,29.0,11,20,78,78,0,20,20,101.0,,461,21,81,102,491.0,80,7.48,85,403,2430,12.3
9795,Garth Butcher,1992-93,30.0,12,20,80,80,6,14,20,87.0,,541,27,95,122,578.0,80,7.37,76,367,2421,12.2
9796,Garth Butcher,1993-94,31.0,13,22,82,82,6,16,22,75.0,,623,33,111,144,653.0,80,6.91,71,366,2385,11.6
9797,Garth Butcher,1994-95,32.0,14,20,68,68,5,15,20,50.0,,691,38,126,164,703.0,80,6.96,77,402,2440,11.4
9798,Garth Butcher,1995-96,33.0,15,15,84,84,5,10,15,83.0,,775,43,136,179,786.0,84,7.25,87,443,2603,11.7
9799,Garth Butcher,1996-97,34.0,16,19,77,77,4,15,19,66.0,,852,47,151,198,852.0,84,6.48,76,407,2545,10.7
9800,Garth Butcher,1997-98,35.0,17,8,45,45,1,7,8,24.0,,897,48,158,206,876.0,48,5.97,37,209,1408,10.2
9801,Garth MacGuigan,1982-83,26.0,4,0,2,2,0,0,0,1.0,,2,0,0,0,1.0,80,7.03,61,280,2352,12.0
9802,Garth MacGuigan,1986-87,30.0,5,1,3,3,0,1,1,2.0,,5,0,1,1,3.0,80,7.89,74,336,2448,12.9
9803,Garth Murray,2006-07,24.0,4,1,20,20,1,0,1,18.0,185.0,20,1,0,1,18.0,82,5.14,57,348,2300,9.2
9804,Garth Murray,2008-09,26.0,5,6,36,36,5,1,6,25.0,333.0,56,6,1,7,43.0,82,6.05,85,480,2458,10.1
9805,Garth Murray,2009-10,27.0,6,3,43,43,2,1,3,28.0,360.0,99,8,2,10,71.0,82,5.76,70,398,2426,9.7
9806,Garth Murray,2010-11,28.0,7,0,7,7,0,0,0,3.0,44.0,106,8,2,10,74.0,82,5.44,62,351,2383,9.4
9807,Garth Murray,2011-12,29.0,8,0,10,10,0,0,0,12.0,93.0,116,8,2,10,86.0,82,5.7,65,341,2477,9.4
9808,Gary Burns,1983-84,29.0,4,4,11,11,2,2,4,13.0,,11,2,2,4,13.0,80,7.69,77,340,2441,12.6
9809,Gary Dillon,1983-84,24.0,4,2,13,13,1,1,2,15.0,,13,1,1,2,15.0,80,7.69,77,340,2441,12.6
9810,Gary Emmons,1996-97,33.0,4,1,3,3,1,0,1,6.0,,3,1,0,1,6.0,84,6.48,76,407,2545,10.7
9811,Gary Leeman,1986-87,22.0,4,12,52,52,4,8,12,41.0,,52,4,8,12,41.0,80,7.89,74,336,2448,12.9
9812,Gary Leeman,1987-88,23.0,5,31,53,53,5,26,31,88.0,,105,9,34,43,129.0,80,7.77,71,321,2447,12.7
9813,Gary Leeman,1988-89,24.0,6,32,53,53,9,23,32,123.0,,158,18,57,75,252.0,80,7.94,82,370,2484,12.8
9814,Gary Leeman,1989-90,25.0,7,52,80,80,21,31,52,196.0,,238,39,88,127,448.0,80,7.34,72,344,2400,12.2
9815,Gary Leeman,1990-91,26.0,8,61,80,80,30,31,61,234.0,,318,69,119,188,682.0,80,7.43,89,437,2435,12.2
9816,Gary Leeman,1991-92,27.0,9,75,61,61,32,43,75,195.0,,379,101,162,263,877.0,80,7.48,85,403,2430,12.3
9817,Gary Leeman,1992-93,28.0,10,95,80,80,51,44,95,256.0,,459,152,206,358,1133.0,80,7.37,76,367,2421,12.2
9818,Gary Leeman,1993-94,29.0,11,29,52,52,17,12,29,135.0,,511,169,218,387,1268.0,80,6.91,71,366,2385,11.6
9819,Gary Leeman,1994-95,30.0,12,29,63,63,9,20,29,141.0,,574,178,238,416,1409.0,80,6.96,77,402,2440,11.4
9820,Gary Leeman,1995-96,31.0,13,32,50,50,15,17,32,85.0,,624,193,255,448,1494.0,84,7.25,87,443,2603,11.7
9821,Gary Leeman,1996-97,32.0,14,15,31,31,4,11,15,53.0,,655,197,266,463,1547.0,84,6.48,76,407,2545,10.7
9822,Gary Leeman,1997-98,33.0,15,2,10,10,2,0,2,14.0,,665,199,266,465,1561.0,48,5.97,37,209,1408,10.2
9823,Gary Leeman,1999-00,35.0,16,1,2,2,0,1,1,3.0,,667,199,267,466,1564.0,82,5.83,55,336,2444,9.8
9824,Gary Lupul,1982-83,23.0,4,20,51,51,9,11,20,71.0,,51,9,11,20,71.0,80,7.03,61,280,2352,12.0
9825,Gary Lupul,1983-84,24.0,5,2,7,7,0,2,2,5.0,,58,9,13,22,76.0,80,7.69,77,340,2441,12.6
9826,Gary Lupul,1984-85,25.0,6,17,41,41,10,7,17,45.0,,99,19,20,39,121.0,80,8.03,73,320,2489,12.9
9827,Gary Lupul,1985-86,26.0,7,28,40,40,18,10,28,64.0,,139,37,30,67,185.0,80,7.73,71,310,2444,12.7
9828,Gary Lupul,1986-87,27.0,8,44,69,69,17,27,44,128.0,,208,54,57,111,313.0,80,7.89,74,336,2448,12.9
9829,Gary Lupul,1987-88,28.0,9,29,66,66,12,17,29,106.0,,274,66,74,140,419.0,80,7.77,71,321,2447,12.7
9830,Gary Lupul,1988-89,29.0,10,5,19,19,4,1,5,17.0,,293,70,75,145,436.0,80,7.94,82,370,2484,12.8
9831,Gary Morrison,1982-83,27.0,4,2,3,3,0,2,2,1.0,,3,0,2,2,1.0,80,7.03,61,280,2352,12.0
9832,Gary Morrison,1983-84,28.0,5,14,33,33,1,13,14,21.0,,36,1,15,16,22.0,80,7.69,77,340,2441,12.6
9833,Gary Morrison,1984-85,29.0,6,0,7,7,0,0,0,5.0,,43,1,15,16,27.0,80,8.03,73,320,2489,12.9
9834,Gary Nylund,1985-86,22.0,4,3,16,16,0,3,3,12.0,,16,0,3,3,12.0,80,7.73,71,310,2444,12.7
9835,Gary Nylund,1986-87,23.0,5,16,47,47,2,14,16,71.0,,63,2,17,19,83.0,80,7.89,74,336,2448,12.9
9836,Gary Nylund,1987-88,24.0,6,20,76,76,3,17,20,62.0,,139,5,34,39,145.0,80,7.77,71,321,2447,12.7
9837,Gary Nylund,1988-89,25.0,7,18,79,79,2,16,18,84.0,,218,7,50,57,229.0,80,7.94,82,370,2484,12.8
9838,Gary Nylund,1989-90,26.0,8,27,80,80,7,20,27,123.0,,298,14,70,84,352.0,80,7.34,72,344,2400,12.2
9839,Gary Nylund,1990-91,27.0,9,19,76,76,4,15,19,92.0,,374,18,85,103,444.0,80,7.43,89,437,2435,12.2
9840,Gary Nylund,1991-92,28.0,10,17,69,69,7,10,17,74.0,,443,25,95,120,518.0,80,7.48,85,403,2430,12.3
9841,Gary Nylund,1992-93,29.0,11,25,64,64,4,21,25,65.0,,507,29,116,145,583.0,80,7.37,76,367,2421,12.2
9842,Gary Nylund,1993-94,30.0,12,23,72,72,2,21,23,102.0,,579,31,137,168,685.0,80,6.91,71,366,2385,11.6
9843,Gary Nylund,1994-95,31.0,13,1,7,7,0,1,1,5.0,,586,31,138,169,690.0,80,6.96,77,402,2440,11.4
9844,Gary Nylund,1995-96,32.0,14,2,22,22,1,1,2,19.0,,608,32,139,171,709.0,84,7.25,87,443,2603,11.7
9845,Gary Roberts,1989-90,23.0,4,15,32,32,5,10,15,38.0,,32,5,10,15,38.0,80,7.34,72,344,2400,12.2
9846,Gary Roberts,1990-91,24.0,5,28,74,74,13,15,28,118.0,,106,18,25,43,156.0,80,7.43,89,437,2435,12.2
9847,Gary Roberts,1991-92,25.0,6,38,71,71,22,16,38,123.0,,177,40,41,81,279.0,80,7.48,85,403,2430,12.3
9848,Gary Roberts,1992-93,26.0,7,72,78,78,39,33,72,175.0,,255,79,74,153,454.0,80,7.37,76,367,2421,12.2
9849,Gary Roberts,1993-94,27.0,8,53,80,80,22,31,53,132.0,,335,101,105,206,586.0,80,6.91,71,366,2385,11.6
9850,Gary Roberts,1994-95,28.0,9,90,76,76,53,37,90,196.0,,411,154,142,296,782.0,80,6.96,77,402,2440,11.4
9851,Gary Roberts,1995-96,29.0,10,79,58,58,38,41,79,166.0,,469,192,183,375,948.0,84,7.25,87,443,2603,11.7
9852,Gary Roberts,1996-97,30.0,11,84,73,73,41,43,84,202.0,,542,233,226,459,1150.0,84,6.48,76,407,2545,10.7
9853,Gary Roberts,1997-98,31.0,12,4,8,8,2,2,4,20.0,,550,235,228,463,1170.0,48,5.97,37,209,1408,10.2
9854,Gary Roberts,1998-99,32.0,13,42,35,35,22,20,42,84.0,,585,257,248,505,1254.0,82,6.29,74,413,2481,10.4
9855,Gary Roberts,2000-01,34.0,14,49,61,61,20,29,49,106.0,,646,277,277,554,1360.0,82,5.28,57,380,2242,9.6
9856,Gary Roberts,2001-02,35.0,15,42,77,77,14,28,42,138.0,1509.0,723,291,305,596,1498.0,82,5.27,57,359,2285,9.4
9857,Gary Roberts,2002-03,36.0,16,53,69,69,23,30,53,150.0,1278.0,792,314,335,649,1648.0,82,5.49,53,331,2294,9.8
9858,Gary Roberts,2003-04,37.0,17,53,82,82,29,24,53,138.0,1405.0,874,343,359,702,1786.0,82,5.51,63,376,2272,9.9
9859,Gary Roberts,2004-05,38.0,18,48,69,69,21,27,48,122.0,1199.0,943,364,386,750,1908.0,82,5.24,53,338,2262,9.5
9860,Gary Roberts,2005-06,39.0,19,8,14,14,5,3,8,22.0,218.0,957,369,389,758,1930.0,82,5.31,60,363,2326,9.4
9861,Gary Roberts,2006-07,40.0,20,48,72,72,28,20,48,124.0,1264.0,1029,397,409,806,2054.0,82,5.14,57,348,2300,9.2
9862,Gary Roberts,2008-09,42.0,21,40,58,58,14,26,40,122.0,972.0,1087,411,435,846,2176.0,82,6.05,85,480,2458,10.1
9863,Gary Roberts,2009-10,43.0,22,42,69,69,20,22,42,125.0,1154.0,1156,431,457,888,2301.0,82,5.76,70,398,2426,9.7
9864,Gary Roberts,2010-11,44.0,23,15,38,38,3,12,15,41.0,507.0,1194,434,469,903,2342.0,82,5.44,62,351,2383,9.4
9865,Gary Roberts,2011-12,45.0,24,7,30,30,4,3,7,32.0,349.0,1224,438,472,910,2374.0,82,5.7,65,341,2477,9.4
9866,Gary Sampson,1986-87,27.0,4,2,15,15,1,1,2,17.0,,15,1,1,2,17.0,80,7.89,74,336,2448,12.9
9867,Gary Sampson,1987-88,28.0,5,25,46,46,10,15,25,51.0,,61,11,16,27,68.0,80,7.77,71,321,2447,12.7
9868,Gary Sampson,1988-89,29.0,6,5,19,19,1,4,5,17.0,,80,12,20,32,85.0,80,7.94,82,370,2484,12.8
9869,Gary Sampson,1989-90,30.0,7,3,25,25,1,2,3,14.0,,105,13,22,35,99.0,80,7.34,72,344,2400,12.2
9870,Gary Shuchuk,1993-94,26.0,4,3,6,6,1,2,3,8.0,,6,1,2,3,8.0,80,6.91,71,366,2385,11.6
9871,Gary Shuchuk,1995-96,28.0,5,6,25,25,2,4,6,24.0,,31,3,6,9,32.0,84,7.25,87,443,2603,11.7
9872,Gary Shuchuk,1996-97,29.0,6,7,56,56,3,4,7,55.0,,87,6,10,16,87.0,84,6.48,76,407,2545,10.7
9873,Gary Shuchuk,1997-98,30.0,7,9,22,22,3,6,9,16.0,,109,9,16,25,103.0,48,5.97,37,209,1408,10.2
9874,Gary Shuchuk,1998-99,31.0,8,14,33,33,4,10,14,22.0,,142,13,26,39,125.0,82,6.29,74,413,2481,10.4
9875,Gary Suter,1988-89,24.0,4,68,80,80,18,50,68,195.0,,80,18,50,68,195.0,80,7.94,82,370,2484,12.8
9876,Gary Suter,1989-90,25.0,5,48,68,68,9,39,48,152.0,,148,27,89,116,347.0,80,7.34,72,344,2400,12.2
9877,Gary Suter,1990-91,26.0,6,91,75,75,21,70,91,204.0,,223,48,159,207,551.0,80,7.43,89,437,2435,12.2
9878,Gary Suter,1991-92,27.0,7,62,63,63,13,49,62,216.0,,286,61,208,269,767.0,80,7.48,85,403,2430,12.3
9879,Gary Suter,1992-93,28.0,8,76,76,76,16,60,76,211.0,,362,77,268,345,978.0,80,7.37,76,367,2421,12.2
9880,Gary Suter,1993-94,29.0,9,70,79,79,12,58,70,258.0,,441,89,326,415,1236.0,80,6.91,71,366,2385,11.6
9881,Gary Suter,1994-95,30.0,10,55,70,70,12,43,55,189.0,,511,101,369,470,1425.0,80,6.96,77,402,2440,11.4
9882,Gary Suter,1995-96,31.0,11,81,81,81,23,58,81,263.0,,592,124,427,551,1688.0,84,7.25,87,443,2603,11.7
9883,Gary Suter,1996-97,32.0,12,18,41,41,6,12,18,86.0,,633,130,439,569,1774.0,84,6.48,76,407,2545,10.7
9884,Gary Suter,1997-98,33.0,13,37,48,48,10,27,37,144.0,,681,140,466,606,1918.0,48,5.97,37,209,1408,10.2
9885,Gary Suter,1998-99,34.0,14,67,82,82,20,47,67,242.0,,763,160,513,673,2160.0,82,6.29,74,413,2481,10.4
9886,Gary Suter,1999-00,35.0,15,28,82,82,7,21,28,225.0,,845,167,534,701,2385.0,82,5.83,55,336,2444,9.8
9887,Gary Suter,2000-01,36.0,16,42,73,73,14,28,42,199.0,,918,181,562,743,2584.0,82,5.28,57,380,2242,9.6
9888,Gary Suter,2001-02,37.0,17,0,1,1,0,0,0,1.0,13.0,919,181,562,743,2585.0,82,5.27,57,359,2285,9.4
9889,Gary Suter,2002-03,38.0,18,34,76,76,6,28,34,175.0,1785.0,995,187,590,777,2760.0,82,5.49,53,331,2294,9.8
9890,Gary Suter,2003-04,39.0,19,34,68,68,10,24,34,157.0,1459.0,1063,197,614,811,2917.0,82,5.51,63,376,2272,9.9
9891,Gary Suter,2004-05,40.0,20,33,82,82,6,27,33,174.0,1650.0,1145,203,641,844,3091.0,82,5.24,53,338,2262,9.5
9892,Gary Yaremchuk,1984-85,23.0,4,3,18,18,0,3,3,6.0,,18,0,3,3,6.0,80,8.03,73,320,2489,12.9
9893,Gary Yaremchuk,1985-86,24.0,5,0,3,3,0,0,0,3.0,,21,0,3,3,9.0,80,7.73,71,310,2444,12.7
9894,Gary Yaremchuk,1986-87,25.0,6,0,1,1,0,0,0,1.0,,22,0,3,3,10.0,80,7.89,74,336,2448,12.9
9895,Gary Yaremchuk,1987-88,26.0,7,2,12,12,1,1,2,7.0,,34,1,4,5,17.0,80,7.77,71,321,2447,12.7
9896,Gaston Gingras,1982-83,23.0,4,10,34,34,3,7,10,60.0,,34,3,7,10,60.0,80,7.03,61,280,2352,12.0
9897,Gaston Gingras,1983-84,24.0,5,21,55,55,5,16,21,133.0,,89,8,23,31,193.0,80,7.69,77,340,2441,12.6
9898,Gaston Gingras,1984-85,25.0,6,24,34,34,6,18,24,89.0,,123,14,41,55,282.0,80,8.03,73,320,2489,12.9
9899,Gaston Gingras,1985-86,26.0,7,37,67,67,11,26,37,155.0,,190,25,67,92,437.0,80,7.73,71,310,2444,12.7
9900,Gaston Gingras,1986-87,27.0,8,27,59,59,7,20,27,125.0,,249,32,87,119,562.0,80,7.89,74,336,2448,12.9
9901,Gaston Gingras,1987-88,28.0,9,2,5,5,0,2,2,17.0,,254,32,89,121,579.0,80,7.77,71,321,2447,12.7
9902,Gaston Gingras,1988-89,29.0,10,26,34,34,8,18,26,77.0,,288,40,107,147,656.0,80,7.94,82,370,2484,12.8
9903,Gaston Gingras,1989-90,30.0,11,45,66,66,11,34,45,174.0,,354,51,141,192,830.0,80,7.34,72,344,2400,12.2
9904,Gaston Gingras,1990-91,31.0,12,30,70,70,7,23,30,133.0,,424,58,164,222,963.0,80,7.43,89,437,2435,12.2
9905,Gaston Gingras,1991-92,32.0,13,13,52,52,3,10,13,98.0,,476,61,174,235,1061.0,80,7.48,85,403,2430,12.3
9906,Gaston Therrien,1983-84,23.0,4,1,3,3,0,1,1,10.0,,3,0,1,1,10.0,80,7.69,77,340,2441,12.6
9907,Gaston Therrien,1984-85,24.0,5,7,14,14,0,7,7,15.0,,17,0,8,8,25.0,80,8.03,73,320,2489,12.9
9908,Gaston Therrien,1985-86,25.0,6,0,5,5,0,0,0,5.0,,22,0,8,8,30.0,80,7.73,71,310,2444,12.7
9909,Gates Orlando,1987-88,25.0,4,9,11,11,3,6,9,22.0,,11,3,6,9,22.0,80,7.77,71,321,2447,12.7
9910,Gates Orlando,1988-89,26.0,5,25,60,60,13,12,25,70.0,,71,16,18,34,92.0,80,7.94,82,370,2484,12.8
9911,Gates Orlando,1989-90,27.0,6,10,27,27,2,8,10,24.0,,98,18,26,44,116.0,80,7.34,72,344,2400,12.2
9912,Gavin Bayreuther,2021-22,27.0,4,5,19,19,2,3,5,25.0,346.0,19,2,3,5,25.0,82,5.96,47,239,2579,9.5
9913,Gavin Morgan,2006-07,30.0,4,0,6,6,0,0,0,7.0,35.0,6,0,0,0,7.0,82,5.14,57,348,2300,9.2
9914,Gemel Smith,2019-20,25.0,4,6,17,17,3,3,6,19.0,231.0,17,3,3,6,19.0,82,5.45,47,245,2478,9.0
9915,Gemel Smith,2020-21,26.0,5,11,46,46,6,5,11,42.0,434.0,63,9,8,17,61.0,82,5.86,50,250,2620,9.2
9916,Gemel Smith,2021-22,27.0,6,3,17,17,2,1,3,14.0,142.0,80,11,9,20,75.0,82,5.96,47,239,2579,9.5
9917,Gemel Smith,2022-23,28.0,7,1,3,3,1,0,1,1.0,28.0,83,12,9,21,76.0,70,5.96,42,208,2192,9.5
9918,Geoff Courtnall,1986-87,24.0,4,0,4,4,0,0,0,1.0,,4,0,0,0,1.0,80,7.89,74,336,2448,12.9
9919,Geoff Courtnall,1987-88,25.0,5,28,64,64,12,16,28,87.0,,68,12,16,28,88.0,80,7.77,71,321,2447,12.7
9920,Geoff Courtnall,1988-89,26.0,6,37,64,64,21,16,37,162.0,,132,33,32,65,250.0,80,7.94,82,370,2484,12.8
9921,Geoff Courtnall,1989-90,27.0,7,36,65,65,13,23,36,178.0,,197,46,55,101,428.0,80,7.34,72,344,2400,12.2
9922,Geoff Courtnall,1990-91,28.0,8,66,74,74,36,30,66,252.0,,271,82,85,167,680.0,80,7.43,89,437,2435,12.2
9923,Geoff Courtnall,1991-92,29.0,9,80,79,79,42,38,80,239.0,,350,124,123,247,919.0,80,7.48,85,403,2430,12.3
9924,Geoff Courtnall,1992-93,30.0,10,74,80,80,35,39,74,307.0,,430,159,162,321,1226.0,80,7.37,76,367,2421,12.2
9925,Geoff Courtnall,1993-94,31.0,11,65,77,77,33,32,65,263.0,,507,192,194,386,1489.0,80,6.91,71,366,2385,11.6
9926,Geoff Courtnall,1994-95,32.0,12,57,70,70,23,34,57,281.0,,577,215,228,443,1770.0,80,6.96,77,402,2440,11.4
9927,Geoff Courtnall,1995-96,33.0,13,77,84,84,31,46,77,214.0,,661,246,274,520,1984.0,84,7.25,87,443,2603,11.7
9928,Geoff Courtnall,1996-97,34.0,14,70,82,82,26,44,70,264.0,,743,272,318,590,2248.0,84,6.48,76,407,2545,10.7
9929,Geoff Courtnall,1997-98,35.0,15,34,45,45,16,18,34,144.0,,788,288,336,624,2392.0,48,5.97,37,209,1408,10.2
9930,Geoff Courtnall,1998-99,36.0,16,40,69,69,24,16,40,228.0,,857,312,352,664,2620.0,82,6.29,74,413,2481,10.4
9931,Geoff Courtnall,1999-00,37.0,17,57,82,82,17,40,57,203.0,,939,329,392,721,2823.0,82,5.83,55,336,2444,9.8
9932,Geoff Courtnall,2000-01,38.0,18,62,79,79,31,31,62,189.0,,1018,360,423,783,3012.0,82,5.28,57,380,2242,9.6
9933,Geoff Courtnall,2001-02,39.0,19,12,24,24,5,7,12,60.0,355.0,1042,365,430,795,3072.0,82,5.27,57,359,2285,9.4
9934,Geoff Courtnall,2002-03,40.0,20,4,6,6,2,2,4,15.0,86.0,1048,367,432,799,3087.0,82,5.49,53,331,2294,9.8
9935,Geoff Kinrade,2011-12,26.0,4,0,1,1,0,0,0,1.0,18.0,1,0,0,0,1.0,82,5.7,65,341,2477,9.4
9936,Geoff Platt,2008-09,23.0,4,5,15,15,0,5,5,29.0,168.0,15,0,5,5,29.0,82,6.05,85,480,2458,10.1
9937,Geoff Platt,2009-10,24.0,5,9,26,26,4,5,9,40.0,262.0,41,4,10,14,69.0,82,5.76,70,398,2426,9.7
9938,Geoff Platt,2010-11,25.0,6,0,5,5,0,0,0,4.0,56.0,46,4,10,14,73.0,82,5.44,62,351,2383,9.4
9939,Geoff Sanderson,1993-94,21.0,4,1,2,2,1,0,1,2.0,,2,1,0,1,2.0,80,6.91,71,366,2385,11.6
9940,Geoff Sanderson,1994-95,22.0,5,31,64,64,13,18,31,98.0,,66,14,18,32,100.0,80,6.96,77,402,2440,11.4
9941,Geoff Sanderson,1995-96,23.0,6,89,82,82,46,43,89,271.0,,148,60,61,121,371.0,84,7.25,87,443,2603,11.7
9942,Geoff Sanderson,1996-97,24.0,7,67,82,82,41,26,67,266.0,,230,101,87,188,637.0,84,6.48,76,407,2545,10.7
9943,Geoff Sanderson,1997-98,25.0,8,32,46,46,18,14,32,170.0,,276,119,101,220,807.0,48,5.97,37,209,1408,10.2
9944,Geoff Sanderson,1998-99,26.0,9,65,81,81,34,31,65,314.0,,357,153,132,285,1121.0,82,6.29,74,413,2481,10.4
9945,Geoff Sanderson,1999-00,27.0,10,67,82,82,36,31,67,297.0,,439,189,163,352,1418.0,82,5.83,55,336,2444,9.8
9946,Geoff Sanderson,2000-01,28.0,11,29,75,75,11,18,29,197.0,,514,200,181,381,1615.0,82,5.28,57,380,2242,9.6
9947,Geoff Sanderson,2001-02,29.0,12,30,75,75,12,18,30,155.0,969.0,589,212,199,411,1770.0,82,5.27,57,359,2285,9.4
9948,Geoff Sanderson,2002-03,30.0,13,26,67,67,13,13,26,136.0,865.0,656,225,212,437,1906.0,82,5.49,53,331,2294,9.8
9949,Geoff Sanderson,2003-04,31.0,14,56,68,68,30,26,56,199.0,1130.0,724,255,238,493,2105.0,82,5.51,63,376,2272,9.9
9950,Geoff Sanderson,2004-05,32.0,15,16,42,42,11,5,16,112.0,707.0,766,266,243,509,2217.0,82,5.24,53,338,2262,9.5
9951,Geoff Sanderson,2005-06,33.0,16,67,82,82,34,33,67,286.0,1536.0,848,300,276,576,2503.0,82,5.31,60,363,2326,9.4
9952,Geoff Sanderson,2006-07,34.0,17,36,80,80,16,20,36,227.0,1287.0,928,316,296,612,2730.0,82,5.14,57,348,2300,9.2
9953,Geoff Sanderson,2008-09,36.0,18,46,77,77,25,21,46,159.0,1056.0,1005,341,317,658,2889.0,82,6.05,85,480,2458,10.1
9954,Geoff Sanderson,2009-10,37.0,19,29,58,58,11,18,29,143.0,811.0,1063,352,335,687,3032.0,82,5.76,70,398,2426,9.7
9955,Geoff Sanderson,2010-11,38.0,20,13,41,41,3,10,13,40.0,416.0,1104,355,345,700,3072.0,82,5.44,62,351,2383,9.4
9956,Geoff Smith,1992-93,23.0,4,15,74,74,4,11,15,66.0,,74,4,11,15,66.0,80,7.37,76,367,2421,12.2
9957,Geoff Smith,1993-94,24.0,5,13,59,59,1,12,13,66.0,,133,5,23,28,132.0,80,6.91,71,366,2385,11.6
9958,Geoff Smith,1994-95,25.0,6,18,74,74,2,16,18,61.0,,207,7,39,46,193.0,80,6.96,77,402,2440,11.4
9959,Geoff Smith,1995-96,26.0,7,18,78,78,4,14,18,67.0,,285,11,53,64,260.0,84,7.25,87,443,2603,11.7
9960,Geoff Smith,1996-97,27.0,8,9,77,77,1,8,9,67.0,,362,12,61,73,327.0,84,6.48,76,407,2545,10.7
9961,Geoff Smith,1997-98,28.0,9,6,47,47,2,4,6,40.0,,409,14,65,79,367.0,48,5.97,37,209,1408,10.2
9962,Geoff Smith,1998-99,29.0,10,10,31,31,3,7,10,34.0,,440,17,72,89,401.0,82,6.29,74,413,2481,10.4
9963,Geoff Smith,1999-00,30.0,11,0,3,3,0,0,0,2.0,,443,17,72,89,403.0,82,5.83,55,336,2444,9.8
9964,Geoff Smith,2000-01,31.0,12,2,15,15,1,1,2,11.0,,458,18,73,91,414.0,82,5.28,57,380,2242,9.6
9965,Geoff Smith,2001-02,32.0,13,0,4,4,0,0,0,0.0,60.0,462,18,73,91,414.0,82,5.27,57,359,2285,9.4
9966,Geordie Kinnear,2002-03,29.0,4,0,4,4,0,0,0,2.0,74.0,4,0,0,0,2.0,82,5.49,53,331,2294,9.8
9967,Geordie Robertson,1985-86,26.0,4,3,5,5,1,2,3,10.0,,5,1,2,3,10.0,80,7.73,71,310,2444,12.7
9968,George Lyle,1982-83,29.0,4,11,27,27,7,4,11,41.0,,27,7,4,11,41.0,80,7.03,61,280,2352,12.0
9969,George Lyle,1983-84,30.0,5,24,31,31,10,14,24,49.0,,58,17,18,35,90.0,80,7.69,77,340,2441,12.6
9970,George Lyle,1984-85,31.0,6,17,25,25,3,14,17,42.0,,83,20,32,52,132.0,80,8.03,73,320,2489,12.9
9971,George Lyle,1985-86,32.0,7,10,16,16,4,6,10,33.0,,99,24,38,62,165.0,80,7.73,71,310,2444,12.7
9972,George McPhee,1986-87,28.0,4,2,9,9,1,1,2,1.0,,9,1,1,2,1.0,80,7.89,74,336,2448,12.9
9973,George McPhee,1987-88,29.0,5,27,49,49,12,15,27,54.0,,58,13,16,29,55.0,80,7.77,71,321,2447,12.7
9974,George McPhee,1988-89,30.0,6,8,30,30,4,4,8,31.0,,88,17,20,37,86.0,80,7.94,82,370,2484,12.8
9975,George McPhee,1989-90,31.0,7,8,21,21,4,4,8,31.0,,109,21,24,45,117.0,80,7.34,72,344,2400,12.2
9976,George McPhee,1990-91,32.0,8,3,5,5,3,0,3,5.0,,114,24,24,48,122.0,80,7.43,89,437,2435,12.2
9977,George McPhee,1991-92,33.0,9,1,1,1,0,1,1,0.0,,115,24,25,49,122.0,80,7.48,85,403,2430,12.3
9978,George Parros,2008-09,29.0,4,5,55,55,2,3,5,23.0,272.0,55,2,3,5,23.0,82,6.05,85,480,2458,10.1
9979,George Parros,2009-10,30.0,5,1,34,34,1,0,1,19.0,172.0,89,3,3,6,42.0,82,5.76,70,398,2426,9.7
9980,George Parros,2010-11,31.0,6,5,69,69,1,4,5,30.0,410.0,158,4,7,11,72.0,82,5.44,62,351,2383,9.4
9981,George Parros,2011-12,32.0,7,10,74,74,5,5,10,47.0,463.0,232,9,12,21,119.0,82,5.7,65,341,2477,9.4
9982,George Parros,2012-13,33.0,8,4,57,57,4,0,4,25.0,342.0,289,13,12,25,144.0,82,5.53,56,304,2486,9.1
9983,George Parros,2013-14,34.0,9,4,78,78,3,1,4,33.0,500.0,367,16,13,29,177.0,82,5.46,52,291,2492,9.0
9984,George Parros,2014-15,35.0,10,4,46,46,1,3,4,17.0,293.0,413,17,16,33,194.0,82,5.32,47,271,2439,8.9
9985,George Parros,2015-16,36.0,11,2,39,39,1,1,2,16.0,258.0,452,18,17,35,210.0,48,5.31,29,160,1399,9.1
9986,George Parros,2016-17,37.0,12,1,22,22,0,1,1,4.0,100.0,474,18,18,36,214.0,82,5.34,48,269,2463,8.9
9987,George Servinis,1990-91,28.0,4,0,5,5,0,0,0,8.0,,5,0,0,0,8.0,80,7.43,89,437,2435,12.2
9988,Georges Laraque,2000-01,24.0,4,0,11,11,0,0,0,4.0,,11,0,0,0,4.0,82,5.28,57,380,2242,9.6
9989,Georges Laraque,2001-02,25.0,5,5,39,39,3,2,5,17.0,215.0,50,3,2,5,21.0,82,5.27,57,359,2285,9.4
9990,Georges Laraque,2002-03,26.0,6,16,76,76,8,8,16,56.0,644.0,126,11,10,21,77.0,82,5.49,53,331,2294,9.8
9991,Georges Laraque,2003-04,27.0,7,29,82,82,13,16,29,73.0,742.0,208,24,26,50,150.0,82,5.51,63,376,2272,9.9
9992,Georges Laraque,2004-05,28.0,8,19,80,80,5,14,19,95.0,784.0,288,29,40,69,245.0,82,5.24,53,338,2262,9.5
9993,Georges Laraque,2005-06,29.0,9,13,64,64,6,7,13,46.0,592.0,352,35,47,82,291.0,82,5.31,60,363,2326,9.4
9994,Georges Laraque,2006-07,30.0,10,17,66,66,6,11,17,54.0,618.0,418,41,58,99,345.0,82,5.14,57,348,2300,9.2
9995,Georges Laraque,2008-09,32.0,11,12,72,72,2,10,12,50.0,474.0,490,43,68,111,395.0,82,6.05,85,480,2458,10.1
9996,Georges Laraque,2009-10,33.0,12,24,73,73,5,19,24,44.0,705.0,563,48,87,135,439.0,82,5.76,70,398,2426,9.7
9997,Georges Laraque,2010-11,34.0,13,13,71,71,4,9,13,29.0,547.0,634,52,96,148,468.0,82,5.44,62,351,2383,9.4
9998,Georges Laraque,2011-12,35.0,14,2,33,33,0,2,2,15.0,252.0,667,52,98,150,483.0,82,5.7,65,341,2477,9.4
9999,Georges Laraque,2012-13,36.0,15,3,28,28,1,2,3,2.0,161.0,695,53,100,153,485.0,82,5.53,56,304,2486,9.1
10000,Gerald Diduck,1987-88,22.0,4,10,65,65,2,8,10,52.0,,65,2,8,10,52.0,80,7.77,71,321,2447,12.7
10001,Gerald Diduck,1988-89,23.0,5,3,10,10,1,2,3,6.0,,75,3,10,13,58.0,80,7.94,82,370,2484,12.8
10002,Gerald Diduck,1989-90,24.0,6,5,30,30,2,3,5,54.0,,105,5,13,18,112.0,80,7.34,72,344,2400,12.2
10003,Gerald Diduck,1990-91,25.0,7,19,68,68,7,12,19,128.0,,173,12,25,37,240.0,80,7.43,89,437,2435,12.2
10004,Gerald Diduck,1991-92,26.0,8,32,65,65,11,21,32,132.0,,238,23,46,69,372.0,80,7.48,85,403,2430,12.3
10005,Gerald Diduck,1992-93,27.0,9,20,76,76,3,17,20,102.0,,314,26,63,89,474.0,80,7.37,76,367,2421,12.2
10006,Gerald Diduck,1993-94,28.0,10,13,63,63,4,9,13,100.0,,377,30,72,102,574.0,80,6.91,71,366,2385,11.6
10007,Gerald Diduck,1994-95,29.0,11,27,77,77,6,21,27,128.0,,454,36,93,129,702.0,80,6.96,77,402,2440,11.4
10008,Gerald Diduck,1995-96,30.0,12,20,80,80,6,14,20,92.0,,534,42,107,149,794.0,84,7.25,87,443,2603,11.7
10009,Gerald Diduck,1996-97,31.0,13,11,55,55,1,10,11,50.0,,589,43,117,160,844.0,84,6.48,76,407,2545,10.7
10010,Gerald Diduck,1997-98,32.0,14,5,35,35,2,3,5,67.0,,624,45,120,165,911.0,48,5.97,37,209,1408,10.2
10011,Gerald Diduck,1998-99,33.0,15,10,79,79,1,9,10,93.0,,703,46,129,175,1004.0,82,6.29,74,413,2481,10.4
10012,Gerald Diduck,1999-00,34.0,16,14,67,67,2,12,14,80.0,,770,48,141,189,1084.0,82,5.83,55,336,2444,9.8
10013,Gerald Diduck,2000-01,35.0,17,18,78,78,8,10,18,104.0,,848,56,151,207,1188.0,82,5.28,57,380,2242,9.6
10014,Gerald Diduck,2001-02,36.0,18,2,44,44,0,2,2,39.0,815.0,892,56,153,209,1227.0,82,5.27,57,359,2285,9.4
10015,Gerald Diduck,2002-03,37.0,19,3,26,26,0,3,3,18.0,401.0,918,56,156,212,1245.0,82,5.49,53,331,2294,9.8
10016,Gerald Diduck,2003-04,38.0,20,0,14,14,0,0,0,8.0,150.0,932,56,156,212,1253.0,82,5.51,63,376,2272,9.9
10017,Gerald Mayhew,2022-23,30.0,4,2,13,13,2,0,2,16.0,150.0,13,2,0,2,16.0,70,5.96,42,208,2192,9.5
10018,Gerard Gallant,1987-88,24.0,4,18,32,32,6,12,18,44.0,,32,6,12,18,44.0,80,7.77,71,321,2447,12.7
10019,Gerard Gallant,1988-89,25.0,5,39,52,52,20,19,39,116.0,,84,26,31,57,160.0,80,7.94,82,370,2484,12.8
10020,Gerard Gallant,1989-90,26.0,6,72,80,80,38,34,72,191.0,,164,64,65,129,351.0,80,7.34,72,344,2400,12.2
10021,Gerard Gallant,1990-91,27.0,7,73,73,73,34,39,73,197.0,,237,98,104,202,548.0,80,7.43,89,437,2435,12.2
10022,Gerard Gallant,1991-92,28.0,8,93,76,76,39,54,93,221.0,,313,137,158,295,769.0,80,7.48,85,403,2430,12.3
10023,Gerard Gallant,1992-93,29.0,9,80,69,69,36,44,80,219.0,,382,173,202,375,988.0,80,7.37,76,367,2421,12.2
10024,Gerard Gallant,1993-94,30.0,10,26,45,45,10,16,26,82.0,,427,183,218,401,1070.0,80,6.91,71,366,2385,11.6
10025,Gerard Gallant,1994-95,31.0,11,36,69,69,14,22,36,116.0,,496,197,240,437,1186.0,80,6.96,77,402,2440,11.4
10026,Gerard Gallant,1995-96,32.0,12,30,67,67,10,20,30,81.0,,563,207,260,467,1267.0,84,7.25,87,443,2603,11.7
10027,Gerard Gallant,1996-97,33.0,13,13,51,51,4,9,13,45.0,,614,211,269,480,1312.0,84,6.48,76,407,2545,10.7
10028,Gerard Gallant,1997-98,34.0,14,0,1,1,0,0,0,1.0,,615,211,269,480,1313.0,48,5.97,37,209,1408,10.2
10029,German Rubtsov,2022-23,24.0,4,0,4,4,0,0,0,1.0,27.0,4,0,0,0,1.0,70,5.96,42,208,2192,9.5
10030,German Titov,1996-97,31.0,4,45,76,76,27,18,45,153.0,,76,27,18,45,153.0,84,6.48,76,407,2545,10.7
10031,German Titov,1997-98,32.0,5,24,40,40,12,12,24,88.0,,116,39,30,69,241.0,48,5.97,37,209,1408,10.2
10032,German Titov,1998-99,33.0,6,67,82,82,28,39,67,214.0,,198,67,69,136,455.0,82,6.29,74,413,2481,10.4
10033,German Titov,1999-00,34.0,7,52,79,79,22,30,52,192.0,,277,89,99,188,647.0,82,5.83,55,336,2444,9.8
10034,German Titov,2000-01,35.0,8,40,68,68,18,22,40,133.0,,345,107,121,228,780.0,82,5.28,57,380,2242,9.6
10035,German Titov,2001-02,36.0,9,56,72,72,11,45,56,113.0,1405.0,417,118,166,284,893.0,82,5.27,57,359,2285,9.4
10036,German Titov,2002-03,37.0,10,46,70,70,17,29,46,122.0,1376.0,487,135,195,330,1015.0,82,5.49,53,331,2294,9.8
10037,German Titov,2003-04,38.0,11,20,71,71,9,11,20,78.0,1128.0,558,144,206,350,1093.0,82,5.51,63,376,2272,9.9
10038,German Titov,2004-05,39.0,12,27,66,66,13,14,27,63.0,824.0,624,157,220,377,1156.0,82,5.24,53,338,2262,9.5
10039,Gerry Fleming,1996-97,30.0,4,0,5,5,0,0,0,4.0,,5,0,0,0,4.0,84,6.48,76,407,2545,10.7
10040,Gerry Fleming,1997-98,31.0,5,0,6,6,0,0,0,1.0,,11,0,0,0,5.0,48,5.97,37,209,1408,10.2
10041,Gerry McDonald,1984-85,26.0,4,0,3,3,0,0,0,1.0,,3,0,0,0,1.0,80,8.03,73,320,2489,12.9
10042,Gerry McDonald,1986-87,28.0,5,0,5,5,0,0,0,7.0,,8,0,0,0,8.0,80,7.89,74,336,2448,12.9
10043,Gerry Minor,1982-83,24.0,4,1,5,5,0,1,1,4.0,,5,0,1,1,4.0,80,7.03,61,280,2352,12.0
10044,Gerry Minor,1983-84,25.0,5,24,74,74,10,14,24,93.0,,79,10,15,25,97.0,80,7.69,77,340,2441,12.6
10045,Gerry Minor,1984-85,26.0,6,1,13,13,0,1,1,18.0,,92,10,16,26,115.0,80,8.03,73,320,2489,12.9
10046,Gerry Minor,1985-86,27.0,7,6,39,39,1,5,6,24.0,,131,11,21,32,139.0,80,7.73,71,310,2444,12.7
10047,Gerry Minor,1986-87,28.0,8,0,9,9,0,0,0,2.0,,140,11,21,32,141.0,80,7.89,74,336,2448,12.9
10048,Gerry Rioux,1982-83,23.0,4,0,8,8,0,0,0,4.0,,8,0,0,0,4.0,80,7.03,61,280,2352,12.0
10049,Gilbert Brule,2008-09,22.0,4,4,7,7,2,2,4,11.0,92.0,7,2,2,4,11.0,82,6.05,85,480,2458,10.1
10050,Gilbert Brule,2009-10,23.0,5,19,78,78,9,10,19,98.0,830.0,85,11,12,23,109.0,82,5.76,70,398,2426,9.7
10051,Gilbert Brule,2010-11,24.0,6,9,61,61,1,8,9,74.0,604.0,146,12,20,32,183.0,82,5.44,62,351,2383,9.4
10052,Gilbert Brule,2011-12,25.0,7,3,11,11,2,1,3,13.0,109.0,157,14,21,35,196.0,82,5.7,65,341,2477,9.4
10053,Gilbert Brule,2012-13,26.0,8,37,65,65,17,20,37,121.0,925.0,222,31,41,72,317.0,82,5.53,56,304,2486,9.1
10054,Gilbert Brule,2013-14,27.0,9,9,41,41,7,2,9,72.0,565.0,263,38,43,81,389.0,82,5.46,52,291,2492,9.0
10055,Gilbert Brule,2014-15,28.0,10,14,33,33,5,9,14,56.0,382.0,296,43,52,95,445.0,82,5.32,47,271,2439,8.9
10056,Gilbert Brule,2016-17,30.0,11,0,3,3,0,0,0,3.0,35.0,299,43,52,95,448.0,82,5.34,48,269,2463,8.9
10057,Gilbert Delorme,1984-85,22.0,4,11,60,60,3,8,11,80.0,,60,3,8,11,80.0,80,8.03,73,320,2489,12.9
10058,Gilbert Delorme,1985-86,23.0,5,33,78,78,12,21,33,166.0,,138,15,29,44,246.0,80,7.73,71,310,2444,12.7
10059,Gilbert Delorme,1986-87,24.0,6,14,71,71,2,12,14,105.0,,209,17,41,58,351.0,80,7.89,74,336,2448,12.9
10060,Gilbert Delorme,1987-88,25.0,7,14,74,74,2,12,14,86.0,,283,19,53,72,437.0,80,7.77,71,321,2447,12.7
10061,Gilbert Delorme,1988-89,26.0,8,20,64,64,2,18,20,100.0,,347,21,71,92,537.0,80,7.94,82,370,2484,12.8
10062,Gilbert Delorme,1989-90,27.0,9,7,43,43,4,3,7,46.0,,390,25,74,99,583.0,80,7.34,72,344,2400,12.2
10063,Gilbert Delorme,1990-91,28.0,10,10,55,55,2,8,10,46.0,,445,27,82,109,629.0,80,7.43,89,437,2435,12.2
10064,Gilbert Delorme,1991-92,29.0,11,4,42,42,1,3,4,23.0,,487,28,85,113,652.0,80,7.48,85,403,2430,12.3
10065,Gilbert Delorme,1992-93,30.0,12,10,54,54,3,7,10,37.0,,541,31,92,123,689.0,80,7.37,76,367,2421,12.2
10066,Gilbert Dionne,1993-94,23.0,4,0,2,2,0,0,0,0.0,,2,0,0,0,0.0,80,6.91,71,366,2385,11.6
10067,Gilbert Dionne,1994-95,24.0,5,34,39,39,21,13,34,90.0,,41,21,13,34,90.0,80,6.96,77,402,2440,11.4
10068,Gilbert Dionne,1995-96,25.0,6,48,75,75,20,28,48,145.0,,116,41,41,82,235.0,84,7.25,87,443,2603,11.7
10069,Gilbert Dionne,1996-97,26.0,7,45,74,74,19,26,45,162.0,,190,60,67,127,397.0,84,6.48,76,407,2545,10.7
10070,Gilbert Dionne,1997-98,27.0,8,9,26,26,0,9,9,33.0,,216,60,76,136,430.0,48,5.97,37,209,1408,10.2
10071,Gilbert Dionne,1998-99,28.0,9,4,7,7,1,3,4,12.0,,223,61,79,140,442.0,82,6.29,74,413,2481,10.4
10072,Gilles Bilodeau,1982-83,27.0,4,1,9,9,0,1,1,1.0,,9,0,1,1,1.0,80,7.03,61,280,2352,12.0
10073,Gilles Hamel,1983-84,23.0,4,19,51,51,10,9,19,56.0,,51,10,9,19,56.0,80,7.69,77,340,2441,12.6
10074,Gilles Hamel,1984-85,24.0,5,9,16,16,2,7,9,17.0,,67,12,16,28,73.0,80,8.03,73,320,2489,12.9
10075,Gilles Hamel,1985-86,25.0,6,42,66,66,22,20,42,121.0,,133,34,36,70,194.0,80,7.73,71,310,2444,12.7
10076,Gilles Hamel,1986-87,26.0,7,44,75,75,21,23,44,135.0,,208,55,59,114,329.0,80,7.89,74,336,2448,12.9
10077,Gilles Hamel,1987-88,27.0,8,48,80,80,18,30,48,163.0,,288,73,89,162,492.0,80,7.77,71,321,2447,12.7
10078,Gilles Hamel,1988-89,28.0,9,44,77,77,19,25,44,158.0,,365,92,114,206,650.0,80,7.94,82,370,2484,12.8
10079,Gilles Hamel,1989-90,29.0,10,48,79,79,27,21,48,175.0,,444,119,135,254,825.0,80,7.34,72,344,2400,12.2
10080,Gilles Hamel,1990-91,30.0,11,19,63,63,8,11,19,106.0,,507,127,146,273,931.0,80,7.43,89,437,2435,12.2
10081,Gilles Hamel,1991-92,31.0,12,1,12,12,0,1,1,11.0,,519,127,147,274,942.0,80,7.48,85,403,2430,12.3
10082,Gilles Thibaudeau,1989-90,26.0,4,4,9,9,1,3,4,10.0,,9,1,3,4,10.0,80,7.34,72,344,2400,12.2
10083,Gilles Thibaudeau,1990-91,27.0,5,11,17,17,5,6,11,25.0,,26,6,9,15,35.0,80,7.43,89,437,2435,12.2
10084,Gilles Thibaudeau,1991-92,28.0,6,12,32,32,6,6,12,42.0,,58,12,15,27,77.0,80,7.48,85,403,2430,12.3
10085,Gilles Thibaudeau,1992-93,29.0,7,26,41,41,11,15,26,67.0,,99,23,30,53,144.0,80,7.37,76,367,2421,12.2
10086,Gilles Thibaudeau,1993-94,30.0,8,9,20,20,2,7,9,36.0,,119,25,37,62,180.0,80,6.91,71,366,2385,11.6
10087,Gino Cavallini,1987-88,25.0,4,16,27,27,6,10,16,44.0,,27,6,10,16,44.0,80,7.77,71,321,2447,12.7
10088,Gino Cavallini,1988-89,26.0,5,25,57,57,13,12,25,95.0,,84,19,22,41,139.0,80,7.94,82,370,2484,12.8
10089,Gino Cavallini,1989-90,27.0,6,44,80,80,18,26,44,159.0,,164,37,48,85,298.0,80,7.34,72,344,2400,12.2
10090,Gino Cavallini,1990-91,28.0,7,32,64,64,15,17,32,131.0,,228,52,65,117,429.0,80,7.43,89,437,2435,12.2
10091,Gino Cavallini,1991-92,29.0,8,43,74,74,20,23,43,153.0,,302,72,88,160,582.0,80,7.48,85,403,2430,12.3
10092,Gino Cavallini,1992-93,30.0,9,30,80,80,15,15,30,134.0,,382,87,103,190,716.0,80,7.37,76,367,2421,12.2
10093,Gino Cavallini,1993-94,31.0,10,35,78,78,8,27,35,131.0,,460,95,130,225,847.0,80,6.91,71,366,2385,11.6
10094,Gino Cavallini,1994-95,32.0,11,24,66,66,10,14,24,111.0,,526,105,144,249,958.0,80,6.96,77,402,2440,11.4
10095,Gino Cavallini,1995-96,33.0,12,24,67,67,9,15,24,71.0,,593,114,159,273,1029.0,84,7.25,87,443,2603,11.7
10096,Gino Odjick,1993-94,23.0,4,8,45,45,7,1,8,39.0,,45,7,1,8,39.0,80,6.91,71,366,2385,11.6
10097,Gino Odjick,1994-95,24.0,5,10,65,65,4,6,10,68.0,,110,11,7,18,107.0,80,6.96,77,402,2440,11.4
10098,Gino Odjick,1995-96,25.0,6,17,75,75,4,13,17,79.0,,185,15,20,35,186.0,84,7.25,87,443,2603,11.7
10099,Gino Odjick,1996-97,26.0,7,29,76,76,16,13,29,121.0,,261,31,33,64,307.0,84,6.48,76,407,2545,10.7
10100,Gino Odjick,1997-98,27.0,8,9,23,23,4,5,9,35.0,,284,35,38,73,342.0,48,5.97,37,209,1408,10.2
10101,Gino Odjick,1998-99,28.0,9,7,55,55,3,4,7,59.0,,339,38,42,80,401.0,82,6.29,74,413,2481,10.4
10102,Gino Odjick,1999-00,29.0,10,13,70,70,5,8,13,85.0,,409,43,50,93,486.0,82,5.83,55,336,2444,9.8
10103,Gino Odjick,2000-01,30.0,11,5,48,48,3,2,5,52.0,,457,46,52,98,538.0,82,5.28,57,380,2242,9.6
10104,Gino Odjick,2001-02,31.0,12,7,23,23,4,3,7,28.0,227.0,480,50,55,105,566.0,82,5.27,57,359,2285,9.4
10105,Gino Odjick,2002-03,32.0,13,19,59,59,8,11,19,115.0,678.0,539,58,66,124,681.0,82,5.49,53,331,2294,9.8
10106,Gino Odjick,2003-04,33.0,14,5,30,30,2,3,5,32.0,237.0,569,60,69,129,713.0,82,5.51,63,376,2272,9.9
10107,Gino Odjick,2004-05,34.0,15,8,36,36,4,4,8,40.0,274.0,605,64,73,137,753.0,82,5.24,53,338,2262,9.5
10108,Giovanni Fiore,2020-21,24.0,4,0,1,1,0,0,0,0.0,8.0,1,0,0,0,0.0,82,5.86,50,250,2620,9.2
10109,Givani Smith,2022-23,24.0,4,3,21,21,2,1,3,22.0,203.0,21,2,1,3,22.0,70,5.96,42,208,2192,9.5
10110,Glen Currie,1982-83,24.0,4,2,32,32,2,0,2,25.0,,32,2,0,2,25.0,80,7.03,61,280,2352,12.0
10111,Glen Currie,1983-84,25.0,5,18,40,40,5,13,18,52.0,,72,7,13,20,77.0,80,7.69,77,340,2441,12.6
10112,Glen Currie,1984-85,26.0,6,14,43,43,7,7,14,45.0,,115,14,20,34,122.0,80,8.03,73,320,2489,12.9
10113,Glen Currie,1985-86,27.0,7,39,68,68,11,28,39,54.0,,183,25,48,73,176.0,80,7.73,71,310,2444,12.7
10114,Glen Currie,1986-87,28.0,8,36,80,80,12,24,36,71.0,,263,37,72,109,247.0,80,7.89,74,336,2448,12.9
10115,Glen Currie,1987-88,29.0,9,6,44,44,1,5,6,27.0,,307,38,77,115,274.0,80,7.77,71,321,2447,12.7
10116,Glen Currie,1988-89,30.0,10,3,12,12,1,2,3,11.0,,319,39,79,118,285.0,80,7.94,82,370,2484,12.8
10117,Glen Currie,1990-91,32.0,11,0,7,7,0,0,0,3.0,,326,39,79,118,288.0,80,7.43,89,437,2435,12.2
10118,Glen Featherstone,1991-92,23.0,4,2,18,18,0,2,2,9.0,,18,0,2,2,9.0,80,7.48,85,403,2430,12.3
10119,Glen Featherstone,1992-93,24.0,5,12,58,58,0,12,12,34.0,,76,0,14,14,43.0,80,7.37,76,367,2421,12.2
10120,Glen Featherstone,1993-94,25.0,6,20,68,68,5,15,20,59.0,,144,5,29,34,102.0,80,6.91,71,366,2385,11.6
10121,Glen Featherstone,1994-95,26.0,7,1,7,7,1,0,1,8.0,,151,6,29,35,110.0,80,6.96,77,402,2440,11.4
10122,Glen Featherstone,1995-96,27.0,8,10,34,34,5,5,10,33.0,,185,11,34,45,143.0,84,7.25,87,443,2603,11.7
10123,Glen Featherstone,1996-97,28.0,9,9,58,58,1,8,9,55.0,,243,12,42,54,198.0,84,6.48,76,407,2545,10.7
10124,Glen Featherstone,1997-98,29.0,10,3,19,19,2,1,3,22.0,,262,14,43,57,220.0,48,5.97,37,209,1408,10.2
10125,Glen Featherstone,1998-99,30.0,11,12,68,68,2,10,12,62.0,,330,16,53,69,282.0,82,6.29,74,413,2481,10.4
10126,Glen Featherstone,1999-00,31.0,12,11,54,54,3,8,11,67.0,,384,19,61,80,349.0,82,5.83,55,336,2444,9.8
10127,Glen Metropolit,2002-03,28.0,4,19,30,30,6,13,19,57.0,398.0,30,6,13,19,57.0,82,5.49,53,331,2294,9.8
10128,Glen Metropolit,2003-04,29.0,5,6,15,15,1,5,6,20.0,178.0,45,7,18,25,77.0,82,5.51,63,376,2272,9.9
10129,Glen Metropolit,2004-05,30.0,6,17,35,35,1,16,17,52.0,496.0,80,8,34,42,129.0,82,5.24,53,338,2262,9.5
10130,Glen Metropolit,2005-06,31.0,7,5,23,23,2,3,5,22.0,233.0,103,10,37,47,151.0,82,5.31,60,363,2326,9.4
10131,Glen Metropolit,2009-10,35.0,8,33,77,77,14,19,33,123.0,931.0,180,24,56,80,274.0,82,5.76,70,398,2426,9.7
10132,Glen Metropolit,2010-11,36.0,9,33,82,82,11,22,33,141.0,1347.0,262,35,78,113,415.0,82,5.44,62,351,2383,9.4
10133,Glen Metropolit,2011-12,37.0,10,17,76,76,6,11,17,82.0,958.0,338,41,89,130,497.0,82,5.7,65,341,2477,9.4
10134,Glen Metropolit,2012-13,38.0,11,29,69,69,16,13,29,115.0,936.0,407,57,102,159,612.0,82,5.53,56,304,2486,9.1
10135,Glen Murray,1994-95,22.0,4,4,5,5,3,1,4,20.0,,5,3,1,4,20.0,80,6.96,77,402,2440,11.4
10136,Glen Murray,1995-96,23.0,5,7,27,27,3,4,7,28.0,,32,6,5,11,48.0,84,7.25,87,443,2603,11.7
10137,Glen Murray,1996-97,24.0,6,31,81,81,18,13,31,114.0,,113,24,18,42,162.0,84,6.48,76,407,2545,10.7
10138,Glen Murray,1997-98,25.0,7,7,35,35,5,2,7,64.0,,148,29,20,49,226.0,48,5.97,37,209,1408,10.2
10139,Glen Murray,1998-99,26.0,8,29,69,69,14,15,29,100.0,,217,43,35,78,326.0,82,6.29,74,413,2481,10.4
10140,Glen Murray,1999-00,27.0,9,30,77,77,16,14,30,153.0,,294,59,49,108,479.0,82,5.83,55,336,2444,9.8
10141,Glen Murray,2000-01,28.0,10,60,81,81,29,31,60,193.0,,375,88,80,168,672.0,82,5.28,57,380,2242,9.6
10142,Glen Murray,2001-02,29.0,11,31,61,61,16,15,31,173.0,1254.0,436,104,95,199,845.0,82,5.27,57,359,2285,9.4
10143,Glen Murray,2002-03,30.0,12,62,78,78,29,33,62,202.0,1443.0,514,133,128,261,1047.0,82,5.49,53,331,2294,9.8
10144,Glen Murray,2003-04,31.0,13,39,64,64,18,21,39,138.0,1165.0,578,151,149,300,1185.0,82,5.51,63,376,2272,9.9
10145,Glen Murray,2004-05,32.0,14,71,82,82,41,30,71,246.0,1620.0,660,192,179,371,1431.0,82,5.24,53,338,2262,9.5
10146,Glen Murray,2005-06,33.0,15,92,82,82,44,48,92,331.0,1854.0,742,236,227,463,1762.0,82,5.31,60,363,2326,9.4
10147,Glen Murray,2006-07,34.0,16,60,81,81,32,28,60,260.0,1696.0,823,268,255,523,2022.0,82,5.14,57,348,2300,9.2
10148,Glen Murray,2008-09,36.0,17,53,64,64,24,29,53,195.0,1292.0,887,292,284,576,2217.0,82,6.05,85,480,2458,10.1
10149,Glen Murray,2009-10,37.0,18,45,59,59,28,17,45,201.0,1106.0,946,320,301,621,2418.0,82,5.76,70,398,2426,9.7
10150,Glen Murray,2010-11,38.0,19,30,63,63,17,13,30,158.0,1147.0,1009,337,314,651,2576.0,82,5.44,62,351,2383,9.4
10151,Glen Seabrooke,1989-90,22.0,4,5,10,10,1,4,5,10.0,,10,1,4,5,10.0,80,7.34,72,344,2400,12.2
10152,Glen Seabrooke,1990-91,23.0,5,1,6,6,0,1,1,3.0,,16,1,5,6,13.0,80,7.43,89,437,2435,12.2
10153,Glen Seabrooke,1991-92,24.0,6,1,3,3,0,1,1,0.0,,19,1,6,7,13.0,80,7.48,85,403,2430,12.3
10154,Glen Wesley,1990-91,22.0,4,37,79,79,7,30,37,158.0,,79,7,30,37,158.0,80,7.43,89,437,2435,12.2
10155,Glen Wesley,1991-92,23.0,5,54,77,77,19,35,54,181.0,,156,26,65,91,339.0,80,7.48,85,403,2430,12.3
10156,Glen Wesley,1992-93,24.0,6,36,78,78,9,27,36,166.0,,234,35,92,127,505.0,80,7.37,76,367,2421,12.2
10157,Glen Wesley,1993-94,25.0,7,43,80,80,11,32,43,199.0,,314,46,124,170,704.0,80,6.91,71,366,2385,11.6
10158,Glen Wesley,1994-95,26.0,8,46,78,78,9,37,46,211.0,,392,55,161,216,915.0,80,6.96,77,402,2440,11.4
10159,Glen Wesley,1995-96,27.0,9,33,64,64,8,25,33,183.0,,456,63,186,249,1098.0,84,7.25,87,443,2603,11.7
10160,Glen Wesley,1996-97,28.0,10,58,81,81,14,44,58,265.0,,537,77,230,307,1363.0,84,6.48,76,407,2545,10.7
10161,Glen Wesley,1997-98,29.0,11,16,48,48,2,14,16,125.0,,585,79,244,323,1488.0,48,5.97,37,209,1408,10.2
10162,Glen Wesley,1998-99,30.0,12,24,68,68,8,16,24,129.0,,653,87,260,347,1617.0,82,6.29,74,413,2481,10.4
10163,Glen Wesley,1999-00,31.0,13,32,68,68,6,26,32,126.0,,721,93,286,379,1743.0,82,5.83,55,336,2444,9.8
10164,Glen Wesley,2000-01,32.0,14,25,82,82,6,19,25,121.0,,803,99,305,404,1864.0,82,5.28,57,380,2242,9.6
10165,Glen Wesley,2001-02,33.0,15,24,74,74,7,17,24,112.0,1666.0,877,106,322,428,1976.0,82,5.27,57,359,2285,9.4
10166,Glen Wesley,2002-03,34.0,16,22,78,78,7,15,22,99.0,1680.0,955,113,337,450,2075.0,82,5.49,53,331,2294,9.8
10167,Glen Wesley,2003-04,35.0,17,21,71,71,5,16,21,92.0,1587.0,1026,118,353,471,2167.0,82,5.51,63,376,2272,9.9
10168,Glen Wesley,2004-05,36.0,18,18,77,77,5,13,18,88.0,1557.0,1103,123,366,489,2255.0,82,5.24,53,338,2262,9.5
10169,Glen Wesley,2005-06,37.0,19,11,70,70,1,10,11,77.0,1493.0,1173,124,376,500,2332.0,82,5.31,60,363,2326,9.4
10170,Glen Wesley,2006-07,38.0,20,6,74,74,0,6,6,82.0,1581.0,1247,124,382,506,2414.0,82,5.14,57,348,2300,9.2
10171,Glen Wesley,2008-09,40.0,21,10,64,64,2,8,10,28.0,990.0,1311,126,390,516,2442.0,82,6.05,85,480,2458,10.1
10172,Glen Wesley,2009-10,41.0,22,13,68,68,1,12,13,51.0,1060.0,1379,127,402,529,2493.0,82,5.76,70,398,2426,9.7
10173,Glen Wesley,2010-11,42.0,23,8,78,78,1,7,8,63.0,1255.0,1457,128,409,537,2556.0,82,5.44,62,351,2383,9.4
10174,Glenn Anderson,1983-84,23.0,4,53,58,58,30,23,53,161.0,,58,30,23,53,161.0,80,7.69,77,340,2441,12.6
10175,Glenn Anderson,1984-85,24.0,5,105,80,80,38,67,105,252.0,,138,68,90,158,413.0,80,8.03,73,320,2489,12.9
10176,Glenn Anderson,1985-86,25.0,6,104,72,72,48,56,104,243.0,,210,116,146,262,656.0,80,7.73,71,310,2444,12.7
10177,Glenn Anderson,1986-87,26.0,7,99,80,80,54,45,99,277.0,,290,170,191,361,933.0,80,7.89,74,336,2448,12.9
10178,Glenn Anderson,1987-88,27.0,8,81,80,80,42,39,81,258.0,,370,212,230,442,1191.0,80,7.77,71,321,2447,12.7
10179,Glenn Anderson,1988-89,28.0,9,102,72,72,54,48,102,242.0,,442,266,278,544,1433.0,80,7.94,82,370,2484,12.8
10180,Glenn Anderson,1989-90,29.0,10,73,80,80,35,38,73,189.0,,522,301,316,617,1622.0,80,7.34,72,344,2400,12.2
10181,Glenn Anderson,1990-91,30.0,11,88,80,80,38,50,88,255.0,,602,339,366,705,1877.0,80,7.43,89,437,2435,12.2
10182,Glenn Anderson,1991-92,31.0,12,64,79,79,16,48,64,212.0,,681,355,414,769,2089.0,80,7.48,85,403,2430,12.3
10183,Glenn Anderson,1992-93,32.0,13,72,73,73,34,38,72,204.0,,754,389,452,841,2293.0,80,7.37,76,367,2421,12.2
10184,Glenn Anderson,1993-94,33.0,14,55,74,74,24,31,55,193.0,,828,413,483,896,2486.0,80,6.91,71,366,2385,11.6
10185,Glenn Anderson,1994-95,34.0,15,57,72,72,24,33,57,188.0,,900,437,516,953,2674.0,80,6.96,77,402,2440,11.4
10186,Glenn Anderson,1995-96,35.0,16,65,76,76,22,43,65,161.0,,976,459,559,1018,2835.0,84,7.25,87,443,2603,11.7
10187,Glenn Anderson,1996-97,36.0,17,41,85,85,21,20,41,149.0,,1061,480,579,1059,2984.0,84,6.48,76,407,2545,10.7
10188,Glenn Anderson,1997-98,37.0,18,26,36,36,12,14,26,54.0,,1097,492,593,1085,3038.0,48,5.97,37,209,1408,10.2
10189,Glenn Anderson,1998-99,38.0,19,14,32,32,6,8,14,71.0,,1129,498,601,1099,3109.0,82,6.29,74,413,2481,10.4
10190,Glenn Hicks,1982-83,24.0,4,3,50,50,1,2,3,52.0,,50,1,2,3,52.0,80,7.03,61,280,2352,12.0
10191,Glenn Hicks,1983-84,25.0,5,15,58,58,5,10,15,71.0,,108,6,12,18,123.0,80,7.69,77,340,2441,12.6
10192,Glenn Johannesen,1988-89,26.0,4,0,2,2,0,0,0,2.0,,2,0,0,0,2.0,80,7.94,82,370,2484,12.8
10193,Glenn Merkosky,1984-85,25.0,4,0,7,7,0,0,0,2.0,,7,0,0,0,2.0,80,8.03,73,320,2489,12.9
10194,Glenn Merkosky,1985-86,26.0,5,14,34,34,4,10,14,43.0,,41,4,10,14,45.0,80,7.73,71,310,2444,12.7
10195,Glenn Merkosky,1986-87,27.0,6,1,5,5,1,0,1,6.0,,46,5,10,15,51.0,80,7.89,74,336,2448,12.9
10196,Glenn Merkosky,1988-89,29.0,7,2,17,17,0,2,2,18.0,,63,5,12,17,69.0,80,7.94,82,370,2484,12.8
10197,Glenn Merkosky,1992-93,33.0,8,0,3,3,0,0,0,0.0,,66,5,12,17,69.0,80,7.37,76,367,2421,12.2
10198,Glenn Mulvenna,1994-95,27.0,4,0,1,1,0,0,0,0.0,,1,0,0,0,0.0,80,6.96,77,402,2440,11.4
10199,Glenn Mulvenna,1995-96,28.0,5,0,1,1,0,0,0,1.0,,2,0,0,0,1.0,84,7.25,87,443,2603,11.7
10200,Glenn Tomalty,1982-83,28.0,4,0,1,1,0,0,0,1.0,,1,0,0,0,1.0,80,7.03,61,280,2352,12.0
10201,Goran Bezina,2006-07,26.0,4,0,3,3,0,0,0,0.0,16.0,3,0,0,0,0.0,82,5.14,57,348,2300,9.2
10202,Gord Dineen,1985-86,23.0,4,0,2,2,0,0,0,3.0,,2,0,0,0,3.0,80,7.73,71,310,2444,12.7
10203,Gord Dineen,1986-87,24.0,5,12,43,43,1,11,12,37.0,,45,1,11,12,40.0,80,7.89,74,336,2448,12.9
10204,Gord Dineen,1987-88,25.0,6,13,48,48,1,12,13,46.0,,93,2,23,25,86.0,80,7.77,71,321,2447,12.7
10205,Gord Dineen,1988-89,26.0,7,9,57,57,1,8,9,52.0,,150,3,31,34,138.0,80,7.94,82,370,2484,12.8
10206,Gord Dineen,1989-90,27.0,8,14,71,71,4,10,14,59.0,,221,7,41,48,197.0,80,7.34,72,344,2400,12.2
10207,Gord Dineen,1990-91,28.0,9,18,70,70,5,13,18,56.0,,291,12,54,66,253.0,80,7.43,89,437,2435,12.2
10208,Gord Dineen,1991-92,29.0,10,4,40,40,1,3,4,32.0,,331,13,57,70,285.0,80,7.48,85,403,2430,12.3
10209,Gord Dineen,1992-93,30.0,11,9,69,69,1,8,9,38.0,,400,14,65,79,323.0,80,7.37,76,367,2421,12.2
10210,Gord Dineen,1993-94,31.0,12,0,9,9,0,0,0,6.0,,409,14,65,79,329.0,80,6.91,71,366,2385,11.6
10211,Gord Dineen,1994-95,32.0,13,0,1,1,0,0,0,0.0,,410,14,65,79,329.0,80,6.96,77,402,2440,11.4
10212,Gord Dineen,1995-96,33.0,14,6,32,32,2,4,6,36.0,,442,16,69,85,365.0,84,7.25,87,443,2603,11.7
10213,Gord Dineen,1996-97,34.0,15,21,77,77,0,21,21,62.0,,519,16,90,106,427.0,84,6.48,76,407,2545,10.7
10214,Gord Dineen,1997-98,35.0,16,0,9,9,0,0,0,4.0,,528,16,90,106,431.0,48,5.97,37,209,1408,10.2
10215,Gord Donnelly,1986-87,24.0,4,5,38,38,0,5,5,14.0,,38,0,5,5,14.0,80,7.89,74,336,2448,12.9
10216,Gord Donnelly,1987-88,25.0,5,0,22,22,0,0,0,7.0,,60,0,5,5,21.0,80,7.77,71,321,2447,12.7
10217,Gord Donnelly,1988-89,26.0,6,4,36,36,2,2,4,30.0,,96,2,7,9,51.0,80,7.94,82,370,2484,12.8
10218,Gord Donnelly,1989-90,27.0,7,2,38,38,0,2,2,14.0,,134,2,9,11,65.0,80,7.34,72,344,2400,12.2
10219,Gord Donnelly,1990-91,28.0,8,7,63,63,4,3,7,46.0,,197,6,12,18,111.0,80,7.43,89,437,2435,12.2
10220,Gord Donnelly,1991-92,29.0,9,20,73,73,10,10,20,67.0,,270,16,22,38,178.0,80,7.48,85,403,2430,12.3
10221,Gord Donnelly,1992-93,30.0,10,6,55,55,3,3,6,43.0,,325,19,25,44,221.0,80,7.37,76,367,2421,12.2
10222,Gord Donnelly,1993-94,31.0,11,7,57,57,3,4,7,35.0,,382,22,29,51,256.0,80,6.91,71,366,2385,11.6
10223,Gord Donnelly,1994-95,32.0,12,5,71,71,2,3,5,30.0,,453,24,32,56,286.0,80,6.96,77,402,2440,11.4
10224,Gord Donnelly,1995-96,33.0,13,11,60,60,3,8,11,38.0,,513,27,40,67,324.0,84,7.25,87,443,2603,11.7
10225,Gord Donnelly,1996-97,34.0,14,1,25,25,0,1,1,7.0,,538,27,41,68,331.0,84,6.48,76,407,2545,10.7
10226,Gord Donnelly,1997-98,35.0,15,1,16,16,1,0,1,9.0,,554,28,41,69,340.0,48,5.97,37,209,1408,10.2
10227,Gord Hampson,1985-86,26.0,4,0,4,4,0,0,0,4.0,,4,0,0,0,4.0,80,7.73,71,310,2444,12.7
10228,Gord Hynes,1994-95,28.0,4,5,15,15,0,5,5,16.0,,15,0,5,5,16.0,80,6.96,77,402,2440,11.4
10229,Gord Hynes,1995-96,29.0,5,7,37,37,3,4,7,39.0,,52,3,9,12,55.0,84,7.25,87,443,2603,11.7
10230,Gord Kluzak,1985-86,21.0,4,7,70,70,1,6,7,49.0,,70,1,6,7,49.0,80,7.73,71,310,2444,12.7
10231,Gord Kluzak,1986-87,22.0,5,37,80,80,10,27,37,121.0,,150,11,33,44,170.0,80,7.89,74,336,2448,12.9
10232,Gord Kluzak,1988-89,24.0,6,39,70,70,8,31,39,114.0,,220,19,64,83,284.0,80,7.94,82,370,2484,12.8
10233,Gord Kluzak,1990-91,26.0,7,37,66,66,6,31,37,168.0,,286,25,95,120,452.0,80,7.43,89,437,2435,12.2
10234,Gord Kluzak,1991-92,27.0,8,1,3,3,0,1,1,4.0,,289,25,96,121,456.0,80,7.48,85,403,2430,12.3
10235,Gord Kluzak,1992-93,28.0,9,2,8,8,0,2,2,8.0,,297,25,98,123,464.0,80,7.37,76,367,2421,12.2
10236,Gord Kluzak,1993-94,29.0,10,0,2,2,0,0,0,3.0,,299,25,98,123,467.0,80,6.91,71,366,2385,11.6
10237,Gord Kruppke,1993-94,24.0,4,0,4,4,0,0,0,0.0,,4,0,0,0,0.0,80,6.91,71,366,2385,11.6
10238,Gord Kruppke,1995-96,26.0,5,0,10,10,0,0,0,7.0,,14,0,0,0,7.0,84,7.25,87,443,2603,11.7
10239,Gord Kruppke,1996-97,27.0,6,0,9,9,0,0,0,5.0,,23,0,0,0,12.0,84,6.48,76,407,2545,10.7
10240,Gord Murphy,1991-92,24.0,4,35,75,75,4,31,35,116.0,,75,4,31,35,116.0,80,7.48,85,403,2430,12.3
10241,Gord Murphy,1992-93,25.0,5,41,75,75,14,27,41,160.0,,150,18,58,76,276.0,80,7.37,76,367,2421,12.2
10242,Gord Murphy,1993-94,26.0,6,42,80,80,11,31,42,203.0,,230,29,89,118,479.0,80,6.91,71,366,2385,11.6
10243,Gord Murphy,1994-95,27.0,7,19,73,73,5,14,19,132.0,,303,34,103,137,611.0,80,6.96,77,402,2440,11.4
10244,Gord Murphy,1995-96,28.0,8,17,49,49,5,12,17,68.0,,352,39,115,154,679.0,84,7.25,87,443,2603,11.7
10245,Gord Murphy,1996-97,29.0,9,43,84,84,14,29,43,172.0,,436,53,144,197,851.0,84,6.48,76,407,2545,10.7
10246,Gord Murphy,1997-98,30.0,10,22,46,46,6,16,22,94.0,,482,59,160,219,945.0,48,5.97,37,209,1408,10.2
10247,Gord Murphy,1998-99,31.0,11,30,70,70,8,22,30,125.0,,552,67,182,249,1070.0,82,6.29,74,413,2481,10.4
10248,Gord Murphy,1999-00,32.0,12,23,80,80,8,15,23,137.0,,632,75,197,272,1207.0,82,5.83,55,336,2444,9.8
10249,Gord Murphy,2000-01,33.0,13,17,79,79,6,11,17,123.0,,711,81,208,289,1330.0,82,5.28,57,380,2242,9.6
10250,Gord Murphy,2001-02,34.0,14,7,51,51,0,7,7,56.0,1017.0,762,81,215,296,1386.0,82,5.27,57,359,2285,9.4
10251,Gord Murphy,2002-03,35.0,15,11,58,58,1,10,11,74.0,1315.0,820,82,225,307,1460.0,82,5.49,53,331,2294,9.8
10252,Gord Murphy,2003-04,36.0,16,14,27,27,3,11,14,44.0,560.0,847,85,236,321,1504.0,82,5.51,63,376,2272,9.9
10253,Gord Murphy,2004-05,37.0,17,2,15,15,0,2,2,10.0,218.0,862,85,238,323,1514.0,82,5.24,53,338,2262,9.5
10254,Gord Sherven,1986-87,23.0,4,1,2,2,1,0,1,5.0,,2,1,0,1,5.0,80,7.89,74,336,2448,12.9
10255,Gord Sherven,1987-88,24.0,5,30,69,69,11,19,30,97.0,,71,12,19,31,102.0,80,7.77,71,321,2447,12.7
10256,Gord Sherven,1988-89,25.0,6,4,18,18,1,3,4,14.0,,89,13,22,35,116.0,80,7.94,82,370,2484,12.8
10257,Gord Sherven,1989-90,26.0,7,0,7,7,0,0,0,7.0,,96,13,22,35,123.0,80,7.34,72,344,2400,12.2
10258,Gord Sherven,1990-91,27.0,8,0,1,1,0,0,0,2.0,,97,13,22,35,125.0,80,7.43,89,437,2435,12.2
10259,Gord Walker,1989-90,24.0,4,1,1,1,1,0,1,1.0,,1,1,0,1,1.0,80,7.34,72,344,2400,12.2
10260,Gord Walker,1990-91,25.0,5,5,18,18,1,4,5,23.0,,19,2,4,6,24.0,80,7.43,89,437,2435,12.2
10261,Gord Walker,1991-92,26.0,6,1,11,11,1,0,1,13.0,,30,3,4,7,37.0,80,7.48,85,403,2430,12.3
10262,Gord Walker,1992-93,27.0,7,0,1,1,0,0,0,0.0,,31,3,4,7,37.0,80,7.37,76,367,2421,12.2
10263,Gord Wappel,1982-83,24.0,4,0,2,2,0,0,0,2.0,,2,0,0,0,2.0,80,7.03,61,280,2352,12.0
10264,Gord Wappel,1983-84,25.0,5,1,7,7,0,1,1,3.0,,9,0,1,1,5.0,80,7.69,77,340,2441,12.6
10265,Gord Wappel,1984-85,26.0,6,1,11,11,1,0,1,7.0,,20,1,1,2,12.0,80,8.03,73,320,2489,12.9
10266,Gord Williams,1984-85,24.0,4,0,1,1,0,0,0,1.0,,1,0,0,0,1.0,80,8.03,73,320,2489,12.9
10267,Gord Williams,1985-86,25.0,5,0,1,1,0,0,0,1.0,,2,0,0,0,2.0,80,7.73,71,310,2444,12.7
10268,Gordie Dwyer,2002-03,25.0,4,1,24,24,0,1,1,7.0,119.0,24,0,1,1,7.0,82,5.49,53,331,2294,9.8
10269,Gordie Dwyer,2003-04,26.0,5,1,28,28,0,1,1,12.0,162.0,52,0,2,2,19.0,82,5.51,63,376,2272,9.9
10270,Gordie Dwyer,2004-05,27.0,6,2,26,26,0,2,2,6.0,132.0,78,0,4,4,25.0,82,5.24,53,338,2262,9.5
10271,Gordie Dwyer,2005-06,28.0,7,1,28,28,0,1,1,10.0,193.0,106,0,5,5,35.0,82,5.31,60,363,2326,9.4
10272,Gordie Dwyer,2006-07,29.0,8,0,2,2,0,0,0,0.0,12.0,108,0,5,5,35.0,82,5.14,57,348,2300,9.2
10273,Gordie Roberts,1982-83,25.0,4,36,80,80,8,28,36,107.0,,80,8,28,36,107.0,80,7.03,61,280,2352,12.0
10274,Gordie Roberts,1983-84,26.0,5,50,77,77,8,42,50,119.0,,157,16,70,86,226.0,80,7.69,77,340,2441,12.6
10275,Gordie Roberts,1984-85,27.0,6,34,79,79,4,30,34,104.0,,236,20,100,120,330.0,80,8.03,73,320,2489,12.9
10276,Gordie Roberts,1985-86,28.0,7,44,80,80,3,41,44,126.0,,316,23,141,164,456.0,80,7.73,71,310,2444,12.7
10277,Gordie Roberts,1986-87,29.0,8,53,77,77,8,45,53,129.0,,393,31,186,217,585.0,80,7.89,74,336,2448,12.9
10278,Gordie Roberts,1987-88,30.0,9,42,78,78,6,36,42,142.0,,471,37,222,259,727.0,80,7.77,71,321,2447,12.7
10279,Gordie Roberts,1988-89,31.0,10,23,76,76,2,21,23,66.0,,547,39,243,282,793.0,80,7.94,82,370,2484,12.8
10280,Gordie Roberts,1989-90,32.0,11,13,67,67,3,10,13,43.0,,614,42,253,295,836.0,80,7.34,72,344,2400,12.2
10281,Gordie Roberts,1990-91,33.0,12,18,70,70,3,15,18,52.0,,684,45,268,313,888.0,80,7.43,89,437,2435,12.2
10282,Gordie Roberts,1991-92,34.0,13,26,77,77,2,24,26,52.0,,761,47,292,339,940.0,80,7.48,85,403,2430,12.3
10283,Gordie Roberts,1992-93,35.0,14,17,75,75,3,14,17,56.0,,836,50,306,356,996.0,80,7.37,76,367,2421,12.2
10284,Gordie Roberts,1993-94,36.0,15,16,64,64,3,13,16,24.0,,900,53,319,372,1020.0,80,6.91,71,366,2385,11.6
10285,Gordie Roberts,1994-95,37.0,16,24,73,73,2,22,24,29.0,,973,55,341,396,1049.0,80,6.96,77,402,2440,11.4
10286,Gordie Roberts,1995-96,38.0,17,17,65,65,5,12,17,40.0,,1038,60,353,413,1089.0,84,7.25,87,443,2603,11.7
10287,Gordie Roberts,1996-97,39.0,18,7,59,59,1,6,7,19.0,,1097,61,359,420,1108.0,84,6.48,76,407,2545,10.7
10288,Gordon Mark,1989-90,25.0,4,8,36,36,3,5,8,31.0,,36,3,5,8,31.0,80,7.34,72,344,2400,12.2
10289,Gordon Mark,1990-91,26.0,5,2,19,19,0,2,2,11.0,,55,3,7,10,42.0,80,7.43,89,437,2435,12.2
10290,Gordon Mark,1996-97,32.0,6,1,12,12,0,1,1,8.0,,67,3,8,11,50.0,84,6.48,76,407,2545,10.7
10291,Gordon Mark,1997-98,33.0,7,2,18,18,0,2,2,21.0,,85,3,10,13,71.0,48,5.97,37,209,1408,10.2
10292,Graeme Townshend,1992-93,27.0,4,0,4,4,0,0,0,3.0,,4,0,0,0,3.0,80,7.37,76,367,2421,12.2
10293,Graeme Townshend,1993-94,28.0,5,7,18,18,2,5,7,10.0,,22,2,5,7,13.0,80,6.91,71,366,2385,11.6
10294,Graeme Townshend,1994-95,29.0,6,3,7,7,1,2,3,6.0,,29,3,7,10,19.0,80,6.96,77,402,2440,11.4
10295,Graeme Townshend,1995-96,30.0,7,0,2,2,0,0,0,0.0,,31,3,7,10,19.0,84,7.25,87,443,2603,11.7
10296,Graeme Townshend,1996-97,31.0,8,0,14,14,0,0,0,5.0,,45,3,7,10,24.0,84,6.48,76,407,2545,10.7
10297,Graham Mink,2006-07,27.0,4,0,2,2,0,0,0,0.0,11.0,2,0,0,0,0.0,82,5.14,57,348,2300,9.2
10298,Graham Mink,2008-09,29.0,5,0,3,3,0,0,0,1.0,17.0,5,0,0,0,1.0,82,6.05,85,480,2458,10.1
10299,Graham Mink,2011-12,32.0,6,0,2,2,0,0,0,4.0,16.0,7,0,0,0,5.0,82,5.7,65,341,2477,9.4
10300,Grant Clitsome,2012-13,27.0,4,3,11,11,1,2,3,7.0,162.0,11,1,2,3,7.0,82,5.53,56,304,2486,9.1
10301,Grant Clitsome,2013-14,28.0,5,19,31,31,4,15,19,50.0,659.0,42,5,17,22,57.0,82,5.46,52,291,2492,9.0
10302,Grant Clitsome,2014-15,29.0,6,17,63,63,4,13,17,87.0,1071.0,105,9,30,39,144.0,82,5.32,47,271,2439,8.9
10303,Grant Clitsome,2015-16,30.0,7,16,44,44,4,12,16,56.0,829.0,149,13,42,55,200.0,48,5.31,29,160,1399,9.1
10304,Grant Clitsome,2016-17,31.0,8,12,32,32,2,10,12,42.0,633.0,181,15,52,67,242.0,82,5.34,48,269,2463,8.9
10305,Grant Clitsome,2017-18,32.0,9,4,24,24,0,4,4,22.0,393.0,205,15,56,71,264.0,82,5.32,47,251,2453,8.9
10306,Grant Jennings,1991-92,26.0,4,13,55,55,3,10,13,39.0,,55,3,10,13,39.0,80,7.48,85,403,2430,12.3
10307,Grant Jennings,1992-93,27.0,5,9,64,64,3,6,9,45.0,,119,6,16,22,84.0,80,7.37,76,367,2421,12.2
10308,Grant Jennings,1993-94,28.0,6,9,57,57,2,7,9,36.0,,176,8,23,31,120.0,80,6.91,71,366,2385,11.6
10309,Grant Jennings,1994-95,29.0,7,9,53,53,4,5,9,35.0,,229,12,28,40,155.0,80,6.96,77,402,2440,11.4
10310,Grant Jennings,1995-96,30.0,8,5,58,58,0,5,5,32.0,,287,12,33,45,187.0,84,7.25,87,443,2603,11.7
10311,Grant Jennings,1996-97,31.0,9,6,61,61,2,4,6,49.0,,348,14,37,51,236.0,84,6.48,76,407,2545,10.7
10312,Grant Jennings,1997-98,32.0,10,6,35,35,0,6,6,25.0,,383,14,43,57,261.0,48,5.97,37,209,1408,10.2
10313,Grant Jennings,1998-99,33.0,11,0,6,6,0,0,0,3.0,,389,14,43,57,264.0,82,6.29,74,413,2481,10.4
10314,Grant Ledyard,1987-88,26.0,4,20,42,42,8,12,20,91.0,,42,8,12,20,91.0,80,7.77,71,321,2447,12.7
10315,Grant Ledyard,1988-89,27.0,5,36,79,79,9,27,36,170.0,,121,17,39,56,261.0,80,7.94,82,370,2484,12.8
10316,Grant Ledyard,1989-90,28.0,6,37,67,67,14,23,37,144.0,,188,31,62,93,405.0,80,7.34,72,344,2400,12.2
10317,Grant Ledyard,1990-91,29.0,7,15,44,44,5,10,15,81.0,,232,36,72,108,486.0,80,7.43,89,437,2435,12.2
10318,Grant Ledyard,1991-92,30.0,8,20,74,74,4,16,20,106.0,,306,40,88,128,592.0,80,7.48,85,403,2430,12.3
10319,Grant Ledyard,1992-93,31.0,9,15,67,67,2,13,15,91.0,,373,42,101,143,683.0,80,7.37,76,367,2421,12.2
10320,Grant Ledyard,1993-94,32.0,10,31,60,60,8,23,31,118.0,,433,50,124,174,801.0,80,6.91,71,366,2385,11.6
10321,Grant Ledyard,1994-95,33.0,11,21,50,50,5,16,21,87.0,,483,55,140,195,888.0,80,6.96,77,402,2440,11.4
10322,Grant Ledyard,1995-96,34.0,12,16,50,50,2,14,16,79.0,,533,57,154,211,967.0,84,7.25,87,443,2603,11.7
10323,Grant Ledyard,1996-97,35.0,13,46,84,84,9,37,46,177.0,,617,66,191,257,1144.0,84,6.48,76,407,2545,10.7
10324,Grant Ledyard,1997-98,36.0,14,18,38,38,5,13,18,79.0,,655,71,204,275,1223.0,48,5.97,37,209,1408,10.2
10325,Grant Ledyard,1998-99,37.0,15,24,73,73,5,19,24,123.0,,728,76,223,299,1346.0,82,6.29,74,413,2481,10.4
10326,Grant Ledyard,1999-00,38.0,16,16,67,67,1,15,16,99.0,,795,77,238,315,1445.0,82,5.83,55,336,2444,9.8
10327,Grant Ledyard,2000-01,39.0,17,24,71,71,4,20,24,90.0,,866,81,258,339,1535.0,82,5.28,57,380,2242,9.6
10328,Grant Ledyard,2001-02,40.0,18,12,47,47,4,8,12,47.0,823.0,913,85,266,351,1582.0,82,5.27,57,359,2285,9.4
10329,Grant Ledyard,2002-03,41.0,19,6,40,40,2,4,6,42.0,590.0,953,87,270,357,1624.0,82,5.49,53,331,2294,9.8
10330,Grant Ledyard,2003-04,42.0,20,5,22,22,2,3,5,19.0,379.0,975,89,273,362,1643.0,82,5.51,63,376,2272,9.9
10331,Grant Ledyard,2004-05,43.0,21,4,53,53,1,3,4,27.0,773.0,1028,90,276,366,1670.0,82,5.24,53,338,2262,9.5
10332,Grant Lewis,2011-12,27.0,4,0,1,1,0,0,0,1.0,15.0,1,0,0,0,1.0,82,5.7,65,341,2477,9.4
10333,Grant Marshall,1997-98,24.0,4,1,2,2,0,1,1,0.0,,2,0,1,1,0.0,48,5.97,37,209,1408,10.2
10334,Grant Marshall,1998-99,25.0,5,28,70,70,9,19,28,62.0,,72,9,20,29,62.0,82,6.29,74,413,2481,10.4
10335,Grant Marshall,1999-00,26.0,6,10,56,56,6,4,10,62.0,,128,15,24,39,124.0,82,5.83,55,336,2444,9.8
10336,Grant Marshall,2000-01,27.0,7,19,72,72,9,10,19,91.0,,200,24,34,58,215.0,82,5.28,57,380,2242,9.6
10337,Grant Marshall,2001-02,28.0,8,31,82,82,13,18,31,112.0,1037.0,282,37,52,89,327.0,82,5.27,57,359,2285,9.4
10338,Grant Marshall,2002-03,29.0,9,8,45,45,2,6,8,43.0,509.0,327,39,58,97,370.0,82,5.49,53,331,2294,9.8
10339,Grant Marshall,2003-04,30.0,10,37,75,75,13,24,37,93.0,832.0,402,52,82,134,463.0,82,5.51,63,376,2272,9.9
10340,Grant Marshall,2004-05,31.0,11,33,81,81,15,18,33,152.0,1252.0,483,67,100,167,615.0,82,5.24,53,338,2262,9.5
10341,Grant Marshall,2005-06,32.0,12,32,76,76,9,23,32,113.0,1036.0,559,76,123,199,728.0,82,5.31,60,363,2326,9.4
10342,Grant Marshall,2006-07,33.0,13,15,65,65,8,7,15,76.0,838.0,624,84,130,214,804.0,82,5.14,57,348,2300,9.2
10343,Grant Marshall,2008-09,35.0,14,25,76,76,8,17,25,89.0,960.0,700,92,147,239,893.0,82,6.05,85,480,2458,10.1
10344,Grant Martin,1986-87,24.0,4,2,12,12,0,2,2,7.0,,12,0,2,2,7.0,80,7.89,74,336,2448,12.9
10345,Grant Martin,1987-88,25.0,5,1,12,12,0,1,1,1.0,,24,0,3,3,8.0,80,7.77,71,321,2447,12.7
10346,Grant Martin,1988-89,26.0,6,1,11,11,0,1,1,5.0,,35,0,4,4,13.0,80,7.94,82,370,2484,12.8
10347,Grant Martin,1989-90,27.0,7,0,9,9,0,0,0,5.0,,44,0,4,4,18.0,80,7.34,72,344,2400,12.2
10348,Grant McNeill,2006-07,23.0,4,0,3,3,0,0,0,0.0,8.0,3,0,0,0,0.0,82,5.14,57,348,2300,9.2
10349,Grant Sasser,1986-87,22.0,4,0,3,3,0,0,0,2.0,,3,0,0,0,2.0,80,7.89,74,336,2448,12.9
10350,Grant Stevenson,2008-09,27.0,4,22,47,47,10,12,22,67.0,561.0,47,10,12,22,67.0,82,6.05,85,480,2458,10.1
10351,Greg Adams,1983-84,23.0,4,3,6,6,3,0,3,6.0,,6,3,0,3,6.0,80,7.69,77,340,2441,12.6
10352,Greg Adams,1984-85,24.0,5,19,33,33,4,15,19,29.0,,39,7,15,22,35.0,80,8.03,73,320,2489,12.9
10353,Greg Adams,1985-86,25.0,6,23,79,79,10,13,23,114.0,,118,17,28,45,149.0,80,7.73,71,310,2444,12.7
10354,Greg Adams,1986-87,26.0,7,8,57,57,2,6,8,37.0,,175,19,34,53,186.0,80,7.89,74,336,2448,12.9
10355,Greg Adams,1987-88,27.0,8,18,51,51,6,12,18,62.0,,226,25,46,71,248.0,80,7.77,71,321,2447,12.7
10356,Greg Adams,1988-89,28.0,9,56,78,78,18,38,56,150.0,,304,43,84,127,398.0,80,7.94,82,370,2484,12.8
10357,Greg Adams,1989-90,29.0,10,44,66,66,14,30,44,92.0,,370,57,114,171,490.0,80,7.34,72,344,2400,12.2
10358,Greg Adams,1990-91,30.0,11,27,78,78,15,12,27,109.0,,448,72,126,198,599.0,80,7.43,89,437,2435,12.2
10359,Greg Adams,1991-92,31.0,12,15,61,61,8,7,15,71.0,,509,80,133,213,670.0,80,7.48,85,403,2430,12.3
10360,Greg Adams,1992-93,32.0,13,14,35,35,4,10,14,27.0,,544,84,143,227,697.0,80,7.37,76,367,2421,12.2
10361,Greg Adams0,1987-88,24.0,4,21,36,36,12,9,21,65.0,,36,12,9,21,65.0,80,7.77,71,321,2447,12.7
10362,Greg Adams0,1988-89,25.0,5,77,78,78,35,42,77,202.0,,114,47,51,98,267.0,80,7.94,82,370,2484,12.8
10363,Greg Adams0,1989-90,26.0,6,47,72,72,20,27,47,140.0,,186,67,78,145,407.0,80,7.34,72,344,2400,12.2
10364,Greg Adams0,1990-91,27.0,7,76,80,80,36,40,76,227.0,,266,103,118,221,634.0,80,7.43,89,437,2435,12.2
10365,Greg Adams0,1991-92,28.0,8,33,61,61,19,14,33,144.0,,327,122,132,254,778.0,80,7.48,85,403,2430,12.3
10366,Greg Adams0,1992-93,29.0,9,50,65,65,30,20,50,181.0,,392,152,152,304,959.0,80,7.37,76,367,2421,12.2
10367,Greg Adams0,1993-94,30.0,10,45,55,55,21,24,45,148.0,,447,173,176,349,1107.0,80,6.91,71,366,2385,11.6
10368,Greg Adams0,1994-95,31.0,11,57,76,76,30,27,57,184.0,,523,203,203,406,1291.0,80,6.96,77,402,2440,11.4
10369,Greg Adams0,1995-96,32.0,12,56,53,53,25,31,56,124.0,,576,228,234,462,1415.0,84,7.25,87,443,2603,11.7
10370,Greg Adams0,1996-97,33.0,13,37,68,68,13,24,37,139.0,,644,241,258,499,1554.0,84,6.48,76,407,2545,10.7
10371,Greg Adams0,1997-98,34.0,14,21,43,43,8,13,21,72.0,,687,249,271,520,1626.0,48,5.97,37,209,1408,10.2
10372,Greg Adams0,1998-99,35.0,15,43,66,66,22,21,43,140.0,,753,271,292,563,1766.0,82,6.29,74,413,2481,10.4
10373,Greg Adams0,1999-00,36.0,16,36,50,50,21,15,36,113.0,,803,292,307,599,1879.0,82,5.83,55,336,2444,9.8
10374,Greg Adams0,2000-01,37.0,17,32,49,49,14,18,32,75.0,,852,306,325,631,1954.0,82,5.28,57,380,2242,9.6
10375,Greg Adams0,2001-02,38.0,18,43,75,75,19,24,43,176.0,1303.0,927,325,349,674,2130.0,82,5.27,57,359,2285,9.4
10376,Greg Adams0,2002-03,39.0,19,46,69,69,19,27,46,129.0,1171.0,996,344,376,720,2259.0,82,5.49,53,331,2294,9.8
10377,Greg Adams0,2003-04,40.0,20,23,60,60,11,12,23,66.0,863.0,1056,355,388,743,2325.0,82,5.51,63,376,2272,9.9
10378,Greg Andrusak,1996-97,27.0,4,0,3,3,0,0,0,4.0,,3,0,0,0,4.0,84,6.48,76,407,2545,10.7
10379,Greg Andrusak,1997-98,28.0,5,4,7,7,0,4,4,7.0,,10,0,4,4,11.0,48,5.97,37,209,1408,10.2
10380,Greg Andrusak,1998-99,29.0,6,0,2,2,0,0,0,1.0,,12,0,4,4,12.0,82,6.29,74,413,2481,10.4
10381,Greg Andrusak,2001-02,32.0,7,1,7,7,0,1,1,2.0,124.0,19,0,5,5,14.0,82,5.27,57,359,2285,9.4
10382,Greg Andrusak,2002-03,33.0,8,1,9,9,0,1,1,5.0,166.0,28,0,6,6,19.0,82,5.49,53,331,2294,9.8
10383,Greg Britz,1986-87,26.0,4,0,6,6,0,0,0,1.0,,6,0,0,0,1.0,80,7.89,74,336,2448,12.9
10384,Greg Britz,1987-88,27.0,5,0,1,1,0,0,0,0.0,,7,0,0,0,1.0,80,7.77,71,321,2447,12.7
10385,Greg Britz,1989-90,29.0,6,0,1,1,0,0,0,0.0,,8,0,0,0,1.0,80,7.34,72,344,2400,12.2
10386,Greg Brown,1993-94,25.0,4,3,39,39,1,2,3,26.0,,39,1,2,3,26.0,80,6.91,71,366,2385,11.6
10387,Greg Brown,1995-96,27.0,5,1,10,10,0,1,1,10.0,,49,1,3,4,36.0,84,7.25,87,443,2603,11.7
10388,Greg Brown,1996-97,28.0,6,11,36,36,3,8,11,37.0,,85,4,11,15,73.0,84,6.48,76,407,2545,10.7
10389,Greg Brown,1997-98,29.0,7,3,9,9,0,3,3,12.0,,94,4,14,18,85.0,48,5.97,37,209,1408,10.2
10390,Greg Classen,2003-04,26.0,4,6,27,27,2,4,6,18.0,277.0,27,2,4,6,18.0,82,5.51,63,376,2272,9.9
10391,Greg Classen,2004-05,27.0,5,11,55,55,5,6,11,32.0,558.0,82,7,10,17,50.0,82,5.24,53,338,2262,9.5
10392,Greg Classen,2005-06,28.0,6,0,8,8,0,0,0,2.0,80.0,90,7,10,17,52.0,82,5.31,60,363,2326,9.4
10393,Greg Crozier,2003-04,27.0,4,0,1,1,0,0,0,0.0,4.0,1,0,0,0,0.0,82,5.51,63,376,2272,9.9
10394,Greg Gilbert,1984-85,23.0,4,1,1,1,1,0,1,2.0,,1,1,0,1,2.0,80,8.03,73,320,2489,12.9
10395,Greg Gilbert,1985-86,24.0,5,19,45,45,8,11,19,33.0,,46,9,11,20,35.0,80,7.73,71,310,2444,12.7
10396,Greg Gilbert,1986-87,25.0,6,66,79,79,31,35,66,118.0,,125,40,46,86,153.0,80,7.89,74,336,2448,12.9
10397,Greg Gilbert,1987-88,26.0,7,38,58,58,13,25,38,82.0,,183,53,71,124,235.0,80,7.77,71,321,2447,12.7
10398,Greg Gilbert,1988-89,27.0,8,28,60,60,9,19,28,58.0,,243,62,90,152,293.0,80,7.94,82,370,2484,12.8
10399,Greg Gilbert,1989-90,28.0,9,13,51,51,6,7,13,50.0,,294,68,97,165,343.0,80,7.34,72,344,2400,12.2
10400,Greg Gilbert,1990-91,29.0,10,45,76,76,17,28,45,77.0,,370,85,125,210,420.0,80,7.43,89,437,2435,12.2
10401,Greg Gilbert,1991-92,30.0,11,21,59,59,8,13,21,75.0,,429,93,138,231,495.0,80,7.48,85,403,2430,12.3
10402,Greg Gilbert,1992-93,31.0,12,37,70,70,12,25,37,108.0,,499,105,163,268,603.0,80,7.37,76,367,2421,12.2
10403,Greg Gilbert,1993-94,32.0,13,25,72,72,10,15,25,98.0,,571,115,178,293,701.0,80,6.91,71,366,2385,11.6
10404,Greg Gilbert,1994-95,33.0,14,12,50,50,7,5,12,45.0,,621,122,183,305,746.0,80,6.96,77,402,2440,11.4
10405,Greg Gilbert,1995-96,34.0,15,32,77,77,13,19,32,72.0,,698,135,202,337,818.0,84,7.25,87,443,2603,11.7
10406,Greg Gilbert,1996-97,35.0,16,15,76,76,4,11,15,64.0,,774,139,213,352,882.0,84,6.48,76,407,2545,10.7
10407,Greg Gilbert,1997-98,36.0,17,25,46,46,11,14,25,57.0,,820,150,227,377,939.0,48,5.97,37,209,1408,10.2
10408,Greg Gilbert,1998-99,37.0,18,1,17,17,0,1,1,9.0,,837,150,228,378,948.0,82,6.29,74,413,2481,10.4
10409,Greg Hawgood,1990-91,22.0,4,0,1,1,0,0,0,1.0,,1,0,0,0,1.0,80,7.43,89,437,2435,12.2
10410,Greg Hawgood,1991-92,23.0,5,40,56,56,16,24,40,132.0,,57,16,24,40,133.0,80,7.48,85,403,2430,12.3
10411,Greg Hawgood,1992-93,24.0,6,38,77,77,11,27,38,127.0,,134,27,51,78,260.0,80,7.37,76,367,2421,12.2
10412,Greg Hawgood,1993-94,25.0,7,1,6,6,0,1,1,9.0,,140,27,52,79,269.0,80,6.91,71,366,2385,11.6
10413,Greg Hawgood,1994-95,26.0,8,13,20,20,2,11,13,24.0,,160,29,63,92,293.0,80,6.96,77,402,2440,11.4
10414,Greg Hawgood,1995-96,27.0,9,46,69,69,11,35,46,138.0,,229,40,98,138,431.0,84,7.25,87,443,2603,11.7
10415,Greg Hawgood,1996-97,28.0,10,34,64,64,6,28,34,112.0,,293,46,126,172,543.0,84,6.48,76,407,2545,10.7
10416,Greg Hawgood,1997-98,29.0,11,5,21,21,1,4,5,17.0,,314,47,130,177,560.0,48,5.97,37,209,1408,10.2
10417,Greg Hawgood,1999-00,31.0,12,18,63,63,6,12,18,83.0,,377,53,142,195,643.0,82,5.83,55,336,2444,9.8
10418,Greg Hawgood,2002-03,34.0,13,22,79,79,5,17,22,70.0,1358.0,456,58,159,217,713.0,82,5.49,53,331,2294,9.8
10419,Greg Hawgood,2003-04,35.0,14,7,16,16,2,5,7,16.0,239.0,472,60,164,224,729.0,82,5.51,63,376,2272,9.9
10420,Greg Hawgood,2004-05,36.0,15,0,2,2,0,0,0,1.0,13.0,474,60,164,224,730.0,82,5.24,53,338,2262,9.5
10421,Greg Hotham,1982-83,26.0,4,13,46,46,3,10,13,46.0,,46,3,10,13,46.0,80,7.03,61,280,2352,12.0
10422,Greg Hotham,1983-84,27.0,5,2,11,11,1,1,2,8.0,,57,4,11,15,54.0,80,7.69,77,340,2441,12.6
10423,Greg Hotham,1984-85,28.0,6,10,28,28,4,6,10,42.0,,85,8,17,25,96.0,80,8.03,73,320,2489,12.9
10424,Greg Hotham,1985-86,29.0,7,32,58,58,2,30,32,75.0,,143,10,47,57,171.0,80,7.73,71,310,2444,12.7
10425,Greg Hotham,1986-87,30.0,8,30,76,76,5,25,30,120.0,,219,15,72,87,291.0,80,7.89,74,336,2448,12.9
10426,Greg Hotham,1987-88,31.0,9,2,11,11,0,2,2,6.0,,230,15,74,89,297.0,80,7.77,71,321,2447,12.7
10427,Greg Jacina,2008-09,26.0,4,1,11,11,0,1,1,10.0,64.0,11,0,1,1,10.0,82,6.05,85,480,2458,10.1
10428,Greg Jacina,2009-10,27.0,5,0,3,3,0,0,0,2.0,21.0,14,0,1,1,12.0,82,5.76,70,398,2426,9.7
10429,Greg Johnson,1996-97,25.0,4,17,52,52,6,11,17,48.0,,52,6,11,17,48.0,84,6.48,76,407,2545,10.7
10430,Greg Johnson,1997-98,26.0,5,8,22,22,3,5,8,32.0,,74,9,16,25,80.0,48,5.97,37,209,1408,10.2
10431,Greg Johnson,1998-99,27.0,6,40,60,60,18,22,40,87.0,,134,27,38,65,167.0,82,6.29,74,413,2481,10.4
10432,Greg Johnson,1999-00,28.0,7,32,75,75,13,19,32,108.0,,209,40,57,97,275.0,82,5.83,55,336,2444,9.8
10433,Greg Johnson,2000-01,29.0,8,34,74,74,12,22,34,89.0,,283,52,79,131,364.0,82,5.28,57,380,2242,9.6
10434,Greg Johnson,2001-02,30.0,9,50,68,68,16,34,50,120.0,1321.0,351,68,113,181,484.0,82,5.27,57,359,2285,9.4
10435,Greg Johnson,2002-03,31.0,10,44,82,82,11,33,44,133.0,1576.0,433,79,146,225,617.0,82,5.49,53,331,2294,9.8
10436,Greg Johnson,2003-04,32.0,11,32,82,82,15,17,32,97.0,1461.0,515,94,163,257,714.0,82,5.51,63,376,2272,9.9
10437,Greg Johnson,2004-05,33.0,12,44,82,82,18,26,44,145.0,1605.0,597,112,189,301,859.0,82,5.24,53,338,2262,9.5
10438,Greg Johnson,2005-06,34.0,13,17,38,38,8,9,17,55.0,653.0,635,120,198,318,914.0,82,5.31,60,363,2326,9.4
10439,Greg Johnson,2006-07,35.0,14,32,82,82,14,18,32,100.0,1446.0,717,134,216,350,1014.0,82,5.14,57,348,2300,9.2
10440,Greg Johnson,2008-09,37.0,15,19,68,68,11,8,19,76.0,1128.0,785,145,224,369,1090.0,82,6.05,85,480,2458,10.1
10441,Greg Johnston,1986-87,22.0,4,3,15,15,2,1,3,15.0,,15,2,1,3,15.0,80,7.89,74,336,2448,12.9
10442,Greg Johnston,1987-88,23.0,5,0,6,6,0,0,0,1.0,,21,2,1,3,16.0,80,7.77,71,321,2447,12.7
10443,Greg Johnston,1988-89,24.0,6,2,20,20,0,2,2,11.0,,41,2,3,5,27.0,80,7.94,82,370,2484,12.8
10444,Greg Johnston,1989-90,25.0,7,27,76,76,12,15,27,132.0,,117,14,18,32,159.0,80,7.34,72,344,2400,12.2
10445,Greg Johnston,1991-92,27.0,8,20,57,57,11,9,20,89.0,,174,25,27,52,248.0,80,7.48,85,403,2430,12.3
10446,Greg Johnston,1992-93,28.0,9,2,9,9,1,1,2,9.0,,183,26,28,54,257.0,80,7.37,76,367,2421,12.2
10447,Greg Johnston,1993-94,29.0,10,0,1,1,0,0,0,0.0,,184,26,28,54,257.0,80,6.91,71,366,2385,11.6
10448,Greg Johnston,1994-95,30.0,11,1,3,3,0,1,1,2.0,,187,26,29,55,259.0,80,6.96,77,402,2440,11.4
10449,Greg Koehler,2003-04,28.0,4,0,1,1,0,0,0,0.0,1.0,1,0,0,0,0.0,82,5.51,63,376,2272,9.9
10450,Greg Kuznik,2003-04,25.0,4,0,1,1,0,0,0,0.0,8.0,1,0,0,0,0.0,82,5.51,63,376,2272,9.9
10451,Greg Leeb,2003-04,26.0,4,0,2,2,0,0,0,4.0,14.0,2,0,0,0,4.0,82,5.51,63,376,2272,9.9
10452,Greg Mauldin,2006-07,24.0,4,0,6,6,0,0,0,6.0,53.0,6,0,0,0,6.0,82,5.14,57,348,2300,9.2
10453,Greg Mauldin,2012-13,30.0,5,0,1,1,0,0,0,2.0,10.0,7,0,0,0,8.0,82,5.53,56,304,2486,9.1
10454,Greg Mauldin,2013-14,31.0,6,10,29,29,5,5,10,46.0,306.0,36,5,5,10,54.0,82,5.46,52,291,2492,9.0
10455,Greg McKegg,2016-17,24.0,4,0,1,1,0,0,0,1.0,4.0,1,0,0,0,1.0,82,5.34,48,269,2463,8.9
10456,Greg McKegg,2017-18,25.0,5,0,3,3,0,0,0,1.0,28.0,4,0,0,0,2.0,82,5.32,47,251,2453,8.9
10457,Greg McKegg,2018-19,26.0,6,2,15,15,2,0,2,14.0,124.0,19,2,0,2,16.0,82,5.34,48,255,2438,9.0
10458,Greg McKegg,2019-20,27.0,7,7,46,46,3,4,7,36.0,456.0,65,5,4,9,52.0,82,5.45,47,245,2478,9.0
10459,Greg McKegg,2020-21,28.0,8,4,26,26,2,2,4,21.0,252.0,91,7,6,13,73.0,82,5.86,50,250,2620,9.2
10460,Greg McKegg,2021-22,29.0,9,11,41,41,6,5,11,27.0,437.0,132,13,11,24,100.0,82,5.96,47,239,2579,9.5
10461,Greg McKegg,2022-23,30.0,10,9,53,53,5,4,9,40.0,507.0,185,18,15,33,140.0,70,5.96,42,208,2192,9.5
10462,Greg Meredith,1983-84,25.0,4,1,3,3,1,0,1,5.0,,3,1,0,1,5.0,80,7.69,77,340,2441,12.6
10463,Greg Meredith,1985-86,27.0,5,9,35,35,5,4,9,39.0,,38,6,4,10,44.0,80,7.73,71,310,2444,12.7
10464,Greg Moore,2010-11,26.0,4,0,6,6,0,0,0,13.0,71.0,6,0,0,0,13.0,82,5.44,62,351,2383,9.4
10465,Greg Moore,2012-13,28.0,5,0,4,4,0,0,0,2.0,24.0,10,0,0,0,15.0,82,5.53,56,304,2486,9.1
10466,Greg Nemisz,2013-14,23.0,4,1,6,6,0,1,1,5.0,31.0,6,0,1,1,5.0,82,5.46,52,291,2492,9.0
10467,Greg Nemisz,2014-15,24.0,5,0,9,9,0,0,0,2.0,69.0,15,0,1,1,7.0,82,5.32,47,271,2439,8.9
10468,Greg Pankewicz,1996-97,26.0,4,0,3,3,0,0,0,3.0,,3,0,0,0,3.0,84,6.48,76,407,2545,10.7
10469,Greg Pankewicz,2001-02,31.0,5,3,18,18,0,3,3,10.0,134.0,21,0,3,3,13.0,82,5.27,57,359,2285,9.4
10470,Greg Parks,1993-94,26.0,4,3,20,20,1,2,3,10.0,,20,1,2,3,10.0,80,6.91,71,366,2385,11.6
10471,Greg Parks,1994-95,27.0,5,0,1,1,0,0,0,0.0,,21,1,2,3,10.0,80,6.96,77,402,2440,11.4
10472,Greg Parks,1995-96,28.0,6,0,2,2,0,0,0,3.0,,23,1,2,3,13.0,84,7.25,87,443,2603,11.7
10473,Greg Paslawski,1986-87,25.0,4,19,60,60,9,10,19,63.0,,60,9,10,19,63.0,80,7.89,74,336,2448,12.9
10474,Greg Paslawski,1987-88,26.0,5,42,72,72,22,20,42,163.0,,132,31,30,61,226.0,80,7.77,71,321,2447,12.7
10475,Greg Paslawski,1988-89,27.0,6,33,56,56,22,11,33,151.0,,188,53,41,94,377.0,80,7.94,82,370,2484,12.8
10476,Greg Paslawski,1989-90,28.0,7,64,76,76,29,35,64,204.0,,264,82,76,158,581.0,80,7.34,72,344,2400,12.2
10477,Greg Paslawski,1990-91,29.0,8,3,17,17,2,1,3,30.0,,281,84,77,161,611.0,80,7.43,89,437,2435,12.2
10478,Greg Paslawski,1991-92,30.0,9,52,75,75,26,26,52,179.0,,356,110,103,213,790.0,80,7.48,85,403,2430,12.3
10479,Greg Paslawski,1992-93,31.0,10,48,71,71,18,30,48,122.0,,427,128,133,261,912.0,80,7.37,76,367,2421,12.2
10480,Greg Paslawski,1993-94,32.0,11,22,55,55,11,11,22,75.0,,482,139,144,283,987.0,80,6.91,71,366,2385,11.6
10481,Greg Paslawski,1994-95,33.0,12,45,80,80,28,17,45,134.0,,562,167,161,328,1121.0,80,6.96,77,402,2440,11.4
10482,Greg Paslawski,1995-96,34.0,13,42,73,73,18,24,42,109.0,,635,185,185,370,1230.0,84,7.25,87,443,2603,11.7
10483,Greg Paslawski,1996-97,35.0,14,2,15,15,2,0,2,13.0,,650,187,185,372,1243.0,84,6.48,76,407,2545,10.7
10484,Greg Pateryn,2015-16,25.0,4,0,3,3,0,0,0,0.0,29.0,3,0,0,0,0.0,48,5.31,29,160,1399,9.1
10485,Greg Pateryn,2017-18,27.0,5,0,17,17,0,0,0,10.0,215.0,20,0,0,0,10.0,82,5.32,47,251,2453,8.9
10486,Greg Pateryn,2018-19,28.0,6,7,38,38,1,6,7,32.0,636.0,58,1,6,7,42.0,82,5.34,48,255,2438,9.0
10487,Greg Pateryn,2019-20,29.0,7,9,36,36,1,8,9,42.0,555.0,94,2,14,16,84.0,82,5.45,47,245,2478,9.0
10488,Greg Pateryn,2020-21,30.0,8,13,73,73,1,12,13,100.0,1432.0,167,3,26,29,184.0,82,5.86,50,250,2620,9.2
10489,Greg Pateryn,2021-22,31.0,9,7,80,80,1,6,7,100.0,1370.0,247,4,32,36,284.0,82,5.96,47,239,2579,9.5
10490,Greg Pateryn,2022-23,32.0,10,3,20,20,0,3,3,22.0,309.0,267,4,35,39,306.0,70,5.96,42,208,2192,9.5
10491,Greg Rallo,2014-15,33.0,4,0,1,1,0,0,0,1.0,4.0,1,0,0,0,1.0,82,5.32,47,271,2439,8.9
10492,Greg Rallo,2015-16,34.0,5,1,10,10,1,0,1,10.0,96.0,11,1,0,1,11.0,48,5.31,29,160,1399,9.1
10493,Greg Smyth,1989-90,23.0,4,0,1,1,0,0,0,1.0,,1,0,0,0,1.0,80,7.34,72,344,2400,12.2
10494,Greg Smyth,1990-91,24.0,5,7,48,48,1,6,7,29.0,,49,1,6,7,30.0,80,7.43,89,437,2435,12.2
10495,Greg Smyth,1991-92,25.0,6,1,10,10,0,1,1,3.0,,59,1,7,8,33.0,80,7.48,85,403,2430,12.3
10496,Greg Smyth,1992-93,26.0,7,0,13,13,0,0,0,4.0,,72,1,7,8,37.0,80,7.37,76,367,2421,12.2
10497,Greg Smyth,1993-94,27.0,8,0,1,1,0,0,0,0.0,,73,1,7,8,37.0,80,6.91,71,366,2385,11.6
10498,Greg Smyth,1994-95,28.0,9,4,36,36,1,3,4,34.0,,109,2,10,12,71.0,80,6.96,77,402,2440,11.4
10499,Greg Smyth,1995-96,29.0,10,3,35,35,1,2,3,14.0,,144,3,12,15,85.0,84,7.25,87,443,2603,11.7
10500,Greg Smyth,1996-97,30.0,11,2,61,61,1,1,2,36.0,,205,4,13,17,121.0,84,6.48,76,407,2545,10.7
10501,Greg Smyth,1997-98,31.0,12,3,22,22,0,3,3,10.0,,227,4,16,20,131.0,48,5.97,37,209,1408,10.2
10502,Greg Smyth,1999-00,33.0,13,0,2,2,0,0,0,1.0,,229,4,16,20,132.0,82,5.83,55,336,2444,9.8
10503,Greg Stewart,2010-11,24.0,4,0,1,1,0,0,0,2.0,11.0,1,0,0,0,2.0,82,5.44,62,351,2383,9.4
10504,Greg Stewart,2011-12,25.0,5,1,20,20,0,1,1,16.0,172.0,21,0,1,1,18.0,82,5.7,65,341,2477,9.4
10505,Greg Stewart,2012-13,26.0,6,0,5,5,0,0,0,4.0,21.0,26,0,1,1,22.0,82,5.53,56,304,2486,9.1
10506,Greg Tebbutt,1982-83,25.0,4,1,2,2,0,1,1,0.0,,2,0,1,1,0.0,80,7.03,61,280,2352,12.0
10507,Greg Tebbutt,1986-87,29.0,5,2,24,24,0,2,2,38.0,,26,0,3,3,38.0,80,7.89,74,336,2448,12.9
10508,Greg Terrion,1983-84,23.0,4,37,73,73,12,25,37,92.0,,73,12,25,37,92.0,80,7.69,77,340,2441,12.6
10509,Greg Terrion,1984-85,24.0,5,37,61,61,15,22,37,111.0,,134,27,47,74,203.0,80,8.03,73,320,2489,12.9
10510,Greg Terrion,1985-86,25.0,6,32,74,74,16,16,32,72.0,,208,43,63,106,275.0,80,7.73,71,310,2444,12.7
10511,Greg Terrion,1986-87,26.0,7,39,79,79,15,24,39,93.0,,287,58,87,145,368.0,80,7.89,74,336,2448,12.9
10512,Greg Terrion,1987-88,27.0,8,31,72,72,14,17,31,91.0,,359,72,104,176,459.0,80,7.77,71,321,2447,12.7
10513,Greg Terrion,1988-89,28.0,9,32,76,76,10,22,32,105.0,,435,82,126,208,564.0,80,7.94,82,370,2484,12.8
10514,Greg Terrion,1989-90,29.0,10,15,67,67,7,8,15,55.0,,502,89,134,223,619.0,80,7.34,72,344,2400,12.2
10515,Greg Terrion,1990-91,30.0,11,20,59,59,4,16,20,57.0,,561,93,150,243,676.0,80,7.43,89,437,2435,12.2
10516,Greg Theberge,1982-83,23.0,4,1,12,12,0,1,1,21.0,,12,0,1,1,21.0,80,7.03,61,280,2352,12.0
10517,Greg Theberge,1983-84,24.0,5,1,1,1,1,0,1,1.0,,13,1,1,2,22.0,80,7.69,77,340,2441,12.6
10518,Greg Theberge,1984-85,25.0,6,37,57,57,5,32,37,150.0,,70,6,33,39,172.0,80,8.03,73,320,2489,12.9
10519,Greg Theberge,1985-86,26.0,7,36,70,70,8,28,36,136.0,,140,14,61,75,308.0,80,7.73,71,310,2444,12.7
10520,Greg Theberge,1986-87,27.0,8,3,13,13,1,2,3,19.0,,153,15,63,78,327.0,80,7.89,74,336,2448,12.9
10521,Greg Zanon,2008-09,28.0,4,2,4,4,0,2,2,3.0,69.0,4,0,2,2,3.0,82,6.05,85,480,2458,10.1
10522,Greg Zanon,2009-10,29.0,5,8,66,66,3,5,8,43.0,1144.0,70,3,7,10,46.0,82,5.76,70,398,2426,9.7
10523,Greg Zanon,2010-11,30.0,6,5,78,78,0,5,5,38.0,1440.0,148,3,12,15,84.0,82,5.44,62,351,2383,9.4
10524,Greg Zanon,2011-12,31.0,7,11,82,82,4,7,11,54.0,1710.0,230,7,19,26,138.0,82,5.7,65,341,2477,9.4
10525,Greg Zanon,2012-13,32.0,8,15,81,81,2,13,15,59.0,1812.0,311,9,32,41,197.0,82,5.53,56,304,2486,9.1
10526,Greg Zanon,2013-14,33.0,9,7,82,82,0,7,7,55.0,1767.0,393,9,39,48,252.0,82,5.46,52,291,2492,9.0
10527,Greg Zanon,2014-15,34.0,10,8,56,56,3,5,8,41.0,997.0,449,12,44,56,293.0,82,5.32,47,271,2439,8.9
10528,Greg Zanon,2015-16,35.0,11,6,44,44,0,6,6,40.0,851.0,493,12,50,62,333.0,48,5.31,29,160,1399,9.1
10529,Greg de Vries,1998-99,26.0,4,2,13,13,1,1,2,8.0,,13,1,1,2,8.0,82,6.29,74,413,2481,10.4
10530,Greg de Vries,1999-00,27.0,5,4,37,37,0,4,4,31.0,,50,1,5,6,39.0,82,5.83,55,336,2444,9.8
10531,Greg de Vries,2000-01,28.0,6,11,65,65,7,4,11,53.0,,115,8,9,17,92.0,82,5.28,57,380,2242,9.6
10532,Greg de Vries,2001-02,29.0,7,4,73,73,1,3,4,57.0,1207.0,188,9,12,21,149.0,82,5.27,57,359,2285,9.4
10533,Greg de Vries,2002-03,30.0,8,9,69,69,2,7,9,40.0,1034.0,257,11,19,30,189.0,82,5.49,53,331,2294,9.8
10534,Greg de Vries,2003-04,31.0,9,17,79,79,5,12,17,76.0,1351.0,336,16,31,47,265.0,82,5.51,63,376,2272,9.9
10535,Greg de Vries,2004-05,32.0,10,20,82,82,8,12,20,148.0,1890.0,418,24,43,67,413.0,82,5.24,53,338,2262,9.5
10536,Greg de Vries,2005-06,33.0,11,32,82,82,6,26,32,112.0,1825.0,500,30,69,99,525.0,82,5.31,60,363,2326,9.4
10537,Greg de Vries,2006-07,34.0,12,16,66,66,3,13,16,70.0,1240.0,566,33,82,115,595.0,82,5.14,57,348,2300,9.2
10538,Greg de Vries,2008-09,36.0,13,35,82,82,7,28,35,111.0,1805.0,648,40,110,150,706.0,82,6.05,85,480,2458,10.1
10539,Greg de Vries,2009-10,37.0,14,24,82,82,3,21,24,102.0,1824.0,730,43,131,174,808.0,82,5.76,70,398,2426,9.7
10540,Greg de Vries,2010-11,38.0,15,15,77,77,4,11,15,66.0,1452.0,807,47,142,189,874.0,82,5.44,62,351,2383,9.4
10541,Greg de Vries,2011-12,39.0,16,5,71,71,1,4,5,38.0,1074.0,878,48,146,194,912.0,82,5.7,65,341,2477,9.4
10542,Gregory Campbell,2006-07,23.0,4,0,2,2,0,0,0,0.0,18.0,2,0,0,0,0.0,82,5.14,57,348,2300,9.2
10543,Gregory Campbell,2008-09,25.0,5,9,64,64,3,6,9,59.0,553.0,66,3,6,9,59.0,82,6.05,85,480,2458,10.1
10544,Gregory Campbell,2009-10,26.0,6,9,79,79,6,3,9,103.0,835.0,145,9,9,18,162.0,82,5.76,70,398,2426,9.7
10545,Gregory Campbell,2010-11,27.0,7,18,81,81,5,13,18,113.0,1008.0,226,14,22,36,275.0,82,5.44,62,351,2383,9.4
10546,Gregory Campbell,2011-12,28.0,8,32,77,77,13,19,32,135.0,1292.0,303,27,41,68,410.0,82,5.7,65,341,2477,9.4
10547,Gregory Campbell,2012-13,29.0,9,17,60,60,2,15,17,84.0,924.0,363,29,56,85,494.0,82,5.53,56,304,2486,9.1
10548,Gregory Campbell,2013-14,30.0,10,29,80,80,13,16,29,98.0,1075.0,443,42,72,114,592.0,82,5.46,52,291,2492,9.0
10549,Gregory Campbell,2014-15,31.0,11,16,78,78,8,8,16,74.0,998.0,521,50,80,130,666.0,82,5.32,47,271,2439,8.9
10550,Gregory Campbell,2015-16,32.0,12,13,48,48,4,9,13,52.0,658.0,569,54,89,143,718.0,48,5.31,29,160,1399,9.1
10551,Gregory Campbell,2016-17,33.0,13,21,82,82,8,13,21,84.0,976.0,651,62,102,164,802.0,82,5.34,48,269,2463,8.9
10552,Gregory Campbell,2017-18,34.0,14,12,70,70,6,6,12,64.0,849.0,721,68,108,176,866.0,82,5.32,47,251,2453,8.9
10553,Gregory Campbell,2018-19,35.0,15,11,82,82,3,8,11,58.0,866.0,803,71,116,187,924.0,82,5.34,48,255,2438,9.0
10554,Griffen Molino,2019-20,26.0,4,0,5,5,0,0,0,3.0,53.0,5,0,0,0,3.0,82,5.45,47,245,2478,9.0
10555,Griffin Reinhart,2017-18,24.0,4,1,8,8,0,1,1,4.0,113.0,8,0,1,1,4.0,82,5.32,47,251,2453,8.9
10556,Griffin Reinhart,2018-19,25.0,5,1,29,29,0,1,1,24.0,524.0,37,0,2,2,28.0,82,5.34,48,255,2438,9.0
10557,Grigori Panteleev,1995-96,23.0,4,14,39,39,8,6,14,45.0,,39,8,6,14,45.0,84,7.25,87,443,2603,11.7
10558,Grigori Panteleev,1996-97,24.0,5,0,10,10,0,0,0,8.0,,49,8,6,14,53.0,84,6.48,76,407,2545,10.7
10559,Grigori Panteleev,1997-98,25.0,6,0,1,1,0,0,0,0.0,,50,8,6,14,53.0,48,5.97,37,209,1408,10.2
10560,Grigori Panteleev,1998-99,26.0,7,0,4,4,0,0,0,1.0,,54,8,6,14,54.0,82,6.29,74,413,2481,10.4
10561,Guillaume Brisebois,2021-22,24.0,4,0,8,8,0,0,0,5.0,88.0,8,0,0,0,5.0,82,5.96,47,239,2579,9.5
10562,Guillaume Desbiens,2012-13,27.0,4,0,1,1,0,0,0,0.0,9.0,1,0,0,0,0.0,82,5.53,56,304,2486,9.1
10563,Guillaume Desbiens,2013-14,28.0,5,0,12,12,0,0,0,4.0,88.0,13,0,0,0,4.0,82,5.46,52,291,2492,9.0
10564,Guillaume Desbiens,2014-15,29.0,6,0,10,10,0,0,0,2.0,71.0,23,0,0,0,6.0,82,5.32,47,271,2439,8.9
10565,Guillaume Latendresse,2009-10,22.0,4,29,80,80,16,13,29,121.0,1008.0,80,16,13,29,121.0,82,5.76,70,398,2426,9.7
10566,Guillaume Latendresse,2010-11,23.0,5,27,73,73,16,11,27,116.0,895.0,153,32,24,56,237.0,82,5.44,62,351,2383,9.4
10567,Guillaume Latendresse,2011-12,24.0,6,26,56,56,14,12,26,117.0,762.0,209,46,36,82,354.0,82,5.7,65,341,2477,9.4
10568,Guillaume Latendresse,2012-13,25.0,7,40,78,78,27,13,40,160.0,1166.0,287,73,49,122,514.0,82,5.53,56,304,2486,9.1
10569,Guillaume Latendresse,2013-14,26.0,8,6,11,11,3,3,6,18.0,140.0,298,76,52,128,532.0,82,5.46,52,291,2492,9.0
10570,Guillaume Latendresse,2014-15,27.0,9,9,16,16,5,4,9,36.0,243.0,314,81,56,137,568.0,82,5.32,47,271,2439,8.9
10571,Guillaume Latendresse,2015-16,28.0,10,10,27,27,6,4,10,53.0,400.0,341,87,60,147,621.0,48,5.31,29,160,1399,9.1
10572,Guillaume Lefebvre,2004-05,23.0,4,0,3,3,0,0,0,3.0,18.0,3,0,0,0,3.0,82,5.24,53,338,2262,9.5
10573,Guillaume Lefebvre,2005-06,24.0,5,6,26,26,2,4,6,19.0,314.0,29,2,4,6,22.0,82,5.31,60,363,2326,9.4
10574,Guillaume Lefebvre,2008-09,27.0,6,0,9,9,0,0,0,3.0,111.0,38,2,4,6,25.0,82,6.05,85,480,2458,10.1
10575,Guillaume Lefebvre,2012-13,31.0,7,0,1,1,0,0,0,0.0,11.0,39,2,4,6,25.0,82,5.53,56,304,2486,9.1
10576,Gustav Forsling,2019-20,23.0,4,5,38,38,2,3,5,48.0,563.0,38,2,3,5,48.0,82,5.45,47,245,2478,9.0
10577,Gustav Forsling,2020-21,24.0,5,13,41,41,3,10,13,82.0,785.0,79,5,13,18,130.0,82,5.86,50,250,2620,9.2
10578,Gustav Forsling,2021-22,25.0,6,9,43,43,3,6,9,57.0,735.0,122,8,19,27,187.0,82,5.96,47,239,2579,9.5
10579,Gustav Lindstrom,2022-23,24.0,4,1,16,16,0,1,1,9.0,265.0,16,0,1,1,9.0,70,5.96,42,208,2192,9.5
10580,Gustav Nyquist,2014-15,25.0,4,7,18,18,1,6,7,19.0,191.0,18,1,6,7,19.0,82,5.32,47,271,2439,8.9
10581,Gustav Nyquist,2015-16,26.0,5,6,22,22,3,3,6,46.0,287.0,40,4,9,13,65.0,48,5.31,29,160,1399,9.1
10582,Gustav Nyquist,2016-17,27.0,6,48,57,57,28,20,48,153.0,961.0,97,32,29,61,218.0,82,5.34,48,269,2463,8.9
10583,Gustav Nyquist,2017-18,28.0,7,54,82,82,27,27,54,195.0,1366.0,179,59,56,115,413.0,82,5.32,47,251,2453,8.9
10584,Gustav Nyquist,2018-19,29.0,8,43,82,82,17,26,43,161.0,1244.0,261,76,82,158,574.0,82,5.34,48,255,2438,9.0
10585,Gustav Nyquist,2019-20,30.0,9,48,76,76,12,36,48,165.0,1325.0,337,88,118,206,739.0,82,5.45,47,245,2478,9.0
10586,Gustav Nyquist,2020-21,31.0,10,40,82,82,21,19,40,213.0,1464.0,419,109,137,246,952.0,82,5.86,50,250,2620,9.2
10587,Gustav Nyquist,2021-22,32.0,11,60,81,81,22,38,60,204.0,1419.0,500,131,175,306,1156.0,82,5.96,47,239,2579,9.5
10588,Gustav Nyquist,2022-23,33.0,12,42,70,70,15,27,42,151.0,1262.0,570,146,202,348,1307.0,70,5.96,42,208,2192,9.5
10589,Gustav Olofsson,2018-19,24.0,4,0,2,2,0,0,0,1.0,18.0,2,0,0,0,1.0,82,5.34,48,255,2438,9.0
10590,Gustav Olofsson,2019-20,25.0,5,3,13,13,0,3,3,7.0,175.0,15,0,3,3,8.0,82,5.45,47,245,2478,9.0
10591,Gustav Olofsson,2020-21,26.0,6,8,41,41,0,8,8,22.0,524.0,56,0,11,11,30.0,82,5.86,50,250,2620,9.2
10592,Gustav Olofsson,2022-23,28.0,7,0,3,3,0,0,0,2.0,24.0,59,0,11,11,32.0,70,5.96,42,208,2192,9.5
10593,Guy Carbonneau,1983-84,23.0,4,1,2,2,0,1,1,1.0,,2,0,1,1,1.0,80,7.69,77,340,2441,12.6
10594,Guy Carbonneau,1985-86,25.0,5,47,77,77,18,29,47,109.0,,79,18,30,48,110.0,80,7.73,71,310,2444,12.7
10595,Guy Carbonneau,1986-87,26.0,6,54,78,78,24,30,54,166.0,,157,42,60,102,276.0,80,7.89,74,336,2448,12.9
10596,Guy Carbonneau,1987-88,27.0,7,57,79,79,23,34,57,163.0,,236,65,94,159,439.0,80,7.77,71,321,2447,12.7
10597,Guy Carbonneau,1988-89,28.0,8,56,80,80,20,36,56,147.0,,316,85,130,215,586.0,80,7.94,82,370,2484,12.8
10598,Guy Carbonneau,1989-90,29.0,9,45,79,79,18,27,45,121.0,,395,103,157,260,707.0,80,7.34,72,344,2400,12.2
10599,Guy Carbonneau,1990-91,30.0,10,38,80,80,17,21,38,109.0,,475,120,178,298,816.0,80,7.43,89,437,2435,12.2
10600,Guy Carbonneau,1991-92,31.0,11,56,79,79,26,30,56,142.0,,554,146,208,354,958.0,80,7.48,85,403,2430,12.3
10601,Guy Carbonneau,1992-93,32.0,12,55,68,68,19,36,55,125.0,,622,165,244,409,1083.0,80,7.37,76,367,2421,12.2
10602,Guy Carbonneau,1993-94,33.0,13,44,78,78,20,24,44,131.0,,700,185,268,453,1214.0,80,6.91,71,366,2385,11.6
10603,Guy Carbonneau,1994-95,34.0,14,39,72,72,18,21,39,120.0,,772,203,289,492,1334.0,80,6.96,77,402,2440,11.4
10604,Guy Carbonneau,1995-96,35.0,15,17,61,61,4,13,17,73.0,,833,207,302,509,1407.0,84,7.25,87,443,2603,11.7
10605,Guy Carbonneau,1996-97,36.0,16,38,79,79,14,24,38,120.0,,912,221,326,547,1527.0,84,6.48,76,407,2545,10.7
10606,Guy Carbonneau,1997-98,37.0,17,16,42,42,5,11,16,33.0,,954,226,337,563,1560.0,48,5.97,37,209,1408,10.2
10607,Guy Carbonneau,1998-99,38.0,18,23,71,71,8,15,23,54.0,,1025,234,352,586,1614.0,82,6.29,74,413,2481,10.4
10608,Guy Carbonneau,1999-00,39.0,19,21,73,73,5,16,21,99.0,,1098,239,368,607,1713.0,82,5.83,55,336,2444,9.8
10609,Guy Carbonneau,2000-01,40.0,20,24,77,77,7,17,24,81.0,,1175,246,385,631,1794.0,82,5.28,57,380,2242,9.6
10610,Guy Carbonneau,2001-02,41.0,21,16,74,74,4,12,16,60.0,988.0,1249,250,397,647,1854.0,82,5.27,57,359,2285,9.4
10611,Guy Carbonneau,2002-03,42.0,22,16,69,69,10,6,16,70.0,1079.0,1318,260,403,663,1924.0,82,5.49,53,331,2294,9.8
10612,Guy Gosselin,1990-91,27.0,4,0,5,5,0,0,0,1.0,,5,0,0,0,1.0,80,7.43,89,437,2435,12.2
10613,Guy Larose,1991-92,24.0,4,1,3,3,0,1,1,2.0,,3,0,1,1,2.0,80,7.48,85,403,2430,12.3
10614,Guy Larose,1993-94,26.0,5,0,7,7,0,0,0,7.0,,10,0,1,1,9.0,80,6.91,71,366,2385,11.6
10615,Guy Larose,1994-95,27.0,6,14,34,34,9,5,14,60.0,,44,9,6,15,69.0,80,6.96,77,402,2440,11.4
10616,Guy Larose,1995-96,28.0,7,0,9,9,0,0,0,8.0,,53,9,6,15,77.0,84,7.25,87,443,2603,11.7
10617,Guy Larose,1996-97,29.0,8,4,17,17,1,3,4,12.0,,70,10,9,19,89.0,84,6.48,76,407,2545,10.7
10618,Guy Leveque,1995-96,23.0,4,3,12,12,2,1,3,12.0,,12,2,1,3,12.0,84,7.25,87,443,2603,11.7
10619,Guy Leveque,1996-97,24.0,5,1,5,5,0,1,1,3.0,,17,2,2,4,15.0,84,6.48,76,407,2545,10.7
10620,Hakan Loob,1986-87,26.0,4,55,77,77,30,25,55,178.0,,77,30,25,55,178.0,80,7.89,74,336,2448,12.9
10621,Hakan Loob,1987-88,27.0,5,72,78,78,37,35,72,224.0,,155,67,60,127,402.0,80,7.77,71,321,2447,12.7
10622,Hakan Loob,1988-89,28.0,6,67,68,68,31,36,67,174.0,,223,98,96,194,576.0,80,7.94,82,370,2484,12.8
10623,Hakan Loob,1989-90,29.0,7,44,68,68,18,26,44,129.0,,291,116,122,238,705.0,80,7.34,72,344,2400,12.2
10624,Hakan Loob,1990-91,30.0,8,106,80,80,50,56,106,198.0,,371,166,178,344,903.0,80,7.43,89,437,2435,12.2
10625,Hakan Loob,1991-92,31.0,9,85,79,79,27,58,85,223.0,,450,193,236,429,1126.0,80,7.48,85,403,2430,12.3
10626,Hal Gill,2000-01,25.0,4,6,68,68,2,4,6,56.0,,68,2,4,6,56.0,82,5.28,57,380,2242,9.6
10627,Hal Gill,2001-02,26.0,5,10,80,80,3,7,10,102.0,1672.0,148,5,11,16,158.0,82,5.27,57,359,2285,9.4
10628,Hal Gill,2002-03,27.0,6,12,81,81,3,9,12,120.0,1398.0,229,8,20,28,278.0,82,5.49,53,331,2294,9.8
10629,Hal Gill,2003-04,28.0,7,11,80,80,1,10,11,79.0,1467.0,309,9,30,39,357.0,82,5.51,63,376,2272,9.9
10630,Hal Gill,2004-05,29.0,8,22,79,79,4,18,22,137.0,1913.0,388,13,48,61,494.0,82,5.24,53,338,2262,9.5
10631,Hal Gill,2005-06,30.0,9,17,76,76,4,13,17,114.0,1573.0,464,17,61,78,608.0,82,5.31,60,363,2326,9.4
10632,Hal Gill,2006-07,31.0,10,9,82,82,2,7,9,104.0,1509.0,546,19,68,87,712.0,82,5.14,57,348,2300,9.2
10633,Hal Gill,2008-09,33.0,11,10,80,80,1,9,10,68.0,1489.0,626,20,77,97,780.0,82,6.05,85,480,2458,10.1
10634,Hal Gill,2009-10,34.0,12,20,82,82,6,14,20,79.0,1549.0,708,26,91,117,859.0,82,5.76,70,398,2426,9.7
10635,Hal Gill,2010-11,35.0,13,24,81,81,3,21,24,86.0,1620.0,789,29,112,141,945.0,82,5.44,62,351,2383,9.4
10636,Hal Gill,2011-12,36.0,14,10,62,62,2,8,10,40.0,1109.0,851,31,120,151,985.0,82,5.7,65,341,2477,9.4
10637,Hal Gill,2012-13,37.0,15,11,68,68,2,9,11,41.0,1247.0,919,33,129,162,1026.0,82,5.53,56,304,2486,9.1
10638,Hal Gill,2013-14,38.0,16,9,75,75,2,7,9,62.0,1486.0,994,35,136,171,1088.0,82,5.46,52,291,2492,9.0
10639,Hal Gill,2014-15,39.0,17,13,76,76,1,12,13,49.0,1302.0,1070,36,148,184,1137.0,82,5.32,47,271,2439,8.9
10640,Hal Gill,2015-16,40.0,18,0,32,32,0,0,0,8.0,428.0,1102,36,148,184,1145.0,48,5.31,29,160,1399,9.1
10641,Hal Gill,2016-17,41.0,19,0,6,6,0,0,0,1.0,89.0,1108,36,148,184,1146.0,82,5.34,48,269,2463,8.9
10642,Hampus Lindholm,2016-17,23.0,4,30,78,78,6,24,30,116.0,1516.0,78,6,24,30,116.0,82,5.34,48,269,2463,8.9
10643,Hampus Lindholm,2017-18,24.0,5,34,78,78,7,27,34,107.0,1697.0,156,13,51,64,223.0,82,5.32,47,251,2453,8.9
10644,Hampus Lindholm,2018-19,25.0,6,28,80,80,10,18,28,149.0,1760.0,236,23,69,92,372.0,82,5.34,48,255,2438,9.0
10645,Hampus Lindholm,2019-20,26.0,7,20,66,66,6,14,20,94.0,1482.0,302,29,83,112,466.0,82,5.45,47,245,2478,9.0
10646,Hampus Lindholm,2020-21,27.0,8,31,69,69,13,18,31,131.0,1569.0,371,42,101,143,597.0,82,5.86,50,250,2620,9.2
10647,Hampus Lindholm,2021-22,28.0,9,28,76,76,6,22,28,125.0,1824.0,447,48,123,171,722.0,82,5.96,47,239,2579,9.5
10648,Hampus Lindholm,2022-23,29.0,10,22,55,55,2,20,22,109.0,1269.0,502,50,143,193,831.0,70,5.96,42,208,2192,9.5
10649,Hank Lammens,1996-97,30.0,4,3,27,27,1,2,3,6.0,,27,1,2,3,6.0,84,6.48,76,407,2545,10.7
10650,Hannes Hyvonen,2004-05,29.0,4,0,6,6,0,0,0,4.0,34.0,6,0,0,0,4.0,82,5.24,53,338,2262,9.5
10651,Hannes Hyvonen,2005-06,30.0,5,9,36,36,4,5,9,48.0,361.0,42,4,5,9,52.0,82,5.31,60,363,2326,9.4
10652,Hannu Jarvenpaa,1989-90,26.0,4,9,20,20,1,8,9,36.0,,20,1,8,9,36.0,80,7.34,72,344,2400,12.2
10653,Hannu Jarvenpaa,1990-91,27.0,5,17,41,41,6,11,17,52.0,,61,7,19,26,88.0,80,7.43,89,437,2435,12.2
10654,Hannu Jarvenpaa,1991-92,28.0,6,11,53,53,4,7,11,27.0,,114,11,26,37,115.0,80,7.48,85,403,2430,12.3
10655,Hannu Virta,1984-85,21.0,4,1,3,3,0,1,1,3.0,,3,0,1,1,3.0,80,8.03,73,320,2489,12.9
10656,Hannu Virta,1985-86,22.0,5,37,74,74,13,24,37,168.0,,77,13,25,38,171.0,80,7.73,71,310,2444,12.7
10657,Hannu Virta,1986-87,23.0,6,36,70,70,6,30,36,98.0,,147,19,55,74,269.0,80,7.89,74,336,2448,12.9
10658,Hannu Virta,1987-88,24.0,7,24,51,51,1,23,24,56.0,,198,20,78,98,325.0,80,7.77,71,321,2447,12.7
10659,Hannu Virta,1988-89,25.0,8,28,47,47,5,23,28,81.0,,245,25,101,126,406.0,80,7.94,82,370,2484,12.8
10660,Hans Jonsson,2002-03,29.0,4,14,68,68,3,11,14,49.0,1263.0,68,3,11,14,49.0,82,5.49,53,331,2294,9.8
10661,Hans Jonsson,2003-04,30.0,5,22,58,58,4,18,22,44.0,1070.0,126,7,29,36,93.0,82,5.51,63,376,2272,9.9
10662,Hans Jonsson,2004-05,31.0,6,7,53,53,2,5,7,37.0,964.0,179,9,34,43,130.0,82,5.24,53,338,2262,9.5
10663,Hans Jonsson,2005-06,32.0,7,5,63,63,1,4,5,40.0,1075.0,242,10,38,48,170.0,82,5.31,60,363,2326,9.4
10664,Harijs Vitolinsh,1996-97,28.0,4,0,8,8,0,0,0,7.0,,8,0,0,0,7.0,84,6.48,76,407,2545,10.7
10665,Harold Druken,2002-03,24.0,4,16,33,33,7,9,16,69.0,429.0,33,7,9,16,69.0,82,5.49,53,331,2294,9.8
10666,Harold Druken,2003-04,25.0,5,30,55,55,15,15,30,82.0,660.0,88,22,24,46,151.0,82,5.51,63,376,2272,9.9
10667,Harold Druken,2004-05,26.0,6,8,27,27,4,4,8,33.0,301.0,115,26,28,54,184.0,82,5.24,53,338,2262,9.5
10668,Harold Druken,2005-06,27.0,7,5,22,22,1,4,5,16.0,146.0,137,27,32,59,200.0,82,5.31,60,363,2326,9.4
10669,Harold Druken,2006-07,28.0,8,4,9,9,0,4,4,19.0,97.0,146,27,36,63,219.0,82,5.14,57,348,2300,9.2
10670,Harri Pesonen,2015-16,27.0,4,0,4,4,0,0,0,3.0,37.0,4,0,0,0,3.0,48,5.31,29,160,1399,9.1
10671,Harry York,1999-00,25.0,4,32,74,74,14,18,32,86.0,,74,14,18,32,86.0,82,5.83,55,336,2444,9.8
10672,Harry York,2000-01,26.0,5,10,60,60,4,6,10,44.0,,134,18,24,42,130.0,82,5.28,57,380,2242,9.6
10673,Harry York,2001-02,27.0,6,16,56,56,7,9,16,60.0,768.0,190,25,33,58,190.0,82,5.27,57,359,2285,9.4
10674,Harry York,2002-03,28.0,7,17,54,54,4,13,17,50.0,679.0,244,29,46,75,240.0,82,5.49,53,331,2294,9.8
10675,Harry Zolnierczyk,2014-15,27.0,4,6,37,37,3,3,6,49.0,285.0,37,3,3,6,49.0,82,5.32,47,271,2439,8.9
10676,Harry Zolnierczyk,2015-16,28.0,5,1,7,7,0,1,1,4.0,52.0,44,3,4,7,53.0,48,5.31,29,160,1399,9.1
10677,Harry Zolnierczyk,2016-17,29.0,6,2,13,13,2,0,2,12.0,132.0,57,5,4,9,65.0,82,5.34,48,269,2463,8.9
10678,Harry Zolnierczyk,2017-18,30.0,7,0,2,2,0,0,0,1.0,22.0,59,5,4,9,66.0,82,5.32,47,251,2453,8.9
10679,Harry Zolnierczyk,2018-19,31.0,8,0,1,1,0,0,0,1.0,9.0,60,5,4,9,67.0,82,5.34,48,255,2438,9.0
10680,Harry Zolnierczyk,2019-20,32.0,9,4,24,24,2,2,4,19.0,213.0,84,7,6,13,86.0,82,5.45,47,245,2478,9.0
10681,Harvie Pocza,1982-83,23.0,4,0,1,1,0,0,0,2.0,,1,0,0,0,2.0,80,7.03,61,280,2352,12.0
10682,Harvie Pocza,1984-85,25.0,5,0,2,2,0,0,0,1.0,,3,0,0,0,3.0,80,8.03,73,320,2489,12.9
10683,Haydn Fleury,2020-21,24.0,4,8,67,67,0,8,8,86.0,1125.0,67,0,8,8,86.0,82,5.86,50,250,2620,9.2
10684,Haydn Fleury,2021-22,25.0,5,1,20,20,0,1,1,17.0,251.0,87,0,9,9,103.0,82,5.96,47,239,2579,9.5
10685,Haydn Fleury,2022-23,26.0,6,14,45,45,4,10,14,65.0,615.0,132,4,19,23,168.0,70,5.96,42,208,2192,9.5
10686,Helmut Balderis,1992-93,40.0,4,9,26,26,3,6,9,30.0,,26,3,6,9,30.0,80,7.37,76,367,2421,12.2
10687,Henri Jokiharju,2021-22,22.0,4,12,38,38,0,12,12,62.0,721.0,38,0,12,12,62.0,82,5.96,47,239,2579,9.5
10688,Henri Jokiharju,2022-23,23.0,5,15,69,69,4,11,15,78.0,1188.0,107,4,23,27,140.0,70,5.96,42,208,2192,9.5
10689,Henrik Borgström,2020-21,23.0,4,1,4,4,1,0,1,6.0,51.0,4,1,0,1,6.0,82,5.86,50,250,2620,9.2
10690,Henrik Borgström,2021-22,24.0,5,18,50,50,8,10,18,54.0,600.0,54,9,10,19,60.0,82,5.96,47,239,2579,9.5
10691,Henrik Borgström,2022-23,25.0,6,0,4,4,0,0,0,3.0,50.0,58,9,10,19,63.0,70,5.96,42,208,2192,9.5
10692,Henrik Haapala,2020-21,26.0,4,1,5,5,0,1,1,3.0,69.0,5,0,1,1,3.0,82,5.86,50,250,2620,9.2
10693,Henrik Samuelsson,2017-18,23.0,4,0,3,3,0,0,0,4.0,40.0,3,0,0,0,4.0,82,5.32,47,251,2453,8.9
10694,Henrik Sedin,2003-04,23.0,4,29,82,82,9,20,29,98.0,1109.0,82,9,20,29,98.0,82,5.51,63,376,2272,9.9
10695,Henrik Sedin,2004-05,24.0,5,36,82,82,16,20,36,78.0,1050.0,164,25,40,65,176.0,82,5.24,53,338,2262,9.5
10696,Henrik Sedin,2005-06,25.0,6,39,78,78,8,31,39,81.0,1089.0,242,33,71,104,257.0,82,5.31,60,363,2326,9.4
10697,Henrik Sedin,2006-07,26.0,7,42,76,76,11,31,42,99.0,1067.0,318,44,102,146,356.0,82,5.14,57,348,2300,9.2
10698,Henrik Sedin,2008-09,28.0,8,75,82,82,18,57,75,113.0,1386.0,400,62,159,221,469.0,82,6.05,85,480,2458,10.1
10699,Henrik Sedin,2009-10,29.0,9,81,82,82,10,71,81,134.0,1511.0,482,72,230,302,603.0,82,5.76,70,398,2426,9.7
10700,Henrik Sedin,2010-11,30.0,10,76,82,82,15,61,76,141.0,1600.0,564,87,291,378,744.0,82,5.44,62,351,2383,9.4
10701,Henrik Sedin,2011-12,31.0,11,82,82,82,22,60,82,143.0,1601.0,646,109,351,460,887.0,82,5.7,65,341,2477,9.4
10702,Henrik Sedin,2012-13,32.0,12,112,82,82,29,83,112,166.0,1614.0,728,138,434,572,1053.0,82,5.53,56,304,2486,9.1
10703,Henrik Sedin,2013-14,33.0,13,94,82,82,19,75,94,157.0,1579.0,810,157,509,666,1210.0,82,5.46,52,291,2492,9.0
10704,Henrik Sedin,2014-15,34.0,14,81,82,82,14,67,81,113.0,1565.0,892,171,576,747,1323.0,82,5.32,47,271,2439,8.9
10705,Henrik Sedin,2015-16,35.0,15,45,48,48,11,34,45,70.0,929.0,940,182,610,792,1393.0,48,5.31,29,160,1399,9.1
10706,Henrik Sedin,2016-17,36.0,16,50,70,70,11,39,50,97.0,1447.0,1010,193,649,842,1490.0,82,5.34,48,269,2463,8.9
10707,Henrik Sedin,2017-18,37.0,17,73,82,82,18,55,73,101.0,1526.0,1092,211,704,915,1591.0,82,5.32,47,251,2453,8.9
10708,Henrik Sedin,2018-19,38.0,18,55,74,74,11,44,55,99.0,1360.0,1166,222,748,970,1690.0,82,5.34,48,255,2438,9.0
10709,Henrik Sedin,2019-20,39.0,19,50,82,82,15,35,50,99.0,1561.0,1248,237,783,1020,1789.0,82,5.45,47,245,2478,9.0
10710,Henrik Sedin,2020-21,40.0,20,50,82,82,3,47,50,67.0,1275.0,1330,240,830,1070,1856.0,82,5.86,50,250,2620,9.2
10711,Henrik Tallinder,2004-05,26.0,4,0,2,2,0,0,0,4.0,36.0,2,0,0,0,4.0,82,5.24,53,338,2262,9.5
10712,Henrik Tallinder,2005-06,27.0,5,13,46,46,3,10,13,37.0,914.0,48,3,10,13,41.0,82,5.31,60,363,2326,9.4
10713,Henrik Tallinder,2006-07,28.0,6,10,72,72,1,9,10,63.0,1323.0,120,4,19,23,104.0,82,5.14,57,348,2300,9.2
10714,Henrik Tallinder,2008-09,30.0,7,21,82,82,6,15,21,79.0,1668.0,202,10,34,44,183.0,82,6.05,85,480,2458,10.1
10715,Henrik Tallinder,2009-10,31.0,8,14,47,47,4,10,14,34.0,993.0,249,14,44,58,217.0,82,5.76,70,398,2426,9.7
10716,Henrik Tallinder,2010-11,32.0,9,18,71,71,1,17,18,70.0,1494.0,320,15,61,76,287.0,82,5.44,62,351,2383,9.4
10717,Henrik Tallinder,2011-12,33.0,10,12,66,66,1,11,12,35.0,1216.0,386,16,72,88,322.0,82,5.7,65,341,2477,9.4
10718,Henrik Tallinder,2012-13,34.0,11,20,82,82,4,16,20,53.0,1690.0,468,20,88,108,375.0,82,5.53,56,304,2486,9.1
10719,Henrik Tallinder,2013-14,35.0,12,16,82,82,5,11,16,102.0,1848.0,550,25,99,124,477.0,82,5.46,52,291,2492,9.0
10720,Henrik Tallinder,2014-15,36.0,13,6,39,39,0,6,6,43.0,831.0,589,25,105,130,520.0,82,5.32,47,271,2439,8.9
10721,Henrik Tallinder,2015-16,37.0,14,4,25,25,1,3,4,22.0,439.0,614,26,108,134,542.0,48,5.31,29,160,1399,9.1
10722,Henrik Tallinder,2016-17,38.0,15,8,64,64,2,6,8,40.0,1216.0,678,28,114,142,582.0,82,5.34,48,269,2463,8.9
10723,Henrik Zetterberg,2005-06,25.0,4,44,79,79,22,22,44,135.0,1289.0,79,22,22,44,135.0,82,5.31,60,363,2326,9.4
10724,Henrik Zetterberg,2006-07,26.0,5,43,61,61,15,28,43,137.0,1113.0,140,37,50,87,272.0,82,5.14,57,348,2300,9.2
10725,Henrik Zetterberg,2008-09,28.0,6,85,77,77,39,46,85,270.0,1460.0,217,76,96,172,542.0,82,6.05,85,480,2458,10.1
10726,Henrik Zetterberg,2009-10,29.0,7,68,63,63,33,35,68,224.0,1313.0,280,109,131,240,766.0,82,5.76,70,398,2426,9.7
10727,Henrik Zetterberg,2010-11,30.0,8,92,75,75,43,49,92,358.0,1655.0,355,152,180,332,1124.0,82,5.44,62,351,2383,9.4
10728,Henrik Zetterberg,2011-12,31.0,9,73,77,77,31,42,73,309.0,1531.0,432,183,222,405,1433.0,82,5.7,65,341,2477,9.4
10729,Henrik Zetterberg,2012-13,32.0,10,70,74,74,23,47,70,309.0,1485.0,506,206,269,475,1742.0,82,5.53,56,304,2486,9.1
10730,Henrik Zetterberg,2013-14,33.0,11,80,80,80,24,56,80,306.0,1567.0,586,230,325,555,2048.0,82,5.46,52,291,2492,9.0
10731,Henrik Zetterberg,2014-15,34.0,12,69,82,82,22,47,69,267.0,1627.0,668,252,372,624,2315.0,82,5.32,47,271,2439,8.9
10732,Henrik Zetterberg,2015-16,35.0,13,48,46,46,11,37,48,173.0,944.0,714,263,409,672,2488.0,48,5.31,29,160,1399,9.1
10733,Henrik Zetterberg,2016-17,36.0,14,48,45,45,16,32,48,151.0,925.0,759,279,441,720,2639.0,82,5.34,48,269,2463,8.9
10734,Henrik Zetterberg,2017-18,37.0,15,66,77,77,17,49,66,227.0,1472.0,836,296,490,786,2866.0,82,5.32,47,251,2453,8.9
10735,Henrik Zetterberg,2018-19,38.0,16,50,82,82,13,37,50,214.0,1592.0,918,309,527,836,3080.0,82,5.34,48,255,2438,9.0
10736,Henrik Zetterberg,2019-20,39.0,17,68,82,82,17,51,68,195.0,1617.0,1000,326,578,904,3275.0,82,5.45,47,245,2478,9.0
10737,Henrik Zetterberg,2020-21,40.0,18,56,82,82,11,45,56,180.0,1599.0,1082,337,623,960,3455.0,82,5.86,50,250,2620,9.2
10738,Herb Raglan,1988-89,21.0,4,0,7,7,0,0,0,4.0,,7,0,0,0,4.0,80,7.94,82,370,2484,12.8
10739,Herb Raglan,1989-90,22.0,5,16,62,62,6,10,16,58.0,,69,6,10,16,62.0,80,7.34,72,344,2400,12.2
10740,Herb Raglan,1990-91,23.0,6,25,73,73,10,15,25,95.0,,142,16,25,41,157.0,80,7.43,89,437,2435,12.2
10741,Herb Raglan,1991-92,24.0,7,17,50,50,7,10,17,86.0,,192,23,35,58,243.0,80,7.48,85,403,2430,12.3
10742,Herb Raglan,1992-93,25.0,8,1,11,11,0,1,1,13.0,,203,23,36,59,256.0,80,7.37,76,367,2421,12.2
10743,Herb Raglan,1993-94,26.0,9,10,47,47,4,6,10,48.0,,250,27,42,69,304.0,80,6.91,71,366,2385,11.6
10744,Herb Raglan,1994-95,27.0,10,20,62,62,6,14,20,79.0,,312,33,56,89,383.0,80,6.96,77,402,2440,11.4
10745,Herb Raglan,1995-96,28.0,11,0,2,2,0,0,0,0.0,,314,33,56,89,383.0,84,7.25,87,443,2603,11.7
10746,Herb Raglan,1996-97,29.0,12,0,29,29,0,0,0,13.0,,343,33,56,89,396.0,84,6.48,76,407,2545,10.7
10747,Herbert Vasiljevs,2001-02,25.0,4,0,5,5,0,0,0,6.0,56.0,5,0,0,0,6.0,82,5.27,57,359,2285,9.4
10748,Herbert Vasiljevs,2002-03,26.0,5,1,7,7,1,0,1,2.0,65.0,12,1,0,1,8.0,82,5.49,53,331,2294,9.8
10749,Herbert Vasiljevs,2003-04,27.0,6,9,21,21,4,5,9,41.0,336.0,33,5,5,10,49.0,82,5.51,63,376,2272,9.9
10750,Herbert Vasiljevs,2004-05,28.0,7,5,18,18,3,2,5,17.0,165.0,51,8,7,15,66.0,82,5.24,53,338,2262,9.5
10751,Hnat Domenichelli,1999-00,23.0,4,6,23,23,3,3,6,30.0,,23,3,3,6,30.0,82,5.83,55,336,2444,9.8
10752,Hnat Domenichelli,2000-01,24.0,5,16,31,31,9,7,16,70.0,,54,12,10,22,100.0,82,5.28,57,380,2242,9.6
10753,Hnat Domenichelli,2001-02,25.0,6,10,23,23,5,5,10,45.0,299.0,77,17,15,32,145.0,82,5.27,57,359,2285,9.4
10754,Hnat Domenichelli,2002-03,26.0,7,29,59,59,11,18,29,125.0,861.0,136,28,33,61,270.0,82,5.49,53,331,2294,9.8
10755,Hnat Domenichelli,2003-04,27.0,8,27,63,63,15,12,27,150.0,904.0,199,43,45,88,420.0,82,5.51,63,376,2272,9.9
10756,Hnat Domenichelli,2004-05,28.0,9,25,67,67,9,16,25,144.0,936.0,266,52,61,113,564.0,82,5.24,53,338,2262,9.5
10757,Hnat Domenichelli,2005-06,29.0,10,0,1,1,0,0,0,1.0,11.0,267,52,61,113,565.0,82,5.31,60,363,2326,9.4
10758,Howard Scruton,1985-86,23.0,4,4,4,4,0,4,4,4.0,,4,0,4,4,4.0,80,7.73,71,310,2444,12.7
10759,Howard Walker,1983-84,25.0,4,13,64,64,2,11,13,68.0,,64,2,11,13,68.0,80,7.69,77,340,2441,12.6
10760,Howard Walker,1984-85,26.0,5,2,16,16,0,2,2,18.0,,80,2,13,15,86.0,80,8.03,73,320,2489,12.9
10761,Howard Walker,1985-86,27.0,6,0,3,3,0,0,0,2.0,,83,2,13,15,88.0,80,7.73,71,310,2444,12.7
10762,Hubie McDonough,1991-92,28.0,4,1,4,4,0,1,1,3.0,,4,0,1,1,3.0,80,7.48,85,403,2430,12.3
10763,Hubie McDonough,1992-93,29.0,5,36,76,76,21,15,36,105.0,,80,21,16,37,108.0,80,7.37,76,367,2421,12.2
10764,Hubie McDonough,1993-94,30.0,6,12,52,52,6,6,12,47.0,,132,27,22,49,155.0,80,6.91,71,366,2385,11.6
10765,Hubie McDonough,1994-95,31.0,7,9,33,33,7,2,9,31.0,,165,34,24,58,186.0,80,6.96,77,402,2440,11.4
10766,Hubie McDonough,1995-96,32.0,8,8,30,30,6,2,8,41.0,,195,40,26,66,227.0,84,7.25,87,443,2603,11.7
10767,Hudson Fasching,2018-19,23.0,4,2,7,7,1,1,2,9.0,81.0,7,1,1,2,9.0,82,5.34,48,255,2438,9.0
10768,Hudson Fasching,2019-20,24.0,5,1,10,10,0,1,1,6.0,104.0,17,1,2,3,15.0,82,5.45,47,245,2478,9.0
10769,Hudson Fasching,2020-21,25.0,6,0,5,5,0,0,0,1.0,49.0,22,1,2,3,16.0,82,5.86,50,250,2620,9.2
10770,Hugh Jessiman,2013-14,29.0,4,0,2,2,0,0,0,2.0,15.0,2,0,0,0,2.0,82,5.46,52,291,2492,9.0
10771,Hunter Shinkaruk,2018-19,24.0,4,3,8,8,2,1,3,12.0,120.0,8,2,1,3,12.0,82,5.34,48,255,2438,9.0
10772,Hunter Shinkaruk,2019-20,25.0,5,1,7,7,0,1,1,5.0,74.0,15,2,2,4,17.0,82,5.45,47,245,2478,9.0
10773,Iain Duncan,1989-90,26.0,4,3,6,6,1,2,3,7.0,,6,1,2,3,7.0,80,7.34,72,344,2400,12.2
10774,Iain Duncan,1990-91,27.0,5,42,62,62,19,23,42,104.0,,68,20,25,45,111.0,80,7.43,89,437,2435,12.2
10775,Iain Duncan,1991-92,28.0,6,44,57,57,14,30,44,91.0,,125,34,55,89,202.0,80,7.48,85,403,2430,12.3
10776,Iain Duncan,1993-94,30.0,7,0,2,2,0,0,0,2.0,,127,34,55,89,204.0,80,6.91,71,366,2385,11.6
10777,Iain Fraser,1995-96,26.0,4,4,7,7,2,2,4,7.0,,7,2,2,4,7.0,84,7.25,87,443,2603,11.7
10778,Iain Fraser,1996-97,27.0,5,37,60,60,17,20,37,109.0,,67,19,22,41,116.0,84,6.48,76,407,2545,10.7
10779,Iain Fraser,1997-98,28.0,6,3,13,13,3,0,3,7.0,,80,22,22,44,123.0,48,5.97,37,209,1408,10.2
10780,Iain Fraser,1998-99,29.0,7,2,12,12,1,1,2,12.0,,92,23,23,46,135.0,82,6.29,74,413,2481,10.4
10781,Iain Fraser,1999-00,30.0,8,0,2,2,0,0,0,0.0,,94,23,23,46,135.0,82,5.83,55,336,2444,9.8
10782,Ian Cole,2013-14,24.0,4,4,26,26,1,3,4,22.0,458.0,26,1,3,4,22.0,82,5.46,52,291,2492,9.0
10783,Ian Cole,2014-15,25.0,5,6,26,26,1,5,6,18.0,414.0,52,2,8,10,40.0,82,5.32,47,271,2439,8.9
10784,Ian Cole,2015-16,26.0,6,1,15,15,0,1,1,10.0,266.0,67,2,9,11,50.0,48,5.31,29,160,1399,9.1
10785,Ian Cole,2016-17,27.0,7,11,46,46,3,8,11,45.0,694.0,113,5,17,22,95.0,82,5.34,48,269,2463,8.9
10786,Ian Cole,2017-18,28.0,8,17,74,74,5,12,17,83.0,1183.0,187,10,29,39,178.0,82,5.32,47,251,2453,8.9
10787,Ian Cole,2018-19,29.0,9,12,70,70,0,12,12,72.0,1207.0,257,10,41,51,250.0,82,5.34,48,255,2438,9.0
10788,Ian Cole,2019-20,30.0,10,26,81,81,5,21,26,89.0,1605.0,338,15,62,77,339.0,82,5.45,47,245,2478,9.0
10789,Ian Cole,2020-21,31.0,11,20,67,67,5,15,20,84.0,1191.0,405,20,77,97,423.0,82,5.86,50,250,2620,9.2
10790,Ian Cole,2021-22,32.0,12,15,71,71,2,13,15,82.0,1403.0,476,22,90,112,505.0,82,5.96,47,239,2579,9.5
10791,Ian Cole,2022-23,33.0,13,26,65,65,4,22,26,92.0,1150.0,541,26,112,138,597.0,70,5.96,42,208,2192,9.5
10792,Ian Herbers,1996-97,29.0,4,2,22,22,0,2,2,16.0,,22,0,2,2,16.0,84,6.48,76,407,2545,10.7
10793,Ian Herbers,2002-03,35.0,5,3,43,43,0,3,3,14.0,651.0,65,0,5,5,30.0,82,5.49,53,331,2294,9.8
10794,Ian Kidd,1990-91,26.0,4,11,19,19,4,7,11,22.0,,19,4,7,11,22.0,80,7.43,89,437,2435,12.2
10795,Ian Kidd,1991-92,27.0,5,0,1,1,0,0,0,0.0,,20,4,7,11,22.0,80,7.48,85,403,2430,12.3
10796,Ian Laperriere,1996-97,23.0,4,0,1,1,0,0,0,1.0,,1,0,0,0,1.0,84,6.48,76,407,2545,10.7
10797,Ian Laperriere,1997-98,24.0,5,27,37,37,13,14,27,53.0,,38,13,14,27,54.0,48,5.97,37,209,1408,10.2
10798,Ian Laperriere,1998-99,25.0,6,17,71,71,6,11,17,70.0,,109,19,25,44,124.0,82,6.29,74,413,2481,10.4
10799,Ian Laperriere,1999-00,26.0,7,23,62,62,8,15,23,84.0,,171,27,40,67,208.0,82,5.83,55,336,2444,9.8
10800,Ian Laperriere,2000-01,27.0,8,21,77,77,6,15,21,74.0,,248,33,55,88,282.0,82,5.28,57,380,2242,9.6
10801,Ian Laperriere,2001-02,28.0,9,13,72,72,3,10,13,62.0,848.0,320,36,65,101,344.0,82,5.27,57,359,2285,9.4
10802,Ian Laperriere,2002-03,29.0,10,22,79,79,9,13,22,87.0,1047.0,399,45,78,123,431.0,82,5.49,53,331,2294,9.8
10803,Ian Laperriere,2003-04,30.0,11,18,79,79,8,10,18,60.0,951.0,478,53,88,141,491.0,82,5.51,63,376,2272,9.9
10804,Ian Laperriere,2004-05,31.0,12,22,81,81,8,14,22,89.0,1113.0,559,61,102,163,580.0,82,5.24,53,338,2262,9.5
10805,Ian Laperriere,2005-06,32.0,13,19,73,73,7,12,19,85.0,1151.0,632,68,114,182,665.0,82,5.31,60,363,2326,9.4
10806,Ian Laperriere,2006-07,33.0,14,22,62,62,10,12,22,59.0,982.0,694,78,126,204,724.0,82,5.14,57,348,2300,9.2
10807,Ian Laperriere,2008-09,35.0,15,45,82,82,21,24,45,133.0,1407.0,776,99,150,249,857.0,82,6.05,85,480,2458,10.1
10808,Ian Laperriere,2009-10,36.0,16,29,81,81,8,21,29,118.0,1121.0,857,107,171,278,975.0,82,5.76,70,398,2426,9.7
10809,Ian Laperriere,2010-11,37.0,17,19,70,70,4,15,19,68.0,956.0,927,111,186,297,1043.0,82,5.44,62,351,2383,9.4
10810,Ian Laperriere,2011-12,38.0,18,19,74,74,7,12,19,61.0,1024.0,1001,118,198,316,1104.0,82,5.7,65,341,2477,9.4
10811,Ian Laperriere,2012-13,39.0,19,20,82,82,3,17,20,53.0,1025.0,1083,121,215,336,1157.0,82,5.53,56,304,2486,9.1
10812,Ian MacNeil,2005-06,28.0,4,0,2,2,0,0,0,2.0,20.0,2,0,0,0,2.0,82,5.31,60,363,2326,9.4
10813,Ian McCoshen,2019-20,24.0,4,1,3,3,0,1,1,0.0,40.0,3,0,1,1,0.0,82,5.45,47,245,2478,9.0
10814,Ian McCoshen,2020-21,25.0,5,4,38,38,3,1,4,26.0,573.0,41,3,2,5,26.0,82,5.86,50,250,2620,9.2
10815,Ian McCoshen,2021-22,26.0,6,2,19,19,1,1,2,15.0,253.0,60,4,3,7,41.0,82,5.96,47,239,2579,9.5
10816,Ian Moran,1998-99,26.0,4,2,51,51,1,1,2,44.0,,51,1,1,2,44.0,82,6.29,74,413,2481,10.4
10817,Ian Moran,1999-00,27.0,5,9,36,36,4,5,9,50.0,,87,5,6,11,94.0,82,5.83,55,336,2444,9.8
10818,Ian Moran,2000-01,28.0,6,7,37,37,1,6,7,33.0,,124,6,12,18,127.0,82,5.28,57,380,2242,9.6
10819,Ian Moran,2001-02,29.0,7,9,62,62,4,5,9,65.0,1027.0,186,10,17,27,192.0,82,5.27,57,359,2285,9.4
10820,Ian Moran,2002-03,30.0,8,12,73,73,4,8,12,58.0,829.0,259,14,25,39,250.0,82,5.49,53,331,2294,9.8
10821,Ian Moran,2003-04,31.0,9,7,40,40,3,4,7,73.0,708.0,299,17,29,46,323.0,82,5.51,63,376,2272,9.9
10822,Ian Moran,2004-05,32.0,10,10,64,64,2,8,10,94.0,1280.0,363,19,37,56,417.0,82,5.24,53,338,2262,9.5
10823,Ian Moran,2005-06,33.0,11,8,78,78,0,8,8,96.0,1435.0,441,19,45,64,513.0,82,5.31,60,363,2326,9.4
10824,Ian Moran,2006-07,34.0,12,5,35,35,1,4,5,54.0,656.0,476,20,49,69,567.0,82,5.14,57,348,2300,9.2
10825,Ian Moran,2008-09,36.0,13,2,12,12,1,1,2,7.0,173.0,488,21,50,71,574.0,82,6.05,85,480,2458,10.1
10826,Ian Moran,2009-10,37.0,14,0,1,1,0,0,0,0.0,6.0,489,21,50,71,574.0,82,5.76,70,398,2426,9.7
10827,Ian White,2008-09,24.0,4,6,12,12,1,5,6,21.0,229.0,12,1,5,6,21.0,82,6.05,85,480,2458,10.1
10828,Ian White,2009-10,25.0,5,26,76,76,3,23,26,138.0,1408.0,88,4,28,32,159.0,82,5.76,70,398,2426,9.7
10829,Ian White,2010-11,26.0,6,21,81,81,5,16,21,116.0,1523.0,169,9,44,53,275.0,82,5.44,62,351,2383,9.4
10830,Ian White,2011-12,27.0,7,26,71,71,10,16,26,158.0,1622.0,240,19,60,79,433.0,82,5.7,65,341,2477,9.4
10831,Ian White,2012-13,28.0,8,38,83,83,13,25,38,173.0,1891.0,323,32,85,117,606.0,82,5.53,56,304,2486,9.1
10832,Ian White,2013-14,29.0,9,26,78,78,4,22,26,138.0,1559.0,401,36,107,143,744.0,82,5.46,52,291,2492,9.0
10833,Ian White,2014-15,30.0,10,32,77,77,7,25,32,196.0,1770.0,478,43,132,175,940.0,82,5.32,47,271,2439,8.9
10834,Ian White,2015-16,31.0,11,4,25,25,2,2,4,27.0,490.0,503,45,134,179,967.0,48,5.31,29,160,1399,9.1
10835,Igor Chibirev,1996-97,28.0,4,15,37,37,4,11,15,30.0,,37,4,11,15,30.0,84,6.48,76,407,2545,10.7
10836,Igor Chibirev,1997-98,29.0,5,4,8,8,3,1,4,9.0,,45,7,12,19,39.0,48,5.97,37,209,1408,10.2
10837,Igor Korolev,1995-96,25.0,4,27,74,74,4,23,27,76.0,,74,4,23,27,76.0,84,7.25,87,443,2603,11.7
10838,Igor Korolev,1996-97,26.0,5,16,73,73,6,10,16,93.0,,147,10,33,43,169.0,84,6.48,76,407,2545,10.7
10839,Igor Korolev,1997-98,27.0,6,30,45,45,8,22,30,85.0,,192,18,55,73,254.0,48,5.97,37,209,1408,10.2
10840,Igor Korolev,1998-99,28.0,7,51,73,73,22,29,51,165.0,,265,40,84,124,419.0,82,6.29,74,413,2481,10.4
10841,Igor Korolev,1999-00,29.0,8,10,41,41,3,7,10,41.0,,306,43,91,134,460.0,82,5.83,55,336,2444,9.8
10842,Igor Korolev,2000-01,30.0,9,39,78,78,17,22,39,97.0,,384,60,113,173,557.0,82,5.28,57,380,2242,9.6
10843,Igor Korolev,2001-02,31.0,10,47,66,66,13,34,47,99.0,1195.0,450,73,147,220,656.0,82,5.27,57,359,2285,9.4
10844,Igor Korolev,2002-03,32.0,11,46,80,80,20,26,46,101.0,1435.0,530,93,173,266,757.0,82,5.49,53,331,2294,9.8
10845,Igor Korolev,2003-04,33.0,12,29,73,73,10,19,29,78.0,1145.0,603,103,192,295,835.0,82,5.51,63,376,2272,9.9
10846,Igor Korolev,2004-05,34.0,13,29,82,82,9,20,29,78.0,1380.0,685,112,212,324,913.0,82,5.24,53,338,2262,9.5
10847,Igor Korolev,2005-06,35.0,14,9,48,48,4,5,9,32.0,655.0,733,116,217,333,945.0,82,5.31,60,363,2326,9.4
10848,Igor Korolev,2006-07,36.0,15,13,62,62,3,10,13,38.0,693.0,795,119,227,346,983.0,82,5.14,57,348,2300,9.2
10849,Igor Kravchuk,1994-95,28.0,4,9,18,18,1,8,9,40.0,,18,1,8,9,40.0,80,6.96,77,402,2440,11.4
10850,Igor Kravchuk,1995-96,29.0,5,27,55,55,10,17,27,143.0,,73,11,25,36,183.0,84,7.25,87,443,2603,11.7
10851,Igor Kravchuk,1996-97,30.0,6,50,81,81,12,38,50,197.0,,154,23,63,86,380.0,84,6.48,76,407,2545,10.7
10852,Igor Kravchuk,1997-98,31.0,7,18,36,36,7,11,18,93.0,,190,30,74,104,473.0,48,5.97,37,209,1408,10.2
10853,Igor Kravchuk,1998-99,32.0,8,23,66,66,7,16,23,173.0,,256,37,90,127,646.0,82,6.29,74,413,2481,10.4
10854,Igor Kravchuk,1999-00,33.0,9,28,82,82,4,24,28,142.0,,338,41,114,155,788.0,82,5.83,55,336,2444,9.8
10855,Igor Kravchuk,2000-01,34.0,10,35,81,81,8,27,35,191.0,,419,49,141,190,979.0,82,5.28,57,380,2242,9.6
10856,Igor Kravchuk,2001-02,35.0,11,25,79,79,4,21,25,171.0,1884.0,498,53,162,215,1150.0,82,5.27,57,359,2285,9.4
10857,Igor Kravchuk,2002-03,36.0,12,18,64,64,6,12,18,126.0,1324.0,562,59,174,233,1276.0,82,5.49,53,331,2294,9.8
10858,Igor Kravchuk,2003-04,37.0,13,14,52,52,1,13,14,67.0,1188.0,614,60,187,247,1343.0,82,5.51,63,376,2272,9.9
10859,Igor Kravchuk,2004-05,38.0,14,26,78,78,4,22,26,135.0,1446.0,692,64,209,273,1478.0,82,5.24,53,338,2262,9.5
10860,Igor Kravchuk,2005-06,39.0,15,1,7,7,0,1,1,8.0,131.0,699,64,210,274,1486.0,82,5.31,60,363,2326,9.4
10861,Igor Larionov,1992-93,32.0,4,44,74,74,17,27,44,118.0,,74,17,27,44,118.0,80,7.37,76,367,2421,12.2
10862,Igor Larionov,1993-94,33.0,5,34,64,64,13,21,34,66.0,,138,30,48,78,184.0,80,6.91,71,366,2385,11.6
10863,Igor Larionov,1994-95,34.0,6,65,72,72,21,44,65,97.0,,210,51,92,143,281.0,80,6.96,77,402,2440,11.4
10864,Igor Larionov,1996-97,36.0,7,56,60,60,18,38,56,72.0,,270,69,130,199,353.0,84,6.48,76,407,2545,10.7
10865,Igor Larionov,1997-98,37.0,8,24,33,33,4,20,24,69.0,,303,73,150,223,422.0,48,5.97,37,209,1408,10.2
10866,Igor Larionov,1998-99,38.0,9,73,73,73,22,51,73,113.0,,376,95,201,296,535.0,82,6.29,74,413,2481,10.4
10867,Igor Larionov,1999-00,39.0,10,54,64,64,12,42,54,95.0,,440,107,243,350,630.0,82,5.83,55,336,2444,9.8
10868,Igor Larionov,2000-01,40.0,11,47,69,69,8,39,47,93.0,,509,115,282,397,723.0,82,5.28,57,380,2242,9.6
10869,Igor Larionov,2001-02,41.0,12,63,75,75,14,49,63,83.0,1300.0,584,129,331,460,806.0,82,5.27,57,359,2285,9.4
10870,Igor Larionov,2002-03,42.0,13,47,79,79,9,38,47,69.0,1270.0,663,138,369,507,875.0,82,5.49,53,331,2294,9.8
10871,Igor Larionov,2003-04,43.0,14,40,65,65,9,31,40,46.0,1078.0,728,147,400,547,921.0,82,5.51,63,376,2272,9.9
10872,Igor Larionov,2004-05,44.0,15,43,70,70,11,32,43,50.0,1012.0,798,158,432,590,971.0,82,5.24,53,338,2262,9.5
10873,Igor Larionov,2005-06,45.0,16,43,74,74,10,33,43,50.0,1030.0,872,168,465,633,1021.0,82,5.31,60,363,2326,9.4
10874,Igor Larionov,2006-07,46.0,17,11,49,49,1,10,11,25.0,593.0,921,169,475,644,1046.0,82,5.14,57,348,2300,9.2
10875,Igor Liba,1991-92,31.0,4,25,37,37,7,18,25,42.0,,37,7,18,25,42.0,80,7.48,85,403,2430,12.3
10876,Igor Ozhiganov,2021-22,29.0,4,7,53,53,3,4,7,43.0,743.0,53,3,4,7,43.0,82,5.96,47,239,2579,9.5
10877,Igor Radulov,2005-06,23.0,4,5,7,7,5,0,5,14.0,106.0,7,5,0,5,14.0,82,5.31,60,363,2326,9.4
10878,Igor Radulov,2006-07,24.0,5,11,36,36,4,7,11,47.0,441.0,43,9,7,16,61.0,82,5.14,57,348,2300,9.2
10879,Igor Ulanov,1994-95,25.0,4,11,27,27,2,9,11,23.0,,27,2,9,11,23.0,80,6.96,77,402,2440,11.4
10880,Igor Ulanov,1995-96,26.0,5,16,56,56,2,14,16,26.0,,83,4,23,27,49.0,84,7.25,87,443,2603,11.7
10881,Igor Ulanov,1996-97,27.0,6,17,74,74,0,17,17,46.0,,157,4,40,44,95.0,84,6.48,76,407,2545,10.7
10882,Igor Ulanov,1997-98,28.0,7,5,22,22,1,4,5,13.0,,179,5,44,49,108.0,48,5.97,37,209,1408,10.2
10883,Igor Ulanov,1998-99,29.0,8,12,64,64,3,9,12,37.0,,243,8,53,61,145.0,82,6.29,74,413,2481,10.4
10884,Igor Ulanov,1999-00,30.0,9,8,59,59,1,7,8,56.0,,302,9,60,69,201.0,82,5.83,55,336,2444,9.8
10885,Igor Ulanov,2000-01,31.0,10,10,49,49,2,8,10,36.0,,351,11,68,79,237.0,82,5.28,57,380,2242,9.6
10886,Igor Ulanov,2001-02,32.0,11,12,76,76,3,9,12,55.0,1336.0,427,14,77,91,292.0,82,5.27,57,359,2285,9.4
10887,Igor Ulanov,2002-03,33.0,12,9,57,57,1,8,9,39.0,941.0,484,15,85,100,331.0,82,5.49,53,331,2294,9.8
10888,Igor Ulanov,2003-04,34.0,13,23,67,67,3,20,23,74.0,1542.0,551,18,105,123,405.0,82,5.51,63,376,2272,9.9
10889,Igor Ulanov,2004-05,35.0,14,10,53,53,0,10,10,26.0,928.0,604,18,115,133,431.0,82,5.24,53,338,2262,9.5
10890,Igor Ulanov,2005-06,36.0,15,2,56,56,1,1,2,20.0,935.0,660,19,116,135,451.0,82,5.31,60,363,2326,9.4
10891,Igor Ulanov,2006-07,37.0,16,18,42,42,5,13,18,49.0,833.0,702,24,129,153,500.0,82,5.14,57,348,2300,9.2
10892,Igor Ulanov,2008-09,39.0,17,9,37,37,3,6,9,29.0,609.0,739,27,135,162,529.0,82,6.05,85,480,2458,10.1
10893,Igor Vyazmikin,1993-94,28.0,4,1,4,4,1,0,1,5.0,,4,1,0,1,5.0,80,6.91,71,366,2385,11.6
10894,Iiro Jarvi,1991-92,26.0,4,41,75,75,11,30,41,109.0,,75,11,30,41,109.0,80,7.48,85,403,2430,12.3
10895,Iiro Jarvi,1992-93,27.0,5,20,41,41,7,13,20,52.0,,116,18,43,61,161.0,80,7.37,76,367,2421,12.2
10896,Iiro Pakarinen,2017-18,26.0,4,3,17,17,1,2,3,34.0,172.0,17,1,2,3,34.0,82,5.32,47,251,2453,8.9
10897,Iiro Pakarinen,2018-19,27.0,5,13,63,63,5,8,13,76.0,677.0,80,6,10,16,110.0,82,5.34,48,255,2438,9.0
10898,Iiro Pakarinen,2019-20,28.0,6,4,14,14,2,2,4,15.0,125.0,94,8,12,20,125.0,82,5.45,47,245,2478,9.0
10899,Iiro Pakarinen,2020-21,29.0,7,3,40,40,2,1,3,50.0,408.0,134,10,13,23,175.0,82,5.86,50,250,2620,9.2
10900,Ilja Byakin,1996-97,33.0,4,28,44,44,8,20,28,51.0,,44,8,20,28,51.0,84,6.48,76,407,2545,10.7
10901,Ilja Byakin,1997-98,34.0,5,5,13,13,0,5,5,19.0,,57,8,25,33,70.0,48,5.97,37,209,1408,10.2
10902,Ilkka Heikkinen,2012-13,28.0,4,0,7,7,0,0,0,4.0,62.0,7,0,0,0,4.0,82,5.53,56,304,2486,9.1
10903,Ilkka Pikkarainen,2012-13,31.0,4,4,31,31,1,3,4,26.0,252.0,31,1,3,4,26.0,82,5.53,56,304,2486,9.1
10904,Ilkka Sinisalo,1984-85,26.0,4,37,66,66,15,22,37,87.0,,66,15,22,37,87.0,80,8.03,73,320,2489,12.9
10905,Ilkka Sinisalo,1985-86,27.0,5,50,61,61,21,29,50,126.0,,127,36,51,87,213.0,80,7.73,71,310,2444,12.7
10906,Ilkka Sinisalo,1986-87,28.0,6,46,73,73,29,17,46,164.0,,200,65,68,133,377.0,80,7.89,74,336,2448,12.9
10907,Ilkka Sinisalo,1987-88,29.0,7,73,70,70,36,37,73,170.0,,270,101,105,206,547.0,80,7.77,71,321,2447,12.7
10908,Ilkka Sinisalo,1988-89,30.0,8,76,74,74,39,37,76,184.0,,344,140,142,282,731.0,80,7.94,82,370,2484,12.8
10909,Ilkka Sinisalo,1989-90,31.0,9,32,42,42,10,22,32,80.0,,386,150,164,314,811.0,80,7.34,72,344,2400,12.2
10910,Ilkka Sinisalo,1990-91,32.0,10,42,68,68,25,17,42,148.0,,454,175,181,356,959.0,80,7.43,89,437,2435,12.2
10911,Ilkka Sinisalo,1991-92,33.0,11,7,13,13,1,6,7,15.0,,467,176,187,363,974.0,80,7.48,85,403,2430,12.3
10912,Ilkka Sinisalo,1992-93,34.0,12,46,59,59,23,23,46,102.0,,526,199,210,409,1076.0,80,7.37,76,367,2421,12.2
10913,Ilkka Sinisalo,1993-94,35.0,13,17,53,53,5,12,17,72.0,,579,204,222,426,1148.0,80,6.91,71,366,2385,11.6
10914,Ilkka Sinisalo,1994-95,36.0,14,1,3,3,0,1,1,3.0,,582,204,223,427,1151.0,80,6.96,77,402,2440,11.4
10915,Ilya Kovalchuk,2004-05,21.0,4,51,65,65,29,22,51,184.0,1205.0,65,29,22,51,184.0,82,5.24,53,338,2262,9.5
10916,Ilya Kovalchuk,2005-06,22.0,5,67,81,81,38,29,67,257.0,1575.0,146,67,51,118,441.0,82,5.31,60,363,2326,9.4
10917,Ilya Kovalchuk,2006-07,23.0,6,87,81,81,41,46,87,341.0,1919.0,227,108,97,205,782.0,82,5.14,57,348,2300,9.2
10918,Ilya Kovalchuk,2008-09,25.0,7,98,78,78,52,46,98,323.0,1746.0,305,160,143,303,1105.0,82,6.05,85,480,2458,10.1
10919,Ilya Kovalchuk,2009-10,26.0,8,76,82,82,42,34,76,336.0,1765.0,387,202,177,379,1441.0,82,5.76,70,398,2426,9.7
10920,Ilya Kovalchuk,2010-11,27.0,9,87,79,79,52,35,87,283.0,1699.0,466,254,212,466,1724.0,82,5.44,62,351,2383,9.4
10921,Ilya Kovalchuk,2011-12,28.0,10,91,79,79,43,48,91,275.0,1723.0,545,297,260,557,1999.0,82,5.7,65,341,2477,9.4
10922,Ilya Kovalchuk,2012-13,29.0,11,85,76,76,41,44,85,290.0,1675.0,621,338,304,642,2289.0,82,5.53,56,304,2486,9.1
10923,Ilya Kovalchuk,2013-14,30.0,12,60,81,81,31,29,60,245.0,1828.0,702,369,333,702,2534.0,82,5.46,52,291,2492,9.0
10924,Ilya Kovalchuk,2014-15,31.0,13,83,77,77,37,46,83,310.0,1882.0,779,406,379,785,2844.0,82,5.32,47,271,2439,8.9
10925,Ilya Kovalchuk,2015-16,32.0,14,31,37,37,11,20,31,123.0,915.0,816,417,399,816,2967.0,48,5.31,29,160,1399,9.1
10926,Ilya Kovalchuk,2021-22,38.0,15,34,64,64,16,18,34,141.0,1039.0,880,433,417,850,3108.0,82,5.96,47,239,2579,9.5
10927,Ilya Kovalchuk,2022-23,39.0,16,26,46,46,10,16,26,115.0,780.0,926,443,433,876,3223.0,70,5.96,42,208,2192,9.5
10928,Ilya Lyubushkin,2021-22,27.0,4,4,41,41,0,4,4,27.0,563.0,41,0,4,4,27.0,82,5.96,47,239,2579,9.5
10929,Ilya Lyubushkin,2022-23,28.0,5,4,51,51,0,4,4,41.0,724.0,92,0,8,8,68.0,70,5.96,42,208,2192,9.5
10930,Ilya Mikheyev,2022-23,28.0,4,23,39,39,8,15,23,98.0,607.0,39,8,15,23,98.0,70,5.96,42,208,2192,9.5
10931,Ilya Zubov,2010-11,23.0,4,0,1,1,0,0,0,0.0,15.0,1,0,0,0,0.0,82,5.44,62,351,2383,9.4
10932,Ilya Zubov,2011-12,24.0,5,2,10,10,0,2,2,11.0,103.0,11,0,2,2,11.0,82,5.7,65,341,2477,9.4
10933,Isac Lundestrom,2021-22,22.0,4,2,15,15,0,2,2,13.0,195.0,15,0,2,2,13.0,82,5.96,47,239,2579,9.5
10934,Isac Lundestrom,2022-23,23.0,5,4,15,15,0,4,4,10.0,209.0,30,0,6,6,23.0,70,5.96,42,208,2192,9.5
10935,Ivan Baranka,2010-11,25.0,4,1,1,1,0,1,1,1.0,13.0,1,0,1,1,1.0,82,5.44,62,351,2383,9.4
10936,Ivan Barbashev,2019-20,24.0,4,12,30,30,5,7,12,20.0,354.0,30,5,7,12,20.0,82,5.45,47,245,2478,9.0
10937,Ivan Barbashev,2020-21,25.0,5,13,53,53,7,6,13,45.0,646.0,83,12,13,25,65.0,82,5.86,50,250,2620,9.2
10938,Ivan Barbashev,2021-22,26.0,6,26,80,80,14,12,26,60.0,921.0,163,26,25,51,125.0,82,5.96,47,239,2579,9.5
10939,Ivan Barbashev,2022-23,27.0,7,26,69,69,11,15,26,75.0,928.0,232,37,40,77,200.0,70,5.96,42,208,2192,9.5
10940,Ivan Ciernik,2000-01,23.0,4,0,2,2,0,0,0,0.0,,2,0,0,0,0.0,82,5.28,57,380,2242,9.6
10941,Ivan Ciernik,2003-04,26.0,5,2,4,4,2,0,2,7.0,31.0,6,2,0,2,7.0,82,5.51,63,376,2272,9.9
10942,Ivan Ciernik,2004-05,27.0,6,4,29,29,1,3,4,23.0,236.0,35,3,3,6,30.0,82,5.24,53,338,2262,9.5
10943,Ivan Ciernik,2005-06,28.0,7,18,47,47,8,10,18,61.0,555.0,82,11,13,24,91.0,82,5.31,60,363,2326,9.4
10944,Ivan Ciernik,2006-07,29.0,8,2,7,7,1,1,2,8.0,67.0,89,12,14,26,99.0,82,5.14,57,348,2300,9.2
10945,Ivan Droppa,1996-97,24.0,4,1,12,12,0,1,1,13.0,,12,0,1,1,13.0,84,6.48,76,407,2545,10.7
10946,Ivan Droppa,1998-99,26.0,5,0,7,7,0,0,0,1.0,,19,0,1,1,14.0,82,6.29,74,413,2481,10.4
10947,Ivan Hlinka,1984-85,35.0,4,60,72,72,23,37,60,152.0,,72,23,37,60,152.0,80,8.03,73,320,2489,12.9
10948,Ivan Hlinka,1985-86,36.0,5,63,65,65,19,44,63,148.0,,137,42,81,123,300.0,80,7.73,71,310,2444,12.7
10949,Ivan Huml,2004-05,23.0,4,1,1,1,0,1,1,2.0,16.0,1,0,1,1,2.0,82,5.24,53,338,2262,9.5
10950,Ivan Huml,2005-06,24.0,5,17,41,41,6,11,17,75.0,523.0,42,6,12,18,77.0,82,5.31,60,363,2326,9.4
10951,Ivan Huml,2006-07,25.0,6,0,7,7,0,0,0,11.0,65.0,49,6,12,18,88.0,82,5.14,57,348,2300,9.2
10952,Ivan Majesky,2005-06,29.0,4,12,82,82,4,8,12,52.0,1713.0,82,4,8,12,52.0,82,5.31,60,363,2326,9.4
10953,Ivan Majesky,2006-07,30.0,5,10,63,63,3,7,10,35.0,911.0,145,7,15,22,87.0,82,5.14,57,348,2300,9.2
10954,Ivan Majesky,2008-09,32.0,6,9,57,57,1,8,9,35.0,987.0,202,8,23,31,122.0,82,6.05,85,480,2458,10.1
10955,Ivan Novoseltsev,2002-03,24.0,4,3,14,14,2,1,3,8.0,147.0,14,2,1,3,8.0,82,5.49,53,331,2294,9.8
10956,Ivan Novoseltsev,2003-04,25.0,5,9,38,38,3,6,9,34.0,408.0,52,5,7,12,42.0,82,5.51,63,376,2272,9.9
10957,Ivan Novoseltsev,2004-05,26.0,6,29,70,70,13,16,29,109.0,1042.0,122,18,23,41,151.0,82,5.24,53,338,2262,9.5
10958,Ivan Novoseltsev,2005-06,27.0,7,27,78,78,10,17,27,115.0,1172.0,200,28,40,68,266.0,82,5.31,60,363,2326,9.4
10959,Ivan Novoseltsev,2006-07,28.0,8,7,34,34,3,4,7,48.0,376.0,234,31,44,75,314.0,82,5.14,57,348,2300,9.2
10960,Ivan Provorov,2019-20,23.0,4,30,82,82,6,24,30,161.0,1802.0,82,6,24,30,161.0,82,5.45,47,245,2478,9.0
10961,Ivan Provorov,2020-21,24.0,5,41,82,82,17,24,41,203.0,1981.0,164,23,48,71,364.0,82,5.86,50,250,2620,9.2
10962,Ivan Provorov,2021-22,25.0,6,26,82,82,7,19,26,145.0,2059.0,246,30,67,97,509.0,82,5.96,47,239,2579,9.5
10963,Ivan Provorov,2022-23,26.0,7,36,69,69,13,23,36,150.0,1714.0,315,43,90,133,659.0,70,5.96,42,208,2192,9.5
10964,Ivan Vishnevskiy,2011-12,23.0,4,2,3,3,0,2,2,9.0,59.0,3,0,2,2,9.0,82,5.7,65,341,2477,9.4
10965,Ivan Vishnevskiy,2012-13,24.0,5,0,2,2,0,0,0,4.0,33.0,5,0,2,2,13.0,82,5.53,56,304,2486,9.1
10966,J.C. Beaudin,2022-23,25.0,4,1,22,22,0,1,1,18.0,190.0,22,0,1,1,18.0,70,5.96,42,208,2192,9.5
10967,J.C. Lipon,2018-19,25.0,4,1,9,9,0,1,1,4.0,63.0,9,0,1,1,4.0,82,5.34,48,255,2438,9.0
10968,J.F. Sauve,1983-84,24.0,4,14,20,20,5,9,14,26.0,,20,5,9,14,26.0,80,7.69,77,340,2441,12.6
10969,J.F. Sauve,1984-85,25.0,5,55,69,69,19,36,55,121.0,,89,24,45,69,147.0,80,8.03,73,320,2489,12.9
10970,J.F. Sauve,1985-86,26.0,6,4,9,9,0,4,4,14.0,,98,24,49,73,161.0,80,7.73,71,310,2444,12.7
10971,J.F. Sauve,1986-87,27.0,7,27,39,39,10,17,27,43.0,,137,34,66,100,204.0,80,7.89,74,336,2448,12.9
10972,J.F. Sauve,1987-88,28.0,8,42,64,64,13,29,42,87.0,,201,47,95,142,291.0,80,7.77,71,321,2447,12.7
10973,J.F. Sauve,1988-89,29.0,9,56,75,75,16,40,56,100.0,,276,63,135,198,391.0,80,7.94,82,370,2484,12.8
10974,J.F. Sauve,1989-90,30.0,10,5,14,14,2,3,5,14.0,,290,65,138,203,405.0,80,7.34,72,344,2400,12.2
10975,J.J. Daigneault,1987-88,22.0,4,27,67,67,4,23,27,93.0,,67,4,23,27,93.0,80,7.77,71,321,2447,12.7
10976,J.J. Daigneault,1988-89,23.0,5,28,64,64,5,23,28,115.0,,131,9,46,55,208.0,80,7.94,82,370,2484,12.8
10977,J.J. Daigneault,1989-90,24.0,6,22,77,77,6,16,22,82.0,,208,15,62,77,290.0,80,7.34,72,344,2400,12.2
10978,J.J. Daigneault,1990-91,25.0,7,4,28,28,2,2,4,20.0,,236,17,64,81,310.0,80,7.43,89,437,2435,12.2
10979,J.J. Daigneault,1992-93,27.0,8,12,36,36,2,10,12,40.0,,272,19,74,93,350.0,80,7.37,76,367,2421,12.2
10980,J.J. Daigneault,1993-94,28.0,9,19,51,51,3,16,19,68.0,,323,22,90,112,418.0,80,6.91,71,366,2385,11.6
10981,J.J. Daigneault,1994-95,29.0,10,18,79,79,4,14,18,108.0,,402,26,104,130,526.0,80,6.96,77,402,2440,11.4
10982,J.J. Daigneault,1995-96,30.0,11,18,66,66,8,10,18,68.0,,468,34,114,148,594.0,84,7.25,87,443,2603,11.7
10983,J.J. Daigneault,1996-97,31.0,12,14,68,68,2,12,14,61.0,,536,36,126,162,655.0,84,6.48,76,407,2545,10.7
10984,J.J. Daigneault,1997-98,32.0,13,8,45,45,3,5,8,36.0,,581,39,131,170,691.0,48,5.97,37,209,1408,10.2
10985,J.J. Daigneault,1998-99,33.0,14,11,57,57,4,7,11,61.0,,638,43,138,181,752.0,82,6.29,74,413,2481,10.4
10986,J.J. Daigneault,1999-00,34.0,15,28,66,66,5,23,28,62.0,,704,48,161,209,814.0,82,5.83,55,336,2444,9.8
10987,J.J. Daigneault,2000-01,35.0,16,23,71,71,2,21,23,92.0,,775,50,182,232,906.0,82,5.28,57,380,2242,9.6
10988,J.J. Daigneault,2001-02,36.0,17,11,70,70,2,9,11,65.0,1357.0,845,52,191,243,971.0,82,5.27,57,359,2285,9.4
10989,J.J. Daigneault,2002-03,37.0,18,7,53,53,1,6,7,44.0,753.0,898,53,197,250,1015.0,82,5.49,53,331,2294,9.8
10990,J.J. Daigneault,2003-04,38.0,19,0,1,1,0,0,0,0.0,12.0,899,53,197,250,1015.0,82,5.51,63,376,2272,9.9
10991,J.P. Dumont,2001-02,23.0,4,15,25,25,9,6,15,42.0,356.0,25,9,6,15,42.0,82,5.27,57,359,2285,9.4
10992,J.P. Dumont,2002-03,24.0,5,18,47,47,10,8,18,86.0,606.0,72,19,14,33,128.0,82,5.49,53,331,2294,9.8
10993,J.P. Dumont,2003-04,25.0,6,51,79,79,23,28,51,156.0,1186.0,151,42,42,84,284.0,82,5.51,63,376,2272,9.9
10994,J.P. Dumont,2004-05,26.0,7,44,76,76,23,21,44,154.0,1157.0,227,65,63,128,438.0,82,5.24,53,338,2262,9.5
10995,J.P. Dumont,2005-06,27.0,8,35,76,76,14,21,35,135.0,1145.0,303,79,84,163,573.0,82,5.31,60,363,2326,9.4
10996,J.P. Dumont,2006-07,28.0,9,53,77,77,22,31,53,156.0,1310.0,380,101,115,216,729.0,82,5.14,57,348,2300,9.2
10997,J.P. Dumont,2008-09,30.0,10,40,54,54,20,20,40,116.0,864.0,434,121,135,256,845.0,82,6.05,85,480,2458,10.1
10998,J.P. Dumont,2009-10,31.0,11,66,82,82,21,45,66,143.0,1328.0,516,142,180,322,988.0,82,5.76,70,398,2426,9.7
10999,J.P. Dumont,2010-11,32.0,12,72,80,80,29,43,72,192.0,1480.0,596,171,223,394,1180.0,82,5.44,62,351,2383,9.4
11000,J.P. Dumont,2011-12,33.0,13,65,82,82,16,49,65,176.0,1435.0,678,187,272,459,1356.0,82,5.7,65,341,2477,9.4
11001,J.P. Dumont,2012-13,34.0,14,45,74,74,17,28,45,112.0,1093.0,752,204,300,504,1468.0,82,5.53,56,304,2486,9.1
11002,J.P. Dumont,2013-14,35.0,15,19,70,70,10,9,19,89.0,783.0,822,214,309,523,1557.0,82,5.46,52,291,2492,9.0
11003,J.P. Vigier,2003-04,27.0,4,0,2,2,0,0,0,1.0,20.0,2,0,0,0,1.0,82,5.51,63,376,2272,9.9
11004,J.P. Vigier,2004-05,28.0,5,5,15,15,4,1,5,18.0,198.0,17,4,1,5,19.0,82,5.24,53,338,2262,9.5
11005,J.P. Vigier,2005-06,29.0,6,0,13,13,0,0,0,21.0,184.0,30,4,1,5,40.0,82,5.31,60,363,2326,9.4
11006,J.P. Vigier,2006-07,30.0,7,18,70,70,10,8,18,110.0,1022.0,100,14,9,23,150.0,82,5.14,57,348,2300,9.2
11007,J.P. Vigier,2008-09,32.0,8,10,41,41,4,6,10,53.0,589.0,141,18,15,33,203.0,82,6.05,85,480,2458,10.1
11008,J.P. Vigier,2009-10,33.0,9,13,72,72,5,8,13,83.0,792.0,213,23,23,46,286.0,82,5.76,70,398,2426,9.7
11009,J.T. Brown,2014-15,24.0,4,1,5,5,0,1,1,13.0,69.0,5,0,1,1,13.0,82,5.32,47,271,2439,8.9
11010,J.T. Brown,2016-17,26.0,5,19,63,63,4,15,19,113.0,821.0,68,4,16,20,126.0,82,5.34,48,269,2463,8.9
11011,J.T. Brown,2017-18,27.0,6,9,52,52,3,6,9,74.0,552.0,120,7,22,29,200.0,82,5.32,47,251,2453,8.9
11012,J.T. Brown,2018-19,28.0,7,22,78,78,8,14,22,140.0,1042.0,198,15,36,51,340.0,82,5.34,48,255,2438,9.0
11013,J.T. Brown,2019-20,29.0,8,6,64,64,3,3,6,67.0,664.0,262,18,39,57,407.0,82,5.45,47,245,2478,9.0
11014,J.T. Brown,2020-21,30.0,9,7,47,47,2,5,7,40.0,426.0,309,20,44,64,447.0,82,5.86,50,250,2620,9.2
11015,J.T. Brown,2021-22,31.0,10,8,56,56,3,5,8,56.0,514.0,365,23,49,72,503.0,82,5.96,47,239,2579,9.5
11016,J.T. Compher,2019-20,24.0,4,5,21,21,3,2,5,30.0,314.0,21,3,2,5,30.0,82,5.45,47,245,2478,9.0
11017,J.T. Compher,2020-21,25.0,5,23,69,69,13,10,23,131.0,1104.0,90,16,12,28,161.0,82,5.86,50,250,2620,9.2
11018,J.T. Compher,2021-22,26.0,6,32,66,66,16,16,32,118.0,1153.0,156,32,28,60,279.0,82,5.96,47,239,2579,9.5
11019,J.T. Compher,2022-23,27.0,7,31,67,67,11,20,31,106.0,1122.0,223,43,48,91,385.0,70,5.96,42,208,2192,9.5
11020,J.T. Miller,2015-16,22.0,4,4,26,26,2,2,4,43.0,352.0,26,2,2,4,43.0,48,5.31,29,160,1399,9.1
11021,J.T. Miller,2016-17,23.0,5,6,30,30,3,3,6,46.0,344.0,56,5,5,10,89.0,82,5.34,48,269,2463,8.9
11022,J.T. Miller,2017-18,24.0,6,23,58,58,10,13,23,92.0,737.0,114,15,18,33,181.0,82,5.32,47,251,2453,8.9
11023,J.T. Miller,2018-19,25.0,7,43,82,82,22,21,43,135.0,1233.0,196,37,39,76,316.0,82,5.34,48,255,2438,9.0
11024,J.T. Miller,2019-20,26.0,8,56,82,82,22,34,56,132.0,1342.0,278,59,73,132,448.0,82,5.45,47,245,2478,9.0
11025,J.T. Miller,2020-21,27.0,9,58,82,82,23,35,58,143.0,1396.0,360,82,108,190,591.0,82,5.86,50,250,2620,9.2
11026,J.T. Miller,2021-22,28.0,10,47,75,75,13,34,47,108.0,1100.0,435,95,142,237,699.0,82,5.96,47,239,2579,9.5
11027,J.T. Miller,2022-23,29.0,11,72,69,69,27,45,72,165.0,1387.0,504,122,187,309,864.0,70,5.96,42,208,2192,9.5
11028,J.T. Wyman,2012-13,26.0,4,0,3,3,0,0,0,0.0,13.0,3,0,0,0,0.0,82,5.53,56,304,2486,9.1
11029,J.T. Wyman,2014-15,28.0,5,11,40,40,2,9,11,31.0,422.0,43,2,9,11,31.0,82,5.32,47,271,2439,8.9
11030,J.T. Wyman,2015-16,29.0,6,0,1,1,0,0,0,0.0,14.0,44,2,9,11,31.0,48,5.31,29,160,1399,9.1
11031,Jaccob Slavin,2018-19,24.0,4,20,63,63,2,18,20,84.0,1322.0,63,2,18,20,84.0,82,5.34,48,255,2438,9.0
11032,Jaccob Slavin,2019-20,25.0,5,34,82,82,5,29,34,99.0,1922.0,145,7,47,54,183.0,82,5.45,47,245,2478,9.0
11033,Jaccob Slavin,2020-21,26.0,6,30,82,82,8,22,30,154.0,1852.0,227,15,69,84,337.0,82,5.86,50,250,2620,9.2
11034,Jaccob Slavin,2021-22,27.0,7,31,82,82,8,23,31,146.0,1889.0,309,23,92,115,483.0,82,5.96,47,239,2579,9.5
11035,Jaccob Slavin,2022-23,28.0,8,36,68,68,6,30,36,145.0,1592.0,377,29,122,151,628.0,70,5.96,42,208,2192,9.5
11036,Jack Capuano,1992-93,26.0,4,0,1,1,0,0,0,1.0,,1,0,0,0,1.0,80,7.37,76,367,2421,12.2
11037,Jack Capuano,1993-94,27.0,5,0,3,3,0,0,0,4.0,,4,0,0,0,5.0,80,6.91,71,366,2385,11.6
11038,Jack Capuano,1994-95,28.0,6,0,2,2,0,0,0,1.0,,6,0,0,0,6.0,80,6.96,77,402,2440,11.4
11039,Jack Eichel,2018-19,22.0,4,56,81,81,24,32,56,238.0,1549.0,81,24,32,56,238.0,82,5.34,48,255,2438,9.0
11040,Jack Eichel,2019-20,23.0,5,57,61,61,24,33,57,249.0,1215.0,142,48,65,113,487.0,82,5.45,47,245,2478,9.0
11041,Jack Eichel,2020-21,24.0,6,64,67,67,25,39,64,246.0,1350.0,209,73,104,177,733.0,82,5.86,50,250,2620,9.2
11042,Jack Eichel,2021-22,25.0,7,82,77,77,28,54,82,303.0,1574.0,286,101,158,259,1036.0,82,5.96,47,239,2579,9.5
11043,Jack Eichel,2022-23,26.0,8,78,68,68,36,42,78,227.0,1503.0,354,137,200,337,1263.0,70,5.96,42,208,2192,9.5
11044,Jack Hillen,2010-11,25.0,4,1,2,2,0,1,1,3.0,31.0,2,0,1,1,3.0,82,5.44,62,351,2383,9.4
11045,Jack Hillen,2011-12,26.0,5,6,40,40,1,5,6,47.0,608.0,42,1,6,7,50.0,82,5.7,65,341,2477,9.4
11046,Jack Hillen,2012-13,27.0,6,21,69,69,3,18,21,78.0,1428.0,111,4,24,28,128.0,82,5.53,56,304,2486,9.1
11047,Jack Hillen,2013-14,28.0,7,22,64,64,4,18,22,81.0,1204.0,175,8,42,50,209.0,82,5.46,52,291,2492,9.0
11048,Jack Hillen,2014-15,29.0,8,6,55,55,2,4,6,51.0,773.0,230,10,46,56,260.0,82,5.32,47,271,2439,8.9
11049,Jack Hillen,2015-16,30.0,9,9,23,23,3,6,9,28.0,405.0,253,13,52,65,288.0,48,5.31,29,160,1399,9.1
11050,Jack Hillen,2016-17,31.0,10,1,13,13,0,1,1,12.0,238.0,266,13,53,66,300.0,82,5.34,48,269,2463,8.9
11051,Jack Hillen,2017-18,32.0,11,5,38,38,0,5,5,24.0,489.0,304,13,58,71,324.0,82,5.32,47,251,2453,8.9
11052,Jack Hughes,1983-84,26.0,4,7,38,38,2,5,7,20.0,,38,2,5,7,20.0,80,7.69,77,340,2441,12.6
11053,Jack Hughes,1984-85,27.0,5,0,8,8,0,0,0,1.0,,46,2,5,7,21.0,80,8.03,73,320,2489,12.9
11054,Jack Hughes0,2022-23,21.0,4,21,61,61,7,14,21,123.0,968.0,61,7,14,21,123.0,70,5.96,42,208,2192,9.5
11055,Jack Johnson,2009-10,23.0,4,0,5,5,0,0,0,5.0,107.0,5,0,0,0,5.0,82,5.76,70,398,2426,9.7
11056,Jack Johnson,2010-11,24.0,5,11,74,74,3,8,11,81.0,1605.0,79,3,8,11,86.0,82,5.44,62,351,2383,9.4
11057,Jack Johnson,2011-12,25.0,6,11,41,41,6,5,11,50.0,831.0,120,9,13,22,136.0,82,5.7,65,341,2477,9.4
11058,Jack Johnson,2012-13,26.0,7,36,80,80,8,28,36,130.0,1809.0,200,17,41,58,266.0,82,5.53,56,304,2486,9.1
11059,Jack Johnson,2013-14,27.0,8,42,82,82,5,37,42,153.0,1902.0,282,22,78,100,419.0,82,5.46,52,291,2492,9.0
11060,Jack Johnson,2014-15,28.0,9,38,82,82,12,26,38,176.0,1949.0,364,34,104,138,595.0,82,5.32,47,271,2439,8.9
11061,Jack Johnson,2015-16,29.0,10,19,44,44,5,14,19,96.0,1143.0,408,39,118,157,691.0,48,5.31,29,160,1399,9.1
11062,Jack Johnson,2016-17,30.0,11,33,82,82,5,28,33,147.0,2024.0,490,44,146,190,838.0,82,5.34,48,269,2463,8.9
11063,Jack Johnson,2017-18,31.0,12,40,79,79,8,32,40,141.0,1909.0,569,52,178,230,979.0,82,5.32,47,251,2453,8.9
11064,Jack Johnson,2018-19,32.0,13,14,60,60,6,8,14,86.0,1451.0,629,58,186,244,1065.0,82,5.34,48,255,2438,9.0
11065,Jack Johnson,2019-20,33.0,14,23,82,82,5,18,23,116.0,1789.0,711,63,204,267,1181.0,82,5.45,47,245,2478,9.0
11066,Jack Johnson,2020-21,34.0,15,11,77,77,3,8,11,88.0,1505.0,788,66,212,278,1269.0,82,5.86,50,250,2620,9.2
11067,Jack Johnson,2021-22,35.0,16,13,82,82,1,12,13,86.0,1581.0,870,67,224,291,1355.0,82,5.96,47,239,2579,9.5
11068,Jack Johnson,2022-23,36.0,17,11,67,67,3,8,11,63.0,1304.0,937,70,232,302,1418.0,70,5.96,42,208,2192,9.5
11069,Jack O'Callahan,1985-86,28.0,4,11,39,39,0,11,11,45.0,,39,0,11,11,45.0,80,7.73,71,310,2444,12.7
11070,Jack O'Callahan,1986-87,29.0,5,17,70,70,4,13,17,89.0,,109,4,24,28,134.0,80,7.89,74,336,2448,12.9
11071,Jack O'Callahan,1987-88,30.0,6,14,66,66,6,8,14,69.0,,175,10,32,42,203.0,80,7.77,71,321,2447,12.7
11072,Jack O'Callahan,1988-89,31.0,7,23,80,80,4,19,23,86.0,,255,14,51,65,289.0,80,7.94,82,370,2484,12.8
11073,Jack O'Callahan,1989-90,32.0,8,14,48,48,1,13,14,66.0,,303,15,64,79,355.0,80,7.34,72,344,2400,12.2
11074,Jack O'Callahan,1990-91,33.0,9,26,50,50,7,19,26,90.0,,353,22,83,105,445.0,80,7.43,89,437,2435,12.2
11075,Jack O'Callahan,1991-92,34.0,10,26,36,36,5,21,26,96.0,,389,27,104,131,541.0,80,7.48,85,403,2430,12.3
11076,Jack Rodewald,2020-21,26.0,4,0,4,4,0,0,0,0.0,29.0,4,0,0,0,0.0,82,5.86,50,250,2620,9.2
11077,Jack Rodewald,2021-22,27.0,5,0,6,6,0,0,0,2.0,42.0,10,0,0,0,2.0,82,5.96,47,239,2579,9.5
11078,Jack Roslovic,2019-20,23.0,4,0,1,1,0,0,0,1.0,8.0,1,0,0,0,1.0,82,5.45,47,245,2478,9.0
11079,Jack Roslovic,2020-21,24.0,5,14,31,31,5,9,14,38.0,382.0,32,5,9,14,39.0,82,5.86,50,250,2620,9.2
11080,Jack Roslovic,2021-22,25.0,6,24,77,77,9,15,24,74.0,750.0,109,14,24,38,113.0,82,5.96,47,239,2579,9.5
11081,Jack Roslovic,2022-23,26.0,7,29,71,71,12,17,29,117.0,1058.0,180,26,41,67,230.0,70,5.96,42,208,2192,9.5
11082,Jack Skille,2010-11,23.0,4,5,16,16,3,2,5,23.0,192.0,16,3,2,5,23.0,82,5.44,62,351,2383,9.4
11083,Jack Skille,2011-12,24.0,5,1,8,8,1,0,1,14.0,76.0,24,4,2,6,37.0,82,5.7,65,341,2477,9.4
11084,Jack Skille,2012-13,25.0,6,2,6,6,1,1,2,9.0,46.0,30,5,3,8,46.0,82,5.53,56,304,2486,9.1
11085,Jack Skille,2013-14,26.0,7,19,62,62,8,11,19,154.0,739.0,92,13,14,27,200.0,82,5.46,52,291,2492,9.0
11086,Jack Skille,2014-15,27.0,8,10,46,46,4,6,10,76.0,550.0,138,17,20,37,276.0,82,5.32,47,271,2439,8.9
11087,Jack Skille,2015-16,28.0,9,12,40,40,3,9,12,69.0,533.0,178,20,29,49,345.0,48,5.31,29,160,1399,9.1
11088,Jack Skille,2016-17,29.0,10,4,16,16,4,0,4,23.0,139.0,194,24,29,53,368.0,82,5.34,48,269,2463,8.9
11089,Jack Skille,2017-18,30.0,11,8,45,45,6,2,8,95.0,564.0,239,30,31,61,463.0,82,5.32,47,251,2453,8.9
11090,Jack Skille,2018-19,31.0,12,14,74,74,8,6,14,106.0,654.0,313,38,37,75,569.0,82,5.34,48,255,2438,9.0
11091,Jack Skille,2019-20,32.0,13,9,55,55,5,4,9,73.0,484.0,368,43,41,84,642.0,82,5.45,47,245,2478,9.0
11092,Jack Studnicka,2022-23,23.0,4,1,2,2,0,1,1,3.0,24.0,2,0,1,1,3.0,70,5.96,42,208,2192,9.5
11093,Jacob Josefson,2013-14,22.0,4,10,28,28,3,7,10,31.0,371.0,28,3,7,10,31.0,82,5.46,52,291,2492,9.0
11094,Jacob Josefson,2014-15,23.0,5,9,41,41,2,7,9,37.0,496.0,69,5,14,19,68.0,82,5.32,47,271,2439,8.9
11095,Jacob Josefson,2015-16,24.0,6,3,22,22,1,2,3,20.0,286.0,91,6,16,22,88.0,48,5.31,29,160,1399,9.1
11096,Jacob Josefson,2016-17,25.0,7,3,27,27,1,2,3,21.0,274.0,118,7,18,25,109.0,82,5.34,48,269,2463,8.9
11097,Jacob Josefson,2017-18,26.0,8,11,62,62,6,5,11,61.0,771.0,180,13,23,36,170.0,82,5.32,47,251,2453,8.9
11098,Jacob Josefson,2018-19,27.0,9,14,58,58,4,10,14,86.0,900.0,238,17,33,50,256.0,82,5.34,48,255,2438,9.0
11099,Jacob Josefson,2019-20,28.0,10,10,38,38,1,9,10,44.0,465.0,276,18,42,60,300.0,82,5.45,47,245,2478,9.0
11100,Jacob Josefson,2020-21,29.0,11,4,39,39,2,2,4,35.0,444.0,315,20,44,64,335.0,82,5.86,50,250,2620,9.2
11101,Jacob Larsson,2019-20,22.0,4,0,4,4,0,0,0,2.0,66.0,4,0,0,0,2.0,82,5.45,47,245,2478,9.0
11102,Jacob Larsson,2021-22,24.0,5,5,49,49,0,5,5,57.0,839.0,53,0,5,5,59.0,82,5.96,47,239,2579,9.5
11103,Jacob Larsson,2022-23,25.0,6,11,60,60,2,9,11,58.0,969.0,113,2,14,16,117.0,70,5.96,42,208,2192,9.5
11104,Jacob MacDonald,2021-22,28.0,4,1,2,2,1,0,1,1.0,24.0,2,1,0,1,1.0,82,5.96,47,239,2579,9.5
11105,Jacob Middleton,2021-22,26.0,4,1,3,3,0,1,1,0.0,30.0,3,0,1,1,0.0,82,5.96,47,239,2579,9.5
11106,Jacob Middleton,2022-23,27.0,5,2,10,10,0,2,2,9.0,108.0,13,0,3,3,9.0,70,5.96,42,208,2192,9.5
11107,Jacob Nilsson,2021-22,28.0,4,0,2,2,0,0,0,0.0,16.0,2,0,0,0,0.0,82,5.96,47,239,2579,9.5
11108,Jacob Trouba,2016-17,22.0,4,29,65,65,10,19,29,121.0,1458.0,65,10,19,29,121.0,82,5.34,48,269,2463,8.9
11109,Jacob Trouba,2017-18,23.0,5,22,65,65,7,15,22,133.0,1516.0,130,17,34,51,254.0,82,5.32,47,251,2453,8.9
11110,Jacob Trouba,2018-19,24.0,6,21,81,81,6,15,21,133.0,1787.0,211,23,49,72,387.0,82,5.34,48,255,2438,9.0
11111,Jacob Trouba,2019-20,25.0,7,33,60,60,8,25,33,154.0,1498.0,271,31,74,105,541.0,82,5.45,47,245,2478,9.0
11112,Jacob Trouba,2020-21,26.0,8,24,55,55,3,21,24,144.0,1204.0,326,34,95,129,685.0,82,5.86,50,250,2620,9.2
11113,Jacob Trouba,2021-22,27.0,9,50,82,82,8,42,50,162.0,1876.0,408,42,137,179,847.0,82,5.96,47,239,2579,9.5
11114,Jacob Trouba,2022-23,28.0,10,27,70,70,7,20,27,168.0,1580.0,478,49,157,206,1015.0,70,5.96,42,208,2192,9.5
11115,Jacob de La Rose,2017-18,22.0,4,6,33,33,4,2,6,38.0,455.0,33,4,2,6,38.0,82,5.32,47,251,2453,8.9
11116,Jacob de La Rose,2018-19,23.0,5,1,22,22,0,1,1,20.0,274.0,55,4,3,7,58.0,82,5.34,48,255,2438,9.0
11117,Jacob de La Rose,2019-20,24.0,6,0,9,9,0,0,0,4.0,98.0,64,4,3,7,62.0,82,5.45,47,245,2478,9.0
11118,Jacob de La Rose,2020-21,25.0,7,12,55,55,4,8,12,53.0,652.0,119,8,11,19,115.0,82,5.86,50,250,2620,9.2
11119,Jacob de La Rose,2021-22,26.0,8,9,60,60,3,6,9,55.0,686.0,179,11,17,28,170.0,82,5.96,47,239,2579,9.5
11120,Jacob de La Rose,2022-23,27.0,9,9,50,50,2,7,9,46.0,536.0,229,13,24,37,216.0,70,5.96,42,208,2192,9.5
11121,Jacques Mailhot,1991-92,30.0,4,0,5,5,0,0,0,0.0,,5,0,0,0,0.0,80,7.48,85,403,2430,12.3
11122,Jaden Schwartz,2014-15,22.0,4,3,7,7,2,1,3,6.0,82.0,7,2,1,3,6.0,82,5.32,47,271,2439,8.9
11123,Jaden Schwartz,2015-16,23.0,5,13,45,45,7,6,13,50.0,561.0,52,9,7,16,56.0,48,5.31,29,160,1399,9.1
11124,Jaden Schwartz,2016-17,24.0,6,56,80,80,25,31,56,188.0,1402.0,132,34,38,72,244.0,82,5.34,48,269,2463,8.9
11125,Jaden Schwartz,2017-18,25.0,7,63,75,75,28,35,63,184.0,1368.0,207,62,73,135,428.0,82,5.32,47,251,2453,8.9
11126,Jaden Schwartz,2018-19,26.0,8,22,33,33,8,14,22,63.0,568.0,240,70,87,157,491.0,82,5.34,48,255,2438,9.0
11127,Jaden Schwartz,2019-20,27.0,9,55,78,78,19,36,55,179.0,1475.0,318,89,123,212,670.0,82,5.45,47,245,2478,9.0
11128,Jaden Schwartz,2020-21,28.0,10,59,62,62,24,35,59,157.0,1202.0,380,113,158,271,827.0,82,5.86,50,250,2620,9.2
11129,Jaden Schwartz,2021-22,29.0,11,36,69,69,11,25,36,183.0,1251.0,449,124,183,307,1010.0,82,5.96,47,239,2579,9.5
11130,Jaden Schwartz,2022-23,30.0,12,57,71,71,22,35,57,162.0,1291.0,520,146,218,364,1172.0,70,5.96,42,208,2192,9.5
11131,Jaime Sifers,2011-12,29.0,4,2,23,23,0,2,2,25.0,295.0,23,0,2,2,25.0,82,5.7,65,341,2477,9.4
11132,Jaime Sifers,2012-13,30.0,5,0,14,14,0,0,0,9.0,182.0,37,0,2,2,34.0,82,5.53,56,304,2486,9.1
11133,Jake Bean,2021-22,23.0,4,0,2,2,0,0,0,1.0,17.0,2,0,0,0,1.0,82,5.96,47,239,2579,9.5
11134,Jake Bischoff,2022-23,28.0,4,0,4,4,0,0,0,6.0,62.0,4,0,0,0,6.0,70,5.96,42,208,2192,9.5
11135,Jake Chelios,2021-22,30.0,4,0,5,5,0,0,0,5.0,86.0,5,0,0,0,5.0,82,5.96,47,239,2579,9.5
11136,Jake Debrusk,2020-21,24.0,4,43,70,70,16,27,43,143.0,1006.0,70,16,27,43,143.0,82,5.86,50,250,2620,9.2
11137,Jake Debrusk,2021-22,25.0,5,42,68,68,27,15,42,156.0,1099.0,138,43,42,85,299.0,82,5.96,47,239,2579,9.5
11138,Jake Debrusk,2022-23,26.0,6,35,65,65,19,16,35,161.0,1043.0,203,62,58,120,460.0,70,5.96,42,208,2192,9.5
11139,Jake Dotchin,2019-20,25.0,4,11,35,35,0,11,11,50.0,645.0,35,0,11,11,50.0,82,5.45,47,245,2478,9.0
11140,Jake Dotchin,2020-21,26.0,5,11,48,48,3,8,11,48.0,791.0,83,3,19,22,98.0,82,5.86,50,250,2620,9.2
11141,Jake Dotchin,2021-22,27.0,6,1,20,20,0,1,1,7.0,236.0,103,3,20,23,105.0,82,5.96,47,239,2579,9.5
11142,Jake Dowell,2010-11,25.0,4,3,19,19,2,1,3,19.0,227.0,19,2,1,3,19.0,82,5.44,62,351,2383,9.4
11143,Jake Dowell,2011-12,26.0,5,0,1,1,0,0,0,0.0,14.0,20,2,1,3,19.0,82,5.7,65,341,2477,9.4
11144,Jake Dowell,2012-13,27.0,6,2,3,3,1,1,2,4.0,21.0,23,3,2,5,23.0,82,5.53,56,304,2486,9.1
11145,Jake Dowell,2013-14,28.0,7,21,79,79,6,15,21,74.0,933.0,102,9,17,26,97.0,82,5.46,52,291,2492,9.0
11146,Jake Dowell,2014-15,29.0,8,7,52,52,2,5,7,39.0,397.0,154,11,22,33,136.0,82,5.32,47,271,2439,8.9
11147,Jake Dowell,2015-16,30.0,9,0,2,2,0,0,0,3.0,17.0,156,11,22,33,139.0,48,5.31,29,160,1399,9.1
11148,Jake Dowell,2016-17,31.0,10,0,1,1,0,0,0,1.0,7.0,157,11,22,33,140.0,82,5.34,48,269,2463,8.9
11149,Jake Evans,2022-23,26.0,4,3,13,13,2,1,3,14.0,135.0,13,2,1,3,14.0,70,5.96,42,208,2192,9.5
11150,Jake Gardiner,2014-15,24.0,4,30,75,75,7,23,30,79.0,1619.0,75,7,23,30,79.0,82,5.32,47,271,2439,8.9
11151,Jake Gardiner,2015-16,25.0,5,4,12,12,0,4,4,12.0,246.0,87,7,27,34,91.0,48,5.31,29,160,1399,9.1
11152,Jake Gardiner,2016-17,26.0,6,31,80,80,10,21,31,136.0,1686.0,167,17,48,65,227.0,82,5.34,48,269,2463,8.9
11153,Jake Gardiner,2017-18,27.0,7,24,79,79,4,20,24,100.0,1657.0,246,21,68,89,327.0,82,5.32,47,251,2453,8.9
11154,Jake Gardiner,2018-19,28.0,8,31,79,79,7,24,31,122.0,1629.0,325,28,92,120,449.0,82,5.34,48,255,2438,9.0
11155,Jake Gardiner,2019-20,29.0,9,43,82,82,9,34,43,127.0,1766.0,407,37,126,163,576.0,82,5.45,47,245,2478,9.0
11156,Jake Gardiner,2020-21,30.0,10,52,82,82,5,47,52,133.0,1847.0,489,42,173,215,709.0,82,5.86,50,250,2620,9.2
11157,Jake Gardiner,2021-22,31.0,11,30,62,62,3,27,30,78.0,1315.0,551,45,200,245,787.0,82,5.96,47,239,2579,9.5
11158,Jake Gardiner,2022-23,32.0,12,24,68,68,4,20,24,87.0,1133.0,619,49,220,269,874.0,70,5.96,42,208,2192,9.5
11159,Jake Guentzel,2019-20,25.0,4,33,40,40,16,17,33,81.0,635.0,40,16,17,33,81.0,82,5.45,47,245,2478,9.0
11160,Jake Guentzel,2020-21,26.0,5,48,82,82,22,26,48,171.0,1352.0,122,38,43,81,252.0,82,5.86,50,250,2620,9.2
11161,Jake Guentzel,2021-22,27.0,6,76,82,82,40,36,76,227.0,1587.0,204,78,79,157,479.0,82,5.96,47,239,2579,9.5
11162,Jake Guentzel,2022-23,28.0,7,43,39,39,20,23,43,127.0,805.0,243,98,102,200,606.0,70,5.96,42,208,2192,9.5
11163,Jake McCabe,2016-17,23.0,4,1,7,7,0,1,1,1.0,107.0,7,0,1,1,1.0,82,5.34,48,269,2463,8.9
11164,Jake McCabe,2017-18,24.0,5,0,2,2,0,0,0,2.0,22.0,9,0,1,1,3.0,82,5.32,47,251,2453,8.9
11165,Jake McCabe,2018-19,25.0,6,14,77,77,4,10,14,62.0,1472.0,86,4,11,15,65.0,82,5.34,48,255,2438,9.0
11166,Jake McCabe,2019-20,26.0,7,20,76,76,3,17,20,79.0,1574.0,162,7,28,35,144.0,82,5.45,47,245,2478,9.0
11167,Jake McCabe,2020-21,27.0,8,12,53,53,3,9,12,53.0,1034.0,215,10,37,47,197.0,82,5.86,50,250,2620,9.2
11168,Jake McCabe,2021-22,28.0,9,14,59,59,4,10,14,64.0,1118.0,274,14,47,61,261.0,82,5.96,47,239,2579,9.5
11169,Jake McCabe,2022-23,29.0,10,13,66,66,3,10,13,75.0,1223.0,340,17,57,74,336.0,70,5.96,42,208,2192,9.5
11170,Jake Muzzin,2013-14,24.0,4,1,11,11,0,1,1,8.0,151.0,11,0,1,1,8.0,82,5.46,52,291,2492,9.0
11171,Jake Muzzin,2015-16,26.0,5,16,45,45,7,9,16,77.0,805.0,56,7,10,17,85.0,48,5.31,29,160,1399,9.1
11172,Jake Muzzin,2016-17,27.0,6,24,76,76,5,19,24,175.0,1446.0,132,12,29,41,260.0,82,5.34,48,269,2463,8.9
11173,Jake Muzzin,2017-18,28.0,7,41,76,76,10,31,41,173.0,1725.0,208,22,60,82,433.0,82,5.32,47,251,2453,8.9
11174,Jake Muzzin,2018-19,29.0,8,40,82,82,8,32,40,203.0,1891.0,290,30,92,122,636.0,82,5.34,48,255,2438,9.0
11175,Jake Muzzin,2019-20,30.0,9,28,82,82,9,19,28,184.0,1828.0,372,39,111,150,820.0,82,5.45,47,245,2478,9.0
11176,Jake Muzzin,2020-21,31.0,10,42,74,74,8,34,42,154.0,1602.0,446,47,145,192,974.0,82,5.86,50,250,2620,9.2
11177,Jake Muzzin,2021-22,32.0,11,37,80,80,9,28,37,141.0,1707.0,526,56,173,229,1115.0,82,5.96,47,239,2579,9.5
11178,Jake Muzzin,2022-23,33.0,12,23,53,53,6,17,23,99.0,1145.0,579,62,190,252,1214.0,70,5.96,42,208,2192,9.5
11179,Jake Virtanen,2018-19,22.0,4,13,55,55,7,6,13,94.0,636.0,55,7,6,13,94.0,82,5.34,48,255,2438,9.0
11180,Jake Virtanen,2019-20,23.0,5,1,10,10,0,1,1,13.0,101.0,65,7,7,14,107.0,82,5.45,47,245,2478,9.0
11181,Jake Virtanen,2020-21,24.0,6,20,75,75,10,10,20,130.0,899.0,140,17,17,34,237.0,82,5.86,50,250,2620,9.2
11182,Jake Virtanen,2021-22,25.0,7,25,70,70,15,10,25,154.0,1037.0,210,32,27,59,391.0,82,5.96,47,239,2579,9.5
11183,Jake Virtanen,2022-23,26.0,8,36,69,69,18,18,36,150.0,903.0,279,50,45,95,541.0,70,5.96,42,208,2192,9.5
11184,Jake Walman,2022-23,26.0,4,0,1,1,0,0,0,1.0,11.0,1,0,0,0,1.0,70,5.96,42,208,2192,9.5
11185,Jakob Chychrun,2019-20,21.0,4,20,68,68,7,13,20,86.0,1133.0,68,7,13,20,86.0,82,5.45,47,245,2478,9.0
11186,Jakob Chychrun,2020-21,22.0,5,14,50,50,4,10,14,102.0,1013.0,118,11,23,34,188.0,82,5.86,50,250,2620,9.2
11187,Jakob Chychrun,2021-22,23.0,6,20,53,53,5,15,20,117.0,1074.0,171,16,38,54,305.0,82,5.96,47,239,2579,9.5
11188,Jakob Chychrun,2022-23,24.0,7,26,63,63,12,14,26,149.0,1413.0,234,28,52,80,454.0,70,5.96,42,208,2192,9.5
11189,Jakob Forsbacka Karlsson,2019-20,23.0,4,0,1,1,0,0,0,0.0,8.0,1,0,0,0,0.0,82,5.45,47,245,2478,9.0
11190,Jakob Forsbacka Karlsson,2021-22,25.0,5,9,28,28,3,6,9,21.0,330.0,29,3,6,9,21.0,82,5.96,47,239,2579,9.5
11191,Jakob Lilja,2022-23,29.0,4,5,37,37,2,3,5,23.0,366.0,37,2,3,5,23.0,70,5.96,42,208,2192,9.5
11192,Jakob Silfverberg,2015-16,25.0,4,19,48,48,10,9,19,134.0,779.0,48,10,9,19,134.0,48,5.31,29,160,1399,9.1
11193,Jakob Silfverberg,2016-17,26.0,5,23,52,52,10,13,23,119.0,742.0,100,20,22,42,253.0,82,5.34,48,269,2463,8.9
11194,Jakob Silfverberg,2017-18,27.0,6,39,81,81,13,26,39,189.0,1269.0,181,33,48,81,442.0,82,5.32,47,251,2453,8.9
11195,Jakob Silfverberg,2018-19,28.0,7,39,82,82,20,19,39,215.0,1392.0,263,53,67,120,657.0,82,5.34,48,255,2438,9.0
11196,Jakob Silfverberg,2019-20,29.0,8,49,79,79,23,26,49,227.0,1460.0,342,76,93,169,884.0,82,5.45,47,245,2478,9.0
11197,Jakob Silfverberg,2020-21,30.0,9,40,77,77,17,23,40,187.0,1383.0,419,93,116,209,1071.0,82,5.86,50,250,2620,9.2
11198,Jakob Silfverberg,2021-22,31.0,10,43,73,73,24,19,43,163.0,1248.0,492,117,135,252,1234.0,82,5.96,47,239,2579,9.5
11199,Jakob Silfverberg,2022-23,32.0,11,39,66,66,21,18,39,155.0,1167.0,558,138,153,291,1389.0,70,5.96,42,208,2192,9.5
11200,Jakub Cutta,2003-04,22.0,4,0,3,3,0,0,0,1.0,35.0,3,0,0,0,1.0,82,5.51,63,376,2272,9.9
11201,Jakub Cutta,2004-05,23.0,5,0,2,2,0,0,0,2.0,32.0,5,0,0,0,3.0,82,5.24,53,338,2262,9.5
11202,Jakub Cutta,2006-07,25.0,6,0,3,3,0,0,0,1.0,42.0,8,0,0,0,4.0,82,5.14,57,348,2300,9.2
11203,Jakub Jerabek,2020-21,29.0,4,8,36,36,2,6,8,33.0,588.0,36,2,6,8,33.0,82,5.86,50,250,2620,9.2
11204,Jakub Jerabek,2021-22,30.0,5,0,1,1,0,0,0,1.0,8.0,37,2,6,8,34.0,82,5.96,47,239,2579,9.5
11205,Jakub Kindl,2012-13,25.0,4,0,3,3,0,0,0,1.0,32.0,3,0,0,0,1.0,82,5.53,56,304,2486,9.1
11206,Jakub Kindl,2013-14,26.0,5,4,48,48,2,2,4,62.0,653.0,51,2,2,4,63.0,82,5.46,52,291,2492,9.0
11207,Jakub Kindl,2014-15,27.0,6,13,55,55,1,12,13,69.0,773.0,106,3,14,17,132.0,82,5.32,47,271,2439,8.9
11208,Jakub Kindl,2015-16,28.0,7,13,41,41,4,9,13,76.0,761.0,147,7,23,30,208.0,48,5.31,29,160,1399,9.1
11209,Jakub Kindl,2016-17,29.0,8,19,66,66,2,17,19,93.0,1137.0,213,9,40,49,301.0,82,5.34,48,269,2463,8.9
11210,Jakub Kindl,2017-18,30.0,9,13,35,35,5,8,13,54.0,557.0,248,14,48,62,355.0,82,5.32,47,251,2453,8.9
11211,Jakub Kindl,2018-19,31.0,10,8,44,44,2,6,8,63.0,677.0,292,16,54,70,418.0,82,5.34,48,255,2438,9.0
11212,Jakub Kindl,2019-20,32.0,11,4,39,39,0,4,4,41.0,573.0,331,16,58,74,459.0,82,5.45,47,245,2478,9.0
11213,Jakub Klepis,2008-09,24.0,4,4,25,25,1,3,4,26.0,185.0,25,1,3,4,26.0,82,6.05,85,480,2458,10.1
11214,Jakub Klepis,2009-10,25.0,5,10,41,41,3,7,10,38.0,408.0,66,4,10,14,64.0,82,5.76,70,398,2426,9.7
11215,Jakub Nakladal,2018-19,31.0,4,5,27,27,2,3,5,42.0,383.0,27,2,3,5,42.0,82,5.34,48,255,2438,9.0
11216,Jakub Nakladal,2019-20,32.0,5,0,3,3,0,0,0,3.0,44.0,30,2,3,5,45.0,82,5.45,47,245,2478,9.0
11217,Jakub Petruzalek,2011-12,26.0,4,1,2,2,0,1,1,0.0,16.0,2,0,1,1,0.0,82,5.7,65,341,2477,9.4
11218,Jakub Voracek,2011-12,22.0,4,38,80,80,9,29,38,101.0,1013.0,80,9,29,38,101.0,82,5.7,65,341,2477,9.4
11219,Jakub Voracek,2012-13,23.0,5,50,81,81,16,34,50,154.0,1265.0,161,25,63,88,255.0,82,5.53,56,304,2486,9.1
11220,Jakub Voracek,2013-14,24.0,6,46,80,80,14,32,46,183.0,1358.0,241,39,95,134,438.0,82,5.46,52,291,2492,9.0
11221,Jakub Voracek,2014-15,25.0,7,49,78,78,18,31,49,190.0,1271.0,319,57,126,183,628.0,82,5.32,47,271,2439,8.9
11222,Jakub Voracek,2015-16,26.0,8,46,48,48,22,24,46,129.0,827.0,367,79,150,229,757.0,48,5.31,29,160,1399,9.1
11223,Jakub Voracek,2016-17,27.0,9,62,82,82,23,39,62,235.0,1415.0,449,102,189,291,992.0,82,5.34,48,269,2463,8.9
11224,Jakub Voracek,2017-18,28.0,10,81,82,82,22,59,81,221.0,1525.0,531,124,248,372,1213.0,82,5.32,47,251,2453,8.9
11225,Jakub Voracek,2018-19,29.0,11,55,73,73,11,44,55,213.0,1357.0,604,135,292,427,1426.0,82,5.34,48,255,2438,9.0
11226,Jakub Voracek,2019-20,30.0,12,61,82,82,20,41,61,253.0,1565.0,686,155,333,488,1679.0,82,5.45,47,245,2478,9.0
11227,Jakub Voracek,2020-21,31.0,13,85,82,82,20,65,85,228.0,1595.0,768,175,398,573,1907.0,82,5.86,50,250,2620,9.2
11228,Jakub Voracek,2021-22,32.0,14,66,78,78,20,46,66,210.0,1456.0,846,195,444,639,2117.0,82,5.96,47,239,2579,9.5
11229,Jakub Voracek,2022-23,33.0,15,56,69,69,12,44,56,132.0,1176.0,915,207,488,695,2249.0,70,5.96,42,208,2192,9.5
11230,Jakub Vrana,2019-20,23.0,4,6,21,21,3,3,6,32.0,233.0,21,3,3,6,32.0,82,5.45,47,245,2478,9.0
11231,Jakub Vrana,2020-21,24.0,5,27,73,73,13,14,27,133.0,912.0,94,16,17,33,165.0,82,5.86,50,250,2620,9.2
11232,Jakub Vrana,2021-22,25.0,6,47,82,82,24,23,47,161.0,1151.0,176,40,40,80,326.0,82,5.96,47,239,2579,9.5
11233,Jakub Vrana,2022-23,26.0,7,52,69,69,25,27,52,187.0,1027.0,245,65,67,132,513.0,70,5.96,42,208,2192,9.5
11234,Jakub Zboril,2021-22,24.0,4,0,2,2,0,0,0,1.0,22.0,2,0,0,0,1.0,82,5.96,47,239,2579,9.5
11235,Jamal Mayers,1999-00,25.0,4,1,6,6,0,1,1,7.0,,6,0,1,1,7.0,82,5.83,55,336,2444,9.8
11236,Jamal Mayers,2001-02,27.0,5,9,34,34,4,5,9,48.0,277.0,40,4,6,10,55.0,82,5.27,57,359,2285,9.4
11237,Jamal Mayers,2002-03,28.0,6,17,79,79,7,10,17,99.0,771.0,119,11,16,27,154.0,82,5.49,53,331,2294,9.8
11238,Jamal Mayers,2003-04,29.0,7,21,77,77,8,13,21,132.0,852.0,196,19,29,48,286.0,82,5.51,63,376,2272,9.9
11239,Jamal Mayers,2004-05,30.0,8,17,77,77,9,8,17,105.0,893.0,273,28,37,65,391.0,82,5.24,53,338,2262,9.5
11240,Jamal Mayers,2005-06,31.0,9,7,15,15,2,5,7,26.0,215.0,288,30,42,72,417.0,82,5.31,60,363,2326,9.4
11241,Jamal Mayers,2006-07,32.0,10,11,80,80,6,5,11,130.0,1041.0,368,36,47,83,547.0,82,5.14,57,348,2300,9.2
11242,Jamal Mayers,2008-09,34.0,11,26,67,67,15,11,26,111.0,1013.0,435,51,58,109,658.0,82,6.05,85,480,2458,10.1
11243,Jamal Mayers,2009-10,35.0,12,22,80,80,8,14,22,129.0,1170.0,515,59,72,131,787.0,82,5.76,70,398,2426,9.7
11244,Jamal Mayers,2010-11,36.0,13,27,80,80,12,15,27,153.0,1275.0,595,71,87,158,940.0,82,5.44,62,351,2383,9.4
11245,Jamal Mayers,2011-12,37.0,14,16,71,71,7,9,16,72.0,749.0,666,78,96,174,1012.0,82,5.7,65,341,2477,9.4
11246,Jamal Mayers,2012-13,38.0,15,14,71,71,3,11,14,75.0,640.0,737,81,107,188,1087.0,82,5.53,56,304,2486,9.1
11247,Jamal Mayers,2013-14,39.0,16,14,78,78,3,11,14,62.0,693.0,815,84,118,202,1149.0,82,5.46,52,291,2492,9.0
11248,Jamal Mayers,2014-15,40.0,17,15,81,81,6,9,15,70.0,794.0,896,90,127,217,1219.0,82,5.32,47,271,2439,8.9
11249,Jamal Mayers,2015-16,41.0,18,2,19,19,0,2,2,10.0,132.0,915,90,129,219,1229.0,48,5.31,29,160,1399,9.1
11250,Jame Pollock,2006-07,27.0,4,0,9,9,0,0,0,19.0,139.0,9,0,0,0,19.0,82,5.14,57,348,2300,9.2
11251,James Black,1992-93,23.0,4,0,1,1,0,0,0,0.0,,1,0,0,0,0.0,80,7.37,76,367,2421,12.2
11252,James Black,1993-94,24.0,5,0,1,1,0,0,0,0.0,,2,0,0,0,0.0,80,6.91,71,366,2385,11.6
11253,James Black,1994-95,25.0,6,10,30,30,4,6,10,54.0,,32,4,6,10,54.0,80,6.96,77,402,2440,11.4
11254,James Black,1995-96,26.0,7,3,10,10,2,1,3,10.0,,42,6,7,13,64.0,84,7.25,87,443,2603,11.7
11255,James Black,1996-97,27.0,8,5,15,15,2,3,5,18.0,,57,8,10,18,82.0,84,6.48,76,407,2545,10.7
11256,James Black,1998-99,29.0,9,6,13,13,3,3,6,23.0,,70,11,13,24,105.0,82,6.29,74,413,2481,10.4
11257,James Black,1999-00,30.0,10,23,64,64,12,11,23,122.0,,134,23,24,47,227.0,82,5.83,55,336,2444,9.8
11258,James Black,2000-01,31.0,11,15,52,52,10,5,15,90.0,,186,33,29,62,317.0,82,5.28,57,380,2242,9.6
11259,James Black,2001-02,32.0,12,30,75,75,16,14,30,135.0,1130.0,261,49,43,92,452.0,82,5.27,57,359,2285,9.4
11260,James Black,2002-03,33.0,13,17,49,49,8,9,17,71.0,591.0,310,57,52,109,523.0,82,5.49,53,331,2294,9.8
11261,James Black,2003-04,34.0,14,6,42,42,1,5,6,34.0,381.0,352,58,57,115,557.0,82,5.51,63,376,2272,9.9
11262,James Camazzola,1986-87,23.0,4,0,1,1,0,0,0,1.0,,1,0,0,0,1.0,80,7.89,74,336,2448,12.9
11263,James Camazzola,1989-90,26.0,5,0,2,2,0,0,0,2.0,,3,0,0,0,3.0,80,7.34,72,344,2400,12.2
11264,James Latos,1991-92,26.0,4,0,1,1,0,0,0,0.0,,1,0,0,0,0.0,80,7.48,85,403,2430,12.3
11265,James Neal,2011-12,24.0,4,37,77,77,24,13,37,171.0,1222.0,77,24,13,37,171.0,82,5.7,65,341,2477,9.4
11266,James Neal,2012-13,25.0,5,55,78,78,27,28,55,200.0,1419.0,155,51,41,92,371.0,82,5.53,56,304,2486,9.1
11267,James Neal,2013-14,26.0,6,45,79,79,22,23,45,212.0,1382.0,234,73,64,137,583.0,82,5.46,52,291,2492,9.0
11268,James Neal,2014-15,27.0,7,81,80,80,40,41,81,329.0,1531.0,314,113,105,218,912.0,82,5.32,47,271,2439,8.9
11269,James Neal,2015-16,28.0,8,36,40,40,21,15,36,136.0,699.0,354,134,120,254,1048.0,48,5.31,29,160,1399,9.1
11270,James Neal,2016-17,29.0,9,61,59,59,27,34,61,238.0,1089.0,413,161,154,315,1286.0,82,5.34,48,269,2463,8.9
11271,James Neal,2017-18,30.0,10,37,67,67,23,14,37,221.0,1212.0,480,184,168,352,1507.0,82,5.32,47,251,2453,8.9
11272,James Neal,2018-19,31.0,11,58,82,82,31,27,58,268.0,1564.0,562,215,195,410,1775.0,82,5.34,48,255,2438,9.0
11273,James Neal,2019-20,32.0,12,41,70,70,23,18,41,202.0,1239.0,632,238,213,451,1977.0,82,5.45,47,245,2478,9.0
11274,James Neal,2020-21,33.0,13,44,71,71,25,19,44,202.0,1219.0,703,263,232,495,2179.0,82,5.86,50,250,2620,9.2
11275,James Neal,2021-22,34.0,14,19,63,63,7,12,19,141.0,942.0,766,270,244,514,2320.0,82,5.96,47,239,2579,9.5
11276,James Neal,2022-23,35.0,15,31,55,55,19,12,31,112.0,897.0,821,289,256,545,2432.0,70,5.96,42,208,2192,9.5
11277,James Patrick,1986-87,23.0,4,8,12,12,1,7,8,15.0,,12,1,7,8,15.0,80,7.89,74,336,2448,12.9
11278,James Patrick,1987-88,24.0,5,36,75,75,8,28,36,102.0,,87,9,35,44,117.0,80,7.77,71,321,2447,12.7
11279,James Patrick,1988-89,25.0,6,43,75,75,14,29,43,131.0,,162,23,64,87,248.0,80,7.94,82,370,2484,12.8
11280,James Patrick,1989-90,26.0,7,55,78,78,10,45,55,145.0,,240,33,109,142,393.0,80,7.34,72,344,2400,12.2
11281,James Patrick,1990-91,27.0,8,62,70,70,17,45,62,187.0,,310,50,154,204,580.0,80,7.43,89,437,2435,12.2
11282,James Patrick,1991-92,28.0,9,47,68,68,11,36,47,147.0,,378,61,190,251,727.0,80,7.48,85,403,2430,12.3
11283,James Patrick,1992-93,29.0,10,57,73,73,14,43,57,136.0,,451,75,233,308,863.0,80,7.37,76,367,2421,12.2
11284,James Patrick,1993-94,30.0,11,59,74,74,10,49,59,138.0,,525,85,282,367,1001.0,80,6.91,71,366,2385,11.6
11285,James Patrick,1994-95,31.0,12,71,80,80,14,57,71,148.0,,605,99,339,438,1149.0,80,6.96,77,402,2440,11.4
11286,James Patrick,1995-96,32.0,13,26,60,60,5,21,26,99.0,,665,104,360,464,1248.0,84,7.25,87,443,2603,11.7
11287,James Patrick,1996-97,33.0,14,35,68,68,10,25,35,91.0,,733,114,385,499,1339.0,84,6.48,76,407,2545,10.7
11288,James Patrick,1997-98,34.0,15,10,43,43,0,10,10,43.0,,776,114,395,509,1382.0,48,5.97,37,209,1408,10.2
11289,James Patrick,1998-99,35.0,16,35,80,80,3,32,35,116.0,,856,117,427,544,1498.0,82,6.29,74,413,2481,10.4
11290,James Patrick,1999-00,36.0,17,4,19,19,3,1,4,22.0,,875,120,428,548,1520.0,82,5.83,55,336,2444,9.8
11291,James Patrick,2000-01,37.0,18,17,60,60,6,11,17,57.0,,935,126,439,565,1577.0,82,5.28,57,380,2242,9.6
11292,James Patrick,2001-02,38.0,19,8,45,45,1,7,8,31.0,664.0,980,127,446,573,1608.0,82,5.27,57,359,2285,9.4
11293,James Patrick,2002-03,39.0,20,13,66,66,5,8,13,40.0,1055.0,1046,132,454,586,1648.0,82,5.49,53,331,2294,9.8
11294,James Patrick,2003-04,40.0,21,13,54,54,4,9,13,48.0,932.0,1100,136,463,599,1696.0,82,5.51,63,376,2272,9.9
11295,James Patrick,2004-05,41.0,22,13,56,56,5,8,13,45.0,921.0,1156,141,471,612,1741.0,82,5.24,53,338,2262,9.5
11296,James Patrick,2005-06,42.0,23,16,69,69,4,12,16,63.0,1305.0,1225,145,483,628,1804.0,82,5.31,60,363,2326,9.4
11297,James Patrick,2006-07,43.0,24,11,55,55,4,7,11,44.0,1044.0,1280,149,490,639,1848.0,82,5.14,57,348,2300,9.2
11298,James Sheppard,2010-11,22.0,4,19,78,78,4,15,19,57.0,828.0,78,4,15,19,57.0,82,5.44,62,351,2383,9.4
11299,James Sheppard,2011-12,23.0,5,24,82,82,5,19,24,88.0,1245.0,160,9,34,43,145.0,82,5.7,65,341,2477,9.4
11300,James Sheppard,2012-13,24.0,6,6,64,64,2,4,6,64.0,767.0,224,11,38,49,209.0,82,5.53,56,304,2486,9.1
11301,James Sheppard,2015-16,27.0,7,4,32,32,1,3,4,40.0,376.0,256,12,41,53,249.0,48,5.31,29,160,1399,9.1
11302,James Sheppard,2016-17,28.0,8,20,67,67,4,16,20,84.0,815.0,323,16,57,73,333.0,82,5.34,48,269,2463,8.9
11303,James Sheppard,2017-18,29.0,9,18,71,71,7,11,18,79.0,941.0,394,23,68,91,412.0,82,5.32,47,251,2453,8.9
11304,James Wisniewski,2008-09,24.0,4,7,19,19,2,5,7,25.0,302.0,19,2,5,7,25.0,82,6.05,85,480,2458,10.1
11305,James Wisniewski,2009-10,25.0,5,10,50,50,2,8,10,55.0,950.0,69,4,13,17,80.0,82,5.76,70,398,2426,9.7
11306,James Wisniewski,2010-11,26.0,6,26,68,68,7,19,26,82.0,1156.0,137,11,32,43,162.0,82,5.44,62,351,2383,9.4
11307,James Wisniewski,2011-12,27.0,7,24,48,48,3,21,24,89.0,953.0,185,14,53,67,251.0,82,5.7,65,341,2477,9.4
11308,James Wisniewski,2012-13,28.0,8,30,69,69,3,27,30,146.0,1680.0,254,17,80,97,397.0,82,5.53,56,304,2486,9.1
11309,James Wisniewski,2013-14,29.0,9,51,75,75,10,41,51,158.0,1721.0,329,27,121,148,555.0,82,5.46,52,291,2492,9.0
11310,James Wisniewski,2014-15,30.0,10,27,48,48,6,21,27,99.0,1190.0,377,33,142,175,654.0,82,5.32,47,271,2439,8.9
11311,James Wisniewski,2015-16,31.0,11,14,30,30,5,9,14,62.0,685.0,407,38,151,189,716.0,48,5.31,29,160,1399,9.1
11312,James Wisniewski,2016-17,32.0,12,51,75,75,7,44,51,166.0,1697.0,482,45,195,240,882.0,82,5.34,48,269,2463,8.9
11313,James Wisniewski,2017-18,33.0,13,34,69,69,8,26,34,147.0,1462.0,551,53,221,274,1029.0,82,5.32,47,251,2453,8.9
11314,James Wisniewski,2018-19,34.0,14,0,1,1,0,0,0,0.0,1.0,552,53,221,274,1029.0,82,5.34,48,255,2438,9.0
11315,James Wright,2012-13,22.0,4,5,48,48,2,3,5,25.0,559.0,48,2,3,5,25.0,82,5.53,56,304,2486,9.1
11316,James Wright,2013-14,23.0,5,0,1,1,0,0,0,0.0,5.0,49,2,3,5,25.0,82,5.46,52,291,2492,9.0
11317,James Wright,2015-16,25.0,6,5,38,38,2,3,5,32.0,441.0,87,4,6,10,57.0,48,5.31,29,160,1399,9.1
11318,James Wright,2016-17,26.0,7,2,59,59,0,2,2,41.0,565.0,146,4,8,12,98.0,82,5.34,48,269,2463,8.9
11319,James van Riemsdyk,2012-13,23.0,4,35,78,78,15,20,35,173.0,1011.0,78,15,20,35,173.0,82,5.53,56,304,2486,9.1
11320,James van Riemsdyk,2013-14,24.0,5,40,75,75,21,19,40,173.0,1090.0,153,36,39,75,346.0,82,5.46,52,291,2492,9.0
11321,James van Riemsdyk,2014-15,25.0,6,24,43,43,11,13,24,121.0,652.0,196,47,52,99,467.0,82,5.32,47,271,2439,8.9
11322,James van Riemsdyk,2015-16,26.0,7,32,48,48,18,14,32,140.0,922.0,244,65,66,131,607.0,48,5.31,29,160,1399,9.1
11323,James van Riemsdyk,2016-17,27.0,8,61,80,80,30,31,61,279.0,1685.0,324,95,97,192,886.0,82,5.34,48,269,2463,8.9
11324,James van Riemsdyk,2017-18,28.0,9,56,82,82,27,29,56,248.0,1565.0,406,122,126,248,1134.0,82,5.32,47,251,2453,8.9
11325,James van Riemsdyk,2018-19,29.0,10,29,40,40,14,15,29,129.0,711.0,446,136,141,277,1263.0,82,5.34,48,255,2438,9.0
11326,James van Riemsdyk,2019-20,30.0,11,62,82,82,29,33,62,238.0,1303.0,528,165,174,339,1501.0,82,5.45,47,245,2478,9.0
11327,James van Riemsdyk,2020-21,31.0,12,54,81,81,36,18,54,248.0,1206.0,609,201,192,393,1749.0,82,5.86,50,250,2620,9.2
11328,James van Riemsdyk,2021-22,32.0,13,48,66,66,27,21,48,167.0,1096.0,675,228,213,441,1916.0,82,5.96,47,239,2579,9.5
11329,James van Riemsdyk,2022-23,33.0,14,40,66,66,19,21,40,151.0,983.0,741,247,234,481,2067.0,70,5.96,42,208,2192,9.5
11330,Jamie Allison,1997-98,22.0,4,0,1,1,0,0,0,0.0,,1,0,0,0,0.0,48,5.97,37,209,1408,10.2
11331,Jamie Allison,1999-00,24.0,5,0,20,20,0,0,0,8.0,,21,0,0,0,8.0,82,5.83,55,336,2444,9.8
11332,Jamie Allison,2000-01,25.0,6,11,43,43,3,8,11,27.0,,64,3,8,11,35.0,82,5.28,57,380,2242,9.6
11333,Jamie Allison,2001-02,26.0,7,4,39,39,2,2,4,24.0,547.0,103,5,10,15,59.0,82,5.27,57,359,2285,9.4
11334,Jamie Allison,2002-03,27.0,8,4,59,59,1,3,4,24.0,840.0,162,6,13,19,83.0,82,5.49,53,331,2294,9.8
11335,Jamie Allison,2003-04,28.0,9,4,44,44,1,3,4,16.0,640.0,206,7,16,23,99.0,82,5.51,63,376,2272,9.9
11336,Jamie Allison,2004-05,29.0,10,2,44,44,0,2,2,16.0,366.0,250,7,18,25,115.0,82,5.24,53,338,2262,9.5
11337,Jamie Allison,2005-06,30.0,11,1,48,48,0,1,1,23.0,574.0,298,7,19,26,138.0,82,5.31,60,363,2326,9.4
11338,Jamie Allison,2006-07,31.0,12,3,47,47,0,3,3,19.0,615.0,345,7,22,29,157.0,82,5.14,57,348,2300,9.2
11339,Jamie Allison,2008-09,33.0,13,1,27,27,0,1,1,7.0,243.0,372,7,23,30,164.0,82,6.05,85,480,2458,10.1
11340,Jamie Arniel,2013-14,24.0,4,0,1,1,0,0,0,3.0,12.0,1,0,0,0,3.0,82,5.46,52,291,2492,9.0
11341,Jamie Baker,1992-93,26.0,4,0,1,1,0,0,0,0.0,,1,0,0,0,0.0,80,7.37,76,367,2421,12.2
11342,Jamie Baker,1993-94,27.0,5,2,18,18,2,0,2,18.0,,19,2,0,2,18.0,80,6.91,71,366,2385,11.6
11343,Jamie Baker,1994-95,28.0,6,17,52,52,7,10,17,77.0,,71,9,10,19,95.0,80,6.96,77,402,2440,11.4
11344,Jamie Baker,1995-96,29.0,7,48,76,76,19,29,48,160.0,,147,28,39,67,255.0,84,7.25,87,443,2603,11.7
11345,Jamie Baker,1996-97,30.0,8,17,65,65,12,5,17,68.0,,212,40,44,84,323.0,84,6.48,76,407,2545,10.7
11346,Jamie Baker,1997-98,31.0,9,11,43,43,7,4,11,60.0,,255,47,48,95,383.0,48,5.97,37,209,1408,10.2
11347,Jamie Baker,1998-99,32.0,10,33,77,77,16,17,33,117.0,,332,63,65,128,500.0,82,6.29,74,413,2481,10.4
11348,Jamie Baker,1999-00,33.0,11,16,58,58,8,8,16,69.0,,390,71,73,144,569.0,82,5.83,55,336,2444,9.8
11349,Jamie Baker,2000-01,34.0,12,5,13,13,0,5,5,16.0,,403,71,78,149,585.0,82,5.28,57,380,2242,9.6
11350,Jamie Baker,2001-02,35.0,13,1,1,1,0,1,1,1.0,,404,71,79,150,586.0,82,5.27,57,359,2285,9.4
11351,Jamie Benn,2012-13,23.0,4,41,82,82,22,19,41,182.0,1206.0,82,22,19,41,182.0,82,5.53,56,304,2486,9.1
11352,Jamie Benn,2013-14,24.0,5,56,69,69,22,34,56,177.0,1243.0,151,44,53,97,359.0,82,5.46,52,291,2492,9.0
11353,Jamie Benn,2014-15,25.0,6,63,71,71,26,37,63,203.0,1283.0,222,70,90,160,562.0,82,5.32,47,271,2439,8.9
11354,Jamie Benn,2015-16,26.0,7,33,41,41,12,21,33,110.0,816.0,263,82,111,193,672.0,48,5.31,29,160,1399,9.1
11355,Jamie Benn,2016-17,27.0,8,79,81,81,34,45,79,279.0,1551.0,344,116,156,272,951.0,82,5.34,48,269,2463,8.9
11356,Jamie Benn,2017-18,28.0,9,87,82,82,35,52,87,253.0,1636.0,426,151,208,359,1204.0,82,5.32,47,251,2453,8.9
11357,Jamie Benn,2018-19,29.0,10,89,82,82,41,48,89,247.0,1642.0,508,192,256,448,1451.0,82,5.34,48,255,2438,9.0
11358,Jamie Benn,2019-20,30.0,11,69,77,77,26,43,69,201.0,1492.0,585,218,299,517,1652.0,82,5.45,47,245,2478,9.0
11359,Jamie Benn,2020-21,31.0,12,79,82,82,36,43,79,241.0,1625.0,667,254,342,596,1893.0,82,5.86,50,250,2620,9.2
11360,Jamie Benn,2021-22,32.0,13,53,78,78,27,26,53,189.0,1422.0,745,281,368,649,2082.0,82,5.96,47,239,2579,9.5
11361,Jamie Benn,2022-23,33.0,14,39,69,69,19,20,39,163.0,1134.0,814,300,388,688,2245.0,70,5.96,42,208,2192,9.5
11362,Jamie Devane,2016-17,25.0,4,0,2,2,0,0,0,1.0,12.0,2,0,0,0,1.0,82,5.34,48,269,2463,8.9
11363,Jamie Doornbosch,2013-14,23.0,4,0,1,1,0,0,0,1.0,5.0,1,0,0,0,1.0,82,5.46,52,291,2492,9.0
11364,Jamie Fraser,2011-12,26.0,4,0,1,1,0,0,0,0.0,11.0,1,0,0,0,0.0,82,5.7,65,341,2477,9.4
11365,Jamie Fritsch,2011-12,26.0,4,0,1,1,0,0,0,0.0,5.0,1,0,0,0,0.0,82,5.7,65,341,2477,9.4
11366,Jamie Heward,1998-99,27.0,4,0,5,5,0,0,0,8.0,,5,0,0,0,8.0,82,6.29,74,413,2481,10.4
11367,Jamie Heward,1999-00,28.0,5,5,20,20,1,4,5,23.0,,25,1,4,5,31.0,82,5.83,55,336,2444,9.8
11368,Jamie Heward,2001-02,30.0,6,18,63,63,6,12,18,124.0,1021.0,88,7,16,23,155.0,82,5.27,57,359,2285,9.4
11369,Jamie Heward,2002-03,31.0,7,17,54,54,6,11,17,92.0,1078.0,142,13,27,40,247.0,82,5.49,53,331,2294,9.8
11370,Jamie Heward,2003-04,32.0,8,27,69,69,11,16,27,108.0,991.0,211,24,43,67,355.0,82,5.51,63,376,2272,9.9
11371,Jamie Heward,2004-05,33.0,9,3,28,28,1,2,3,38.0,394.0,239,25,45,70,393.0,82,5.24,53,338,2262,9.5
11372,Jamie Heward,2008-09,37.0,10,28,71,71,7,21,28,140.0,1552.0,310,32,66,98,533.0,82,6.05,85,480,2458,10.1
11373,Jamie Heward,2009-10,38.0,11,24,71,71,6,18,24,75.0,1226.0,381,38,84,122,608.0,82,5.76,70,398,2426,9.7
11374,Jamie Heward,2011-12,40.0,12,2,13,13,0,2,2,11.0,154.0,394,38,86,124,619.0,82,5.7,65,341,2477,9.4
11375,Jamie Hislop,1982-83,29.0,4,39,80,80,19,20,39,124.0,,80,19,20,39,124.0,80,7.03,61,280,2352,12.0
11376,Jamie Hislop,1983-84,30.0,5,56,79,79,25,31,56,117.0,,159,44,51,95,241.0,80,7.69,77,340,2441,12.6
11377,Jamie Hislop,1984-85,31.0,6,41,80,80,16,25,41,113.0,,239,60,76,136,354.0,80,8.03,73,320,2489,12.9
11378,Jamie Hislop,1985-86,32.0,7,33,79,79,14,19,33,80.0,,318,74,95,169,434.0,80,7.73,71,310,2444,12.7
11379,Jamie Hislop,1986-87,33.0,8,9,27,27,1,8,9,18.0,,345,75,103,178,452.0,80,7.89,74,336,2448,12.9
11380,Jamie Hunt,2009-10,25.0,4,0,1,1,0,0,0,0.0,6.0,1,0,0,0,0.0,82,5.76,70,398,2426,9.7
11381,Jamie Huscroft,1991-92,25.0,4,2,15,15,0,2,2,9.0,,15,0,2,2,9.0,80,7.48,85,403,2430,12.3
11382,Jamie Huscroft,1992-93,26.0,5,5,42,42,2,3,5,19.0,,57,2,5,7,28.0,80,7.37,76,367,2421,12.2
11383,Jamie Huscroft,1993-94,27.0,6,1,8,8,0,1,1,3.0,,65,2,6,8,31.0,80,6.91,71,366,2385,11.6
11384,Jamie Huscroft,1996-97,30.0,7,1,36,36,0,1,1,13.0,,101,2,7,9,44.0,84,6.48,76,407,2545,10.7
11385,Jamie Huscroft,1997-98,31.0,8,6,34,34,0,6,6,30.0,,135,2,13,15,74.0,48,5.97,37,209,1408,10.2
11386,Jamie Huscroft,1998-99,32.0,9,12,70,70,3,9,12,57.0,,205,5,22,27,131.0,82,6.29,74,413,2481,10.4
11387,Jamie Huscroft,1999-00,33.0,10,5,52,52,0,5,5,40.0,,257,5,27,32,171.0,82,5.83,55,336,2444,9.8
11388,Jamie Huscroft,2000-01,34.0,11,4,51,51,0,4,4,26.0,,308,5,31,36,197.0,82,5.28,57,380,2242,9.6
11389,Jamie Huscroft,2001-02,35.0,12,2,37,37,0,2,2,27.0,353.0,345,5,33,38,224.0,82,5.27,57,359,2285,9.4
11390,Jamie Huscroft,2002-03,36.0,13,0,7,7,0,0,0,4.0,74.0,352,5,33,38,228.0,82,5.49,53,331,2294,9.8
11391,Jamie Langenbrunner,1997-98,22.0,4,0,2,2,0,0,0,1.0,,2,0,0,0,1.0,48,5.97,37,209,1408,10.2
11392,Jamie Langenbrunner,1998-99,23.0,5,4,12,12,2,2,4,15.0,,14,2,2,4,16.0,82,6.29,74,413,2481,10.4
11393,Jamie Langenbrunner,1999-00,24.0,6,39,76,76,13,26,39,112.0,,90,15,28,43,128.0,82,5.83,55,336,2444,9.8
11394,Jamie Langenbrunner,2000-01,25.0,7,52,81,81,23,29,52,159.0,,171,38,57,95,287.0,82,5.28,57,380,2242,9.6
11395,Jamie Langenbrunner,2001-02,26.0,8,45,75,75,12,33,45,145.0,1189.0,246,50,90,140,432.0,82,5.27,57,359,2285,9.4
11396,Jamie Langenbrunner,2002-03,27.0,9,39,65,65,18,21,39,153.0,1141.0,311,68,111,179,585.0,82,5.49,53,331,2294,9.8
11397,Jamie Langenbrunner,2003-04,28.0,10,30,53,53,12,18,30,104.0,874.0,364,80,129,209,689.0,82,5.51,63,376,2272,9.9
11398,Jamie Langenbrunner,2004-05,29.0,11,32,82,82,13,19,32,163.0,1288.0,446,93,148,241,852.0,82,5.24,53,338,2262,9.5
11399,Jamie Langenbrunner,2005-06,30.0,12,55,78,78,22,33,55,197.0,1388.0,524,115,181,296,1049.0,82,5.31,60,363,2326,9.4
11400,Jamie Langenbrunner,2006-07,31.0,13,26,53,53,10,16,26,130.0,849.0,577,125,197,322,1179.0,82,5.14,57,348,2300,9.2
11401,Jamie Langenbrunner,2008-09,33.0,14,53,80,80,19,34,53,243.0,1488.0,657,144,231,375,1422.0,82,6.05,85,480,2458,10.1
11402,Jamie Langenbrunner,2009-10,34.0,15,60,82,82,23,37,60,243.0,1522.0,739,167,268,435,1665.0,82,5.76,70,398,2426,9.7
11403,Jamie Langenbrunner,2010-11,35.0,16,41,64,64,13,28,41,152.0,1171.0,803,180,296,476,1817.0,82,5.44,62,351,2383,9.4
11404,Jamie Langenbrunner,2011-12,36.0,17,69,81,81,29,40,69,229.0,1466.0,884,209,336,545,2046.0,82,5.7,65,341,2477,9.4
11405,Jamie Langenbrunner,2012-13,37.0,18,61,81,81,19,42,61,228.0,1584.0,965,228,378,606,2274.0,82,5.53,56,304,2486,9.1
11406,Jamie Langenbrunner,2013-14,38.0,19,32,70,70,9,23,32,153.0,1221.0,1035,237,401,638,2427.0,82,5.46,52,291,2492,9.0
11407,Jamie Langenbrunner,2014-15,39.0,20,24,70,70,6,18,24,127.0,1023.0,1105,243,419,662,2554.0,82,5.32,47,271,2439,8.9
11408,Jamie Langenbrunner,2015-16,40.0,21,1,4,4,0,1,1,5.0,39.0,1109,243,420,663,2559.0,48,5.31,29,160,1399,9.1
11409,Jamie Leach,1992-93,23.0,4,3,10,10,0,3,3,10.0,,10,0,3,3,10.0,80,7.37,76,367,2421,12.2
11410,Jamie Leach,1993-94,24.0,5,2,7,7,2,0,2,8.0,,17,2,3,5,18.0,80,6.91,71,366,2385,11.6
11411,Jamie Leach,1994-95,25.0,6,9,38,38,5,4,9,32.0,,55,7,7,14,50.0,80,6.96,77,402,2440,11.4
11412,Jamie Leach,1995-96,26.0,7,5,24,24,3,2,5,19.0,,79,10,9,19,69.0,84,7.25,87,443,2603,11.7
11413,Jamie Leach,1996-97,27.0,8,1,2,2,1,0,1,2.0,,81,11,9,20,71.0,84,6.48,76,407,2545,10.7
11414,Jamie Linden,1997-98,25.0,4,0,4,4,0,0,0,0.0,,4,0,0,0,0.0,48,5.97,37,209,1408,10.2
11415,Jamie Lundmark,2005-06,25.0,4,19,55,55,8,11,19,78.0,663.0,55,8,11,19,78.0,82,5.31,60,363,2326,9.4
11416,Jamie Lundmark,2006-07,26.0,5,10,56,56,2,8,10,68.0,715.0,111,10,19,29,146.0,82,5.14,57,348,2300,9.2
11417,Jamie Lundmark,2008-09,28.0,6,29,53,53,10,19,29,78.0,659.0,164,20,38,58,224.0,82,6.05,85,480,2458,10.1
11418,Jamie Lundmark,2009-10,29.0,7,13,68,68,7,6,13,81.0,801.0,232,27,44,71,305.0,82,5.76,70,398,2426,9.7
11419,Jamie Lundmark,2011-12,31.0,8,16,27,27,8,8,16,50.0,378.0,259,35,52,87,355.0,82,5.7,65,341,2477,9.4
11420,Jamie Lundmark,2012-13,32.0,9,12,36,36,5,7,12,52.0,496.0,295,40,59,99,407.0,82,5.53,56,304,2486,9.1
11421,Jamie Macoun,1985-86,24.0,4,5,22,22,1,4,5,18.0,,22,1,4,5,18.0,80,7.73,71,310,2444,12.7
11422,Jamie Macoun,1986-87,25.0,5,32,72,72,9,23,32,165.0,,94,10,27,37,183.0,80,7.89,74,336,2448,12.9
11423,Jamie Macoun,1987-88,26.0,6,39,70,70,9,30,39,129.0,,164,19,57,76,312.0,80,7.77,71,321,2447,12.7
11424,Jamie Macoun,1988-89,27.0,7,32,77,77,11,21,32,133.0,,241,30,78,108,445.0,80,7.94,82,370,2484,12.8
11425,Jamie Macoun,1989-90,28.0,8,40,79,79,7,33,40,137.0,,320,37,111,148,582.0,80,7.34,72,344,2400,12.2
11426,Jamie Macoun,1991-92,30.0,9,27,72,72,8,19,27,89.0,,392,45,130,175,671.0,80,7.48,85,403,2430,12.3
11427,Jamie Macoun,1992-93,31.0,10,35,78,78,8,27,35,120.0,,470,53,157,210,791.0,80,7.37,76,367,2421,12.2
11428,Jamie Macoun,1993-94,32.0,11,22,79,79,7,15,22,117.0,,549,60,172,232,908.0,80,6.91,71,366,2385,11.6
11429,Jamie Macoun,1994-95,33.0,12,30,76,76,5,25,30,129.0,,625,65,197,262,1037.0,80,6.96,77,402,2440,11.4
11430,Jamie Macoun,1995-96,34.0,13,19,77,77,4,15,19,114.0,,702,69,212,281,1151.0,84,7.25,87,443,2603,11.7
11431,Jamie Macoun,1996-97,35.0,14,30,82,82,3,27,30,122.0,,784,72,239,311,1273.0,84,6.48,76,407,2545,10.7
11432,Jamie Macoun,1997-98,36.0,15,10,46,46,2,8,10,84.0,,830,74,247,321,1357.0,48,5.97,37,209,1408,10.2
11433,Jamie Macoun,1998-99,37.0,16,8,82,82,0,8,8,74.0,,912,74,255,329,1431.0,82,6.29,74,413,2481,10.4
11434,Jamie Macoun,1999-00,38.0,17,11,73,73,1,10,11,64.0,,985,75,265,340,1495.0,82,5.83,55,336,2444,9.8
11435,Jamie Macoun,2000-01,39.0,18,7,74,74,0,7,7,78.0,,1059,75,272,347,1573.0,82,5.28,57,380,2242,9.6
11436,Jamie Macoun,2001-02,40.0,19,11,69,69,1,10,11,62.0,1208.0,1128,76,282,358,1635.0,82,5.27,57,359,2285,9.4
11437,Jamie McBain,2012-13,24.0,4,10,14,14,3,7,10,29.0,361.0,14,3,7,10,29.0,82,5.53,56,304,2486,9.1
11438,Jamie McBain,2013-14,25.0,5,30,76,76,7,23,30,95.0,1452.0,90,10,30,40,124.0,82,5.46,52,291,2492,9.0
11439,Jamie McBain,2014-15,26.0,6,27,76,76,8,19,27,127.0,1505.0,166,18,49,67,251.0,82,5.32,47,271,2439,8.9
11440,Jamie McBain,2015-16,27.0,7,8,40,40,1,7,8,46.0,737.0,206,19,56,75,297.0,48,5.31,29,160,1399,9.1
11441,Jamie McBain,2016-17,28.0,8,17,69,69,6,11,17,98.0,1391.0,275,25,67,92,395.0,82,5.34,48,269,2463,8.9
11442,Jamie McBain,2017-18,29.0,9,9,26,26,3,6,9,18.0,330.0,301,28,73,101,413.0,82,5.32,47,251,2453,8.9
11443,Jamie McBain,2018-19,30.0,10,9,44,44,2,7,9,32.0,538.0,345,30,80,110,445.0,82,5.34,48,255,2438,9.0
11444,Jamie McBain,2019-20,31.0,11,0,3,3,0,0,0,3.0,50.0,348,30,80,110,448.0,82,5.45,47,245,2478,9.0
11445,Jamie McGinn,2011-12,23.0,4,6,35,35,4,2,6,27.0,312.0,35,4,2,6,27.0,82,5.7,65,341,2477,9.4
11446,Jamie McGinn,2012-13,24.0,5,13,59,59,10,3,13,76.0,590.0,94,14,5,19,103.0,82,5.53,56,304,2486,9.1
11447,Jamie McGinn,2013-14,25.0,6,6,49,49,1,5,6,63.0,568.0,143,15,10,25,166.0,82,5.46,52,291,2492,9.0
11448,Jamie McGinn,2014-15,26.0,7,37,78,78,20,17,37,159.0,1049.0,221,35,27,62,325.0,82,5.32,47,271,2439,8.9
11449,Jamie McGinn,2015-16,27.0,8,22,47,47,11,11,22,128.0,812.0,268,46,38,84,453.0,48,5.31,29,160,1399,9.1
11450,Jamie McGinn,2016-17,28.0,9,38,79,79,19,19,38,167.0,1247.0,347,65,57,122,620.0,82,5.34,48,269,2463,8.9
11451,Jamie McGinn,2017-18,29.0,10,6,19,19,4,2,6,36.0,281.0,366,69,59,128,656.0,82,5.32,47,251,2453,8.9
11452,Jamie McGinn,2018-19,30.0,11,39,84,84,22,17,39,156.0,1201.0,450,91,76,167,812.0,82,5.34,48,255,2438,9.0
11453,Jamie McGinn,2019-20,31.0,12,17,72,72,9,8,17,116.0,948.0,522,100,84,184,928.0,82,5.45,47,245,2478,9.0
11454,Jamie McGinn,2020-21,32.0,13,29,76,76,13,16,29,116.0,1023.0,598,113,100,213,1044.0,82,5.86,50,250,2620,9.2
11455,Jamie McGinn,2021-22,33.0,14,7,19,19,4,3,7,23.0,203.0,617,117,103,220,1067.0,82,5.96,47,239,2579,9.5
11456,Jamie Oleksiak,2015-16,23.0,4,2,16,16,0,2,2,11.0,237.0,16,0,2,2,11.0,48,5.31,29,160,1399,9.1
11457,Jamie Oleksiak,2016-17,24.0,5,0,7,7,0,0,0,5.0,125.0,23,0,2,2,16.0,82,5.34,48,269,2463,8.9
11458,Jamie Oleksiak,2017-18,25.0,6,8,36,36,1,7,8,36.0,482.0,59,1,9,10,52.0,82,5.32,47,251,2453,8.9
11459,Jamie Oleksiak,2018-19,26.0,7,2,19,19,0,2,2,13.0,242.0,78,1,11,12,65.0,82,5.34,48,255,2438,9.0
11460,Jamie Oleksiak,2019-20,27.0,8,7,41,41,5,2,7,33.0,665.0,119,6,13,19,98.0,82,5.45,47,245,2478,9.0
11461,Jamie Oleksiak,2020-21,28.0,9,17,68,68,5,12,17,81.0,1133.0,187,11,25,36,179.0,82,5.86,50,250,2620,9.2
11462,Jamie Oleksiak,2021-22,29.0,10,12,57,57,4,8,12,55.0,840.0,244,15,33,48,234.0,82,5.96,47,239,2579,9.5
11463,Jamie Oleksiak,2022-23,30.0,11,10,69,69,3,7,10,76.0,1091.0,313,18,40,58,310.0,70,5.96,42,208,2192,9.5
11464,Jamie Pushor,1998-99,25.0,4,1,5,5,0,1,1,6.0,,5,0,1,1,6.0,82,6.29,74,413,2481,10.4
11465,Jamie Pushor,1999-00,26.0,5,11,75,75,4,7,11,63.0,,80,4,8,12,69.0,82,5.83,55,336,2444,9.8
11466,Jamie Pushor,2000-01,27.0,6,9,64,64,2,7,9,51.0,,144,6,15,21,120.0,82,5.28,57,380,2242,9.6
11467,Jamie Pushor,2001-02,28.0,7,3,70,70,1,2,3,75.0,1349.0,214,7,17,24,195.0,82,5.27,57,359,2285,9.4
11468,Jamie Pushor,2002-03,29.0,8,8,62,62,0,8,8,27.0,719.0,276,7,25,32,222.0,82,5.49,53,331,2294,9.8
11469,Jamie Pushor,2003-04,30.0,9,13,75,75,3,10,13,64.0,1561.0,351,10,35,45,286.0,82,5.51,63,376,2272,9.9
11470,Jamie Pushor,2004-05,31.0,10,8,76,76,0,8,8,60.0,1329.0,427,10,43,53,346.0,82,5.24,53,338,2262,9.5
11471,Jamie Pushor,2005-06,32.0,11,4,76,76,3,1,4,54.0,1290.0,503,13,44,57,400.0,82,5.31,60,363,2326,9.4
11472,Jamie Pushor,2006-07,33.0,12,0,14,14,0,0,0,10.0,184.0,517,13,44,57,410.0,82,5.14,57,348,2300,9.2
11473,Jamie Pushor,2008-09,35.0,13,3,4,4,1,2,3,2.0,73.0,521,14,46,60,412.0,82,6.05,85,480,2458,10.1
11474,Jamie Rivers,1998-99,23.0,4,0,3,3,0,0,0,5.0,,3,0,0,0,5.0,82,6.29,74,413,2481,10.4
11475,Jamie Rivers,1999-00,24.0,5,7,15,15,2,5,7,9.0,,18,2,5,7,14.0,82,5.83,55,336,2444,9.8
11476,Jamie Rivers,2000-01,25.0,6,6,59,59,2,4,6,53.0,,77,4,9,13,67.0,82,5.28,57,380,2242,9.6
11477,Jamie Rivers,2001-02,26.0,7,7,76,76,2,5,7,78.0,1077.0,153,6,14,20,145.0,82,5.27,57,359,2285,9.4
11478,Jamie Rivers,2002-03,27.0,8,17,75,75,1,16,17,95.0,1474.0,228,7,30,37,240.0,82,5.49,53,331,2294,9.8
11479,Jamie Rivers,2003-04,28.0,9,6,45,45,2,4,6,41.0,631.0,273,9,34,43,281.0,82,5.51,63,376,2272,9.9
11480,Jamie Rivers,2004-05,29.0,10,6,66,66,4,2,6,51.0,564.0,339,13,36,49,332.0,82,5.24,53,338,2262,9.5
11481,Jamie Rivers,2005-06,30.0,11,0,1,1,0,0,0,2.0,18.0,340,13,36,49,334.0,82,5.31,60,363,2326,9.4
11482,Jamie Rivers,2006-07,31.0,12,7,50,50,3,4,7,31.0,512.0,390,16,40,56,365.0,82,5.14,57,348,2300,9.2
11483,Jamie Rivers,2008-09,33.0,13,6,33,33,0,6,6,36.0,495.0,423,16,46,62,401.0,82,6.05,85,480,2458,10.1
11484,Jamie Rivers,2009-10,34.0,14,4,31,31,1,3,4,17.0,440.0,454,17,49,66,418.0,82,5.76,70,398,2426,9.7
11485,Jamie Tardif,2015-16,31.0,4,0,2,2,0,0,0,1.0,10.0,2,0,0,0,1.0,48,5.31,29,160,1399,9.1
11486,Jamie Wright,2000-01,24.0,4,6,21,21,4,2,6,15.0,,21,4,2,6,15.0,82,5.28,57,380,2242,9.6
11487,Jamie Wright,2001-02,25.0,5,0,11,11,0,0,0,10.0,84.0,32,4,2,6,25.0,82,5.27,57,359,2285,9.4
11488,Jamie Wright,2002-03,26.0,6,5,23,23,1,4,5,15.0,226.0,55,5,6,11,40.0,82,5.49,53,331,2294,9.8
11489,Jamie Wright,2003-04,27.0,7,1,2,2,1,0,1,4.0,22.0,57,6,6,12,44.0,82,5.51,63,376,2272,9.9
11490,Jamie Wright,2004-05,28.0,8,16,44,44,4,12,16,64.0,604.0,101,10,18,28,108.0,82,5.24,53,338,2262,9.5
11491,Jamie Wright,2005-06,29.0,9,4,23,23,2,2,4,18.0,260.0,124,12,20,32,126.0,82,5.31,60,363,2326,9.4
11492,Jan Benda,2000-01,28.0,4,3,9,9,0,3,3,8.0,,9,0,3,3,8.0,82,5.28,57,380,2242,9.6
11493,Jan Bulis,2000-01,22.0,4,16,48,48,5,11,16,37.0,,48,5,11,16,37.0,82,5.28,57,380,2242,9.6
11494,Jan Bulis,2001-02,23.0,5,23,38,38,7,16,23,57.0,549.0,86,12,27,39,94.0,82,5.27,57,359,2285,9.4
11495,Jan Bulis,2002-03,24.0,6,31,56,56,9,22,31,92.0,780.0,142,21,49,70,186.0,82,5.49,53,331,2294,9.8
11496,Jan Bulis,2003-04,25.0,7,23,51,51,5,18,23,61.0,685.0,193,26,67,93,247.0,82,5.51,63,376,2272,9.9
11497,Jan Bulis,2004-05,26.0,8,19,53,53,9,10,19,87.0,719.0,246,35,77,112,334.0,82,5.24,53,338,2262,9.5
11498,Jan Bulis,2005-06,27.0,9,40,82,82,16,24,40,160.0,1288.0,328,51,101,152,494.0,82,5.31,60,363,2326,9.4
11499,Jan Bulis,2006-07,28.0,10,30,72,72,13,17,30,147.0,1232.0,400,64,118,182,641.0,82,5.14,57,348,2300,9.2
11500,Jan Bulis,2008-09,30.0,11,40,73,73,20,20,40,131.0,1141.0,473,84,138,222,772.0,82,6.05,85,480,2458,10.1
11501,Jan Bulis,2009-10,31.0,12,23,79,79,12,11,23,122.0,1136.0,552,96,149,245,894.0,82,5.76,70,398,2426,9.7
11502,Jan Caloun,1998-99,26.0,4,11,11,11,8,3,11,20.0,,11,8,3,11,20.0,82,6.29,74,413,2481,10.4
11503,Jan Caloun,1999-00,27.0,5,0,2,2,0,0,0,3.0,,13,8,3,11,23.0,82,5.83,55,336,2444,9.8
11504,Jan Caloun,2003-04,31.0,6,3,11,11,0,3,3,14.0,139.0,24,8,6,14,37.0,82,5.51,63,376,2272,9.9
11505,Jan Erixon,1986-87,24.0,4,30,75,75,5,25,30,94.0,,75,5,25,30,94.0,80,7.89,74,336,2448,12.9
11506,Jan Erixon,1987-88,25.0,5,29,66,66,7,22,29,72.0,,141,12,47,59,166.0,80,7.77,71,321,2447,12.7
11507,Jan Erixon,1988-89,26.0,6,19,31,31,2,17,19,33.0,,172,14,64,78,199.0,80,7.94,82,370,2484,12.8
11508,Jan Erixon,1989-90,27.0,7,26,68,68,8,18,26,73.0,,240,22,82,104,272.0,80,7.34,72,344,2400,12.2
11509,Jan Erixon,1990-91,28.0,8,26,70,70,7,19,26,99.0,,310,29,101,130,371.0,80,7.43,89,437,2435,12.2
11510,Jan Erixon,1991-92,29.0,9,15,44,44,4,11,15,41.0,,354,33,112,145,412.0,80,7.48,85,403,2430,12.3
11511,Jan Erixon,1992-93,30.0,10,13,58,58,4,9,13,61.0,,412,37,121,158,473.0,80,7.37,76,367,2421,12.2
11512,Jan Erixon,1993-94,31.0,11,25,53,53,7,18,25,40.0,,465,44,139,183,513.0,80,6.91,71,366,2385,11.6
11513,Jan Erixon,1994-95,32.0,12,17,46,46,8,9,17,51.0,,511,52,148,200,564.0,80,6.96,77,402,2440,11.4
11514,Jan Erixon,1995-96,33.0,13,16,45,45,5,11,16,36.0,,556,57,159,216,600.0,84,7.25,87,443,2603,11.7
11515,Jan Hejda,2009-10,31.0,4,9,39,39,1,8,9,33.0,795.0,39,1,8,9,33.0,82,5.76,70,398,2426,9.7
11516,Jan Hejda,2010-11,32.0,5,13,81,81,0,13,13,71.0,1711.0,120,1,21,22,104.0,82,5.44,62,351,2383,9.4
11517,Jan Hejda,2011-12,33.0,6,21,82,82,3,18,21,66.0,1835.0,202,4,39,43,170.0,82,5.7,65,341,2477,9.4
11518,Jan Hejda,2012-13,34.0,7,13,62,62,3,10,13,63.0,1280.0,264,7,49,56,233.0,82,5.53,56,304,2486,9.1
11519,Jan Hejda,2013-14,35.0,8,20,77,77,5,15,20,79.0,1626.0,341,12,64,76,312.0,82,5.46,52,291,2492,9.0
11520,Jan Hejda,2014-15,36.0,9,19,81,81,5,14,19,78.0,1675.0,422,17,78,95,390.0,82,5.32,47,271,2439,8.9
11521,Jan Hejda,2015-16,37.0,10,10,46,46,1,9,10,50.0,906.0,468,18,87,105,440.0,48,5.31,29,160,1399,9.1
11522,Jan Hejda,2016-17,38.0,11,17,78,78,6,11,17,75.0,1741.0,546,24,98,122,515.0,82,5.34,48,269,2463,8.9
11523,Jan Hejda,2017-18,39.0,12,13,81,81,1,12,13,84.0,1673.0,627,25,110,135,599.0,82,5.32,47,251,2453,8.9
11524,Jan Hlavac,2002-03,26.0,4,42,67,67,19,23,42,134.0,1015.0,67,19,23,42,134.0,82,5.49,53,331,2294,9.8
11525,Jan Hlavac,2003-04,27.0,5,64,79,79,28,36,64,195.0,1314.0,146,47,59,106,329.0,82,5.51,63,376,2272,9.9
11526,Jan Hlavac,2004-05,28.0,6,31,77,77,16,15,31,132.0,1070.0,223,63,74,137,461.0,82,5.24,53,338,2262,9.5
11527,Jan Hlavac,2005-06,29.0,7,26,61,61,10,16,26,123.0,991.0,284,73,90,163,584.0,82,5.31,60,363,2326,9.4
11528,Jan Hlavac,2006-07,30.0,8,26,72,72,5,21,26,125.0,999.0,356,78,111,189,709.0,82,5.14,57,348,2300,9.2
11529,Jan Hlavac,2010-11,34.0,9,35,80,80,12,23,35,152.0,1212.0,436,90,134,224,861.0,82,5.44,62,351,2383,9.4
11530,Jan Hrdina,2001-02,25.0,4,42,82,82,13,29,42,94.0,1348.0,82,13,29,42,94.0,82,5.27,57,359,2285,9.4
11531,Jan Hrdina,2002-03,26.0,5,46,70,70,13,33,46,84.0,1315.0,152,26,62,88,178.0,82,5.49,53,331,2294,9.8
11532,Jan Hrdina,2003-04,27.0,6,43,78,78,15,28,43,89.0,1242.0,230,41,90,131,267.0,82,5.51,63,376,2272,9.9
11533,Jan Hrdina,2004-05,28.0,7,57,79,79,24,33,57,115.0,1568.0,309,65,123,188,382.0,82,5.24,53,338,2262,9.5
11534,Jan Hrdina,2005-06,29.0,8,43,61,61,14,29,43,86.0,1199.0,370,79,152,231,468.0,82,5.31,60,363,2326,9.4
11535,Jan Hrdina,2006-07,30.0,9,33,68,68,12,21,33,73.0,1155.0,438,91,173,264,541.0,82,5.14,57,348,2300,9.2
11536,Jan Hrdina,2008-09,32.0,10,33,75,75,10,23,33,78.0,1272.0,513,101,196,297,619.0,82,6.05,85,480,2458,10.1
11537,Jan Ludvig,1985-86,24.0,4,17,51,51,7,10,17,105.0,,51,7,10,17,105.0,80,7.73,71,310,2444,12.7
11538,Jan Ludvig,1986-87,25.0,5,54,74,74,22,32,54,176.0,,125,29,42,71,281.0,80,7.89,74,336,2448,12.9
11539,Jan Ludvig,1987-88,26.0,6,31,74,74,12,19,31,134.0,,199,41,61,102,415.0,80,7.77,71,321,2447,12.7
11540,Jan Ludvig,1988-89,27.0,7,14,42,42,5,9,14,72.0,,241,46,70,116,487.0,80,7.94,82,370,2484,12.8
11541,Jan Ludvig,1989-90,28.0,8,16,47,47,7,9,16,56.0,,288,53,79,132,543.0,80,7.34,72,344,2400,12.2
11542,Jan Ludvig,1990-91,29.0,9,7,13,13,1,6,7,13.0,,301,54,85,139,556.0,80,7.43,89,437,2435,12.2
11543,Jan Ludvig,1991-92,30.0,10,2,13,13,0,2,2,11.0,,314,54,87,141,567.0,80,7.48,85,403,2430,12.3
11544,Jan Mertzig,2001-02,31.0,4,2,23,23,0,2,2,10.0,277.0,23,0,2,2,10.0,82,5.27,57,359,2285,9.4
11545,Jan Mursak ,2013-14,26.0,4,1,19,19,1,0,1,20.0,156.0,19,1,0,1,20.0,82,5.46,52,291,2492,9.0
11546,Jan Mursak ,2014-15,27.0,5,3,25,25,1,2,3,22.0,189.0,44,2,2,4,42.0,82,5.32,47,271,2439,8.9
11547,Jan Mursak ,2015-16,28.0,6,0,2,2,0,0,0,0.0,11.0,46,2,2,4,42.0,48,5.31,29,160,1399,9.1
11548,Jan Nemecek,2001-02,25.0,4,1,6,6,1,0,1,8.0,100.0,6,1,0,1,8.0,82,5.27,57,359,2285,9.4
11549,Jan Nemecek,2002-03,26.0,5,0,1,1,0,0,0,0.0,10.0,7,1,0,1,8.0,82,5.49,53,331,2294,9.8
11550,Jan Rutta,2020-21,30.0,4,20,57,57,6,14,20,71.0,1098.0,57,6,14,20,71.0,82,5.86,50,250,2620,9.2
11551,Jan Rutta,2021-22,31.0,5,8,37,37,2,6,8,42.0,577.0,94,8,20,28,113.0,82,5.96,47,239,2579,9.5
11552,Jan Rutta,2022-23,32.0,6,7,33,33,1,6,7,43.0,513.0,127,9,26,35,156.0,70,5.96,42,208,2192,9.5
11553,Jan Vopat,1998-99,25.0,4,5,11,11,1,4,5,13.0,,11,1,4,5,13.0,82,6.29,74,413,2481,10.4
11554,Jan Vopat,1999-00,26.0,5,9,33,33,4,5,9,44.0,,44,5,9,14,57.0,82,5.83,55,336,2444,9.8
11555,Jan Vopat,2000-01,27.0,6,6,21,21,1,5,6,13.0,,65,6,14,20,70.0,82,5.28,57,380,2242,9.6
11556,Jan Vopat,2001-02,28.0,7,11,55,55,5,6,11,46.0,995.0,120,11,20,31,116.0,82,5.27,57,359,2285,9.4
11557,Jan Vopat,2002-03,29.0,8,0,6,6,0,0,0,3.0,108.0,126,11,20,31,119.0,82,5.49,53,331,2294,9.8
11558,Jani Hakanpaa,2022-23,30.0,4,1,5,5,1,0,1,4.0,91.0,5,1,0,1,4.0,70,5.96,42,208,2192,9.5
11559,Jani Rita,2004-05,23.0,4,0,1,1,0,0,0,0.0,6.0,1,0,0,0,0.0,82,5.24,53,338,2262,9.5
11560,Jani Rita,2005-06,24.0,5,4,12,12,3,1,4,18.0,114.0,13,3,1,4,18.0,82,5.31,60,363,2326,9.4
11561,Jani Rita,2006-07,25.0,6,0,2,2,0,0,0,1.0,9.0,15,3,1,4,19.0,82,5.14,57,348,2300,9.2
11562,Jani Rita,2008-09,27.0,7,10,51,51,6,4,10,49.0,445.0,66,9,5,14,68.0,82,6.05,85,480,2458,10.1
11563,Janis Sprukts,2009-10,28.0,4,3,13,13,1,2,3,10.0,82.0,13,1,2,3,10.0,82,5.76,70,398,2426,9.7
11564,Janis Sprukts,2011-12,30.0,5,0,1,1,0,0,0,1.0,12.0,14,1,2,3,11.0,82,5.7,65,341,2477,9.4
11565,Janne Kuokkanen,2020-21,22.0,4,0,4,4,0,0,0,6.0,44.0,4,0,0,0,6.0,82,5.86,50,250,2620,9.2
11566,Janne Kuokkanen,2021-22,23.0,5,0,7,7,0,0,0,6.0,76.0,11,0,0,0,12.0,82,5.96,47,239,2579,9.5
11567,Janne Kuokkanen,2022-23,24.0,6,0,1,1,0,0,0,0.0,12.0,12,0,0,0,12.0,70,5.96,42,208,2192,9.5
11568,Janne Laukkanen,1997-98,27.0,4,3,11,11,0,3,3,12.0,,11,0,3,3,12.0,48,5.97,37,209,1408,10.2
11569,Janne Laukkanen,1998-99,28.0,5,3,23,23,1,2,3,35.0,,34,1,5,6,47.0,82,6.29,74,413,2481,10.4
11570,Janne Laukkanen,1999-00,29.0,6,21,76,76,3,18,21,109.0,,110,4,23,27,156.0,82,5.83,55,336,2444,9.8
11571,Janne Laukkanen,2000-01,30.0,7,21,60,60,4,17,21,69.0,,170,8,40,48,225.0,82,5.28,57,380,2242,9.6
11572,Janne Laukkanen,2001-02,31.0,8,12,50,50,1,11,12,46.0,931.0,220,9,51,60,271.0,82,5.27,57,359,2285,9.4
11573,Janne Laukkanen,2002-03,32.0,9,20,71,71,2,18,20,81.0,1373.0,291,11,69,80,352.0,82,5.49,53,331,2294,9.8
11574,Janne Laukkanen,2003-04,33.0,10,20,50,50,3,17,20,58.0,923.0,341,14,86,100,410.0,82,5.51,63,376,2272,9.9
11575,Janne Laukkanen,2004-05,34.0,11,13,47,47,6,7,13,66.0,839.0,388,20,93,113,476.0,82,5.24,53,338,2262,9.5
11576,Janne Laukkanen,2005-06,35.0,12,8,19,19,2,6,8,12.0,323.0,407,22,99,121,488.0,82,5.31,60,363,2326,9.4
11577,Janne Niinimaa,1999-00,24.0,4,44,77,77,4,40,44,141.0,,77,4,40,44,141.0,82,5.83,55,336,2444,9.8
11578,Janne Niinimaa,2000-01,25.0,5,43,77,77,4,39,43,134.0,,154,8,79,87,275.0,82,5.28,57,380,2242,9.6
11579,Janne Niinimaa,2001-02,26.0,6,28,81,81,4,24,28,142.0,1936.0,235,12,103,115,417.0,82,5.27,57,359,2285,9.4
11580,Janne Niinimaa,2002-03,27.0,7,33,81,81,8,25,33,133.0,1982.0,316,20,128,148,550.0,82,5.49,53,331,2294,9.8
11581,Janne Niinimaa,2003-04,28.0,8,46,82,82,12,34,46,122.0,2078.0,398,32,162,194,672.0,82,5.51,63,376,2272,9.9
11582,Janne Niinimaa,2004-05,29.0,9,44,81,81,5,39,44,119.0,2108.0,479,37,201,238,791.0,82,5.24,53,338,2262,9.5
11583,Janne Niinimaa,2005-06,30.0,10,34,76,76,5,29,34,101.0,1988.0,555,42,230,272,892.0,82,5.31,60,363,2326,9.4
11584,Janne Niinimaa,2006-07,31.0,11,28,82,82,9,19,28,97.0,1907.0,637,51,249,300,989.0,82,5.14,57,348,2300,9.2
11585,Janne Niinimaa,2008-09,33.0,12,16,63,63,3,13,16,49.0,1246.0,700,54,262,316,1038.0,82,6.05,85,480,2458,10.1
11586,Janne Niinimaa,2009-10,34.0,13,3,41,41,0,3,3,29.0,609.0,741,54,265,319,1067.0,82,5.76,70,398,2426,9.7
11587,Janne Niskala,2011-12,30.0,4,3,6,6,1,2,3,10.0,82.0,6,1,2,3,10.0,82,5.7,65,341,2477,9.4
11588,Janne Ojanen,1991-92,23.0,4,1,3,3,0,1,1,1.0,,3,0,1,1,1.0,80,7.48,85,403,2430,12.3
11589,Janne Ojanen,1992-93,24.0,5,30,64,64,17,13,30,76.0,,67,17,14,31,77.0,80,7.37,76,367,2421,12.2
11590,Janne Ojanen,1995-96,27.0,6,13,31,31,4,9,13,44.0,,98,21,23,44,121.0,84,7.25,87,443,2603,11.7
11591,Janne Pesonen,2011-12,29.0,4,0,7,7,0,0,0,3.0,52.0,7,0,0,0,3.0,82,5.7,65,341,2477,9.4
11592,Jannik Hansen,2010-11,24.0,4,0,5,5,0,0,0,3.0,58.0,5,0,0,0,3.0,82,5.44,62,351,2383,9.4
11593,Jannik Hansen,2011-12,25.0,5,21,55,55,6,15,21,64.0,688.0,60,6,15,21,67.0,82,5.7,65,341,2477,9.4
11594,Jannik Hansen,2012-13,26.0,6,15,47,47,9,6,15,67.0,580.0,107,15,21,36,134.0,82,5.53,56,304,2486,9.1
11595,Jannik Hansen,2013-14,27.0,7,29,82,82,9,20,29,113.0,1206.0,189,24,41,65,247.0,82,5.46,52,291,2492,9.0
11596,Jannik Hansen,2014-15,28.0,8,39,82,82,16,23,39,137.0,1222.0,271,40,64,104,384.0,82,5.32,47,271,2439,8.9
11597,Jannik Hansen,2015-16,29.0,9,27,47,47,10,17,27,99.0,825.0,318,50,81,131,483.0,48,5.31,29,160,1399,9.1
11598,Jannik Hansen,2016-17,30.0,10,20,71,71,11,9,20,112.0,1112.0,389,61,90,151,595.0,82,5.34,48,269,2463,8.9
11599,Jannik Hansen,2017-18,31.0,11,33,81,81,16,17,33,145.0,1132.0,470,77,107,184,740.0,82,5.32,47,251,2453,8.9
11600,Jannik Hansen,2018-19,32.0,12,38,67,67,22,16,38,117.0,1101.0,537,99,123,222,857.0,82,5.34,48,255,2438,9.0
11601,Jannik Hansen,2019-20,33.0,13,20,43,43,8,12,20,73.0,690.0,580,107,135,242,930.0,82,5.45,47,245,2478,9.0
11602,Jannik Hansen,2020-21,34.0,14,14,46,46,2,12,14,54.0,554.0,626,109,147,256,984.0,82,5.86,50,250,2620,9.2
11603,Jansen Harkins,2022-23,25.0,4,7,29,29,2,5,7,29.0,308.0,29,2,5,7,29.0,70,5.96,42,208,2192,9.5
11604,Jared Aulin,2005-06,23.0,4,4,17,17,2,2,4,21.0,169.0,17,2,2,4,21.0,82,5.31,60,363,2326,9.4
11605,Jared Boll,2010-11,24.0,4,10,75,75,5,5,10,63.0,601.0,75,5,5,10,63.0,82,5.44,62,351,2383,9.4
11606,Jared Boll,2011-12,25.0,5,14,75,75,4,10,14,73.0,667.0,150,9,15,24,136.0,82,5.7,65,341,2477,9.4
11607,Jared Boll,2012-13,26.0,6,7,68,68,4,3,7,56.0,490.0,218,13,18,31,192.0,82,5.53,56,304,2486,9.1
11608,Jared Boll,2013-14,27.0,7,12,73,73,7,5,12,66.0,560.0,291,20,23,43,258.0,82,5.46,52,291,2492,9.0
11609,Jared Boll,2014-15,28.0,8,3,54,54,2,1,3,35.0,438.0,345,22,24,46,293.0,82,5.32,47,271,2439,8.9
11610,Jared Boll,2015-16,29.0,9,6,43,43,2,4,6,19.0,348.0,388,24,28,52,312.0,48,5.31,29,160,1399,9.1
11611,Jared Boll,2016-17,30.0,10,2,28,28,1,1,2,12.0,214.0,416,25,29,54,324.0,82,5.34,48,269,2463,8.9
11612,Jared Boll,2017-18,31.0,11,5,72,72,1,4,5,28.0,524.0,488,26,33,59,352.0,82,5.32,47,251,2453,8.9
11613,Jared Boll,2018-19,32.0,12,3,30,30,1,2,3,11.0,200.0,518,27,35,62,363.0,82,5.34,48,255,2438,9.0
11614,Jared Boll,2019-20,33.0,13,3,51,51,0,3,3,13.0,297.0,569,27,38,65,376.0,82,5.45,47,245,2478,9.0
11615,Jared Boll,2020-21,34.0,14,1,10,10,1,0,1,4.0,44.0,579,28,38,66,380.0,82,5.86,50,250,2620,9.2
11616,Jared Cowen,2012-13,22.0,4,0,1,1,0,0,0,0.0,7.0,1,0,0,0,0.0,82,5.53,56,304,2486,9.1
11617,Jared Cowen,2014-15,24.0,5,17,82,82,5,12,17,58.0,1549.0,83,5,12,17,58.0,82,5.32,47,271,2439,8.9
11618,Jared Cowen,2015-16,25.0,6,1,7,7,1,0,1,8.0,142.0,90,6,12,18,66.0,48,5.31,29,160,1399,9.1
11619,Jared Cowen,2016-17,26.0,7,15,68,68,6,9,15,68.0,1395.0,158,12,21,33,134.0,82,5.34,48,269,2463,8.9
11620,Jared Cowen,2017-18,27.0,8,9,54,54,3,6,9,47.0,980.0,212,15,27,42,181.0,82,5.32,47,251,2453,8.9
11621,Jared Cowen,2018-19,28.0,9,4,37,37,0,4,4,23.0,628.0,249,15,31,46,204.0,82,5.34,48,255,2438,9.0
11622,Jared McCann,2018-19,22.0,4,18,69,69,9,9,18,106.0,864.0,69,9,9,18,106.0,82,5.34,48,255,2438,9.0
11623,Jared McCann,2019-20,23.0,5,7,29,29,1,6,7,44.0,337.0,98,10,15,25,150.0,82,5.45,47,245,2478,9.0
11624,Jared McCann,2020-21,24.0,6,28,68,68,9,19,28,143.0,901.0,166,19,34,53,293.0,82,5.86,50,250,2620,9.2
11625,Jared McCann,2021-22,25.0,7,35,78,78,19,16,35,150.0,1133.0,244,38,50,88,443.0,82,5.96,47,239,2579,9.5
11626,Jared McCann,2022-23,26.0,8,35,66,66,14,21,35,150.0,1006.0,310,52,71,123,593.0,70,5.96,42,208,2192,9.5
11627,Jared Ross,2011-12,29.0,4,0,10,10,0,0,0,12.0,77.0,10,0,0,0,12.0,82,5.7,65,341,2477,9.4
11628,Jared Ross,2012-13,30.0,5,0,3,3,0,0,0,4.0,23.0,13,0,0,0,16.0,82,5.53,56,304,2486,9.1
11629,Jared Spurgeon,2013-14,24.0,4,12,53,53,4,8,12,38.0,799.0,53,4,8,12,38.0,82,5.46,52,291,2492,9.0
11630,Jared Spurgeon,2014-15,25.0,5,23,70,70,3,20,23,92.0,1512.0,123,7,28,35,130.0,82,5.32,47,271,2439,8.9
11631,Jared Spurgeon,2015-16,26.0,6,15,39,39,5,10,15,67.0,840.0,162,12,38,50,197.0,48,5.31,29,160,1399,9.1
11632,Jared Spurgeon,2016-17,27.0,7,26,67,67,5,21,26,91.0,1517.0,229,17,59,76,288.0,82,5.34,48,269,2463,8.9
11633,Jared Spurgeon,2017-18,28.0,8,25,66,66,9,16,25,128.0,1493.0,295,26,75,101,416.0,82,5.32,47,251,2453,8.9
11634,Jared Spurgeon,2018-19,29.0,9,29,77,77,11,18,29,122.0,1746.0,372,37,93,130,538.0,82,5.34,48,255,2438,9.0
11635,Jared Spurgeon,2019-20,30.0,10,38,76,76,10,28,38,144.0,1827.0,448,47,121,168,682.0,82,5.45,47,245,2478,9.0
11636,Jared Spurgeon,2020-21,31.0,11,37,61,61,9,28,37,110.0,1497.0,509,56,149,205,792.0,82,5.86,50,250,2620,9.2
11637,Jared Spurgeon,2021-22,32.0,12,43,82,82,14,29,43,152.0,1980.0,591,70,178,248,944.0,82,5.96,47,239,2579,9.5
11638,Jared Spurgeon,2022-23,33.0,13,32,62,62,12,20,32,112.0,1400.0,653,82,198,280,1056.0,70,5.96,42,208,2192,9.5
11639,Jared Staal,2015-16,25.0,4,0,2,2,0,0,0,3.0,27.0,2,0,0,0,3.0,48,5.31,29,160,1399,9.1
11640,Jaret Anderson-Dolan,2021-22,22.0,4,1,5,5,0,1,1,6.0,58.0,5,0,1,1,6.0,82,5.96,47,239,2579,9.5
11641,Jaret Anderson-Dolan,2022-23,23.0,5,0,4,4,0,0,0,2.0,41.0,9,0,1,1,8.0,70,5.96,42,208,2192,9.5
11642,Jari Gronstrand,1989-90,27.0,4,7,47,47,1,6,7,32.0,,47,1,6,7,32.0,80,7.34,72,344,2400,12.2
11643,Jari Gronstrand,1990-91,28.0,5,14,62,62,3,11,14,65.0,,109,4,17,21,97.0,80,7.43,89,437,2435,12.2
11644,Jari Gronstrand,1991-92,29.0,6,4,25,25,1,3,4,18.0,,134,5,20,25,115.0,80,7.48,85,403,2430,12.3
11645,Jari Gronstrand,1992-93,30.0,7,8,48,48,3,5,8,26.0,,182,8,25,33,141.0,80,7.37,76,367,2421,12.2
11646,Jari Gronstrand,1993-94,31.0,8,1,3,3,0,1,1,1.0,,185,8,26,34,142.0,80,6.91,71,366,2385,11.6
11647,Jari Kurri,1983-84,23.0,4,75,75,75,32,43,75,202.0,,75,32,43,75,202.0,80,7.69,77,340,2441,12.6
11648,Jari Kurri,1984-85,24.0,5,86,71,71,32,54,86,211.0,,146,64,97,161,413.0,80,8.03,73,320,2489,12.9
11649,Jari Kurri,1985-86,25.0,6,104,80,80,45,59,104,218.0,,226,109,156,265,631.0,80,7.73,71,310,2444,12.7
11650,Jari Kurri,1986-87,26.0,7,113,64,64,52,61,113,195.0,,290,161,217,378,826.0,80,7.89,74,336,2448,12.9
11651,Jari Kurri,1987-88,27.0,8,135,73,73,71,64,135,267.0,,363,232,281,513,1093.0,80,7.77,71,321,2447,12.7
11652,Jari Kurri,1988-89,28.0,9,131,78,78,68,63,131,236.0,,441,300,344,644,1329.0,80,7.94,82,370,2484,12.8
11653,Jari Kurri,1989-90,29.0,10,108,79,79,54,54,108,211.0,,520,354,398,752,1540.0,80,7.34,72,344,2400,12.2
11654,Jari Kurri,1990-91,30.0,11,96,80,80,43,53,96,207.0,,600,397,451,848,1747.0,80,7.43,89,437,2435,12.2
11655,Jari Kurri,1991-92,31.0,12,102,76,76,44,58,102,214.0,,676,441,509,950,1961.0,80,7.48,85,403,2430,12.3
11656,Jari Kurri,1992-93,32.0,13,93,78,78,33,60,93,201.0,,754,474,569,1043,2162.0,80,7.37,76,367,2421,12.2
11657,Jari Kurri,1994-95,34.0,14,60,73,73,23,37,60,167.0,,827,497,606,1103,2329.0,80,6.96,77,402,2440,11.4
11658,Jari Kurri,1995-96,35.0,15,87,82,82,27,60,87,210.0,,909,524,666,1190,2539.0,84,7.25,87,443,2603,11.7
11659,Jari Kurri,1996-97,36.0,16,77,81,81,31,46,77,198.0,,990,555,712,1267,2737.0,84,6.48,76,407,2545,10.7
11660,Jari Kurri,1997-98,37.0,17,29,38,38,10,19,29,84.0,,1028,565,731,1296,2821.0,48,5.97,37,209,1408,10.2
11661,Jari Kurri,1998-99,38.0,18,45,71,71,18,27,45,158.0,,1099,583,758,1341,2979.0,82,6.29,74,413,2481,10.4
11662,Jari Kurri,1999-00,39.0,19,35,82,82,13,22,35,109.0,,1181,596,780,1376,3088.0,82,5.83,55,336,2444,9.8
11663,Jari Kurri,2000-01,40.0,20,22,70,70,5,17,22,61.0,,1251,601,797,1398,3149.0,82,5.28,57,380,2242,9.6
11664,Jari Torkki,1991-92,26.0,4,1,4,4,1,0,1,2.0,,4,1,0,1,2.0,80,7.48,85,403,2430,12.3
11665,Jarkko Immonen,2008-09,26.0,4,2,6,6,2,0,2,8.0,62.0,6,2,0,2,8.0,82,6.05,85,480,2458,10.1
11666,Jarkko Immonen,2009-10,27.0,5,6,14,14,1,5,6,14.0,145.0,20,3,5,8,22.0,82,5.76,70,398,2426,9.7
11667,Jarkko Ruutu,2002-03,27.0,4,1,8,8,0,1,1,4.0,70.0,8,0,1,1,4.0,82,5.49,53,331,2294,9.8
11668,Jarkko Ruutu,2003-04,28.0,5,6,21,21,3,3,6,23.0,224.0,29,3,4,7,27.0,82,5.51,63,376,2272,9.9
11669,Jarkko Ruutu,2004-05,29.0,6,9,49,49,2,7,9,37.0,499.0,78,5,11,16,64.0,82,5.24,53,338,2262,9.5
11670,Jarkko Ruutu,2005-06,30.0,7,4,36,36,2,2,4,36.0,323.0,114,7,13,20,100.0,82,5.31,60,363,2326,9.4
11671,Jarkko Ruutu,2006-07,31.0,8,14,71,71,6,8,14,70.0,815.0,185,13,21,34,170.0,82,5.14,57,348,2300,9.2
11672,Jarkko Ruutu,2008-09,33.0,9,17,82,82,10,7,17,85.0,960.0,267,23,28,51,255.0,82,6.05,85,480,2458,10.1
11673,Jarkko Ruutu,2009-10,34.0,10,16,81,81,7,9,16,63.0,756.0,348,30,37,67,318.0,82,5.76,70,398,2426,9.7
11674,Jarkko Ruutu,2010-11,35.0,11,16,71,71,6,10,16,55.0,725.0,419,36,47,83,373.0,82,5.44,62,351,2383,9.4
11675,Jarkko Ruutu,2011-12,36.0,12,21,78,78,7,14,21,89.0,913.0,497,43,61,104,462.0,82,5.7,65,341,2477,9.4
11676,Jarkko Ruutu,2012-13,37.0,13,26,82,82,12,14,26,106.0,1095.0,579,55,75,130,568.0,82,5.53,56,304,2486,9.1
11677,Jarkko Ruutu,2013-14,38.0,14,12,73,73,3,9,12,66.0,830.0,652,58,84,142,634.0,82,5.46,52,291,2492,9.0
11678,Jarkko Varvio,1996-97,24.0,4,5,8,8,2,3,5,17.0,,8,2,3,5,17.0,84,6.48,76,407,2545,10.7
11679,Jarkko Varvio,1997-98,25.0,5,2,5,5,1,1,2,9.0,,13,3,4,7,26.0,48,5.97,37,209,1408,10.2
11680,Jarmo Kekalainen,1992-93,26.0,4,4,11,11,2,2,4,7.0,,11,2,2,4,7.0,80,7.37,76,367,2421,12.2
11681,Jarmo Kekalainen,1993-94,27.0,5,3,16,16,2,1,3,12.0,,27,4,3,7,19.0,80,6.91,71,366,2385,11.6
11682,Jarmo Kekalainen,1996-97,30.0,6,6,28,28,1,5,6,18.0,,55,5,8,13,37.0,84,6.48,76,407,2545,10.7
11683,Jarno Kultanen,2003-04,31.0,4,10,62,62,2,8,10,76.0,1208.0,62,2,8,10,76.0,82,5.51,63,376,2272,9.9
11684,Jarno Kultanen,2004-05,32.0,5,3,38,38,0,3,3,31.0,493.0,100,2,11,13,107.0,82,5.24,53,338,2262,9.5
11685,Jarno Kultanen,2005-06,33.0,6,0,2,2,0,0,0,3.0,21.0,102,2,11,13,110.0,82,5.31,60,363,2326,9.4
11686,Jarod Palmer,2014-15,28.0,4,1,6,6,1,0,1,14.0,80.0,6,1,0,1,14.0,82,5.32,47,271,2439,8.9
11687,Jarome Iginla,1999-00,22.0,4,50,82,82,21,29,50,169.0,,82,21,29,50,169.0,82,5.83,55,336,2444,9.8
11688,Jarome Iginla,2000-01,23.0,5,32,70,70,13,19,32,154.0,,152,34,48,82,323.0,82,5.28,57,380,2242,9.6
11689,Jarome Iginla,2001-02,24.0,6,51,82,82,28,23,51,211.0,1353.0,234,62,71,133,534.0,82,5.27,57,359,2285,9.4
11690,Jarome Iginla,2002-03,25.0,7,63,77,77,29,34,63,256.0,1417.0,311,91,105,196,790.0,82,5.49,53,331,2294,9.8
11691,Jarome Iginla,2003-04,26.0,8,71,77,77,31,40,71,229.0,1537.0,388,122,145,267,1019.0,82,5.51,63,376,2272,9.9
11692,Jarome Iginla,2004-05,27.0,9,96,82,82,52,44,96,311.0,1834.0,470,174,189,363,1330.0,82,5.24,53,338,2262,9.5
11693,Jarome Iginla,2005-06,28.0,10,67,75,75,35,32,67,316.0,1607.0,545,209,221,430,1646.0,82,5.31,60,363,2326,9.4
11694,Jarome Iginla,2006-07,29.0,11,73,81,81,41,32,73,265.0,1725.0,626,250,253,503,1911.0,82,5.14,57,348,2300,9.2
11695,Jarome Iginla,2008-09,31.0,12,67,82,82,35,32,67,293.0,1779.0,708,285,285,570,2204.0,82,6.05,85,480,2458,10.1
11696,Jarome Iginla,2009-10,32.0,13,94,70,70,39,55,94,264.0,1544.0,778,324,340,664,2468.0,82,5.76,70,398,2426,9.7
11697,Jarome Iginla,2010-11,33.0,14,98,82,82,50,48,98,338.0,1758.0,860,374,388,762,2806.0,82,5.44,62,351,2383,9.4
11698,Jarome Iginla,2011-12,34.0,15,89,82,82,35,54,89,289.0,1772.0,942,409,442,851,3095.0,82,5.7,65,341,2477,9.4
11699,Jarome Iginla,2012-13,35.0,16,69,82,82,32,37,69,257.0,1689.0,1024,441,479,920,3352.0,82,5.53,56,304,2486,9.1
11700,Jarome Iginla,2013-14,36.0,17,86,82,82,43,43,86,289.0,1717.0,1106,484,522,1006,3641.0,82,5.46,52,291,2492,9.0
11701,Jarome Iginla,2014-15,37.0,18,67,82,82,32,35,67,251.0,1690.0,1188,516,557,1073,3892.0,82,5.32,47,271,2439,8.9
11702,Jarome Iginla,2015-16,38.0,19,33,44,44,14,19,33,134.0,828.0,1232,530,576,1106,4026.0,48,5.31,29,160,1399,9.1
11703,Jarome Iginla,2016-17,39.0,20,61,78,78,30,31,61,209.0,1421.0,1310,560,607,1167,4235.0,82,5.34,48,269,2463,8.9
11704,Jarome Iginla,2017-18,40.0,21,59,82,82,29,30,59,189.0,1487.0,1392,589,637,1226,4424.0,82,5.32,47,251,2453,8.9
11705,Jarome Iginla,2018-19,41.0,22,47,82,82,22,25,47,182.0,1301.0,1474,611,662,1273,4606.0,82,5.34,48,255,2438,9.0
11706,Jarome Iginla,2019-20,42.0,23,27,80,80,14,13,27,153.0,1210.0,1554,625,675,1300,4759.0,82,5.45,47,245,2478,9.0
11707,Jaromir Jagr,1993-94,21.0,4,57,80,80,27,30,57,136.0,,80,27,30,57,136.0,80,6.91,71,366,2385,11.6
11708,Jaromir Jagr,1994-95,22.0,5,69,70,70,32,37,69,194.0,,150,59,67,126,330.0,80,6.96,77,402,2440,11.4
11709,Jaromir Jagr,1995-96,23.0,6,94,81,81,34,60,94,242.0,,231,93,127,220,572.0,84,7.25,87,443,2603,11.7
11710,Jaromir Jagr,1996-97,24.0,7,99,80,80,32,67,99,298.0,,311,125,194,319,870.0,84,6.48,76,407,2545,10.7
11711,Jaromir Jagr,1997-98,25.0,8,70,48,48,32,38,70,192.0,,359,157,232,389,1062.0,48,5.97,37,209,1408,10.2
11712,Jaromir Jagr,1998-99,26.0,9,149,82,82,62,87,149,403.0,,441,219,319,538,1465.0,82,6.29,74,413,2481,10.4
11713,Jaromir Jagr,1999-00,27.0,10,95,63,63,47,48,95,234.0,,504,266,367,633,1699.0,82,5.83,55,336,2444,9.8
11714,Jaromir Jagr,2000-01,28.0,11,102,77,77,35,67,102,262.0,,581,301,434,735,1961.0,82,5.28,57,380,2242,9.6
11715,Jaromir Jagr,2001-02,29.0,12,127,81,81,44,83,127,343.0,2094.0,662,345,517,862,2304.0,82,5.27,57,359,2285,9.4
11716,Jaromir Jagr,2002-03,30.0,13,96,63,63,42,54,96,290.0,1462.0,725,387,571,958,2594.0,82,5.49,53,331,2294,9.8
11717,Jaromir Jagr,2003-04,31.0,14,121,81,81,52,69,121,317.0,1888.0,806,439,640,1079,2911.0,82,5.51,63,376,2272,9.9
11718,Jaromir Jagr,2004-05,32.0,15,79,69,69,31,48,79,197.0,1498.0,875,470,688,1158,3108.0,82,5.24,53,338,2262,9.5
11719,Jaromir Jagr,2005-06,33.0,16,77,75,75,36,41,77,290.0,1598.0,950,506,729,1235,3398.0,82,5.31,60,363,2326,9.4
11720,Jaromir Jagr,2006-07,34.0,17,74,77,77,31,43,74,257.0,1613.0,1027,537,772,1309,3655.0,82,5.14,57,348,2300,9.2
11721,Jaromir Jagr,2008-09,36.0,18,123,82,82,54,69,123,368.0,1810.0,1109,591,841,1432,4023.0,82,6.05,85,480,2458,10.1
11722,Jaromir Jagr,2009-10,37.0,19,96,82,82,30,66,96,324.0,1784.0,1191,621,907,1528,4347.0,82,5.76,70,398,2426,9.7
11723,Jaromir Jagr,2010-11,38.0,20,71,82,82,25,46,71,249.0,1678.0,1273,646,953,1599,4596.0,82,5.44,62,351,2383,9.4
11724,Jaromir Jagr,2014-15,42.0,21,54,73,73,19,35,54,170.0,1193.0,1346,665,988,1653,4766.0,82,5.32,47,271,2439,8.9
11725,Jaromir Jagr,2015-16,43.0,22,35,45,45,16,19,35,115.0,825.0,1391,681,1007,1688,4881.0,48,5.31,29,160,1399,9.1
11726,Jaromir Jagr,2016-17,44.0,23,67,82,82,24,43,67,231.0,1571.0,1473,705,1050,1755,5112.0,82,5.34,48,269,2463,8.9
11727,Jaromir Jagr,2017-18,45.0,24,47,77,77,17,30,47,169.0,1353.0,1550,722,1080,1802,5281.0,82,5.32,47,251,2453,8.9
11728,Jaromir Jagr,2018-19,46.0,25,66,79,79,27,39,66,143.0,1349.0,1629,749,1119,1868,5424.0,82,5.34,48,255,2438,9.0
11729,Jaromir Jagr,2019-20,47.0,26,46,82,82,16,30,46,181.0,1394.0,1711,765,1149,1914,5605.0,82,5.45,47,245,2478,9.0
11730,Jaromir Jagr,2020-21,48.0,27,7,22,22,1,6,7,32.0,287.0,1733,766,1155,1921,5637.0,82,5.86,50,250,2620,9.2
11731,Jaroslav Balastik,2008-09,29.0,4,22,66,66,12,10,22,158.0,847.0,66,12,10,22,158.0,82,6.05,85,480,2458,10.1
11732,Jaroslav Balastik,2009-10,30.0,5,2,8,8,1,1,2,6.0,65.0,74,13,11,24,164.0,82,5.76,70,398,2426,9.7
11733,Jaroslav Bednar,2004-05,28.0,4,6,22,22,4,2,6,20.0,235.0,22,4,2,6,20.0,82,5.24,53,338,2262,9.5
11734,Jaroslav Bednar,2005-06,29.0,5,27,67,67,5,22,27,95.0,946.0,89,9,24,33,115.0,82,5.31,60,363,2326,9.4
11735,Jaroslav Bednar,2006-07,30.0,6,2,13,13,1,1,2,19.0,169.0,102,10,25,35,134.0,82,5.14,57,348,2300,9.2
11736,Jaroslav Hlinka,2010-11,34.0,4,28,63,63,8,20,28,90.0,877.0,63,8,20,28,90.0,82,5.44,62,351,2383,9.4
11737,Jaroslav Kristek,2005-06,25.0,4,0,6,6,0,0,0,4.0,70.0,6,0,0,0,4.0,82,5.31,60,363,2326,9.4
11738,Jaroslav Modry,1996-97,25.0,4,17,41,41,2,15,17,35.0,,41,2,15,17,35.0,84,6.48,76,407,2545,10.7
11739,Jaroslav Modry,1997-98,26.0,5,0,11,11,0,0,0,10.0,,52,2,15,17,45.0,48,5.97,37,209,1408,10.2
11740,Jaroslav Modry,1998-99,27.0,6,21,73,73,4,17,21,106.0,,125,6,32,38,151.0,82,6.29,74,413,2481,10.4
11741,Jaroslav Modry,1999-00,28.0,7,6,30,30,3,3,6,32.0,,155,9,35,44,183.0,82,5.83,55,336,2444,9.8
11742,Jaroslav Modry,2001-02,30.0,8,1,5,5,0,1,1,11.0,130.0,160,9,36,45,194.0,82,5.27,57,359,2285,9.4
11743,Jaroslav Modry,2002-03,31.0,9,9,26,26,5,4,9,32.0,500.0,186,14,40,54,226.0,82,5.49,53,331,2294,9.8
11744,Jaroslav Modry,2003-04,32.0,10,19,63,63,4,15,19,72.0,1157.0,249,18,55,73,298.0,82,5.51,63,376,2272,9.9
11745,Jaroslav Modry,2004-05,33.0,11,42,80,80,4,38,42,119.0,1561.0,329,22,93,115,417.0,82,5.24,53,338,2262,9.5
11746,Jaroslav Modry,2005-06,34.0,12,38,82,82,13,25,38,205.0,1857.0,411,35,118,153,622.0,82,5.31,60,363,2326,9.4
11747,Jaroslav Modry,2006-07,35.0,13,32,79,79,5,27,32,196.0,1928.0,490,40,145,185,818.0,82,5.14,57,348,2300,9.2
11748,Jaroslav Modry,2008-09,37.0,14,38,79,79,7,31,38,143.0,1643.0,569,47,176,223,961.0,82,6.05,85,480,2458,10.1
11749,Jaroslav Modry,2009-10,38.0,15,18,76,76,1,17,18,89.0,1434.0,645,48,193,241,1050.0,82,5.76,70,398,2426,9.7
11750,Jaroslav Modry,2010-11,39.0,16,9,80,80,1,8,9,56.0,1525.0,725,49,201,250,1106.0,82,5.44,62,351,2383,9.4
11751,Jaroslav Obsut,2003-04,27.0,4,0,4,4,0,0,0,3.0,74.0,4,0,0,0,3.0,82,5.51,63,376,2272,9.9
11752,Jaroslav Obsut,2004-05,28.0,5,0,3,3,0,0,0,3.0,29.0,7,0,0,0,6.0,82,5.24,53,338,2262,9.5
11753,Jaroslav Otevrel,1995-96,27.0,4,2,7,7,0,2,2,4.0,,7,0,2,2,4.0,84,7.25,87,443,2603,11.7
11754,Jaroslav Otevrel,1996-97,28.0,5,5,9,9,3,2,5,11.0,,16,3,4,7,15.0,84,6.48,76,407,2545,10.7
11755,Jaroslav Pouzar,1985-86,34.0,4,33,74,74,15,18,33,86.0,,74,15,18,33,86.0,80,7.73,71,310,2444,12.7
11756,Jaroslav Pouzar,1986-87,35.0,5,32,67,67,13,19,32,87.0,,141,28,37,65,173.0,80,7.89,74,336,2448,12.9
11757,Jaroslav Pouzar,1987-88,36.0,6,12,33,33,4,8,12,37.0,,174,32,45,77,210.0,80,7.77,71,321,2447,12.7
11758,Jaroslav Pouzar,1989-90,38.0,7,5,12,12,2,3,5,11.0,,186,34,48,82,221.0,80,7.34,72,344,2400,12.2
11759,Jaroslav Sevcik,1992-93,27.0,4,2,13,13,0,2,2,9.0,,13,0,2,2,9.0,80,7.37,76,367,2421,12.2
11760,Jaroslav Spacek,2001-02,27.0,4,15,63,63,3,12,15,92.0,1225.0,63,3,12,15,92.0,82,5.27,57,359,2285,9.4
11761,Jaroslav Spacek,2002-03,28.0,5,36,82,82,10,26,36,111.0,1858.0,145,13,38,51,203.0,82,5.49,53,331,2294,9.8
11762,Jaroslav Spacek,2003-04,29.0,6,26,62,62,7,19,26,106.0,1306.0,207,20,57,77,309.0,82,5.51,63,376,2272,9.9
11763,Jaroslav Spacek,2004-05,30.0,7,18,74,74,5,13,18,93.0,1316.0,281,25,70,95,402.0,82,5.24,53,338,2262,9.5
11764,Jaroslav Spacek,2005-06,31.0,8,45,81,81,9,36,45,166.0,2007.0,362,34,106,140,568.0,82,5.31,60,363,2326,9.4
11765,Jaroslav Spacek,2006-07,32.0,9,22,58,58,5,17,22,108.0,1359.0,420,39,123,162,676.0,82,5.14,57,348,2300,9.2
11766,Jaroslav Spacek,2008-09,34.0,10,43,76,76,12,31,43,150.0,1798.0,496,51,154,205,826.0,82,6.05,85,480,2458,10.1
11767,Jaroslav Spacek,2009-10,35.0,11,21,65,65,5,16,21,78.0,1245.0,561,56,170,226,904.0,82,5.76,70,398,2426,9.7
11768,Jaroslav Spacek,2010-11,36.0,12,32,60,60,9,23,32,95.0,1379.0,621,65,193,258,999.0,82,5.44,62,351,2383,9.4
11769,Jaroslav Spacek,2011-12,37.0,13,45,80,80,8,37,45,130.0,1782.0,701,73,230,303,1129.0,82,5.7,65,341,2477,9.4
11770,Jaroslav Spacek,2012-13,38.0,14,21,74,74,3,18,21,99.0,1613.0,775,76,248,324,1228.0,82,5.53,56,304,2486,9.1
11771,Jaroslav Spacek,2013-14,39.0,15,16,59,59,1,15,16,65.0,1135.0,834,77,263,340,1293.0,82,5.46,52,291,2492,9.0
11772,Jaroslav Spacek,2014-15,40.0,16,15,46,46,5,10,15,42.0,740.0,880,82,273,355,1335.0,82,5.32,47,271,2439,8.9
11773,Jaroslav Svejkovsky,1999-00,23.0,4,10,19,19,7,3,10,30.0,,19,7,3,10,30.0,82,5.83,55,336,2444,9.8
11774,Jaroslav Svejkovsky,2000-01,24.0,5,5,17,17,4,1,5,29.0,,36,11,4,15,59.0,82,5.28,57,380,2242,9.6
11775,Jaroslav Svejkovsky,2001-02,25.0,6,14,25,25,6,8,14,50.0,340.0,61,17,12,29,109.0,82,5.27,57,359,2285,9.4
11776,Jaroslav Svejkovsky,2002-03,26.0,7,13,52,52,6,7,13,60.0,565.0,113,23,19,42,169.0,82,5.49,53,331,2294,9.8
11777,Jaroslav Svoboda,2004-05,24.0,4,4,10,10,2,2,4,12.0,94.0,10,2,2,4,12.0,82,5.24,53,338,2262,9.5
11778,Jaroslav Svoboda,2005-06,25.0,5,14,48,48,3,11,14,63.0,699.0,58,5,13,18,75.0,82,5.31,60,363,2326,9.4
11779,Jaroslav Svoboda,2006-07,26.0,6,4,33,33,3,1,4,27.0,301.0,91,8,14,22,102.0,82,5.14,57,348,2300,9.2
11780,Jaroslav Svoboda,2008-09,28.0,7,7,43,43,4,3,7,33.0,304.0,134,12,17,29,135.0,82,6.05,85,480,2458,10.1
11781,Jarred Tinordi,2015-16,23.0,4,2,8,8,0,2,2,5.0,94.0,8,0,2,2,5.0,48,5.31,29,160,1399,9.1
11782,Jarred Tinordi,2016-17,24.0,5,2,22,22,0,2,2,10.0,320.0,30,0,4,4,15.0,82,5.34,48,269,2463,8.9
11783,Jarred Tinordi,2017-18,25.0,6,2,13,13,0,2,2,5.0,157.0,43,0,6,6,20.0,82,5.32,47,251,2453,8.9
11784,Jarred Tinordi,2018-19,26.0,7,0,10,10,0,0,0,3.0,143.0,53,0,6,6,23.0,82,5.34,48,255,2438,9.0
11785,Jarred Tinordi,2022-23,30.0,8,5,28,28,1,4,5,20.0,465.0,81,1,10,11,43.0,70,5.96,42,208,2192,9.5
11786,Jarret Stoll,2005-06,23.0,4,1,4,4,0,1,1,5.0,31.0,4,0,1,1,5.0,82,5.31,60,363,2326,9.4
11787,Jarret Stoll,2006-07,24.0,5,21,68,68,10,11,21,107.0,945.0,72,10,12,22,112.0,82,5.14,57,348,2300,9.2
11788,Jarret Stoll,2008-09,26.0,6,68,82,82,22,46,68,243.0,1507.0,154,32,58,90,355.0,82,6.05,85,480,2458,10.1
11789,Jarret Stoll,2009-10,27.0,7,39,51,51,13,26,39,115.0,928.0,205,45,84,129,470.0,82,5.76,70,398,2426,9.7
11790,Jarret Stoll,2010-11,28.0,8,36,81,81,14,22,36,187.0,1453.0,286,59,106,165,657.0,82,5.44,62,351,2383,9.4
11791,Jarret Stoll,2011-12,29.0,9,41,74,74,18,23,41,155.0,1264.0,360,77,129,206,812.0,82,5.7,65,341,2477,9.4
11792,Jarret Stoll,2012-13,30.0,10,47,73,73,16,31,47,164.0,1272.0,433,93,160,253,976.0,82,5.53,56,304,2486,9.1
11793,Jarret Stoll,2013-14,31.0,11,43,82,82,20,23,43,187.0,1407.0,515,113,183,296,1163.0,82,5.46,52,291,2492,9.0
11794,Jarret Stoll,2014-15,32.0,12,21,78,78,6,15,21,133.0,1301.0,593,119,198,317,1296.0,82,5.32,47,271,2439,8.9
11795,Jarret Stoll,2015-16,33.0,13,18,48,48,7,11,18,73.0,793.0,641,126,209,335,1369.0,48,5.31,29,160,1399,9.1
11796,Jarret Stoll,2016-17,34.0,14,27,78,78,8,19,27,109.0,1237.0,719,134,228,362,1478.0,82,5.34,48,269,2463,8.9
11797,Jarret Stoll,2017-18,35.0,15,17,73,73,6,11,17,83.0,1131.0,792,140,239,379,1561.0,82,5.32,47,251,2453,8.9
11798,Jarret Stoll,2018-19,36.0,16,9,80,80,4,5,9,49.0,974.0,872,144,244,388,1610.0,82,5.34,48,255,2438,9.0
11799,Jarrett Deuling,1998-99,24.0,4,1,14,14,0,1,1,11.0,,14,0,1,1,11.0,82,6.29,74,413,2481,10.4
11800,Jarrett Deuling,1999-00,25.0,5,0,1,1,0,0,0,0.0,,15,0,1,1,11.0,82,5.83,55,336,2444,9.8
11801,Jarrod Skalde,1993-94,22.0,4,1,1,1,0,1,1,2.0,,1,0,1,1,2.0,80,6.91,71,366,2385,11.6
11802,Jarrod Skalde,1994-95,23.0,5,6,15,15,2,4,6,25.0,,16,2,5,7,27.0,80,6.96,77,402,2440,11.4
11803,Jarrod Skalde,1995-96,24.0,6,2,11,11,0,2,2,11.0,,27,2,7,9,38.0,84,7.25,87,443,2603,11.7
11804,Jarrod Skalde,1996-97,25.0,7,9,20,20,5,4,9,25.0,,47,7,11,18,63.0,84,6.48,76,407,2545,10.7
11805,Jarrod Skalde,1998-99,27.0,8,0,1,1,0,0,0,0.0,,48,7,11,18,63.0,82,6.29,74,413,2481,10.4
11806,Jarrod Skalde,2000-01,29.0,9,11,30,30,4,7,11,34.0,,78,11,18,29,97.0,82,5.28,57,380,2242,9.6
11807,Jarrod Skalde,2001-02,30.0,10,2,17,17,1,1,2,17.0,172.0,95,12,19,31,114.0,82,5.27,57,359,2285,9.4
11808,Jarrod Skalde,2003-04,32.0,11,3,19,19,1,2,3,24.0,265.0,114,13,21,34,138.0,82,5.51,63,376,2272,9.9
11809,Jarrod Skalde,2004-05,33.0,12,0,1,1,0,0,0,5.0,12.0,115,13,21,34,143.0,82,5.24,53,338,2262,9.5
11810,Jason Akeson,2015-16,25.0,4,1,1,1,1,0,1,2.0,12.0,1,1,0,1,2.0,48,5.31,29,160,1399,9.1
11811,Jason Akeson,2016-17,26.0,5,1,1,1,0,1,1,2.0,13.0,2,1,1,2,4.0,82,5.34,48,269,2463,8.9
11812,Jason Akeson,2017-18,27.0,6,0,13,13,0,0,0,9.0,105.0,15,1,1,2,13.0,82,5.32,47,251,2453,8.9
11813,Jason Allison,1996-97,21.0,4,1,2,2,0,1,1,5.0,,2,0,1,1,5.0,84,6.48,76,407,2545,10.7
11814,Jason Allison,1997-98,22.0,5,3,12,12,2,1,3,9.0,,14,2,2,4,14.0,48,5.97,37,209,1408,10.2
11815,Jason Allison,1998-99,23.0,6,3,19,19,0,3,3,18.0,,33,2,5,7,32.0,82,6.29,74,413,2481,10.4
11816,Jason Allison,1999-00,24.0,7,34,72,72,8,26,34,99.0,,105,10,31,41,131.0,82,5.83,55,336,2444,9.8
11817,Jason Allison,2000-01,25.0,8,83,81,81,33,50,83,158.0,,186,43,81,124,289.0,82,5.28,57,380,2242,9.6
11818,Jason Allison,2001-02,26.0,9,76,82,82,23,53,76,158.0,1835.0,268,66,134,200,447.0,82,5.27,57,359,2285,9.4
11819,Jason Allison,2002-03,27.0,10,28,37,37,10,18,28,66.0,797.0,305,76,152,228,513.0,82,5.49,53,331,2294,9.8
11820,Jason Allison,2003-04,28.0,11,95,82,82,36,59,95,185.0,1915.0,387,112,211,323,698.0,82,5.51,63,376,2272,9.9
11821,Jason Allison,2004-05,29.0,12,74,73,73,19,55,74,139.0,1591.0,460,131,266,397,837.0,82,5.24,53,338,2262,9.5
11822,Jason Allison,2005-06,30.0,13,28,26,26,6,22,28,46.0,562.0,486,137,288,425,883.0,82,5.31,60,363,2326,9.4
11823,Jason Allison,2008-09,33.0,14,60,66,66,17,43,60,111.0,1234.0,552,154,331,485,994.0,82,6.05,85,480,2458,10.1
11824,Jason Arnott,1996-97,22.0,4,68,78,78,33,35,68,194.0,,78,33,35,68,194.0,84,6.48,76,407,2545,10.7
11825,Jason Arnott,1997-98,23.0,5,37,42,42,15,22,37,156.0,,120,48,57,105,350.0,48,5.97,37,209,1408,10.2
11826,Jason Arnott,1998-99,24.0,6,59,64,64,28,31,59,244.0,,184,76,88,164,594.0,82,6.29,74,413,2481,10.4
11827,Jason Arnott,1999-00,25.0,7,57,67,67,19,38,57,248.0,,251,95,126,221,842.0,82,5.83,55,336,2444,9.8
11828,Jason Arnott,2000-01,26.0,8,33,70,70,10,23,33,199.0,,321,105,149,254,1041.0,82,5.28,57,380,2242,9.6
11829,Jason Arnott,2001-02,27.0,9,54,74,74,27,27,54,200.0,1140.0,395,132,176,308,1241.0,82,5.27,57,359,2285,9.4
11830,Jason Arnott,2002-03,28.0,10,56,76,76,22,34,56,244.0,1299.0,471,154,210,364,1485.0,82,5.49,53,331,2294,9.8
11831,Jason Arnott,2003-04,29.0,11,55,54,54,21,34,55,138.0,875.0,525,175,244,419,1623.0,82,5.51,63,376,2272,9.9
11832,Jason Arnott,2004-05,30.0,12,45,73,73,25,20,45,197.0,1267.0,598,200,264,464,1820.0,82,5.24,53,338,2262,9.5
11833,Jason Arnott,2005-06,31.0,13,47,72,72,23,24,47,169.0,1166.0,670,223,288,511,1989.0,82,5.31,60,363,2326,9.4
11834,Jason Arnott,2006-07,32.0,14,57,73,73,21,36,57,143.0,1241.0,743,244,324,568,2132.0,82,5.14,57,348,2300,9.2
11835,Jason Arnott,2008-09,34.0,15,76,81,81,32,44,76,167.0,1393.0,824,276,368,644,2299.0,82,6.05,85,480,2458,10.1
11836,Jason Arnott,2009-10,35.0,16,54,68,68,27,27,54,190.0,1223.0,892,303,395,698,2489.0,82,5.76,70,398,2426,9.7
11837,Jason Arnott,2010-11,36.0,17,72,79,79,28,44,72,248.0,1500.0,971,331,439,770,2737.0,82,5.44,62,351,2383,9.4
11838,Jason Arnott,2011-12,37.0,18,57,65,65,33,24,57,196.0,1229.0,1036,364,463,827,2933.0,82,5.7,65,341,2477,9.4
11839,Jason Arnott,2012-13,38.0,19,46,63,63,19,27,46,216.0,1178.0,1099,383,490,873,3149.0,82,5.53,56,304,2486,9.1
11840,Jason Arnott,2013-14,39.0,20,31,73,73,17,14,31,169.0,1133.0,1172,400,504,904,3318.0,82,5.46,52,291,2492,9.0
11841,Jason Arnott,2014-15,40.0,21,34,72,72,17,17,34,142.0,1014.0,1244,417,521,938,3460.0,82,5.32,47,271,2439,8.9
11842,Jason Blake,2001-02,28.0,4,1,1,1,1,0,1,5.0,17.0,1,1,0,1,5.0,82,5.27,57,359,2285,9.4
11843,Jason Blake,2002-03,29.0,5,23,64,64,5,18,23,131.0,722.0,65,6,18,24,136.0,82,5.49,53,331,2294,9.8
11844,Jason Blake,2003-04,30.0,6,16,47,47,5,11,16,100.0,642.0,112,11,29,40,236.0,82,5.51,63,376,2272,9.9
11845,Jason Blake,2004-05,31.0,7,18,82,82,8,10,18,136.0,1057.0,194,19,39,58,372.0,82,5.24,53,338,2262,9.5
11846,Jason Blake,2005-06,32.0,8,55,81,81,25,30,55,253.0,1429.0,275,44,69,113,625.0,82,5.31,60,363,2326,9.4
11847,Jason Blake,2006-07,33.0,9,47,75,75,22,25,47,243.0,1411.0,350,66,94,160,868.0,82,5.14,57,348,2300,9.2
11848,Jason Blake,2008-09,35.0,10,57,76,76,28,29,57,304.0,1427.0,426,94,123,217,1172.0,82,6.05,85,480,2458,10.1
11849,Jason Blake,2009-10,36.0,11,69,82,82,40,29,69,305.0,1488.0,508,134,152,286,1477.0,82,5.76,70,398,2426,9.7
11850,Jason Blake,2010-11,37.0,12,52,82,82,15,37,52,332.0,1461.0,590,149,189,338,1809.0,82,5.44,62,351,2383,9.4
11851,Jason Blake,2011-12,38.0,13,63,78,78,25,38,63,302.0,1431.0,668,174,227,401,2111.0,82,5.7,65,341,2477,9.4
11852,Jason Blake,2012-13,39.0,14,41,82,82,16,25,41,239.0,1304.0,750,190,252,442,2350.0,82,5.53,56,304,2486,9.1
11853,Jason Blake,2013-14,40.0,15,32,76,76,16,16,32,187.0,1122.0,826,206,268,474,2537.0,82,5.46,52,291,2492,9.0
11854,Jason Blake,2014-15,41.0,16,12,45,45,7,5,12,109.0,636.0,871,213,273,486,2646.0,82,5.32,47,271,2439,8.9
11855,Jason Bonsignore,1997-98,21.0,4,1,1,1,1,0,1,3.0,,1,1,0,1,3.0,48,5.97,37,209,1408,10.2
11856,Jason Bonsignore,1998-99,22.0,5,2,20,20,0,2,2,13.0,,21,1,2,3,16.0,82,6.29,74,413,2481,10.4
11857,Jason Bonsignore,2000-01,24.0,6,10,35,35,2,8,10,29.0,,56,3,10,13,45.0,82,5.28,57,380,2242,9.6
11858,Jason Bonsignore,2001-02,25.0,7,3,23,23,0,3,3,12.0,171.0,79,3,13,16,57.0,82,5.27,57,359,2285,9.4
11859,Jason Botterill,2000-01,24.0,4,0,4,4,0,0,0,2.0,,4,0,0,0,2.0,82,5.28,57,380,2242,9.6
11860,Jason Botterill,2001-02,25.0,5,0,17,17,0,0,0,8.0,141.0,21,0,0,0,10.0,82,5.27,57,359,2285,9.4
11861,Jason Botterill,2002-03,26.0,6,5,27,27,1,4,5,19.0,298.0,48,1,4,5,29.0,82,5.49,53,331,2294,9.8
11862,Jason Botterill,2004-05,28.0,7,1,4,4,1,0,1,4.0,38.0,52,2,4,6,33.0,82,5.24,53,338,2262,9.5
11863,Jason Botterill,2005-06,29.0,8,5,17,17,1,4,5,20.0,184.0,69,3,8,11,53.0,82,5.31,60,363,2326,9.4
11864,Jason Botterill,2006-07,30.0,9,3,19,19,2,1,3,20.0,217.0,88,5,9,14,73.0,82,5.14,57,348,2300,9.2
11865,Jason Bowen,1995-96,22.0,4,1,7,7,1,0,1,3.0,,7,1,0,1,3.0,84,7.25,87,443,2603,11.7
11866,Jason Bowen,1996-97,23.0,5,6,56,56,1,5,6,50.0,,63,2,5,7,53.0,84,6.48,76,407,2545,10.7
11867,Jason Bowen,1997-98,24.0,6,0,4,4,0,0,0,2.0,,67,2,5,7,55.0,48,5.97,37,209,1408,10.2
11868,Jason Bowen,1998-99,25.0,7,0,2,2,0,0,0,2.0,,69,2,5,7,57.0,82,6.29,74,413,2481,10.4
11869,Jason Bowen,1999-00,26.0,8,1,4,4,0,1,1,1.0,,73,2,6,8,58.0,82,5.83,55,336,2444,9.8
11870,Jason Bowen,2000-01,27.0,9,0,4,4,0,0,0,3.0,,77,2,6,8,61.0,82,5.28,57,380,2242,9.6
11871,Jason Chimera,2003-04,24.0,4,0,1,1,0,0,0,0.0,7.0,1,0,0,0,0.0,82,5.51,63,376,2272,9.9
11872,Jason Chimera,2004-05,25.0,5,1,3,3,1,0,1,3.0,38.0,4,1,0,1,3.0,82,5.24,53,338,2262,9.5
11873,Jason Chimera,2005-06,26.0,6,23,66,66,14,9,23,90.0,710.0,70,15,9,24,93.0,82,5.31,60,363,2326,9.4
11874,Jason Chimera,2006-07,27.0,7,12,60,60,4,8,12,79.0,607.0,130,19,17,36,172.0,82,5.14,57,348,2300,9.2
11875,Jason Chimera,2008-09,29.0,8,30,80,80,17,13,30,127.0,1014.0,210,36,30,66,299.0,82,6.05,85,480,2458,10.1
11876,Jason Chimera,2009-10,30.0,9,36,82,82,15,21,36,151.0,1260.0,292,51,51,102,450.0,82,5.76,70,398,2426,9.7
11877,Jason Chimera,2010-11,31.0,10,31,81,81,14,17,31,198.0,1417.0,373,65,68,133,648.0,82,5.44,62,351,2383,9.4
11878,Jason Chimera,2011-12,32.0,11,22,49,49,8,14,22,115.0,796.0,422,73,82,155,763.0,82,5.7,65,341,2477,9.4
11879,Jason Chimera,2012-13,33.0,12,34,78,78,15,19,34,160.0,1068.0,500,88,101,189,923.0,82,5.53,56,304,2486,9.1
11880,Jason Chimera,2013-14,34.0,13,26,81,81,10,16,26,162.0,1074.0,581,98,117,215,1085.0,82,5.46,52,291,2492,9.0
11881,Jason Chimera,2014-15,35.0,14,39,82,82,20,19,39,205.0,1184.0,663,118,136,254,1290.0,82,5.32,47,271,2439,8.9
11882,Jason Chimera,2015-16,36.0,15,14,47,47,3,11,14,92.0,596.0,710,121,147,268,1382.0,48,5.31,29,160,1399,9.1
11883,Jason Chimera,2016-17,37.0,16,42,82,82,15,27,42,167.0,1264.0,792,136,174,310,1549.0,82,5.34,48,269,2463,8.9
11884,Jason Chimera,2017-18,38.0,17,19,77,77,7,12,19,96.0,996.0,869,143,186,329,1645.0,82,5.32,47,251,2453,8.9
11885,Jason Chimera,2018-19,39.0,18,40,82,82,20,20,40,165.0,1152.0,951,163,206,369,1810.0,82,5.34,48,255,2438,9.0
11886,Jason Chimera,2019-20,40.0,19,33,82,82,20,13,33,121.0,1071.0,1033,183,219,402,1931.0,82,5.45,47,245,2478,9.0
11887,Jason Chimera,2020-21,41.0,20,13,74,74,3,10,13,79.0,762.0,1107,186,229,415,2010.0,82,5.86,50,250,2620,9.2
11888,Jason Cirone,1994-95,23.0,4,0,3,3,0,0,0,1.0,,3,0,0,0,1.0,80,6.96,77,402,2440,11.4
11889,Jason Dawe,1996-97,23.0,4,13,32,32,6,7,13,35.0,,32,6,7,13,35.0,84,6.48,76,407,2545,10.7
11890,Jason Dawe,1997-98,24.0,5,11,42,42,7,4,11,51.0,,74,13,11,24,86.0,48,5.97,37,209,1408,10.2
11891,Jason Dawe,1998-99,25.0,6,50,67,67,25,25,50,130.0,,141,38,36,74,216.0,82,6.29,74,413,2481,10.4
11892,Jason Dawe,1999-00,26.0,7,48,81,81,22,26,48,136.0,,222,60,62,122,352.0,82,5.83,55,336,2444,9.8
11893,Jason Dawe,2000-01,27.0,8,39,81,81,20,19,39,134.0,,303,80,81,161,486.0,82,5.28,57,380,2242,9.6
11894,Jason Dawe,2001-02,28.0,9,14,59,59,6,8,14,81.0,669.0,362,86,89,175,567.0,82,5.27,57,359,2285,9.4
11895,Jason Dawe,2002-03,29.0,10,1,3,3,0,1,1,8.0,41.0,365,86,90,176,575.0,82,5.49,53,331,2294,9.8
11896,Jason Dawe,2004-05,31.0,11,0,1,1,0,0,0,1.0,9.0,366,86,90,176,576.0,82,5.24,53,338,2262,9.5
11897,Jason Demers,2012-13,24.0,4,21,51,51,4,17,21,52.0,787.0,51,4,17,21,52.0,82,5.53,56,304,2486,9.1
11898,Jason Demers,2013-14,25.0,5,24,75,75,2,22,24,105.0,1462.0,126,6,39,45,157.0,82,5.46,52,291,2492,9.0
11899,Jason Demers,2014-15,26.0,6,13,57,57,4,9,13,73.0,960.0,183,10,48,58,230.0,82,5.32,47,271,2439,8.9
11900,Jason Demers,2015-16,27.0,7,3,22,22,1,2,3,27.0,410.0,205,11,50,61,257.0,48,5.31,29,160,1399,9.1
11901,Jason Demers,2016-17,28.0,8,34,75,75,5,29,34,105.0,1462.0,280,16,79,95,362.0,82,5.34,48,269,2463,8.9
11902,Jason Demers,2017-18,29.0,9,25,81,81,5,20,25,99.0,1549.0,361,21,99,120,461.0,82,5.32,47,251,2453,8.9
11903,Jason Demers,2018-19,30.0,10,23,62,62,7,16,23,94.0,1294.0,423,28,115,143,555.0,82,5.34,48,255,2438,9.0
11904,Jason Demers,2019-20,31.0,11,28,81,81,9,19,28,98.0,1588.0,504,37,134,171,653.0,82,5.45,47,245,2478,9.0
11905,Jason Demers,2020-21,32.0,12,20,69,69,6,14,20,95.0,1458.0,573,43,148,191,748.0,82,5.86,50,250,2620,9.2
11906,Jason Demers,2021-22,33.0,13,8,35,35,2,6,8,39.0,700.0,608,45,154,199,787.0,82,5.96,47,239,2579,9.5
11907,Jason Demers,2022-23,34.0,14,11,50,50,0,11,11,53.0,1025.0,658,45,165,210,840.0,70,5.96,42,208,2192,9.5
11908,Jason Dickinson,2018-19,23.0,4,1,1,1,1,0,1,2.0,12.0,1,1,0,1,2.0,82,5.34,48,255,2438,9.0
11909,Jason Dickinson,2019-20,24.0,5,2,10,10,2,0,2,9.0,118.0,11,3,0,3,11.0,82,5.45,47,245,2478,9.0
11910,Jason Dickinson,2020-21,25.0,6,2,27,27,0,2,2,16.0,230.0,38,3,2,5,27.0,82,5.86,50,250,2620,9.2
11911,Jason Dickinson,2021-22,26.0,7,22,67,67,6,16,22,94.0,896.0,105,9,18,27,121.0,82,5.96,47,239,2579,9.5
11912,Jason Dickinson,2022-23,27.0,8,21,65,65,9,12,21,85.0,973.0,170,18,30,48,206.0,70,5.96,42,208,2192,9.5
11913,Jason Doig,1998-99,22.0,4,2,15,15,1,1,2,7.0,,15,1,1,2,7.0,82,6.29,74,413,2481,10.4
11914,Jason Doig,2000-01,24.0,5,1,4,4,0,1,1,1.0,,19,1,2,3,8.0,82,5.28,57,380,2242,9.6
11915,Jason Doig,2001-02,25.0,6,1,9,9,0,1,1,0.0,46.0,28,1,3,4,8.0,82,5.27,57,359,2285,9.4
11916,Jason Doig,2002-03,26.0,7,1,7,7,0,1,1,3.0,62.0,35,1,4,5,11.0,82,5.49,53,331,2294,9.8
11917,Jason Doig,2003-04,27.0,8,0,3,3,0,0,0,1.0,20.0,38,1,4,5,12.0,82,5.51,63,376,2272,9.9
11918,Jason Doig,2005-06,29.0,9,8,55,55,3,5,8,41.0,780.0,93,4,9,13,53.0,82,5.31,60,363,2326,9.4
11919,Jason Doig,2006-07,30.0,10,11,65,65,2,9,11,59.0,1244.0,158,6,18,24,112.0,82,5.14,57,348,2300,9.2
11920,Jason Garrison,2011-12,27.0,4,0,1,1,0,0,0,0.0,12.0,1,0,0,0,0.0,82,5.7,65,341,2477,9.4
11921,Jason Garrison,2012-13,28.0,5,8,39,39,2,6,8,24.0,590.0,40,2,6,8,24.0,82,5.53,56,304,2486,9.1
11922,Jason Garrison,2013-14,29.0,6,18,73,73,5,13,18,116.0,1627.0,113,7,19,26,140.0,82,5.46,52,291,2492,9.0
11923,Jason Garrison,2014-15,30.0,7,33,77,77,16,17,33,168.0,1825.0,190,23,36,59,308.0,82,5.32,47,271,2439,8.9
11924,Jason Garrison,2015-16,31.0,8,16,47,47,8,8,16,94.0,1019.0,237,31,44,75,402.0,48,5.31,29,160,1399,9.1
11925,Jason Garrison,2016-17,32.0,9,33,81,81,7,26,33,181.0,1693.0,318,38,70,108,583.0,82,5.34,48,269,2463,8.9
11926,Jason Garrison,2017-18,33.0,10,30,70,70,4,26,30,111.0,1401.0,388,42,96,138,694.0,82,5.32,47,251,2453,8.9
11927,Jason Garrison,2018-19,34.0,11,11,72,72,5,6,11,99.0,1329.0,460,47,102,149,793.0,82,5.34,48,255,2438,9.0
11928,Jason Garrison,2019-20,35.0,12,9,70,70,1,8,9,96.0,1300.0,530,48,110,158,889.0,82,5.45,47,245,2478,9.0
11929,Jason Garrison,2020-21,36.0,13,1,8,8,0,1,1,7.0,153.0,538,48,111,159,896.0,82,5.86,50,250,2620,9.2
11930,Jason Garrison,2021-22,37.0,14,1,17,17,1,0,1,16.0,216.0,555,49,111,160,912.0,82,5.96,47,239,2579,9.5
11931,Jason Herter,1998-99,28.0,4,1,1,1,0,1,1,1.0,,1,0,1,1,1.0,82,6.29,74,413,2481,10.4
11932,Jason Holland,1999-00,23.0,4,1,4,4,1,0,1,3.0,,4,1,0,1,3.0,82,5.83,55,336,2444,9.8
11933,Jason Holland,2000-01,24.0,5,0,8,8,0,0,0,6.0,,12,1,0,1,9.0,82,5.28,57,380,2242,9.6
11934,Jason Holland,2001-02,25.0,6,0,3,3,0,0,0,2.0,33.0,15,1,0,1,11.0,82,5.27,57,359,2285,9.4
11935,Jason Holland,2002-03,26.0,7,1,9,9,0,1,1,8.0,140.0,24,1,1,2,19.0,82,5.49,53,331,2294,9.8
11936,Jason Holland,2004-05,28.0,8,0,3,3,0,0,0,1.0,48.0,27,1,1,2,20.0,82,5.24,53,338,2262,9.5
11937,Jason Holland,2005-06,29.0,9,1,2,2,0,1,1,0.0,27.0,29,1,2,3,20.0,82,5.31,60,363,2326,9.4
11938,Jason Holland,2006-07,30.0,10,6,52,52,3,3,6,64.0,920.0,81,4,5,9,84.0,82,5.14,57,348,2300,9.2
11939,Jason Jaffray,2010-11,29.0,4,6,19,19,2,4,6,15.0,239.0,19,2,4,6,15.0,82,5.44,62,351,2383,9.4
11940,Jason Jaffray,2011-12,30.0,5,4,14,14,2,2,4,11.0,127.0,33,4,6,10,26.0,82,5.7,65,341,2477,9.4
11941,Jason Jaffray,2012-13,31.0,6,0,3,3,0,0,0,4.0,20.0,36,4,6,10,30.0,82,5.53,56,304,2486,9.1
11942,Jason Jaffray,2014-15,33.0,7,1,13,13,0,1,1,10.0,85.0,49,4,7,11,40.0,82,5.32,47,271,2439,8.9
11943,Jason Jaspers,2004-05,23.0,4,1,4,4,0,1,1,1.0,32.0,4,0,1,1,1.0,82,5.24,53,338,2262,9.5
11944,Jason Jaspers,2005-06,24.0,5,0,2,2,0,0,0,0.0,15.0,6,0,1,1,1.0,82,5.31,60,363,2326,9.4
11945,Jason Jaspers,2006-07,25.0,6,0,3,3,0,0,0,3.0,34.0,9,0,1,1,4.0,82,5.14,57,348,2300,9.2
11946,Jason King,2005-06,24.0,4,2,8,8,0,2,2,12.0,90.0,8,0,2,2,12.0,82,5.31,60,363,2326,9.4
11947,Jason King,2006-07,25.0,5,21,47,47,12,9,21,107.0,597.0,55,12,11,23,119.0,82,5.14,57,348,2300,9.2
11948,Jason King,2010-11,29.0,6,0,4,4,0,0,0,2.0,44.0,59,12,11,23,121.0,82,5.44,62,351,2383,9.4
11949,Jason Krog,2002-03,27.0,4,6,17,17,2,4,6,22.0,171.0,17,2,4,6,22.0,82,5.49,53,331,2294,9.8
11950,Jason Krog,2003-04,28.0,5,3,9,9,0,3,3,7.0,95.0,26,2,7,9,29.0,82,5.51,63,376,2272,9.9
11951,Jason Krog,2004-05,29.0,6,0,2,2,0,0,0,0.0,13.0,28,2,7,9,29.0,82,5.24,53,338,2262,9.5
11952,Jason Krog,2005-06,30.0,7,25,67,67,10,15,25,92.0,923.0,95,12,22,34,121.0,82,5.31,60,363,2326,9.4
11953,Jason Krog,2006-07,31.0,8,18,80,80,6,12,18,111.0,958.0,175,18,34,52,232.0,82,5.14,57,348,2300,9.2
11954,Jason Krog,2009-10,34.0,9,6,23,23,3,3,6,22.0,285.0,198,21,37,58,254.0,82,5.76,70,398,2426,9.7
11955,Jason Krog,2011-12,36.0,10,1,4,4,1,0,1,5.0,41.0,202,22,37,59,259.0,82,5.7,65,341,2477,9.4
11956,Jason Lafreniere,1989-90,23.0,4,28,56,56,13,15,28,55.0,,56,13,15,28,55.0,80,7.34,72,344,2400,12.2
11957,Jason Lafreniere,1990-91,24.0,5,29,40,40,10,19,29,54.0,,96,23,34,57,109.0,80,7.43,89,437,2435,12.2
11958,Jason Lafreniere,1991-92,25.0,6,24,38,38,8,16,24,42.0,,134,31,50,81,151.0,80,7.48,85,403,2430,12.3
11959,Jason Lafreniere,1995-96,29.0,7,6,11,11,3,3,6,17.0,,145,34,53,87,168.0,84,7.25,87,443,2603,11.7
11960,Jason Lafreniere,1996-97,30.0,8,0,1,1,0,0,0,2.0,,146,34,53,87,170.0,84,6.48,76,407,2545,10.7
11961,Jason MacDonald,2006-07,32.0,4,0,4,4,0,0,0,3.0,33.0,4,0,0,0,3.0,82,5.14,57,348,2300,9.2
11962,Jason Marshall,1994-95,23.0,4,1,2,2,1,0,1,2.0,,2,1,0,1,2.0,80,6.96,77,402,2440,11.4
11963,Jason Marshall,1997-98,26.0,5,0,1,1,0,0,0,1.0,,3,1,0,1,3.0,48,5.97,37,209,1408,10.2
11964,Jason Marshall,1998-99,27.0,6,1,24,24,0,1,1,9.0,,27,1,1,2,12.0,82,6.29,74,413,2481,10.4
11965,Jason Marshall,1999-00,28.0,7,10,73,73,1,9,10,34.0,,100,2,10,12,46.0,82,5.83,55,336,2444,9.8
11966,Jason Marshall,2000-01,29.0,8,9,72,72,3,6,9,68.0,,172,5,16,21,114.0,82,5.28,57,380,2242,9.6
11967,Jason Marshall,2001-02,30.0,9,8,72,72,1,7,8,63.0,1375.0,244,6,23,29,177.0,82,5.27,57,359,2285,9.4
11968,Jason Marshall,2002-03,31.0,10,3,55,55,0,3,3,41.0,910.0,299,6,26,32,218.0,82,5.49,53,331,2294,9.8
11969,Jason Marshall,2003-04,32.0,11,7,55,55,3,4,7,43.0,789.0,354,9,30,39,261.0,82,5.51,63,376,2272,9.9
11970,Jason Marshall,2004-05,33.0,12,11,80,80,5,6,11,73.0,1304.0,434,14,36,50,334.0,82,5.24,53,338,2262,9.5
11971,Jason Marshall,2005-06,34.0,13,6,45,45,1,5,6,40.0,513.0,479,15,41,56,374.0,82,5.31,60,363,2326,9.4
11972,Jason Marshall,2006-07,35.0,14,7,24,24,1,6,7,30.0,379.0,503,16,47,63,404.0,82,5.14,57,348,2300,9.2
11973,Jason Marshall,2008-09,37.0,15,4,23,23,0,4,4,25.0,271.0,526,16,51,67,429.0,82,6.05,85,480,2458,10.1
11974,Jason McBain,1998-99,24.0,4,0,3,3,0,0,0,0.0,,3,0,0,0,0.0,82,6.29,74,413,2481,10.4
11975,Jason McBain,1999-00,25.0,5,0,6,6,0,0,0,1.0,,9,0,0,0,1.0,82,5.83,55,336,2444,9.8
11976,Jason Miller,1993-94,22.0,4,0,1,1,0,0,0,0.0,,1,0,0,0,0.0,80,6.91,71,366,2385,11.6
11977,Jason Miller,1994-95,23.0,5,0,3,3,0,0,0,1.0,,4,0,0,0,1.0,80,6.96,77,402,2440,11.4
11978,Jason Miller,1995-96,24.0,6,0,2,2,0,0,0,1.0,,6,0,0,0,2.0,84,7.25,87,443,2603,11.7
11979,Jason Morgan,1999-00,23.0,4,0,3,3,0,0,0,4.0,,3,0,0,0,4.0,82,5.83,55,336,2444,9.8
11980,Jason Morgan,2000-01,24.0,5,1,11,11,1,0,1,5.0,,14,1,0,1,9.0,82,5.28,57,380,2242,9.6
11981,Jason Morgan,2006-07,30.0,6,4,19,19,0,4,4,20.0,187.0,33,1,4,5,29.0,82,5.14,57,348,2300,9.2
11982,Jason Morgan,2008-09,32.0,7,2,7,7,1,1,2,6.0,71.0,40,2,5,7,35.0,82,6.05,85,480,2458,10.1
11983,Jason Morgan,2009-10,33.0,8,0,4,4,0,0,0,0.0,30.0,44,2,5,7,35.0,82,5.76,70,398,2426,9.7
11984,Jason Podollan,1999-00,23.0,4,5,29,29,1,4,5,30.0,,29,1,4,5,30.0,82,5.83,55,336,2444,9.8
11985,Jason Podollan,2001-02,25.0,5,0,10,10,0,0,0,9.0,87.0,39,1,4,5,39.0,82,5.27,57,359,2285,9.4
11986,Jason Podollan,2002-03,26.0,6,1,1,1,0,1,1,2.0,16.0,40,1,5,6,41.0,82,5.49,53,331,2294,9.8
11987,Jason Podollan,2004-05,28.0,7,0,1,1,0,0,0,1.0,4.0,41,1,5,6,42.0,82,5.24,53,338,2262,9.5
11988,Jason Pominville,2006-07,24.0,4,0,1,1,0,0,0,3.0,14.0,1,0,0,0,3.0,82,5.14,57,348,2300,9.2
11989,Jason Pominville,2008-09,26.0,5,30,57,57,18,12,30,124.0,805.0,58,18,12,30,127.0,82,6.05,85,480,2458,10.1
11990,Jason Pominville,2009-10,27.0,6,68,82,82,34,34,68,212.0,1428.0,140,52,46,98,339.0,82,5.76,70,398,2426,9.7
11991,Jason Pominville,2010-11,28.0,7,80,82,82,27,53,80,232.0,1637.0,222,79,99,178,571.0,82,5.44,62,351,2383,9.4
11992,Jason Pominville,2011-12,29.0,8,66,82,82,20,46,66,239.0,1620.0,304,99,145,244,810.0,82,5.7,65,341,2477,9.4
11993,Jason Pominville,2012-13,30.0,9,62,82,82,24,38,62,252.0,1537.0,386,123,183,306,1062.0,82,5.53,56,304,2486,9.1
11994,Jason Pominville,2013-14,31.0,10,52,73,73,22,30,52,215.0,1325.0,459,145,213,358,1277.0,82,5.46,52,291,2492,9.0
11995,Jason Pominville,2014-15,32.0,11,73,82,82,30,43,73,235.0,1614.0,541,175,256,431,1512.0,82,5.32,47,271,2439,8.9
11996,Jason Pominville,2015-16,33.0,12,34,47,47,14,20,34,118.0,948.0,588,189,276,465,1630.0,48,5.31,29,160,1399,9.1
11997,Jason Pominville,2016-17,34.0,13,60,82,82,30,30,60,226.0,1524.0,670,219,306,525,1856.0,82,5.34,48,269,2463,8.9
11998,Jason Pominville,2017-18,35.0,14,54,82,82,18,36,54,252.0,1499.0,752,237,342,579,2108.0,82,5.32,47,251,2453,8.9
11999,Jason Pominville,2018-19,36.0,15,36,75,75,11,25,36,187.0,1227.0,827,248,367,615,2295.0,82,5.34,48,255,2438,9.0
12000,Jason Pominville,2019-20,37.0,16,47,78,78,13,34,47,176.0,1110.0,905,261,401,662,2471.0,82,5.45,47,245,2478,9.0
12001,Jason Pominville,2020-21,38.0,17,34,82,82,16,18,34,168.0,1222.0,987,277,419,696,2639.0,82,5.86,50,250,2620,9.2
12002,Jason Pominville,2021-22,39.0,18,31,73,73,16,15,31,134.0,910.0,1060,293,434,727,2773.0,82,5.96,47,239,2579,9.5
12003,Jason Robertson,2022-23,23.0,4,1,3,3,0,1,1,4.0,37.0,3,0,1,1,4.0,70,5.96,42,208,2192,9.5
12004,Jason Ruff,1995-96,26.0,4,3,8,8,2,1,3,8.0,,8,2,1,3,8.0,84,7.25,87,443,2603,11.7
12005,Jason Ruff,1996-97,27.0,5,3,6,6,1,2,3,14.0,,14,3,3,6,22.0,84,6.48,76,407,2545,10.7
12006,Jason Ryznar,2008-09,25.0,4,0,8,8,0,0,0,1.0,43.0,8,0,0,0,1.0,82,6.05,85,480,2458,10.1
12007,Jason Simon,1996-97,27.0,4,0,4,4,0,0,0,0.0,,4,0,0,0,0.0,84,6.48,76,407,2545,10.7
12008,Jason Simon,1999-00,30.0,5,0,1,1,0,0,0,0.0,,5,0,0,0,0.0,82,5.83,55,336,2444,9.8
12009,Jason Smith,1996-97,23.0,4,5,41,41,0,5,5,47.0,,41,0,5,5,47.0,84,6.48,76,407,2545,10.7
12010,Jason Smith,1997-98,24.0,5,0,2,2,0,0,0,5.0,,43,0,5,5,52.0,48,5.97,37,209,1408,10.2
12011,Jason Smith,1998-99,25.0,6,3,64,64,2,1,3,52.0,,107,2,6,8,104.0,82,6.29,74,413,2481,10.4
12012,Jason Smith,1999-00,26.0,7,8,78,78,1,7,8,74.0,,185,3,13,16,178.0,82,5.83,55,336,2444,9.8
12013,Jason Smith,2000-01,27.0,8,16,81,81,3,13,16,97.0,,266,6,26,32,275.0,82,5.28,57,380,2242,9.6
12014,Jason Smith,2001-02,28.0,9,15,72,72,3,12,15,68.0,1296.0,338,9,38,47,343.0,82,5.27,57,359,2285,9.4
12015,Jason Smith,2002-03,29.0,10,14,80,80,3,11,14,96.0,1700.0,418,12,49,61,439.0,82,5.49,53,331,2294,9.8
12016,Jason Smith,2003-04,30.0,11,20,82,82,5,15,20,140.0,1776.0,500,17,64,81,579.0,82,5.51,63,376,2272,9.9
12017,Jason Smith,2004-05,31.0,12,18,74,74,5,13,18,85.0,1554.0,574,22,77,99,664.0,82,5.24,53,338,2262,9.5
12018,Jason Smith,2005-06,32.0,13,12,68,68,4,8,12,93.0,1480.0,642,26,85,111,757.0,82,5.31,60,363,2326,9.4
12019,Jason Smith,2006-07,33.0,14,19,68,68,7,12,19,84.0,1452.0,710,33,97,130,841.0,82,5.14,57,348,2300,9.2
12020,Jason Smith,2008-09,35.0,15,17,76,76,4,13,17,79.0,1493.0,786,37,110,147,920.0,82,6.05,85,480,2458,10.1
12021,Jason Smith,2009-10,36.0,16,11,82,82,2,9,11,61.0,1733.0,868,39,119,158,981.0,82,5.76,70,398,2426,9.7
12022,Jason Smith,2010-11,37.0,17,10,77,77,1,9,10,58.0,1381.0,945,40,128,168,1039.0,82,5.44,62,351,2383,9.4
12023,Jason Smith,2011-12,38.0,18,1,63,63,1,0,1,53.0,1105.0,1008,41,128,169,1092.0,82,5.7,65,341,2477,9.4
12024,Jason Spezza,2005-06,22.0,4,21,33,33,7,14,21,65.0,418.0,33,7,14,21,65.0,82,5.31,60,363,2326,9.4
12025,Jason Spezza,2006-07,23.0,5,55,78,78,22,33,55,142.0,1142.0,111,29,47,76,207.0,82,5.14,57,348,2300,9.2
12026,Jason Spezza,2008-09,25.0,6,90,68,68,19,71,90,156.0,1292.0,179,48,118,166,363.0,82,6.05,85,480,2458,10.1
12027,Jason Spezza,2009-10,26.0,7,87,67,67,34,53,87,162.0,1292.0,246,82,171,253,525.0,82,5.76,70,398,2426,9.7
12028,Jason Spezza,2010-11,27.0,8,92,76,76,34,58,92,210.0,1571.0,322,116,229,345,735.0,82,5.44,62,351,2383,9.4
12029,Jason Spezza,2011-12,28.0,9,73,82,82,32,41,73,246.0,1615.0,404,148,270,418,981.0,82,5.7,65,341,2477,9.4
12030,Jason Spezza,2012-13,29.0,10,57,60,60,23,34,57,165.0,1144.0,464,171,304,475,1146.0,82,5.53,56,304,2486,9.1
12031,Jason Spezza,2013-14,30.0,11,57,62,62,21,36,57,188.0,1252.0,526,192,340,532,1334.0,82,5.46,52,291,2492,9.0
12032,Jason Spezza,2014-15,31.0,12,84,80,80,34,50,84,232.0,1594.0,606,226,390,616,1566.0,82,5.32,47,271,2439,8.9
12033,Jason Spezza,2015-16,32.0,13,5,5,5,2,3,5,12.0,96.0,611,228,393,621,1578.0,48,5.31,29,160,1399,9.1
12034,Jason Spezza,2016-17,33.0,14,66,75,75,23,43,66,223.0,1366.0,686,251,436,687,1801.0,82,5.34,48,269,2463,8.9
12035,Jason Spezza,2017-18,34.0,15,62,82,82,17,45,62,204.0,1412.0,768,268,481,749,2005.0,82,5.32,47,251,2453,8.9
12036,Jason Spezza,2018-19,35.0,16,63,75,75,33,30,63,202.0,1239.0,843,301,511,812,2207.0,82,5.34,48,255,2438,9.0
12037,Jason Spezza,2019-20,36.0,17,50,68,68,15,35,50,149.0,1100.0,911,316,546,862,2356.0,82,5.45,47,245,2478,9.0
12038,Jason Spezza,2020-21,37.0,18,26,78,78,8,18,26,138.0,1014.0,989,324,564,888,2494.0,82,5.86,50,250,2620,9.2
12039,Jason Spezza,2021-22,38.0,19,27,76,76,8,19,27,121.0,1009.0,1065,332,583,915,2615.0,82,5.96,47,239,2579,9.5
12040,Jason Spezza,2022-23,39.0,20,25,58,58,9,16,25,73.0,628.0,1123,341,599,940,2688.0,70,5.96,42,208,2192,9.5
12041,Jason Strudwick,1998-99,23.0,4,0,1,1,0,0,0,0.0,,1,0,0,0,0.0,82,6.29,74,413,2481,10.4
12042,Jason Strudwick,2000-01,25.0,5,2,28,28,0,2,2,8.0,,29,0,2,2,8.0,82,5.28,57,380,2242,9.6
12043,Jason Strudwick,2001-02,26.0,6,3,65,65,0,3,3,25.0,833.0,94,0,5,5,33.0,82,5.27,57,359,2285,9.4
12044,Jason Strudwick,2002-03,27.0,7,4,63,63,1,3,4,18.0,958.0,157,1,8,9,51.0,82,5.49,53,331,2294,9.8
12045,Jason Strudwick,2003-04,28.0,8,5,60,60,1,4,5,21.0,599.0,217,2,12,14,72.0,82,5.51,63,376,2272,9.9
12046,Jason Strudwick,2004-05,29.0,9,6,44,44,2,4,6,13.0,429.0,261,4,16,20,85.0,82,5.24,53,338,2262,9.5
12047,Jason Strudwick,2005-06,30.0,10,5,48,48,2,3,5,19.0,409.0,309,6,19,25,104.0,82,5.31,60,363,2326,9.4
12048,Jason Strudwick,2006-07,31.0,11,4,54,54,1,3,4,32.0,805.0,363,7,22,29,136.0,82,5.14,57,348,2300,9.2
12049,Jason Strudwick,2008-09,33.0,12,7,65,65,3,4,7,31.0,1009.0,428,10,26,36,167.0,82,6.05,85,480,2458,10.1
12050,Jason Strudwick,2009-10,34.0,13,0,8,8,0,0,0,3.0,109.0,436,10,26,36,170.0,82,5.76,70,398,2426,9.7
12051,Jason Strudwick,2010-11,35.0,14,2,52,52,1,1,2,21.0,673.0,488,11,27,38,191.0,82,5.44,62,351,2383,9.4
12052,Jason Strudwick,2011-12,36.0,15,9,71,71,2,7,9,32.0,896.0,559,13,34,47,223.0,82,5.7,65,341,2477,9.4
12053,Jason Strudwick,2012-13,37.0,16,6,72,72,0,6,6,19.0,1219.0,631,13,40,53,242.0,82,5.53,56,304,2486,9.1
12054,Jason Strudwick,2013-14,38.0,17,2,43,43,0,2,2,9.0,648.0,674,13,42,55,251.0,82,5.46,52,291,2492,9.0
12055,Jason Ward,2002-03,24.0,4,3,32,32,2,1,3,24.0,294.0,32,2,1,3,24.0,82,5.49,53,331,2294,9.8
12056,Jason Ward,2003-04,25.0,5,0,12,12,0,0,0,4.0,99.0,44,2,1,3,28.0,82,5.51,63,376,2272,9.9
12057,Jason Ward,2005-06,27.0,6,5,8,8,3,2,5,10.0,90.0,52,5,3,8,38.0,82,5.31,60,363,2326,9.4
12058,Jason Ward,2006-07,28.0,7,12,53,53,5,7,12,56.0,671.0,105,10,10,20,94.0,82,5.14,57,348,2300,9.2
12059,Jason Ward,2008-09,30.0,8,28,81,81,10,18,28,125.0,1069.0,186,20,28,48,219.0,82,6.05,85,480,2458,10.1
12060,Jason Ward,2009-10,31.0,9,19,70,70,8,11,19,108.0,883.0,256,28,39,67,327.0,82,5.76,70,398,2426,9.7
12061,Jason Ward,2010-11,32.0,10,14,79,79,8,6,14,85.0,991.0,335,36,45,81,412.0,82,5.44,62,351,2383,9.4
12062,Jason Ward,2011-12,33.0,11,0,1,1,0,0,0,1.0,10.0,336,36,45,81,413.0,82,5.7,65,341,2477,9.4
12063,Jason Widmer,1997-98,24.0,4,0,1,1,0,0,0,0.0,,1,0,0,0,0.0,48,5.97,37,209,1408,10.2
12064,Jason Widmer,1998-99,25.0,5,0,4,4,0,0,0,1.0,,5,0,0,0,1.0,82,6.29,74,413,2481,10.4
12065,Jason Widmer,1999-00,26.0,6,1,2,2,0,1,1,0.0,,7,0,1,1,1.0,82,5.83,55,336,2444,9.8
12066,Jason Wiemer,1997-98,21.0,4,5,36,36,1,4,5,10.0,,36,1,4,5,10.0,48,5.97,37,209,1408,10.2
12067,Jason Wiemer,1998-99,22.0,5,18,66,66,9,9,18,89.0,,102,10,13,23,99.0,82,6.29,74,413,2481,10.4
12068,Jason Wiemer,1999-00,23.0,6,14,63,63,9,5,14,103.0,,165,19,18,37,202.0,82,5.83,55,336,2444,9.8
12069,Jason Wiemer,2000-01,24.0,7,22,79,79,12,10,22,122.0,,244,31,28,59,324.0,82,5.28,57,380,2242,9.6
12070,Jason Wiemer,2001-02,25.0,8,21,78,78,8,13,21,128.0,1036.0,322,39,41,80,452.0,82,5.27,57,359,2285,9.4
12071,Jason Wiemer,2002-03,26.0,9,22,64,64,11,11,22,104.0,940.0,386,50,52,102,556.0,82,5.49,53,331,2294,9.8
12072,Jason Wiemer,2003-04,27.0,10,15,65,65,10,5,15,76.0,905.0,451,60,57,117,632.0,82,5.51,63,376,2272,9.9
12073,Jason Wiemer,2004-05,28.0,11,31,70,70,11,20,31,115.0,1201.0,521,71,77,148,747.0,82,5.24,53,338,2262,9.5
12074,Jason Wiemer,2005-06,29.0,12,28,81,81,9,19,28,139.0,1008.0,602,80,96,176,886.0,82,5.31,60,363,2326,9.4
12075,Jason Wiemer,2006-07,30.0,13,22,75,75,8,14,22,103.0,1015.0,677,88,110,198,989.0,82,5.14,57,348,2300,9.2
12076,Jason Wiemer,2008-09,32.0,14,4,49,49,2,2,4,37.0,396.0,726,90,112,202,1026.0,82,6.05,85,480,2458,10.1
12077,Jason Williams,2003-04,23.0,4,3,5,5,0,3,3,7.0,62.0,5,0,3,3,7.0,82,5.51,63,376,2272,9.9
12078,Jason Williams,2004-05,24.0,5,10,25,25,8,2,10,32.0,271.0,30,8,5,13,39.0,82,5.24,53,338,2262,9.5
12079,Jason Williams,2005-06,25.0,6,6,16,16,3,3,6,20.0,171.0,46,11,8,19,59.0,82,5.31,60,363,2326,9.4
12080,Jason Williams,2006-07,26.0,7,13,49,49,6,7,13,44.0,463.0,95,17,15,32,103.0,82,5.14,57,348,2300,9.2
12081,Jason Williams,2008-09,28.0,8,58,80,80,21,37,58,177.0,1193.0,175,38,52,90,280.0,82,6.05,85,480,2458,10.1
12082,Jason Williams,2009-10,29.0,9,32,78,78,15,17,32,149.0,1203.0,253,53,69,122,429.0,82,5.76,70,398,2426,9.7
12083,Jason Williams,2010-11,30.0,10,36,43,43,13,23,36,101.0,713.0,296,66,92,158,530.0,82,5.44,62,351,2383,9.4
12084,Jason Williams,2011-12,31.0,11,47,80,80,19,28,47,153.0,1269.0,376,85,120,205,683.0,82,5.7,65,341,2477,9.4
12085,Jason Williams,2012-13,32.0,12,15,44,44,6,9,15,96.0,595.0,420,91,129,220,779.0,82,5.53,56,304,2486,9.1
12086,Jason Williams,2013-14,33.0,13,5,27,27,2,3,5,18.0,219.0,447,93,132,225,797.0,82,5.46,52,291,2492,9.0
12087,Jason Williams,2014-15,34.0,14,2,8,8,1,1,2,4.0,85.0,455,94,133,227,801.0,82,5.32,47,271,2439,8.9
12088,Jason Woolley,1994-95,25.0,4,0,1,1,0,0,0,2.0,,1,0,0,0,2.0,80,6.96,77,402,2440,11.4
12089,Jason Woolley,1995-96,26.0,5,2,26,26,0,2,2,11.0,,27,0,2,2,13.0,84,7.25,87,443,2603,11.7
12090,Jason Woolley,1996-97,27.0,6,3,10,10,1,2,3,15.0,,37,1,4,5,28.0,84,6.48,76,407,2545,10.7
12091,Jason Woolley,1997-98,28.0,7,13,34,34,4,9,13,76.0,,71,5,13,18,104.0,48,5.97,37,209,1408,10.2
12092,Jason Woolley,1998-99,29.0,8,34,52,52,6,28,34,98.0,,123,11,41,52,202.0,82,6.29,74,413,2481,10.4
12093,Jason Woolley,1999-00,30.0,9,36,60,60,6,30,36,86.0,,183,17,71,88,288.0,82,5.83,55,336,2444,9.8
12094,Jason Woolley,2000-01,31.0,10,35,71,71,9,26,35,129.0,,254,26,97,123,417.0,82,5.28,57,380,2242,9.6
12095,Jason Woolley,2001-02,32.0,11,43,80,80,10,33,43,154.0,1497.0,334,36,130,166,571.0,82,5.27,57,359,2285,9.4
12096,Jason Woolley,2002-03,33.0,12,33,74,74,8,25,33,113.0,1321.0,408,44,155,199,684.0,82,5.49,53,331,2294,9.8
12097,Jason Woolley,2003-04,34.0,13,23,67,67,5,18,23,92.0,1164.0,475,49,173,222,776.0,82,5.51,63,376,2272,9.9
12098,Jason Woolley,2004-05,35.0,14,28,59,59,8,20,28,90.0,1014.0,534,57,193,250,866.0,82,5.24,53,338,2262,9.5
12099,Jason Woolley,2005-06,36.0,15,26,76,76,6,20,26,81.0,1276.0,610,63,213,276,947.0,82,5.31,60,363,2326,9.4
12100,Jason Woolley,2006-07,37.0,16,19,55,55,4,15,19,60.0,864.0,665,67,228,295,1007.0,82,5.14,57,348,2300,9.2
12101,Jason Woolley,2008-09,39.0,17,19,53,53,1,18,19,43.0,631.0,718,68,246,314,1050.0,82,6.05,85,480,2458,10.1
12102,Jason York,1995-96,25.0,4,0,2,2,0,0,0,1.0,,2,0,0,0,1.0,84,7.25,87,443,2603,11.7
12103,Jason York,1996-97,26.0,5,3,7,7,1,2,3,9.0,,9,1,2,3,10.0,84,6.48,76,407,2545,10.7
12104,Jason York,1997-98,27.0,6,11,25,25,1,10,11,28.0,,34,2,12,14,38.0,48,5.97,37,209,1408,10.2
12105,Jason York,1998-99,28.0,7,24,79,79,3,21,24,106.0,,113,5,33,38,144.0,82,6.29,74,413,2481,10.4
12106,Jason York,1999-00,29.0,8,21,75,75,4,17,21,121.0,,188,9,50,59,265.0,82,5.83,55,336,2444,9.8
12107,Jason York,2000-01,30.0,9,16,73,73,3,13,16,109.0,,261,12,63,75,374.0,82,5.28,57,380,2242,9.6
12108,Jason York,2001-02,31.0,10,35,79,79,4,31,35,177.0,1882.0,340,16,94,110,551.0,82,5.27,57,359,2285,9.4
12109,Jason York,2002-03,32.0,11,30,79,79,8,22,30,159.0,1843.0,419,24,116,140,710.0,82,5.49,53,331,2294,9.8
12110,Jason York,2003-04,33.0,12,22,74,74,6,16,22,133.0,1762.0,493,30,132,162,843.0,82,5.51,63,376,2272,9.9
12111,Jason York,2004-05,34.0,13,25,74,74,5,20,25,104.0,1430.0,567,35,152,187,947.0,82,5.24,53,338,2262,9.5
12112,Jason York,2005-06,35.0,14,19,74,74,4,15,19,107.0,1477.0,641,39,167,206,1054.0,82,5.31,60,363,2326,9.4
12113,Jason York,2006-07,36.0,15,15,67,67,2,13,15,80.0,1426.0,708,41,180,221,1134.0,82,5.14,57,348,2300,9.2
12114,Jason York,2009-10,39.0,16,8,49,49,1,7,8,27.0,641.0,757,42,187,229,1161.0,82,5.76,70,398,2426,9.7
12115,Jason Zent,1999-00,28.0,4,6,22,22,3,3,6,20.0,,22,3,3,6,20.0,82,5.83,55,336,2444,9.8
12116,Jason Zent,2000-01,29.0,5,0,3,3,0,0,0,1.0,,25,3,3,6,21.0,82,5.28,57,380,2242,9.6
12117,Jason Zent,2001-02,30.0,6,0,2,2,0,0,0,1.0,6.0,27,3,3,6,22.0,82,5.27,57,359,2285,9.4
12118,Jason Zucker,2014-15,23.0,4,2,6,6,0,2,2,10.0,66.0,6,0,2,2,10.0,82,5.32,47,271,2439,8.9
12119,Jason Zucker,2015-16,24.0,5,5,20,20,4,1,5,34.0,225.0,26,4,3,7,44.0,48,5.31,29,160,1399,9.1
12120,Jason Zucker,2016-17,25.0,6,5,21,21,4,1,5,40.0,273.0,47,8,4,12,84.0,82,5.34,48,269,2463,8.9
12121,Jason Zucker,2017-18,26.0,7,26,51,51,21,5,26,124.0,768.0,98,29,9,38,208.0,82,5.32,47,251,2453,8.9
12122,Jason Zucker,2018-19,27.0,8,23,71,71,13,10,23,158.0,1106.0,169,42,19,61,366.0,82,5.34,48,255,2438,9.0
12123,Jason Zucker,2019-20,28.0,9,47,79,79,22,25,47,172.0,1208.0,248,64,44,108,538.0,82,5.45,47,245,2478,9.0
12124,Jason Zucker,2020-21,29.0,10,64,82,82,33,31,64,222.0,1391.0,330,97,75,172,760.0,82,5.86,50,250,2620,9.2
12125,Jason Zucker,2021-22,30.0,11,42,81,81,21,21,42,214.0,1383.0,411,118,96,214,974.0,82,5.96,47,239,2579,9.5
12126,Jason Zucker,2022-23,31.0,12,41,60,60,20,21,41,111.0,980.0,471,138,117,255,1085.0,70,5.96,42,208,2192,9.5
12127,Jassen Cullimore,1997-98,25.0,4,3,34,34,1,2,3,30.0,,34,1,2,3,30.0,48,5.97,37,209,1408,10.2
12128,Jassen Cullimore,1998-99,26.0,5,2,27,27,1,1,2,12.0,,61,2,3,5,42.0,82,6.29,74,413,2481,10.4
12129,Jassen Cullimore,1999-00,27.0,6,8,52,52,2,6,8,54.0,,113,4,9,13,96.0,82,5.83,55,336,2444,9.8
12130,Jassen Cullimore,2000-01,28.0,7,3,28,28,1,2,3,18.0,,141,5,11,16,114.0,82,5.28,57,380,2242,9.6
12131,Jassen Cullimore,2001-02,29.0,8,17,78,78,5,12,17,73.0,1578.0,219,10,23,33,187.0,82,5.27,57,359,2285,9.4
12132,Jassen Cullimore,2002-03,30.0,9,2,46,46,1,1,2,23.0,719.0,265,11,24,35,210.0,82,5.49,53,331,2294,9.8
12133,Jassen Cullimore,2003-04,31.0,10,7,74,74,1,6,7,56.0,1458.0,339,12,30,42,266.0,82,5.51,63,376,2272,9.9
12134,Jassen Cullimore,2004-05,32.0,11,13,78,78,4,9,13,84.0,1568.0,417,16,39,55,350.0,82,5.24,53,338,2262,9.5
12135,Jassen Cullimore,2005-06,33.0,12,4,28,28,1,3,4,23.0,516.0,445,17,42,59,373.0,82,5.31,60,363,2326,9.4
12136,Jassen Cullimore,2006-07,34.0,13,7,79,79,2,5,7,78.0,1503.0,524,19,47,66,451.0,82,5.14,57,348,2300,9.2
12137,Jassen Cullimore,2008-09,36.0,14,7,54,54,1,6,7,23.0,916.0,578,20,53,73,474.0,82,6.05,85,480,2458,10.1
12138,Jassen Cullimore,2009-10,37.0,15,7,65,65,1,6,7,17.0,1058.0,643,21,59,80,491.0,82,5.76,70,398,2426,9.7
12139,Jassen Cullimore,2010-11,38.0,16,13,65,65,3,10,13,55.0,1175.0,708,24,69,93,546.0,82,5.44,62,351,2383,9.4
12140,Jassen Cullimore,2011-12,39.0,17,10,68,68,2,8,10,52.0,1142.0,776,26,77,103,598.0,82,5.7,65,341,2477,9.4
12141,Jassen Cullimore,2013-14,41.0,18,8,36,36,0,8,8,22.0,455.0,812,26,85,111,620.0,82,5.46,52,291,2492,9.0
12142,Jay Beagle,2011-12,26.0,4,0,3,3,0,0,0,5.0,23.0,3,0,0,0,5.0,82,5.7,65,341,2477,9.4
12143,Jay Beagle,2012-13,27.0,5,2,7,7,1,1,2,10.0,65.0,10,1,1,2,15.0,82,5.53,56,304,2486,9.1
12144,Jay Beagle,2013-14,28.0,6,3,31,31,2,1,3,27.0,326.0,41,3,2,5,42.0,82,5.46,52,291,2492,9.0
12145,Jay Beagle,2014-15,29.0,7,5,41,41,4,1,5,49.0,486.0,82,7,3,10,91.0,82,5.32,47,271,2439,8.9
12146,Jay Beagle,2015-16,30.0,8,8,48,48,2,6,8,56.0,581.0,130,9,9,18,147.0,48,5.31,29,160,1399,9.1
12147,Jay Beagle,2016-17,31.0,9,9,62,62,4,5,9,60.0,697.0,192,13,14,27,207.0,82,5.34,48,269,2463,8.9
12148,Jay Beagle,2017-18,32.0,10,20,62,62,10,10,20,84.0,794.0,254,23,24,47,291.0,82,5.32,47,251,2453,8.9
12149,Jay Beagle,2018-19,33.0,11,17,57,57,8,9,17,74.0,799.0,311,31,33,64,365.0,82,5.34,48,255,2438,9.0
12150,Jay Beagle,2019-20,34.0,12,30,81,81,13,17,30,100.0,1104.0,392,44,50,94,465.0,82,5.45,47,245,2478,9.0
12151,Jay Beagle,2020-21,35.0,13,22,79,79,7,15,22,65.0,983.0,471,51,65,116,530.0,82,5.86,50,250,2620,9.2
12152,Jay Beagle,2021-22,36.0,14,13,57,57,3,10,13,45.0,778.0,528,54,75,129,575.0,82,5.96,47,239,2579,9.5
12153,Jay Beagle,2022-23,37.0,15,8,55,55,2,6,8,49.0,691.0,583,56,81,137,624.0,70,5.96,42,208,2192,9.5
12154,Jay Bouwmeester,2005-06,22.0,4,16,82,82,4,12,16,110.0,1652.0,82,4,12,16,110.0,82,5.31,60,363,2326,9.4
12155,Jay Bouwmeester,2006-07,23.0,5,20,61,61,2,18,20,85.0,1405.0,143,6,30,36,195.0,82,5.14,57,348,2300,9.2
12156,Jay Bouwmeester,2008-09,25.0,6,46,82,82,5,41,46,189.0,2090.0,225,11,71,82,384.0,82,6.05,85,480,2458,10.1
12157,Jay Bouwmeester,2009-10,26.0,7,42,82,82,12,30,42,174.0,2144.0,307,23,101,124,558.0,82,5.76,70,398,2426,9.7
12158,Jay Bouwmeester,2010-11,27.0,8,37,82,82,15,22,37,182.0,2252.0,389,38,123,161,740.0,82,5.44,62,351,2383,9.4
12159,Jay Bouwmeester,2011-12,28.0,9,42,82,82,15,27,42,182.0,2213.0,471,53,150,203,922.0,82,5.7,65,341,2477,9.4
12160,Jay Bouwmeester,2012-13,29.0,10,29,82,82,3,26,29,130.0,2125.0,553,56,176,232,1052.0,82,5.53,56,304,2486,9.1
12161,Jay Bouwmeester,2013-14,30.0,11,24,82,82,4,20,24,121.0,2131.0,635,60,196,256,1173.0,82,5.46,52,291,2492,9.0
12162,Jay Bouwmeester,2014-15,31.0,12,29,82,82,5,24,29,107.0,2129.0,717,65,220,285,1280.0,82,5.32,47,271,2439,8.9
12163,Jay Bouwmeester,2015-16,32.0,13,22,47,47,7,15,22,79.0,1158.0,764,72,235,307,1359.0,48,5.31,29,160,1399,9.1
12164,Jay Bouwmeester,2016-17,33.0,14,37,82,82,4,33,37,152.0,1972.0,846,76,268,344,1511.0,82,5.34,48,269,2463,8.9
12165,Jay Bouwmeester,2017-18,34.0,15,13,72,72,2,11,13,92.0,1632.0,918,78,279,357,1603.0,82,5.32,47,251,2453,8.9
12166,Jay Bouwmeester,2018-19,35.0,16,19,72,72,3,16,19,105.0,1664.0,990,81,295,376,1708.0,82,5.34,48,255,2438,9.0
12167,Jay Bouwmeester,2019-20,36.0,17,15,81,81,1,14,15,106.0,1815.0,1071,82,309,391,1814.0,82,5.45,47,245,2478,9.0
12168,Jay Bouwmeester,2020-21,37.0,18,7,35,35,2,5,7,45.0,705.0,1106,84,314,398,1859.0,82,5.86,50,250,2620,9.2
12169,Jay Bouwmeester,2021-22,38.0,19,17,78,78,3,14,17,82.0,1617.0,1184,87,328,415,1941.0,82,5.96,47,239,2579,9.5
12170,Jay Bouwmeester,2022-23,39.0,20,9,56,56,1,8,9,53.0,1208.0,1240,88,336,424,1994.0,70,5.96,42,208,2192,9.5
12171,Jay Caufield,1989-90,29.0,4,3,13,13,2,1,3,8.0,,13,2,1,3,8.0,80,7.34,72,344,2400,12.2
12172,Jay Caufield,1990-91,30.0,5,0,1,1,0,0,0,0.0,,14,2,1,3,8.0,80,7.43,89,437,2435,12.2
12173,Jay Caufield,1991-92,31.0,6,5,58,58,1,4,5,10.0,,72,3,5,8,18.0,80,7.48,85,403,2430,12.3
12174,Jay Caufield,1992-93,32.0,7,3,37,37,1,2,3,6.0,,109,4,7,11,24.0,80,7.37,76,367,2421,12.2
12175,Jay Caufield,1993-94,33.0,8,2,23,23,1,1,2,5.0,,132,5,8,13,29.0,80,6.91,71,366,2385,11.6
12176,Jay Caufield,1994-95,34.0,9,0,50,50,0,0,0,16.0,,182,5,8,13,45.0,80,6.96,77,402,2440,11.4
12177,Jay Caufield,1995-96,35.0,10,0,26,26,0,0,0,6.0,,208,5,8,13,51.0,84,7.25,87,443,2603,11.7
12178,Jay Harrison,2008-09,26.0,4,1,8,8,0,1,1,7.0,151.0,8,0,1,1,7.0,82,6.05,85,480,2458,10.1
12179,Jay Harrison,2009-10,27.0,5,0,5,5,0,0,0,3.0,42.0,13,0,1,1,10.0,82,5.76,70,398,2426,9.7
12180,Jay Harrison,2011-12,29.0,6,1,7,7,0,1,1,6.0,121.0,20,0,2,2,16.0,82,5.7,65,341,2477,9.4
12181,Jay Harrison,2012-13,30.0,7,6,38,38,1,5,6,30.0,559.0,58,1,7,8,46.0,82,5.53,56,304,2486,9.1
12182,Jay Harrison,2013-14,31.0,8,10,72,72,3,7,10,49.0,1100.0,130,4,14,18,95.0,82,5.46,52,291,2492,9.0
12183,Jay Harrison,2014-15,32.0,9,23,72,72,9,14,23,128.0,1480.0,202,13,28,41,223.0,82,5.32,47,271,2439,8.9
12184,Jay Harrison,2015-16,33.0,10,10,47,47,3,7,10,54.0,936.0,249,16,35,51,277.0,48,5.31,29,160,1399,9.1
12185,Jay Harrison,2016-17,34.0,11,15,68,68,4,11,15,103.0,1131.0,317,20,46,66,380.0,82,5.34,48,269,2463,8.9
12186,Jay Harrison,2017-18,35.0,12,9,55,55,3,6,9,50.0,876.0,372,23,52,75,430.0,82,5.32,47,251,2453,8.9
12187,Jay Henderson,2001-02,23.0,4,0,4,4,0,0,0,4.0,23.0,4,0,0,0,4.0,82,5.27,57,359,2285,9.4
12188,Jay Henderson,2002-03,24.0,5,4,16,16,1,3,4,18.0,86.0,20,1,3,4,22.0,82,5.49,53,331,2294,9.8
12189,Jay Henderson,2003-04,25.0,6,0,13,13,0,0,0,12.0,90.0,33,1,3,4,34.0,82,5.51,63,376,2272,9.9
12190,Jay Johnston,1983-84,25.0,4,0,2,2,0,0,0,0.0,,2,0,0,0,0.0,80,7.69,77,340,2441,12.6
12191,Jay Johnston,1984-85,26.0,5,0,6,6,0,0,0,3.0,,8,0,0,0,3.0,80,8.03,73,320,2489,12.9
12192,Jay Leach,2008-09,29.0,4,0,2,2,0,0,0,0.0,13.0,2,0,0,0,0.0,82,6.05,85,480,2458,10.1
12193,Jay Leach,2010-11,31.0,5,0,2,2,0,0,0,0.0,9.0,4,0,0,0,0.0,82,5.44,62,351,2383,9.4
12194,Jay Leach,2011-12,32.0,6,1,24,24,0,1,1,5.0,356.0,28,0,1,1,5.0,82,5.7,65,341,2477,9.4
12195,Jay Leach,2012-13,33.0,7,2,35,35,1,1,2,30.0,517.0,63,1,2,3,35.0,82,5.53,56,304,2486,9.1
12196,Jay Leach,2013-14,34.0,8,0,7,7,0,0,0,2.0,100.0,70,1,2,3,37.0,82,5.46,52,291,2492,9.0
12197,Jay Mazur,1991-92,27.0,4,0,1,1,0,0,0,0.0,,1,0,0,0,0.0,80,7.48,85,403,2430,12.3
12198,Jay Mazur,1992-93,28.0,5,0,5,5,0,0,0,4.0,,6,0,0,0,4.0,80,7.37,76,367,2421,12.2
12199,Jay Mazur,1993-94,29.0,6,18,36,36,11,7,18,59.0,,42,11,7,18,63.0,80,6.91,71,366,2385,11.6
12200,Jay Mazur,1994-95,30.0,7,0,5,5,0,0,0,3.0,,47,11,7,18,66.0,80,6.96,77,402,2440,11.4
12201,Jay McClement,2008-09,25.0,4,27,67,67,6,21,27,76.0,934.0,67,6,21,27,76.0,82,6.05,85,480,2458,10.1
12202,Jay McClement,2009-10,26.0,5,36,81,81,8,28,36,104.0,1125.0,148,14,49,63,180.0,82,5.76,70,398,2426,9.7
12203,Jay McClement,2010-11,27.0,6,22,81,81,9,13,22,110.0,1128.0,229,23,62,85,290.0,82,5.44,62,351,2383,9.4
12204,Jay McClement,2011-12,28.0,7,26,82,82,12,14,26,137.0,1361.0,311,35,76,111,427.0,82,5.7,65,341,2477,9.4
12205,Jay McClement,2012-13,29.0,8,29,82,82,11,18,29,109.0,1372.0,393,46,94,140,536.0,82,5.53,56,304,2486,9.1
12206,Jay McClement,2013-14,30.0,9,20,80,80,7,13,20,127.0,1335.0,473,53,107,160,663.0,82,5.46,52,291,2492,9.0
12207,Jay McClement,2014-15,31.0,10,17,80,80,10,7,17,95.0,1100.0,553,63,114,177,758.0,82,5.32,47,271,2439,8.9
12208,Jay McClement,2015-16,32.0,11,17,48,48,8,9,17,48.0,732.0,601,71,123,194,806.0,48,5.31,29,160,1399,9.1
12209,Jay McClement,2016-17,33.0,12,10,81,81,4,6,10,67.0,1196.0,682,75,129,204,873.0,82,5.34,48,269,2463,8.9
12210,Jay McClement,2017-18,34.0,13,21,82,82,7,14,21,68.0,1113.0,764,82,143,225,941.0,82,5.32,47,251,2453,8.9
12211,Jay McClement,2018-19,35.0,14,11,77,77,3,8,11,64.0,893.0,841,85,151,236,1005.0,82,5.34,48,255,2438,9.0
12212,Jay McClement,2019-20,36.0,15,8,65,65,5,3,8,37.0,740.0,906,90,154,244,1042.0,82,5.45,47,245,2478,9.0
12213,Jay McKee,1998-99,21.0,4,1,1,1,0,1,1,2.0,,1,0,1,1,2.0,82,6.29,74,413,2481,10.4
12214,Jay McKee,1999-00,22.0,5,10,43,43,1,9,10,29.0,,44,1,10,11,31.0,82,5.83,55,336,2444,9.8
12215,Jay McKee,2000-01,23.0,6,14,56,56,1,13,14,55.0,,100,2,23,25,86.0,82,5.28,57,380,2242,9.6
12216,Jay McKee,2001-02,24.0,7,6,72,72,0,6,6,57.0,1474.0,172,2,29,31,143.0,82,5.27,57,359,2285,9.4
12217,Jay McKee,2002-03,25.0,8,17,78,78,5,12,17,84.0,1635.0,250,7,41,48,227.0,82,5.49,53,331,2294,9.8
12218,Jay McKee,2003-04,26.0,9,11,74,74,1,10,11,62.0,1435.0,324,8,51,59,289.0,82,5.51,63,376,2272,9.9
12219,Jay McKee,2004-05,27.0,10,13,81,81,2,11,13,50.0,1574.0,405,10,62,72,339.0,82,5.24,53,338,2262,9.5
12220,Jay McKee,2005-06,28.0,11,5,59,59,0,5,5,44.0,1106.0,464,10,67,77,383.0,82,5.31,60,363,2326,9.4
12221,Jay McKee,2006-07,29.0,12,5,43,43,2,3,5,29.0,763.0,507,12,70,82,412.0,82,5.14,57,348,2300,9.2
12222,Jay McKee,2008-09,31.0,13,16,75,75,5,11,16,50.0,1354.0,582,17,81,98,462.0,82,6.05,85,480,2458,10.1
12223,Jay McKee,2009-10,32.0,14,0,23,23,0,0,0,19.0,465.0,605,17,81,98,481.0,82,5.76,70,398,2426,9.7
12224,Jay McKee,2010-11,33.0,15,9,66,66,2,7,9,42.0,1181.0,671,19,88,107,523.0,82,5.44,62,351,2383,9.4
12225,Jay McKee,2011-12,34.0,16,8,69,69,1,7,8,43.0,1195.0,740,20,95,115,566.0,82,5.7,65,341,2477,9.4
12226,Jay McKee,2012-13,35.0,17,10,62,62,1,9,10,42.0,957.0,802,21,104,125,608.0,82,5.53,56,304,2486,9.1
12227,Jay Miller,1988-89,28.0,4,3,46,46,3,0,3,21.0,,46,3,0,3,21.0,80,7.94,82,370,2484,12.8
12228,Jay Miller,1989-90,29.0,5,5,55,55,1,4,5,26.0,,101,4,4,8,47.0,80,7.34,72,344,2400,12.2
12229,Jay Miller,1990-91,30.0,6,19,78,78,7,12,19,44.0,,179,11,16,27,91.0,80,7.43,89,437,2435,12.2
12230,Jay Miller,1991-92,31.0,7,14,66,66,7,7,14,30.0,,245,18,23,41,121.0,80,7.48,85,403,2430,12.3
12231,Jay Miller,1992-93,32.0,8,12,68,68,10,2,12,44.0,,313,28,25,53,165.0,80,7.37,76,367,2421,12.2
12232,Jay Miller,1993-94,33.0,9,20,66,66,8,12,20,35.0,,379,36,37,73,200.0,80,6.91,71,366,2385,11.6
12233,Jay Miller,1994-95,34.0,10,11,67,67,4,7,11,32.0,,446,40,44,84,232.0,80,6.96,77,402,2440,11.4
12234,Jay More,1991-92,23.0,4,0,1,1,0,0,0,0.0,,1,0,0,0,0.0,80,7.48,85,403,2430,12.3
12235,Jay More,1992-93,24.0,5,0,5,5,0,0,0,4.0,,6,0,0,0,4.0,80,7.37,76,367,2421,12.2
12236,Jay More,1994-95,26.0,6,17,46,46,4,13,17,60.0,,52,4,13,17,64.0,80,6.96,77,402,2440,11.4
12237,Jay More,1995-96,27.0,7,11,73,73,5,6,11,107.0,,125,9,19,28,171.0,84,7.25,87,443,2603,11.7
12238,Jay More,1996-97,28.0,8,7,49,49,1,6,7,38.0,,174,10,25,35,209.0,84,6.48,76,407,2545,10.7
12239,Jay More,1997-98,29.0,9,6,45,45,0,6,6,25.0,,219,10,31,41,234.0,48,5.97,37,209,1408,10.2
12240,Jay More,1998-99,30.0,10,9,74,74,2,7,9,67.0,,293,12,38,50,301.0,82,6.29,74,413,2481,10.4
12241,Jay More,1999-00,31.0,11,8,37,37,1,7,8,28.0,,330,13,45,58,329.0,82,5.83,55,336,2444,9.8
12242,Jay More,2000-01,32.0,12,12,58,58,5,7,12,57.0,,388,18,52,70,386.0,82,5.28,57,380,2242,9.6
12243,Jay More,2001-02,33.0,13,2,18,18,0,2,2,24.0,297.0,406,18,54,72,410.0,82,5.27,57,359,2285,9.4
12244,Jay Pandolfo,1999-00,25.0,4,14,46,46,6,8,14,61.0,,46,6,8,14,61.0,82,5.83,55,336,2444,9.8
12245,Jay Pandolfo,2000-01,26.0,5,4,23,23,1,3,4,23.0,,69,7,11,18,84.0,82,5.28,57,380,2242,9.6
12246,Jay Pandolfo,2001-02,27.0,6,27,70,70,14,13,27,100.0,1065.0,139,21,24,45,184.0,82,5.27,57,359,2285,9.4
12247,Jay Pandolfo,2002-03,28.0,7,15,71,71,7,8,15,86.0,953.0,210,28,32,60,270.0,82,5.49,53,331,2294,9.8
12248,Jay Pandolfo,2003-04,29.0,8,16,63,63,4,12,16,57.0,887.0,273,32,44,76,327.0,82,5.51,63,376,2272,9.9
12249,Jay Pandolfo,2004-05,30.0,9,14,65,65,4,10,14,72.0,909.0,338,36,54,90,399.0,82,5.24,53,338,2262,9.5
12250,Jay Pandolfo,2005-06,31.0,10,17,68,68,6,11,17,92.0,1097.0,406,42,65,107,491.0,82,5.31,60,363,2326,9.4
12251,Jay Pandolfo,2006-07,32.0,11,26,82,82,13,13,26,140.0,1313.0,488,55,78,133,631.0,82,5.14,57,348,2300,9.2
12252,Jay Pandolfo,2008-09,34.0,12,20,82,82,10,10,20,116.0,1479.0,570,65,88,153,747.0,82,6.05,85,480,2458,10.1
12253,Jay Pandolfo,2009-10,35.0,13,27,82,82,13,14,27,109.0,1526.0,652,78,102,180,856.0,82,5.76,70,398,2426,9.7
12254,Jay Pandolfo,2010-11,36.0,14,24,54,54,12,12,24,78.0,933.0,706,90,114,204,934.0,82,5.44,62,351,2383,9.4
12255,Jay Pandolfo,2011-12,37.0,15,10,61,61,5,5,10,63.0,905.0,767,95,119,214,997.0,82,5.7,65,341,2477,9.4
12256,Jay Pandolfo,2012-13,38.0,16,9,52,52,4,5,9,71.0,724.0,819,99,124,223,1068.0,82,5.53,56,304,2486,9.1
12257,Jay Pandolfo,2014-15,40.0,17,3,62,62,1,2,3,44.0,677.0,881,100,126,226,1112.0,82,5.32,47,271,2439,8.9
12258,Jay Pandolfo,2015-16,41.0,18,0,18,18,0,0,0,11.0,163.0,899,100,126,226,1123.0,48,5.31,29,160,1399,9.1
12259,Jay Rosehill,2012-13,27.0,4,2,15,15,1,1,2,6.0,94.0,15,1,1,2,6.0,82,5.53,56,304,2486,9.1
12260,Jay Rosehill,2013-14,28.0,5,3,26,26,1,2,3,12.0,135.0,41,2,3,5,18.0,82,5.46,52,291,2492,9.0
12261,Jay Rosehill,2014-15,29.0,6,0,31,31,0,0,0,15.0,183.0,72,2,3,5,33.0,82,5.32,47,271,2439,8.9
12262,Jay Rosehill,2015-16,30.0,7,1,11,11,1,0,1,7.0,75.0,83,3,3,6,40.0,48,5.31,29,160,1399,9.1
12263,Jay Rosehill,2016-17,31.0,8,2,34,34,2,0,2,14.0,168.0,117,5,3,8,54.0,82,5.34,48,269,2463,8.9
12264,Jay Wells,1982-83,23.0,4,0,43,43,0,0,0,22.0,,43,0,0,0,22.0,80,7.03,61,280,2352,12.0
12265,Jay Wells,1983-84,24.0,5,18,72,72,5,13,18,75.0,,115,5,13,18,97.0,80,7.69,77,340,2441,12.6
12266,Jay Wells,1984-85,25.0,6,9,60,60,1,8,9,84.0,,175,6,21,27,181.0,80,8.03,73,320,2489,12.9
12267,Jay Wells,1985-86,26.0,7,15,69,69,3,12,15,101.0,,244,9,33,42,282.0,80,7.73,71,310,2444,12.7
12268,Jay Wells,1986-87,27.0,8,21,69,69,3,18,21,96.0,,313,12,51,63,378.0,80,7.89,74,336,2448,12.9
12269,Jay Wells,1987-88,28.0,9,11,77,77,2,9,11,72.0,,390,14,60,74,450.0,80,7.77,71,321,2447,12.7
12270,Jay Wells,1988-89,29.0,10,42,79,79,11,31,42,113.0,,469,25,91,116,563.0,80,7.94,82,370,2484,12.8
12271,Jay Wells,1989-90,30.0,11,36,77,77,7,29,36,115.0,,546,32,120,152,678.0,80,7.34,72,344,2400,12.2
12272,Jay Wells,1990-91,31.0,12,25,58,58,2,23,25,76.0,,604,34,143,177,754.0,80,7.43,89,437,2435,12.2
12273,Jay Wells,1991-92,32.0,13,21,67,67,2,19,21,67.0,,671,36,162,198,821.0,80,7.48,85,403,2430,12.3
12274,Jay Wells,1992-93,33.0,14,20,60,60,3,17,20,76.0,,731,39,179,218,897.0,80,7.37,76,367,2421,12.2
12275,Jay Wells,1993-94,34.0,15,3,43,43,1,2,3,36.0,,774,40,181,221,933.0,80,6.91,71,366,2385,11.6
12276,Jay Wells,1994-95,35.0,16,11,52,52,2,9,11,30.0,,826,42,190,232,963.0,80,6.96,77,402,2440,11.4
12277,Jay Wells,1995-96,36.0,17,10,53,53,1,9,10,32.0,,879,43,199,242,995.0,84,7.25,87,443,2603,11.7
12278,Jay Wells,1996-97,37.0,18,9,79,79,2,7,9,64.0,,958,45,206,251,1059.0,84,6.48,76,407,2545,10.7
12279,Jay Wells,1997-98,38.0,19,9,43,43,2,7,9,38.0,,1001,47,213,260,1097.0,48,5.97,37,209,1408,10.2
12280,Jay Wells,1998-99,39.0,20,3,76,76,0,3,3,24.0,,1077,47,216,263,1121.0,82,6.29,74,413,2481,10.4
12281,Jay Wells,1999-00,40.0,21,0,21,21,0,0,0,16.0,,1098,47,216,263,1137.0,82,5.83,55,336,2444,9.8
12282,Jayce Hawryluk,2021-22,26.0,4,12,42,42,7,5,12,35.0,396.0,42,7,5,12,35.0,82,5.96,47,239,2579,9.5
12283,Jayce Hawryluk,2022-23,27.0,5,10,26,26,3,7,10,26.0,288.0,68,10,12,22,61.0,70,5.96,42,208,2192,9.5
12284,Jaycob Megna,2019-20,27.0,4,0,1,1,0,0,0,0.0,15.0,1,0,0,0,0.0,82,5.45,47,245,2478,9.0
12285,Jaycob Megna,2020-21,28.0,5,1,14,14,0,1,1,7.0,220.0,15,0,1,1,7.0,82,5.86,50,250,2620,9.2
12286,Jaycob Megna,2021-22,29.0,6,4,28,28,1,3,4,31.0,407.0,43,1,4,5,38.0,82,5.96,47,239,2579,9.5
12287,Jayson Megna,2016-17,26.0,4,9,36,36,5,4,9,36.0,377.0,36,5,4,9,36.0,82,5.34,48,269,2463,8.9
12288,Jayson Megna,2017-18,27.0,5,1,12,12,0,1,1,13.0,132.0,48,5,5,10,49.0,82,5.32,47,251,2453,8.9
12289,Jayson Megna,2018-19,28.0,6,2,6,6,1,1,2,9.0,73.0,54,6,6,12,58.0,82,5.34,48,255,2438,9.0
12290,Jayson Megna,2019-20,29.0,7,8,58,58,4,4,8,72.0,721.0,112,10,10,20,130.0,82,5.45,47,245,2478,9.0
12291,Jayson Megna,2020-21,30.0,8,0,1,1,0,0,0,0.0,4.0,113,10,10,20,130.0,82,5.86,50,250,2620,9.2
12292,Jayson Megna,2022-23,32.0,9,0,8,8,0,0,0,4.0,54.0,121,10,10,20,134.0,70,5.96,42,208,2192,9.5
12293,Jean-Francois Fortin,2004-05,25.0,4,4,36,36,1,3,4,24.0,699.0,36,1,3,4,24.0,82,5.24,53,338,2262,9.5
12294,Jean-Francois Fortin,2005-06,26.0,5,1,33,33,0,1,1,20.0,503.0,69,1,4,5,44.0,82,5.31,60,363,2326,9.4
12295,Jean-Francois Fortin,2006-07,27.0,6,0,2,2,0,0,0,0.0,16.0,71,1,4,5,44.0,82,5.14,57,348,2300,9.2
12296,Jean-Francois Jacques,2008-09,23.0,4,0,7,7,0,0,0,8.0,47.0,7,0,0,0,8.0,82,6.05,85,480,2458,10.1
12297,Jean-Francois Jacques,2009-10,24.0,5,0,37,37,0,0,0,23.0,293.0,44,0,0,0,31.0,82,5.76,70,398,2426,9.7
12298,Jean-Francois Jacques,2010-11,25.0,6,0,9,9,0,0,0,2.0,55.0,53,0,0,0,33.0,82,5.44,62,351,2383,9.4
12299,Jean-Francois Jacques,2011-12,26.0,7,1,7,7,1,0,1,3.0,52.0,60,1,0,1,36.0,82,5.7,65,341,2477,9.4
12300,Jean-Francois Jacques,2012-13,27.0,8,11,49,49,4,7,11,49.0,549.0,109,5,7,12,85.0,82,5.53,56,304,2486,9.1
12301,Jean-Francois Jacques,2013-14,28.0,9,5,51,51,4,1,5,28.0,361.0,160,9,8,17,113.0,82,5.46,52,291,2492,9.0
12302,Jean-Francois Jacques,2014-15,29.0,10,0,6,6,0,0,0,7.0,40.0,166,9,8,17,120.0,82,5.32,47,271,2439,8.9
12303,Jean-Francois Jomphe,1998-99,26.0,4,14,31,31,2,12,14,46.0,,31,2,12,14,46.0,82,6.29,74,413,2481,10.4
12304,Jean-Francois Jomphe,1999-00,27.0,5,21,64,64,7,14,21,81.0,,95,9,26,35,127.0,82,5.83,55,336,2444,9.8
12305,Jean-Francois Jomphe,2000-01,28.0,6,4,9,9,1,3,4,8.0,,104,10,29,39,135.0,82,5.28,57,380,2242,9.6
12306,Jean-Francois Jomphe,2001-02,29.0,7,0,7,7,0,0,0,4.0,62.0,111,10,29,39,139.0,82,5.27,57,359,2285,9.4
12307,Jean-Francois Quintin,1994-95,25.0,4,3,8,8,3,0,3,12.0,,8,3,0,3,12.0,80,6.96,77,402,2440,11.4
12308,Jean-Francois Quintin,1995-96,26.0,5,7,14,14,2,5,7,12.0,,22,5,5,10,24.0,84,7.25,87,443,2603,11.7
12309,Jean-Gabriel Pageau,2015-16,23.0,4,4,9,9,2,2,4,14.0,103.0,9,2,2,4,14.0,48,5.31,29,160,1399,9.1
12310,Jean-Gabriel Pageau,2016-17,24.0,5,2,28,28,2,0,2,31.0,287.0,37,4,2,6,45.0,82,5.34,48,269,2463,8.9
12311,Jean-Gabriel Pageau,2017-18,25.0,6,19,50,50,10,9,19,97.0,709.0,87,14,11,25,142.0,82,5.32,47,251,2453,8.9
12312,Jean-Gabriel Pageau,2018-19,26.0,7,43,82,82,19,24,43,133.0,1370.0,169,33,35,68,275.0,82,5.34,48,255,2438,9.0
12313,Jean-Gabriel Pageau,2019-20,27.0,8,33,82,82,12,21,33,169.0,1323.0,251,45,56,101,444.0,82,5.45,47,245,2478,9.0
12314,Jean-Gabriel Pageau,2020-21,28.0,9,29,78,78,14,15,29,147.0,1306.0,329,59,71,130,591.0,82,5.86,50,250,2620,9.2
12315,Jean-Gabriel Pageau,2021-22,29.0,10,12,39,39,4,8,12,83.0,696.0,368,63,79,142,674.0,82,5.96,47,239,2579,9.5
12316,Jean-Gabriel Pageau,2022-23,30.0,11,42,67,67,26,16,42,151.0,1284.0,435,89,95,184,825.0,70,5.96,42,208,2192,9.5
12317,Jean-Guy Trudel,2002-03,27.0,4,0,1,1,0,0,0,0.0,5.0,1,0,0,0,0.0,82,5.49,53,331,2294,9.8
12318,Jean-Guy Trudel,2004-05,29.0,5,0,3,3,0,0,0,1.0,26.0,4,0,0,0,1.0,82,5.24,53,338,2262,9.5
12319,Jean-Guy Trudel,2005-06,30.0,6,0,1,1,0,0,0,0.0,6.0,5,0,0,0,1.0,82,5.31,60,363,2326,9.4
12320,Jean-Luc Grand-Pierre,2001-02,24.0,4,1,16,16,0,1,1,11.0,218.0,16,0,1,1,11.0,82,5.27,57,359,2285,9.4
12321,Jean-Luc Grand-Pierre,2002-03,25.0,5,0,11,11,0,0,0,10.0,167.0,27,0,1,1,21.0,82,5.49,53,331,2294,9.8
12322,Jean-Luc Grand-Pierre,2003-04,26.0,6,5,64,64,1,4,5,33.0,822.0,91,1,5,6,54.0,82,5.51,63,376,2272,9.9
12323,Jean-Luc Grand-Pierre,2004-05,27.0,7,8,81,81,2,6,8,62.0,1243.0,172,3,11,14,116.0,82,5.24,53,338,2262,9.5
12324,Jean-Luc Grand-Pierre,2005-06,28.0,8,1,41,41,1,0,1,32.0,559.0,213,4,11,15,148.0,82,5.31,60,363,2326,9.4
12325,Jean-Luc Grand-Pierre,2006-07,29.0,9,5,56,56,3,2,5,53.0,685.0,269,7,13,20,201.0,82,5.14,57,348,2300,9.2
12326,Jean-Marc Gaulin,1985-86,23.0,4,0,1,1,0,0,0,0.0,,1,0,0,0,0.0,80,7.73,71,310,2444,12.7
12327,Jean-Marc Gaulin,1986-87,24.0,5,0,2,2,0,0,0,0.0,,3,0,0,0,0.0,80,7.89,74,336,2448,12.9
12328,Jean-Marc Gaulin,1987-88,25.0,6,6,22,22,3,3,6,24.0,,25,3,3,6,24.0,80,7.77,71,321,2447,12.7
12329,Jean-Marc Gaulin,1988-89,26.0,7,1,1,1,1,0,1,2.0,,26,4,3,7,26.0,80,7.94,82,370,2484,12.8
12330,Jean-Marc Lanthier,1986-87,23.0,4,3,11,11,2,1,3,9.0,,11,2,1,3,9.0,80,7.89,74,336,2448,12.9
12331,Jean-Marc Lanthier,1987-88,24.0,5,10,27,27,6,4,10,24.0,,38,8,5,13,33.0,80,7.77,71,321,2447,12.7
12332,Jean-Marc Lanthier,1988-89,25.0,6,17,62,62,7,10,17,50.0,,100,15,15,30,83.0,80,7.94,82,370,2484,12.8
12333,Jean-Marc Lanthier,1990-91,27.0,7,2,5,5,1,1,2,3.0,,105,16,16,32,86.0,80,7.43,89,437,2435,12.2
12334,Jean-Marc Richard,1990-91,24.0,4,3,4,4,2,1,3,5.0,,4,2,1,3,5.0,80,7.43,89,437,2435,12.2
12335,Jean-Marc Richard,1992-93,26.0,5,0,1,1,0,0,0,0.0,,5,2,1,3,5.0,80,7.37,76,367,2421,12.2
12336,Jean-Marc Routhier,1992-93,24.0,4,0,8,8,0,0,0,8.0,,8,0,0,0,8.0,80,7.37,76,367,2421,12.2
12337,Jean-Philippe Cote,2008-09,26.0,4,0,8,8,0,0,0,2.0,88.0,8,0,0,0,2.0,82,6.05,85,480,2458,10.1
12338,Jean-Philippe Cote,2016-17,34.0,5,4,19,19,0,4,4,12.0,190.0,27,0,4,4,14.0,82,5.34,48,269,2463,8.9
12339,Jean-Sebastien Dea,2019-20,25.0,4,0,1,1,0,0,0,1.0,11.0,1,0,0,0,1.0,82,5.45,47,245,2478,9.0
12340,Jean-Sebastien Dea,2020-21,26.0,5,1,5,5,1,0,1,1.0,27.0,6,1,0,1,2.0,82,5.86,50,250,2620,9.2
12341,Jean-Sebastien Dea,2021-22,27.0,6,6,23,23,4,2,6,29.0,236.0,29,5,2,7,31.0,82,5.96,47,239,2579,9.5
12342,Jean-Sebastien Dea,2022-23,28.0,7,0,3,3,0,0,0,0.0,23.0,32,5,2,7,31.0,70,5.96,42,208,2192,9.5
12343,Jean-Yves Leroux,1999-00,23.0,4,1,1,1,0,1,1,0.0,,1,0,1,1,0.0,82,5.83,55,336,2444,9.8
12344,Jean-Yves Leroux,2000-01,24.0,5,13,66,66,6,7,13,57.0,,67,6,8,14,57.0,82,5.28,57,380,2242,9.6
12345,Jean-Yves Leroux,2001-02,25.0,6,8,40,40,3,5,8,47.0,509.0,107,9,13,22,104.0,82,5.27,57,359,2285,9.4
12346,Jean-Yves Leroux,2002-03,26.0,7,8,54,54,3,5,8,36.0,579.0,161,12,18,30,140.0,82,5.49,53,331,2294,9.8
12347,Jean-Yves Leroux,2003-04,27.0,8,8,59,59,4,4,8,60.0,601.0,220,16,22,38,200.0,82,5.51,63,376,2272,9.9
12348,Jean-Yves Roy,1997-98,28.0,4,1,3,3,1,0,1,8.0,,3,1,0,1,8.0,48,5.97,37,209,1408,10.2
12349,Jean-Yves Roy,1998-99,29.0,5,2,4,4,1,1,2,6.0,,7,2,1,3,14.0,82,6.29,74,413,2481,10.4
12350,Jean-Yves Roy,1999-00,30.0,6,25,52,52,10,15,25,100.0,,59,12,16,28,114.0,82,5.83,55,336,2444,9.8
12351,Jean-Yves Roy,2000-01,31.0,7,0,2,2,0,0,0,1.0,,61,12,16,28,115.0,82,5.28,57,380,2242,9.6
12352,Jed Ortmeyer,2006-07,28.0,4,6,58,58,2,4,6,48.0,572.0,58,2,4,6,48.0,82,5.14,57,348,2300,9.2
12353,Jed Ortmeyer,2008-09,30.0,5,7,78,78,5,2,7,90.0,866.0,136,7,6,13,138.0,82,6.05,85,480,2458,10.1
12354,Jed Ortmeyer,2009-10,31.0,6,11,41,41,2,9,11,67.0,516.0,177,9,15,24,205.0,82,5.76,70,398,2426,9.7
12355,Jed Ortmeyer,2010-11,32.0,7,8,51,51,4,4,8,68.0,635.0,228,13,19,32,273.0,82,5.44,62,351,2383,9.4
12356,Jed Ortmeyer,2011-12,33.0,8,0,2,2,0,0,0,4.0,22.0,230,13,19,32,277.0,82,5.7,65,341,2477,9.4
12357,Jed Ortmeyer,2012-13,34.0,9,19,76,76,8,11,19,131.0,875.0,306,21,30,51,408.0,82,5.53,56,304,2486,9.1
12358,Jed Ortmeyer,2013-14,35.0,10,0,4,4,0,0,0,5.0,38.0,310,21,30,51,413.0,82,5.46,52,291,2492,9.0
12359,Jed Ortmeyer,2014-15,36.0,11,2,35,35,1,1,2,41.0,340.0,345,22,31,53,454.0,82,5.32,47,271,2439,8.9
12360,Jeff Bandura,1983-84,26.0,4,1,2,2,0,1,1,2.0,,2,0,1,1,2.0,80,7.69,77,340,2441,12.6
12361,Jeff Batters,1996-97,26.0,4,0,6,6,0,0,0,1.0,,6,0,0,0,1.0,84,6.48,76,407,2545,10.7
12362,Jeff Batters,1997-98,27.0,5,0,10,10,0,0,0,3.0,,16,0,0,0,4.0,48,5.97,37,209,1408,10.2
12363,Jeff Beukeboom,1989-90,24.0,4,11,44,44,3,8,11,24.0,,44,3,8,11,24.0,80,7.34,72,344,2400,12.2
12364,Jeff Beukeboom,1990-91,25.0,5,25,73,73,5,20,25,76.0,,117,8,28,36,100.0,80,7.43,89,437,2435,12.2
12365,Jeff Beukeboom,1991-92,26.0,6,5,36,36,0,5,5,26.0,,153,8,33,41,126.0,80,7.48,85,403,2430,12.3
12366,Jeff Beukeboom,1992-93,27.0,7,13,46,46,1,12,13,36.0,,199,9,45,54,162.0,80,7.37,76,367,2421,12.2
12367,Jeff Beukeboom,1993-94,28.0,8,10,67,67,3,7,10,48.0,,266,12,52,64,210.0,80,6.91,71,366,2385,11.6
12368,Jeff Beukeboom,1994-95,29.0,9,16,74,74,1,15,16,48.0,,340,13,67,80,258.0,80,6.96,77,402,2440,11.4
12369,Jeff Beukeboom,1995-96,30.0,10,19,82,82,2,17,19,54.0,,422,15,84,99,312.0,84,7.25,87,443,2603,11.7
12370,Jeff Beukeboom,1996-97,31.0,11,16,68,68,8,8,16,58.0,,490,23,92,115,370.0,84,6.48,76,407,2545,10.7
12371,Jeff Beukeboom,1997-98,32.0,12,4,44,44,1,3,4,29.0,,534,24,95,119,399.0,48,5.97,37,209,1408,10.2
12372,Jeff Beukeboom,1998-99,33.0,13,14,82,82,3,11,14,65.0,,616,27,106,133,464.0,82,6.29,74,413,2481,10.4
12373,Jeff Beukeboom,1999-00,34.0,14,12,80,80,3,9,12,55.0,,696,30,115,145,519.0,82,5.83,55,336,2444,9.8
12374,Jeff Beukeboom,2000-01,35.0,15,5,63,63,0,5,5,23.0,,759,30,120,150,542.0,82,5.28,57,380,2242,9.6
12375,Jeff Beukeboom,2001-02,36.0,16,9,45,45,0,9,9,8.0,628.0,804,30,129,159,550.0,82,5.27,57,359,2285,9.4
12376,Jeff Bloemberg,1991-92,24.0,4,0,9,9,0,0,0,9.0,,9,0,0,0,9.0,80,7.48,85,403,2430,12.3
12377,Jeff Bloemberg,1992-93,25.0,5,6,28,28,3,3,6,20.0,,37,3,3,6,29.0,80,7.37,76,367,2421,12.2
12378,Jeff Bloemberg,1993-94,26.0,6,2,3,3,0,2,2,4.0,,40,3,5,8,33.0,80,6.91,71,366,2385,11.6
12379,Jeff Bloemberg,1994-95,27.0,7,1,3,3,0,1,1,5.0,,43,3,6,9,38.0,80,6.96,77,402,2440,11.4
12380,Jeff Brown,1988-89,22.0,4,5,8,8,3,2,5,16.0,,8,3,2,5,16.0,80,7.94,82,370,2484,12.8
12381,Jeff Brown,1989-90,23.0,5,29,44,44,7,22,29,99.0,,52,10,24,34,115.0,80,7.34,72,344,2400,12.2
12382,Jeff Brown,1990-91,24.0,6,52,78,78,16,36,52,208.0,,130,26,60,86,323.0,80,7.43,89,437,2435,12.2
12383,Jeff Brown,1991-92,25.0,7,68,78,78,21,47,68,276.0,,208,47,107,154,599.0,80,7.48,85,403,2430,12.3
12384,Jeff Brown,1992-93,26.0,8,54,77,77,16,38,54,284.0,,285,63,145,208,883.0,80,7.37,76,367,2421,12.2
12385,Jeff Brown,1993-94,27.0,9,59,67,67,12,47,59,176.0,,352,75,192,267,1059.0,80,6.91,71,366,2385,11.6
12386,Jeff Brown,1994-95,28.0,10,59,80,80,20,39,59,214.0,,432,95,231,326,1273.0,80,6.96,77,402,2440,11.4
12387,Jeff Brown,1995-96,29.0,11,78,71,71,25,53,78,220.0,,503,120,284,404,1493.0,84,7.25,87,443,2603,11.7
12388,Jeff Brown,1996-97,30.0,12,66,74,74,14,52,66,237.0,,577,134,336,470,1730.0,84,6.48,76,407,2545,10.7
12389,Jeff Brown,1997-98,31.0,13,31,33,33,8,23,31,111.0,,610,142,359,501,1841.0,48,5.97,37,209,1408,10.2
12390,Jeff Brown,1998-99,32.0,14,55,76,76,8,47,55,177.0,,686,150,406,556,2018.0,82,6.29,74,413,2481,10.4
12391,Jeff Brown,1999-00,33.0,15,0,1,1,0,0,0,0.0,,687,150,406,556,2018.0,82,5.83,55,336,2444,9.8
12392,Jeff Brown,2000-01,34.0,16,28,60,60,4,24,28,102.0,,747,154,430,584,2120.0,82,5.28,57,380,2242,9.6
12393,Jeff Brownschidle,1984-85,25.0,4,1,3,3,0,1,1,4.0,,3,0,1,1,4.0,80,8.03,73,320,2489,12.9
12394,Jeff Brownschidle,1985-86,26.0,5,0,4,4,0,0,0,0.0,,7,0,1,1,4.0,80,7.73,71,310,2444,12.7
12395,Jeff Brubaker,1982-83,24.0,4,1,3,3,0,1,1,2.0,,3,0,1,1,2.0,80,7.03,61,280,2352,12.0
12396,Jeff Brubaker,1983-84,25.0,5,8,43,43,5,3,8,29.0,,46,5,4,9,31.0,80,7.69,77,340,2441,12.6
12397,Jeff Brubaker,1984-85,26.0,6,1,3,3,0,1,1,3.0,,49,5,5,10,34.0,80,8.03,73,320,2489,12.9
12398,Jeff Brubaker,1986-87,28.0,7,0,4,4,0,0,0,2.0,,53,5,5,10,36.0,80,7.89,74,336,2448,12.9
12399,Jeff Brubaker,1987-88,29.0,8,12,68,68,8,4,12,39.0,,121,13,9,22,75.0,80,7.77,71,321,2447,12.7
12400,Jeff Brubaker,1988-89,30.0,9,1,25,25,1,0,1,12.0,,146,14,9,23,87.0,80,7.94,82,370,2484,12.8
12401,Jeff Brubaker,1990-91,32.0,10,2,31,31,2,0,2,9.0,,177,16,9,25,96.0,80,7.43,89,437,2435,12.2
12402,Jeff Brubaker,1991-92,33.0,11,0,1,1,0,0,0,0.0,,178,16,9,25,96.0,80,7.48,85,403,2430,12.3
12403,Jeff Buchanan,2001-02,30.0,4,0,6,6,0,0,0,1.0,25.0,6,0,0,0,1.0,82,5.27,57,359,2285,9.4
12404,Jeff Carter,2008-09,24.0,4,42,81,81,23,19,42,189.0,978.0,81,23,19,42,189.0,82,6.05,85,480,2458,10.1
12405,Jeff Carter,2009-10,25.0,5,37,62,62,14,23,37,215.0,1178.0,143,37,42,79,404.0,82,5.76,70,398,2426,9.7
12406,Jeff Carter,2010-11,26.0,6,53,82,82,29,24,53,260.0,1545.0,225,66,66,132,664.0,82,5.44,62,351,2383,9.4
12407,Jeff Carter,2011-12,27.0,7,84,82,82,46,38,84,342.0,1718.0,307,112,104,216,1006.0,82,5.7,65,341,2477,9.4
12408,Jeff Carter,2012-13,28.0,8,61,74,74,33,28,61,319.0,1428.0,381,145,132,277,1325.0,82,5.53,56,304,2486,9.1
12409,Jeff Carter,2013-14,29.0,9,66,80,80,36,30,66,335.0,1460.0,461,181,162,343,1660.0,82,5.46,52,291,2492,9.0
12410,Jeff Carter,2014-15,30.0,10,34,55,55,21,13,34,184.0,1055.0,516,202,175,377,1844.0,82,5.32,47,271,2439,8.9
12411,Jeff Carter,2015-16,31.0,11,33,48,48,26,7,33,133.0,844.0,564,228,182,410,1977.0,48,5.31,29,160,1399,9.1
12412,Jeff Carter,2016-17,32.0,12,50,72,72,27,23,50,256.0,1365.0,636,255,205,460,2233.0,82,5.34,48,269,2463,8.9
12413,Jeff Carter,2017-18,33.0,13,62,82,82,28,34,62,218.0,1474.0,718,283,239,522,2451.0,82,5.32,47,251,2453,8.9
12414,Jeff Carter,2018-19,34.0,14,62,77,77,24,38,62,242.0,1416.0,795,307,277,584,2693.0,82,5.34,48,255,2438,9.0
12415,Jeff Carter,2019-20,35.0,15,66,82,82,32,34,66,250.0,1479.0,877,339,311,650,2943.0,82,5.45,47,245,2478,9.0
12416,Jeff Carter,2020-21,36.0,16,22,27,27,13,9,22,85.0,482.0,904,352,320,672,3028.0,82,5.86,50,250,2620,9.2
12417,Jeff Carter,2021-22,37.0,17,33,76,76,13,20,33,174.0,1380.0,980,365,340,705,3202.0,82,5.96,47,239,2579,9.5
12418,Jeff Carter,2022-23,38.0,18,27,60,60,17,10,27,182.0,1016.0,1040,382,350,732,3384.0,70,5.96,42,208,2192,9.5
12419,Jeff Christian,1994-95,24.0,4,0,2,2,0,0,0,1.0,,2,0,0,0,1.0,80,6.96,77,402,2440,11.4
12420,Jeff Christian,1997-98,27.0,5,0,1,1,0,0,0,2.0,,3,0,0,0,3.0,48,5.97,37,209,1408,10.2
12421,Jeff Christian,1998-99,28.0,6,0,3,3,0,0,0,0.0,,6,0,0,0,3.0,82,6.29,74,413,2481,10.4
12422,Jeff Christian,1999-00,29.0,7,4,11,11,2,2,4,18.0,,17,2,2,4,21.0,82,5.83,55,336,2444,9.8
12423,Jeff Christian,2000-01,30.0,8,0,1,1,0,0,0,0.0,,18,2,2,4,21.0,82,5.28,57,380,2242,9.6
12424,Jeff Chychrun,1989-90,23.0,4,0,1,1,0,0,0,1.0,,1,0,0,0,1.0,80,7.34,72,344,2400,12.2
12425,Jeff Chychrun,1990-91,24.0,5,0,3,3,0,0,0,1.0,,4,0,0,0,2.0,80,7.43,89,437,2435,12.2
12426,Jeff Chychrun,1991-92,25.0,6,5,80,80,1,4,5,53.0,,84,1,4,5,55.0,80,7.48,85,403,2430,12.3
12427,Jeff Chychrun,1992-93,26.0,7,9,79,79,2,7,9,52.0,,163,3,11,14,107.0,80,7.37,76,367,2421,12.2
12428,Jeff Chychrun,1993-94,27.0,8,6,36,36,0,6,6,25.0,,199,3,17,20,132.0,80,6.91,71,366,2385,11.6
12429,Jeff Chychrun,1994-95,28.0,9,4,43,43,0,4,4,26.0,,242,3,21,24,158.0,80,6.96,77,402,2440,11.4
12430,Jeff Chychrun,1995-96,29.0,10,1,18,18,0,1,1,3.0,,260,3,22,25,161.0,84,7.25,87,443,2603,11.7
12431,Jeff Chychrun,1996-97,30.0,11,0,2,2,0,0,0,2.0,,262,3,22,25,163.0,84,6.48,76,407,2545,10.7
12432,Jeff Cowan,2002-03,26.0,4,5,13,13,4,1,5,26.0,135.0,13,4,1,5,26.0,82,5.49,53,331,2294,9.8
12433,Jeff Cowan,2003-04,27.0,5,13,51,51,9,4,13,48.0,465.0,64,13,5,18,74.0,82,5.51,63,376,2272,9.9
12434,Jeff Cowan,2004-05,28.0,6,6,57,57,5,1,6,64.0,620.0,121,18,6,24,138.0,82,5.24,53,338,2262,9.5
12435,Jeff Cowan,2005-06,29.0,7,8,66,66,3,5,8,52.0,554.0,187,21,11,32,190.0,82,5.31,60,363,2326,9.4
12436,Jeff Cowan,2006-07,30.0,8,27,71,71,11,16,27,89.0,736.0,258,32,27,59,279.0,82,5.14,57,348,2300,9.2
12437,Jeff Cowan,2008-09,32.0,9,9,46,46,8,1,9,53.0,388.0,304,40,28,68,332.0,82,6.05,85,480,2458,10.1
12438,Jeff Cowan,2009-10,33.0,10,12,63,63,7,5,12,74.0,507.0,367,47,33,80,406.0,82,5.76,70,398,2426,9.7
12439,Jeff Cowan,2010-11,34.0,11,1,46,46,0,1,1,35.0,402.0,413,47,34,81,441.0,82,5.44,62,351,2383,9.4
12440,Jeff Daniels,1993-94,25.0,4,2,11,11,0,2,2,6.0,,11,0,2,2,6.0,80,6.91,71,366,2385,11.6
12441,Jeff Daniels,1994-95,26.0,5,0,2,2,0,0,0,0.0,,13,0,2,2,6.0,80,6.96,77,402,2440,11.4
12442,Jeff Daniels,1995-96,27.0,6,9,58,58,5,4,9,30.0,,71,5,6,11,36.0,84,7.25,87,443,2603,11.7
12443,Jeff Daniels,1996-97,28.0,7,8,70,70,3,5,8,52.0,,141,8,11,19,88.0,84,6.48,76,407,2545,10.7
12444,Jeff Daniels,1997-98,29.0,8,0,3,3,0,0,0,0.0,,144,8,11,19,88.0,48,5.97,37,209,1408,10.2
12445,Jeff Daniels,1999-00,31.0,9,2,10,10,0,2,2,6.0,,154,8,13,21,94.0,82,5.83,55,336,2444,9.8
12446,Jeff Daniels,2000-01,32.0,10,0,2,2,0,0,0,1.0,,156,8,13,21,95.0,82,5.28,57,380,2242,9.6
12447,Jeff Daniels,2001-02,33.0,11,4,9,9,1,3,4,8.0,98.0,165,9,16,25,103.0,82,5.27,57,359,2285,9.4
12448,Jeff Daniels,2002-03,34.0,12,7,69,69,3,4,7,28.0,531.0,234,12,20,32,131.0,82,5.49,53,331,2294,9.8
12449,Jeff Daniels,2003-04,35.0,13,2,67,67,1,1,2,42.0,502.0,301,13,21,34,173.0,82,5.51,63,376,2272,9.9
12450,Jeff Daniels,2004-05,36.0,14,5,65,65,4,1,5,40.0,527.0,366,17,22,39,213.0,82,5.24,53,338,2262,9.5
12451,Jeff Daniels,2005-06,37.0,15,4,59,59,0,4,4,41.0,497.0,425,17,26,43,254.0,82,5.31,60,363,2326,9.4
12452,Jeff Daw,2004-05,32.0,4,1,1,1,0,1,1,2.0,13.0,1,0,1,1,2.0,82,5.24,53,338,2262,9.5
12453,Jeff Eatough,1984-85,21.0,4,0,1,1,0,0,0,0.0,,1,0,0,0,0.0,80,8.03,73,320,2489,12.9
12454,Jeff Farkas,2003-04,26.0,4,0,2,2,0,0,0,1.0,28.0,2,0,0,0,1.0,82,5.51,63,376,2272,9.9
12455,Jeff Farkas,2004-05,27.0,5,2,6,6,0,2,2,3.0,58.0,8,0,2,2,4.0,82,5.24,53,338,2262,9.5
12456,Jeff Farkas,2005-06,28.0,6,0,3,3,0,0,0,5.0,41.0,11,0,2,2,9.0,82,5.31,60,363,2326,9.4
12457,Jeff Finger,2009-10,30.0,4,5,22,22,1,4,5,16.0,304.0,22,1,4,5,16.0,82,5.76,70,398,2426,9.7
12458,Jeff Finger,2010-11,31.0,5,19,72,72,8,11,19,93.0,1437.0,94,9,15,24,109.0,82,5.44,62,351,2383,9.4
12459,Jeff Finger,2011-12,32.0,6,23,66,66,6,17,23,68.0,1352.0,160,15,32,47,177.0,82,5.7,65,341,2477,9.4
12460,Jeff Finger,2012-13,33.0,7,10,39,39,2,8,10,29.0,538.0,199,17,40,57,206.0,82,5.53,56,304,2486,9.1
12461,Jeff Finley,1990-91,23.0,4,5,10,10,0,5,5,9.0,,10,0,5,5,9.0,80,7.43,89,437,2435,12.2
12462,Jeff Finley,1991-92,24.0,5,0,4,4,0,0,0,1.0,,14,0,5,5,10.0,80,7.48,85,403,2430,12.3
12463,Jeff Finley,1992-93,25.0,6,1,11,11,0,1,1,7.0,,25,0,6,6,17.0,80,7.37,76,367,2421,12.2
12464,Jeff Finley,1993-94,26.0,7,0,11,11,0,0,0,0.0,,36,0,6,6,17.0,80,6.91,71,366,2385,11.6
12465,Jeff Finley,1994-95,27.0,8,11,51,51,1,10,11,25.0,,87,1,16,17,42.0,80,6.96,77,402,2440,11.4
12466,Jeff Finley,1996-97,29.0,9,9,55,55,1,8,9,43.0,,142,2,24,26,85.0,84,6.48,76,407,2545,10.7
12467,Jeff Finley,1998-99,31.0,10,6,65,65,1,5,6,27.0,,207,3,29,32,112.0,82,6.29,74,413,2481,10.4
12468,Jeff Finley,1999-00,32.0,11,10,65,65,3,7,10,38.0,,272,6,36,42,150.0,82,5.83,55,336,2444,9.8
12469,Jeff Finley,2000-01,33.0,12,7,63,63,1,6,7,32.0,,335,7,42,49,182.0,82,5.28,57,380,2242,9.6
12470,Jeff Finley,2001-02,34.0,13,3,32,32,1,2,3,16.0,551.0,367,8,44,52,198.0,82,5.27,57,359,2285,9.4
12471,Jeff Finley,2002-03,35.0,14,10,74,74,2,8,10,31.0,1318.0,441,10,52,62,229.0,82,5.49,53,331,2294,9.8
12472,Jeff Finley,2003-04,36.0,15,10,72,72,2,8,10,35.0,1359.0,513,12,60,72,264.0,82,5.51,63,376,2272,9.9
12473,Jeff Finley,2004-05,37.0,16,6,78,78,0,6,6,39.0,1445.0,591,12,66,78,303.0,82,5.24,53,338,2262,9.5
12474,Jeff Finley,2005-06,38.0,17,4,64,64,1,3,4,30.0,1000.0,655,13,69,82,333.0,82,5.31,60,363,2326,9.4
12475,Jeff Finley,2006-07,39.0,18,1,53,53,0,1,1,25.0,906.0,708,13,70,83,358.0,82,5.14,57,348,2300,9.2
12476,Jeff Friesen,1997-98,21.0,4,25,48,48,15,10,25,86.0,,48,15,10,25,86.0,48,5.97,37,209,1408,10.2
12477,Jeff Friesen,1998-99,22.0,5,46,79,79,15,31,46,123.0,,127,30,41,71,209.0,82,6.29,74,413,2481,10.4
12478,Jeff Friesen,1999-00,23.0,6,62,82,82,28,34,62,200.0,,209,58,75,133,409.0,82,5.83,55,336,2444,9.8
12479,Jeff Friesen,2000-01,24.0,7,63,79,79,31,32,63,186.0,,288,89,107,196,595.0,82,5.28,57,380,2242,9.6
12480,Jeff Friesen,2001-02,25.0,8,57,78,78,22,35,57,215.0,1515.0,366,111,142,253,810.0,82,5.27,57,359,2285,9.4
12481,Jeff Friesen,2002-03,26.0,9,61,82,82,26,35,61,191.0,1623.0,448,137,177,314,1001.0,82,5.49,53,331,2294,9.8
12482,Jeff Friesen,2003-04,27.0,10,48,79,79,14,34,48,149.0,1528.0,527,151,211,362,1150.0,82,5.51,63,376,2272,9.9
12483,Jeff Friesen,2004-05,28.0,11,43,81,81,17,26,43,161.0,1457.0,608,168,237,405,1311.0,82,5.24,53,338,2262,9.5
12484,Jeff Friesen,2005-06,29.0,12,51,81,81,23,28,51,179.0,1259.0,689,191,265,456,1490.0,82,5.31,60,363,2326,9.4
12485,Jeff Friesen,2006-07,30.0,13,37,81,81,17,20,37,177.0,1226.0,770,208,285,493,1667.0,82,5.14,57,348,2300,9.2
12486,Jeff Friesen,2008-09,32.0,14,11,51,51,4,7,11,75.0,682.0,821,212,292,504,1742.0,82,6.05,85,480,2458,10.1
12487,Jeff Friesen,2009-10,33.0,15,12,72,72,6,6,12,55.0,877.0,893,218,298,516,1797.0,82,5.76,70,398,2426,9.7
12488,Jeff Giuliano,2008-09,29.0,4,7,48,48,3,4,7,32.0,468.0,48,3,4,7,32.0,82,6.05,85,480,2458,10.1
12489,Jeff Giuliano,2010-11,31.0,5,6,53,53,0,6,6,30.0,627.0,101,3,10,13,62.0,82,5.44,62,351,2383,9.4
12490,Jeff Greenlaw,1989-90,21.0,4,3,22,22,0,3,3,11.0,,22,0,3,3,11.0,80,7.34,72,344,2400,12.2
12491,Jeff Greenlaw,1993-94,25.0,5,2,10,10,2,0,2,9.0,,32,2,3,5,20.0,80,6.91,71,366,2385,11.6
12492,Jeff Greenlaw,1994-95,26.0,6,1,5,5,0,1,1,3.0,,37,2,4,6,23.0,80,6.96,77,402,2440,11.4
12493,Jeff Greenlaw,1995-96,27.0,7,2,16,16,1,1,2,15.0,,53,3,5,8,38.0,84,7.25,87,443,2603,11.7
12494,Jeff Greenlaw,1996-97,28.0,8,1,4,4,0,1,1,6.0,,57,3,6,9,44.0,84,6.48,76,407,2545,10.7
12495,Jeff Halpern,2002-03,26.0,4,29,79,79,18,11,29,108.0,1046.0,79,18,11,29,108.0,82,5.49,53,331,2294,9.8
12496,Jeff Halpern,2003-04,27.0,5,42,80,80,21,21,42,110.0,1291.0,159,39,32,71,218.0,82,5.51,63,376,2272,9.9
12497,Jeff Halpern,2004-05,28.0,6,19,48,48,5,14,19,74.0,735.0,207,44,46,90,292.0,82,5.24,53,338,2262,9.5
12498,Jeff Halpern,2005-06,29.0,7,34,82,82,13,21,34,126.0,1429.0,289,57,67,124,418.0,82,5.31,60,363,2326,9.4
12499,Jeff Halpern,2006-07,30.0,8,46,79,79,19,27,46,114.0,1505.0,368,76,94,170,532.0,82,5.14,57,348,2300,9.2
12500,Jeff Halpern,2008-09,32.0,9,44,70,70,11,33,44,151.0,1400.0,438,87,127,214,683.0,82,6.05,85,480,2458,10.1
12501,Jeff Halpern,2009-10,33.0,10,25,76,76,8,17,25,106.0,1277.0,514,95,144,239,789.0,82,5.76,70,398,2426,9.7
12502,Jeff Halpern,2010-11,34.0,11,42,83,83,20,22,42,132.0,1393.0,597,115,166,281,921.0,82,5.44,62,351,2383,9.4
12503,Jeff Halpern,2011-12,35.0,12,16,52,52,7,9,16,60.0,885.0,649,122,175,297,981.0,82,5.7,65,341,2477,9.4
12504,Jeff Halpern,2012-13,36.0,13,19,71,71,9,10,19,71.0,1031.0,720,131,185,316,1052.0,82,5.53,56,304,2486,9.1
12505,Jeff Halpern,2013-14,37.0,14,26,72,72,11,15,26,62.0,917.0,792,142,200,342,1114.0,82,5.46,52,291,2492,9.0
12506,Jeff Halpern,2014-15,38.0,15,16,69,69,4,12,16,63.0,870.0,861,146,212,358,1177.0,82,5.32,47,271,2439,8.9
12507,Jeff Halpern,2015-16,39.0,16,3,46,46,1,2,3,26.0,468.0,907,147,214,361,1203.0,48,5.31,29,160,1399,9.1
12508,Jeff Halpern,2016-17,40.0,17,12,69,69,5,7,12,45.0,710.0,976,152,221,373,1248.0,82,5.34,48,269,2463,8.9
12509,Jeff Hamilton,2006-07,29.0,4,0,1,1,0,0,0,1.0,10.0,1,0,0,0,1.0,82,5.14,57,348,2300,9.2
12510,Jeff Hamilton,2008-09,31.0,5,8,13,13,2,6,8,29.0,137.0,14,2,6,8,30.0,82,6.05,85,480,2458,10.1
12511,Jeff Hamilton,2009-10,32.0,6,39,70,70,18,21,39,138.0,905.0,84,20,27,47,168.0,82,5.76,70,398,2426,9.7
12512,Jeff Hamilton,2010-11,33.0,7,24,58,58,9,15,24,116.0,626.0,142,29,42,71,284.0,82,5.44,62,351,2383,9.4
12513,Jeff Hamilton,2011-12,34.0,8,6,15,15,3,3,6,30.0,194.0,157,32,45,77,314.0,82,5.7,65,341,2477,9.4
12514,Jeff Harding,1991-92,22.0,4,0,6,6,0,0,0,11.0,,6,0,0,0,11.0,80,7.48,85,403,2430,12.3
12515,Jeff Harding,1992-93,23.0,5,0,9,9,0,0,0,11.0,,15,0,0,0,22.0,80,7.37,76,367,2421,12.2
12516,Jeff Heerema,2005-06,26.0,4,3,10,10,3,0,3,16.0,96.0,10,3,0,3,16.0,82,5.31,60,363,2326,9.4
12517,Jeff Heerema,2006-07,27.0,5,3,22,22,1,2,3,28.0,230.0,32,4,2,6,44.0,82,5.14,57,348,2300,9.2
12518,Jeff Hoggan,2008-09,30.0,4,8,52,52,2,6,8,60.0,457.0,52,2,6,8,60.0,82,6.05,85,480,2458,10.1
12519,Jeff Hoggan,2009-10,31.0,5,2,46,46,0,2,2,53.0,325.0,98,2,8,10,113.0,82,5.76,70,398,2426,9.7
12520,Jeff Hoggan,2010-11,32.0,6,0,1,1,0,0,0,0.0,8.0,99,2,8,10,113.0,82,5.44,62,351,2383,9.4
12521,Jeff Hoggan,2011-12,33.0,7,1,4,4,0,1,1,7.0,48.0,103,2,9,11,120.0,82,5.7,65,341,2477,9.4
12522,Jeff Hoggan,2012-13,34.0,8,0,4,4,0,0,0,5.0,28.0,107,2,9,11,125.0,82,5.53,56,304,2486,9.1
12523,Jeff Jackson,1987-88,22.0,4,1,17,17,0,1,1,12.0,,17,0,1,1,12.0,80,7.77,71,321,2447,12.7
12524,Jeff Jackson,1988-89,23.0,5,3,5,5,1,2,3,2.0,,22,1,3,4,14.0,80,7.94,82,370,2484,12.8
12525,Jeff Jackson,1989-90,24.0,6,21,64,64,13,8,21,58.0,,86,14,11,25,72.0,80,7.34,72,344,2400,12.2
12526,Jeff Jackson,1990-91,25.0,7,27,68,68,9,18,27,98.0,,154,23,29,52,170.0,80,7.43,89,437,2435,12.2
12527,Jeff Jackson,1991-92,26.0,8,10,33,33,4,6,10,40.0,,187,27,35,62,210.0,80,7.48,85,403,2430,12.3
12528,Jeff Jackson,1992-93,27.0,9,20,65,65,8,12,20,73.0,,252,35,47,82,283.0,80,7.37,76,367,2421,12.2
12529,Jeff Jackson,1993-94,28.0,10,4,10,10,3,1,4,13.0,,262,38,48,86,296.0,80,6.91,71,366,2385,11.6
12530,Jeff Jackson,1994-95,29.0,11,0,1,1,0,0,0,0.0,,263,38,48,86,296.0,80,6.96,77,402,2440,11.4
12531,Jeff Jillson,2004-05,24.0,4,18,48,48,5,13,18,47.0,701.0,48,5,13,18,47.0,82,5.24,53,338,2262,9.5
12532,Jeff Jillson,2005-06,25.0,5,6,26,26,0,6,6,22.0,358.0,74,5,19,24,69.0,82,5.31,60,363,2326,9.4
12533,Jeff Jillson,2006-07,26.0,6,17,64,64,4,13,17,115.0,1151.0,138,9,32,41,184.0,82,5.14,57,348,2300,9.2
12534,Jeff Jillson,2008-09,28.0,7,0,2,2,0,0,0,1.0,29.0,140,9,32,41,185.0,82,6.05,85,480,2458,10.1
12535,Jeff Lank,2002-03,27.0,4,0,2,2,0,0,0,0.0,26.0,2,0,0,0,0.0,82,5.49,53,331,2294,9.8
12536,Jeff Larmer,1984-85,22.0,4,2,8,8,1,1,2,9.0,,8,1,1,2,9.0,80,8.03,73,320,2489,12.9
12537,Jeff Larmer,1985-86,23.0,5,45,65,65,21,24,45,124.0,,73,22,25,47,133.0,80,7.73,71,310,2444,12.7
12538,Jeff Larmer,1986-87,24.0,6,41,76,76,15,26,41,120.0,,149,37,51,88,253.0,80,7.89,74,336,2448,12.9
12539,Jeff Larmer,1987-88,25.0,7,0,7,7,0,0,0,5.0,,156,37,51,88,258.0,80,7.77,71,321,2447,12.7
12540,Jeff Larmer,1988-89,26.0,8,0,2,2,0,0,0,1.0,,158,37,51,88,259.0,80,7.94,82,370,2484,12.8
12541,Jeff Lazaro,1993-94,25.0,4,18,49,49,5,13,18,73.0,,49,5,13,18,73.0,80,6.91,71,366,2385,11.6
12542,Jeff Lazaro,1994-95,26.0,5,9,27,27,3,6,9,46.0,,76,8,19,27,119.0,80,6.96,77,402,2440,11.4
12543,Jeff Lazaro,1995-96,27.0,6,10,26,26,6,4,10,38.0,,102,14,23,37,157.0,84,7.25,87,443,2603,11.7
12544,Jeff Libby,2000-01,26.0,4,0,1,1,0,0,0,0.0,,1,0,0,0,0.0,82,5.28,57,380,2242,9.6
12545,Jeff MacMillan,2006-07,27.0,4,0,4,4,0,0,0,3.0,33.0,4,0,0,0,3.0,82,5.14,57,348,2300,9.2
12546,Jeff Madill,1993-94,28.0,4,4,14,14,4,0,4,24.0,,14,4,0,4,24.0,80,6.91,71,366,2385,11.6
12547,Jeff McLean,1996-97,27.0,4,1,6,6,1,0,1,5.0,,6,1,0,1,5.0,84,6.48,76,407,2545,10.7
12548,Jeff Mitchell,2000-01,25.0,4,0,7,7,0,0,0,3.0,,7,0,0,0,3.0,82,5.28,57,380,2242,9.6
12549,Jeff Nelson,1997-98,25.0,4,1,10,10,1,0,1,4.0,,10,1,0,1,4.0,48,5.97,37,209,1408,10.2
12550,Jeff Nelson,1998-99,26.0,5,7,33,33,0,7,7,21.0,,43,1,7,8,25.0,82,6.29,74,413,2481,10.4
12551,Jeff Nelson,2001-02,29.0,6,3,9,9,2,1,3,8.0,145.0,52,3,8,11,33.0,82,5.27,57,359,2285,9.4
12552,Jeff Nielsen,1999-00,28.0,4,0,2,2,0,0,0,1.0,,2,0,0,0,1.0,82,5.83,55,336,2444,9.8
12553,Jeff Nielsen,2000-01,29.0,5,9,32,32,4,5,9,36.0,,34,4,5,9,37.0,82,5.28,57,380,2242,9.6
12554,Jeff Nielsen,2001-02,30.0,6,9,80,80,5,4,9,94.0,821.0,114,9,9,18,131.0,82,5.27,57,359,2285,9.4
12555,Jeff Nielsen,2002-03,31.0,7,18,79,79,8,10,18,113.0,946.0,193,17,19,36,244.0,82,5.49,53,331,2294,9.8
12556,Jeff Nielsen,2003-04,32.0,8,11,59,59,3,8,11,82.0,800.0,252,20,27,47,326.0,82,5.51,63,376,2272,9.9
12557,Jeff Norton,1990-91,25.0,4,7,15,15,1,6,7,18.0,,15,1,6,7,18.0,80,7.43,89,437,2435,12.2
12558,Jeff Norton,1991-92,26.0,5,31,69,69,1,30,31,126.0,,84,2,36,38,144.0,80,7.48,85,403,2430,12.3
12559,Jeff Norton,1992-93,27.0,6,53,60,60,4,49,53,104.0,,144,6,85,91,248.0,80,7.37,76,367,2421,12.2
12560,Jeff Norton,1993-94,28.0,7,28,44,44,3,25,28,87.0,,188,9,110,119,335.0,80,6.91,71,366,2385,11.6
12561,Jeff Norton,1994-95,29.0,8,19,28,28,1,18,19,34.0,,216,10,128,138,369.0,80,6.96,77,402,2440,11.4
12562,Jeff Norton,1995-96,30.0,9,50,66,66,12,38,50,127.0,,282,22,166,188,496.0,84,7.25,87,443,2603,11.7
12563,Jeff Norton,1996-97,31.0,10,40,64,64,7,33,40,92.0,,346,29,199,228,588.0,84,6.48,76,407,2545,10.7
12564,Jeff Norton,1997-98,32.0,11,30,48,48,3,27,30,48.0,,394,32,226,258,636.0,48,5.97,37,209,1408,10.2
12565,Jeff Norton,1998-99,33.0,12,31,66,66,8,23,31,85.0,,460,40,249,289,721.0,82,6.29,74,413,2481,10.4
12566,Jeff Norton,1999-00,34.0,13,18,75,75,2,16,18,81.0,,535,42,265,307,802.0,82,5.83,55,336,2444,9.8
12567,Jeff Norton,2000-01,35.0,14,17,56,56,4,13,17,61.0,,591,46,278,324,863.0,82,5.28,57,380,2242,9.6
12568,Jeff Norton,2001-02,36.0,15,22,72,72,4,18,22,70.0,1496.0,663,50,296,346,933.0,82,5.27,57,359,2285,9.4
12569,Jeff Norton,2002-03,37.0,16,20,62,62,0,20,20,45.0,1212.0,725,50,316,366,978.0,82,5.49,53,331,2294,9.8
12570,Jeff Norton,2003-04,38.0,17,13,42,42,2,11,13,22.0,785.0,767,52,327,379,1000.0,82,5.51,63,376,2272,9.9
12571,Jeff Norton,2004-05,39.0,18,5,32,32,0,5,5,15.0,644.0,799,52,332,384,1015.0,82,5.24,53,338,2262,9.5
12572,Jeff O'Neill,1998-99,22.0,4,27,65,65,8,19,27,65.0,,65,8,19,27,65.0,82,6.29,74,413,2481,10.4
12573,Jeff O'Neill,1999-00,23.0,5,30,72,72,14,16,30,101.0,,137,22,35,57,166.0,82,5.83,55,336,2444,9.8
12574,Jeff O'Neill,2000-01,24.0,6,39,74,74,19,20,39,114.0,,211,41,55,96,280.0,82,5.28,57,380,2242,9.6
12575,Jeff O'Neill,2001-02,25.0,7,31,75,75,16,15,31,121.0,1255.0,286,57,70,127,401.0,82,5.27,57,359,2285,9.4
12576,Jeff O'Neill,2002-03,26.0,8,63,80,80,25,38,63,189.0,1546.0,366,82,108,190,590.0,82,5.49,53,331,2294,9.8
12577,Jeff O'Neill,2003-04,27.0,9,67,82,82,41,26,67,242.0,1504.0,448,123,134,257,832.0,82,5.51,63,376,2272,9.9
12578,Jeff O'Neill,2004-05,28.0,10,64,76,76,31,33,64,272.0,1500.0,524,154,167,321,1104.0,82,5.24,53,338,2262,9.5
12579,Jeff O'Neill,2005-06,29.0,11,61,82,82,30,31,61,316.0,1571.0,606,184,198,382,1420.0,82,5.31,60,363,2326,9.4
12580,Jeff O'Neill,2006-07,30.0,12,34,67,67,14,20,34,207.0,1171.0,673,198,218,416,1627.0,82,5.14,57,348,2300,9.2
12581,Jeff O'Neill,2008-09,32.0,13,38,74,74,19,19,38,169.0,936.0,747,217,237,454,1796.0,82,6.05,85,480,2458,10.1
12582,Jeff O'Neill,2009-10,33.0,14,42,74,74,20,22,42,165.0,1016.0,821,237,259,496,1961.0,82,5.76,70,398,2426,9.7
12583,Jeff Odgers,1994-95,25.0,4,11,61,61,7,4,11,64.0,,61,7,4,11,64.0,80,6.96,77,402,2440,11.4
12584,Jeff Odgers,1995-96,26.0,5,27,66,66,12,15,27,100.0,,127,19,19,38,164.0,84,7.25,87,443,2603,11.7
12585,Jeff Odgers,1996-97,27.0,6,21,81,81,13,8,21,73.0,,208,32,27,59,237.0,84,6.48,76,407,2545,10.7
12586,Jeff Odgers,1997-98,28.0,7,7,48,48,4,3,7,47.0,,256,36,30,66,284.0,48,5.97,37,209,1408,10.2
12587,Jeff Odgers,1998-99,29.0,8,16,78,78,12,4,16,84.0,,334,48,34,82,368.0,82,6.29,74,413,2481,10.4
12588,Jeff Odgers,1999-00,30.0,9,15,80,80,7,8,15,84.0,,414,55,42,97,452.0,82,5.83,55,336,2444,9.8
12589,Jeff Odgers,2000-01,31.0,10,13,68,68,5,8,13,47.0,,482,60,50,110,499.0,82,5.28,57,380,2242,9.6
12590,Jeff Odgers,2001-02,32.0,11,5,75,75,2,3,5,39.0,384.0,557,62,53,115,538.0,82,5.27,57,359,2285,9.4
12591,Jeff Odgers,2002-03,33.0,12,3,62,62,1,2,3,29.0,334.0,619,63,55,118,567.0,82,5.49,53,331,2294,9.8
12592,Jeff Odgers,2003-04,34.0,13,13,82,82,6,7,13,67.0,709.0,701,69,62,131,634.0,82,5.51,63,376,2272,9.9
12593,Jeff Odgers,2004-05,35.0,14,8,46,46,4,4,8,34.0,397.0,747,73,66,139,668.0,82,5.24,53,338,2262,9.5
12594,Jeff Odgers,2005-06,36.0,15,6,74,74,2,4,6,48.0,577.0,821,75,70,145,716.0,82,5.31,60,363,2326,9.4
12595,Jeff Parker,1989-90,25.0,4,6,15,15,3,3,6,10.0,,15,3,3,6,10.0,80,7.34,72,344,2400,12.2
12596,Jeff Parker,1990-91,26.0,5,2,4,4,0,2,2,0.0,,19,3,5,8,10.0,80,7.43,89,437,2435,12.2
12597,Jeff Parker,1991-92,27.0,6,18,57,57,9,9,18,78.0,,76,12,14,26,88.0,80,7.48,85,403,2430,12.3
12598,Jeff Parker,1992-93,28.0,7,9,61,61,4,5,9,61.0,,137,16,19,35,149.0,80,7.37,76,367,2421,12.2
12599,Jeff Parker,1993-94,29.0,8,0,4,4,0,0,0,4.0,,141,16,19,35,153.0,80,6.91,71,366,2385,11.6
12600,Jeff Paul,2005-06,27.0,4,0,2,2,0,0,0,0.0,7.0,2,0,0,0,0.0,82,5.31,60,363,2326,9.4
12601,Jeff Penner,2012-13,25.0,4,0,2,2,0,0,0,1.0,28.0,2,0,0,0,1.0,82,5.53,56,304,2486,9.1
12602,Jeff Petry,2013-14,26.0,4,5,35,35,1,4,5,41.0,713.0,35,1,4,5,41.0,82,5.46,52,291,2492,9.0
12603,Jeff Petry,2014-15,27.0,5,25,73,73,2,23,25,111.0,1589.0,108,3,27,30,152.0,82,5.32,47,271,2439,8.9
12604,Jeff Petry,2015-16,28.0,6,12,48,48,3,9,12,66.0,1052.0,156,6,36,42,218.0,48,5.31,29,160,1399,9.1
12605,Jeff Petry,2016-17,29.0,7,17,80,80,7,10,17,96.0,1727.0,236,13,46,59,314.0,82,5.34,48,269,2463,8.9
12606,Jeff Petry,2017-18,30.0,8,22,78,78,7,15,22,126.0,1658.0,314,20,61,81,440.0,82,5.32,47,251,2453,8.9
12607,Jeff Petry,2018-19,31.0,9,16,51,51,5,11,16,98.0,1089.0,365,25,72,97,538.0,82,5.34,48,255,2438,9.0
12608,Jeff Petry,2019-20,32.0,10,28,80,80,8,20,28,172.0,1769.0,445,33,92,125,710.0,82,5.45,47,245,2478,9.0
12609,Jeff Petry,2020-21,33.0,11,42,82,82,12,30,42,178.0,1927.0,527,45,122,167,888.0,82,5.86,50,250,2620,9.2
12610,Jeff Petry,2021-22,34.0,12,46,82,82,13,33,46,172.0,1896.0,609,58,155,213,1060.0,82,5.96,47,239,2579,9.5
12611,Jeff Petry,2022-23,35.0,13,40,71,71,11,29,40,158.0,1679.0,680,69,184,253,1218.0,70,5.96,42,208,2192,9.5
12612,Jeff Rohlicek,1990-91,25.0,4,0,7,7,0,0,0,2.0,,7,0,0,0,2.0,80,7.43,89,437,2435,12.2
12613,Jeff Rohlicek,1991-92,26.0,5,0,2,2,0,0,0,2.0,,9,0,0,0,4.0,80,7.48,85,403,2430,12.3
12614,Jeff Schultz,2009-10,23.0,4,3,38,38,0,3,3,22.0,692.0,38,0,3,3,22.0,82,5.76,70,398,2426,9.7
12615,Jeff Schultz,2010-11,24.0,5,18,72,72,5,13,18,36.0,1303.0,110,5,16,21,58.0,82,5.44,62,351,2383,9.4
12616,Jeff Schultz,2011-12,25.0,6,12,64,64,1,11,12,40.0,1265.0,174,6,27,33,98.0,82,5.7,65,341,2477,9.4
12617,Jeff Schultz,2012-13,26.0,7,23,73,73,3,20,23,43.0,1450.0,247,9,47,56,141.0,82,5.53,56,304,2486,9.1
12618,Jeff Schultz,2013-14,27.0,8,10,72,72,1,9,10,34.0,1424.0,319,10,56,66,175.0,82,5.46,52,291,2492,9.0
12619,Jeff Schultz,2014-15,28.0,9,6,54,54,1,5,6,22.0,826.0,373,11,61,72,197.0,82,5.32,47,271,2439,8.9
12620,Jeff Schultz,2015-16,29.0,10,3,26,26,0,3,3,12.0,371.0,399,11,64,75,209.0,48,5.31,29,160,1399,9.1
12621,Jeff Schultz,2017-18,31.0,11,1,9,9,0,1,1,7.0,151.0,408,11,65,76,216.0,82,5.32,47,251,2453,8.9
12622,Jeff Schultz,2018-19,32.0,12,0,1,1,0,0,0,1.0,18.0,409,11,65,76,217.0,82,5.34,48,255,2438,9.0
12623,Jeff Serowik,1993-94,27.0,4,0,1,1,0,0,0,1.0,,1,0,0,0,1.0,80,6.91,71,366,2385,11.6
12624,Jeff Serowik,1997-98,31.0,5,0,1,1,0,0,0,0.0,,2,0,0,0,1.0,48,5.97,37,209,1408,10.2
12625,Jeff Serowik,2001-02,35.0,6,6,26,26,0,6,6,26.0,414.0,28,0,6,6,27.0,82,5.27,57,359,2285,9.4
12626,Jeff Shantz,1996-97,23.0,4,16,52,52,3,13,16,56.0,,52,3,13,16,56.0,84,6.48,76,407,2545,10.7
12627,Jeff Shantz,1997-98,24.0,5,18,45,45,6,12,18,58.0,,97,9,25,34,114.0,48,5.97,37,209,1408,10.2
12628,Jeff Shantz,1998-99,25.0,6,20,78,78,6,14,20,72.0,,175,15,39,54,186.0,82,6.29,74,413,2481,10.4
12629,Jeff Shantz,1999-00,26.0,7,30,69,69,9,21,30,86.0,,244,24,60,84,272.0,82,5.83,55,336,2444,9.8
12630,Jeff Shantz,2000-01,27.0,8,31,61,61,11,20,31,69.0,,305,35,80,115,341.0,82,5.28,57,380,2242,9.6
12631,Jeff Shantz,2001-02,28.0,9,30,76,76,13,17,30,82.0,1265.0,381,48,97,145,423.0,82,5.27,57,359,2285,9.4
12632,Jeff Shantz,2002-03,29.0,10,31,74,74,13,18,31,112.0,1350.0,455,61,115,176,535.0,82,5.49,53,331,2294,9.8
12633,Jeff Shantz,2003-04,30.0,11,20,73,73,5,15,20,88.0,1084.0,528,66,130,196,623.0,82,5.51,63,376,2272,9.9
12634,Jeff Shantz,2004-05,31.0,12,6,40,40,3,3,6,37.0,457.0,568,69,133,202,660.0,82,5.24,53,338,2262,9.5
12635,Jeff Shantz,2005-06,32.0,13,9,74,74,3,6,9,68.0,848.0,642,72,139,211,728.0,82,5.31,60,363,2326,9.4
12636,Jeff Sharples,1989-90,22.0,4,1,3,3,0,1,1,1.0,,3,0,1,1,1.0,80,7.34,72,344,2400,12.2
12637,Jeff Sharples,1990-91,23.0,5,35,56,56,10,25,35,94.0,,59,10,26,36,95.0,80,7.43,89,437,2435,12.2
12638,Jeff Sharples,1991-92,24.0,6,13,46,46,4,9,13,48.0,,105,14,35,49,143.0,80,7.48,85,403,2430,12.3
12639,Jeff Shevalier,1997-98,23.0,4,1,1,1,1,0,1,1.0,,1,1,0,1,1.0,48,5.97,37,209,1408,10.2
12640,Jeff Shevalier,1999-00,25.0,5,13,26,26,4,9,13,42.0,,27,5,9,14,43.0,82,5.83,55,336,2444,9.8
12641,Jeff Shevalier,2002-03,28.0,6,0,5,5,0,0,0,2.0,11.0,32,5,9,14,45.0,82,5.49,53,331,2294,9.8
12642,Jeff Skinner,2013-14,21.0,4,63,82,82,31,32,63,215.0,1372.0,82,31,32,63,215.0,82,5.46,52,291,2492,9.0
12643,Jeff Skinner,2014-15,22.0,5,44,64,64,20,24,44,210.0,1192.0,146,51,56,107,425.0,82,5.32,47,271,2439,8.9
12644,Jeff Skinner,2015-16,23.0,6,24,42,42,13,11,24,159.0,775.0,188,64,67,131,584.0,48,5.31,29,160,1399,9.1
12645,Jeff Skinner,2016-17,24.0,7,54,71,71,33,21,54,274.0,1221.0,259,97,88,185,858.0,82,5.34,48,269,2463,8.9
12646,Jeff Skinner,2017-18,25.0,8,31,77,77,18,13,31,235.0,1236.0,336,115,101,216,1093.0,82,5.32,47,251,2453,8.9
12647,Jeff Skinner,2018-19,26.0,9,51,82,82,28,23,51,258.0,1336.0,418,143,124,267,1351.0,82,5.34,48,255,2438,9.0
12648,Jeff Skinner,2019-20,27.0,10,63,79,79,37,26,63,281.0,1401.0,497,180,150,330,1632.0,82,5.45,47,245,2478,9.0
12649,Jeff Skinner,2020-21,28.0,11,49,82,82,24,25,49,277.0,1370.0,579,204,175,379,1909.0,82,5.86,50,250,2620,9.2
12650,Jeff Skinner,2021-22,29.0,12,63,82,82,40,23,63,268.0,1518.0,661,244,198,442,2177.0,82,5.96,47,239,2579,9.5
12651,Jeff Skinner,2022-23,30.0,13,23,59,59,14,9,23,183.0,973.0,720,258,207,465,2360.0,70,5.96,42,208,2192,9.5
12652,Jeff Taffe,2005-06,24.0,4,4,20,20,3,1,4,18.0,231.0,20,3,1,4,18.0,82,5.31,60,363,2326,9.4
12653,Jeff Taffe,2006-07,25.0,5,18,59,59,8,10,18,67.0,651.0,79,11,11,22,85.0,82,5.14,57,348,2300,9.2
12654,Jeff Taffe,2008-09,27.0,6,0,4,4,0,0,0,3.0,26.0,83,11,11,22,88.0,82,6.05,85,480,2458,10.1
12655,Jeff Taffe,2009-10,28.0,7,6,17,17,4,2,6,34.0,241.0,100,15,13,28,122.0,82,5.76,70,398,2426,9.7
12656,Jeff Taffe,2010-11,29.0,8,12,45,45,5,7,12,56.0,431.0,145,20,20,40,178.0,82,5.44,62,351,2383,9.4
12657,Jeff Taffe,2011-12,30.0,9,2,8,8,0,2,2,5.0,68.0,153,20,22,42,183.0,82,5.7,65,341,2477,9.4
12658,Jeff Taffe,2012-13,31.0,10,2,21,21,1,1,2,18.0,177.0,174,21,23,44,201.0,82,5.53,56,304,2486,9.1
12659,Jeff Taffe,2013-14,32.0,11,0,1,1,0,0,0,0.0,4.0,175,21,23,44,201.0,82,5.46,52,291,2492,9.0
12660,Jeff Taffe,2014-15,33.0,12,2,5,5,0,2,2,7.0,65.0,180,21,25,46,208.0,82,5.32,47,271,2439,8.9
12661,Jeff Tambellini,2008-09,24.0,4,4,25,25,1,3,4,17.0,246.0,25,1,3,4,17.0,82,6.05,85,480,2458,10.1
12662,Jeff Tambellini,2009-10,25.0,5,9,23,23,2,7,9,20.0,166.0,48,3,10,13,37.0,82,5.76,70,398,2426,9.7
12663,Jeff Tambellini,2010-11,26.0,6,4,31,31,1,3,4,43.0,323.0,79,4,13,17,80.0,82,5.44,62,351,2383,9.4
12664,Jeff Tambellini,2011-12,27.0,7,15,65,65,7,8,15,98.0,852.0,144,11,21,32,178.0,82,5.7,65,341,2477,9.4
12665,Jeff Tambellini,2012-13,28.0,8,14,36,36,7,7,14,55.0,413.0,180,18,28,46,233.0,82,5.53,56,304,2486,9.1
12666,Jeff Tambellini,2013-14,29.0,9,17,62,62,9,8,17,114.0,731.0,242,27,36,63,347.0,82,5.46,52,291,2492,9.0
12667,Jeff Teal,1987-88,27.0,4,1,6,6,0,1,1,4.0,,6,0,1,1,4.0,80,7.77,71,321,2447,12.7
12668,Jeff Toms,1998-99,24.0,4,0,1,1,0,0,0,1.0,,1,0,0,0,1.0,82,6.29,74,413,2481,10.4
12669,Jeff Toms,1999-00,25.0,5,10,34,34,2,8,10,53.0,,35,2,8,10,54.0,82,5.83,55,336,2444,9.8
12670,Jeff Toms,2000-01,26.0,6,10,46,46,4,6,10,69.0,,81,6,14,20,123.0,82,5.28,57,380,2242,9.6
12671,Jeff Toms,2001-02,27.0,7,6,21,21,1,5,6,30.0,285.0,102,7,19,26,153.0,82,5.27,57,359,2285,9.4
12672,Jeff Toms,2002-03,28.0,8,3,20,20,1,2,3,18.0,169.0,122,8,21,29,171.0,82,5.49,53,331,2294,9.8
12673,Jeff Toms,2003-04,29.0,9,8,54,54,3,5,8,49.0,478.0,176,11,26,37,220.0,82,5.51,63,376,2272,9.9
12674,Jeff Toms,2004-05,30.0,10,14,52,52,9,5,14,84.0,572.0,228,20,31,51,304.0,82,5.24,53,338,2262,9.5
12675,Jeff Toms,2005-06,31.0,11,4,8,8,2,2,4,12.0,93.0,236,22,33,55,316.0,82,5.31,60,363,2326,9.4
12676,Jeff Ulmer,2003-04,26.0,4,3,21,21,3,0,3,22.0,218.0,21,3,0,3,22.0,82,5.51,63,376,2272,9.9
12677,Jeff Ware,1999-00,22.0,4,0,13,13,0,0,0,4.0,,13,0,0,0,4.0,82,5.83,55,336,2444,9.8
12678,Jeff Ware,2000-01,23.0,5,0,2,2,0,0,0,0.0,,15,0,0,0,4.0,82,5.28,57,380,2242,9.6
12679,Jeff Ware,2001-02,24.0,6,1,6,6,0,1,1,1.0,96.0,21,0,1,1,5.0,82,5.27,57,359,2285,9.4
12680,Jeff Woywitka,2008-09,25.0,4,2,26,26,0,2,2,23.0,277.0,26,0,2,2,23.0,82,6.05,85,480,2458,10.1
12681,Jeff Woywitka,2009-10,26.0,5,7,34,34,1,6,7,28.0,502.0,60,1,8,9,51.0,82,5.76,70,398,2426,9.7
12682,Jeff Woywitka,2010-11,27.0,6,8,27,27,2,6,8,25.0,434.0,87,3,14,17,76.0,82,5.44,62,351,2383,9.4
12683,Jeff Woywitka,2011-12,28.0,7,18,65,65,3,15,18,71.0,1201.0,152,6,29,35,147.0,82,5.7,65,341,2477,9.4
12684,Jeff Woywitka,2012-13,29.0,8,3,36,36,0,3,3,44.0,508.0,188,6,32,38,191.0,82,5.53,56,304,2486,9.1
12685,Jeff Woywitka,2013-14,30.0,9,11,63,63,2,9,11,72.0,1131.0,251,8,41,49,263.0,82,5.46,52,291,2492,9.0
12686,Jeff Woywitka,2014-15,31.0,10,6,27,27,1,5,6,13.0,281.0,278,9,46,55,276.0,82,5.32,47,271,2439,8.9
12687,Jeff Zehr,2002-03,24.0,4,0,4,4,0,0,0,3.0,30.0,4,0,0,0,3.0,82,5.49,53,331,2294,9.8
12688,Jere Karalahti,2002-03,27.0,4,16,48,48,6,10,16,69.0,820.0,48,6,10,16,69.0,82,5.49,53,331,2294,9.8
12689,Jere Karalahti,2003-04,28.0,5,9,56,56,2,7,9,26.0,956.0,104,8,17,25,95.0,82,5.51,63,376,2272,9.9
12690,Jere Karalahti,2004-05,29.0,6,2,45,45,0,2,2,27.0,762.0,149,8,19,27,122.0,82,5.24,53,338,2262,9.5
12691,Jere Lehtinen,1998-99,25.0,4,28,57,57,6,22,28,109.0,,57,6,22,28,109.0,82,6.29,74,413,2481,10.4
12692,Jere Lehtinen,1999-00,26.0,5,43,63,63,16,27,43,134.0,,120,22,49,71,243.0,82,5.83,55,336,2444,9.8
12693,Jere Lehtinen,2000-01,27.0,6,42,72,72,23,19,42,201.0,,192,45,68,113,444.0,82,5.28,57,380,2242,9.6
12694,Jere Lehtinen,2001-02,28.0,7,52,74,74,20,32,52,173.0,1450.0,266,65,100,165,617.0,82,5.27,57,359,2285,9.4
12695,Jere Lehtinen,2002-03,29.0,8,8,17,17,3,5,8,29.0,298.0,283,68,105,173,646.0,82,5.49,53,331,2294,9.8
12696,Jere Lehtinen,2003-04,30.0,9,45,74,74,20,25,45,148.0,1427.0,357,88,130,218,794.0,82,5.51,63,376,2272,9.9
12697,Jere Lehtinen,2004-05,31.0,10,49,73,73,25,24,49,198.0,1448.0,430,113,154,267,992.0,82,5.24,53,338,2262,9.5
12698,Jere Lehtinen,2005-06,32.0,11,48,80,80,31,17,48,238.0,1503.0,510,144,171,315,1230.0,82,5.31,60,363,2326,9.4
12699,Jere Lehtinen,2006-07,33.0,12,26,58,58,13,13,26,138.0,1128.0,568,157,184,341,1368.0,82,5.14,57,348,2300,9.2
12700,Jere Lehtinen,2008-09,35.0,13,52,80,80,33,19,52,216.0,1496.0,648,190,203,393,1584.0,82,6.05,85,480,2458,10.1
12701,Jere Lehtinen,2009-10,36.0,14,43,73,73,26,17,43,194.0,1418.0,721,216,220,436,1778.0,82,5.76,70,398,2426,9.7
12702,Jere Lehtinen,2010-11,37.0,15,37,48,48,15,22,37,118.0,908.0,769,231,242,473,1896.0,82,5.44,62,351,2383,9.4
12703,Jere Lehtinen,2011-12,38.0,16,24,48,48,8,16,24,119.0,912.0,817,239,258,497,2015.0,82,5.7,65,341,2477,9.4
12704,Jere Lehtinen,2012-13,39.0,17,17,58,58,4,13,17,87.0,855.0,875,243,271,514,2102.0,82,5.53,56,304,2486,9.1
12705,Jeremy Colliton,2008-09,24.0,4,2,19,19,1,1,2,9.0,120.0,19,1,1,2,9.0,82,6.05,85,480,2458,10.1
12706,Jeremy Colliton,2009-10,25.0,5,0,1,1,0,0,0,0.0,5.0,20,1,1,2,9.0,82,5.76,70,398,2426,9.7
12707,Jeremy Colliton,2010-11,26.0,6,0,16,16,0,0,0,16.0,140.0,36,1,1,2,25.0,82,5.44,62,351,2383,9.4
12708,Jeremy Colliton,2011-12,27.0,7,1,6,6,0,1,1,4.0,66.0,42,1,2,3,29.0,82,5.7,65,341,2477,9.4
12709,Jeremy Colliton,2013-14,29.0,8,3,15,15,2,1,3,7.0,178.0,57,3,3,6,36.0,82,5.46,52,291,2492,9.0
12710,Jeremy Lauzon,2021-22,24.0,4,1,16,16,1,0,1,11.0,249.0,16,1,0,1,11.0,82,5.96,47,239,2579,9.5
12711,Jeremy Lauzon,2022-23,25.0,5,2,19,19,1,1,2,20.0,293.0,35,2,1,3,31.0,70,5.96,42,208,2192,9.5
12712,Jeremy Morin,2013-14,22.0,4,3,9,9,2,1,3,13.0,109.0,9,2,1,3,13.0,82,5.46,52,291,2492,9.0
12713,Jeremy Morin,2014-15,23.0,5,0,3,3,0,0,0,2.0,27.0,12,2,1,3,15.0,82,5.32,47,271,2439,8.9
12714,Jeremy Morin,2015-16,24.0,6,2,3,3,1,1,2,7.0,39.0,15,3,2,5,22.0,48,5.31,29,160,1399,9.1
12715,Jeremy Morin,2016-17,25.0,7,11,24,24,5,6,11,46.0,220.0,39,8,8,16,68.0,82,5.34,48,269,2463,8.9
12716,Jeremy Morin,2017-18,26.0,8,6,43,43,2,4,6,73.0,439.0,82,10,12,22,141.0,82,5.32,47,251,2453,8.9
12717,Jeremy Reich,2006-07,27.0,4,1,9,9,0,1,1,3.0,69.0,9,0,1,1,3.0,82,5.14,57,348,2300,9.2
12718,Jeremy Reich,2009-10,30.0,5,1,32,32,0,1,1,27.0,263.0,41,0,2,2,30.0,82,5.76,70,398,2426,9.7
12719,Jeremy Reich,2010-11,31.0,6,4,58,58,2,2,4,39.0,479.0,99,2,4,6,69.0,82,5.44,62,351,2383,9.4
12720,Jeremy Roenick,1991-92,22.0,4,18,20,20,9,9,18,52.0,,20,9,9,18,52.0,80,7.48,85,403,2430,12.3
12721,Jeremy Roenick,1992-93,23.0,5,66,78,78,26,40,66,173.0,,98,35,49,84,225.0,80,7.37,76,367,2421,12.2
12722,Jeremy Roenick,1993-94,24.0,6,94,79,79,41,53,94,194.0,,177,76,102,178,419.0,80,6.91,71,366,2385,11.6
12723,Jeremy Roenick,1994-95,25.0,7,103,80,80,53,50,103,234.0,,257,129,152,281,653.0,80,6.96,77,402,2440,11.4
12724,Jeremy Roenick,1995-96,26.0,8,107,84,84,50,57,107,255.0,,341,179,209,388,908.0,84,7.25,87,443,2603,11.7
12725,Jeremy Roenick,1996-97,27.0,9,107,84,84,46,61,107,281.0,,425,225,270,495,1189.0,84,6.48,76,407,2545,10.7
12726,Jeremy Roenick,1997-98,28.0,10,34,33,33,10,24,34,93.0,,458,235,294,529,1282.0,48,5.97,37,209,1408,10.2
12727,Jeremy Roenick,1998-99,29.0,11,67,66,66,32,35,67,171.0,,524,267,329,596,1453.0,82,6.29,74,413,2481,10.4
12728,Jeremy Roenick,1999-00,30.0,12,69,72,72,29,40,69,228.0,,596,296,369,665,1681.0,82,5.83,55,336,2444,9.8
12729,Jeremy Roenick,2000-01,31.0,13,56,79,79,24,32,56,182.0,,675,320,401,721,1863.0,82,5.28,57,380,2242,9.6
12730,Jeremy Roenick,2001-02,32.0,14,72,78,78,24,48,72,203.0,1573.0,753,344,449,793,2066.0,82,5.27,57,359,2285,9.4
12731,Jeremy Roenick,2002-03,33.0,15,78,75,75,34,44,78,192.0,1564.0,828,378,493,871,2258.0,82,5.49,53,331,2294,9.8
12732,Jeremy Roenick,2003-04,34.0,16,76,80,80,30,46,76,192.0,1680.0,908,408,539,947,2450.0,82,5.51,63,376,2272,9.9
12733,Jeremy Roenick,2004-05,35.0,17,67,75,75,21,46,67,167.0,1367.0,983,429,585,1014,2617.0,82,5.24,53,338,2262,9.5
12734,Jeremy Roenick,2005-06,36.0,18,59,79,79,27,32,59,197.0,1485.0,1062,456,617,1073,2814.0,82,5.31,60,363,2326,9.4
12735,Jeremy Roenick,2006-07,37.0,19,47,62,62,19,28,47,128.0,1093.0,1124,475,645,1120,2942.0,82,5.14,57,348,2300,9.2
12736,Jeremy Roenick,2008-09,39.0,20,22,58,58,9,13,22,111.0,1007.0,1182,484,658,1142,3053.0,82,6.05,85,480,2458,10.1
12737,Jeremy Roenick,2009-10,40.0,21,28,70,70,11,17,28,89.0,973.0,1252,495,675,1170,3142.0,82,5.76,70,398,2426,9.7
12738,Jeremy Roenick,2010-11,41.0,22,33,69,69,14,19,33,89.0,949.0,1321,509,694,1203,3231.0,82,5.44,62,351,2383,9.4
12739,Jeremy Roenick,2011-12,42.0,23,13,42,42,4,9,13,50.0,489.0,1363,513,703,1216,3281.0,82,5.7,65,341,2477,9.4
12740,Jeremy Stevenson,1998-99,24.0,4,1,3,3,0,1,1,1.0,,3,0,1,1,1.0,82,6.29,74,413,2481,10.4
12741,Jeremy Stevenson,1999-00,25.0,5,0,5,5,0,0,0,1.0,,8,0,1,1,2.0,82,5.83,55,336,2444,9.8
12742,Jeremy Stevenson,2000-01,26.0,6,8,45,45,3,5,8,43.0,,53,3,6,9,45.0,82,5.28,57,380,2242,9.6
12743,Jeremy Stevenson,2002-03,28.0,7,0,3,3,0,0,0,2.0,21.0,56,3,6,9,47.0,82,5.49,53,331,2294,9.8
12744,Jeremy Stevenson,2003-04,29.0,8,1,8,8,1,0,1,6.0,51.0,64,4,6,10,53.0,82,5.51,63,376,2272,9.9
12745,Jeremy Stevenson,2004-05,30.0,9,0,4,4,0,0,0,0.0,24.0,68,4,6,10,53.0,82,5.24,53,338,2262,9.5
12746,Jeremy Stevenson,2005-06,31.0,10,11,32,32,5,6,11,29.0,345.0,100,9,12,21,82.0,82,5.31,60,363,2326,9.4
12747,Jeremy Stevenson,2006-07,32.0,11,9,56,56,5,4,9,67.0,567.0,156,14,16,30,149.0,82,5.14,57,348,2300,9.2
12748,Jeremy Stevenson,2008-09,34.0,12,8,51,51,5,3,8,48.0,369.0,207,19,19,38,197.0,82,6.05,85,480,2458,10.1
12749,Jeremy Welsh,2014-15,26.0,4,0,1,1,0,0,0,2.0,17.0,1,0,0,0,2.0,82,5.32,47,271,2439,8.9
12750,Jeremy Welsh,2015-16,27.0,5,1,5,5,0,1,1,4.0,29.0,6,0,1,1,6.0,48,5.31,29,160,1399,9.1
12751,Jeremy Welsh,2016-17,28.0,6,1,19,19,1,0,1,13.0,130.0,25,1,1,2,19.0,82,5.34,48,269,2463,8.9
12752,Jeremy Welsh,2018-19,30.0,7,0,2,2,0,0,0,0.0,17.0,27,1,1,2,19.0,82,5.34,48,255,2438,9.0
12753,Jeremy Williams,2008-09,25.0,4,1,1,1,1,0,1,1.0,10.0,1,1,0,1,1.0,82,6.05,85,480,2458,10.1
12754,Jeremy Williams,2009-10,26.0,5,1,1,1,1,0,1,3.0,7.0,2,2,0,2,4.0,82,5.76,70,398,2426,9.7
12755,Jeremy Williams,2010-11,27.0,6,2,18,18,2,0,2,16.0,132.0,20,4,0,4,20.0,82,5.44,62,351,2383,9.4
12756,Jeremy Williams,2011-12,28.0,7,7,11,11,5,2,7,21.0,148.0,31,9,2,11,41.0,82,5.7,65,341,2477,9.4
12757,Jeremy Williams,2013-14,30.0,8,0,1,1,0,0,0,0.0,4.0,32,9,2,11,41.0,82,5.46,52,291,2492,9.0
12758,Jeremy Yablonski,2006-07,26.0,4,0,1,1,0,0,0,1.0,8.0,1,0,0,0,1.0,82,5.14,57,348,2300,9.2
12759,Jergus Baca,1993-94,29.0,4,2,9,9,0,2,2,15.0,,9,0,2,2,15.0,80,6.91,71,366,2385,11.6
12760,Jergus Baca,1994-95,30.0,5,0,1,1,0,0,0,1.0,,10,0,2,2,16.0,80,6.96,77,402,2440,11.4
12761,Jerome Dupont,1984-85,22.0,4,4,34,34,0,4,4,22.0,,34,0,4,4,22.0,80,8.03,73,320,2489,12.9
12762,Jerome Dupont,1985-86,23.0,5,0,1,1,0,0,0,0.0,,35,0,4,4,22.0,80,7.73,71,310,2444,12.7
12763,Jerome Dupont,1986-87,24.0,6,4,36,36,2,2,4,28.0,,71,2,6,8,50.0,80,7.89,74,336,2448,12.9
12764,Jerome Dupont,1987-88,25.0,7,13,55,55,3,10,13,55.0,,126,5,16,21,105.0,80,7.77,71,321,2447,12.7
12765,Jerome Dupont,1988-89,26.0,8,15,75,75,2,13,15,69.0,,201,7,29,36,174.0,80,7.94,82,370,2484,12.8
12766,Jerome Dupont,1989-90,27.0,9,0,13,13,0,0,0,5.0,,214,7,29,36,179.0,80,7.34,72,344,2400,12.2
12767,Jerome Samson,2012-13,25.0,4,2,7,7,0,2,2,17.0,59.0,7,0,2,2,17.0,82,5.53,56,304,2486,9.1
12768,Jerome Samson,2013-14,26.0,5,2,23,23,0,2,2,28.0,158.0,30,0,4,4,45.0,82,5.46,52,291,2492,9.0
12769,Jerome Samson,2014-15,27.0,6,5,16,16,2,3,5,31.0,196.0,46,2,7,9,76.0,82,5.32,47,271,2439,8.9
12770,Jerred Smithson,2005-06,26.0,4,2,22,22,0,2,2,9.0,194.0,22,0,2,2,9.0,82,5.31,60,363,2326,9.4
12771,Jerred Smithson,2006-07,27.0,5,1,8,8,0,1,1,2.0,85.0,30,0,3,3,11.0,82,5.14,57,348,2300,9.2
12772,Jerred Smithson,2008-09,29.0,6,14,66,66,5,9,14,50.0,781.0,96,5,12,17,61.0,82,6.05,85,480,2458,10.1
12773,Jerred Smithson,2009-10,30.0,7,12,64,64,5,7,12,47.0,707.0,160,10,19,29,108.0,82,5.76,70,398,2426,9.7
12774,Jerred Smithson,2010-11,31.0,8,16,81,81,7,9,16,61.0,979.0,241,17,28,45,169.0,82,5.44,62,351,2383,9.4
12775,Jerred Smithson,2011-12,32.0,9,13,82,82,4,9,13,74.0,1135.0,323,21,37,58,243.0,82,5.7,65,341,2477,9.4
12776,Jerred Smithson,2012-13,33.0,10,13,69,69,9,4,13,54.0,964.0,392,30,41,71,297.0,82,5.53,56,304,2486,9.1
12777,Jerred Smithson,2013-14,34.0,11,13,82,82,5,8,13,73.0,1218.0,474,35,49,84,370.0,82,5.46,52,291,2492,9.0
12778,Jerred Smithson,2014-15,35.0,12,6,69,69,1,5,6,37.0,808.0,543,36,54,90,407.0,82,5.32,47,271,2439,8.9
12779,Jerred Smithson,2015-16,36.0,13,6,45,45,3,3,6,29.0,480.0,588,39,57,96,436.0,48,5.31,29,160,1399,9.1
12780,Jerred Smithson,2016-17,37.0,14,0,18,18,0,0,0,2.0,158.0,606,39,57,96,438.0,82,5.34,48,269,2463,8.9
12781,Jerry D'Amigo,2016-17,25.0,4,3,22,22,1,2,3,12.0,177.0,22,1,2,3,12.0,82,5.34,48,269,2463,8.9
12782,Jerry D'Amigo,2017-18,26.0,5,0,9,9,0,0,0,7.0,88.0,31,1,2,3,19.0,82,5.32,47,251,2453,8.9
12783,Jesper Boqvist,2022-23,24.0,4,4,35,35,4,0,4,41.0,383.0,35,4,0,4,41.0,70,5.96,42,208,2192,9.5
12784,Jesper Bratt,2020-21,22.0,4,35,74,74,13,22,35,100.0,1129.0,74,13,22,35,100.0,82,5.86,50,250,2620,9.2
12785,Jesper Bratt,2021-22,23.0,5,33,51,51,8,25,33,91.0,774.0,125,21,47,68,191.0,82,5.96,47,239,2579,9.5
12786,Jesper Bratt,2022-23,24.0,6,32,60,60,16,16,32,101.0,839.0,185,37,63,100,292.0,70,5.96,42,208,2192,9.5
12787,Jesper Fast,2016-17,25.0,4,0,11,11,0,0,0,7.0,124.0,11,0,0,0,7.0,82,5.34,48,269,2463,8.9
12788,Jesper Fast,2017-18,26.0,5,14,58,58,6,8,14,52.0,685.0,69,6,8,14,59.0,82,5.32,47,251,2453,8.9
12789,Jesper Fast,2018-19,27.0,6,30,79,79,10,20,30,75.0,1180.0,148,16,28,44,134.0,82,5.34,48,255,2438,9.0
12790,Jesper Fast,2019-20,28.0,7,21,68,68,6,15,21,56.0,938.0,216,22,43,65,190.0,82,5.45,47,245,2478,9.0
12791,Jesper Fast,2020-21,29.0,8,33,71,71,13,20,33,80.0,1057.0,287,35,63,98,270.0,82,5.86,50,250,2620,9.2
12792,Jesper Fast,2021-22,30.0,9,20,66,66,8,12,20,80.0,1038.0,353,43,75,118,350.0,82,5.96,47,239,2579,9.5
12793,Jesper Fast,2022-23,31.0,10,29,69,69,12,17,29,84.0,1146.0,422,55,92,147,434.0,70,5.96,42,208,2192,9.5
12794,Jesperi Kotkaniemi,2021-22,21.0,4,34,79,79,11,23,34,134.0,1086.0,79,11,23,34,134.0,82,5.96,47,239,2579,9.5
12795,Jesperi Kotkaniemi,2022-23,22.0,5,8,36,36,6,2,8,55.0,468.0,115,17,25,42,189.0,70,5.96,42,208,2192,9.5
12796,Jesse Belanger,1994-95,25.0,4,0,4,4,0,0,0,4.0,,4,0,0,0,4.0,80,6.96,77,402,2440,11.4
12797,Jesse Belanger,1995-96,26.0,5,6,19,19,4,2,6,24.0,,23,4,2,6,28.0,84,7.25,87,443,2603,11.7
12798,Jesse Belanger,1996-97,27.0,6,50,70,70,17,33,50,104.0,,93,21,35,56,132.0,84,6.48,76,407,2545,10.7
12799,Jesse Belanger,1997-98,28.0,7,29,47,47,15,14,29,89.0,,140,36,49,85,221.0,48,5.97,37,209,1408,10.2
12800,Jesse Belanger,1998-99,29.0,8,41,72,72,20,21,41,151.0,,212,56,70,126,372.0,82,6.29,74,413,2481,10.4
12801,Jesse Belanger,1999-00,30.0,9,0,6,6,0,0,0,8.0,,218,56,70,126,380.0,82,5.83,55,336,2444,9.8
12802,Jesse Belanger,2002-03,33.0,10,9,16,16,3,6,9,21.0,171.0,234,59,76,135,401.0,82,5.49,53,331,2294,9.8
12803,Jesse Belanger,2003-04,34.0,11,0,12,12,0,0,0,7.0,70.0,246,59,76,135,408.0,82,5.51,63,376,2272,9.9
12804,Jesse Blacker,2017-18,26.0,4,0,1,1,0,0,0,0.0,6.0,1,0,0,0,0.0,82,5.32,47,251,2453,8.9
12805,Jesse Boulerice,2004-05,26.0,4,0,3,3,0,0,0,1.0,13.0,3,0,0,0,1.0,82,5.24,53,338,2262,9.5
12806,Jesse Boulerice,2005-06,27.0,5,3,48,48,2,1,3,12.0,187.0,51,2,1,3,13.0,82,5.31,60,363,2326,9.4
12807,Jesse Boulerice,2006-07,28.0,6,7,76,76,6,1,7,46.0,497.0,127,8,2,10,59.0,82,5.14,57,348,2300,9.2
12808,Jesse Boulerice,2008-09,30.0,7,0,38,38,0,0,0,5.0,97.0,165,8,2,10,64.0,82,6.05,85,480,2458,10.1
12809,Jesse Boulerice,2010-11,32.0,8,0,5,5,0,0,0,1.0,19.0,170,8,2,10,65.0,82,5.44,62,351,2383,9.4
12810,Jesse Boulerice,2011-12,33.0,9,0,2,2,0,0,0,0.0,7.0,172,8,2,10,65.0,82,5.7,65,341,2477,9.4
12811,Jesse Fibiger,2005-06,27.0,4,0,16,16,0,0,0,2.0,97.0,16,0,0,0,2.0,82,5.31,60,363,2326,9.4
12812,Jesse Joensuu,2011-12,24.0,4,3,7,7,1,2,3,9.0,85.0,7,1,2,3,9.0,82,5.7,65,341,2477,9.4
12813,Jesse Joensuu,2012-13,25.0,5,1,11,11,1,0,1,13.0,123.0,18,2,2,4,22.0,82,5.53,56,304,2486,9.1
12814,Jesse Joensuu,2013-14,26.0,6,9,42,42,6,3,9,41.0,486.0,60,8,5,13,63.0,82,5.46,52,291,2492,9.0
12815,Jesse Joensuu,2015-16,28.0,7,2,7,7,0,2,2,15.0,71.0,67,8,7,15,78.0,48,5.31,29,160,1399,9.1
12816,Jesse Joensuu,2016-17,29.0,8,5,42,42,3,2,5,41.0,392.0,109,11,9,20,119.0,82,5.34,48,269,2463,8.9
12817,Jesse Joensuu,2017-18,30.0,9,4,20,20,2,2,4,18.0,213.0,129,13,11,24,137.0,82,5.32,47,251,2453,8.9
12818,Jesse Puljujarvi,2019-20,21.0,4,8,28,28,1,7,8,41.0,315.0,28,1,7,8,41.0,82,5.45,47,245,2478,9.0
12819,Jesse Puljujarvi,2020-21,22.0,5,20,65,65,12,8,20,136.0,869.0,93,13,15,28,177.0,82,5.86,50,250,2620,9.2
12820,Jesse Puljujarvi,2021-22,23.0,6,9,46,46,4,5,9,53.0,550.0,139,17,20,37,230.0,82,5.96,47,239,2579,9.5
12821,Jesse Schultz,2009-10,27.0,4,0,2,2,0,0,0,6.0,20.0,2,0,0,0,6.0,82,5.76,70,398,2426,9.7
12822,Jesse Wallin,2002-03,24.0,4,0,1,1,0,0,0,0.0,19.0,1,0,0,0,0.0,82,5.49,53,331,2294,9.8
12823,Jesse Wallin,2003-04,25.0,5,0,1,1,0,0,0,1.0,4.0,2,0,0,0,1.0,82,5.51,63,376,2272,9.9
12824,Jesse Wallin,2004-05,26.0,6,1,15,15,0,1,1,8.0,160.0,17,0,1,1,9.0,82,5.24,53,338,2262,9.5
12825,Jesse Wallin,2005-06,27.0,7,1,32,32,0,1,1,23.0,425.0,49,0,2,2,32.0,82,5.31,60,363,2326,9.4
12826,Jesse Winchester,2010-11,27.0,4,0,1,1,0,0,0,1.0,14.0,1,0,0,0,1.0,82,5.44,62,351,2383,9.4
12827,Jesse Winchester,2011-12,28.0,5,18,76,76,3,15,18,115.0,805.0,77,3,15,18,116.0,82,5.7,65,341,2477,9.4
12828,Jesse Winchester,2012-13,29.0,6,13,52,52,2,11,13,77.0,521.0,129,5,26,31,193.0,82,5.53,56,304,2486,9.1
12829,Jesse Winchester,2013-14,30.0,7,13,72,72,4,9,13,118.0,780.0,201,9,35,44,311.0,82,5.46,52,291,2492,9.0
12830,Jesse Winchester,2014-15,31.0,8,8,32,32,2,6,8,52.0,340.0,233,11,41,52,363.0,82,5.32,47,271,2439,8.9
12831,Jesse Winchester,2016-17,33.0,9,18,52,52,9,9,18,100.0,662.0,285,20,50,70,463.0,82,5.34,48,269,2463,8.9
12832,Jim Agnew,1989-90,23.0,4,0,4,4,0,0,0,1.0,,4,0,0,0,1.0,80,7.34,72,344,2400,12.2
12833,Jim Agnew,1990-91,24.0,5,1,10,10,0,1,1,4.0,,14,0,1,1,5.0,80,7.43,89,437,2435,12.2
12834,Jim Agnew,1992-93,26.0,6,0,7,7,0,0,0,3.0,,21,0,1,1,8.0,80,7.37,76,367,2421,12.2
12835,Jim Agnew,1993-94,27.0,7,0,20,20,0,0,0,12.0,,41,0,1,1,20.0,80,6.91,71,366,2385,11.6
12836,Jim Agnew,1994-95,28.0,8,0,24,24,0,0,0,9.0,,65,0,1,1,29.0,80,6.96,77,402,2440,11.4
12837,Jim Agnew,1995-96,29.0,9,0,16,16,0,0,0,3.0,,81,0,1,1,32.0,84,7.25,87,443,2603,11.7
12838,Jim Archibald,1987-88,26.0,4,3,4,4,1,2,3,12.0,,4,1,2,3,12.0,80,7.77,71,321,2447,12.7
12839,Jim Archibald,1988-89,27.0,5,0,11,11,0,0,0,7.0,,15,1,2,3,19.0,80,7.94,82,370,2484,12.8
12840,Jim Archibald,1989-90,28.0,6,0,1,1,0,0,0,1.0,,16,1,2,3,20.0,80,7.34,72,344,2400,12.2
12841,Jim Benning,1984-85,21.0,4,31,74,74,7,24,31,90.0,,74,7,24,31,90.0,80,8.03,73,320,2489,12.9
12842,Jim Benning,1985-86,22.0,5,22,74,74,5,17,22,68.0,,148,12,41,53,158.0,80,7.73,71,310,2444,12.7
12843,Jim Benning,1986-87,23.0,6,51,79,79,12,39,51,136.0,,227,24,80,104,294.0,80,7.89,74,336,2448,12.9
12844,Jim Benning,1987-88,24.0,7,44,80,80,9,35,44,161.0,,307,33,115,148,455.0,80,7.77,71,321,2447,12.7
12845,Jim Benning,1988-89,25.0,8,25,52,52,4,21,25,76.0,,359,37,136,173,531.0,80,7.94,82,370,2484,12.8
12846,Jim Benning,1989-90,26.0,9,13,59,59,2,11,13,62.0,,418,39,147,186,593.0,80,7.34,72,344,2400,12.2
12847,Jim Benning,1990-91,27.0,10,33,77,77,7,26,33,102.0,,495,46,173,219,695.0,80,7.43,89,437,2435,12.2
12848,Jim Benning,1991-92,28.0,11,12,65,65,3,9,12,55.0,,560,49,182,231,750.0,80,7.48,85,403,2430,12.3
12849,Jim Benning,1992-93,29.0,12,12,45,45,3,9,12,49.0,,605,52,191,243,799.0,80,7.37,76,367,2421,12.2
12850,Jim Brown,1985-86,25.0,4,1,3,3,0,1,1,0.0,,3,0,1,1,0.0,80,7.73,71,310,2444,12.7
12851,Jim Campbell,1998-99,25.0,4,5,16,16,2,3,5,25.0,,16,2,3,5,25.0,82,6.29,74,413,2481,10.4
12852,Jim Campbell,1999-00,26.0,5,43,68,68,23,20,43,169.0,,84,25,23,48,194.0,82,5.83,55,336,2444,9.8
12853,Jim Campbell,2000-01,27.0,6,41,76,76,22,19,41,147.0,,160,47,42,89,341.0,82,5.28,57,380,2242,9.6
12854,Jim Campbell,2001-02,28.0,7,25,55,55,4,21,25,99.0,746.0,215,51,63,114,440.0,82,5.27,57,359,2285,9.4
12855,Jim Campbell,2002-03,29.0,8,0,2,2,0,0,0,6.0,31.0,217,51,63,114,446.0,82,5.49,53,331,2294,9.8
12856,Jim Campbell,2003-04,30.0,9,20,57,57,9,11,20,81.0,588.0,274,60,74,134,527.0,82,5.51,63,376,2272,9.9
12857,Jim Campbell,2004-05,31.0,10,2,9,9,1,1,2,12.0,120.0,283,61,75,136,539.0,82,5.24,53,338,2262,9.5
12858,Jim Campbell,2005-06,32.0,11,0,1,1,0,0,0,3.0,9.0,284,61,75,136,542.0,82,5.31,60,363,2326,9.4
12859,Jim Campbell,2008-09,35.0,12,0,1,1,0,0,0,0.0,9.0,285,61,75,136,542.0,82,6.05,85,480,2458,10.1
12860,Jim Culhane,1992-93,27.0,4,1,6,6,0,1,1,6.0,,6,0,1,1,6.0,80,7.37,76,367,2421,12.2
12861,Jim Cummins,1994-95,24.0,4,0,1,1,0,0,0,0.0,,1,0,0,0,0.0,80,6.96,77,402,2440,11.4
12862,Jim Cummins,1995-96,25.0,5,2,7,7,1,1,2,5.0,,8,1,1,2,5.0,84,7.25,87,443,2603,11.7
12863,Jim Cummins,1996-97,26.0,6,3,26,26,1,2,3,20.0,,34,2,3,5,25.0,84,6.48,76,407,2545,10.7
12864,Jim Cummins,1997-98,27.0,7,5,37,37,4,1,5,23.0,,71,6,4,10,48.0,48,5.97,37,209,1408,10.2
12865,Jim Cummins,1998-99,28.0,8,6,52,52,2,4,6,34.0,,123,8,8,16,82.0,82,6.29,74,413,2481,10.4
12866,Jim Cummins,1999-00,29.0,9,12,65,65,6,6,12,61.0,,188,14,14,28,143.0,82,5.83,55,336,2444,9.8
12867,Jim Cummins,2000-01,30.0,10,2,75,75,0,2,2,43.0,,263,14,16,30,186.0,82,5.28,57,380,2242,9.6
12868,Jim Cummins,2001-02,31.0,11,8,55,55,1,7,8,26.0,391.0,318,15,23,38,212.0,82,5.27,57,359,2285,9.4
12869,Jim Cummins,2002-03,32.0,12,8,47,47,3,5,8,33.0,422.0,365,18,28,46,245.0,82,5.49,53,331,2294,9.8
12870,Jim Cummins,2003-04,33.0,13,11,79,79,5,6,11,45.0,572.0,444,23,34,57,290.0,82,5.51,63,376,2272,9.9
12871,Jim Cummins,2004-05,34.0,14,0,12,12,0,0,0,3.0,59.0,456,23,34,57,293.0,82,5.24,53,338,2262,9.5
12872,Jim Cummins,2006-07,36.0,15,3,55,55,1,2,3,25.0,321.0,511,24,36,60,318.0,82,5.14,57,348,2300,9.2
12873,Jim Dobson,1982-83,22.0,4,0,1,1,0,0,0,0.0,,1,0,0,0,0.0,80,7.03,61,280,2352,12.0
12874,Jim Dobson,1983-84,23.0,5,0,1,1,0,0,0,0.0,,2,0,0,0,0.0,80,7.69,77,340,2441,12.6
12875,Jim Dobson,1984-85,24.0,6,0,9,9,0,0,0,10.0,,11,0,0,0,10.0,80,8.03,73,320,2489,12.9
12876,Jim Dobson,1986-87,26.0,7,0,1,1,0,0,0,1.0,,12,0,0,0,11.0,80,7.89,74,336,2448,12.9
12877,Jim Dowd,1994-95,26.0,4,0,1,1,0,0,0,0.0,,1,0,0,0,0.0,80,6.96,77,402,2440,11.4
12878,Jim Dowd,1995-96,27.0,5,0,1,1,0,0,0,1.0,,2,0,0,0,1.0,84,7.25,87,443,2603,11.7
12879,Jim Dowd,1996-97,28.0,6,15,15,15,5,10,15,26.0,,17,5,10,15,27.0,84,6.48,76,407,2545,10.7
12880,Jim Dowd,1997-98,29.0,7,5,10,10,1,4,5,14.0,,27,6,14,20,41.0,48,5.97,37,209,1408,10.2
12881,Jim Dowd,1998-99,30.0,8,20,66,66,5,15,20,76.0,,93,11,29,40,117.0,82,6.29,74,413,2481,10.4
12882,Jim Dowd,1999-00,31.0,9,0,3,3,0,0,0,0.0,,96,11,29,40,117.0,82,5.83,55,336,2444,9.8
12883,Jim Dowd,2000-01,32.0,10,14,48,48,6,8,14,58.0,,144,17,37,54,175.0,82,5.28,57,380,2242,9.6
12884,Jim Dowd,2001-02,33.0,11,0,1,1,0,0,0,1.0,10.0,145,17,37,54,176.0,82,5.27,57,359,2285,9.4
12885,Jim Dowd,2002-03,34.0,12,23,69,69,5,18,23,103.0,906.0,214,22,55,77,279.0,82,5.49,53,331,2294,9.8
12886,Jim Dowd,2003-04,35.0,13,29,68,68,7,22,29,92.0,1213.0,282,29,77,106,371.0,82,5.51,63,376,2272,9.9
12887,Jim Dowd,2004-05,36.0,14,43,82,82,13,30,43,111.0,1276.0,364,42,107,149,482.0,82,5.24,53,338,2262,9.5
12888,Jim Dowd,2005-06,37.0,15,25,78,78,8,17,25,78.0,1018.0,442,50,124,174,560.0,82,5.31,60,363,2326,9.4
12889,Jim Dowd,2006-07,38.0,16,29,69,69,7,22,29,54.0,965.0,511,57,146,203,614.0,82,5.14,57,348,2300,9.2
12890,Jim Dowd,2008-09,40.0,17,18,78,78,5,13,18,67.0,980.0,589,62,159,221,681.0,82,6.05,85,480,2458,10.1
12891,Jim Dowd,2009-10,41.0,18,8,66,66,4,4,8,44.0,547.0,655,66,163,229,725.0,82,5.76,70,398,2426,9.7
12892,Jim Dowd,2010-11,42.0,19,10,73,73,5,5,10,41.0,616.0,728,71,168,239,766.0,82,5.44,62,351,2383,9.4
12893,Jim Ennis,1990-91,23.0,4,1,5,5,1,0,1,9.0,,5,1,0,1,9.0,80,7.43,89,437,2435,12.2
12894,Jim Fahey,2005-06,26.0,4,20,43,43,1,19,20,66.0,788.0,43,1,19,20,66.0,82,5.31,60,363,2326,9.4
12895,Jim Fahey,2006-07,27.0,5,2,15,15,0,2,2,19.0,254.0,58,1,21,22,85.0,82,5.14,57,348,2300,9.2
12896,Jim Fahey,2008-09,29.0,6,2,21,21,0,2,2,22.0,266.0,79,1,23,24,107.0,82,6.05,85,480,2458,10.1
12897,Jim Fahey,2009-10,30.0,7,1,13,13,0,1,1,7.0,140.0,92,1,24,25,114.0,82,5.76,70,398,2426,9.7
12898,Jim Fox,1983-84,23.0,4,43,71,71,18,25,43,92.0,,71,18,25,43,92.0,80,7.69,77,340,2441,12.6
12899,Jim Fox,1984-85,24.0,5,68,77,77,30,38,68,157.0,,148,48,63,111,249.0,80,8.03,73,320,2489,12.9
12900,Jim Fox,1985-86,25.0,6,68,77,77,28,40,68,137.0,,225,76,103,179,386.0,80,7.73,71,310,2444,12.7
12901,Jim Fox,1986-87,26.0,7,72,80,80,30,42,72,153.0,,305,106,145,251,539.0,80,7.89,74,336,2448,12.9
12902,Jim Fox,1987-88,27.0,8,83,79,79,30,53,83,173.0,,384,136,198,334,712.0,80,7.77,71,321,2447,12.7
12903,Jim Fox,1988-89,28.0,9,31,39,39,14,17,31,81.0,,423,150,215,365,793.0,80,7.94,82,370,2484,12.8
12904,Jim Fox,1989-90,29.0,10,61,76,76,19,42,61,162.0,,499,169,257,426,955.0,80,7.34,72,344,2400,12.2
12905,Jim Fox,1990-91,30.0,11,51,68,68,16,35,51,120.0,,567,185,292,477,1075.0,80,7.43,89,437,2435,12.2
12906,Jim Fox,1992-93,32.0,12,2,11,11,1,1,2,7.0,,578,186,293,479,1082.0,80,7.37,76,367,2421,12.2
12907,Jim Hiller,1995-96,26.0,4,20,61,61,8,12,20,83.0,,61,8,12,20,83.0,84,7.25,87,443,2603,11.7
12908,Jim Hiller,1996-97,27.0,5,0,2,2,0,0,0,0.0,,63,8,12,20,83.0,84,6.48,76,407,2545,10.7
12909,Jim Hofford,1988-89,24.0,4,0,5,5,0,0,0,3.0,,5,0,0,0,3.0,80,7.94,82,370,2484,12.8
12910,Jim Hofford,1989-90,25.0,5,0,12,12,0,0,0,8.0,,17,0,0,0,11.0,80,7.34,72,344,2400,12.2
12911,Jim Hofford,1991-92,27.0,6,0,1,1,0,0,0,0.0,,18,0,0,0,11.0,80,7.48,85,403,2430,12.3
12912,Jim Jackson,1985-86,25.0,4,20,48,48,8,12,20,85.0,,48,8,12,20,85.0,80,7.73,71,310,2444,12.7
12913,Jim Jackson,1986-87,26.0,5,20,49,49,6,14,20,66.0,,97,14,26,40,151.0,80,7.89,74,336,2448,12.9
12914,Jim Jackson,1987-88,27.0,6,5,10,10,1,4,5,10.0,,107,15,30,45,161.0,80,7.77,71,321,2447,12.7
12915,Jim Jackson,1990-91,30.0,7,2,5,5,2,0,2,11.0,,112,17,30,47,172.0,80,7.43,89,437,2435,12.2
12916,Jim Johnson,1988-89,26.0,4,29,80,80,3,26,29,118.0,,80,3,26,29,118.0,80,7.94,82,370,2484,12.8
12917,Jim Johnson,1989-90,27.0,5,30,80,80,5,25,30,88.0,,160,8,51,59,206.0,80,7.34,72,344,2400,12.2
12918,Jim Johnson,1990-91,28.0,6,13,55,55,1,12,13,44.0,,215,9,63,72,250.0,80,7.43,89,437,2435,12.2
12919,Jim Johnson,1991-92,29.0,7,16,76,76,2,14,16,70.0,,291,11,77,88,320.0,80,7.48,85,403,2430,12.3
12920,Jim Johnson,1992-93,30.0,8,16,75,75,3,13,16,72.0,,366,14,90,104,392.0,80,7.37,76,367,2421,12.2
12921,Jim Johnson,1993-94,31.0,9,15,68,68,1,14,15,83.0,,434,15,104,119,475.0,80,6.91,71,366,2385,11.6
12922,Jim Johnson,1994-95,32.0,10,14,71,71,4,10,14,86.0,,505,19,114,133,561.0,80,6.96,77,402,2440,11.4
12923,Jim Johnson,1995-96,33.0,11,23,79,79,3,20,23,67.0,,584,22,134,156,628.0,84,7.25,87,443,2603,11.7
12924,Jim Johnson,1996-97,34.0,12,7,61,61,0,7,7,49.0,,645,22,141,163,677.0,84,6.48,76,407,2545,10.7
12925,Jim Johnson,1997-98,35.0,13,13,47,47,0,13,13,46.0,,692,22,154,176,723.0,48,5.97,37,209,1408,10.2
12926,Jim Johnson,1998-99,36.0,14,6,66,66,2,4,6,49.0,,758,24,158,182,772.0,82,6.29,74,413,2481,10.4
12927,Jim Johnson,1999-00,37.0,15,10,55,55,3,7,10,51.0,,813,27,165,192,823.0,82,5.83,55,336,2444,9.8
12928,Jim Johnson,2000-01,38.0,16,3,16,16,2,1,3,17.0,,829,29,166,195,840.0,82,5.28,57,380,2242,9.6
12929,Jim Korn,1982-83,25.0,4,18,63,63,5,13,18,58.0,,63,5,13,18,58.0,80,7.03,61,280,2352,12.0
12930,Jim Korn,1983-84,26.0,5,20,63,63,5,15,20,82.0,,126,10,28,38,140.0,80,7.69,77,340,2441,12.6
12931,Jim Korn,1984-85,27.0,6,12,70,70,2,10,12,51.0,,196,12,38,50,191.0,80,8.03,73,320,2489,12.9
12932,Jim Korn,1985-86,28.0,7,29,80,80,8,21,29,103.0,,276,20,59,79,294.0,80,7.73,71,310,2444,12.7
12933,Jim Korn,1986-87,29.0,8,26,65,65,12,14,26,92.0,,341,32,73,105,386.0,80,7.89,74,336,2448,12.9
12934,Jim Korn,1987-88,30.0,9,10,41,41,5,5,10,48.0,,382,37,78,115,434.0,80,7.77,71,321,2447,12.7
12935,Jim Korn,1989-90,32.0,10,14,52,52,4,10,14,35.0,,434,41,88,129,469.0,80,7.34,72,344,2400,12.2
12936,Jim Korn,1990-91,33.0,11,21,52,52,8,13,21,49.0,,486,49,101,150,518.0,80,7.43,89,437,2435,12.2
12937,Jim Korn,1991-92,34.0,12,31,65,65,15,16,31,65.0,,551,64,117,181,583.0,80,7.48,85,403,2430,12.3
12938,Jim Korn,1992-93,35.0,13,7,46,46,2,5,7,21.0,,597,66,122,188,604.0,80,7.37,76,367,2421,12.2
12939,Jim Kyte,1985-86,21.0,4,0,2,2,0,0,0,0.0,,2,0,0,0,0.0,80,7.73,71,310,2444,12.7
12940,Jim Kyte,1986-87,22.0,5,3,58,58,1,2,3,7.0,,60,1,2,3,7.0,80,7.89,74,336,2448,12.9
12941,Jim Kyte,1987-88,23.0,6,3,71,71,0,3,3,32.0,,131,1,5,6,39.0,80,7.77,71,321,2447,12.7
12942,Jim Kyte,1988-89,24.0,7,4,71,71,1,3,4,28.0,,202,2,8,10,67.0,80,7.94,82,370,2484,12.8
12943,Jim Kyte,1989-90,25.0,8,10,72,72,5,5,10,62.0,,274,7,13,20,129.0,80,7.34,72,344,2400,12.2
12944,Jim Kyte,1990-91,26.0,9,4,51,51,1,3,4,59.0,,325,8,16,24,188.0,80,7.43,89,437,2435,12.2
12945,Jim Kyte,1991-92,27.0,10,12,74,74,3,9,12,56.0,,399,11,25,36,244.0,80,7.48,85,403,2430,12.3
12946,Jim Kyte,1992-93,28.0,11,4,56,56,3,1,4,23.0,,455,14,26,40,267.0,80,7.37,76,367,2421,12.2
12947,Jim Kyte,1993-94,29.0,12,9,43,43,0,9,9,29.0,,498,14,35,49,296.0,80,6.91,71,366,2385,11.6
12948,Jim Kyte,1994-95,30.0,13,1,21,21,0,1,1,13.0,,519,14,36,50,309.0,80,6.96,77,402,2440,11.4
12949,Jim Kyte,1995-96,31.0,14,1,4,4,0,1,1,1.0,,523,14,37,51,310.0,84,7.25,87,443,2603,11.7
12950,Jim Kyte,1997-98,33.0,15,7,18,18,2,5,7,14.0,,541,16,42,58,324.0,48,5.97,37,209,1408,10.2
12951,Jim Kyte,1998-99,34.0,16,8,57,57,1,7,8,32.0,,598,17,49,66,356.0,82,6.29,74,413,2481,10.4
12952,Jim Leavins,1988-89,28.0,4,13,37,37,2,11,13,63.0,,37,2,11,13,63.0,80,7.94,82,370,2484,12.8
12953,Jim Leavins,1989-90,29.0,5,1,4,4,0,1,1,4.0,,41,2,12,14,67.0,80,7.34,72,344,2400,12.2
12954,Jim Mathieson,1992-93,23.0,4,0,2,2,0,0,0,0.0,,2,0,0,0,0.0,80,7.37,76,367,2421,12.2
12955,Jim Mayer,1982-83,28.0,4,0,4,4,0,0,0,2.0,,4,0,0,0,2.0,80,7.03,61,280,2352,12.0
12956,Jim McGeough,1984-85,21.0,4,0,4,4,0,0,0,7.0,,4,0,0,0,7.0,80,8.03,73,320,2489,12.9
12957,Jim McGeough,1987-88,24.0,5,7,25,25,3,4,7,56.0,,29,3,4,7,63.0,80,7.77,71,321,2447,12.7
12958,Jim McGeough,1988-89,25.0,6,5,17,17,3,2,5,29.0,,46,6,6,12,92.0,80,7.94,82,370,2484,12.8
12959,Jim McGeough,1989-90,26.0,7,5,11,11,1,4,5,24.0,,57,7,10,17,116.0,80,7.34,72,344,2400,12.2
12960,Jim McKenzie,1992-93,23.0,4,0,5,5,0,0,0,0.0,,5,0,0,0,0.0,80,7.37,76,367,2421,12.2
12961,Jim McKenzie,1993-94,24.0,5,7,41,41,4,3,7,16.0,,46,4,3,7,16.0,80,6.91,71,366,2385,11.6
12962,Jim McKenzie,1994-95,25.0,6,6,67,67,5,1,6,34.0,,113,9,4,13,50.0,80,6.96,77,402,2440,11.4
12963,Jim McKenzie,1995-96,26.0,7,9,64,64,3,6,9,36.0,,177,12,10,22,86.0,84,7.25,87,443,2603,11.7
12964,Jim McKenzie,1996-97,27.0,8,8,71,71,3,5,8,33.0,,248,15,15,30,119.0,84,6.48,76,407,2545,10.7
12965,Jim McKenzie,1997-98,28.0,9,3,39,39,2,1,3,16.0,,287,17,16,33,135.0,48,5.97,37,209,1408,10.2
12966,Jim McKenzie,1998-99,29.0,10,6,73,73,4,2,6,28.0,,360,21,18,39,163.0,82,6.29,74,413,2481,10.4
12967,Jim McKenzie,1999-00,30.0,11,8,65,65,5,3,8,38.0,,425,26,21,47,201.0,82,5.83,55,336,2444,9.8
12968,Jim McKenzie,2000-01,31.0,12,7,64,64,3,4,7,35.0,,489,29,25,54,236.0,82,5.28,57,380,2242,9.6
12969,Jim McKenzie,2001-02,32.0,13,9,73,73,5,4,9,59.0,757.0,562,34,29,63,295.0,82,5.27,57,359,2285,9.4
12970,Jim McKenzie,2002-03,33.0,14,9,61,61,4,5,9,32.0,514.0,623,38,34,72,327.0,82,5.49,53,331,2294,9.8
12971,Jim McKenzie,2003-04,34.0,15,4,53,53,2,2,4,32.0,420.0,676,40,36,76,359.0,82,5.51,63,376,2272,9.9
12972,Jim McKenzie,2004-05,35.0,16,8,67,67,3,5,8,33.0,490.0,743,43,41,84,392.0,82,5.24,53,338,2262,9.5
12973,Jim McKenzie,2005-06,36.0,17,12,76,76,4,8,12,42.0,585.0,819,47,49,96,434.0,82,5.31,60,363,2326,9.4
12974,Jim McKenzie,2006-07,37.0,18,4,61,61,1,3,4,10.0,381.0,880,48,52,100,444.0,82,5.14,57,348,2300,9.2
12975,Jim McTaggart,1983-84,23.0,4,7,52,52,1,6,7,40.0,,52,1,6,7,40.0,80,7.69,77,340,2441,12.6
12976,Jim McTaggart,1984-85,24.0,5,6,19,19,2,4,6,24.0,,71,3,10,13,64.0,80,8.03,73,320,2489,12.9
12977,Jim Montgomery,1996-97,27.0,4,20,67,67,6,14,20,67.0,,67,6,14,20,67.0,84,6.48,76,407,2545,10.7
12978,Jim Montgomery,1997-98,28.0,5,2,13,13,1,1,2,13.0,,80,7,15,22,80.0,48,5.97,37,209,1408,10.2
12979,Jim Montgomery,1998-99,29.0,6,3,5,5,1,2,3,4.0,,85,8,17,25,84.0,82,6.29,74,413,2481,10.4
12980,Jim Montgomery,2003-04,34.0,7,7,28,28,1,6,7,17.0,255.0,113,9,23,32,101.0,82,5.51,63,376,2272,9.9
12981,Jim Montgomery,2004-05,35.0,8,2,8,8,0,2,2,8.0,69.0,121,9,25,34,109.0,82,5.24,53,338,2262,9.5
12982,Jim Montgomery,2005-06,36.0,9,0,1,1,0,0,0,0.0,7.0,122,9,25,34,109.0,82,5.31,60,363,2326,9.4
12983,Jim Nill,1984-85,26.0,4,24,69,69,10,14,24,71.0,,69,10,14,24,71.0,80,8.03,73,320,2489,12.9
12984,Jim Nill,1985-86,27.0,5,22,65,65,7,15,22,53.0,,134,17,29,46,124.0,80,7.73,71,310,2444,12.7
12985,Jim Nill,1986-87,28.0,6,20,78,78,12,8,20,73.0,,212,29,37,66,197.0,80,7.89,74,336,2448,12.9
12986,Jim Nill,1987-88,29.0,7,26,69,69,9,17,26,45.0,,281,38,54,92,242.0,80,7.77,71,321,2447,12.7
12987,Jim Nill,1988-89,30.0,8,14,61,61,6,8,14,35.0,,342,44,62,106,277.0,80,7.94,82,370,2484,12.8
12988,Jim Nill,1989-90,31.0,9,7,36,36,3,4,7,12.0,,378,47,66,113,289.0,80,7.34,72,344,2400,12.2
12989,Jim Nill,1990-91,32.0,10,15,60,60,3,12,15,38.0,,438,50,78,128,327.0,80,7.43,89,437,2435,12.2
12990,Jim Nill,1991-92,33.0,11,15,71,71,8,7,15,39.0,,509,58,85,143,366.0,80,7.48,85,403,2430,12.3
12991,Jim Nill,1992-93,34.0,12,2,15,15,0,2,2,10.0,,524,58,87,145,376.0,80,7.37,76,367,2421,12.2
12992,Jim O'Brien,2013-14,25.0,4,0,6,6,0,0,0,11.0,58.0,6,0,0,0,11.0,82,5.46,52,291,2492,9.0
12993,Jim O'Brien,2014-15,26.0,5,6,28,28,3,3,6,37.0,329.0,34,3,3,6,48.0,82,5.32,47,271,2439,8.9
12994,Jim O'Brien,2015-16,27.0,6,6,29,29,5,1,6,38.0,331.0,63,8,4,12,86.0,48,5.31,29,160,1399,9.1
12995,Jim O'Brien,2018-19,30.0,7,0,4,4,0,0,0,3.0,54.0,67,8,4,12,89.0,82,5.34,48,255,2438,9.0
12996,Jim O'Brien,2020-21,32.0,8,1,10,10,0,1,1,11.0,88.0,77,8,5,13,100.0,82,5.86,50,250,2620,9.2
12997,Jim Paek,1993-94,26.0,4,0,3,3,0,0,0,0.0,,3,0,0,0,0.0,80,6.91,71,366,2385,11.6
12998,Jim Paek,1994-95,27.0,5,8,49,49,1,7,8,33.0,,52,1,7,8,33.0,80,6.96,77,402,2440,11.4
12999,Jim Paek,1995-96,28.0,6,18,77,77,3,15,18,57.0,,129,4,22,26,90.0,84,7.25,87,443,2603,11.7
13000,Jim Paek,1996-97,29.0,7,6,59,59,1,5,6,35.0,,188,5,27,32,125.0,84,6.48,76,407,2545,10.7
13001,Jim Paek,1997-98,30.0,8,2,29,29,0,2,2,16.0,,217,5,29,34,141.0,48,5.97,37,209,1408,10.2
13002,Jim Pavese,1984-85,22.0,4,11,42,42,2,9,11,29.0,,42,2,9,11,29.0,80,8.03,73,320,2489,12.9
13003,Jim Pavese,1985-86,23.0,5,2,24,24,0,2,2,9.0,,66,2,11,13,38.0,80,7.73,71,310,2444,12.7
13004,Jim Pavese,1986-87,24.0,6,1,4,4,0,1,1,1.0,,70,2,12,14,39.0,80,7.89,74,336,2448,12.9
13005,Jim Pavese,1987-88,25.0,7,7,51,51,2,5,7,27.0,,121,4,17,21,66.0,80,7.77,71,321,2447,12.7
13006,Jim Pavese,1988-89,26.0,8,11,69,69,4,7,11,51.0,,190,8,24,32,117.0,80,7.94,82,370,2484,12.8
13007,Jim Pavese,1989-90,27.0,9,11,69,69,2,9,11,45.0,,259,10,33,43,162.0,80,7.34,72,344,2400,12.2
13008,Jim Pavese,1990-91,28.0,10,5,25,25,0,5,5,20.0,,284,10,38,48,182.0,80,7.43,89,437,2435,12.2
13009,Jim Pavese,1991-92,29.0,11,9,44,44,3,6,9,33.0,,328,13,44,57,215.0,80,7.48,85,403,2430,12.3
13010,Jim Peplinski,1983-84,23.0,4,38,80,80,13,25,38,107.0,,80,13,25,38,107.0,80,7.69,77,340,2441,12.6
13011,Jim Peplinski,1984-85,24.0,5,67,74,74,30,37,67,141.0,,154,43,62,105,248.0,80,8.03,73,320,2489,12.9
13012,Jim Peplinski,1985-86,25.0,6,41,80,80,15,26,41,145.0,,234,58,88,146,393.0,80,7.73,71,310,2444,12.7
13013,Jim Peplinski,1986-87,26.0,7,33,74,74,11,22,33,149.0,,308,69,110,179,542.0,80,7.89,74,336,2448,12.9
13014,Jim Peplinski,1987-88,27.0,8,45,80,80,16,29,45,174.0,,388,85,139,224,716.0,80,7.77,71,321,2447,12.7
13015,Jim Peplinski,1988-89,28.0,9,59,77,77,24,35,59,161.0,,465,109,174,283,877.0,80,7.94,82,370,2484,12.8
13016,Jim Peplinski,1989-90,29.0,10,50,80,80,18,32,50,144.0,,545,127,206,333,1021.0,80,7.34,72,344,2400,12.2
13017,Jim Peplinski,1990-91,30.0,11,51,75,75,20,31,51,128.0,,620,147,237,384,1149.0,80,7.43,89,437,2435,12.2
13018,Jim Peplinski,1991-92,31.0,12,38,79,79,13,25,38,103.0,,699,160,262,422,1252.0,80,7.48,85,403,2430,12.3
13019,Jim Peplinski,1992-93,32.0,13,1,6,6,1,0,1,12.0,,705,161,262,423,1264.0,80,7.37,76,367,2421,12.2
13020,Jim Peplinski,1997-98,37.0,14,1,6,6,0,1,1,5.0,,711,161,263,424,1269.0,48,5.97,37,209,1408,10.2
13021,Jim Playfair,1986-87,22.0,4,2,2,2,1,1,2,2.0,,2,1,1,2,2.0,80,7.89,74,336,2448,12.9
13022,Jim Playfair,1990-91,26.0,5,4,12,12,1,3,4,11.0,,14,2,4,6,13.0,80,7.43,89,437,2435,12.2
13023,Jim Playfair,1991-92,27.0,6,0,7,7,0,0,0,1.0,,21,2,4,6,14.0,80,7.48,85,403,2430,12.3
13024,Jim Sandlak,1988-89,22.0,4,4,23,23,1,3,4,34.0,,23,1,3,4,34.0,80,7.94,82,370,2484,12.8
13025,Jim Sandlak,1989-90,23.0,5,36,78,78,15,21,36,114.0,,101,16,24,40,148.0,80,7.34,72,344,2400,12.2
13026,Jim Sandlak,1990-91,24.0,6,31,49,49,16,15,31,96.0,,150,32,39,71,244.0,80,7.43,89,437,2435,12.2
13027,Jim Sandlak,1991-92,25.0,7,40,72,72,20,20,40,164.0,,222,52,59,111,408.0,80,7.48,85,403,2430,12.3
13028,Jim Sandlak,1992-93,26.0,8,23,70,70,15,8,23,135.0,,292,67,67,134,543.0,80,7.37,76,367,2421,12.2
13029,Jim Sandlak,1993-94,27.0,9,13,59,59,7,6,13,88.0,,351,74,73,147,631.0,80,6.91,71,366,2385,11.6
13030,Jim Sandlak,1994-95,28.0,10,40,66,66,16,24,40,122.0,,417,90,97,187,753.0,80,6.96,77,402,2440,11.4
13031,Jim Sandlak,1995-96,29.0,11,28,59,59,10,18,28,104.0,,476,100,115,215,857.0,84,7.25,87,443,2603,11.7
13032,Jim Sandlak,1996-97,30.0,12,8,27,27,6,2,8,32.0,,503,106,117,223,889.0,84,6.48,76,407,2545,10.7
13033,Jim Sandlak,1997-98,31.0,13,0,13,13,0,0,0,13.0,,516,106,117,223,902.0,48,5.97,37,209,1408,10.2
13034,Jim Sandlak,1998-99,32.0,14,6,33,33,4,2,6,44.0,,549,110,119,229,946.0,82,6.29,74,413,2481,10.4
13035,Jim Slater,2008-09,26.0,4,20,71,71,10,10,20,108.0,717.0,71,10,10,20,108.0,82,6.05,85,480,2458,10.1
13036,Jim Slater,2009-10,27.0,5,19,74,74,5,14,19,90.0,757.0,145,15,24,39,198.0,82,5.76,70,398,2426,9.7
13037,Jim Slater,2010-11,28.0,6,13,69,69,8,5,13,95.0,717.0,214,23,29,52,293.0,82,5.44,62,351,2383,9.4
13038,Jim Slater,2011-12,29.0,7,18,60,60,8,10,18,94.0,675.0,274,31,39,70,387.0,82,5.7,65,341,2477,9.4
13039,Jim Slater,2012-13,30.0,8,18,61,61,11,7,18,107.0,745.0,335,42,46,88,494.0,82,5.53,56,304,2486,9.1
13040,Jim Slater,2013-14,31.0,9,12,36,36,5,7,12,53.0,381.0,371,47,53,100,547.0,82,5.46,52,291,2492,9.0
13041,Jim Slater,2014-15,32.0,10,21,78,78,13,8,21,118.0,1152.0,449,60,61,121,665.0,82,5.32,47,271,2439,8.9
13042,Jim Slater,2015-16,33.0,11,2,26,26,1,1,2,22.0,272.0,475,61,62,123,687.0,48,5.31,29,160,1399,9.1
13043,Jim Slater,2016-17,34.0,12,2,27,27,1,1,2,24.0,287.0,502,62,63,125,711.0,82,5.34,48,269,2463,8.9
13044,Jim Slater,2017-18,35.0,13,13,82,82,5,8,13,51.0,755.0,584,67,71,138,762.0,82,5.32,47,251,2453,8.9
13045,Jim Storm,1996-97,25.0,4,16,68,68,6,10,16,84.0,,68,6,10,16,84.0,84,6.48,76,407,2545,10.7
13046,Jim Storm,1997-98,26.0,5,3,6,6,0,3,3,3.0,,74,6,13,19,87.0,48,5.97,37,209,1408,10.2
13047,Jim Storm,1998-99,27.0,6,3,10,10,1,2,3,11.0,,84,7,15,22,98.0,82,6.29,74,413,2481,10.4
13048,Jim Thomson,1989-90,24.0,4,0,10,10,0,0,0,5.0,,10,0,0,0,5.0,80,7.34,72,344,2400,12.2
13049,Jim Thomson,1991-92,26.0,5,2,19,19,2,0,2,12.0,,29,2,0,2,17.0,80,7.48,85,403,2430,12.3
13050,Jim Thomson,1992-93,27.0,6,0,3,3,0,0,0,3.0,,32,2,0,2,20.0,80,7.37,76,367,2421,12.2
13051,Jim Thomson,1993-94,28.0,7,1,8,8,1,0,1,6.0,,40,3,0,3,26.0,80,6.91,71,366,2385,11.6
13052,Jim Thomson,1994-95,29.0,8,3,45,45,1,2,3,24.0,,85,4,2,6,50.0,80,6.96,77,402,2440,11.4
13053,Jim Thomson,1995-96,30.0,9,1,24,24,0,1,1,23.0,,109,4,3,7,73.0,84,7.25,87,443,2603,11.7
13054,Jim Thomson,1996-97,31.0,10,0,6,6,0,0,0,1.0,,115,4,3,7,74.0,84,6.48,76,407,2545,10.7
13055,Jim Vandermeer,2005-06,25.0,4,3,24,24,2,1,3,22.0,329.0,24,2,1,3,22.0,82,5.31,60,363,2326,9.4
13056,Jim Vandermeer,2006-07,26.0,5,17,46,46,5,12,17,61.0,870.0,70,7,13,20,83.0,82,5.14,57,348,2300,9.2
13057,Jim Vandermeer,2008-09,28.0,6,24,76,76,6,18,24,93.0,1655.0,146,13,31,44,176.0,82,6.05,85,480,2458,10.1
13058,Jim Vandermeer,2009-10,29.0,7,7,46,46,1,6,7,50.0,820.0,192,14,37,51,226.0,82,5.76,70,398,2426,9.7
13059,Jim Vandermeer,2010-11,30.0,8,17,75,75,3,14,17,72.0,1473.0,267,17,51,68,298.0,82,5.44,62,351,2383,9.4
13060,Jim Vandermeer,2011-12,31.0,9,7,45,45,1,6,7,31.0,721.0,312,18,57,75,329.0,82,5.7,65,341,2477,9.4
13061,Jim Vandermeer,2012-13,32.0,10,12,62,62,4,8,12,64.0,1096.0,374,22,65,87,393.0,82,5.53,56,304,2486,9.1
13062,Jim Vandermeer,2013-14,33.0,11,14,62,62,2,12,14,57.0,1128.0,436,24,77,101,450.0,82,5.46,52,291,2492,9.0
13063,Jim Vandermeer,2014-15,34.0,12,4,25,25,1,3,4,19.0,260.0,461,25,80,105,469.0,82,5.32,47,271,2439,8.9
13064,Jim Vesey,1991-92,26.0,4,2,5,5,1,1,2,5.0,,5,1,1,2,5.0,80,7.48,85,403,2430,12.3
13065,Jim Vesey,1992-93,27.0,5,1,6,6,0,1,1,3.0,,11,1,2,3,8.0,80,7.37,76,367,2421,12.2
13066,Jim Vesey,1994-95,29.0,6,0,4,4,0,0,0,1.0,,15,1,2,3,9.0,80,6.96,77,402,2440,11.4
13067,Jim Walsh,1984-85,28.0,4,1,4,4,0,1,1,8.0,,4,0,1,1,8.0,80,8.03,73,320,2489,12.9
13068,Jim Warner,1982-83,28.0,4,3,32,32,0,3,3,26.0,,32,0,3,3,26.0,80,7.03,61,280,2352,12.0
13069,Jim Wiemer,1986-87,26.0,4,20,64,64,5,15,20,90.0,,64,5,15,20,90.0,80,7.89,74,336,2448,12.9
13070,Jim Wiemer,1987-88,27.0,5,12,32,32,7,5,12,72.0,,96,12,20,32,162.0,80,7.77,71,321,2447,12.7
13071,Jim Wiemer,1988-89,28.0,6,3,7,7,3,0,3,22.0,,103,15,20,35,184.0,80,7.94,82,370,2484,12.8
13072,Jim Wiemer,1990-91,30.0,7,3,12,12,1,2,3,24.0,,115,16,22,38,208.0,80,7.43,89,437,2435,12.2
13073,Jim Wiemer,1991-92,31.0,8,5,9,9,2,3,5,17.0,,124,18,25,43,225.0,80,7.48,85,403,2430,12.3
13074,Jim Wiemer,1992-93,32.0,9,19,61,61,5,14,19,90.0,,185,23,39,62,315.0,80,7.37,76,367,2421,12.2
13075,Jim Wiemer,1993-94,33.0,10,23,61,61,4,19,23,86.0,,246,27,58,85,401.0,80,6.91,71,366,2385,11.6
13076,Jim Wiemer,1994-95,34.0,11,9,47,47,1,8,9,60.0,,293,28,66,94,461.0,80,6.96,77,402,2440,11.4
13077,Jim Wiemer,1995-96,35.0,12,7,28,28,1,6,7,39.0,,321,29,72,101,500.0,84,7.25,87,443,2603,11.7
13078,Jim Wiemer,1996-97,36.0,13,0,4,4,0,0,0,8.0,,325,29,72,101,508.0,84,6.48,76,407,2545,10.7
13079,Jimmie Olvestad,2004-05,24.0,4,14,74,74,3,11,14,99.0,1036.0,74,3,11,14,99.0,82,5.24,53,338,2262,9.5
13080,Jimmie Olvestad,2005-06,25.0,5,3,37,37,0,3,3,30.0,387.0,111,3,14,17,129.0,82,5.31,60,363,2326,9.4
13081,Jimmy Carson,1989-90,21.0,4,79,80,80,37,42,79,215.0,,80,37,42,79,215.0,80,7.34,72,344,2400,12.2
13082,Jimmy Carson,1990-91,22.0,5,107,80,80,55,52,107,264.0,,160,92,94,186,479.0,80,7.43,89,437,2435,12.2
13083,Jimmy Carson,1991-92,23.0,6,100,80,80,49,51,100,240.0,,240,141,145,286,719.0,80,7.48,85,403,2430,12.3
13084,Jimmy Carson,1992-93,24.0,7,39,48,48,21,18,39,138.0,,288,162,163,325,857.0,80,7.37,76,367,2421,12.2
13085,Jimmy Carson,1993-94,25.0,8,46,64,64,21,25,46,175.0,,352,183,188,371,1032.0,80,6.91,71,366,2385,11.6
13086,Jimmy Carson,1994-95,26.0,9,69,80,80,34,35,69,150.0,,432,217,223,440,1182.0,80,6.96,77,402,2440,11.4
13087,Jimmy Carson,1995-96,27.0,10,73,86,86,37,36,73,189.0,,518,254,259,513,1371.0,84,7.25,87,443,2603,11.7
13088,Jimmy Carson,1996-97,28.0,11,28,59,59,11,17,28,129.0,,577,265,276,541,1500.0,84,6.48,76,407,2545,10.7
13089,Jimmy Carson,1997-98,29.0,12,19,38,38,9,10,19,58.0,,615,274,286,560,1558.0,48,5.97,37,209,1408,10.2
13090,Jimmy Carson,1998-99,30.0,13,1,11,11,1,0,1,9.0,,626,275,286,561,1567.0,82,6.29,74,413,2481,10.4
13091,Jimmy Hayes,2014-15,25.0,4,9,31,31,5,4,9,41.0,318.0,31,5,4,9,41.0,82,5.32,47,271,2439,8.9
13092,Jimmy Hayes,2015-16,26.0,5,4,10,10,1,3,4,13.0,143.0,41,6,7,13,54.0,48,5.31,29,160,1399,9.1
13093,Jimmy Hayes,2016-17,27.0,6,18,55,55,11,7,18,72.0,603.0,96,17,14,31,126.0,82,5.34,48,269,2463,8.9
13094,Jimmy Hayes,2017-18,28.0,7,35,72,72,19,16,35,166.0,1090.0,168,36,30,66,292.0,82,5.32,47,251,2453,8.9
13095,Jimmy Hayes,2018-19,29.0,8,29,75,75,13,16,29,127.0,1037.0,243,49,46,95,419.0,82,5.34,48,255,2438,9.0
13096,Jimmy Hayes,2019-20,30.0,9,5,58,58,2,3,5,74.0,535.0,301,51,49,100,493.0,82,5.45,47,245,2478,9.0
13097,Jimmy Hayes,2020-21,31.0,10,9,33,33,3,6,9,37.0,394.0,334,54,55,109,530.0,82,5.86,50,250,2620,9.2
13098,Jimmy Mann,1982-83,23.0,4,8,72,72,3,5,8,60.0,,72,3,5,8,60.0,80,7.03,61,280,2352,12.0
13099,Jimmy Mann,1983-84,24.0,5,6,37,37,3,3,6,30.0,,109,6,8,14,90.0,80,7.69,77,340,2441,12.6
13100,Jimmy Mann,1984-85,25.0,6,5,37,37,3,2,5,22.0,,146,9,10,19,112.0,80,8.03,73,320,2489,12.9
13101,Jimmy Mann,1985-86,26.0,7,1,40,40,0,1,1,20.0,,186,9,11,20,132.0,80,7.73,71,310,2444,12.7
13102,Jimmy Mann,1986-87,27.0,8,3,38,38,1,2,3,20.0,,224,10,13,23,152.0,80,7.89,74,336,2448,12.9
13103,Jimmy Mann,1987-88,28.0,9,4,25,25,0,4,4,12.0,,249,10,17,27,164.0,80,7.77,71,321,2447,12.7
13104,Jimmy Mann,1988-89,29.0,10,3,35,35,0,3,3,4.0,,284,10,20,30,168.0,80,7.94,82,370,2484,12.8
13105,Jimmy Mann,1990-91,31.0,11,0,9,9,0,0,0,1.0,,293,10,20,30,169.0,80,7.43,89,437,2435,12.2
13106,Jimmy Schuldt,2021-22,26.0,4,1,1,1,0,1,1,1.0,21.0,1,0,1,1,1.0,82,5.96,47,239,2579,9.5
13107,Jimmy Vesey,2019-20,26.0,4,27,80,80,16,11,27,116.0,1091.0,80,16,11,27,116.0,82,5.45,47,245,2478,9.0
13108,Jimmy Vesey,2020-21,27.0,5,28,79,79,17,11,28,136.0,1132.0,159,33,22,55,252.0,82,5.86,50,250,2620,9.2
13109,Jimmy Vesey,2021-22,28.0,6,35,81,81,17,18,35,154.0,1301.0,240,50,40,90,406.0,82,5.96,47,239,2579,9.5
13110,Jimmy Vesey,2022-23,29.0,7,20,64,64,9,11,20,93.0,883.0,304,59,51,110,499.0,70,5.96,42,208,2192,9.5
13111,Jiri Bicek,2003-04,25.0,4,1,5,5,1,0,1,10.0,65.0,5,1,0,1,10.0,82,5.51,63,376,2272,9.9
13112,Jiri Bicek,2004-05,26.0,5,0,1,1,0,0,0,2.0,13.0,6,1,0,1,12.0,82,5.24,53,338,2262,9.5
13113,Jiri Bicek,2005-06,27.0,6,11,44,44,5,6,11,63.0,519.0,50,6,6,12,75.0,82,5.31,60,363,2326,9.4
13114,Jiri Bicek,2006-07,28.0,7,1,12,12,0,1,1,10.0,119.0,62,6,7,13,85.0,82,5.14,57,348,2300,9.2
13115,Jiri Bubla,1984-85,35.0,4,2,23,23,1,1,2,23.0,,23,1,1,2,23.0,80,8.03,73,320,2489,12.9
13116,Jiri Bubla,1985-86,36.0,5,30,72,72,2,28,30,92.0,,95,3,29,32,115.0,80,7.73,71,310,2444,12.7
13117,Jiri Bubla,1986-87,37.0,6,39,62,62,6,33,39,84.0,,157,9,62,71,199.0,80,7.89,74,336,2448,12.9
13118,Jiri Bubla,1987-88,38.0,7,17,56,56,2,15,17,73.0,,213,11,77,88,272.0,80,7.77,71,321,2447,12.7
13119,Jiri Bubla,1988-89,39.0,8,30,43,43,6,24,30,62.0,,256,17,101,118,334.0,80,7.94,82,370,2484,12.8
13120,Jiri Dopita,2004-05,36.0,4,27,52,52,11,16,27,79.0,792.0,52,11,16,27,79.0,82,5.24,53,338,2262,9.5
13121,Jiri Dopita,2005-06,37.0,5,6,21,21,1,5,6,23.0,290.0,73,12,21,33,102.0,82,5.31,60,363,2326,9.4
13122,Jiri Fischer,2002-03,22.0,4,8,52,52,0,8,8,41.0,564.0,52,0,8,8,41.0,82,5.49,53,331,2294,9.8
13123,Jiri Fischer,2003-04,23.0,5,9,55,55,1,8,9,64.0,922.0,107,1,16,17,105.0,82,5.51,63,376,2272,9.9
13124,Jiri Fischer,2004-05,24.0,6,10,80,80,2,8,10,103.0,1374.0,187,3,24,27,208.0,82,5.24,53,338,2262,9.5
13125,Jiri Fischer,2005-06,25.0,7,6,15,15,1,5,6,19.0,321.0,202,4,29,33,227.0,82,5.31,60,363,2326,9.4
13126,Jiri Fischer,2006-07,26.0,8,19,81,81,4,15,19,115.0,1499.0,283,8,44,52,342.0,82,5.14,57,348,2300,9.2
13127,Jiri Fischer,2008-09,28.0,9,8,22,22,3,5,8,36.0,456.0,305,11,49,60,378.0,82,6.05,85,480,2458,10.1
13128,Jiri Hrdina,1990-91,33.0,4,7,9,9,2,5,7,13.0,,9,2,5,7,13.0,80,7.43,89,437,2435,12.2
13129,Jiri Hrdina,1991-92,34.0,5,54,70,70,22,32,54,147.0,,79,24,37,61,160.0,80,7.48,85,403,2430,12.3
13130,Jiri Hrdina,1992-93,35.0,6,30,64,64,12,18,30,96.0,,143,36,55,91,256.0,80,7.37,76,367,2421,12.2
13131,Jiri Hrdina,1993-94,36.0,7,23,51,51,6,17,23,66.0,,194,42,72,114,322.0,80,6.91,71,366,2385,11.6
13132,Jiri Hrdina,1994-95,37.0,8,16,56,56,3,13,16,51.0,,250,45,85,130,373.0,80,6.96,77,402,2440,11.4
13133,Jiri Hudler,2006-07,23.0,4,3,12,12,1,2,3,8.0,98.0,12,1,2,3,8.0,82,5.14,57,348,2300,9.2
13134,Jiri Hudler,2008-09,25.0,5,0,4,4,0,0,0,3.0,29.0,16,1,2,3,11.0,82,6.05,85,480,2458,10.1
13135,Jiri Hudler,2009-10,26.0,6,25,76,76,15,10,25,107.0,763.0,92,16,12,28,118.0,82,5.76,70,398,2426,9.7
13136,Jiri Hudler,2010-11,27.0,7,42,81,81,13,29,42,131.0,1067.0,173,29,41,70,249.0,82,5.44,62,351,2383,9.4
13137,Jiri Hudler,2011-12,28.0,8,57,82,82,23,34,57,155.0,1119.0,255,52,75,127,404.0,82,5.7,65,341,2477,9.4
13138,Jiri Hudler,2013-14,30.0,9,37,73,73,10,27,37,105.0,997.0,328,62,102,164,509.0,82,5.46,52,291,2492,9.0
13139,Jiri Hudler,2014-15,31.0,10,50,81,81,25,25,50,127.0,1269.0,409,87,127,214,636.0,82,5.32,47,271,2439,8.9
13140,Jiri Hudler,2015-16,32.0,11,27,42,42,10,17,27,56.0,721.0,451,97,144,241,692.0,48,5.31,29,160,1399,9.1
13141,Jiri Hudler,2016-17,33.0,12,54,75,75,17,37,54,109.0,1413.0,526,114,181,295,801.0,82,5.34,48,269,2463,8.9
13142,Jiri Hudler,2017-18,34.0,13,76,78,78,31,45,76,158.0,1405.0,604,145,226,371,959.0,82,5.32,47,251,2453,8.9
13143,Jiri Hudler,2018-19,35.0,14,46,72,72,16,30,46,109.0,1135.0,676,161,256,417,1068.0,82,5.34,48,255,2438,9.0
13144,Jiri Hudler,2019-20,36.0,15,11,32,32,3,8,11,27.0,379.0,708,164,264,428,1095.0,82,5.45,47,245,2478,9.0
13145,Jiri Latal,1992-93,25.0,4,19,32,32,6,13,19,59.0,,32,6,13,19,59.0,80,7.37,76,367,2421,12.2
13146,Jiri Latal,1993-94,26.0,5,26,50,50,5,21,26,81.0,,82,11,34,45,140.0,80,6.91,71,366,2385,11.6
13147,Jiri Latal,1994-95,27.0,6,3,10,10,1,2,3,22.0,,92,12,36,48,162.0,80,6.96,77,402,2440,11.4
13148,Jiri Novotny,2008-09,25.0,4,3,14,14,2,1,3,15.0,171.0,14,2,1,3,15.0,82,6.05,85,480,2458,10.1
13149,Jiri Novotny,2009-10,26.0,5,19,68,68,6,13,19,79.0,879.0,82,8,14,22,94.0,82,5.76,70,398,2426,9.7
13150,Jiri Novotny,2010-11,27.0,6,22,65,65,8,14,22,91.0,1152.0,147,16,28,44,185.0,82,5.44,62,351,2383,9.4
13151,Jiri Novotny,2011-12,28.0,7,7,42,42,4,3,7,56.0,560.0,189,20,31,51,241.0,82,5.7,65,341,2477,9.4
13152,Jiri Sejba,1993-94,31.0,4,2,11,11,0,2,2,10.0,,11,0,2,2,10.0,80,6.91,71,366,2385,11.6
13153,Jiri Sekac,2017-18,25.0,4,23,69,69,9,14,23,85.0,936.0,69,9,14,23,85.0,82,5.32,47,251,2453,8.9
13154,Jiri Sekac,2018-19,26.0,5,6,39,39,1,5,6,49.0,455.0,108,10,19,29,134.0,82,5.34,48,255,2438,9.0
13155,Jiri Slegr,1995-96,24.0,4,26,41,41,4,22,26,89.0,,41,4,22,26,89.0,84,7.25,87,443,2603,11.7
13156,Jiri Slegr,1996-97,25.0,5,38,78,78,5,33,38,160.0,,119,9,55,64,249.0,84,6.48,76,407,2545,10.7
13157,Jiri Slegr,1997-98,26.0,6,12,31,31,2,10,12,69.0,,150,11,65,76,318.0,48,5.97,37,209,1408,10.2
13158,Jiri Slegr,1998-99,27.0,7,17,57,57,4,13,17,91.0,,207,15,78,93,409.0,82,6.29,74,413,2481,10.4
13159,Jiri Slegr,2000-01,29.0,8,17,73,73,5,12,17,131.0,,280,20,90,110,540.0,82,5.28,57,380,2242,9.6
13160,Jiri Slegr,2001-02,30.0,9,23,63,63,3,20,23,91.0,1178.0,343,23,110,133,631.0,82,5.27,57,359,2285,9.4
13161,Jiri Slegr,2002-03,31.0,10,31,74,74,11,20,31,144.0,1581.0,417,34,130,164,775.0,82,5.49,53,331,2294,9.8
13162,Jiri Slegr,2003-04,32.0,11,34,75,75,8,26,34,145.0,1452.0,492,42,156,198,920.0,82,5.51,63,376,2272,9.9
13163,Jiri Slegr,2004-05,33.0,12,9,46,46,3,6,9,67.0,966.0,538,45,162,207,987.0,82,5.24,53,338,2262,9.5
13164,Jiri Slegr,2006-07,35.0,13,26,52,52,6,20,26,98.0,918.0,590,51,182,233,1085.0,82,5.14,57,348,2300,9.2
13165,Jiri Slegr,2008-09,37.0,14,16,32,32,5,11,16,59.0,524.0,622,56,193,249,1144.0,82,6.05,85,480,2458,10.1
13166,Jiri Tlusty,2010-11,22.0,4,16,58,58,10,6,16,69.0,634.0,58,10,6,16,69.0,82,5.44,62,351,2383,9.4
13167,Jiri Tlusty,2011-12,23.0,5,4,14,14,0,4,4,22.0,178.0,72,10,10,20,91.0,82,5.7,65,341,2477,9.4
13168,Jiri Tlusty,2012-13,24.0,6,6,20,20,1,5,6,17.0,251.0,92,11,15,26,108.0,82,5.53,56,304,2486,9.1
13169,Jiri Tlusty,2013-14,25.0,7,12,57,57,6,6,12,53.0,562.0,149,17,21,38,161.0,82,5.46,52,291,2492,9.0
13170,Jiri Tlusty,2014-15,26.0,8,36,79,79,17,19,36,136.0,1178.0,228,34,40,74,297.0,82,5.32,47,271,2439,8.9
13171,Jiri Tlusty,2015-16,27.0,9,38,48,48,23,15,38,117.0,876.0,276,57,55,112,414.0,48,5.31,29,160,1399,9.1
13172,Jiri Tlusty,2016-17,28.0,10,30,68,68,16,14,30,131.0,1032.0,344,73,69,142,545.0,82,5.34,48,269,2463,8.9
13173,Jiri Tlusty,2017-18,29.0,11,31,72,72,14,17,31,123.0,1154.0,416,87,86,173,668.0,82,5.32,47,251,2453,8.9
13174,Jiri Tlusty,2018-19,30.0,12,4,30,30,2,2,4,38.0,411.0,446,89,88,177,706.0,82,5.34,48,255,2438,9.0
13175,Joachim Blichfeld,2022-23,24.0,4,0,3,3,0,0,0,3.0,38.0,3,0,0,0,3.0,70,5.96,42,208,2192,9.5
13176,Joakim Andersson,2014-15,25.0,4,0,5,5,0,0,0,3.0,33.0,5,0,0,0,3.0,82,5.32,47,271,2439,8.9
13177,Joakim Andersson,2015-16,26.0,5,8,38,38,3,5,8,43.0,459.0,43,3,5,8,46.0,48,5.31,29,160,1399,9.1
13178,Joakim Andersson,2016-17,27.0,6,17,65,65,8,9,17,78.0,899.0,108,11,14,25,124.0,82,5.34,48,269,2463,8.9
13179,Joakim Andersson,2017-18,28.0,7,8,68,68,3,5,8,74.0,791.0,176,14,19,33,198.0,82,5.32,47,251,2453,8.9
13180,Joakim Andersson,2018-19,29.0,8,3,29,29,1,2,3,17.0,262.0,205,15,21,36,215.0,82,5.34,48,255,2438,9.0
13181,Joakim Lindstrom,2008-09,25.0,4,0,3,3,0,0,0,4.0,16.0,3,0,0,0,4.0,82,6.05,85,480,2458,10.1
13182,Joakim Lindstrom,2009-10,26.0,5,1,9,9,1,0,1,9.0,76.0,12,1,0,1,13.0,82,5.76,70,398,2426,9.7
13183,Joakim Lindstrom,2010-11,27.0,6,7,25,25,3,4,7,25.0,236.0,37,4,4,8,38.0,82,5.44,62,351,2383,9.4
13184,Joakim Lindstrom,2011-12,28.0,7,20,44,44,9,11,20,77.0,654.0,81,13,15,28,115.0,82,5.7,65,341,2477,9.4
13185,Joakim Lindstrom,2014-15,31.0,8,5,16,16,2,3,5,22.0,223.0,97,15,18,33,137.0,82,5.32,47,271,2439,8.9
13186,Joakim Lindstrom,2017-18,34.0,9,10,53,53,4,6,10,61.0,576.0,150,19,24,43,198.0,82,5.32,47,251,2453,8.9
13187,Joakim Nordstrom,2016-17,24.0,4,3,16,16,1,2,3,26.0,187.0,16,1,2,3,26.0,82,5.34,48,269,2463,8.9
13188,Joakim Nordstrom,2017-18,25.0,5,3,38,38,0,3,3,42.0,417.0,54,1,5,6,68.0,82,5.32,47,251,2453,8.9
13189,Joakim Nordstrom,2018-19,26.0,6,24,71,71,10,14,24,81.0,1109.0,125,11,19,30,149.0,82,5.34,48,255,2438,9.0
13190,Joakim Nordstrom,2019-20,27.0,7,12,82,82,7,5,12,104.0,1043.0,207,18,24,42,253.0,82,5.45,47,245,2478,9.0
13191,Joakim Nordstrom,2020-21,28.0,8,7,75,75,2,5,7,97.0,793.0,282,20,29,49,350.0,82,5.86,50,250,2620,9.2
13192,Joakim Nordstrom,2021-22,29.0,9,12,70,70,7,5,12,103.0,944.0,352,27,34,61,453.0,82,5.96,47,239,2579,9.5
13193,Joakim Nordstrom,2022-23,30.0,10,7,48,48,4,3,7,49.0,581.0,400,31,37,68,502.0,70,5.96,42,208,2192,9.5
13194,Joakim Nygard,2022-23,30.0,4,9,33,33,3,6,9,39.0,353.0,33,3,6,9,39.0,70,5.96,42,208,2192,9.5
13195,Joakim Ryan,2020-21,27.0,4,12,62,62,3,9,12,79.0,1039.0,62,3,9,12,79.0,82,5.86,50,250,2620,9.2
13196,Joakim Ryan,2021-22,28.0,5,7,44,44,0,7,7,35.0,562.0,106,3,16,19,114.0,82,5.96,47,239,2579,9.5
13197,Joakim Ryan,2022-23,29.0,6,5,35,35,1,4,5,54.0,670.0,141,4,20,24,168.0,70,5.96,42,208,2192,9.5
13198,Joby Messier,1995-96,25.0,4,0,11,11,0,0,0,11.0,,11,0,0,0,11.0,84,7.25,87,443,2603,11.7
13199,Joby Messier,1996-97,26.0,5,2,4,4,0,2,2,7.0,,15,0,2,2,18.0,84,6.48,76,407,2545,10.7
13200,Joby Messier,1997-98,27.0,6,2,10,10,0,2,2,4.0,,25,0,4,4,22.0,48,5.97,37,209,1408,10.2
13201,Jocelyn Gauvreau,1986-87,22.0,4,0,2,2,0,0,0,0.0,,2,0,0,0,0.0,80,7.89,74,336,2448,12.9
13202,Jocelyn Lemieux,1989-90,22.0,4,18,53,53,10,8,18,48.0,,53,10,8,18,48.0,80,7.34,72,344,2400,12.2
13203,Jocelyn Lemieux,1990-91,23.0,5,1,23,23,1,0,1,19.0,,76,11,8,19,67.0,80,7.43,89,437,2435,12.2
13204,Jocelyn Lemieux,1991-92,24.0,6,1,1,1,0,1,1,0.0,,77,11,9,20,67.0,80,7.48,85,403,2430,12.3
13205,Jocelyn Lemieux,1992-93,25.0,7,27,73,73,14,13,27,112.0,,150,25,22,47,179.0,80,7.37,76,367,2421,12.2
13206,Jocelyn Lemieux,1993-94,26.0,8,13,67,67,6,7,13,89.0,,217,31,29,60,268.0,80,6.91,71,366,2385,11.6
13207,Jocelyn Lemieux,1994-95,27.0,9,16,78,78,6,10,16,103.0,,295,37,39,76,371.0,80,6.96,77,402,2440,11.4
13208,Jocelyn Lemieux,1995-96,28.0,10,31,81,81,10,21,31,117.0,,376,47,60,107,488.0,84,7.25,87,443,2603,11.7
13209,Jocelyn Lemieux,1996-97,29.0,11,27,82,82,18,9,27,151.0,,458,65,69,134,639.0,84,6.48,76,407,2545,10.7
13210,Jocelyn Lemieux,1997-98,30.0,12,11,41,41,6,5,11,78.0,,499,71,74,145,717.0,48,5.97,37,209,1408,10.2
13211,Jocelyn Lemieux,1998-99,31.0,13,12,67,67,5,7,12,90.0,,566,76,81,157,807.0,82,6.29,74,413,2481,10.4
13212,Jocelyn Lemieux,1999-00,32.0,14,1,2,2,1,0,1,4.0,,568,77,81,158,811.0,82,5.83,55,336,2444,9.8
13213,Jocelyn Lemieux,2000-01,33.0,15,6,30,30,3,3,6,32.0,,598,80,84,164,843.0,82,5.28,57,380,2242,9.6
13214,Jochen Hecht,2001-02,24.0,4,0,3,3,0,0,0,4.0,40.0,3,0,0,0,4.0,82,5.27,57,359,2285,9.4
13215,Jochen Hecht,2002-03,25.0,5,34,63,63,13,21,34,140.0,971.0,66,13,21,34,144.0,82,5.49,53,331,2294,9.8
13216,Jochen Hecht,2003-04,26.0,6,44,72,72,19,25,44,208.0,1291.0,138,32,46,78,352.0,82,5.51,63,376,2272,9.9
13217,Jochen Hecht,2004-05,27.0,7,40,82,82,16,24,40,211.0,1230.0,220,48,70,118,563.0,82,5.24,53,338,2262,9.5
13218,Jochen Hecht,2005-06,28.0,8,26,49,49,10,16,26,145.0,878.0,269,58,86,144,708.0,82,5.31,60,363,2326,9.4
13219,Jochen Hecht,2006-07,29.0,9,52,64,64,15,37,52,174.0,1216.0,333,73,123,196,882.0,82,5.14,57,348,2300,9.2
13220,Jochen Hecht,2008-09,31.0,10,42,64,64,18,24,42,179.0,1160.0,397,91,147,238,1061.0,82,6.05,85,480,2458,10.1
13221,Jochen Hecht,2009-10,32.0,11,56,76,76,19,37,56,197.0,1432.0,473,110,184,294,1258.0,82,5.76,70,398,2426,9.7
13222,Jochen Hecht,2010-11,33.0,12,49,75,75,22,27,49,229.0,1449.0,548,132,211,343,1487.0,82,5.44,62,351,2383,9.4
13223,Jochen Hecht,2011-12,34.0,13,27,70,70,12,15,27,173.0,1218.0,618,144,226,370,1660.0,82,5.7,65,341,2477,9.4
13224,Jochen Hecht,2012-13,35.0,14,42,79,79,21,21,42,224.0,1358.0,697,165,247,412,1884.0,82,5.53,56,304,2486,9.1
13225,Jochen Hecht,2013-14,36.0,15,29,67,67,12,17,29,172.0,1144.0,764,177,264,441,2056.0,82,5.46,52,291,2492,9.0
13226,Jochen Hecht,2014-15,37.0,16,8,22,22,4,4,8,40.0,370.0,786,181,268,449,2096.0,82,5.32,47,271,2439,8.9
13227,Jochen Hecht,2015-16,38.0,17,14,47,47,5,9,14,69.0,644.0,833,186,277,463,2165.0,48,5.31,29,160,1399,9.1
13228,Jock Callander,1990-91,29.0,4,27,41,41,11,16,27,59.0,,41,11,16,27,59.0,80,7.43,89,437,2435,12.2
13229,Jock Callander,1991-92,30.0,5,11,30,30,6,5,11,35.0,,71,17,21,38,94.0,80,7.48,85,403,2430,12.3
13230,Jock Callander,1992-93,31.0,6,11,30,30,4,7,11,22.0,,101,21,28,49,116.0,80,7.37,76,367,2421,12.2
13231,Jock Callander,1995-96,34.0,7,2,8,8,1,1,2,12.0,,109,22,29,51,128.0,84,7.25,87,443,2603,11.7
13232,Jody Gage,1983-84,24.0,4,4,16,16,2,2,4,26.0,,16,2,2,4,26.0,80,7.69,77,340,2441,12.6
13233,Jody Gage,1984-85,25.0,5,19,31,31,9,10,19,47.0,,47,11,12,23,73.0,80,8.03,73,320,2489,12.9
13234,Jody Gage,1986-87,27.0,6,0,3,3,0,0,0,1.0,,50,11,12,23,74.0,80,7.89,74,336,2448,12.9
13235,Jody Gage,1988-89,29.0,7,5,7,7,3,2,5,18.0,,57,14,14,28,92.0,80,7.94,82,370,2484,12.8
13236,Jody Gage,1990-91,31.0,8,0,2,2,0,0,0,1.0,,59,14,14,28,93.0,80,7.43,89,437,2435,12.2
13237,Jody Gage,1994-95,35.0,9,1,9,9,0,1,1,9.0,,68,14,15,29,102.0,80,6.96,77,402,2440,11.4
13238,Jody Hull,1991-92,22.0,4,34,60,60,16,18,34,82.0,,60,16,18,34,82.0,80,7.48,85,403,2430,12.3
13239,Jody Hull,1992-93,23.0,5,17,38,38,7,10,17,46.0,,98,23,28,51,128.0,80,7.37,76,367,2421,12.2
13240,Jody Hull,1993-94,24.0,6,13,47,47,5,8,13,57.0,,145,28,36,64,185.0,80,6.91,71,366,2385,11.6
13241,Jody Hull,1994-95,25.0,7,0,3,3,0,0,0,4.0,,148,28,36,64,189.0,80,6.96,77,402,2440,11.4
13242,Jody Hull,1995-96,26.0,8,34,69,69,13,21,34,134.0,,217,41,57,98,323.0,84,7.25,87,443,2603,11.7
13243,Jody Hull,1996-97,27.0,9,26,69,69,13,13,26,100.0,,286,54,70,124,423.0,84,6.48,76,407,2545,10.7
13244,Jody Hull,1997-98,28.0,10,19,46,46,11,8,19,63.0,,332,65,78,143,486.0,48,5.97,37,209,1408,10.2
13245,Jody Hull,1998-99,29.0,11,37,78,78,20,17,37,120.0,,410,85,95,180,606.0,82,6.29,74,413,2481,10.4
13246,Jody Hull,1999-00,30.0,12,16,67,67,10,6,16,92.0,,477,95,101,196,698.0,82,5.83,55,336,2444,9.8
13247,Jody Hull,2000-01,31.0,13,8,49,49,4,4,8,51.0,,526,99,105,204,749.0,82,5.28,57,380,2242,9.6
13248,Jody Hull,2001-02,32.0,14,14,72,72,3,11,14,73.0,935.0,598,102,116,218,822.0,82,5.27,57,359,2285,9.4
13249,Jody Hull,2002-03,33.0,15,13,67,67,10,3,13,63.0,802.0,665,112,119,231,885.0,82,5.49,53,331,2294,9.8
13250,Jody Hull,2003-04,34.0,16,15,71,71,7,8,15,78.0,938.0,736,119,127,246,963.0,82,5.51,63,376,2272,9.9
13251,Jody Hull,2004-05,35.0,17,4,24,24,2,2,4,12.0,244.0,760,121,129,250,975.0,82,5.24,53,338,2262,9.5
13252,Jody Hull,2005-06,36.0,18,11,70,70,3,8,11,42.0,737.0,830,124,137,261,1017.0,82,5.31,60,363,2326,9.4
13253,Jody Hull,2006-07,37.0,19,0,1,1,0,0,0,0.0,3.0,831,124,137,261,1017.0,82,5.14,57,348,2300,9.2
13254,Jody Shelley,2003-04,27.0,4,0,1,1,0,0,0,0.0,2.0,1,0,0,0,0.0,82,5.51,63,376,2272,9.9
13255,Jody Shelley,2004-05,28.0,5,6,52,52,3,3,6,35.0,339.0,53,3,3,6,35.0,82,5.24,53,338,2262,9.5
13256,Jody Shelley,2005-06,29.0,6,5,68,68,1,4,5,39.0,417.0,121,4,7,11,74.0,82,5.31,60,363,2326,9.4
13257,Jody Shelley,2006-07,30.0,7,6,76,76,3,3,6,62.0,550.0,197,7,10,17,136.0,82,5.14,57,348,2300,9.2
13258,Jody Shelley,2008-09,32.0,8,10,80,80,3,7,10,39.0,478.0,277,10,17,27,175.0,82,6.05,85,480,2458,10.1
13259,Jody Shelley,2009-10,33.0,9,2,72,72,1,1,2,32.0,350.0,349,11,18,29,207.0,82,5.76,70,398,2426,9.7
13260,Jody Shelley,2010-11,34.0,10,7,62,62,1,6,7,41.0,364.0,411,12,24,36,248.0,82,5.44,62,351,2383,9.4
13261,Jody Shelley,2011-12,35.0,11,4,70,70,2,2,4,44.0,433.0,481,14,26,40,292.0,82,5.7,65,341,2477,9.4
13262,Jody Shelley,2012-13,36.0,12,9,57,57,2,7,9,49.0,386.0,538,16,33,49,341.0,82,5.53,56,304,2486,9.1
13263,Jody Shelley,2013-14,37.0,13,4,58,58,2,2,4,31.0,359.0,596,18,35,53,372.0,82,5.46,52,291,2492,9.0
13264,Jody Shelley,2014-15,38.0,14,1,30,30,0,1,1,19.0,170.0,626,18,36,54,391.0,82,5.32,47,271,2439,8.9
13265,Jody Shelley,2015-16,39.0,15,0,1,1,0,0,0,0.0,8.0,627,18,36,54,391.0,48,5.31,29,160,1399,9.1
13266,Joe Callahan,2011-12,29.0,4,2,18,18,0,2,2,6.0,270.0,18,0,2,2,6.0,82,5.7,65,341,2477,9.4
13267,Joe Callahan,2012-13,30.0,5,1,1,1,0,1,1,0.0,10.0,19,0,3,3,6.0,82,5.53,56,304,2486,9.1
13268,Joe Callahan,2013-14,31.0,6,1,27,27,0,1,1,21.0,429.0,46,0,4,4,27.0,82,5.46,52,291,2492,9.0
13269,Joe Cirella,1984-85,21.0,4,19,65,65,7,12,19,71.0,,65,7,12,19,71.0,80,8.03,73,320,2489,12.9
13270,Joe Cirella,1985-86,22.0,5,1,2,2,0,1,1,3.0,,67,7,13,20,74.0,80,7.73,71,310,2444,12.7
13271,Joe Cirella,1986-87,23.0,6,44,79,79,11,33,44,158.0,,146,18,46,64,232.0,80,7.89,74,336,2448,12.9
13272,Joe Cirella,1987-88,24.0,7,24,66,66,6,18,24,97.0,,212,24,64,88,329.0,80,7.77,71,321,2447,12.7
13273,Joe Cirella,1988-89,25.0,8,29,66,66,6,23,29,89.0,,278,30,87,117,418.0,80,7.94,82,370,2484,12.8
13274,Joe Cirella,1989-90,26.0,9,31,65,65,9,22,31,115.0,,343,39,109,148,533.0,80,7.34,72,344,2400,12.2
13275,Joe Cirella,1990-91,27.0,10,39,80,80,8,31,39,135.0,,423,47,140,187,668.0,80,7.43,89,437,2435,12.2
13276,Joe Cirella,1991-92,28.0,11,22,80,80,3,19,22,84.0,,503,50,159,209,752.0,80,7.48,85,403,2430,12.3
13277,Joe Cirella,1992-93,29.0,12,18,56,56,4,14,18,76.0,,559,54,173,227,828.0,80,7.37,76,367,2421,12.2
13278,Joe Cirella,1993-94,30.0,13,13,58,58,3,10,13,82.0,,617,57,183,240,910.0,80,6.91,71,366,2385,11.6
13279,Joe Cirella,1994-95,31.0,14,15,67,67,3,12,15,58.0,,684,60,195,255,968.0,80,6.96,77,402,2440,11.4
13280,Joe Cirella,1995-96,32.0,15,9,55,55,3,6,9,37.0,,739,63,201,264,1005.0,84,7.25,87,443,2603,11.7
13281,Joe Cirella,1996-97,33.0,16,10,63,63,1,9,10,63.0,,802,64,210,274,1068.0,84,6.48,76,407,2545,10.7
13282,Joe Cirella,1997-98,34.0,17,1,20,20,0,1,1,13.0,,822,64,211,275,1081.0,48,5.97,37,209,1408,10.2
13283,Joe Cirella,1998-99,35.0,18,0,6,6,0,0,0,3.0,,828,64,211,275,1084.0,82,6.29,74,413,2481,10.4
13284,Joe Colborne,2013-14,24.0,4,1,1,1,0,1,1,1.0,19.0,1,0,1,1,1.0,82,5.46,52,291,2492,9.0
13285,Joe Colborne,2014-15,25.0,5,5,10,10,1,4,5,7.0,137.0,11,1,5,6,8.0,82,5.32,47,271,2439,8.9
13286,Joe Colborne,2015-16,26.0,6,0,5,5,0,0,0,4.0,46.0,16,1,5,6,12.0,48,5.31,29,160,1399,9.1
13287,Joe Colborne,2016-17,27.0,7,28,80,80,10,18,28,80.0,1141.0,96,11,23,34,92.0,82,5.34,48,269,2463,8.9
13288,Joe Colborne,2017-18,28.0,8,28,64,64,8,20,28,67.0,987.0,160,19,43,62,159.0,82,5.32,47,251,2453,8.9
13289,Joe Colborne,2018-19,29.0,9,44,73,73,19,25,44,100.0,1107.0,233,38,68,106,259.0,82,5.34,48,255,2438,9.0
13290,Joe Colborne,2019-20,30.0,10,8,62,62,4,4,8,48.0,663.0,295,42,72,114,307.0,82,5.45,47,245,2478,9.0
13291,Joe Corvo,2005-06,28.0,4,12,50,50,5,7,12,84.0,931.0,50,5,7,12,84.0,82,5.31,60,363,2326,9.4
13292,Joe Corvo,2006-07,29.0,5,25,72,72,8,17,25,150.0,1522.0,122,13,24,37,234.0,82,5.14,57,348,2300,9.2
13293,Joe Corvo,2008-09,31.0,6,40,81,81,14,26,40,190.0,1619.0,203,27,50,77,424.0,82,6.05,85,480,2458,10.1
13294,Joe Corvo,2009-10,32.0,7,37,76,76,8,29,37,160.0,1373.0,279,35,79,114,584.0,82,5.76,70,398,2426,9.7
13295,Joe Corvo,2010-11,33.0,8,48,74,74,13,35,48,167.0,1380.0,353,48,114,162,751.0,82,5.44,62,351,2383,9.4
13296,Joe Corvo,2011-12,34.0,9,38,81,81,14,24,38,213.0,1970.0,434,62,138,200,964.0,82,5.7,65,341,2477,9.4
13297,Joe Corvo,2012-13,35.0,10,18,52,52,6,12,18,99.0,1212.0,486,68,150,218,1063.0,82,5.53,56,304,2486,9.1
13298,Joe Corvo,2013-14,36.0,11,40,82,82,11,29,40,191.0,2032.0,568,79,179,258,1254.0,82,5.46,52,291,2492,9.0
13299,Joe Corvo,2014-15,37.0,12,25,75,75,4,21,25,168.0,1411.0,643,83,200,283,1422.0,82,5.32,47,271,2439,8.9
13300,Joe Corvo,2015-16,38.0,13,17,40,40,6,11,17,71.0,750.0,683,89,211,300,1493.0,48,5.31,29,160,1399,9.1
13301,Joe Corvo,2016-17,39.0,14,10,25,25,3,7,10,54.0,438.0,708,92,218,310,1547.0,82,5.34,48,269,2463,8.9
13302,Joe Day,1994-95,26.0,4,3,24,24,0,3,3,13.0,,24,0,3,3,13.0,80,6.96,77,402,2440,11.4
13303,Joe Day,1995-96,27.0,5,8,24,24,1,7,8,10.0,,48,1,10,11,23.0,84,7.25,87,443,2603,11.7
13304,Joe Day,1996-97,28.0,6,0,24,24,0,0,0,16.0,,72,1,10,11,39.0,84,6.48,76,407,2545,10.7
13305,Joe DiPenta,2005-06,26.0,4,2,3,3,1,1,2,2.0,47.0,3,1,1,2,2.0,82,5.31,60,363,2326,9.4
13306,Joe DiPenta,2008-09,29.0,5,8,72,72,2,6,8,27.0,973.0,75,3,7,10,29.0,82,6.05,85,480,2458,10.1
13307,Joe DiPenta,2009-10,30.0,6,8,76,76,2,6,8,33.0,924.0,151,5,13,18,62.0,82,5.76,70,398,2426,9.7
13308,Joe DiPenta,2010-11,31.0,7,5,23,23,1,4,5,5.0,245.0,174,6,17,23,67.0,82,5.44,62,351,2383,9.4
13309,Joe Dziedzic,1998-99,27.0,4,10,69,69,5,5,10,44.0,,69,5,5,10,44.0,82,6.29,74,413,2481,10.4
13310,Joe Dziedzic,1999-00,28.0,5,18,59,59,9,9,18,85.0,,128,14,14,28,129.0,82,5.83,55,336,2444,9.8
13311,Joe Dziedzic,2001-02,30.0,6,0,2,2,0,0,0,1.0,16.0,130,14,14,28,130.0,82,5.27,57,359,2285,9.4
13312,Joe Finley,2014-15,27.0,4,0,5,5,0,0,0,1.0,39.0,5,0,0,0,1.0,82,5.32,47,271,2439,8.9
13313,Joe Finley,2015-16,28.0,5,1,16,16,0,1,1,2.0,191.0,21,0,1,1,3.0,48,5.31,29,160,1399,9.1
13314,Joe Hicketts,2020-21,24.0,4,3,5,5,0,3,3,2.0,87.0,5,0,3,3,2.0,82,5.86,50,250,2620,9.2
13315,Joe Hicketts,2021-22,25.0,5,0,11,11,0,0,0,16.0,204.0,16,0,3,3,18.0,82,5.96,47,239,2579,9.5
13316,Joe Hicketts,2022-23,26.0,6,2,6,6,0,2,2,6.0,110.0,22,0,5,5,24.0,70,5.96,42,208,2192,9.5
13317,Joe Hulbig,1999-00,26.0,4,0,6,6,0,0,0,4.0,,6,0,0,0,4.0,82,5.83,55,336,2444,9.8
13318,Joe Hulbig,2000-01,27.0,5,4,17,17,2,2,4,8.0,,23,2,2,4,12.0,82,5.28,57,380,2242,9.6
13319,Joe Hulbig,2001-02,28.0,6,0,1,1,0,0,0,2.0,8.0,24,2,2,4,14.0,82,5.27,57,359,2285,9.4
13320,Joe Hulbig,2002-03,29.0,7,4,24,24,2,2,4,15.0,199.0,48,4,4,8,29.0,82,5.49,53,331,2294,9.8
13321,Joe Hulbig,2003-04,30.0,8,0,7,7,0,0,0,0.0,38.0,55,4,4,8,29.0,82,5.51,63,376,2272,9.9
13322,Joe Jensen,2010-11,27.0,4,1,6,6,1,0,1,6.0,39.0,6,1,0,1,6.0,82,5.44,62,351,2383,9.4
13323,Joe Juneau,1994-95,27.0,4,19,14,14,5,14,19,38.0,,14,5,14,19,38.0,80,6.96,77,402,2440,11.4
13324,Joe Juneau,1995-96,28.0,5,102,84,84,32,70,102,229.0,,98,37,84,121,267.0,84,7.25,87,443,2603,11.7
13325,Joe Juneau,1996-97,29.0,6,85,74,74,19,66,85,164.0,,172,56,150,206,431.0,84,6.48,76,407,2545,10.7
13326,Joe Juneau,1997-98,30.0,7,43,44,44,5,38,43,70.0,,216,61,188,249,501.0,48,5.97,37,209,1408,10.2
13327,Joe Juneau,1998-99,31.0,8,64,80,80,14,50,64,176.0,,296,75,238,313,677.0,82,6.29,74,413,2481,10.4
13328,Joe Juneau,1999-00,32.0,9,42,58,58,15,27,42,124.0,,354,90,265,355,801.0,82,5.83,55,336,2444,9.8
13329,Joe Juneau,2000-01,33.0,10,31,56,56,9,22,31,87.0,,410,99,287,386,888.0,82,5.28,57,380,2242,9.6
13330,Joe Juneau,2001-02,34.0,11,43,72,72,15,28,43,150.0,1381.0,482,114,315,429,1038.0,82,5.27,57,359,2285,9.4
13331,Joe Juneau,2002-03,35.0,12,37,65,65,13,24,37,126.0,1200.0,547,127,339,466,1164.0,82,5.49,53,331,2294,9.8
13332,Joe Juneau,2003-04,36.0,13,33,69,69,10,23,33,100.0,1202.0,616,137,362,499,1264.0,82,5.51,63,376,2272,9.9
13333,Joe Juneau,2004-05,37.0,14,36,70,70,8,28,36,96.0,1303.0,686,145,390,535,1360.0,82,5.24,53,338,2262,9.5
13334,Joe Juneau,2005-06,38.0,15,22,72,72,6,16,22,88.0,1208.0,758,151,406,557,1448.0,82,5.31,60,363,2326,9.4
13335,Joe Juneau,2006-07,39.0,16,15,70,70,5,10,15,76.0,1105.0,828,156,416,572,1524.0,82,5.14,57,348,2300,9.2
13336,Joe Kocur,1987-88,23.0,4,1,17,17,1,0,1,7.0,,17,1,0,1,7.0,80,7.77,71,321,2447,12.7
13337,Joe Kocur,1988-89,24.0,5,15,59,59,9,6,15,65.0,,76,10,6,16,72.0,80,7.94,82,370,2484,12.8
13338,Joe Kocur,1989-90,25.0,6,18,77,77,9,9,18,81.0,,153,19,15,34,153.0,80,7.34,72,344,2400,12.2
13339,Joe Kocur,1990-91,26.0,7,14,63,63,7,7,14,41.0,,216,26,22,48,194.0,80,7.43,89,437,2435,12.2
13340,Joe Kocur,1991-92,27.0,8,18,60,60,9,9,18,76.0,,276,35,31,66,270.0,80,7.48,85,403,2430,12.3
13341,Joe Kocur,1992-93,28.0,9,36,71,71,16,20,36,128.0,,347,51,51,102,398.0,80,7.37,76,367,2421,12.2
13342,Joe Kocur,1993-94,29.0,10,9,57,57,5,4,9,73.0,,404,56,55,111,471.0,80,6.91,71,366,2385,11.6
13343,Joe Kocur,1994-95,30.0,11,11,51,51,7,4,11,72.0,,455,63,59,122,543.0,80,6.96,77,402,2440,11.4
13344,Joe Kocur,1995-96,31.0,12,9,65,65,3,6,9,43.0,,520,66,65,131,586.0,84,7.25,87,443,2603,11.7
13345,Joe Kocur,1996-97,32.0,13,3,71,71,2,1,3,43.0,,591,68,66,134,629.0,84,6.48,76,407,2545,10.7
13346,Joe Kocur,1997-98,33.0,14,3,48,48,1,2,3,25.0,,639,69,68,137,654.0,48,5.97,37,209,1408,10.2
13347,Joe Kocur,1998-99,34.0,15,4,45,45,1,3,4,20.0,,684,70,71,141,674.0,82,6.29,74,413,2481,10.4
13348,Joe Kocur,1999-00,35.0,16,3,34,34,2,1,3,38.0,,718,72,72,144,712.0,82,5.83,55,336,2444,9.8
13349,Joe Kocur,2000-01,36.0,17,11,63,63,6,5,11,53.0,,781,78,77,155,765.0,82,5.28,57,380,2242,9.6
13350,Joe Kocur,2001-02,37.0,18,7,39,39,2,5,7,20.0,263.0,820,80,82,162,785.0,82,5.27,57,359,2285,9.4
13351,Joe McDonnell,1984-85,23.0,4,1,7,7,0,1,1,6.0,,7,0,1,1,6.0,80,8.03,73,320,2489,12.9
13352,Joe McDonnell,1987-88,26.0,5,11,40,40,2,9,11,75.0,,47,2,10,12,81.0,80,7.77,71,321,2447,12.7
13353,Joe McDonnell,1988-89,27.0,6,0,3,3,0,0,0,1.0,,50,2,10,12,82.0,80,7.94,82,370,2484,12.8
13354,Joe Micheletti,1982-83,28.0,4,18,54,54,2,16,18,68.0,,54,2,16,18,68.0,80,7.03,61,280,2352,12.0
13355,Joe Micheletti,1983-84,29.0,5,31,63,63,4,27,31,102.0,,117,6,43,49,170.0,80,7.69,77,340,2441,12.6
13356,Joe Micheletti,1984-85,30.0,6,22,41,41,5,17,22,71.0,,158,11,60,71,241.0,80,8.03,73,320,2489,12.9
13357,Joe Motzko,2006-07,26.0,4,0,2,2,0,0,0,1.0,15.0,2,0,0,0,1.0,82,5.14,57,348,2300,9.2
13358,Joe Motzko,2008-09,28.0,5,0,2,2,0,0,0,3.0,21.0,4,0,0,0,4.0,82,6.05,85,480,2458,10.1
13359,Joe Motzko,2009-10,29.0,6,1,7,7,1,0,1,10.0,45.0,11,1,0,1,14.0,82,5.76,70,398,2426,9.7
13360,Joe Motzko,2010-11,30.0,7,4,8,8,2,2,4,10.0,100.0,19,3,2,5,24.0,82,5.44,62,351,2383,9.4
13361,Joe Motzko,2011-12,31.0,8,1,6,6,1,0,1,8.0,70.0,25,4,2,6,32.0,82,5.7,65,341,2477,9.4
13362,Joe Mullen,1984-85,27.0,4,59,45,45,25,34,59,141.0,,45,25,34,59,141.0,80,8.03,73,320,2489,12.9
13363,Joe Mullen,1985-86,28.0,5,47,49,49,17,30,47,128.0,,94,42,64,106,269.0,80,7.73,71,310,2444,12.7
13364,Joe Mullen,1986-87,29.0,6,85,80,80,41,44,85,228.0,,174,83,108,191,497.0,80,7.89,74,336,2448,12.9
13365,Joe Mullen,1987-88,30.0,7,92,79,79,40,52,92,253.0,,253,123,160,283,750.0,80,7.77,71,321,2447,12.7
13366,Joe Mullen,1988-89,31.0,8,90,77,77,44,46,90,202.0,,330,167,206,373,952.0,80,7.94,82,370,2484,12.8
13367,Joe Mullen,1989-90,32.0,9,87,79,79,47,40,87,206.0,,409,214,246,460,1158.0,80,7.34,72,344,2400,12.2
13368,Joe Mullen,1990-91,33.0,10,84,80,80,40,44,84,205.0,,489,254,290,544,1363.0,80,7.43,89,437,2435,12.2
13369,Joe Mullen,1991-92,34.0,11,110,79,79,51,59,110,270.0,,568,305,349,654,1633.0,80,7.48,85,403,2430,12.3
13370,Joe Mullen,1992-93,35.0,12,69,78,78,36,33,69,236.0,,646,341,382,723,1869.0,80,7.37,76,367,2421,12.2
13371,Joe Mullen,1993-94,36.0,13,39,47,47,17,22,39,85.0,,693,358,404,762,1954.0,80,6.91,71,366,2385,11.6
13372,Joe Mullen,1994-95,37.0,14,87,77,77,42,45,87,226.0,,770,400,449,849,2180.0,80,6.96,77,402,2440,11.4
13373,Joe Mullen,1995-96,38.0,15,70,72,72,33,37,70,175.0,,842,433,486,919,2355.0,84,7.25,87,443,2603,11.7
13374,Joe Mullen,1996-97,39.0,16,70,84,84,38,32,70,231.0,,926,471,518,989,2586.0,84,6.48,76,407,2545,10.7
13375,Joe Mullen,1997-98,40.0,17,37,45,45,16,21,37,78.0,,971,487,539,1026,2664.0,48,5.97,37,209,1408,10.2
13376,Joe Mullen,1998-99,41.0,18,15,37,37,8,7,15,60.0,,1008,495,546,1041,2724.0,82,6.29,74,413,2481,10.4
13377,Joe Mullen,1999-00,42.0,19,22,54,54,7,15,22,63.0,,1062,502,561,1063,2787.0,82,5.83,55,336,2444,9.8
13378,Joe Murphy,1989-90,22.0,4,1,5,5,0,1,1,3.0,,5,0,1,1,3.0,80,7.34,72,344,2400,12.2
13379,Joe Murphy,1990-91,23.0,5,19,50,50,10,9,19,82.0,,55,10,10,20,85.0,80,7.43,89,437,2435,12.2
13380,Joe Murphy,1991-92,24.0,6,8,26,26,1,7,8,29.0,,81,11,17,28,114.0,80,7.48,85,403,2430,12.3
13381,Joe Murphy,1992-93,25.0,7,29,71,71,10,19,29,117.0,,152,21,36,57,231.0,80,7.37,76,367,2421,12.2
13382,Joe Murphy,1993-94,26.0,8,62,80,80,27,35,62,141.0,,232,48,71,119,372.0,80,6.91,71,366,2385,11.6
13383,Joe Murphy,1994-95,27.0,9,82,80,80,35,47,82,193.0,,312,83,118,201,565.0,80,6.96,77,402,2440,11.4
13384,Joe Murphy,1995-96,28.0,10,17,19,19,7,10,17,43.0,,331,90,128,218,608.0,84,7.25,87,443,2603,11.7
13385,Joe Murphy,1996-97,29.0,11,70,81,81,31,39,70,222.0,,412,121,167,288,830.0,84,6.48,76,407,2545,10.7
13386,Joe Murphy,1997-98,30.0,12,41,40,40,23,18,41,120.0,,452,144,185,329,950.0,48,5.97,37,209,1408,10.2
13387,Joe Murphy,1998-99,31.0,13,51,70,70,22,29,51,212.0,,522,166,214,380,1162.0,82,6.29,74,413,2481,10.4
13388,Joe Murphy,1999-00,32.0,14,45,75,75,20,25,45,151.0,,597,186,239,425,1313.0,82,5.83,55,336,2444,9.8
13389,Joe Murphy,2000-01,33.0,15,22,37,37,9,13,22,81.0,,634,195,252,447,1394.0,82,5.28,57,380,2242,9.6
13390,Joe Murphy,2001-02,34.0,16,48,76,76,25,23,48,176.0,1121.0,710,220,275,495,1570.0,82,5.27,57,359,2285,9.4
13391,Joe Murphy,2002-03,35.0,17,27,55,55,12,15,27,118.0,815.0,765,232,290,522,1688.0,82,5.49,53,331,2294,9.8
13392,Joe Murphy,2003-04,36.0,18,6,14,14,1,5,6,22.0,175.0,779,233,295,528,1710.0,82,5.51,63,376,2272,9.9
13393,Joe Nieuwendyk,1989-90,23.0,4,6,9,9,5,1,6,16.0,,9,5,1,6,16.0,80,7.34,72,344,2400,12.2
13394,Joe Nieuwendyk,1990-91,24.0,5,92,75,75,51,41,92,212.0,,84,56,42,98,228.0,80,7.43,89,437,2435,12.2
13395,Joe Nieuwendyk,1991-92,25.0,6,82,77,77,51,31,82,215.0,,161,107,73,180,443.0,80,7.48,85,403,2430,12.3
13396,Joe Nieuwendyk,1992-93,26.0,7,95,79,79,45,50,95,226.0,,240,152,123,275,669.0,80,7.37,76,367,2421,12.2
13397,Joe Nieuwendyk,1993-94,27.0,8,85,79,79,45,40,85,222.0,,319,197,163,360,891.0,80,6.91,71,366,2385,11.6
13398,Joe Nieuwendyk,1994-95,28.0,9,56,69,69,22,34,56,137.0,,388,219,197,416,1028.0,80,6.96,77,402,2440,11.4
13399,Joe Nieuwendyk,1995-96,29.0,10,75,79,79,38,37,75,208.0,,467,257,234,491,1236.0,84,7.25,87,443,2603,11.7
13400,Joe Nieuwendyk,1996-97,30.0,11,75,64,64,36,39,75,191.0,,531,293,273,566,1427.0,84,6.48,76,407,2545,10.7
13401,Joe Nieuwendyk,1997-98,31.0,12,50,46,46,21,29,50,122.0,,577,314,302,616,1549.0,48,5.97,37,209,1408,10.2
13402,Joe Nieuwendyk,1998-99,32.0,13,32,52,52,14,18,32,138.0,,629,328,320,648,1687.0,82,6.29,74,413,2481,10.4
13403,Joe Nieuwendyk,1999-00,33.0,14,51,66,66,30,21,51,173.0,,695,358,341,699,1860.0,82,5.83,55,336,2444,9.8
13404,Joe Nieuwendyk,2000-01,34.0,15,69,73,73,39,30,69,203.0,,768,397,371,768,2063.0,82,5.28,57,380,2242,9.6
13405,Joe Nieuwendyk,2001-02,35.0,16,55,67,67,28,27,55,157.0,1042.0,835,425,398,823,2220.0,82,5.27,57,359,2285,9.4
13406,Joe Nieuwendyk,2002-03,36.0,17,34,48,48,15,19,34,110.0,780.0,883,440,417,857,2330.0,82,5.49,53,331,2294,9.8
13407,Joe Nieuwendyk,2003-04,37.0,18,52,69,69,29,23,52,166.0,1116.0,952,469,440,909,2496.0,82,5.51,63,376,2272,9.9
13408,Joe Nieuwendyk,2004-05,38.0,19,58,81,81,25,33,58,189.0,1367.0,1033,494,473,967,2685.0,82,5.24,53,338,2262,9.5
13409,Joe Nieuwendyk,2005-06,39.0,20,45,80,80,17,28,45,201.0,1340.0,1113,511,501,1012,2886.0,82,5.31,60,363,2326,9.4
13410,Joe Nieuwendyk,2006-07,40.0,21,50,64,64,22,28,50,131.0,1001.0,1177,533,529,1062,3017.0,82,5.14,57,348,2300,9.2
13411,Joe Nieuwendyk,2008-09,42.0,22,56,65,65,26,30,56,195.0,1065.0,1242,559,559,1118,3212.0,82,6.05,85,480,2458,10.1
13412,Joe Nieuwendyk,2009-10,43.0,23,8,15,15,5,3,8,30.0,201.0,1257,564,562,1126,3242.0,82,5.76,70,398,2426,9.7
13413,Joe Paterson,1983-84,23.0,4,7,38,38,2,5,7,36.0,,38,2,5,7,36.0,80,7.69,77,340,2441,12.6
13414,Joe Paterson,1984-85,24.0,5,0,3,3,0,0,0,1.0,,41,2,5,7,37.0,80,8.03,73,320,2489,12.9
13415,Joe Paterson,1985-86,25.0,6,3,33,33,2,1,3,18.0,,74,4,6,10,55.0,80,7.73,71,310,2444,12.7
13416,Joe Paterson,1986-87,26.0,7,7,41,41,2,5,7,26.0,,115,6,11,17,81.0,80,7.89,74,336,2448,12.9
13417,Joe Paterson,1987-88,27.0,8,0,6,6,0,0,0,4.0,,121,6,11,17,85.0,80,7.77,71,321,2447,12.7
13418,Joe Paterson,1988-89,28.0,9,27,52,52,9,18,27,79.0,,173,15,29,44,164.0,80,7.94,82,370,2484,12.8
13419,Joe Paterson,1989-90,29.0,10,3,45,45,2,1,3,30.0,,218,17,30,47,194.0,80,7.34,72,344,2400,12.2
13420,Joe Paterson,1990-91,30.0,11,8,53,53,2,6,8,29.0,,271,19,36,55,223.0,80,7.43,89,437,2435,12.2
13421,Joe Paterson,1991-92,31.0,12,1,20,20,0,1,1,8.0,,291,19,37,56,231.0,80,7.48,85,403,2430,12.3
13422,Joe Pavelski,2009-10,25.0,4,28,46,46,14,14,28,111.0,691.0,46,14,14,28,111.0,82,5.76,70,398,2426,9.7
13423,Joe Pavelski,2010-11,26.0,5,40,82,82,19,21,40,207.0,1157.0,128,33,35,68,318.0,82,5.44,62,351,2383,9.4
13424,Joe Pavelski,2011-12,27.0,6,59,80,80,25,34,59,266.0,1517.0,208,58,69,127,584.0,82,5.7,65,341,2477,9.4
13425,Joe Pavelski,2012-13,28.0,7,51,67,67,25,26,51,228.0,1305.0,275,83,95,178,812.0,82,5.53,56,304,2486,9.1
13426,Joe Pavelski,2013-14,29.0,8,66,74,74,20,46,66,282.0,1454.0,349,103,141,244,1094.0,82,5.46,52,291,2492,9.0
13427,Joe Pavelski,2014-15,30.0,9,61,82,82,31,30,61,269.0,1690.0,431,134,171,305,1363.0,82,5.32,47,271,2439,8.9
13428,Joe Pavelski,2015-16,31.0,10,31,48,48,16,15,31,130.0,908.0,479,150,186,336,1493.0,48,5.31,29,160,1399,9.1
13429,Joe Pavelski,2016-17,32.0,11,79,82,82,41,38,79,225.0,1628.0,561,191,224,415,1718.0,82,5.34,48,269,2463,8.9
13430,Joe Pavelski,2017-18,33.0,12,70,82,82,37,33,70,261.0,1650.0,643,228,257,485,1979.0,82,5.32,47,251,2453,8.9
13431,Joe Pavelski,2018-19,34.0,13,78,82,82,38,40,78,224.0,1625.0,725,266,297,563,2203.0,82,5.34,48,255,2438,9.0
13432,Joe Pavelski,2019-20,35.0,14,68,81,81,29,39,68,233.0,1549.0,806,295,336,631,2436.0,82,5.45,47,245,2478,9.0
13433,Joe Pavelski,2020-21,36.0,15,66,82,82,22,44,66,224.0,1579.0,888,317,380,697,2660.0,82,5.86,50,250,2620,9.2
13434,Joe Pavelski,2021-22,37.0,16,64,75,75,38,26,64,188.0,1428.0,963,355,406,761,2848.0,82,5.96,47,239,2579,9.5
13435,Joe Pavelski,2022-23,38.0,17,31,67,67,14,17,31,125.0,1134.0,1030,369,423,792,2973.0,70,5.96,42,208,2192,9.5
13436,Joe Piskula,2009-10,25.0,4,0,5,5,0,0,0,4.0,50.0,5,0,0,0,4.0,82,5.76,70,398,2426,9.7
13437,Joe Piskula,2014-15,30.0,5,0,5,5,0,0,0,2.0,54.0,10,0,0,0,6.0,82,5.32,47,271,2439,8.9
13438,Joe Piskula,2016-17,32.0,6,0,2,2,0,0,0,2.0,24.0,12,0,0,0,8.0,82,5.34,48,269,2463,8.9
13439,Joe Piskula,2017-18,33.0,7,0,1,1,0,0,0,0.0,16.0,13,0,0,0,8.0,82,5.32,47,251,2453,8.9
13440,Joe Reekie,1988-89,23.0,4,0,3,3,0,0,0,1.0,,3,0,0,0,1.0,80,7.94,82,370,2484,12.8
13441,Joe Reekie,1989-90,24.0,5,9,56,56,1,8,9,56.0,,59,1,8,9,57.0,80,7.34,72,344,2400,12.2
13442,Joe Reekie,1990-91,25.0,6,5,30,30,1,4,5,23.0,,89,2,12,14,80.0,80,7.43,89,437,2435,12.2
13443,Joe Reekie,1991-92,26.0,7,4,15,15,1,3,4,14.0,,104,3,15,18,94.0,80,7.48,85,403,2430,12.3
13444,Joe Reekie,1992-93,27.0,8,9,31,31,1,8,9,22.0,,135,4,23,27,116.0,80,7.37,76,367,2421,12.2
13445,Joe Reekie,1993-94,28.0,9,19,66,66,3,16,19,70.0,,201,7,39,46,186.0,80,6.91,71,366,2385,11.6
13446,Joe Reekie,1994-95,29.0,10,16,54,54,4,12,16,59.0,,255,11,51,62,245.0,80,6.96,77,402,2440,11.4
13447,Joe Reekie,1995-96,30.0,11,13,42,42,2,11,13,53.0,,297,13,62,75,298.0,84,7.25,87,443,2603,11.7
13448,Joe Reekie,1996-97,31.0,12,17,85,85,1,16,17,98.0,,382,14,78,92,396.0,84,6.48,76,407,2545,10.7
13449,Joe Reekie,1997-98,32.0,13,7,48,48,1,6,7,52.0,,430,15,84,99,448.0,48,5.97,37,209,1408,10.2
13450,Joe Reekie,1998-99,33.0,14,10,78,78,3,7,10,52.0,,508,18,91,109,500.0,82,6.29,74,413,2481,10.4
13451,Joe Reekie,1999-00,34.0,15,9,65,65,1,8,9,65.0,,573,19,99,118,565.0,82,5.83,55,336,2444,9.8
13452,Joe Reekie,2000-01,35.0,16,10,68,68,2,8,10,59.0,,641,21,107,128,624.0,82,5.28,57,380,2242,9.6
13453,Joe Reekie,2001-02,36.0,17,10,73,73,0,10,10,81.0,1597.0,714,21,117,138,705.0,82,5.27,57,359,2285,9.4
13454,Joe Reekie,2002-03,37.0,18,7,59,59,0,7,7,32.0,1034.0,773,21,124,145,737.0,82,5.49,53,331,2294,9.8
13455,Joe Reekie,2003-04,38.0,19,11,74,74,2,9,11,59.0,1392.0,847,23,133,156,796.0,82,5.51,63,376,2272,9.9
13456,Joe Reekie,2004-05,39.0,20,8,55,55,2,6,8,33.0,812.0,902,25,139,164,829.0,82,5.24,53,338,2262,9.5
13457,Joe Sacco,1993-94,24.0,4,5,20,20,0,5,5,20.0,,20,0,5,5,20.0,80,6.91,71,366,2385,11.6
13458,Joe Sacco,1994-95,25.0,5,11,17,17,7,4,11,40.0,,37,7,9,16,60.0,80,6.96,77,402,2440,11.4
13459,Joe Sacco,1995-96,26.0,6,8,23,23,4,4,8,38.0,,60,11,13,24,98.0,84,7.25,87,443,2603,11.7
13460,Joe Sacco,1996-97,27.0,7,37,84,84,19,18,37,206.0,,144,30,31,61,304.0,84,6.48,76,407,2545,10.7
13461,Joe Sacco,1997-98,28.0,8,18,41,41,10,8,18,77.0,,185,40,39,79,381.0,48,5.97,37,209,1408,10.2
13462,Joe Sacco,1998-99,29.0,9,27,76,76,13,14,27,132.0,,261,53,53,106,513.0,82,6.29,74,413,2481,10.4
13463,Joe Sacco,1999-00,30.0,10,29,77,77,12,17,29,131.0,,338,65,70,135,644.0,82,5.83,55,336,2444,9.8
13464,Joe Sacco,2000-01,31.0,11,25,80,80,11,14,25,122.0,,418,76,84,160,766.0,82,5.28,57,380,2242,9.6
13465,Joe Sacco,2001-02,32.0,12,3,73,73,3,0,3,84.0,729.0,491,79,84,163,850.0,82,5.27,57,359,2285,9.4
13466,Joe Sacco,2002-03,33.0,13,23,79,79,7,16,23,117.0,936.0,570,86,100,186,967.0,82,5.49,53,331,2294,9.8
13467,Joe Sacco,2003-04,34.0,14,14,69,69,7,7,14,81.0,770.0,639,93,107,200,1048.0,82,5.51,63,376,2272,9.9
13468,Joe Sacco,2004-05,35.0,15,7,65,65,0,7,7,57.0,496.0,704,93,114,207,1105.0,82,5.24,53,338,2262,9.5
13469,Joe Sacco,2005-06,36.0,16,6,34,34,1,5,6,48.0,424.0,738,94,119,213,1153.0,82,5.31,60,363,2326,9.4
13470,Joe Sakic,1991-92,22.0,4,62,70,70,23,39,62,148.0,,70,23,39,62,148.0,80,7.48,85,403,2430,12.3
13471,Joe Sakic,1992-93,23.0,5,102,80,80,39,63,102,234.0,,150,62,102,164,382.0,80,7.37,76,367,2421,12.2
13472,Joe Sakic,1993-94,24.0,6,109,80,80,48,61,109,245.0,,230,110,163,273,627.0,80,6.91,71,366,2385,11.6
13473,Joe Sakic,1994-95,25.0,7,94,69,69,29,65,94,217.0,,299,139,228,367,844.0,80,6.96,77,402,2440,11.4
13474,Joe Sakic,1995-96,26.0,8,105,78,78,48,57,105,264.0,,377,187,285,472,1108.0,84,7.25,87,443,2603,11.7
13475,Joe Sakic,1996-97,27.0,9,92,84,84,28,64,92,279.0,,461,215,349,564,1387.0,84,6.48,76,407,2545,10.7
13476,Joe Sakic,1997-98,28.0,10,62,47,47,19,43,62,157.0,,508,234,392,626,1544.0,48,5.97,37,209,1408,10.2
13477,Joe Sakic,1998-99,29.0,11,120,82,82,51,69,120,339.0,,590,285,461,746,1883.0,82,6.29,74,413,2481,10.4
13478,Joe Sakic,1999-00,30.0,12,74,65,65,22,52,74,261.0,,655,307,513,820,2144.0,82,5.83,55,336,2444,9.8
13479,Joe Sakic,2000-01,31.0,13,63,64,64,27,36,63,254.0,,719,334,549,883,2398.0,82,5.28,57,380,2242,9.6
13480,Joe Sakic,2001-02,32.0,14,96,73,73,41,55,96,255.0,1868.0,792,375,604,979,2653.0,82,5.27,57,359,2285,9.4
13481,Joe Sakic,2002-03,33.0,15,81,60,60,28,53,81,242.0,1396.0,852,403,657,1060,2895.0,82,5.49,53,331,2294,9.8
13482,Joe Sakic,2003-04,34.0,16,118,82,82,54,64,118,332.0,1887.0,934,457,721,1178,3227.0,82,5.51,63,376,2272,9.9
13483,Joe Sakic,2004-05,35.0,17,79,82,82,26,53,79,260.0,1805.0,1016,483,774,1257,3487.0,82,5.24,53,338,2262,9.5
13484,Joe Sakic,2005-06,36.0,18,58,58,58,26,32,58,190.0,1230.0,1074,509,806,1315,3677.0,82,5.31,60,363,2326,9.4
13485,Joe Sakic,2006-07,37.0,19,87,81,81,33,54,87,253.0,1641.0,1155,542,860,1402,3930.0,82,5.14,57,348,2300,9.2
13486,Joe Sakic,2008-09,39.0,20,87,82,82,32,55,87,263.0,1633.0,1237,574,915,1489,4193.0,82,6.05,85,480,2458,10.1
13487,Joe Sakic,2009-10,40.0,21,100,82,82,36,64,100,258.0,1655.0,1319,610,979,1589,4451.0,82,5.76,70,398,2426,9.7
13488,Joe Sakic,2010-11,41.0,22,40,44,44,13,27,40,124.0,879.0,1363,623,1006,1629,4575.0,82,5.44,62,351,2383,9.4
13489,Joe Sakic,2011-12,42.0,23,12,15,15,2,10,12,46.0,272.0,1378,625,1016,1641,4621.0,82,5.7,65,341,2477,9.4
13490,Joe Thornton,2000-01,21.0,4,7,55,55,3,4,7,33.0,,55,3,4,7,33.0,82,5.28,57,380,2242,9.6
13491,Joe Thornton,2001-02,22.0,5,41,81,81,16,25,41,128.0,1243.0,136,19,29,48,161.0,82,5.27,57,359,2285,9.4
13492,Joe Thornton,2002-03,23.0,6,60,81,81,23,37,60,171.0,1725.0,217,42,66,108,332.0,82,5.49,53,331,2294,9.8
13493,Joe Thornton,2003-04,24.0,7,71,72,72,37,34,71,181.0,1566.0,289,79,100,179,513.0,82,5.51,63,376,2272,9.9
13494,Joe Thornton,2004-05,25.0,8,68,66,66,22,46,68,152.0,1319.0,355,101,146,247,665.0,82,5.24,53,338,2262,9.5
13495,Joe Thornton,2005-06,26.0,9,101,77,77,36,65,101,196.0,1736.0,432,137,211,348,861.0,82,5.31,60,363,2326,9.4
13496,Joe Thornton,2006-07,27.0,10,73,77,77,23,50,73,187.0,1666.0,509,160,261,421,1048.0,82,5.14,57,348,2300,9.2
13497,Joe Thornton,2008-09,29.0,11,125,81,81,29,96,125,195.0,1728.0,590,189,357,546,1243.0,82,6.05,85,480,2458,10.1
13498,Joe Thornton,2009-10,30.0,12,114,82,82,22,92,114,213.0,1666.0,672,211,449,660,1456.0,82,5.76,70,398,2426,9.7
13499,Joe Thornton,2010-11,31.0,13,96,82,82,29,67,96,178.0,1754.0,754,240,516,756,1634.0,82,5.44,62,351,2383,9.4
13500,Joe Thornton,2011-12,32.0,14,86,82,82,25,61,86,139.0,1596.0,836,265,577,842,1773.0,82,5.7,65,341,2477,9.4
13501,Joe Thornton,2012-13,33.0,15,89,79,79,20,69,89,141.0,1569.0,915,285,646,931,1914.0,82,5.53,56,304,2486,9.1
13502,Joe Thornton,2013-14,34.0,16,70,80,80,21,49,70,149.0,1590.0,995,306,695,1001,2063.0,82,5.46,52,291,2492,9.0
13503,Joe Thornton,2014-15,35.0,17,77,82,82,18,59,77,156.0,1678.0,1077,324,754,1078,2219.0,82,5.32,47,271,2439,8.9
13504,Joe Thornton,2015-16,36.0,18,40,48,48,7,33,40,85.0,882.0,1125,331,787,1118,2304.0,48,5.31,29,160,1399,9.1
13505,Joe Thornton,2016-17,37.0,19,76,82,82,11,65,76,122.0,1552.0,1207,342,852,1194,2426.0,82,5.34,48,269,2463,8.9
13506,Joe Thornton,2017-18,38.0,20,65,78,78,16,49,65,131.0,1437.0,1285,358,901,1259,2557.0,82,5.32,47,251,2453,8.9
13507,Joe Thornton,2018-19,39.0,21,82,82,82,19,63,82,121.0,1506.0,1367,377,964,1341,2678.0,82,5.34,48,255,2438,9.0
13508,Joe Thornton,2019-20,40.0,22,50,79,79,7,43,50,81.0,1427.0,1446,384,1007,1391,2759.0,82,5.45,47,245,2478,9.0
13509,Joe Thornton,2020-21,41.0,23,36,47,47,13,23,36,75.0,862.0,1493,397,1030,1427,2834.0,82,5.86,50,250,2620,9.2
13510,Joe Thornton,2021-22,42.0,24,51,73,73,16,35,51,90.0,1135.0,1566,413,1065,1478,2924.0,82,5.96,47,239,2579,9.5
13511,Joe Thornton,2022-23,43.0,25,31,70,70,7,24,31,76.0,1085.0,1636,420,1089,1509,3000.0,70,5.96,42,208,2192,9.5
13512,Joe Vitale,2013-14,28.0,4,2,9,9,1,1,2,13.0,95.0,9,1,1,2,13.0,82,5.46,52,291,2492,9.0
13513,Joe Vitale,2014-15,29.0,5,14,68,68,4,10,14,70.0,760.0,77,5,11,16,83.0,82,5.32,47,271,2439,8.9
13514,Joe Vitale,2015-16,30.0,6,5,33,33,2,3,5,26.0,314.0,110,7,14,21,109.0,48,5.31,29,160,1399,9.1
13515,Joe Vitale,2016-17,31.0,7,14,53,53,1,13,14,42.0,582.0,163,8,27,35,151.0,82,5.34,48,269,2463,8.9
13516,Joe Vitale,2017-18,32.0,8,9,70,70,3,6,9,55.0,786.0,233,11,33,44,206.0,82,5.32,47,251,2453,8.9
13517,Joe Vitale,2018-19,33.0,9,0,1,1,0,0,0,1.0,6.0,234,11,33,44,207.0,82,5.34,48,255,2438,9.0
13518,Joe Ward,1983-84,22.0,4,0,4,4,0,0,0,2.0,,4,0,0,0,2.0,80,7.69,77,340,2441,12.6
13519,Joe Whitney,2016-17,28.0,4,0,1,1,0,0,0,0.0,8.0,1,0,0,0,0.0,82,5.34,48,269,2463,8.9
13520,Joe Whitney,2017-18,29.0,5,1,4,4,1,0,1,1.0,28.0,5,1,0,1,1.0,82,5.32,47,251,2453,8.9
13521,Joel Armia,2017-18,24.0,4,0,1,1,0,0,0,0.0,15.0,1,0,0,0,0.0,82,5.32,47,251,2453,8.9
13522,Joel Armia,2018-19,25.0,5,10,43,43,4,6,10,52.0,523.0,44,4,6,10,52.0,82,5.34,48,255,2438,9.0
13523,Joel Armia,2019-20,26.0,6,19,57,57,10,9,19,111.0,863.0,101,14,15,29,163.0,82,5.45,47,245,2478,9.0
13524,Joel Armia,2020-21,27.0,7,29,79,79,12,17,29,128.0,996.0,180,26,32,58,291.0,82,5.86,50,250,2620,9.2
13525,Joel Armia,2021-22,28.0,8,23,57,57,13,10,23,134.0,900.0,237,39,42,81,425.0,82,5.96,47,239,2579,9.5
13526,Joel Armia,2022-23,29.0,9,30,58,58,16,14,30,155.0,999.0,295,55,56,111,580.0,70,5.96,42,208,2192,9.5
13527,Joel Baillargeon,1989-90,25.0,4,1,11,11,0,1,1,1.0,,11,0,1,1,1.0,80,7.34,72,344,2400,12.2
13528,Joel Baillargeon,1990-91,26.0,5,1,4,4,0,1,1,3.0,,15,0,2,2,4.0,80,7.43,89,437,2435,12.2
13529,Joel Baillargeon,1991-92,27.0,6,0,5,5,0,0,0,2.0,,20,0,2,2,6.0,80,7.48,85,403,2430,12.3
13530,Joel Bouchard,1997-98,24.0,4,0,2,2,0,0,0,0.0,,2,0,0,0,0.0,48,5.97,37,209,1408,10.2
13531,Joel Bouchard,1998-99,25.0,5,0,4,4,0,0,0,0.0,,6,0,0,0,0.0,82,6.29,74,413,2481,10.4
13532,Joel Bouchard,1999-00,26.0,6,9,76,76,4,5,9,61.0,,82,4,5,9,61.0,82,5.83,55,336,2444,9.8
13533,Joel Bouchard,2000-01,27.0,7,12,44,44,5,7,12,51.0,,126,9,12,21,112.0,82,5.28,57,380,2242,9.6
13534,Joel Bouchard,2001-02,28.0,8,15,64,64,4,11,15,78.0,1444.0,190,13,23,36,190.0,82,5.27,57,359,2285,9.4
13535,Joel Bouchard,2002-03,29.0,9,5,54,54,1,4,5,61.0,991.0,244,14,27,41,251.0,82,5.49,53,331,2294,9.8
13536,Joel Bouchard,2003-04,30.0,10,3,32,32,1,2,3,26.0,463.0,276,15,29,44,277.0,82,5.51,63,376,2272,9.9
13537,Joel Bouchard,2004-05,31.0,11,1,1,1,0,1,1,0.0,19.0,277,15,30,45,277.0,82,5.24,53,338,2262,9.5
13538,Joel Bouchard,2005-06,32.0,12,13,34,34,5,8,13,47.0,696.0,311,20,38,58,324.0,82,5.31,60,363,2326,9.4
13539,Joel Bouchard,2006-07,33.0,13,8,28,28,1,7,8,34.0,468.0,339,21,45,66,358.0,82,5.14,57,348,2300,9.2
13540,Joel Bouchard,2008-09,35.0,14,9,25,25,1,8,9,45.0,548.0,364,22,53,75,403.0,82,6.05,85,480,2458,10.1
13541,Joel Edmundson,2018-19,25.0,4,9,67,67,1,8,9,90.0,1000.0,67,1,8,9,90.0,82,5.34,48,255,2438,9.0
13542,Joel Edmundson,2019-20,26.0,5,15,69,69,3,12,15,81.0,1226.0,136,4,20,24,171.0,82,5.45,47,245,2478,9.0
13543,Joel Edmundson,2020-21,27.0,6,17,69,69,7,10,17,124.0,1431.0,205,11,30,41,295.0,82,5.86,50,250,2620,9.2
13544,Joel Edmundson,2021-22,28.0,7,11,64,64,2,9,11,102.0,1241.0,269,13,39,52,397.0,82,5.96,47,239,2579,9.5
13545,Joel Edmundson,2022-23,29.0,8,20,68,68,7,13,20,97.0,1255.0,337,20,52,72,494.0,70,5.96,42,208,2192,9.5
13546,Joel Eriksson Ek,2019-20,23.0,4,7,15,15,3,4,7,15.0,159.0,15,3,4,7,15.0,82,5.45,47,245,2478,9.0
13547,Joel Eriksson Ek,2020-21,24.0,5,16,75,75,6,10,16,124.0,958.0,90,9,14,23,139.0,82,5.86,50,250,2620,9.2
13548,Joel Eriksson Ek,2021-22,25.0,6,14,58,58,7,7,14,111.0,783.0,148,16,21,37,250.0,82,5.96,47,239,2579,9.5
13549,Joel Eriksson Ek,2022-23,26.0,7,29,62,62,8,21,29,102.0,974.0,210,24,42,66,352.0,70,5.96,42,208,2192,9.5
13550,Joel Farabee,2022-23,22.0,4,21,52,52,8,13,21,81.0,733.0,52,8,13,21,81.0,70,5.96,42,208,2192,9.5
13551,Joel Hanley,2018-19,27.0,4,6,10,10,0,6,6,10.0,160.0,10,0,6,6,10.0,82,5.34,48,255,2438,9.0
13552,Joel Hanley,2019-20,28.0,5,0,7,7,0,0,0,5.0,71.0,17,0,6,6,15.0,82,5.45,47,245,2478,9.0
13553,Joel Hanley,2020-21,29.0,6,0,5,5,0,0,0,2.0,56.0,22,0,6,6,17.0,82,5.86,50,250,2620,9.2
13554,Joel Hanley,2021-22,30.0,7,0,16,16,0,0,0,9.0,219.0,38,0,6,6,26.0,82,5.96,47,239,2579,9.5
13555,Joel Hanley,2022-23,31.0,8,2,8,8,0,2,2,4.0,91.0,46,0,8,8,30.0,70,5.96,42,208,2192,9.5
13556,Joel Kellman,2022-23,28.0,4,7,31,31,3,4,7,31.0,359.0,31,3,4,7,31.0,70,5.96,42,208,2192,9.5
13557,Joel Kiviranta,2022-23,26.0,4,1,11,11,1,0,1,13.0,117.0,11,1,0,1,13.0,70,5.96,42,208,2192,9.5
13558,Joel Kwiatkowski,2003-04,26.0,4,1,4,4,1,0,1,2.0,48.0,4,1,0,1,2.0,82,5.51,63,376,2272,9.9
13559,Joel Kwiatkowski,2004-05,27.0,5,0,11,11,0,0,0,9.0,150.0,15,1,0,1,11.0,82,5.24,53,338,2262,9.5
13560,Joel Kwiatkowski,2005-06,28.0,6,5,54,54,0,5,5,56.0,773.0,69,1,5,6,67.0,82,5.31,60,363,2326,9.4
13561,Joel Kwiatkowski,2006-07,29.0,7,12,80,80,6,6,12,90.0,1701.0,149,7,11,18,157.0,82,5.14,57,348,2300,9.2
13562,Joel Kwiatkowski,2008-09,31.0,8,12,73,73,4,8,12,87.0,1193.0,222,11,19,30,244.0,82,6.05,85,480,2458,10.1
13563,Joel Kwiatkowski,2009-10,32.0,9,10,42,42,5,5,10,46.0,412.0,264,16,24,40,290.0,82,5.76,70,398,2426,9.7
13564,Joel Kwiatkowski,2010-11,33.0,10,5,18,18,0,5,5,24.0,301.0,282,16,29,45,314.0,82,5.44,62,351,2383,9.4
13565,Joel L'Esperance,2021-22,26.0,4,2,18,18,2,0,2,24.0,220.0,18,2,0,2,24.0,82,5.96,47,239,2579,9.5
13566,Joel L'Esperance,2022-23,27.0,5,1,3,3,1,0,1,2.0,22.0,21,3,0,3,26.0,70,5.96,42,208,2192,9.5
13567,Joel Lundqvist,2009-10,27.0,4,6,36,36,3,3,6,36.0,408.0,36,3,3,6,36.0,82,5.76,70,398,2426,9.7
13568,Joel Lundqvist,2010-11,28.0,5,14,55,55,3,11,14,48.0,598.0,91,6,14,20,84.0,82,5.44,62,351,2383,9.4
13569,Joel Lundqvist,2011-12,29.0,6,6,43,43,1,5,6,32.0,465.0,134,7,19,26,116.0,82,5.7,65,341,2477,9.4
13570,Joel Otto,1987-88,26.0,4,12,17,17,4,8,12,27.0,,17,4,8,12,27.0,80,7.77,71,321,2447,12.7
13571,Joel Otto,1988-89,27.0,5,59,79,79,25,34,59,147.0,,96,29,42,71,174.0,80,7.94,82,370,2484,12.8
13572,Joel Otto,1989-90,28.0,6,50,68,68,19,31,50,127.0,,164,48,73,121,301.0,80,7.34,72,344,2400,12.2
13573,Joel Otto,1990-91,29.0,7,52,62,62,13,39,52,105.0,,226,61,112,173,406.0,80,7.43,89,437,2435,12.2
13574,Joel Otto,1991-92,30.0,8,53,72,72,23,30,53,123.0,,298,84,142,226,529.0,80,7.48,85,403,2430,12.3
13575,Joel Otto,1992-93,31.0,9,33,75,75,13,20,33,96.0,,373,97,162,259,625.0,80,7.37,76,367,2421,12.2
13576,Joel Otto,1993-94,32.0,10,39,76,76,19,20,39,109.0,,449,116,182,298,734.0,80,6.91,71,366,2385,11.6
13577,Joel Otto,1994-95,33.0,11,34,78,78,13,21,34,105.0,,527,129,203,332,839.0,80,6.96,77,402,2440,11.4
13578,Joel Otto,1995-96,34.0,12,52,75,75,19,33,52,115.0,,602,148,236,384,954.0,84,7.25,87,443,2603,11.7
13579,Joel Otto,1996-97,35.0,13,23,81,81,11,12,23,108.0,,683,159,248,407,1062.0,84,6.48,76,407,2545,10.7
13580,Joel Otto,1997-98,36.0,14,21,47,47,8,13,21,46.0,,730,167,261,428,1108.0,48,5.97,37,209,1408,10.2
13581,Joel Otto,1998-99,37.0,15,41,67,67,12,29,41,91.0,,797,179,290,469,1199.0,82,6.29,74,413,2481,10.4
13582,Joel Otto,1999-00,38.0,16,32,78,78,13,19,32,105.0,,875,192,309,501,1304.0,82,5.83,55,336,2444,9.8
13583,Joel Otto,2000-01,39.0,17,7,68,68,3,4,7,53.0,,943,195,313,508,1357.0,82,5.28,57,380,2242,9.6
13584,Joel Perrault,2008-09,25.0,4,2,5,5,1,1,2,7.0,57.0,5,1,1,2,7.0,82,6.05,85,480,2458,10.1
13585,Joel Perrault,2009-10,26.0,5,3,26,26,1,2,3,31.0,264.0,31,2,3,5,38.0,82,5.76,70,398,2426,9.7
13586,Joel Perrault,2010-11,27.0,6,17,49,49,7,10,17,87.0,707.0,80,9,13,22,125.0,82,5.44,62,351,2383,9.4
13587,Joel Perrault,2011-12,28.0,7,3,7,7,2,1,3,15.0,90.0,87,11,14,25,140.0,82,5.7,65,341,2477,9.4
13588,Joel Perrault,2012-13,29.0,8,1,2,2,1,0,1,7.0,20.0,89,12,14,26,147.0,82,5.53,56,304,2486,9.1
13589,Joel Perrault,2013-14,30.0,9,0,7,7,0,0,0,3.0,50.0,96,12,14,26,150.0,82,5.46,52,291,2492,9.0
13590,Joel Persson,2022-23,28.0,4,2,13,13,0,2,2,17.0,199.0,13,0,2,2,17.0,70,5.96,42,208,2192,9.5
13591,Joel Prpic,2000-01,26.0,4,0,1,1,0,0,0,0.0,,1,0,0,0,0.0,82,5.28,57,380,2242,9.6
13592,Joel Prpic,2002-03,28.0,5,3,14,14,0,3,3,13.0,95.0,15,0,3,3,13.0,82,5.49,53,331,2294,9.8
13593,Joel Prpic,2003-04,29.0,6,0,3,3,0,0,0,0.0,29.0,18,0,3,3,13.0,82,5.51,63,376,2272,9.9
13594,Joel Rechlicz,2011-12,24.0,4,1,17,17,0,1,1,7.0,83.0,17,0,1,1,7.0,82,5.7,65,341,2477,9.4
13595,Joel Rechlicz,2012-13,25.0,5,0,6,6,0,0,0,1.0,16.0,23,0,1,1,8.0,82,5.53,56,304,2486,9.1
13596,Joel Rechlicz,2014-15,27.0,6,0,3,3,0,0,0,0.0,6.0,26,0,1,1,8.0,82,5.32,47,271,2439,8.9
13597,Joel Savage,1993-94,24.0,4,1,3,3,0,1,1,2.0,,3,0,1,1,2.0,80,6.91,71,366,2385,11.6
13598,Joel Vermin,2018-19,26.0,4,1,6,6,0,1,1,1.0,55.0,6,0,1,1,1.0,82,5.34,48,255,2438,9.0
13599,Joel Vermin,2019-20,27.0,5,3,18,18,0,3,3,12.0,197.0,24,0,4,4,13.0,82,5.45,47,245,2478,9.0
13600,Joel Ward,2009-10,29.0,4,1,11,11,0,1,1,12.0,85.0,11,0,1,1,12.0,82,5.76,70,398,2426,9.7
13601,Joel Ward,2011-12,31.0,5,35,79,79,17,18,35,133.0,1265.0,90,17,19,36,145.0,82,5.7,65,341,2477,9.4
13602,Joel Ward,2012-13,32.0,6,34,71,71,13,21,34,134.0,1246.0,161,30,40,70,279.0,82,5.53,56,304,2486,9.1
13603,Joel Ward,2013-14,33.0,7,29,80,80,10,19,29,157.0,1366.0,241,40,59,99,436.0,82,5.46,52,291,2492,9.0
13604,Joel Ward,2014-15,34.0,8,18,73,73,6,12,18,79.0,907.0,314,46,71,117,515.0,82,5.32,47,271,2439,8.9
13605,Joel Ward,2015-16,35.0,9,20,39,39,8,12,20,52.0,590.0,353,54,83,137,567.0,48,5.31,29,160,1399,9.1
13606,Joel Ward,2016-17,36.0,10,49,82,82,24,25,49,133.0,1318.0,435,78,108,186,700.0,82,5.34,48,269,2463,8.9
13607,Joel Ward,2017-18,37.0,11,34,82,82,19,15,34,138.0,1383.0,517,97,123,220,838.0,82,5.32,47,251,2453,8.9
13608,Joel Ward,2018-19,38.0,12,43,79,79,21,22,43,138.0,1341.0,596,118,145,263,976.0,82,5.34,48,255,2438,9.0
13609,Joel Ward,2019-20,39.0,13,29,78,78,10,19,29,105.0,1244.0,674,128,164,292,1081.0,82,5.45,47,245,2478,9.0
13610,Joel Ward,2020-21,40.0,14,12,52,52,5,7,12,40.0,617.0,726,133,171,304,1121.0,82,5.86,50,250,2620,9.2
13611,Joey Anderson,2021-22,23.0,4,7,34,34,4,3,7,49.0,439.0,34,4,3,7,49.0,82,5.96,47,239,2579,9.5
13612,Joey Anderson,2022-23,24.0,5,6,18,18,4,2,6,21.0,238.0,52,8,5,13,70.0,70,5.96,42,208,2192,9.5
13613,Joey Crabb,2011-12,28.0,4,9,29,29,4,5,9,33.0,354.0,29,4,5,9,33.0,82,5.7,65,341,2477,9.4
13614,Joey Crabb,2013-14,30.0,5,15,48,48,3,12,15,51.0,623.0,77,7,17,24,84.0,82,5.46,52,291,2492,9.0
13615,Joey Crabb,2014-15,31.0,6,26,67,67,11,15,26,75.0,901.0,144,18,32,50,159.0,82,5.32,47,271,2439,8.9
13616,Joey Crabb,2015-16,32.0,7,2,26,26,2,0,2,20.0,245.0,170,20,32,52,179.0,48,5.31,29,160,1399,9.1
13617,Joey Crabb,2016-17,33.0,8,1,9,9,0,1,1,5.0,129.0,179,20,33,53,184.0,82,5.34,48,269,2463,8.9
13618,Joey Hishon,2017-18,26.0,4,2,13,13,1,1,2,19.0,131.0,13,1,1,2,19.0,82,5.32,47,251,2453,8.9
13619,Joey Mormina,2010-11,28.0,4,0,1,1,0,0,0,1.0,8.0,1,0,0,0,1.0,82,5.44,62,351,2383,9.4
13620,Joey Tenute,2008-09,25.0,4,0,1,1,0,0,0,1.0,7.0,1,0,0,0,1.0,82,6.05,85,480,2458,10.1
13621,Joey Tetarenko,2003-04,25.0,4,4,29,29,3,1,4,21.0,180.0,29,3,1,4,21.0,82,5.51,63,376,2272,9.9
13622,Joey Tetarenko,2004-05,26.0,5,1,38,38,1,0,1,10.0,195.0,67,4,1,5,31.0,82,5.24,53,338,2262,9.5
13623,Joey Tetarenko,2005-06,27.0,6,0,4,4,0,0,0,3.0,26.0,71,4,1,5,34.0,82,5.31,60,363,2326,9.4
13624,Joey Tetarenko,2006-07,28.0,7,0,2,2,0,0,0,0.0,7.0,73,4,1,5,34.0,82,5.14,57,348,2300,9.2
13625,Joffrey Lupul,2006-07,23.0,4,34,75,75,13,21,34,137.0,1021.0,75,13,21,34,137.0,82,5.14,57,348,2300,9.2
13626,Joffrey Lupul,2008-09,25.0,5,53,81,81,28,25,53,296.0,1347.0,156,41,46,87,433.0,82,6.05,85,480,2458,10.1
13627,Joffrey Lupul,2009-10,26.0,6,28,81,81,16,12,28,172.0,1263.0,237,57,58,115,605.0,82,5.76,70,398,2426,9.7
13628,Joffrey Lupul,2010-11,27.0,7,46,56,56,20,26,46,176.0,1020.0,293,77,84,161,781.0,82,5.44,62,351,2383,9.4
13629,Joffrey Lupul,2011-12,28.0,8,50,79,79,25,25,50,194.0,1239.0,372,102,109,211,975.0,82,5.7,65,341,2477,9.4
13630,Joffrey Lupul,2012-13,29.0,9,14,23,23,10,4,14,66.0,367.0,395,112,113,225,1041.0,82,5.53,56,304,2486,9.1
13631,Joffrey Lupul,2013-14,30.0,10,31,54,54,14,17,31,129.0,844.0,449,126,130,256,1170.0,82,5.46,52,291,2492,9.0
13632,Joffrey Lupul,2014-15,31.0,11,67,66,66,25,42,67,191.0,1228.0,515,151,172,323,1361.0,82,5.32,47,271,2439,8.9
13633,Joffrey Lupul,2015-16,32.0,12,18,16,16,11,7,18,42.0,258.0,531,162,179,341,1403.0,48,5.31,29,160,1399,9.1
13634,Joffrey Lupul,2016-17,33.0,13,44,69,69,22,22,44,191.0,1274.0,600,184,201,385,1594.0,82,5.34,48,269,2463,8.9
13635,Joffrey Lupul,2017-18,34.0,14,21,55,55,10,11,21,97.0,852.0,655,194,212,406,1691.0,82,5.32,47,251,2453,8.9
13636,Joffrey Lupul,2018-19,35.0,15,14,46,46,11,3,14,102.0,673.0,701,205,215,420,1793.0,82,5.34,48,255,2438,9.0
13637,Johan Davidsson,2001-02,26.0,4,8,64,64,3,5,8,48.0,679.0,64,3,5,8,48.0,82,5.27,57,359,2285,9.4
13638,Johan Davidsson,2002-03,27.0,5,7,19,19,3,4,7,29.0,215.0,83,6,9,15,77.0,82,5.49,53,331,2294,9.8
13639,Johan Franzen,2008-09,29.0,4,16,80,80,12,4,16,119.0,996.0,80,12,4,16,119.0,82,6.05,85,480,2458,10.1
13640,Johan Franzen,2009-10,30.0,5,30,69,69,10,20,30,151.0,1076.0,149,22,24,46,270.0,82,5.76,70,398,2426,9.7
13641,Johan Franzen,2010-11,31.0,6,38,72,72,27,11,38,199.0,1276.0,221,49,35,84,469.0,82,5.44,62,351,2383,9.4
13642,Johan Franzen,2011-12,32.0,7,59,71,71,34,25,59,246.0,1285.0,292,83,60,143,715.0,82,5.7,65,341,2477,9.4
13643,Johan Franzen,2012-13,33.0,8,21,27,27,10,11,21,91.0,505.0,319,93,71,164,806.0,82,5.53,56,304,2486,9.1
13644,Johan Franzen,2013-14,34.0,9,55,76,76,28,27,55,248.0,1325.0,395,121,98,219,1054.0,82,5.46,52,291,2492,9.0
13645,Johan Franzen,2014-15,35.0,10,56,77,77,29,27,56,211.0,1363.0,472,150,125,275,1265.0,82,5.32,47,271,2439,8.9
13646,Johan Franzen,2015-16,36.0,11,31,41,41,14,17,31,116.0,742.0,513,164,142,306,1381.0,48,5.31,29,160,1399,9.1
13647,Johan Franzen,2016-17,37.0,12,41,54,54,16,25,41,149.0,954.0,567,180,167,347,1530.0,82,5.34,48,269,2463,8.9
13648,Johan Franzen,2017-18,38.0,13,22,33,33,7,15,22,74.0,530.0,600,187,182,369,1604.0,82,5.32,47,251,2453,8.9
13649,Johan Franzen,2018-19,39.0,14,1,2,2,0,1,1,3.0,26.0,602,187,183,370,1607.0,82,5.34,48,255,2438,9.0
13650,Johan Garpenlov,1993-94,25.0,4,40,71,71,18,22,40,91.0,,71,18,22,40,91.0,80,6.91,71,366,2385,11.6
13651,Johan Garpenlov,1994-95,26.0,5,13,28,28,6,7,13,34.0,,99,24,29,53,125.0,80,6.96,77,402,2440,11.4
13652,Johan Garpenlov,1995-96,27.0,6,66,79,79,22,44,66,171.0,,178,46,73,119,296.0,84,7.25,87,443,2603,11.7
13653,Johan Garpenlov,1996-97,28.0,7,53,80,80,18,35,53,125.0,,258,64,108,172,421.0,84,6.48,76,407,2545,10.7
13654,Johan Garpenlov,1997-98,29.0,8,14,40,40,4,10,14,44.0,,298,68,118,186,465.0,48,5.97,37,209,1408,10.2
13655,Johan Garpenlov,1998-99,30.0,9,51,82,82,23,28,51,130.0,,380,91,146,237,595.0,82,6.29,74,413,2481,10.4
13656,Johan Garpenlov,1999-00,31.0,10,36,53,53,11,25,36,83.0,,433,102,171,273,678.0,82,5.83,55,336,2444,9.8
13657,Johan Garpenlov,2000-01,32.0,11,5,39,39,2,3,5,43.0,,472,104,174,278,721.0,82,5.28,57,380,2242,9.6
13658,Johan Garpenlov,2001-02,33.0,12,17,64,64,8,9,17,71.0,847.0,536,112,183,295,792.0,82,5.27,57,359,2285,9.4
13659,Johan Garpenlov,2002-03,34.0,13,16,73,73,2,14,16,79.0,1118.0,609,114,197,311,871.0,82,5.49,53,331,2294,9.8
13660,Johan Harju,2013-14,27.0,4,3,10,10,1,2,3,14.0,85.0,10,1,2,3,14.0,82,5.46,52,291,2492,9.0
13661,Johan Larsson,2015-16,23.0,4,0,1,1,0,0,0,2.0,14.0,1,0,0,0,2.0,48,5.31,29,160,1399,9.1
13662,Johan Larsson,2016-17,24.0,5,4,28,28,0,4,4,21.0,377.0,29,0,4,4,23.0,82,5.34,48,269,2463,8.9
13663,Johan Larsson,2017-18,25.0,6,16,39,39,6,10,16,50.0,566.0,68,6,14,20,73.0,82,5.32,47,251,2453,8.9
13664,Johan Larsson,2018-19,26.0,7,17,74,74,10,7,17,95.0,1097.0,142,16,21,37,168.0,82,5.34,48,255,2438,9.0
13665,Johan Larsson,2019-20,27.0,8,11,36,36,6,5,11,49.0,607.0,178,22,26,48,217.0,82,5.45,47,245,2478,9.0
13666,Johan Larsson,2020-21,28.0,9,17,80,80,4,13,17,86.0,1129.0,258,26,39,65,303.0,82,5.86,50,250,2620,9.2
13667,Johan Larsson,2021-22,29.0,10,14,73,73,6,8,14,79.0,1043.0,331,32,47,79,382.0,82,5.96,47,239,2579,9.5
13668,Johan Larsson,2022-23,30.0,11,18,62,62,6,12,18,60.0,924.0,393,38,59,97,442.0,70,5.96,42,208,2192,9.5
13669,Johan Lindbom,2000-01,29.0,4,4,38,38,1,3,4,38.0,,38,1,3,4,38.0,82,5.28,57,380,2242,9.6
13670,Johan Motin,2012-13,23.0,4,0,1,1,0,0,0,0.0,14.0,1,0,0,0,0.0,82,5.53,56,304,2486,9.1
13671,Johan Sundstrom,2016-17,24.0,4,1,11,11,0,1,1,13.0,95.0,11,0,1,1,13.0,82,5.34,48,269,2463,8.9
13672,Johan Witehall,2001-02,30.0,4,0,4,4,0,0,0,1.0,16.0,4,0,0,0,1.0,82,5.27,57,359,2285,9.4
13673,Johan Witehall,2002-03,31.0,5,2,9,9,1,1,2,6.0,76.0,13,1,1,2,7.0,82,5.49,53,331,2294,9.8
13674,Johan Witehall,2003-04,32.0,6,5,41,41,1,4,5,34.0,405.0,54,2,5,7,41.0,82,5.51,63,376,2272,9.9
13675,John Albert,2016-17,28.0,4,1,9,9,1,0,1,5.0,46.0,9,1,0,1,5.0,82,5.34,48,269,2463,8.9
13676,John Barrett,1983-84,25.0,4,13,56,56,3,10,13,97.0,,56,3,10,13,97.0,80,7.69,77,340,2441,12.6
13677,John Barrett,1984-85,26.0,5,13,69,69,1,12,13,97.0,,125,4,22,26,194.0,80,8.03,73,320,2489,12.9
13678,John Barrett,1985-86,27.0,6,14,79,79,4,10,14,75.0,,204,8,32,40,269.0,80,7.73,71,310,2444,12.7
13679,John Barrett,1986-87,28.0,7,10,78,78,2,8,10,63.0,,282,10,40,50,332.0,80,7.89,74,336,2448,12.9
13680,John Barrett,1987-88,29.0,8,25,71,71,6,19,25,73.0,,353,16,59,75,405.0,80,7.77,71,321,2447,12.7
13681,John Barrett,1988-89,30.0,9,17,79,79,2,15,17,67.0,,432,18,74,92,472.0,80,7.94,82,370,2484,12.8
13682,John Barrett,1989-90,31.0,10,4,55,55,2,2,4,37.0,,487,20,76,96,509.0,80,7.34,72,344,2400,12.2
13683,John Barrett,1990-91,32.0,11,1,1,1,0,1,1,0.0,,488,20,77,97,509.0,80,7.43,89,437,2435,12.2
13684,John Bethel,1982-83,26.0,4,2,17,17,0,2,2,12.0,,17,0,2,2,12.0,80,7.03,61,280,2352,12.0
13685,John Blum,1985-86,26.0,4,3,5,5,0,3,3,0.0,,5,0,3,3,0.0,80,7.73,71,310,2444,12.7
13686,John Blum,1986-87,27.0,5,3,16,16,1,2,3,12.0,,21,1,5,6,12.0,80,7.89,74,336,2448,12.9
13687,John Blum,1987-88,28.0,6,16,75,75,3,13,16,36.0,,96,4,18,22,48.0,80,7.77,71,321,2447,12.7
13688,John Blum,1988-89,29.0,7,8,61,61,1,7,8,34.0,,157,5,25,30,82.0,80,7.94,82,370,2484,12.8
13689,John Blum,1989-90,30.0,8,10,66,66,2,8,10,33.0,,223,7,33,40,115.0,80,7.34,72,344,2400,12.2
13690,John Blum,1990-91,31.0,9,1,19,19,0,1,1,6.0,,242,7,34,41,121.0,80,7.43,89,437,2435,12.2
13691,John Blum,1991-92,32.0,10,0,6,6,0,0,0,3.0,,248,7,34,41,124.0,80,7.48,85,403,2430,12.3
13692,John Blum,1992-93,33.0,11,0,2,2,0,0,0,0.0,,250,7,34,41,124.0,80,7.37,76,367,2421,12.2
13693,John Byce,1993-94,26.0,4,4,18,18,1,3,4,13.0,,18,1,3,4,13.0,80,6.91,71,366,2385,11.6
13694,John Byce,1994-95,27.0,5,1,3,3,1,0,1,2.0,,21,2,3,5,15.0,80,6.96,77,402,2440,11.4
13695,John Carlson,2012-13,23.0,4,6,22,22,1,5,6,21.0,335.0,22,1,5,6,21.0,82,5.53,56,304,2486,9.1
13696,John Carlson,2013-14,24.0,5,37,82,82,7,30,37,144.0,1857.0,104,8,35,43,165.0,82,5.46,52,291,2492,9.0
13697,John Carlson,2014-15,25.0,6,32,82,82,9,23,32,152.0,1792.0,186,17,58,75,317.0,82,5.32,47,271,2439,8.9
13698,John Carlson,2015-16,26.0,7,22,48,48,6,16,22,97.0,1105.0,234,23,74,97,414.0,48,5.31,29,160,1399,9.1
13699,John Carlson,2016-17,27.0,8,37,82,82,10,27,37,208.0,2010.0,316,33,101,134,622.0,82,5.34,48,269,2463,8.9
13700,John Carlson,2017-18,28.0,9,55,82,82,12,43,55,193.0,1892.0,398,45,144,189,815.0,82,5.32,47,251,2453,8.9
13701,John Carlson,2018-19,29.0,10,39,56,56,8,31,39,124.0,1327.0,454,53,175,228,939.0,82,5.34,48,255,2438,9.0
13702,John Carlson,2019-20,30.0,11,37,72,72,9,28,37,180.0,1635.0,526,62,203,265,1119.0,82,5.45,47,245,2478,9.0
13703,John Carlson,2020-21,31.0,12,68,82,82,15,53,68,237.0,2032.0,608,77,256,333,1356.0,82,5.86,50,250,2620,9.2
13704,John Carlson,2021-22,32.0,13,70,80,80,13,57,70,185.0,2005.0,688,90,313,403,1541.0,82,5.96,47,239,2579,9.5
13705,John Carlson,2022-23,33.0,14,75,69,69,15,60,75,189.0,1700.0,757,105,373,478,1730.0,70,5.96,42,208,2192,9.5
13706,John Carter,1988-89,25.0,4,0,3,3,0,0,0,2.0,,3,0,0,0,2.0,80,7.94,82,370,2484,12.8
13707,John Carter,1989-90,26.0,5,1,8,8,0,1,1,12.0,,11,0,1,1,14.0,80,7.34,72,344,2400,12.2
13708,John Carter,1990-91,27.0,6,1,4,4,0,1,1,8.0,,15,0,2,2,22.0,80,7.43,89,437,2435,12.2
13709,John Carter,1991-92,28.0,7,22,44,44,12,10,22,96.0,,59,12,12,24,118.0,80,7.48,85,403,2430,12.3
13710,John Carter,1992-93,29.0,8,39,76,76,17,22,39,142.0,,135,29,34,63,260.0,80,7.37,76,367,2421,12.2
13711,John Carter,1993-94,30.0,9,11,50,50,4,7,11,61.0,,185,33,41,74,321.0,80,6.91,71,366,2385,11.6
13712,John Carter,1994-95,31.0,10,0,4,4,0,0,0,5.0,,189,33,41,74,326.0,80,6.96,77,402,2440,11.4
13713,John Carter,1995-96,32.0,11,16,55,55,7,9,16,110.0,,244,40,50,90,436.0,84,7.25,87,443,2603,11.7
13714,John Chabot,1986-87,24.0,4,43,56,56,18,25,43,69.0,,56,18,25,43,69.0,80,7.89,74,336,2448,12.9
13715,John Chabot,1987-88,25.0,5,60,77,77,9,51,60,112.0,,133,27,76,103,181.0,80,7.77,71,321,2447,12.7
13716,John Chabot,1988-89,26.0,6,45,77,77,14,31,45,89.0,,210,41,107,148,270.0,80,7.94,82,370,2484,12.8
13717,John Chabot,1989-90,27.0,7,36,72,72,14,22,36,90.0,,282,55,129,184,360.0,80,7.34,72,344,2400,12.2
13718,John Chabot,1990-91,28.0,8,57,78,78,13,44,57,83.0,,360,68,173,241,443.0,80,7.43,89,437,2435,12.2
13719,John Chabot,1991-92,29.0,9,12,52,52,2,10,12,49.0,,412,70,183,253,492.0,80,7.48,85,403,2430,12.3
13720,John Chabot,1992-93,30.0,10,49,69,69,9,40,49,91.0,,481,79,223,302,583.0,80,7.37,76,367,2421,12.2
13721,John Chabot,1993-94,31.0,11,10,27,27,5,5,10,26.0,,508,84,228,312,609.0,80,6.91,71,366,2385,11.6
13722,John Craighead,1999-00,28.0,4,0,5,5,0,0,0,0.0,,5,0,0,0,0.0,82,5.83,55,336,2444,9.8
13723,John Cullen,1991-92,27.0,4,49,79,79,12,37,49,121.0,,79,12,37,49,121.0,80,7.48,85,403,2430,12.3
13724,John Cullen,1992-93,28.0,5,92,72,72,32,60,92,197.0,,151,44,97,141,318.0,80,7.37,76,367,2421,12.2
13725,John Cullen,1993-94,29.0,6,110,78,78,39,71,110,205.0,,229,83,168,251,523.0,80,6.91,71,366,2385,11.6
13726,John Cullen,1994-95,30.0,7,77,77,77,26,51,77,173.0,,306,109,219,328,696.0,80,6.96,77,402,2440,11.4
13727,John Cullen,1995-96,31.0,8,50,66,66,18,32,50,124.0,,372,127,251,378,820.0,84,7.25,87,443,2603,11.7
13728,John Cullen,1996-97,32.0,9,30,53,53,13,17,30,80.0,,425,140,268,408,900.0,84,6.48,76,407,2545,10.7
13729,John Cullen,1997-98,33.0,10,37,46,46,13,24,37,88.0,,471,153,292,445,988.0,48,5.97,37,209,1408,10.2
13730,John Cullen,1998-99,34.0,11,50,76,76,16,34,50,152.0,,547,169,326,495,1140.0,82,6.29,74,413,2481,10.4
13731,John Cullen,1999-00,35.0,12,55,70,70,18,37,55,116.0,,617,187,363,550,1256.0,82,5.83,55,336,2444,9.8
13732,John Cullen,2001-02,37.0,13,0,4,4,0,0,0,3.0,51.0,621,187,363,550,1259.0,82,5.27,57,359,2285,9.4
13733,John Druce,1991-92,25.0,4,15,48,48,8,7,15,59.0,,48,8,7,15,59.0,80,7.48,85,403,2430,12.3
13734,John Druce,1992-93,26.0,5,11,45,45,8,3,11,66.0,,93,16,10,26,125.0,80,7.37,76,367,2421,12.2
13735,John Druce,1993-94,27.0,6,58,80,80,22,36,58,209.0,,173,38,46,84,334.0,80,6.91,71,366,2385,11.6
13736,John Druce,1994-95,28.0,7,37,67,67,19,18,37,129.0,,240,57,64,121,463.0,80,6.96,77,402,2440,11.4
13737,John Druce,1995-96,29.0,8,20,50,50,6,14,20,60.0,,290,63,78,141,523.0,84,7.25,87,443,2603,11.7
13738,John Druce,1996-97,30.0,9,31,55,55,14,17,31,104.0,,345,77,95,172,627.0,84,6.48,76,407,2545,10.7
13739,John Druce,1997-98,31.0,10,20,43,43,15,5,20,75.0,,388,92,100,192,702.0,48,5.97,37,209,1408,10.2
13740,John Druce,1998-99,32.0,11,29,77,77,13,16,29,128.0,,465,105,116,221,830.0,82,6.29,74,413,2481,10.4
13741,John Druce,1999-00,33.0,12,15,43,43,7,8,15,73.0,,508,112,124,236,903.0,82,5.83,55,336,2444,9.8
13742,John Druce,2000-01,34.0,13,3,23,23,1,2,3,18.0,,531,113,126,239,921.0,82,5.28,57,380,2242,9.6
13743,John Emmons,2002-03,28.0,4,0,10,10,0,0,0,3.0,74.0,10,0,0,0,3.0,82,5.49,53,331,2294,9.8
13744,John Emmons,2003-04,29.0,5,4,53,53,2,2,4,37.0,476.0,63,2,2,4,40.0,82,5.51,63,376,2272,9.9
13745,John Emmons,2004-05,30.0,6,2,22,22,0,2,2,20.0,178.0,85,2,4,6,60.0,82,5.24,53,338,2262,9.5
13746,John English,1990-91,24.0,4,4,3,3,1,3,4,5.0,,3,1,3,4,5.0,80,7.43,89,437,2435,12.2
13747,John Erskine,2004-05,24.0,4,1,33,33,0,1,1,16.0,354.0,33,0,1,1,16.0,82,5.24,53,338,2262,9.5
13748,John Erskine,2005-06,25.0,5,2,16,16,2,0,2,12.0,172.0,49,2,1,3,28.0,82,5.31,60,363,2326,9.4
13749,John Erskine,2006-07,26.0,6,1,32,32,0,1,1,23.0,403.0,81,2,2,4,51.0,82,5.14,57,348,2300,9.2
13750,John Erskine,2008-09,28.0,7,1,60,60,1,0,1,32.0,783.0,141,3,2,5,83.0,82,6.05,85,480,2458,10.1
13751,John Erskine,2009-10,29.0,8,7,29,29,1,6,7,14.0,523.0,170,4,8,12,97.0,82,5.76,70,398,2426,9.7
13752,John Erskine,2010-11,30.0,9,9,51,51,2,7,9,48.0,801.0,221,6,15,21,145.0,82,5.44,62,351,2383,9.4
13753,John Erskine,2011-12,31.0,10,4,52,52,0,4,4,50.0,873.0,273,6,19,25,195.0,82,5.7,65,341,2477,9.4
13754,John Erskine,2012-13,32.0,11,6,50,50,1,5,6,50.0,799.0,323,7,24,31,245.0,82,5.53,56,304,2486,9.1
13755,John Erskine,2013-14,33.0,12,11,73,73,4,7,11,58.0,1083.0,396,11,31,42,303.0,82,5.46,52,291,2492,9.0
13756,John Erskine,2014-15,34.0,13,2,28,28,0,2,2,20.0,339.0,424,11,33,44,323.0,82,5.32,47,271,2439,8.9
13757,John Erskine,2015-16,35.0,14,6,30,30,3,3,6,32.0,554.0,454,14,36,50,355.0,48,5.31,29,160,1399,9.1
13758,John Erskine,2016-17,36.0,15,4,37,37,1,3,4,38.0,577.0,491,15,39,54,393.0,82,5.34,48,269,2463,8.9
13759,John Gibson,1983-84,24.0,4,0,4,4,0,0,0,5.0,,4,0,0,0,5.0,80,7.69,77,340,2441,12.6
13760,John Gibson,1984-85,25.0,5,2,33,33,0,2,2,37.0,,37,0,2,2,42.0,80,8.03,73,320,2489,12.9
13761,John Gibson,1986-87,27.0,6,0,11,11,0,0,0,4.0,,48,0,2,2,46.0,80,7.89,74,336,2448,12.9
13762,John Gilmour,2020-21,27.0,4,5,28,28,2,3,5,61.0,481.0,28,2,3,5,61.0,82,5.86,50,250,2620,9.2
13763,John Gilmour,2021-22,28.0,5,0,5,5,0,0,0,9.0,80.0,33,2,3,5,70.0,82,5.96,47,239,2579,9.5
13764,John Gilmour,2022-23,29.0,6,0,4,4,0,0,0,5.0,68.0,37,2,3,5,75.0,70,5.96,42,208,2192,9.5
13765,John Gruden,1996-97,26.0,4,1,7,7,0,1,1,8.0,,7,0,1,1,8.0,84,6.48,76,407,2545,10.7
13766,John Gruden,1997-98,27.0,5,6,38,38,0,6,6,30.0,,45,0,7,7,38.0,48,5.97,37,209,1408,10.2
13767,John Gruden,1998-99,28.0,6,0,14,14,0,0,0,12.0,,59,0,7,7,50.0,82,6.29,74,413,2481,10.4
13768,John Gruden,2001-02,31.0,7,1,13,13,0,1,1,10.0,171.0,72,0,8,8,60.0,82,5.27,57,359,2285,9.4
13769,John Gruden,2002-03,32.0,8,0,9,9,0,0,0,3.0,148.0,81,0,8,8,63.0,82,5.49,53,331,2294,9.8
13770,John Gruden,2006-07,36.0,9,1,11,11,1,0,1,7.0,146.0,92,1,8,9,70.0,82,5.14,57,348,2300,9.2
13771,John Hayden,2019-20,24.0,4,4,12,12,1,3,4,22.0,140.0,12,1,3,4,22.0,82,5.45,47,245,2478,9.0
13772,John Hayden,2020-21,25.0,5,13,47,47,4,9,13,56.0,509.0,59,5,12,17,78.0,82,5.86,50,250,2620,9.2
13773,John Hayden,2021-22,26.0,6,5,54,54,3,2,5,42.0,495.0,113,8,14,22,120.0,82,5.96,47,239,2579,9.5
13774,John Hayden,2022-23,27.0,7,4,43,43,3,1,4,39.0,418.0,156,11,15,26,159.0,70,5.96,42,208,2192,9.5
13775,John Hughes,1982-83,28.0,4,13,52,52,2,11,13,49.0,,52,2,11,13,49.0,80,7.03,61,280,2352,12.0
13776,John Hughes,1983-84,29.0,5,3,18,18,0,3,3,9.0,,70,2,14,16,58.0,80,7.69,77,340,2441,12.6
13777,John Jakopin,2000-01,25.0,4,0,2,2,0,0,0,1.0,,2,0,0,0,1.0,82,5.28,57,380,2242,9.6
13778,John Jakopin,2001-02,26.0,5,0,3,3,0,0,0,0.0,41.0,5,0,0,0,1.0,82,5.27,57,359,2285,9.4
13779,John Jakopin,2002-03,27.0,6,0,17,17,0,0,0,1.0,203.0,22,0,0,0,2.0,82,5.49,53,331,2294,9.8
13780,John Jakopin,2003-04,28.0,7,3,60,60,1,2,3,23.0,774.0,82,1,2,3,25.0,82,5.51,63,376,2272,9.9
13781,John Jakopin,2004-05,29.0,8,4,19,19,0,4,4,3.0,157.0,101,1,6,7,28.0,82,5.24,53,338,2262,9.5
13782,John Jakopin,2005-06,30.0,9,0,12,12,0,0,0,3.0,98.0,113,1,6,7,31.0,82,5.31,60,363,2326,9.4
13783,John Johannson,1986-87,25.0,4,0,5,5,0,0,0,4.0,,5,0,0,0,4.0,80,7.89,74,336,2448,12.9
13784,John Klingberg,2017-18,25.0,4,40,65,65,11,29,40,98.0,1420.0,65,11,29,40,98.0,82,5.32,47,251,2453,8.9
13785,John Klingberg,2018-19,26.0,5,58,76,76,10,48,58,171.0,1724.0,141,21,77,98,269.0,82,5.34,48,255,2438,9.0
13786,John Klingberg,2019-20,27.0,6,49,80,80,13,36,49,124.0,1868.0,221,34,113,147,393.0,82,5.45,47,245,2478,9.0
13787,John Klingberg,2020-21,28.0,7,67,82,82,8,59,67,204.0,1974.0,303,42,172,214,597.0,82,5.86,50,250,2620,9.2
13788,John Klingberg,2021-22,29.0,8,45,64,64,10,35,45,153.0,1570.0,367,52,207,259,750.0,82,5.96,47,239,2579,9.5
13789,John Klingberg,2022-23,30.0,9,32,58,58,6,26,32,120.0,1286.0,425,58,233,291,870.0,70,5.96,42,208,2192,9.5
13790,John Kordic,1988-89,23.0,4,1,5,5,0,1,1,0.0,,5,0,1,1,0.0,80,7.94,82,370,2484,12.8
13791,John Kordic,1989-90,24.0,5,8,44,44,5,3,8,32.0,,49,5,4,9,32.0,80,7.34,72,344,2400,12.2
13792,John Kordic,1990-91,25.0,6,8,60,60,2,6,8,17.0,,109,7,10,17,49.0,80,7.43,89,437,2435,12.2
13793,John Kordic,1991-92,26.0,7,3,52,52,1,2,3,35.0,,161,8,12,20,84.0,80,7.48,85,403,2430,12.3
13794,John Kordic,1992-93,27.0,8,13,55,55,9,4,13,48.0,,216,17,16,33,132.0,80,7.37,76,367,2421,12.2
13795,John Kordic,1993-94,28.0,9,0,10,10,0,0,0,1.0,,226,17,16,33,133.0,80,6.91,71,366,2385,11.6
13796,John Kordic,1994-95,29.0,10,2,18,18,0,2,2,3.0,,244,17,18,35,136.0,80,6.96,77,402,2440,11.4
13797,John LeBlanc,1989-90,26.0,4,1,2,2,1,0,1,4.0,,2,1,0,1,4.0,80,7.34,72,344,2400,12.2
13798,John LeBlanc,1990-91,27.0,5,22,41,41,12,10,22,86.0,,43,13,10,23,90.0,80,7.43,89,437,2435,12.2
13799,John LeBlanc,1991-92,28.0,6,1,2,2,1,0,1,5.0,,45,14,10,24,95.0,80,7.48,85,403,2430,12.3
13800,John LeBlanc,1994-95,31.0,7,7,16,16,6,1,7,32.0,,61,20,11,31,127.0,80,6.96,77,402,2440,11.4
13801,John LeBlanc,1995-96,32.0,8,0,3,3,0,0,0,5.0,,64,20,11,31,132.0,84,7.25,87,443,2603,11.7
13802,John LeBlanc,1996-97,33.0,9,8,17,17,6,2,8,29.0,,81,26,13,39,161.0,84,6.48,76,407,2545,10.7
13803,John LeBlanc,1997-98,34.0,10,0,2,2,0,0,0,0.0,,83,26,13,39,161.0,48,5.97,37,209,1408,10.2
13804,John LeClair,1993-94,24.0,4,7,10,10,2,5,7,12.0,,10,2,5,7,12.0,80,6.91,71,366,2385,11.6
13805,John LeClair,1994-95,25.0,5,19,59,59,8,11,19,73.0,,69,10,16,26,85.0,80,6.96,77,402,2440,11.4
13806,John LeClair,1995-96,26.0,6,44,72,72,19,25,44,139.0,,141,29,41,70,224.0,84,7.25,87,443,2603,11.7
13807,John LeClair,1996-97,27.0,7,43,74,74,19,24,43,153.0,,215,48,65,113,377.0,84,6.48,76,407,2545,10.7
13808,John LeClair,1997-98,28.0,8,54,46,46,26,28,54,131.0,,261,74,93,167,508.0,48,5.97,37,209,1408,10.2
13809,John LeClair,1998-99,29.0,9,97,82,82,51,46,97,270.0,,343,125,139,264,778.0,82,6.29,74,413,2481,10.4
13810,John LeClair,1999-00,30.0,10,97,82,82,50,47,97,324.0,,425,175,186,361,1102.0,82,5.83,55,336,2444,9.8
13811,John LeClair,2000-01,31.0,11,87,82,82,51,36,87,303.0,,507,226,222,448,1405.0,82,5.28,57,380,2242,9.6
13812,John LeClair,2001-02,32.0,12,90,76,76,43,47,90,246.0,1600.0,583,269,269,538,1651.0,82,5.27,57,359,2285,9.4
13813,John LeClair,2002-03,33.0,13,77,82,82,40,37,77,249.0,1664.0,665,309,306,615,1900.0,82,5.49,53,331,2294,9.8
13814,John LeClair,2003-04,34.0,14,12,16,16,7,5,12,48.0,306.0,681,316,311,627,1948.0,82,5.51,63,376,2272,9.9
13815,John LeClair,2004-05,35.0,15,51,82,82,25,26,51,220.0,1435.0,763,341,337,678,2168.0,82,5.24,53,338,2262,9.5
13816,John LeClair,2005-06,36.0,16,28,35,35,18,10,28,99.0,565.0,798,359,347,706,2267.0,82,5.31,60,363,2326,9.4
13817,John LeClair,2006-07,37.0,17,55,75,75,23,32,55,182.0,1207.0,873,382,379,761,2449.0,82,5.14,57,348,2300,9.2
13818,John LeClair,2008-09,39.0,18,51,73,73,22,29,51,135.0,1150.0,946,404,408,812,2584.0,82,6.05,85,480,2458,10.1
13819,John LeClair,2009-10,40.0,19,7,21,21,2,5,7,27.0,249.0,967,406,413,819,2611.0,82,5.76,70,398,2426,9.7
13820,John Lilley,1996-97,24.0,4,7,13,13,1,6,7,20.0,,13,1,6,7,20.0,84,6.48,76,407,2545,10.7
13821,John Lilley,1997-98,25.0,5,4,9,9,2,2,4,10.0,,22,3,8,11,30.0,48,5.97,37,209,1408,10.2
13822,John Lilley,1998-99,26.0,6,0,1,1,0,0,0,0.0,,23,3,8,11,30.0,82,6.29,74,413,2481,10.4
13823,John MacLean,1986-87,22.0,4,1,23,23,1,0,1,22.0,,23,1,0,1,22.0,80,7.89,74,336,2448,12.9
13824,John MacLean,1987-88,23.0,5,33,61,61,13,20,33,97.0,,84,14,20,34,119.0,80,7.77,71,321,2447,12.7
13825,John MacLean,1988-89,24.0,6,57,74,74,21,36,57,139.0,,158,35,56,91,258.0,80,7.94,82,370,2484,12.8
13826,John MacLean,1989-90,25.0,7,67,80,80,31,36,67,197.0,,238,66,92,158,455.0,80,7.34,72,344,2400,12.2
13827,John MacLean,1990-91,26.0,8,39,76,76,23,16,39,204.0,,314,89,108,197,659.0,80,7.43,89,437,2435,12.2
13828,John MacLean,1991-92,27.0,9,87,74,74,42,45,87,266.0,,388,131,153,284,925.0,80,7.48,85,403,2430,12.3
13829,John MacLean,1992-93,28.0,10,79,80,80,41,38,79,322.0,,468,172,191,363,1247.0,80,7.37,76,367,2421,12.2
13830,John MacLean,1993-94,29.0,11,78,78,78,45,33,78,292.0,,546,217,224,441,1539.0,80,6.91,71,366,2385,11.6
13831,John MacLean,1995-96,31.0,12,48,80,80,24,24,48,195.0,,626,241,248,489,1734.0,84,7.25,87,443,2603,11.7
13832,John MacLean,1996-97,32.0,13,70,80,80,37,33,70,277.0,,706,278,281,559,2011.0,84,6.48,76,407,2545,10.7
13833,John MacLean,1997-98,33.0,14,29,46,46,17,12,29,139.0,,752,295,293,588,2150.0,48,5.97,37,209,1408,10.2
13834,John MacLean,1998-99,34.0,15,48,76,76,20,28,48,237.0,,828,315,321,636,2387.0,82,6.29,74,413,2481,10.4
13835,John MacLean,1999-00,35.0,16,54,80,80,29,25,54,254.0,,908,344,346,690,2641.0,82,5.83,55,336,2444,9.8
13836,John MacLean,2000-01,36.0,17,43,77,77,16,27,43,213.0,,985,360,373,733,2854.0,82,5.28,57,380,2242,9.6
13837,John MacLean,2001-02,37.0,18,55,82,82,28,27,55,231.0,1699.0,1067,388,400,788,3085.0,82,5.27,57,359,2285,9.4
13838,John MacLean,2002-03,38.0,19,42,77,77,18,24,42,158.0,1134.0,1144,406,424,830,3243.0,82,5.49,53,331,2294,9.8
13839,John MacLean,2003-04,39.0,20,6,30,30,4,2,6,41.0,378.0,1174,410,426,836,3284.0,82,5.51,63,376,2272,9.9
13840,John MacLean,2004-05,40.0,21,6,20,20,3,3,6,40.0,251.0,1194,413,429,842,3324.0,82,5.24,53,338,2262,9.5
13841,John Madden,2001-02,28.0,4,1,4,4,0,1,1,4.0,37.0,4,0,1,1,4.0,82,5.27,57,359,2285,9.4
13842,John Madden,2002-03,29.0,5,25,74,74,16,9,25,115.0,863.0,78,16,10,26,119.0,82,5.49,53,331,2294,9.8
13843,John Madden,2003-04,30.0,6,38,80,80,23,15,38,163.0,1247.0,158,39,25,64,282.0,82,5.51,63,376,2272,9.9
13844,John Madden,2004-05,31.0,7,23,82,82,15,8,23,170.0,1280.0,240,54,33,87,452.0,82,5.24,53,338,2262,9.5
13845,John Madden,2005-06,32.0,8,41,80,80,19,22,41,207.0,1465.0,320,73,55,128,659.0,82,5.31,60,363,2326,9.4
13846,John Madden,2006-07,33.0,9,35,80,80,12,23,35,210.0,1382.0,400,85,78,163,869.0,82,5.14,57,348,2300,9.2
13847,John Madden,2008-09,35.0,10,36,82,82,16,20,36,194.0,1557.0,482,101,98,199,1063.0,82,6.05,85,480,2458,10.1
13848,John Madden,2009-10,36.0,11,32,74,74,12,20,32,153.0,1397.0,556,113,118,231,1216.0,82,5.76,70,398,2426,9.7
13849,John Madden,2010-11,37.0,12,43,80,80,20,23,43,185.0,1556.0,636,133,141,274,1401.0,82,5.44,62,351,2383,9.4
13850,John Madden,2011-12,38.0,13,23,76,76,7,16,23,132.0,1248.0,712,140,157,297,1533.0,82,5.7,65,341,2477,9.4
13851,John Madden,2012-13,39.0,14,23,79,79,10,13,23,127.0,1217.0,791,150,170,320,1660.0,82,5.53,56,304,2486,9.1
13852,John Madden,2013-14,40.0,15,25,76,76,12,13,25,107.0,1166.0,867,162,183,345,1767.0,82,5.46,52,291,2492,9.0
13853,John Madden,2014-15,41.0,16,3,31,31,3,0,3,33.0,371.0,898,165,183,348,1800.0,82,5.32,47,271,2439,8.9
13854,John Marino,2022-23,25.0,4,26,56,56,6,20,26,61.0,1134.0,56,6,20,26,61.0,70,5.96,42,208,2192,9.5
13855,John Markell,1982-83,26.0,4,17,38,38,10,7,17,46.0,,38,10,7,17,46.0,80,7.03,61,280,2352,12.0
13856,John Markell,1983-84,27.0,5,4,14,14,1,3,4,11.0,,52,11,10,21,57.0,80,7.69,77,340,2441,12.6
13857,John Markell,1986-87,30.0,6,0,2,2,0,0,0,0.0,,54,11,10,21,57.0,80,7.89,74,336,2448,12.9
13858,John Markell,1987-88,31.0,7,0,1,1,0,0,0,0.0,,55,11,10,21,57.0,80,7.77,71,321,2447,12.7
13859,John McCarthy,2012-13,26.0,4,0,4,4,0,0,0,3.0,37.0,4,0,0,0,3.0,82,5.53,56,304,2486,9.1
13860,John McCarthy,2013-14,27.0,5,4,37,37,2,2,4,41.0,323.0,41,2,2,4,44.0,82,5.46,52,291,2492,9.0
13861,John McCarthy,2014-15,28.0,6,0,10,10,0,0,0,14.0,94.0,51,2,2,4,58.0,82,5.32,47,271,2439,8.9
13862,John McCarthy,2016-17,30.0,7,2,36,36,1,1,2,49.0,398.0,87,3,3,6,107.0,82,5.34,48,269,2463,8.9
13863,John McCarthy,2018-19,32.0,8,0,1,1,0,0,0,0.0,7.0,88,3,3,6,107.0,82,5.34,48,255,2438,9.0
13864,John McFarland,2018-19,26.0,4,0,3,3,0,0,0,2.0,30.0,3,0,0,0,2.0,82,5.34,48,255,2438,9.0
13865,John McIntyre,1992-93,23.0,4,17,59,59,5,12,17,44.0,,59,5,12,17,44.0,80,7.37,76,367,2421,12.2
13866,John McIntyre,1993-94,24.0,5,16,69,69,8,8,16,33.0,,128,13,20,33,77.0,80,6.91,71,366,2385,11.6
13867,John McIntyre,1994-95,25.0,6,24,73,73,5,19,24,40.0,,201,18,39,57,117.0,80,6.96,77,402,2440,11.4
13868,John McIntyre,1995-96,26.0,7,8,60,60,3,5,8,36.0,,261,21,44,65,153.0,84,7.25,87,443,2603,11.7
13869,John McIntyre,1996-97,27.0,8,9,62,62,3,6,9,30.0,,323,24,50,74,183.0,84,6.48,76,407,2545,10.7
13870,John McIntyre,1997-98,28.0,9,4,28,28,0,4,4,6.0,,351,24,54,78,189.0,48,5.97,37,209,1408,10.2
13871,John Miner,1990-91,25.0,4,5,14,14,2,3,5,16.0,,14,2,3,5,16.0,80,7.43,89,437,2435,12.2
13872,John Mitchell,2011-12,27.0,4,29,76,76,12,17,29,98.0,1049.0,76,12,17,29,98.0,82,5.7,65,341,2477,9.4
13873,John Mitchell,2012-13,28.0,5,23,60,60,6,17,23,90.0,949.0,136,18,34,52,188.0,82,5.53,56,304,2486,9.1
13874,John Mitchell,2013-14,29.0,6,3,23,23,2,1,3,28.0,288.0,159,20,35,55,216.0,82,5.46,52,291,2492,9.0
13875,John Mitchell,2014-15,30.0,7,16,63,63,5,11,16,64.0,640.0,222,25,46,71,280.0,82,5.32,47,271,2439,8.9
13876,John Mitchell,2015-16,31.0,8,20,47,47,10,10,20,72.0,787.0,269,35,56,91,352.0,48,5.31,29,160,1399,9.1
13877,John Mitchell,2016-17,32.0,9,32,75,75,11,21,32,107.0,1220.0,344,46,77,123,459.0,82,5.34,48,269,2463,8.9
13878,John Mitchell,2017-18,33.0,10,26,68,68,11,15,26,105.0,1078.0,412,57,92,149,564.0,82,5.32,47,251,2453,8.9
13879,John Mitchell,2018-19,34.0,11,21,71,71,10,11,21,101.0,1082.0,483,67,103,170,665.0,82,5.34,48,255,2438,9.0
13880,John Mitchell,2019-20,35.0,12,7,65,65,3,4,7,57.0,816.0,548,70,107,177,722.0,82,5.45,47,245,2478,9.0
13881,John Mokosak,1991-92,28.0,4,1,8,8,0,1,1,0.0,,8,0,1,1,0.0,80,7.48,85,403,2430,12.3
13882,John Mokosak,1992-93,29.0,5,1,33,33,0,1,1,15.0,,41,0,2,2,15.0,80,7.37,76,367,2421,12.2
13883,John Moore,2013-14,23.0,4,0,2,2,0,0,0,0.0,23.0,2,0,0,0,0.0,82,5.46,52,291,2492,9.0
13884,John Moore,2014-15,24.0,5,7,67,67,2,5,7,64.0,1060.0,69,2,5,7,64.0,82,5.32,47,271,2439,8.9
13885,John Moore,2015-16,25.0,6,7,30,30,1,6,7,29.0,400.0,99,3,11,14,93.0,48,5.31,29,160,1399,9.1
13886,John Moore,2016-17,26.0,7,15,74,74,4,11,15,115.0,1134.0,173,7,22,29,208.0,82,5.34,48,269,2463,8.9
13887,John Moore,2017-18,27.0,8,11,57,57,2,9,11,77.0,929.0,230,9,31,40,285.0,82,5.32,47,251,2453,8.9
13888,John Moore,2018-19,28.0,9,19,73,73,4,15,19,106.0,1448.0,303,13,46,59,391.0,82,5.34,48,255,2438,9.0
13889,John Moore,2019-20,29.0,10,22,63,63,12,10,22,102.0,1196.0,366,25,56,81,493.0,82,5.45,47,245,2478,9.0
13890,John Moore,2020-21,30.0,11,18,81,81,7,11,18,141.0,1621.0,447,32,67,99,634.0,82,5.86,50,250,2620,9.2
13891,John Moore,2021-22,31.0,12,13,61,61,4,9,13,97.0,1145.0,508,36,76,112,731.0,82,5.96,47,239,2579,9.5
13892,John Moore,2022-23,32.0,13,3,24,24,2,1,3,33.0,397.0,532,38,77,115,764.0,70,5.96,42,208,2192,9.5
13893,John Negrin,2011-12,22.0,4,1,3,3,0,1,1,3.0,30.0,3,0,1,1,3.0,82,5.7,65,341,2477,9.4
13894,John Newberry,1986-87,24.0,4,0,3,3,0,0,0,2.0,,3,0,0,0,2.0,80,7.89,74,336,2448,12.9
13895,John Newberry,1987-88,25.0,5,4,16,16,0,4,4,13.0,,19,0,4,4,15.0,80,7.77,71,321,2447,12.7
13896,John Newberry,1988-89,26.0,6,0,3,3,0,0,0,4.0,,22,0,4,4,19.0,80,7.94,82,370,2484,12.8
13897,John Ogrodnick,1982-83,23.0,4,32,41,41,8,24,32,121.0,,41,8,24,32,121.0,80,7.03,61,280,2352,12.0
13898,John Ogrodnick,1983-84,24.0,5,70,80,80,35,35,70,276.0,,121,43,59,102,397.0,80,7.69,77,340,2441,12.6
13899,John Ogrodnick,1984-85,25.0,6,54,80,80,28,26,54,254.0,,201,71,85,156,651.0,80,8.03,73,320,2489,12.9
13900,John Ogrodnick,1985-86,26.0,7,85,80,80,41,44,85,254.0,,281,112,129,241,905.0,80,7.73,71,310,2444,12.7
13901,John Ogrodnick,1986-87,27.0,8,78,64,64,42,36,78,254.0,,345,154,165,319,1159.0,80,7.89,74,336,2448,12.9
13902,John Ogrodnick,1987-88,28.0,9,105,79,79,55,50,105,301.0,,424,209,215,424,1460.0,80,7.77,71,321,2447,12.7
13903,John Ogrodnick,1988-89,29.0,10,70,76,76,38,32,70,208.0,,500,247,247,494,1668.0,80,7.94,82,370,2484,12.8
13904,John Ogrodnick,1989-90,30.0,11,67,71,71,23,44,67,246.0,,571,270,291,561,1914.0,80,7.34,72,344,2400,12.2
13905,John Ogrodnick,1990-91,31.0,12,54,64,64,22,32,54,152.0,,635,292,323,615,2066.0,80,7.43,89,437,2435,12.2
13906,John Ogrodnick,1991-92,32.0,13,42,60,60,13,29,42,149.0,,695,305,352,657,2215.0,80,7.48,85,403,2430,12.3
13907,John Ogrodnick,1992-93,33.0,14,74,80,80,43,31,74,215.0,,775,348,383,731,2430.0,80,7.37,76,367,2421,12.2
13908,John Ogrodnick,1993-94,34.0,15,54,79,79,31,23,54,250.0,,854,379,406,785,2680.0,80,6.91,71,366,2385,11.6
13909,John Ogrodnick,1994-95,35.0,16,30,55,55,17,13,30,110.0,,909,396,419,815,2790.0,80,6.96,77,402,2440,11.4
13910,John Ogrodnick,1995-96,36.0,17,12,19,19,6,6,12,25.0,,928,402,425,827,2815.0,84,7.25,87,443,2603,11.7
13911,John Paul Kelly,1982-83,23.0,4,7,40,40,2,5,7,31.0,,40,2,5,7,31.0,80,7.03,61,280,2352,12.0
13912,John Paul Kelly,1983-84,24.0,5,9,19,19,3,6,9,18.0,,59,5,11,16,49.0,80,7.69,77,340,2441,12.6
13913,John Paul Kelly,1984-85,25.0,6,23,70,70,12,11,23,92.0,,129,17,22,39,141.0,80,8.03,73,320,2489,12.9
13914,John Paul Kelly,1985-86,26.0,7,31,65,65,16,15,31,103.0,,194,33,37,70,244.0,80,7.73,71,310,2444,12.7
13915,John Paul Kelly,1986-87,27.0,8,21,72,72,7,14,21,87.0,,266,40,51,91,331.0,80,7.89,74,336,2448,12.9
13916,John Paul Kelly,1987-88,28.0,9,18,73,73,8,10,18,71.0,,339,48,61,109,402.0,80,7.77,71,321,2447,12.7
13917,John Paul Kelly,1988-89,29.0,10,15,61,61,6,9,15,38.0,,400,54,70,124,440.0,80,7.94,82,370,2484,12.8
13918,John Persson,2016-17,24.0,4,1,10,10,1,0,1,16.0,120.0,10,1,0,1,16.0,82,5.34,48,269,2463,8.9
13919,John Pohl,2006-07,27.0,4,0,1,1,0,0,0,1.0,8.0,1,0,0,0,1.0,82,5.14,57,348,2300,9.2
13920,John Pohl,2008-09,29.0,5,4,7,7,3,1,4,17.0,89.0,8,3,1,4,18.0,82,6.05,85,480,2458,10.1
13921,John Pohl,2009-10,30.0,6,29,74,74,13,16,29,105.0,840.0,82,16,17,33,123.0,82,5.76,70,398,2426,9.7
13922,John Pohl,2010-11,31.0,7,5,33,33,1,4,5,23.0,234.0,115,17,21,38,146.0,82,5.44,62,351,2383,9.4
13923,John Purves,1993-94,25.0,4,1,7,7,1,0,1,8.0,,7,1,0,1,8.0,80,6.91,71,366,2385,11.6
13924,John Quenneville,2019-20,23.0,4,4,12,12,1,3,4,21.0,164.0,12,1,3,4,21.0,82,5.45,47,245,2478,9.0
13925,John Quenneville,2020-21,24.0,5,0,2,2,0,0,0,5.0,27.0,14,1,3,4,26.0,82,5.86,50,250,2620,9.2
13926,John Quenneville,2021-22,25.0,6,1,19,19,1,0,1,16.0,215.0,33,2,3,5,42.0,82,5.96,47,239,2579,9.5
13927,John Quenneville,2022-23,26.0,7,0,9,9,0,0,0,14.0,99.0,42,2,3,5,56.0,70,5.96,42,208,2192,9.5
13928,John Ramage,2017-18,26.0,4,0,1,1,0,0,0,4.0,18.0,1,0,0,0,4.0,82,5.32,47,251,2453,8.9
13929,John Ramage,2018-19,27.0,5,0,1,1,0,0,0,0.0,14.0,2,0,0,0,4.0,82,5.34,48,255,2438,9.0
13930,John Scott,2011-12,29.0,4,1,20,20,0,1,1,6.0,185.0,20,0,1,1,6.0,82,5.7,65,341,2477,9.4
13931,John Scott,2012-13,30.0,5,2,51,51,1,1,2,22.0,439.0,71,1,2,3,28.0,82,5.53,56,304,2486,9.1
13932,John Scott,2013-14,31.0,6,1,40,40,0,1,1,15.0,250.0,111,1,3,4,43.0,82,5.46,52,291,2492,9.0
13933,John Scott,2014-15,32.0,7,1,35,35,0,1,1,9.0,235.0,146,1,4,5,52.0,82,5.32,47,271,2439,8.9
13934,John Scott,2015-16,33.0,8,0,34,34,0,0,0,15.0,185.0,180,1,4,5,67.0,48,5.31,29,160,1399,9.1
13935,John Scott,2016-17,34.0,9,1,56,56,1,0,1,16.0,378.0,236,2,4,6,83.0,82,5.34,48,269,2463,8.9
13936,John Scott,2017-18,35.0,10,4,38,38,3,1,4,19.0,283.0,274,5,5,10,102.0,82,5.32,47,251,2453,8.9
13937,John Scott,2018-19,36.0,11,1,12,12,0,1,1,6.0,78.0,286,5,6,11,108.0,82,5.34,48,255,2438,9.0
13938,John Slaney,1996-97,24.0,4,16,47,47,7,9,16,70.0,,47,7,9,16,70.0,84,6.48,76,407,2545,10.7
13939,John Slaney,1997-98,25.0,5,3,16,16,0,3,3,21.0,,63,7,12,19,91.0,48,5.97,37,209,1408,10.2
13940,John Slaney,1998-99,26.0,6,20,38,38,6,14,20,75.0,,101,13,26,39,166.0,82,6.29,74,413,2481,10.4
13941,John Slaney,1999-00,27.0,7,14,32,32,3,11,14,60.0,,133,16,37,53,226.0,82,5.83,55,336,2444,9.8
13942,John Slaney,2000-01,28.0,8,17,55,55,3,14,17,74.0,,188,19,51,70,300.0,82,5.28,57,380,2242,9.6
13943,John Slaney,2001-02,29.0,9,14,46,46,2,12,14,84.0,950.0,234,21,63,84,384.0,82,5.27,57,359,2285,9.4
13944,John Slaney,2002-03,30.0,10,5,29,29,1,4,5,27.0,354.0,263,22,67,89,411.0,82,5.49,53,331,2294,9.8
13945,John Slaney,2004-05,32.0,11,0,1,1,0,0,0,1.0,24.0,264,22,67,89,412.0,82,5.24,53,338,2262,9.5
13946,John Slaney,2006-07,34.0,12,2,4,4,0,2,2,0.0,55.0,268,22,69,91,412.0,82,5.14,57,348,2300,9.2
13947,John Stevens,1989-90,23.0,4,2,6,6,0,2,2,2.0,,6,0,2,2,2.0,80,7.34,72,344,2400,12.2
13948,John Stevens,1990-91,24.0,5,0,3,3,0,0,0,0.0,,9,0,2,2,2.0,80,7.43,89,437,2435,12.2
13949,John Stevens,1993-94,27.0,6,1,14,14,0,1,1,7.0,,23,0,3,3,9.0,80,6.91,71,366,2385,11.6
13950,John Stevens,1994-95,28.0,7,4,21,21,0,4,4,13.0,,44,0,7,7,22.0,80,6.96,77,402,2440,11.4
13951,John Stevens,1996-97,30.0,8,3,9,9,0,3,3,3.0,,53,0,10,10,25.0,84,6.48,76,407,2545,10.7
13952,John Stewart,1982-83,29.0,4,0,2,2,0,0,0,4.0,,2,0,0,0,4.0,80,7.03,61,280,2352,12.0
13953,John Tavares,2012-13,22.0,4,54,82,82,24,30,54,186.0,1477.0,82,24,30,54,186.0,82,5.53,56,304,2486,9.1
13954,John Tavares,2013-14,23.0,5,67,79,79,29,38,67,243.0,1521.0,161,53,68,121,429.0,82,5.46,52,291,2492,9.0
13955,John Tavares,2014-15,24.0,6,81,82,82,31,50,81,286.0,1687.0,243,84,118,202,715.0,82,5.32,47,271,2439,8.9
13956,John Tavares,2015-16,25.0,7,47,48,48,28,19,47,162.0,997.0,291,112,137,249,877.0,48,5.31,29,160,1399,9.1
13957,John Tavares,2016-17,26.0,8,66,59,59,24,42,66,188.0,1253.0,350,136,179,315,1065.0,82,5.34,48,269,2463,8.9
13958,John Tavares,2017-18,27.0,9,86,82,82,38,48,86,278.0,1695.0,432,174,227,401,1343.0,82,5.32,47,251,2453,8.9
13959,John Tavares,2018-19,28.0,10,70,78,78,33,37,70,250.0,1560.0,510,207,264,471,1593.0,82,5.34,48,255,2438,9.0
13960,John Tavares,2019-20,29.0,11,66,77,77,28,38,66,260.0,1572.0,587,235,302,537,1853.0,82,5.45,47,245,2478,9.0
13961,John Tavares,2020-21,30.0,12,84,82,82,37,47,84,257.0,1634.0,669,272,349,621,2110.0,82,5.86,50,250,2620,9.2
13962,John Tavares,2021-22,31.0,13,88,82,82,47,41,88,286.0,1565.0,751,319,390,709,2396.0,82,5.96,47,239,2579,9.5
13963,John Tavares,2022-23,32.0,14,60,63,63,26,34,60,197.0,1232.0,814,345,424,769,2593.0,70,5.96,42,208,2192,9.5
13964,John Tripp,2005-06,28.0,4,3,9,9,1,2,3,16.0,79.0,9,1,2,3,16.0,82,5.31,60,363,2326,9.4
13965,John Tripp,2006-07,29.0,5,6,34,34,1,5,6,45.0,275.0,43,2,7,9,61.0,82,5.14,57,348,2300,9.2
13966,John Tucker,1986-87,22.0,4,16,21,21,12,4,16,40.0,,21,12,4,16,40.0,80,7.89,74,336,2448,12.9
13967,John Tucker,1987-88,23.0,5,49,64,64,22,27,49,112.0,,85,34,31,65,152.0,80,7.77,71,321,2447,12.7
13968,John Tucker,1988-89,24.0,6,65,75,75,31,34,65,146.0,,160,65,65,130,298.0,80,7.94,82,370,2484,12.8
13969,John Tucker,1989-90,25.0,7,51,54,54,17,34,51,104.0,,214,82,99,181,402.0,80,7.34,72,344,2400,12.2
13970,John Tucker,1990-91,26.0,8,38,45,45,19,19,38,93.0,,259,101,118,219,495.0,80,7.43,89,437,2435,12.2
13971,John Tucker,1991-92,27.0,9,44,60,60,13,31,44,94.0,,319,114,149,263,589.0,80,7.48,85,403,2430,12.3
13972,John Tucker,1992-93,28.0,10,31,46,46,10,21,31,69.0,,365,124,170,294,658.0,80,7.37,76,367,2421,12.2
13973,John Tucker,1993-94,29.0,11,11,38,38,4,7,11,35.0,,403,128,177,305,693.0,80,6.91,71,366,2385,11.6
13974,John Tucker,1995-96,31.0,12,56,78,78,17,39,56,179.0,,481,145,216,361,872.0,84,7.25,87,443,2603,11.7
13975,John Tucker,1996-97,32.0,13,40,66,66,17,23,40,126.0,,547,162,239,401,998.0,84,6.48,76,407,2545,10.7
13976,John Tucker,1997-98,33.0,14,25,46,46,12,13,25,81.0,,593,174,252,426,1079.0,48,5.97,37,209,1408,10.2
13977,John Tucker,1998-99,34.0,15,10,63,63,3,7,10,53.0,,656,177,259,436,1132.0,82,6.29,74,413,2481,10.4
13978,John Zeiler,2009-10,27.0,4,3,23,23,1,2,3,12.0,198.0,23,1,2,3,12.0,82,5.76,70,398,2426,9.7
13979,John Zeiler,2010-11,28.0,5,1,36,36,0,1,1,18.0,305.0,59,1,3,4,30.0,82,5.44,62,351,2383,9.4
13980,John Zeiler,2011-12,29.0,6,1,27,27,0,1,1,3.0,177.0,86,1,4,5,33.0,82,5.7,65,341,2477,9.4
13981,John Zeiler,2013-14,31.0,7,0,4,4,0,0,0,1.0,22.0,90,1,4,5,34.0,82,5.46,52,291,2492,9.0
13982,John-Michael Liles,2006-07,26.0,4,34,79,79,10,24,34,115.0,1282.0,79,10,24,34,115.0,82,5.14,57,348,2300,9.2
13983,John-Michael Liles,2008-09,28.0,5,49,82,82,14,35,49,154.0,1519.0,161,24,59,83,269.0,82,6.05,85,480,2458,10.1
13984,John-Michael Liles,2009-10,29.0,6,44,71,71,14,30,44,128.0,1261.0,232,38,89,127,397.0,82,5.76,70,398,2426,9.7
13985,John-Michael Liles,2010-11,30.0,7,32,81,81,6,26,32,163.0,1593.0,313,44,115,159,560.0,82,5.44,62,351,2383,9.4
13986,John-Michael Liles,2011-12,31.0,8,39,75,75,12,27,39,146.0,1616.0,388,56,142,198,706.0,82,5.7,65,341,2477,9.4
13987,John-Michael Liles,2012-13,32.0,9,31,59,59,6,25,31,96.0,1089.0,447,62,167,229,802.0,82,5.53,56,304,2486,9.1
13988,John-Michael Liles,2013-14,33.0,10,46,76,76,6,40,46,163.0,1673.0,523,68,207,275,965.0,82,5.46,52,291,2492,9.0
13989,John-Michael Liles,2014-15,34.0,11,27,66,66,7,20,27,106.0,1409.0,589,75,227,302,1071.0,82,5.32,47,271,2439,8.9
13990,John-Michael Liles,2015-16,35.0,12,11,32,32,2,9,11,47.0,601.0,621,77,236,313,1118.0,48,5.31,29,160,1399,9.1
13991,John-Michael Liles,2016-17,36.0,13,9,41,41,2,7,9,56.0,806.0,662,79,243,322,1174.0,82,5.34,48,269,2463,8.9
13992,John-Michael Liles,2017-18,37.0,14,22,57,57,2,20,22,90.0,1091.0,719,81,263,344,1264.0,82,5.32,47,251,2453,8.9
13993,John-Michael Liles,2018-19,38.0,15,21,81,81,6,15,21,111.0,1645.0,800,87,278,365,1375.0,82,5.34,48,255,2438,9.0
13994,John-Michael Liles,2019-20,39.0,16,5,36,36,0,5,5,36.0,583.0,836,87,283,370,1411.0,82,5.45,47,245,2478,9.0
13995,Johnathan Aitken,2002-03,24.0,4,0,3,3,0,0,0,2.0,57.0,3,0,0,0,2.0,82,5.49,53,331,2294,9.8
13996,Johnathan Aitken,2006-07,28.0,5,1,41,41,0,1,1,37.0,707.0,44,0,1,1,39.0,82,5.14,57,348,2300,9.2
13997,Johnny Boychuk,2010-11,27.0,4,0,4,4,0,0,0,3.0,36.0,4,0,0,0,3.0,82,5.44,62,351,2383,9.4
13998,Johnny Boychuk,2011-12,28.0,5,0,1,1,0,0,0,0.0,15.0,5,0,0,0,3.0,82,5.7,65,341,2477,9.4
13999,Johnny Boychuk,2012-13,29.0,6,15,51,51,5,10,15,96.0,901.0,56,5,10,15,99.0,82,5.53,56,304,2486,9.1
14000,Johnny Boychuk,2013-14,30.0,7,16,69,69,3,13,16,154.0,1415.0,125,8,23,31,253.0,82,5.46,52,291,2492,9.0
14001,Johnny Boychuk,2014-15,31.0,8,15,77,77,5,10,15,171.0,1587.0,202,13,33,46,424.0,82,5.32,47,271,2439,8.9
14002,Johnny Boychuk,2015-16,32.0,9,6,44,44,1,5,6,75.0,898.0,246,14,38,52,499.0,48,5.31,29,160,1399,9.1
14003,Johnny Boychuk,2016-17,33.0,10,23,75,75,5,18,23,142.0,1589.0,321,19,56,75,641.0,82,5.34,48,269,2463,8.9
14004,Johnny Boychuk,2017-18,34.0,11,35,72,72,9,26,35,192.0,1561.0,393,28,82,110,833.0,82,5.32,47,251,2453,8.9
14005,Johnny Boychuk,2018-19,35.0,12,25,70,70,9,16,25,165.0,1496.0,463,37,98,135,998.0,82,5.34,48,255,2438,9.0
14006,Johnny Boychuk,2019-20,36.0,13,23,66,66,6,17,23,155.0,1368.0,529,43,115,158,1153.0,82,5.45,47,245,2478,9.0
14007,Johnny Boychuk,2020-21,37.0,14,18,58,58,6,12,18,141.0,1171.0,587,49,127,176,1294.0,82,5.86,50,250,2620,9.2
14008,Johnny Boychuk,2021-22,38.0,15,19,74,74,3,16,19,157.0,1393.0,661,52,143,195,1451.0,82,5.96,47,239,2579,9.5
14009,Johnny Boychuk,2022-23,39.0,16,11,64,64,2,9,11,96.0,1106.0,725,54,152,206,1547.0,70,5.96,42,208,2192,9.5
14010,Johnny Gaudreau,2016-17,23.0,4,1,1,1,1,0,1,1.0,15.0,1,1,0,1,1.0,82,5.34,48,269,2463,8.9
14011,Johnny Gaudreau,2017-18,24.0,5,64,80,80,24,40,64,167.0,1417.0,81,25,40,65,168.0,82,5.32,47,251,2453,8.9
14012,Johnny Gaudreau,2018-19,25.0,6,78,79,79,30,48,78,217.0,1575.0,160,55,88,143,385.0,82,5.34,48,255,2438,9.0
14013,Johnny Gaudreau,2019-20,26.0,7,61,72,72,18,43,61,182.0,1331.0,232,73,131,204,567.0,82,5.45,47,245,2478,9.0
14014,Johnny Gaudreau,2020-21,27.0,8,84,80,80,24,60,84,227.0,1554.0,312,97,191,288,794.0,82,5.86,50,250,2620,9.2
14015,Johnny Gaudreau,2021-22,28.0,9,99,82,82,36,63,99,245.0,1646.0,394,133,254,387,1039.0,82,5.96,47,239,2579,9.5
14016,Johnny Gaudreau,2022-23,29.0,10,58,70,70,18,40,58,209.0,1315.0,464,151,294,445,1248.0,70,5.96,42,208,2192,9.5
14017,Johnny Oduya,2009-10,28.0,4,11,76,76,2,9,11,55.0,1407.0,76,2,9,11,55.0,82,5.76,70,398,2426,9.7
14018,Johnny Oduya,2010-11,29.0,5,26,75,75,6,20,26,63.0,1427.0,151,8,29,37,118.0,82,5.44,62,351,2383,9.4
14019,Johnny Oduya,2011-12,30.0,6,29,82,82,7,22,29,108.0,1712.0,233,15,51,66,226.0,82,5.7,65,341,2477,9.4
14020,Johnny Oduya,2012-13,31.0,7,13,67,67,3,10,13,68.0,1424.0,300,18,61,79,294.0,82,5.53,56,304,2486,9.1
14021,Johnny Oduya,2013-14,32.0,8,17,82,82,2,15,17,90.0,1699.0,382,20,76,96,384.0,82,5.46,52,291,2492,9.0
14022,Johnny Oduya,2014-15,33.0,9,18,81,81,3,15,18,82.0,1657.0,463,23,91,114,466.0,82,5.32,47,271,2439,8.9
14023,Johnny Oduya,2015-16,34.0,10,12,48,48,3,9,12,52.0,985.0,511,26,100,126,518.0,48,5.31,29,160,1399,9.1
14024,Johnny Oduya,2016-17,35.0,11,16,77,77,3,13,16,83.0,1548.0,588,29,113,142,601.0,82,5.34,48,269,2463,8.9
14025,Johnny Oduya,2017-18,36.0,12,10,76,76,2,8,10,76.0,1542.0,664,31,121,152,677.0,82,5.32,47,251,2453,8.9
14026,Johnny Oduya,2018-19,37.0,13,21,82,82,4,17,21,63.0,1671.0,746,35,138,173,740.0,82,5.34,48,255,2438,9.0
14027,Johnny Oduya,2019-20,38.0,14,9,52,52,2,7,9,37.0,950.0,798,37,145,182,777.0,82,5.45,47,245,2478,9.0
14028,Johnny Oduya,2020-21,39.0,15,8,52,52,4,4,8,59.0,890.0,850,41,149,190,836.0,82,5.86,50,250,2620,9.2
14029,Jon DiSalvatore,2008-09,27.0,4,0,5,5,0,0,0,3.0,42.0,5,0,0,0,3.0,82,6.05,85,480,2458,10.1
14030,Jon DiSalvatore,2014-15,33.0,5,0,1,1,0,0,0,2.0,14.0,6,0,0,0,5.0,82,5.32,47,271,2439,8.9
14031,Jon Fontas,1982-83,27.0,4,0,1,1,0,0,0,0.0,,1,0,0,0,0.0,80,7.03,61,280,2352,12.0
14032,Jon Fontas,1983-84,28.0,5,0,1,1,0,0,0,0.0,,2,0,0,0,0.0,80,7.69,77,340,2441,12.6
14033,Jon Kalinski,2011-12,24.0,4,3,12,12,1,2,3,7.0,91.0,12,1,2,3,7.0,82,5.7,65,341,2477,9.4
14034,Jon Kalinski,2012-13,25.0,5,2,10,10,0,2,2,9.0,70.0,22,1,4,5,16.0,82,5.53,56,304,2486,9.1
14035,Jon Klemm,1994-95,25.0,4,1,4,4,0,1,1,2.0,,4,0,1,1,2.0,80,6.96,77,402,2440,11.4
14036,Jon Klemm,1996-97,27.0,5,0,7,7,0,0,0,11.0,,11,0,1,1,13.0,84,6.48,76,407,2545,10.7
14037,Jon Klemm,1997-98,28.0,6,1,4,4,1,0,1,5.0,,15,1,1,2,18.0,48,5.97,37,209,1408,10.2
14038,Jon Klemm,1998-99,29.0,7,15,56,56,3,12,15,61.0,,71,4,13,17,79.0,82,6.29,74,413,2481,10.4
14039,Jon Klemm,1999-00,30.0,8,24,80,80,9,15,24,103.0,,151,13,28,41,182.0,82,5.83,55,336,2444,9.8
14040,Jon Klemm,2000-01,31.0,9,14,67,67,6,8,14,60.0,,218,19,36,55,242.0,82,5.28,57,380,2242,9.6
14041,Jon Klemm,2001-02,32.0,10,3,39,39,1,2,3,28.0,535.0,257,20,38,58,270.0,82,5.27,57,359,2285,9.4
14042,Jon Klemm,2002-03,33.0,11,12,73,73,5,7,12,64.0,1267.0,330,25,45,70,334.0,82,5.49,53,331,2294,9.8
14043,Jon Klemm,2003-04,34.0,12,15,78,78,4,11,15,97.0,1554.0,408,29,56,85,431.0,82,5.51,63,376,2272,9.9
14044,Jon Klemm,2004-05,35.0,13,20,82,82,4,16,20,111.0,1955.0,490,33,72,105,542.0,82,5.24,53,338,2262,9.5
14045,Jon Klemm,2005-06,36.0,14,16,70,70,2,14,16,74.0,1537.0,560,35,86,121,616.0,82,5.31,60,363,2326,9.4
14046,Jon Klemm,2006-07,37.0,15,7,77,77,2,5,7,71.0,1333.0,637,37,91,128,687.0,82,5.14,57,348,2300,9.2
14047,Jon Klemm,2008-09,39.0,16,11,76,76,4,7,11,57.0,1287.0,713,41,98,139,744.0,82,6.05,85,480,2458,10.1
14048,Jon Klemm,2009-10,40.0,17,3,38,38,1,2,3,25.0,496.0,751,42,100,142,769.0,82,5.76,70,398,2426,9.7
14049,Jon Klemm,2010-11,41.0,18,0,22,22,0,0,0,6.0,241.0,773,42,100,142,775.0,82,5.44,62,351,2383,9.4
14050,Jon Matsumoto,2013-14,27.0,4,2,13,13,2,0,2,11.0,92.0,13,2,0,2,11.0,82,5.46,52,291,2492,9.0
14051,Jon Matsumoto,2014-15,28.0,5,0,1,1,0,0,0,0.0,5.0,14,2,0,2,11.0,82,5.32,47,271,2439,8.9
14052,Jon Morris,1991-92,25.0,4,2,4,4,0,2,2,1.0,,4,0,2,2,1.0,80,7.48,85,403,2430,12.3
14053,Jon Morris,1992-93,26.0,5,13,20,20,6,7,13,17.0,,24,6,9,15,18.0,80,7.37,76,367,2421,12.2
14054,Jon Morris,1993-94,27.0,6,28,53,53,9,19,28,44.0,,77,15,28,43,62.0,80,6.91,71,366,2385,11.6
14055,Jon Morris,1994-95,28.0,7,3,7,7,1,2,3,5.0,,84,16,30,46,67.0,80,6.96,77,402,2440,11.4
14056,Jon Morris,1995-96,29.0,8,3,15,15,0,3,3,12.0,,99,16,33,49,79.0,84,7.25,87,443,2603,11.7
14057,Jon Morris,1996-97,30.0,9,0,4,4,0,0,0,3.0,,103,16,33,49,82.0,84,6.48,76,407,2545,10.7
14058,Jon Rheault,2015-16,29.0,4,0,5,5,0,0,0,5.0,53.0,5,0,0,0,5.0,48,5.31,29,160,1399,9.1
14059,Jon Rohloff,1997-98,28.0,4,11,34,34,3,8,11,51.0,,34,3,8,11,51.0,48,5.97,37,209,1408,10.2
14060,Jon Rohloff,1998-99,29.0,5,13,79,79,1,12,13,106.0,,113,4,20,24,157.0,82,6.29,74,413,2481,10.4
14061,Jon Rohloff,1999-00,30.0,6,8,37,37,3,5,8,69.0,,150,7,25,32,226.0,82,5.83,55,336,2444,9.8
14062,Jon Sim,2001-02,24.0,4,1,7,7,1,0,1,8.0,80.0,7,1,0,1,8.0,82,5.27,57,359,2285,9.4
14063,Jon Sim,2002-03,25.0,5,8,25,25,5,3,8,44.0,271.0,32,6,3,9,52.0,82,5.49,53,331,2294,9.8
14064,Jon Sim,2003-04,26.0,6,3,15,15,0,3,3,18.0,132.0,47,6,6,12,70.0,82,5.51,63,376,2272,9.9
14065,Jon Sim,2004-05,27.0,7,3,26,26,3,0,3,43.0,247.0,73,9,6,15,113.0,82,5.24,53,338,2262,9.5
14066,Jon Sim,2005-06,28.0,8,3,22,22,1,2,3,39.0,243.0,95,10,8,18,152.0,82,5.31,60,363,2326,9.4
14067,Jon Sim,2006-07,29.0,9,18,63,63,8,10,18,100.0,686.0,158,18,18,36,252.0,82,5.14,57,348,2300,9.2
14068,Jon Sim,2008-09,31.0,10,32,72,72,17,15,32,172.0,840.0,230,35,33,68,424.0,82,6.05,85,480,2458,10.1
14069,Jon Sim,2009-10,32.0,11,29,77,77,17,12,29,141.0,904.0,307,52,45,97,565.0,82,5.76,70,398,2426,9.7
14070,Jon Sim,2010-11,33.0,12,1,2,2,0,1,1,8.0,29.0,309,52,46,98,573.0,82,5.44,62,351,2383,9.4
14071,Jon Sim,2011-12,34.0,13,15,49,49,9,6,15,90.0,596.0,358,61,52,113,663.0,82,5.7,65,341,2477,9.4
14072,Jon Sim,2012-13,35.0,14,22,77,77,13,9,22,128.0,897.0,435,74,61,135,791.0,82,5.53,56,304,2486,9.1
14073,Jon Sim,2013-14,36.0,15,4,34,34,1,3,4,38.0,388.0,469,75,64,139,829.0,82,5.46,52,291,2492,9.0
14074,Jonas Andersson,2004-05,23.0,4,0,5,5,0,0,0,4.0,46.0,5,0,0,0,4.0,82,5.24,53,338,2262,9.5
14075,Jonas Andersson,2013-14,32.0,5,0,4,4,0,0,0,1.0,24.0,9,0,0,0,5.0,82,5.46,52,291,2492,9.0
14076,Jonas Bergqvist,1992-93,30.0,4,7,22,22,2,5,7,30.0,,22,2,5,7,30.0,80,7.37,76,367,2421,12.2
14077,Jonas Brodin,2015-16,22.0,4,11,45,45,2,9,11,51.0,1045.0,45,2,9,11,51.0,48,5.31,29,160,1399,9.1
14078,Jonas Brodin,2016-17,23.0,5,19,79,79,8,11,19,74.0,1888.0,124,10,20,30,125.0,82,5.34,48,269,2463,8.9
14079,Jonas Brodin,2017-18,24.0,6,17,71,71,3,14,17,95.0,1716.0,195,13,34,47,220.0,82,5.32,47,251,2453,8.9
14080,Jonas Brodin,2018-19,25.0,7,7,68,68,2,5,7,58.0,1389.0,263,15,39,54,278.0,82,5.34,48,255,2438,9.0
14081,Jonas Brodin,2019-20,26.0,8,25,68,68,3,22,25,85.0,1331.0,331,18,61,79,363.0,82,5.45,47,245,2478,9.0
14082,Jonas Brodin,2020-21,27.0,9,21,73,73,6,15,21,77.0,1577.0,404,24,76,100,440.0,82,5.86,50,250,2620,9.2
14083,Jonas Brodin,2021-22,28.0,10,18,82,82,4,14,18,111.0,1685.0,486,28,90,118,551.0,82,5.96,47,239,2579,9.5
14084,Jonas Brodin,2022-23,29.0,11,28,69,69,2,26,28,103.0,1487.0,555,30,116,146,654.0,70,5.96,42,208,2192,9.5
14085,Jonas Frogren,2011-12,31.0,4,7,41,41,1,6,7,12.0,551.0,41,1,6,7,12.0,82,5.7,65,341,2477,9.4
14086,Jonas Hoglund,1999-00,27.0,4,35,68,68,19,16,35,189.0,,68,19,16,35,189.0,82,5.83,55,336,2444,9.8
14087,Jonas Hoglund,2000-01,28.0,5,25,78,78,12,13,25,186.0,,146,31,29,60,375.0,82,5.28,57,380,2242,9.6
14088,Jonas Hoglund,2001-02,29.0,6,18,74,74,8,10,18,122.0,876.0,220,39,39,78,497.0,82,5.27,57,359,2285,9.4
14089,Jonas Hoglund,2002-03,30.0,7,56,82,82,29,27,56,215.0,1407.0,302,68,66,134,712.0,82,5.49,53,331,2294,9.8
14090,Jonas Hoglund,2003-04,31.0,8,49,82,82,23,26,49,196.0,1241.0,384,91,92,183,908.0,82,5.51,63,376,2272,9.9
14091,Jonas Hoglund,2004-05,32.0,9,47,82,82,13,34,47,199.0,1277.0,466,104,126,230,1107.0,82,5.24,53,338,2262,9.5
14092,Jonas Hoglund,2005-06,33.0,10,32,79,79,13,19,32,157.0,1010.0,545,117,145,262,1264.0,82,5.31,60,363,2326,9.4
14093,Jonas Holos,2013-14,26.0,4,6,39,39,0,6,6,36.0,704.0,39,0,6,6,36.0,82,5.46,52,291,2492,9.0
14094,Jonas Johansson,2008-09,24.0,4,0,1,1,0,0,0,0.0,4.0,1,0,0,0,0.0,82,6.05,85,480,2458,10.1
14095,Jonas Junland,2011-12,24.0,4,0,1,1,0,0,0,0.0,12.0,1,0,0,0,0.0,82,5.7,65,341,2477,9.4
14096,Jonas Junland,2012-13,25.0,5,2,3,3,0,2,2,7.0,52.0,4,0,2,2,7.0,82,5.53,56,304,2486,9.1
14097,Jonas Nordqvist,2009-10,27.0,4,2,3,3,0,2,2,2.0,42.0,3,0,2,2,2.0,82,5.76,70,398,2426,9.7
14098,Jonas Ronnqvist,2003-04,30.0,4,4,38,38,0,4,4,30.0,404.0,38,0,4,4,30.0,82,5.51,63,376,2272,9.9
14099,Jonas Siegenthaler,2021-22,24.0,4,4,26,26,0,4,4,12.0,368.0,26,0,4,4,12.0,82,5.96,47,239,2579,9.5
14100,Jonas Siegenthaler,2022-23,25.0,5,9,64,64,2,7,9,49.0,1007.0,90,2,11,13,61.0,70,5.96,42,208,2192,9.5
14101,Jonathan Cheechoo,2005-06,25.0,4,16,66,66,9,7,16,94.0,707.0,66,9,7,16,94.0,82,5.31,60,363,2326,9.4
14102,Jonathan Cheechoo,2006-07,26.0,5,47,81,81,28,19,47,175.0,1312.0,147,37,26,63,269.0,82,5.14,57,348,2300,9.2
14103,Jonathan Cheechoo,2008-09,28.0,6,93,82,82,56,37,93,317.0,1637.0,229,93,63,156,586.0,82,6.05,85,480,2458,10.1
14104,Jonathan Cheechoo,2009-10,29.0,7,69,76,76,37,32,69,250.0,1334.0,305,130,95,225,836.0,82,5.76,70,398,2426,9.7
14105,Jonathan Cheechoo,2010-11,30.0,8,37,69,69,23,14,37,220.0,1145.0,374,153,109,262,1056.0,82,5.44,62,351,2383,9.4
14106,Jonathan Cheechoo,2011-12,31.0,9,29,66,66,12,17,29,152.0,1011.0,440,165,126,291,1208.0,82,5.7,65,341,2477,9.4
14107,Jonathan Cheechoo,2012-13,32.0,10,14,61,61,5,9,14,117.0,729.0,501,170,135,305,1325.0,82,5.53,56,304,2486,9.1
14108,Jonathan Davidsson,2022-23,25.0,4,1,6,6,0,1,1,3.0,33.0,6,0,1,1,3.0,70,5.96,42,208,2192,9.5
14109,Jonathan Delisle,2001-02,24.0,4,0,1,1,0,0,0,0.0,5.0,1,0,0,0,0.0,82,5.27,57,359,2285,9.4
14110,Jonathan Drouin,2017-18,22.0,4,32,70,70,4,28,32,76.0,927.0,70,4,28,32,76.0,82,5.32,47,251,2453,8.9
14111,Jonathan Drouin,2018-19,23.0,5,10,21,21,4,6,10,25.0,303.0,91,8,34,42,101.0,82,5.34,48,255,2438,9.0
14112,Jonathan Drouin,2019-20,24.0,6,53,73,73,21,32,53,183.0,1293.0,164,29,66,95,284.0,82,5.45,47,245,2478,9.0
14113,Jonathan Drouin,2020-21,25.0,7,46,77,77,13,33,46,164.0,1355.0,241,42,99,141,448.0,82,5.86,50,250,2620,9.2
14114,Jonathan Drouin,2021-22,26.0,8,53,81,81,18,35,53,190.0,1371.0,322,60,134,194,638.0,82,5.96,47,239,2579,9.5
14115,Jonathan Drouin,2022-23,27.0,9,15,27,27,7,8,15,51.0,424.0,349,67,142,209,689.0,70,5.96,42,208,2192,9.5
14116,Jonathan Ericsson,2010-11,26.0,4,1,8,8,1,0,1,19.0,128.0,8,1,0,1,19.0,82,5.44,62,351,2383,9.4
14117,Jonathan Ericsson,2011-12,27.0,5,4,19,19,1,3,4,25.0,336.0,27,2,3,5,44.0,82,5.7,65,341,2477,9.4
14118,Jonathan Ericsson,2012-13,28.0,6,13,62,62,4,9,13,55.0,1036.0,89,6,12,18,99.0,82,5.53,56,304,2486,9.1
14119,Jonathan Ericsson,2013-14,29.0,7,15,74,74,3,12,15,89.0,1394.0,163,9,24,33,188.0,82,5.46,52,291,2492,9.0
14120,Jonathan Ericsson,2014-15,30.0,8,11,69,69,1,10,11,63.0,1179.0,232,10,34,44,251.0,82,5.32,47,271,2439,8.9
14121,Jonathan Ericsson,2015-16,31.0,9,13,45,45,3,10,13,34.0,960.0,277,13,44,57,285.0,48,5.31,29,160,1399,9.1
14122,Jonathan Ericsson,2016-17,32.0,10,11,48,48,1,10,11,66.0,1020.0,325,14,54,68,351.0,82,5.34,48,269,2463,8.9
14123,Jonathan Ericsson,2017-18,33.0,11,15,82,82,3,12,15,82.0,1606.0,407,17,66,83,433.0,82,5.32,47,251,2453,8.9
14124,Jonathan Ericsson,2018-19,34.0,12,15,71,71,3,12,15,68.0,1316.0,478,20,78,98,501.0,82,5.34,48,255,2438,9.0
14125,Jonathan Ericsson,2019-20,35.0,13,9,51,51,1,8,9,43.0,980.0,529,21,86,107,544.0,82,5.45,47,245,2478,9.0
14126,Jonathan Ericsson,2020-21,36.0,14,13,81,81,3,10,13,86.0,1564.0,610,24,96,120,630.0,82,5.86,50,250,2620,9.2
14127,Jonathan Ericsson,2021-22,37.0,15,5,52,52,3,2,5,48.0,895.0,662,27,98,125,678.0,82,5.96,47,239,2579,9.5
14128,Jonathan Ericsson,2022-23,38.0,16,0,18,18,0,0,0,16.0,256.0,680,27,98,125,694.0,70,5.96,42,208,2192,9.5
14129,Jonathan Ferland,2008-09,25.0,4,1,7,7,1,0,1,9.0,46.0,7,1,0,1,9.0,82,6.05,85,480,2458,10.1
14130,Jonathan Filewich,2010-11,26.0,4,0,5,5,0,0,0,3.0,43.0,5,0,0,0,3.0,82,5.44,62,351,2383,9.4
14131,Jonathan Girard,2001-02,21.0,4,0,3,3,0,0,0,3.0,28.0,3,0,0,0,3.0,82,5.27,57,359,2285,9.4
14132,Jonathan Girard,2002-03,22.0,5,3,23,23,1,2,3,17.0,219.0,26,1,2,3,20.0,82,5.49,53,331,2294,9.8
14133,Jonathan Girard,2003-04,23.0,6,16,31,31,3,13,16,42.0,513.0,57,4,15,19,62.0,82,5.51,63,376,2272,9.9
14134,Jonathan Girard,2004-05,24.0,7,3,20,20,0,3,3,28.0,294.0,77,4,18,22,90.0,82,5.24,53,338,2262,9.5
14135,Jonathan Girard,2005-06,25.0,8,22,73,73,6,16,22,123.0,1521.0,150,10,34,44,213.0,82,5.31,60,363,2326,9.4
14136,Jonathan Hedstrom,2005-06,28.0,4,0,4,4,0,0,0,3.0,31.0,4,0,0,0,3.0,82,5.31,60,363,2326,9.4
14137,Jonathan Hedstrom,2008-09,31.0,5,27,79,79,13,14,27,99.0,1286.0,83,13,14,27,102.0,82,6.05,85,480,2458,10.1
14138,Jonathan Huberdeau,2015-16,22.0,4,31,48,48,14,17,31,112.0,813.0,48,14,17,31,112.0,48,5.31,29,160,1399,9.1
14139,Jonathan Huberdeau,2016-17,23.0,5,28,69,69,9,19,28,108.0,1081.0,117,23,36,59,220.0,82,5.34,48,269,2463,8.9
14140,Jonathan Huberdeau,2017-18,24.0,6,54,79,79,15,39,54,169.0,1323.0,196,38,75,113,389.0,82,5.32,47,251,2453,8.9
14141,Jonathan Huberdeau,2018-19,25.0,7,59,76,76,20,39,59,174.0,1379.0,272,58,114,172,563.0,82,5.34,48,255,2438,9.0
14142,Jonathan Huberdeau,2019-20,26.0,8,26,31,31,10,16,26,86.0,556.0,303,68,130,198,649.0,82,5.45,47,245,2478,9.0
14143,Jonathan Huberdeau,2020-21,27.0,9,69,82,82,27,42,69,204.0,1575.0,385,95,172,267,853.0,82,5.86,50,250,2620,9.2
14144,Jonathan Huberdeau,2021-22,28.0,10,92,82,82,30,62,92,226.0,1546.0,467,125,234,359,1079.0,82,5.96,47,239,2579,9.5
14145,Jonathan Huberdeau,2022-23,29.0,11,78,69,69,23,55,78,152.0,1295.0,536,148,289,437,1231.0,70,5.96,42,208,2192,9.5
14146,Jonathan Marchessault,2015-16,25.0,4,0,2,2,0,0,0,0.0,22.0,2,0,0,0,0.0,48,5.31,29,160,1399,9.1
14147,Jonathan Marchessault,2017-18,27.0,5,1,2,2,1,0,1,3.0,24.0,4,1,0,1,3.0,82,5.32,47,251,2453,8.9
14148,Jonathan Marchessault,2018-19,28.0,6,18,45,45,7,11,18,81.0,544.0,49,8,11,19,84.0,82,5.34,48,255,2438,9.0
14149,Jonathan Marchessault,2019-20,29.0,7,51,75,75,30,21,51,193.0,1268.0,124,38,32,70,277.0,82,5.45,47,245,2478,9.0
14150,Jonathan Marchessault,2020-21,30.0,8,75,77,77,27,48,75,268.0,1348.0,201,65,80,145,545.0,82,5.86,50,250,2620,9.2
14151,Jonathan Marchessault,2021-22,31.0,9,59,82,82,25,34,59,278.0,1488.0,283,90,114,204,823.0,82,5.96,47,239,2579,9.5
14152,Jonathan Marchessault,2022-23,32.0,10,47,66,66,22,25,47,235.0,1141.0,349,112,139,251,1058.0,70,5.96,42,208,2192,9.5
14153,Jonathan Racine,2016-17,23.0,4,0,1,1,0,0,0,0.0,16.0,1,0,0,0,0.0,82,5.34,48,269,2463,8.9
14154,Jonathan Sigalet,2009-10,23.0,4,0,1,1,0,0,0,1.0,15.0,1,0,0,0,1.0,82,5.76,70,398,2426,9.7
14155,Jonathan Toews,2010-11,22.0,4,54,64,64,24,30,54,144.0,1195.0,64,24,30,54,144.0,82,5.44,62,351,2383,9.4
14156,Jonathan Toews,2011-12,23.0,5,69,82,82,34,35,69,195.0,1527.0,146,58,65,123,339.0,82,5.7,65,341,2477,9.4
14157,Jonathan Toews,2012-13,24.0,6,68,76,76,25,43,68,202.0,1520.0,222,83,108,191,541.0,82,5.53,56,304,2486,9.1
14158,Jonathan Toews,2013-14,25.0,7,76,80,80,32,44,76,233.0,1661.0,302,115,152,267,774.0,82,5.46,52,291,2492,9.0
14159,Jonathan Toews,2014-15,26.0,8,57,59,59,29,28,57,185.0,1230.0,361,144,180,324,959.0,82,5.32,47,271,2439,8.9
14160,Jonathan Toews,2015-16,27.0,9,48,47,47,23,25,48,143.0,909.0,408,167,205,372,1102.0,48,5.31,29,160,1399,9.1
14161,Jonathan Toews,2016-17,28.0,10,68,76,76,28,40,68,193.0,1555.0,484,195,245,440,1295.0,82,5.34,48,269,2463,8.9
14162,Jonathan Toews,2017-18,29.0,11,66,81,81,28,38,66,192.0,1585.0,565,223,283,506,1487.0,82,5.32,47,251,2453,8.9
14163,Jonathan Toews,2018-19,30.0,12,58,80,80,28,30,58,179.0,1540.0,645,251,313,564,1666.0,82,5.34,48,255,2438,9.0
14164,Jonathan Toews,2019-20,31.0,13,58,72,72,21,37,58,199.0,1451.0,717,272,350,622,1865.0,82,5.45,47,245,2478,9.0
14165,Jonathan Toews,2020-21,32.0,14,52,74,74,20,32,52,211.0,1457.0,791,292,382,674,2076.0,82,5.86,50,250,2620,9.2
14166,Jonathan Toews,2021-22,33.0,15,81,82,82,35,46,81,235.0,1723.0,873,327,428,755,2311.0,82,5.96,47,239,2579,9.5
14167,Jonathan Toews,2022-23,34.0,16,60,70,70,18,42,60,172.0,1384.0,943,345,470,815,2483.0,70,5.96,42,208,2192,9.5
14168,Jonathon Blum,2013-14,25.0,4,8,23,23,3,5,8,18.0,408.0,23,3,5,8,18.0,82,5.46,52,291,2492,9.0
14169,Jonathon Blum,2014-15,26.0,5,7,33,33,3,4,7,25.0,592.0,56,6,9,15,43.0,82,5.32,47,271,2439,8.9
14170,Jonathon Blum,2015-16,27.0,6,7,35,35,1,6,7,26.0,500.0,91,7,15,22,69.0,48,5.31,29,160,1399,9.1
14171,Jonathon Blum,2016-17,28.0,7,1,15,15,0,1,1,11.0,175.0,106,7,16,23,80.0,82,5.34,48,269,2463,8.9
14172,Jonathon Blum,2017-18,29.0,8,1,4,4,0,1,1,3.0,39.0,110,7,17,24,83.0,82,5.32,47,251,2453,8.9
14173,Jonathon Merrill,2016-17,24.0,4,11,52,52,2,9,11,45.0,1000.0,52,2,9,11,45.0,82,5.34,48,269,2463,8.9
14174,Jonathon Merrill,2017-18,25.0,5,14,66,66,2,12,14,47.0,1357.0,118,4,21,25,92.0,82,5.32,47,251,2453,8.9
14175,Jonathon Merrill,2018-19,26.0,6,5,47,47,1,4,5,30.0,794.0,165,5,25,30,122.0,82,5.34,48,255,2438,9.0
14176,Jonathon Merrill,2019-20,27.0,7,6,51,51,1,5,6,48.0,947.0,216,6,30,36,170.0,82,5.45,47,245,2478,9.0
14177,Jonathon Merrill,2020-21,28.0,8,3,34,34,1,2,3,30.0,547.0,250,7,32,39,200.0,82,5.86,50,250,2620,9.2
14178,Jonathon Merrill,2021-22,29.0,9,15,57,57,3,12,15,72.0,1019.0,307,10,44,54,272.0,82,5.96,47,239,2579,9.5
14179,Jonathon Merrill,2022-23,30.0,10,7,49,49,2,5,7,37.0,890.0,356,12,49,61,309.0,70,5.96,42,208,2192,9.5
14180,Joni Pitkanen,2006-07,23.0,4,27,71,71,8,19,27,133.0,1177.0,71,8,19,27,133.0,82,5.14,57,348,2300,9.2
14181,Joni Pitkanen,2008-09,25.0,5,46,58,58,13,33,46,118.0,1375.0,129,21,52,73,251.0,82,6.05,85,480,2458,10.1
14182,Joni Pitkanen,2009-10,26.0,6,43,77,77,4,39,43,137.0,1890.0,206,25,91,116,388.0,82,5.76,70,398,2426,9.7
14183,Joni Pitkanen,2010-11,27.0,7,26,63,63,8,18,26,101.0,1520.0,269,33,109,142,489.0,82,5.44,62,351,2383,9.4
14184,Joni Pitkanen,2011-12,28.0,8,33,71,71,7,26,33,147.0,1761.0,340,40,135,175,636.0,82,5.7,65,341,2477,9.4
14185,Joni Pitkanen,2012-13,29.0,9,46,71,71,6,40,46,161.0,1944.0,411,46,175,221,797.0,82,5.53,56,304,2486,9.1
14186,Joni Pitkanen,2013-14,30.0,10,35,72,72,5,30,35,144.0,1802.0,483,51,205,256,941.0,82,5.46,52,291,2492,9.0
14187,Joni Pitkanen,2014-15,31.0,11,17,30,30,5,12,17,62.0,669.0,513,56,217,273,1003.0,82,5.32,47,271,2439,8.9
14188,Joni Pitkanen,2015-16,32.0,12,9,22,22,1,8,9,34.0,502.0,535,57,225,282,1037.0,48,5.31,29,160,1399,9.1
14189,Jonny Brodzinski,2019-20,26.0,4,2,6,6,0,2,2,17.0,74.0,6,0,2,2,17.0,82,5.45,47,245,2478,9.0
14190,Jonny Brodzinski,2020-21,27.0,5,6,35,35,4,2,6,53.0,333.0,41,4,4,8,70.0,82,5.86,50,250,2620,9.2
14191,Jonny Brodzinski,2021-22,28.0,6,3,13,13,2,1,3,17.0,129.0,54,6,5,11,87.0,82,5.96,47,239,2579,9.5
14192,Jonny Brodzinski,2022-23,29.0,7,1,3,3,0,1,1,5.0,22.0,57,6,6,12,92.0,70,5.96,42,208,2192,9.5
14193,Joona Luoto,2022-23,25.0,4,0,16,16,0,0,0,9.0,105.0,16,0,0,0,9.0,70,5.96,42,208,2192,9.5
14194,Joonas Donskoi,2018-19,26.0,4,36,76,76,11,25,36,107.0,1076.0,76,11,25,36,107.0,82,5.34,48,255,2438,9.0
14195,Joonas Donskoi,2019-20,27.0,5,17,61,61,6,11,17,95.0,842.0,137,17,36,53,202.0,82,5.45,47,245,2478,9.0
14196,Joonas Donskoi,2020-21,28.0,6,32,66,66,14,18,32,129.0,988.0,203,31,54,85,331.0,82,5.86,50,250,2620,9.2
14197,Joonas Donskoi,2021-22,29.0,7,37,80,80,14,23,37,115.0,1074.0,283,45,77,122,446.0,82,5.96,47,239,2579,9.5
14198,Joonas Donskoi,2022-23,30.0,8,33,65,65,16,17,33,111.0,1056.0,348,61,94,155,557.0,70,5.96,42,208,2192,9.5
14199,Joonas Kemppainen,2018-19,30.0,4,5,44,44,2,3,5,35.0,552.0,44,2,3,5,35.0,82,5.34,48,255,2438,9.0
14200,Joonas Nattinen,2016-17,26.0,4,0,1,1,0,0,0,0.0,2.0,1,0,0,0,0.0,82,5.34,48,269,2463,8.9
14201,Joonas Rask,2015-16,25.0,4,1,2,2,0,1,1,0.0,16.0,2,0,1,1,0.0,48,5.31,29,160,1399,9.1
14202,Jordan Caron,2013-14,23.0,4,7,23,23,3,4,7,27.0,291.0,23,3,4,7,27.0,82,5.46,52,291,2492,9.0
14203,Jordan Caron,2014-15,24.0,5,15,48,48,7,8,15,57.0,553.0,71,10,12,22,84.0,82,5.32,47,271,2439,8.9
14204,Jordan Caron,2015-16,25.0,6,3,17,17,1,2,3,20.0,160.0,88,11,14,25,104.0,48,5.31,29,160,1399,9.1
14205,Jordan Caron,2016-17,26.0,7,3,35,35,1,2,3,52.0,382.0,123,12,16,28,156.0,82,5.34,48,269,2463,8.9
14206,Jordan Caron,2017-18,27.0,8,0,30,30,0,0,0,12.0,241.0,153,12,16,28,168.0,82,5.32,47,251,2453,8.9
14207,Jordan Caron,2018-19,28.0,9,0,4,4,0,0,0,1.0,33.0,157,12,16,28,169.0,82,5.34,48,255,2438,9.0
14208,Jordan Eberle,2013-14,23.0,4,43,69,69,18,25,43,158.0,1220.0,69,18,25,43,158.0,82,5.46,52,291,2492,9.0
14209,Jordan Eberle,2014-15,24.0,5,76,78,78,34,42,76,180.0,1373.0,147,52,67,119,338.0,82,5.32,47,271,2439,8.9
14210,Jordan Eberle,2015-16,25.0,6,37,48,48,16,21,37,133.0,912.0,195,68,88,156,471.0,48,5.31,29,160,1399,9.1
14211,Jordan Eberle,2016-17,26.0,7,65,80,80,28,37,65,200.0,1564.0,275,96,125,221,671.0,82,5.34,48,269,2463,8.9
14212,Jordan Eberle,2017-18,27.0,8,63,81,81,24,39,63,183.0,1542.0,356,120,164,284,854.0,82,5.32,47,251,2453,8.9
14213,Jordan Eberle,2018-19,28.0,9,47,69,69,25,22,47,173.0,1232.0,425,145,186,331,1027.0,82,5.34,48,255,2438,9.0
14214,Jordan Eberle,2019-20,29.0,10,51,82,82,20,31,51,208.0,1375.0,507,165,217,382,1235.0,82,5.45,47,245,2478,9.0
14215,Jordan Eberle,2020-21,30.0,11,59,81,81,25,34,59,183.0,1302.0,588,190,251,441,1418.0,82,5.86,50,250,2620,9.2
14216,Jordan Eberle,2021-22,31.0,12,37,78,78,19,18,37,160.0,1289.0,666,209,269,478,1578.0,82,5.96,47,239,2579,9.5
14217,Jordan Eberle,2022-23,32.0,13,40,58,58,16,24,40,136.0,1033.0,724,225,293,518,1714.0,70,5.96,42,208,2192,9.5
14218,Jordan Greenway,2020-21,23.0,4,1,6,6,0,1,1,4.0,69.0,6,0,1,1,4.0,82,5.86,50,250,2620,9.2
14219,Jordan Greenway,2021-22,24.0,5,24,81,81,12,12,24,109.0,1104.0,87,12,13,25,113.0,82,5.96,47,239,2579,9.5
14220,Jordan Greenway,2022-23,25.0,6,28,67,67,8,20,28,93.0,949.0,154,20,33,53,206.0,70,5.96,42,208,2192,9.5
14221,Jordan Gross,2022-23,27.0,4,1,2,2,0,1,1,3.0,32.0,2,0,1,1,3.0,70,5.96,42,208,2192,9.5
14222,Jordan Hendry,2010-11,26.0,4,4,40,40,1,3,4,32.0,689.0,40,1,3,4,32.0,82,5.44,62,351,2383,9.4
14223,Jordan Hendry,2011-12,27.0,5,0,9,9,0,0,0,1.0,91.0,49,1,3,4,33.0,82,5.7,65,341,2477,9.4
14224,Jordan Hendry,2012-13,28.0,6,8,43,43,2,6,8,42.0,510.0,92,3,9,12,75.0,82,5.53,56,304,2486,9.1
14225,Jordan Hendry,2013-14,29.0,7,1,37,37,1,0,1,35.0,396.0,129,4,9,13,110.0,82,5.46,52,291,2492,9.0
14226,Jordan Hendry,2015-16,31.0,8,0,2,2,0,0,0,0.0,35.0,131,4,9,13,110.0,48,5.31,29,160,1399,9.1
14227,Jordan Krestanovich,2004-05,23.0,4,2,8,8,0,2,2,6.0,69.0,8,0,2,2,6.0,82,5.24,53,338,2262,9.5
14228,Jordan Krestanovich,2006-07,25.0,5,0,14,14,0,0,0,25.0,142.0,22,0,2,2,31.0,82,5.14,57,348,2300,9.2
14229,Jordan Kyrou,2021-22,23.0,4,3,16,16,1,2,3,16.0,155.0,16,1,2,3,16.0,82,5.96,47,239,2579,9.5
14230,Jordan Kyrou,2022-23,24.0,5,9,28,28,4,5,9,39.0,305.0,44,5,7,12,55.0,70,5.96,42,208,2192,9.5
14231,Jordan Leopold,2005-06,25.0,4,14,58,58,4,10,14,78.0,1195.0,58,4,10,14,78.0,82,5.31,60,363,2326,9.4
14232,Jordan Leopold,2006-07,26.0,5,33,82,82,9,24,33,138.0,1822.0,140,13,34,47,216.0,82,5.14,57,348,2300,9.2
14233,Jordan Leopold,2008-09,28.0,6,20,74,74,2,18,20,87.0,1652.0,214,15,52,67,303.0,82,6.05,85,480,2458,10.1
14234,Jordan Leopold,2009-10,29.0,7,5,15,15,2,3,5,19.0,297.0,229,17,55,72,322.0,82,5.76,70,398,2426,9.7
14235,Jordan Leopold,2010-11,30.0,8,13,43,43,5,8,13,35.0,687.0,272,22,63,85,357.0,82,5.44,62,351,2383,9.4
14236,Jordan Leopold,2011-12,31.0,9,24,83,83,7,17,24,107.0,1561.0,355,29,80,109,464.0,82,5.7,65,341,2477,9.4
14237,Jordan Leopold,2012-13,32.0,10,26,81,81,11,15,26,95.0,1777.0,436,40,95,135,559.0,82,5.53,56,304,2486,9.1
14238,Jordan Leopold,2013-14,33.0,11,35,71,71,13,22,35,134.0,1656.0,507,53,117,170,693.0,82,5.46,52,291,2492,9.0
14239,Jordan Leopold,2014-15,34.0,12,24,79,79,10,14,24,110.0,1767.0,586,63,131,194,803.0,82,5.32,47,271,2439,8.9
14240,Jordan Leopold,2015-16,35.0,13,10,39,39,2,8,10,60.0,783.0,625,65,139,204,863.0,48,5.31,29,160,1399,9.1
14241,Jordan Leopold,2016-17,36.0,14,6,27,27,1,5,6,40.0,421.0,652,66,144,210,903.0,82,5.34,48,269,2463,8.9
14242,Jordan Leopold,2017-18,37.0,15,4,43,43,1,3,4,39.0,642.0,695,67,147,214,942.0,82,5.32,47,251,2453,8.9
14243,Jordan Martinook,2017-18,25.0,4,1,8,8,0,1,1,8.0,94.0,8,0,1,1,8.0,82,5.32,47,251,2453,8.9
14244,Jordan Martinook,2018-19,26.0,5,24,81,81,9,15,24,109.0,1230.0,89,9,16,25,117.0,82,5.34,48,255,2438,9.0
14245,Jordan Martinook,2019-20,27.0,6,25,77,77,11,14,25,109.0,1207.0,166,20,30,50,226.0,82,5.45,47,245,2478,9.0
14246,Jordan Martinook,2020-21,28.0,7,15,81,81,6,9,15,112.0,1135.0,247,26,39,65,338.0,82,5.86,50,250,2620,9.2
14247,Jordan Martinook,2021-22,29.0,8,25,82,82,15,10,25,146.0,1188.0,329,41,49,90,484.0,82,5.96,47,239,2579,9.5
14248,Jordan Martinook,2022-23,30.0,9,13,45,45,2,11,13,44.0,507.0,374,43,60,103,528.0,70,5.96,42,208,2192,9.5
14249,Jordan Nolan,2014-15,25.0,4,4,26,26,2,2,4,19.0,243.0,26,2,2,4,19.0,82,5.32,47,271,2439,8.9
14250,Jordan Nolan,2015-16,26.0,5,6,44,44,2,4,6,23.0,373.0,70,4,6,10,42.0,48,5.31,29,160,1399,9.1
14251,Jordan Nolan,2016-17,27.0,6,10,64,64,6,4,10,58.0,576.0,134,10,10,20,100.0,82,5.34,48,269,2463,8.9
14252,Jordan Nolan,2017-18,28.0,7,9,60,60,6,3,9,44.0,598.0,194,16,13,29,144.0,82,5.32,47,251,2453,8.9
14253,Jordan Nolan,2018-19,29.0,8,5,52,52,0,5,5,49.0,463.0,246,16,18,34,193.0,82,5.34,48,255,2438,9.0
14254,Jordan Nolan,2019-20,30.0,9,8,46,46,4,4,8,39.0,499.0,292,20,22,42,232.0,82,5.45,47,245,2478,9.0
14255,Jordan Nolan,2020-21,31.0,10,8,69,69,4,4,8,50.0,676.0,361,24,26,50,282.0,82,5.86,50,250,2620,9.2
14256,Jordan Nolan,2021-22,32.0,11,2,14,14,0,2,2,17.0,111.0,375,24,28,52,299.0,82,5.96,47,239,2579,9.5
14257,Jordan Oesterle,2017-18,25.0,4,1,6,6,0,1,1,7.0,88.0,6,0,1,1,7.0,82,5.32,47,251,2453,8.9
14258,Jordan Oesterle,2018-19,26.0,5,5,17,17,0,5,5,24.0,369.0,23,0,6,6,31.0,82,5.34,48,255,2438,9.0
14259,Jordan Oesterle,2019-20,27.0,6,0,2,2,0,0,0,2.0,35.0,25,0,6,6,33.0,82,5.45,47,245,2478,9.0
14260,Jordan Oesterle,2020-21,28.0,7,15,55,55,5,10,15,99.0,1128.0,80,5,16,21,132.0,82,5.86,50,250,2620,9.2
14261,Jordan Oesterle,2021-22,29.0,8,20,71,71,6,14,20,77.0,1342.0,151,11,30,41,209.0,82,5.96,47,239,2579,9.5
14262,Jordan Oesterle,2022-23,30.0,9,13,58,58,3,10,13,69.0,987.0,209,14,40,54,278.0,70,5.96,42,208,2192,9.5
14263,Jordan Schmaltz,2019-20,26.0,4,2,9,9,0,2,2,5.0,129.0,9,0,2,2,5.0,82,5.45,47,245,2478,9.0
14264,Jordan Schmaltz,2020-21,27.0,5,1,13,13,0,1,1,5.0,143.0,22,0,3,3,10.0,82,5.86,50,250,2620,9.2
14265,Jordan Schmaltz,2021-22,28.0,6,2,20,20,0,2,2,11.0,230.0,42,0,5,5,21.0,82,5.96,47,239,2579,9.5
14266,Jordan Schroeder,2015-16,25.0,4,9,31,31,3,6,9,28.0,425.0,31,3,6,9,28.0,48,5.31,29,160,1399,9.1
14267,Jordan Schroeder,2016-17,26.0,5,6,25,25,3,3,6,25.0,300.0,56,6,9,15,53.0,82,5.34,48,269,2463,8.9
14268,Jordan Schroeder,2017-18,27.0,6,8,25,25,3,5,8,48.0,271.0,81,9,14,23,101.0,82,5.32,47,251,2453,8.9
14269,Jordan Schroeder,2018-19,28.0,7,4,26,26,2,2,4,30.0,245.0,107,11,16,27,131.0,82,5.34,48,255,2438,9.0
14270,Jordan Schroeder,2019-20,29.0,8,13,37,37,6,7,13,37.0,362.0,144,17,23,40,168.0,82,5.45,47,245,2478,9.0
14271,Jordan Schroeder,2020-21,30.0,9,2,21,21,1,1,2,20.0,157.0,165,18,24,42,188.0,82,5.86,50,250,2620,9.2
14272,Jordan Smotherman,2010-11,24.0,4,2,2,2,1,1,2,1.0,23.0,2,1,1,2,1.0,82,5.44,62,351,2383,9.4
14273,Jordan Smotherman,2011-12,25.0,5,0,2,2,0,0,0,1.0,13.0,4,1,1,2,2.0,82,5.7,65,341,2477,9.4
14274,Jordan Staal,2009-10,21.0,4,42,81,81,29,13,42,131.0,1210.0,81,29,13,42,131.0,82,5.76,70,398,2426,9.7
14275,Jordan Staal,2010-11,22.0,5,28,82,82,12,16,28,183.0,1498.0,163,41,29,70,314.0,82,5.44,62,351,2383,9.4
14276,Jordan Staal,2011-12,23.0,6,49,82,82,22,27,49,166.0,1627.0,245,63,56,119,480.0,82,5.7,65,341,2477,9.4
14277,Jordan Staal,2012-13,24.0,7,49,82,82,21,28,49,195.0,1590.0,327,84,84,168,675.0,82,5.53,56,304,2486,9.1
14278,Jordan Staal,2013-14,25.0,8,30,42,42,11,19,30,91.0,897.0,369,95,103,198,766.0,82,5.46,52,291,2492,9.0
14279,Jordan Staal,2014-15,26.0,9,50,62,62,25,25,50,149.0,1243.0,431,120,128,248,915.0,82,5.32,47,271,2439,8.9
14280,Jordan Staal,2015-16,27.0,10,31,48,48,10,21,31,114.0,965.0,479,130,149,279,1029.0,48,5.31,29,160,1399,9.1
14281,Jordan Staal,2016-17,28.0,11,40,82,82,15,25,40,165.0,1554.0,561,145,174,319,1194.0,82,5.34,48,269,2463,8.9
14282,Jordan Staal,2017-18,29.0,12,24,46,46,6,18,24,92.0,853.0,607,151,192,343,1286.0,82,5.32,47,251,2453,8.9
14283,Jordan Staal,2018-19,30.0,13,48,82,82,20,28,48,151.0,1501.0,689,171,220,391,1437.0,82,5.34,48,255,2438,9.0
14284,Jordan Staal,2019-20,31.0,14,45,75,75,16,29,45,164.0,1400.0,764,187,249,436,1601.0,82,5.45,47,245,2478,9.0
14285,Jordan Staal,2020-21,32.0,15,46,79,79,19,27,46,160.0,1521.0,843,206,276,482,1761.0,82,5.86,50,250,2620,9.2
14286,Jordan Staal,2021-22,33.0,16,28,50,50,11,17,28,121.0,914.0,893,217,293,510,1882.0,82,5.96,47,239,2579,9.5
14287,Jordan Staal,2022-23,34.0,17,27,68,68,8,19,27,125.0,1190.0,961,225,312,537,2007.0,70,5.96,42,208,2192,9.5
14288,Jordan Szwarz,2016-17,25.0,4,3,26,26,3,0,3,25.0,225.0,26,3,0,3,25.0,82,5.34,48,269,2463,8.9
14289,Jordan Szwarz,2017-18,26.0,5,1,9,9,1,0,1,8.0,121.0,35,4,0,4,33.0,82,5.32,47,251,2453,8.9
14290,Jordan Szwarz,2020-21,29.0,6,3,12,12,0,3,3,19.0,138.0,47,4,3,7,52.0,82,5.86,50,250,2620,9.2
14291,Jordan Szwarz,2022-23,31.0,7,0,3,3,0,0,0,2.0,15.0,50,4,3,7,54.0,70,5.96,42,208,2192,9.5
14292,Jordan Weal,2018-19,26.0,4,0,14,14,0,0,0,4.0,131.0,14,0,0,0,4.0,82,5.34,48,255,2438,9.0
14293,Jordan Weal,2019-20,27.0,5,12,23,23,8,4,12,49.0,329.0,37,8,4,12,53.0,82,5.45,47,245,2478,9.0
14294,Jordan Weal,2020-21,28.0,6,21,69,69,8,13,21,102.0,894.0,106,16,17,33,155.0,82,5.86,50,250,2620,9.2
14295,Jordan Weal,2021-22,29.0,7,21,63,63,8,13,21,75.0,848.0,169,24,30,54,230.0,82,5.96,47,239,2579,9.5
14296,Jordan Weal,2022-23,30.0,8,15,49,49,8,7,15,86.0,667.0,218,32,37,69,316.0,70,5.96,42,208,2192,9.5
14297,Jordie Benn,2014-15,27.0,4,2,3,3,0,2,2,1.0,42.0,3,0,2,2,1.0,82,5.32,47,271,2439,8.9
14298,Jordie Benn,2015-16,28.0,5,6,26,26,1,5,6,31.0,450.0,29,1,7,8,32.0,48,5.31,29,160,1399,9.1
14299,Jordie Benn,2016-17,29.0,6,20,78,78,3,17,20,91.0,1494.0,107,4,24,28,123.0,82,5.34,48,269,2463,8.9
14300,Jordie Benn,2017-18,30.0,7,16,73,73,2,14,16,70.0,1319.0,180,6,38,44,193.0,82,5.32,47,251,2453,8.9
14301,Jordie Benn,2018-19,31.0,8,12,64,64,3,9,12,58.0,1001.0,244,9,47,56,251.0,82,5.34,48,255,2438,9.0
14302,Jordie Benn,2019-20,32.0,9,17,71,71,4,13,17,68.0,1298.0,315,13,60,73,319.0,82,5.45,47,245,2478,9.0
14303,Jordie Benn,2020-21,33.0,10,15,77,77,4,11,15,106.0,1461.0,392,17,71,88,425.0,82,5.86,50,250,2620,9.2
14304,Jordie Benn,2021-22,34.0,11,22,81,81,5,17,22,93.0,1474.0,473,22,88,110,518.0,82,5.96,47,239,2579,9.5
14305,Jordie Benn,2022-23,35.0,12,7,44,44,1,6,7,58.0,717.0,517,23,94,117,576.0,70,5.96,42,208,2192,9.5
14306,Jordin Tootoo,2006-07,23.0,4,8,70,70,4,4,8,92.0,594.0,70,4,4,8,92.0,82,5.14,57,348,2300,9.2
14307,Jordin Tootoo,2008-09,25.0,5,10,34,34,4,6,10,61.0,315.0,104,8,10,18,153.0,82,6.05,85,480,2458,10.1
14308,Jordin Tootoo,2009-10,26.0,6,9,65,65,3,6,9,77.0,546.0,169,11,16,27,230.0,82,5.76,70,398,2426,9.7
14309,Jordin Tootoo,2010-11,27.0,7,18,63,63,11,7,18,98.0,624.0,232,22,23,45,328.0,82,5.44,62,351,2383,9.4
14310,Jordin Tootoo,2011-12,28.0,8,16,72,72,4,12,16,138.0,870.0,304,26,35,61,466.0,82,5.7,65,341,2477,9.4
14311,Jordin Tootoo,2012-13,29.0,9,16,51,51,6,10,16,101.0,553.0,355,32,45,77,567.0,82,5.53,56,304,2486,9.1
14312,Jordin Tootoo,2013-14,30.0,10,18,54,54,8,10,18,85.0,641.0,409,40,55,95,652.0,82,5.46,52,291,2492,9.0
14313,Jordin Tootoo,2014-15,31.0,11,30,77,77,6,24,30,136.0,1013.0,486,46,79,125,788.0,82,5.32,47,271,2439,8.9
14314,Jordin Tootoo,2015-16,32.0,12,8,42,42,3,5,8,45.0,381.0,528,49,84,133,833.0,48,5.31,29,160,1399,9.1
14315,Jordin Tootoo,2016-17,33.0,13,1,11,11,0,1,1,11.0,77.0,539,49,85,134,844.0,82,5.34,48,269,2463,8.9
14316,Jordin Tootoo,2017-18,34.0,14,15,68,68,10,5,15,75.0,711.0,607,59,90,149,919.0,82,5.32,47,251,2453,8.9
14317,Jordin Tootoo,2018-19,35.0,15,9,66,66,4,5,9,90.0,761.0,673,63,95,158,1009.0,82,5.34,48,255,2438,9.0
14318,Jordin Tootoo,2019-20,36.0,16,3,50,50,2,1,3,43.0,337.0,723,65,96,161,1052.0,82,5.45,47,245,2478,9.0
14319,Jordy Douglas,1982-83,25.0,4,57,77,77,33,24,57,188.0,,77,33,24,57,188.0,80,7.03,61,280,2352,12.0
14320,Jordy Douglas,1983-84,26.0,5,22,55,55,13,9,22,98.0,,132,46,33,79,286.0,80,7.69,77,340,2441,12.6
14321,Jordy Douglas,1984-85,27.0,6,17,30,30,10,7,17,74.0,,162,56,40,96,360.0,80,8.03,73,320,2489,12.9
14322,Jordy Douglas,1985-86,28.0,7,27,68,68,13,14,27,86.0,,230,69,54,123,446.0,80,7.73,71,310,2444,12.7
14323,Jordy Douglas,1986-87,29.0,8,13,31,31,7,6,13,35.0,,261,76,60,136,481.0,80,7.89,74,336,2448,12.9
14324,Jordy Douglas,1987-88,30.0,9,2,7,7,0,2,2,6.0,,268,76,62,138,487.0,80,7.77,71,321,2447,12.7
14325,Jorgen Jonsson,2002-03,30.0,4,31,81,81,12,19,31,116.0,1263.0,81,12,19,31,116.0,82,5.49,53,331,2294,9.8
14326,Jorgen Pettersson,1983-84,27.0,4,73,62,62,37,36,73,172.0,,62,37,36,73,172.0,80,7.69,77,340,2441,12.6
14327,Jorgen Pettersson,1984-85,28.0,5,69,77,77,38,31,69,227.0,,139,75,67,142,399.0,80,8.03,73,320,2489,12.9
14328,Jorgen Pettersson,1985-86,29.0,6,73,74,74,35,38,73,201.0,,213,110,105,215,600.0,80,7.73,71,310,2444,12.7
14329,Jorgen Pettersson,1986-87,30.0,7,62,77,77,28,34,62,203.0,,290,138,139,277,803.0,80,7.89,74,336,2448,12.9
14330,Jorgen Pettersson,1987-88,31.0,8,55,75,75,23,32,55,180.0,,365,161,171,332,983.0,80,7.77,71,321,2447,12.7
14331,Jorgen Pettersson,1988-89,32.0,9,34,70,70,13,21,34,101.0,,435,174,192,366,1084.0,80,7.94,82,370,2484,12.8
14332,Jori Lehtera,2017-18,30.0,4,44,75,75,14,30,44,103.0,1216.0,75,14,30,44,103.0,82,5.32,47,251,2453,8.9
14333,Jori Lehtera,2018-19,31.0,5,34,79,79,9,25,34,83.0,1271.0,154,23,55,78,186.0,82,5.34,48,255,2438,9.0
14334,Jori Lehtera,2019-20,32.0,6,22,64,64,7,15,22,67.0,971.0,218,30,70,100,253.0,82,5.45,47,245,2478,9.0
14335,Jori Lehtera,2020-21,33.0,7,8,62,62,3,5,8,45.0,652.0,280,33,75,108,298.0,82,5.86,50,250,2620,9.2
14336,Jori Lehtera,2021-22,34.0,8,3,27,27,1,2,3,17.0,246.0,307,34,77,111,315.0,82,5.96,47,239,2579,9.5
14337,Jose Charbonneau,1990-91,24.0,4,2,16,16,0,2,2,22.0,,16,0,2,2,22.0,80,7.43,89,437,2435,12.2
14338,Jose Charbonneau,1991-92,25.0,5,5,22,22,1,4,5,31.0,,38,1,6,7,53.0,80,7.48,85,403,2430,12.3
14339,Jose Charbonneau,1996-97,30.0,6,14,30,30,7,7,14,28.0,,68,8,13,21,81.0,84,6.48,76,407,2545,10.7
14340,Jose Charbonneau,1997-98,31.0,7,1,3,3,1,0,1,2.0,,71,9,13,22,83.0,48,5.97,37,209,1408,10.2
14341,Josef Beranek,1994-95,25.0,4,28,58,58,12,16,28,79.0,,58,12,16,28,79.0,80,6.96,77,402,2440,11.4
14342,Josef Beranek,1995-96,26.0,5,33,66,66,15,18,33,130.0,,124,27,34,61,209.0,84,7.25,87,443,2603,11.7
14343,Josef Beranek,1996-97,27.0,6,49,80,80,28,21,49,182.0,,204,55,55,110,391.0,84,6.48,76,407,2545,10.7
14344,Josef Beranek,1997-98,28.0,7,31,51,51,13,18,31,134.0,,255,68,73,141,525.0,48,5.97,37,209,1408,10.2
14345,Josef Beranek,1998-99,29.0,8,20,61,61,6,14,20,131.0,,316,74,87,161,656.0,82,6.29,74,413,2481,10.4
14346,Josef Beranek,1999-00,30.0,9,4,8,8,3,1,4,15.0,,324,77,88,165,671.0,82,5.83,55,336,2444,9.8
14347,Josef Beranek,2001-02,32.0,10,49,66,66,19,30,49,160.0,1084.0,390,96,118,214,831.0,82,5.27,57,359,2285,9.4
14348,Josef Beranek,2002-03,33.0,11,25,71,71,13,12,25,139.0,1029.0,461,109,130,239,970.0,82,5.49,53,331,2294,9.8
14349,Josef Beranek,2003-04,34.0,12,23,70,70,9,14,23,152.0,1011.0,531,118,144,262,1122.0,82,5.51,63,376,2272,9.9
14350,Josef Boumedienne,2004-05,27.0,4,1,4,4,1,0,1,1.0,53.0,4,1,0,1,1.0,82,5.24,53,338,2262,9.5
14351,Josef Boumedienne,2005-06,28.0,5,1,6,6,1,0,1,7.0,117.0,10,2,0,2,8.0,82,5.31,60,363,2326,9.4
14352,Josef Boumedienne,2006-07,29.0,6,14,37,37,2,12,14,44.0,852.0,47,4,12,16,52.0,82,5.14,57,348,2300,9.2
14353,Josef Marha,1998-99,22.0,4,1,2,2,0,1,1,2.0,,2,0,1,1,2.0,82,6.29,74,413,2481,10.4
14354,Josef Marha,1999-00,23.0,5,1,6,6,0,1,1,6.0,,8,0,2,2,8.0,82,5.83,55,336,2444,9.8
14355,Josef Marha,2000-01,24.0,6,18,23,23,9,9,18,31.0,,31,9,11,20,39.0,82,5.28,57,380,2242,9.6
14356,Josef Marha,2001-02,25.0,7,8,32,32,2,6,8,45.0,442.0,63,11,17,28,84.0,82,5.27,57,359,2285,9.4
14357,Josef Marha,2002-03,26.0,8,22,81,81,10,12,22,91.0,1080.0,144,21,29,50,175.0,82,5.49,53,331,2294,9.8
14358,Josef Marha,2003-04,27.0,9,3,15,15,0,3,3,17.0,191.0,159,21,32,53,192.0,82,5.51,63,376,2272,9.9
14359,Josef Melichar,2003-04,25.0,4,2,18,18,0,2,2,9.0,268.0,18,0,2,2,9.0,82,5.51,63,376,2272,9.9
14360,Josef Melichar,2004-05,26.0,5,3,60,60,0,3,3,46.0,1006.0,78,0,5,5,55.0,82,5.24,53,338,2262,9.5
14361,Josef Melichar,2005-06,27.0,6,0,8,8,0,0,0,6.0,122.0,86,0,5,5,61.0,82,5.31,60,363,2326,9.4
14362,Josef Melichar,2006-07,28.0,7,8,82,82,3,5,8,78.0,1559.0,168,3,10,13,139.0,82,5.14,57,348,2300,9.2
14363,Josef Melichar,2008-09,30.0,8,15,72,72,3,12,15,53.0,1256.0,240,6,22,28,192.0,82,6.05,85,480,2458,10.1
14364,Josef Melichar,2009-10,31.0,9,12,70,70,1,11,12,57.0,1317.0,310,7,33,40,249.0,82,5.76,70,398,2426,9.7
14365,Josef Melichar,2011-12,33.0,10,9,39,39,0,9,9,19.0,537.0,349,7,42,49,268.0,82,5.7,65,341,2477,9.4
14366,Josef Vasicek,2003-04,23.0,4,21,76,76,8,13,21,103.0,898.0,76,8,13,21,103.0,82,5.51,63,376,2272,9.9
14367,Josef Vasicek,2004-05,24.0,5,31,78,78,14,17,31,117.0,1107.0,154,22,30,52,220.0,82,5.24,53,338,2262,9.5
14368,Josef Vasicek,2005-06,25.0,6,20,57,57,10,10,20,87.0,909.0,211,32,40,72,307.0,82,5.31,60,363,2326,9.4
14369,Josef Vasicek,2006-07,26.0,7,45,82,82,19,26,45,161.0,1402.0,293,51,66,117,468.0,82,5.14,57,348,2300,9.2
14370,Josef Vasicek,2008-09,28.0,8,9,23,23,4,5,9,41.0,354.0,316,55,71,126,509.0,82,6.05,85,480,2458,10.1
14371,Josef Vasicek,2009-10,29.0,9,22,63,63,6,16,22,77.0,843.0,379,61,87,148,586.0,82,5.76,70,398,2426,9.7
14372,Josef Vasicek,2010-11,30.0,10,35,81,81,16,19,35,126.0,1284.0,460,77,106,183,712.0,82,5.44,62,351,2383,9.4
14373,Joseph Blandisi,2018-19,24.0,4,17,41,41,5,12,17,43.0,640.0,41,5,12,17,43.0,82,5.34,48,255,2438,9.0
14374,Joseph Blandisi,2019-20,25.0,5,9,27,27,3,6,9,24.0,361.0,68,8,18,26,67.0,82,5.45,47,245,2478,9.0
14375,Joseph Blandisi,2020-21,26.0,6,0,3,3,0,0,0,4.0,35.0,71,8,18,26,71.0,82,5.86,50,250,2620,9.2
14376,Joseph Blandisi,2021-22,27.0,7,0,9,9,0,0,0,8.0,67.0,80,8,18,26,79.0,82,5.96,47,239,2579,9.5
14377,Joseph Blandisi,2022-23,28.0,8,5,21,21,2,3,5,12.0,172.0,101,10,21,31,91.0,70,5.96,42,208,2192,9.5
14378,Joseph Cramarossa,2019-20,27.0,4,10,59,59,4,6,10,36.0,587.0,59,4,6,10,36.0,82,5.45,47,245,2478,9.0
14379,Joseph Gambardella,2021-22,28.0,4,3,15,15,0,3,3,7.0,122.0,15,0,3,3,7.0,82,5.96,47,239,2579,9.5
14380,Joseph Labate,2019-20,26.0,4,0,13,13,0,0,0,5.0,88.0,13,0,0,0,5.0,82,5.45,47,245,2478,9.0
14381,Joseph Morrow,2017-18,25.0,4,1,15,15,1,0,1,20.0,250.0,15,1,0,1,20.0,82,5.32,47,251,2453,8.9
14382,Joseph Morrow,2018-19,26.0,5,7,33,33,1,6,7,44.0,525.0,48,2,6,8,64.0,82,5.34,48,255,2438,9.0
14383,Joseph Morrow,2019-20,27.0,6,1,17,17,0,1,1,19.0,264.0,65,2,7,9,83.0,82,5.45,47,245,2478,9.0
14384,Joseph Morrow,2020-21,28.0,7,16,56,56,6,10,16,83.0,937.0,121,8,17,25,166.0,82,5.86,50,250,2620,9.2
14385,Joseph Morrow,2021-22,29.0,8,7,41,41,1,6,7,40.0,572.0,162,9,23,32,206.0,82,5.96,47,239,2579,9.5
14386,Josh Anderson,2017-18,23.0,4,1,6,6,0,1,1,10.0,81.0,6,0,1,1,10.0,82,5.32,47,251,2453,8.9
14387,Josh Anderson,2018-19,24.0,5,4,12,12,1,3,4,11.0,128.0,18,1,4,5,21.0,82,5.34,48,255,2438,9.0
14388,Josh Anderson,2019-20,25.0,6,29,78,78,17,12,29,119.0,938.0,96,18,16,34,140.0,82,5.45,47,245,2478,9.0
14389,Josh Anderson,2020-21,26.0,7,30,63,63,19,11,30,188.0,1136.0,159,37,27,64,328.0,82,5.86,50,250,2620,9.2
14390,Josh Anderson,2021-22,27.0,8,47,82,82,27,20,47,230.0,1396.0,241,64,47,111,558.0,82,5.96,47,239,2579,9.5
14391,Josh Anderson,2022-23,28.0,9,4,26,26,1,3,4,63.0,418.0,267,65,50,115,621.0,70,5.96,42,208,2192,9.5
14392,Josh Archibald,2018-19,26.0,4,0,1,1,0,0,0,0.0,5.0,1,0,0,0,0.0,82,5.34,48,255,2438,9.0
14393,Josh Archibald,2019-20,27.0,5,3,10,10,3,0,3,11.0,109.0,11,3,0,3,11.0,82,5.45,47,245,2478,9.0
14394,Josh Archibald,2020-21,28.0,6,11,42,42,5,6,11,42.0,502.0,53,8,6,14,53.0,82,5.86,50,250,2620,9.2
14395,Josh Archibald,2021-22,29.0,7,22,68,68,12,10,22,92.0,923.0,121,20,16,36,145.0,82,5.96,47,239,2579,9.5
14396,Josh Archibald,2022-23,30.0,8,21,62,62,12,9,21,64.0,820.0,183,32,25,57,209.0,70,5.96,42,208,2192,9.5
14397,Josh Bailey,2011-12,22.0,4,25,68,68,7,18,25,74.0,1053.0,68,7,18,25,74.0,82,5.7,65,341,2477,9.4
14398,Josh Bailey,2012-13,23.0,5,35,73,73,16,19,35,112.0,1106.0,141,23,37,60,186.0,82,5.53,56,304,2486,9.1
14399,Josh Bailey,2013-14,24.0,6,28,70,70,11,17,28,102.0,1248.0,211,34,54,88,288.0,82,5.46,52,291,2492,9.0
14400,Josh Bailey,2014-15,25.0,7,32,80,80,13,19,32,104.0,1218.0,291,47,73,120,392.0,82,5.32,47,271,2439,8.9
14401,Josh Bailey,2015-16,26.0,8,19,38,38,11,8,19,76.0,622.0,329,58,81,139,468.0,48,5.31,29,160,1399,9.1
14402,Josh Bailey,2016-17,27.0,9,38,77,77,8,30,38,98.0,1220.0,406,66,111,177,566.0,82,5.34,48,269,2463,8.9
14403,Josh Bailey,2017-18,28.0,10,41,70,70,15,26,41,140.0,1175.0,476,81,137,218,706.0,82,5.32,47,251,2453,8.9
14404,Josh Bailey,2018-19,29.0,11,32,81,81,12,20,32,105.0,1284.0,557,93,157,250,811.0,82,5.34,48,255,2438,9.0
14405,Josh Bailey,2019-20,30.0,12,56,82,82,13,43,56,173.0,1506.0,639,106,200,306,984.0,82,5.45,47,245,2478,9.0
14406,Josh Bailey,2020-21,31.0,13,71,76,76,18,53,71,151.0,1359.0,715,124,253,377,1135.0,82,5.86,50,250,2620,9.2
14407,Josh Bailey,2021-22,32.0,14,56,82,82,16,40,56,126.0,1380.0,797,140,293,433,1261.0,82,5.96,47,239,2579,9.5
14408,Josh Bailey,2022-23,33.0,15,43,68,68,14,29,43,94.0,1149.0,865,154,322,476,1355.0,70,5.96,42,208,2192,9.5
14409,Josh Brown,2021-22,28.0,4,2,37,37,1,1,2,28.0,492.0,37,1,1,2,28.0,82,5.96,47,239,2579,9.5
14410,Josh Brown,2022-23,29.0,5,8,56,56,3,5,8,48.0,751.0,93,4,6,10,76.0,70,5.96,42,208,2192,9.5
14411,Josh Currie,2021-22,29.0,4,5,21,21,2,3,5,19.0,183.0,21,2,3,5,19.0,82,5.96,47,239,2579,9.5
14412,Josh Gorges,2008-09,24.0,4,6,49,49,0,6,6,25.0,864.0,49,0,6,6,25.0,82,6.05,85,480,2458,10.1
14413,Josh Gorges,2009-10,25.0,5,4,54,54,1,3,4,40.0,924.0,103,1,9,10,65.0,82,5.76,70,398,2426,9.7
14414,Josh Gorges,2010-11,26.0,6,9,62,62,0,9,9,41.0,1013.0,165,1,18,19,106.0,82,5.44,62,351,2383,9.4
14415,Josh Gorges,2011-12,27.0,7,23,81,81,4,19,23,63.0,1630.0,246,5,37,42,169.0,82,5.7,65,341,2477,9.4
14416,Josh Gorges,2012-13,28.0,8,10,82,82,3,7,10,52.0,1723.0,328,8,44,52,221.0,82,5.53,56,304,2486,9.1
14417,Josh Gorges,2013-14,29.0,9,7,36,36,1,6,7,20.0,762.0,364,9,50,59,241.0,82,5.46,52,291,2492,9.0
14418,Josh Gorges,2014-15,30.0,10,16,82,82,2,14,16,59.0,1856.0,446,11,64,75,300.0,82,5.32,47,271,2439,8.9
14419,Josh Gorges,2015-16,31.0,11,9,48,48,2,7,9,40.0,1027.0,494,13,71,84,340.0,48,5.31,29,160,1399,9.1
14420,Josh Gorges,2016-17,32.0,12,14,66,66,1,13,14,35.0,1402.0,560,14,84,98,375.0,82,5.34,48,269,2463,8.9
14421,Josh Gorges,2017-18,33.0,13,6,46,46,0,6,6,28.0,1029.0,606,14,90,104,403.0,82,5.32,47,251,2453,8.9
14422,Josh Gorges,2018-19,34.0,14,12,77,77,2,10,12,57.0,1576.0,683,16,100,116,460.0,82,5.34,48,255,2438,9.0
14423,Josh Gorges,2019-20,35.0,15,6,66,66,1,5,6,40.0,1218.0,749,17,105,122,500.0,82,5.45,47,245,2478,9.0
14424,Josh Gorges,2020-21,36.0,16,2,34,34,0,2,2,15.0,508.0,783,17,107,124,515.0,82,5.86,50,250,2620,9.2
14425,Josh Gratton,2008-09,26.0,4,1,14,14,1,0,1,17.0,103.0,14,1,0,1,17.0,82,6.05,85,480,2458,10.1
14426,Josh Gratton,2009-10,27.0,5,2,52,52,1,1,2,29.0,307.0,66,2,1,3,46.0,82,5.76,70,398,2426,9.7
14427,Josh Gratton,2010-11,28.0,6,0,1,1,0,0,0,0.0,10.0,67,2,1,3,46.0,82,5.44,62,351,2383,9.4
14428,Josh Gratton,2011-12,29.0,7,3,19,19,1,2,3,14.0,119.0,86,3,3,6,60.0,82,5.7,65,341,2477,9.4
14429,Josh Green,2001-02,24.0,4,4,27,27,1,3,4,35.0,317.0,27,1,3,4,35.0,82,5.27,57,359,2285,9.4
14430,Josh Green,2002-03,25.0,5,26,49,49,12,14,26,109.0,666.0,76,13,17,30,144.0,82,5.49,53,331,2294,9.8
14431,Josh Green,2004-05,27.0,6,15,61,61,10,5,15,78.0,615.0,137,23,22,45,222.0,82,5.24,53,338,2262,9.5
14432,Josh Green,2005-06,28.0,7,5,45,45,1,4,5,43.0,414.0,182,24,26,50,265.0,82,5.31,60,363,2326,9.4
14433,Josh Green,2006-07,29.0,8,11,50,50,5,6,11,76.0,607.0,232,29,32,61,341.0,82,5.14,57,348,2300,9.2
14434,Josh Green,2008-09,31.0,9,6,33,33,4,2,6,35.0,283.0,265,33,34,67,376.0,82,6.05,85,480,2458,10.1
14435,Josh Green,2009-10,32.0,10,7,57,57,2,5,7,74.0,650.0,322,35,39,74,450.0,82,5.76,70,398,2426,9.7
14436,Josh Green,2013-14,36.0,11,0,12,12,0,0,0,10.0,120.0,334,35,39,74,460.0,82,5.46,52,291,2492,9.0
14437,Josh Green,2014-15,37.0,12,2,7,7,1,1,2,14.0,83.0,341,36,40,76,474.0,82,5.32,47,271,2439,8.9
14438,Josh Hennessy,2009-10,24.0,4,1,10,10,1,0,1,6.0,57.0,10,1,0,1,6.0,82,5.76,70,398,2426,9.7
14439,Josh Hennessy,2010-11,25.0,5,0,5,5,0,0,0,2.0,19.0,15,1,0,1,8.0,82,5.44,62,351,2383,9.4
14440,Josh Hennessy,2011-12,26.0,6,0,1,1,0,0,0,0.0,14.0,16,1,0,1,8.0,82,5.7,65,341,2477,9.4
14441,Josh Hennessy,2012-13,27.0,7,0,4,4,0,0,0,2.0,24.0,20,1,0,1,10.0,82,5.53,56,304,2486,9.1
14442,Josh Hennessy,2014-15,29.0,8,0,3,3,0,0,0,2.0,20.0,23,1,0,1,12.0,82,5.32,47,271,2439,8.9
14443,Josh Holden,2001-02,24.0,4,6,30,30,2,4,6,44.0,382.0,30,2,4,6,44.0,82,5.27,57,359,2285,9.4
14444,Josh Holden,2002-03,25.0,5,6,6,6,1,5,6,5.0,63.0,36,3,9,12,49.0,82,5.49,53,331,2294,9.8
14445,Josh Holden,2003-04,26.0,6,1,10,10,1,0,1,12.0,94.0,46,4,9,13,61.0,82,5.51,63,376,2272,9.9
14446,Josh Holden,2004-05,27.0,7,0,8,8,0,0,0,3.0,42.0,54,4,9,13,64.0,82,5.24,53,338,2262,9.5
14447,Josh Holden,2005-06,28.0,8,1,5,5,1,0,1,6.0,40.0,59,5,9,14,70.0,82,5.31,60,363,2326,9.4
14448,Josh Holden,2006-07,29.0,9,0,1,1,0,0,0,0.0,11.0,60,5,9,14,70.0,82,5.14,57,348,2300,9.2
14449,Josh Jooris,2017-18,27.0,4,24,60,60,12,12,24,89.0,870.0,60,12,12,24,89.0,82,5.32,47,251,2453,8.9
14450,Josh Jooris,2018-19,28.0,5,13,59,59,4,9,13,80.0,725.0,119,16,21,37,169.0,82,5.34,48,255,2438,9.0
14451,Josh Jooris,2019-20,29.0,6,12,54,54,4,8,12,75.0,659.0,173,20,29,49,244.0,82,5.45,47,245,2478,9.0
14452,Josh Jooris,2020-21,30.0,7,6,40,40,3,3,6,50.0,391.0,213,23,32,55,294.0,82,5.86,50,250,2620,9.2
14453,Josh Langfeld,2004-05,27.0,4,0,1,1,0,0,0,5.0,8.0,1,0,0,0,5.0,82,5.24,53,338,2262,9.5
14454,Josh Langfeld,2005-06,28.0,5,1,12,12,0,1,1,16.0,134.0,13,0,1,1,21.0,82,5.31,60,363,2326,9.4
14455,Josh Langfeld,2006-07,29.0,6,17,38,38,7,10,17,59.0,414.0,51,7,11,18,80.0,82,5.14,57,348,2300,9.2
14456,Josh Langfeld,2008-09,31.0,7,12,57,57,2,10,12,85.0,628.0,108,9,21,30,165.0,82,6.05,85,480,2458,10.1
14457,Josh Langfeld,2009-10,32.0,8,2,33,33,0,2,2,37.0,183.0,141,9,23,32,202.0,82,5.76,70,398,2426,9.7
14458,Josh Langfeld,2010-11,33.0,9,0,2,2,0,0,0,5.0,20.0,143,9,23,32,207.0,82,5.44,62,351,2383,9.4
14459,Josh Leivo,2016-17,23.0,4,2,7,7,1,1,2,4.0,69.0,7,1,1,2,4.0,82,5.34,48,269,2463,8.9
14460,Josh Leivo,2017-18,24.0,5,1,9,9,1,0,1,10.0,69.0,16,2,1,3,14.0,82,5.32,47,251,2453,8.9
14461,Josh Leivo,2018-19,25.0,6,5,12,12,5,0,5,20.0,148.0,28,7,1,8,34.0,82,5.34,48,255,2438,9.0
14462,Josh Leivo,2019-20,26.0,7,10,13,13,2,8,10,27.0,163.0,41,9,9,18,61.0,82,5.45,47,245,2478,9.0
14463,Josh Leivo,2020-21,27.0,8,4,16,16,1,3,4,25.0,169.0,57,10,12,22,86.0,82,5.86,50,250,2620,9.2
14464,Josh Leivo,2021-22,28.0,9,24,76,76,14,10,24,151.0,1066.0,133,24,22,46,237.0,82,5.96,47,239,2579,9.5
14465,Josh Leivo,2022-23,29.0,10,19,36,36,7,12,19,69.0,540.0,169,31,34,65,306.0,70,5.96,42,208,2192,9.5
14466,Josh Mahura,2021-22,23.0,4,5,17,17,1,4,5,20.0,243.0,17,1,4,5,20.0,82,5.96,47,239,2579,9.5
14467,Josh Mahura,2022-23,24.0,5,4,11,11,1,3,4,11.0,179.0,28,2,7,9,31.0,70,5.96,42,208,2192,9.5
14468,Josh Manson,2017-18,26.0,4,3,28,28,0,3,3,26.0,516.0,28,0,3,3,26.0,82,5.32,47,251,2453,8.9
14469,Josh Manson,2018-19,27.0,5,15,71,71,5,10,15,88.0,1334.0,99,5,13,18,114.0,82,5.34,48,255,2438,9.0
14470,Josh Manson,2019-20,28.0,6,17,82,82,5,12,17,88.0,1527.0,181,10,25,35,202.0,82,5.45,47,245,2478,9.0
14471,Josh Manson,2020-21,29.0,7,37,80,80,7,30,37,117.0,1628.0,261,17,55,72,319.0,82,5.86,50,250,2620,9.2
14472,Josh Manson,2021-22,30.0,8,16,74,74,3,13,16,96.0,1651.0,335,20,68,88,415.0,82,5.96,47,239,2579,9.5
14473,Josh Manson,2022-23,31.0,9,9,50,50,1,8,9,64.0,1032.0,385,21,76,97,479.0,70,5.96,42,208,2192,9.5
14474,Josh Morrissey,2018-19,23.0,4,0,1,1,0,0,0,1.0,16.0,1,0,0,0,1.0,82,5.34,48,255,2438,9.0
14475,Josh Morrissey,2019-20,24.0,5,20,82,82,6,14,20,99.0,1598.0,83,6,14,20,100.0,82,5.45,47,245,2478,9.0
14476,Josh Morrissey,2020-21,25.0,6,26,81,81,7,19,26,102.0,1657.0,164,13,33,46,202.0,82,5.86,50,250,2620,9.2
14477,Josh Morrissey,2021-22,26.0,7,31,59,59,6,25,31,95.0,1322.0,223,19,58,77,297.0,82,5.96,47,239,2579,9.5
14478,Josh Morrissey,2022-23,27.0,8,31,65,65,5,26,31,120.0,1480.0,288,24,84,108,417.0,70,5.96,42,208,2192,9.5
14479,Josh Olson,2006-07,25.0,4,1,5,5,1,0,1,6.0,41.0,5,1,0,1,6.0,82,5.14,57,348,2300,9.2
14480,Josh Teves,2021-22,26.0,4,0,1,1,0,0,0,0.0,14.0,1,0,0,0,0.0,82,5.96,47,239,2579,9.5
14481,Joshua Ho-Sang,2019-20,24.0,4,10,21,21,4,6,10,22.0,346.0,21,4,6,10,22.0,82,5.45,47,245,2478,9.0
14482,Joshua Ho-Sang,2020-21,25.0,5,12,22,22,2,10,12,18.0,314.0,43,6,16,22,40.0,82,5.86,50,250,2620,9.2
14483,Joshua Ho-Sang,2021-22,26.0,6,2,10,10,1,1,2,10.0,145.0,53,7,17,24,50.0,82,5.96,47,239,2579,9.5
14484,Joshua Jacobs,2021-22,25.0,4,0,1,1,0,0,0,1.0,15.0,1,0,0,0,1.0,82,5.96,47,239,2579,9.5
14485,Joshua Jacobs,2022-23,26.0,5,0,2,2,0,0,0,3.0,33.0,3,0,0,0,4.0,70,5.96,42,208,2192,9.5
14486,Joshua Norris,2022-23,23.0,4,0,3,3,0,0,0,9.0,54.0,3,0,0,0,9.0,70,5.96,42,208,2192,9.5
14487,Jozef Balej,2006-07,24.0,4,5,17,17,1,4,5,29.0,221.0,17,1,4,5,29.0,82,5.14,57,348,2300,9.2
14488,Jozef Balej,2008-09,26.0,5,1,1,1,0,1,1,3.0,8.0,18,1,5,6,32.0,82,6.05,85,480,2458,10.1
14489,Jozef Cierny,1996-97,22.0,4,0,1,1,0,0,0,0.0,,1,0,0,0,0.0,84,6.48,76,407,2545,10.7
14490,Jozef Stumpel,1994-95,22.0,4,1,4,4,1,0,1,3.0,,4,1,0,1,3.0,80,6.96,77,402,2440,11.4
14491,Jozef Stumpel,1995-96,23.0,5,4,13,13,1,3,4,8.0,,17,2,3,5,11.0,84,7.25,87,443,2603,11.7
14492,Jozef Stumpel,1996-97,24.0,6,23,59,59,8,15,23,62.0,,76,10,18,28,73.0,84,6.48,76,407,2545,10.7
14493,Jozef Stumpel,1997-98,25.0,7,18,44,44,5,13,18,46.0,,120,15,31,46,119.0,48,5.97,37,209,1408,10.2
14494,Jozef Stumpel,1998-99,26.0,8,54,76,76,18,36,54,158.0,,196,33,67,100,277.0,82,6.29,74,413,2481,10.4
14495,Jozef Stumpel,1999-00,27.0,9,76,78,78,21,55,76,168.0,,274,54,122,176,445.0,82,5.83,55,336,2444,9.8
14496,Jozef Stumpel,2000-01,28.0,10,79,77,77,21,58,79,162.0,,351,75,180,255,607.0,82,5.28,57,380,2242,9.6
14497,Jozef Stumpel,2001-02,29.0,11,34,64,64,13,21,34,131.0,1263.0,415,88,201,289,738.0,82,5.27,57,359,2285,9.4
14498,Jozef Stumpel,2002-03,30.0,12,58,57,57,17,41,58,126.0,1098.0,472,105,242,347,864.0,82,5.49,53,331,2294,9.8
14499,Jozef Stumpel,2003-04,31.0,13,55,63,63,16,39,55,95.0,1234.0,535,121,281,402,959.0,82,5.51,63,376,2272,9.9
14500,Jozef Stumpel,2004-05,32.0,14,58,81,81,8,50,58,100.0,1520.0,616,129,331,460,1059.0,82,5.24,53,338,2262,9.5
14501,Jozef Stumpel,2005-06,33.0,15,51,78,78,14,37,51,110.0,1439.0,694,143,368,511,1169.0,82,5.31,60,363,2326,9.4
14502,Jozef Stumpel,2006-07,34.0,16,37,64,64,8,29,37,78.0,1201.0,758,151,397,548,1247.0,82,5.14,57,348,2300,9.2
14503,Jozef Stumpel,2008-09,36.0,17,52,74,74,15,37,52,115.0,1316.0,832,166,434,600,1362.0,82,6.05,85,480,2458,10.1
14504,Jozef Stumpel,2009-10,37.0,18,57,73,73,23,34,57,131.0,1396.0,905,189,468,657,1493.0,82,5.76,70,398,2426,9.7
14505,Jozef Stumpel,2010-11,38.0,19,20,52,52,7,13,20,64.0,903.0,957,196,481,677,1557.0,82,5.44,62,351,2383,9.4
14506,Juha Lind,2000-01,27.0,4,5,39,39,2,3,5,27.0,,39,2,3,5,27.0,82,5.28,57,380,2242,9.6
14507,Juha Lind,2002-03,29.0,5,10,47,47,4,6,10,42.0,493.0,86,6,9,15,69.0,82,5.49,53,331,2294,9.8
14508,Juha Lind,2003-04,30.0,6,7,47,47,3,4,7,36.0,367.0,133,9,13,22,105.0,82,5.51,63,376,2272,9.9
14509,Juha Ylonen,1999-00,27.0,4,0,2,2,0,0,0,2.0,,2,0,0,0,2.0,82,5.83,55,336,2444,9.8
14510,Juha Ylonen,2000-01,28.0,5,12,55,55,1,11,12,60.0,,57,1,11,12,62.0,82,5.28,57,380,2242,9.6
14511,Juha Ylonen,2001-02,29.0,6,23,59,59,6,17,23,66.0,939.0,116,7,28,35,128.0,82,5.27,57,359,2285,9.4
14512,Juha Ylonen,2002-03,30.0,7,29,76,76,6,23,29,82.0,1270.0,192,13,51,64,210.0,82,5.49,53,331,2294,9.8
14513,Juha Ylonen,2003-04,31.0,8,23,69,69,9,14,23,72.0,987.0,261,22,65,87,282.0,82,5.51,63,376,2272,9.9
14514,Juha Ylonen,2004-05,32.0,9,15,80,80,4,11,15,97.0,1253.0,341,26,76,102,379.0,82,5.24,53,338,2262,9.5
14515,Juho Lammikko,2021-22,26.0,4,6,40,40,0,6,6,39.0,437.0,40,0,6,6,39.0,82,5.96,47,239,2579,9.5
14516,Jujhar Khaira,2018-19,24.0,4,2,15,15,0,2,2,14.0,155.0,15,0,2,2,14.0,82,5.34,48,255,2438,9.0
14517,Jujhar Khaira,2019-20,25.0,5,1,10,10,1,0,1,10.0,93.0,25,1,2,3,24.0,82,5.45,47,245,2478,9.0
14518,Jujhar Khaira,2020-21,26.0,6,21,69,69,11,10,21,73.0,877.0,94,12,12,24,97.0,82,5.86,50,250,2620,9.2
14519,Jujhar Khaira,2021-22,27.0,7,18,60,60,3,15,18,64.0,754.0,154,15,27,42,161.0,82,5.96,47,239,2579,9.5
14520,Jujhar Khaira,2022-23,28.0,8,10,64,64,6,4,10,69.0,802.0,218,21,31,52,230.0,70,5.96,42,208,2192,9.5
14521,Jukka Hentunen,2004-05,30.0,4,9,38,38,4,5,9,50.0,440.0,38,4,5,9,50.0,82,5.24,53,338,2262,9.5
14522,Jukka Porvari,1984-85,31.0,4,8,31,31,2,6,8,45.0,,31,2,6,8,45.0,80,8.03,73,320,2489,12.9
14523,Jukka Porvari,1985-86,32.0,5,4,8,8,1,3,4,10.0,,39,3,9,12,55.0,80,7.73,71,310,2444,12.7
14524,Julian Melchiori,2016-17,25.0,4,0,1,1,0,0,0,0.0,9.0,1,0,0,0,0.0,82,5.34,48,269,2463,8.9
14525,Julian Melchiori,2018-19,27.0,5,0,11,11,0,0,0,12.0,150.0,12,0,0,0,12.0,82,5.34,48,255,2438,9.0
14526,Julian Melchiori,2019-20,28.0,6,2,18,18,0,2,2,15.0,331.0,30,0,2,2,27.0,82,5.45,47,245,2478,9.0
14527,Julien Brouillette,2016-17,30.0,4,2,10,10,1,1,2,4.0,156.0,10,1,1,2,4.0,82,5.34,48,269,2463,8.9
14528,Julien Brouillette,2017-18,31.0,5,0,1,1,0,0,0,0.0,10.0,11,1,1,2,4.0,82,5.32,47,251,2453,8.9
14529,Julien Gauthier,2022-23,25.0,4,3,17,17,0,3,3,10.0,141.0,17,0,3,3,10.0,70,5.96,42,208,2192,9.5
14530,Julien Vauclair,2006-07,27.0,4,0,1,1,0,0,0,0.0,13.0,1,0,0,0,0.0,82,5.14,57,348,2300,9.2
14531,Julius Honka,2019-20,24.0,4,5,16,16,1,4,5,34.0,270.0,16,1,4,5,34.0,82,5.45,47,245,2478,9.0
14532,Julius Honka,2020-21,25.0,5,4,42,42,1,3,4,42.0,546.0,58,2,7,9,76.0,82,5.86,50,250,2620,9.2
14533,Julius Honka,2021-22,26.0,6,4,29,29,0,4,4,38.0,398.0,87,2,11,13,114.0,82,5.96,47,239,2579,9.5
14534,Junior Lessard,2008-09,28.0,4,1,5,5,1,0,1,6.0,37.0,5,1,0,1,6.0,82,6.05,85,480,2458,10.1
14535,Junior Lessard,2009-10,29.0,5,1,1,1,1,0,1,3.0,12.0,6,2,0,2,9.0,82,5.76,70,398,2426,9.7
14536,Junior Lessard,2010-11,30.0,6,2,21,21,1,1,2,21.0,207.0,27,3,1,4,30.0,82,5.44,62,351,2383,9.4
14537,Juraj Kolnik,2003-04,23.0,4,7,29,29,4,3,7,38.0,303.0,29,4,3,7,38.0,82,5.51,63,376,2272,9.9
14538,Juraj Kolnik,2004-05,24.0,5,2,7,7,2,0,2,10.0,56.0,36,6,3,9,48.0,82,5.24,53,338,2262,9.5
14539,Juraj Kolnik,2005-06,25.0,6,1,10,10,0,1,1,14.0,106.0,46,6,4,10,62.0,82,5.31,60,363,2326,9.4
14540,Juraj Kolnik,2006-07,26.0,7,25,53,53,14,11,25,100.0,852.0,99,20,15,35,162.0,82,5.14,57,348,2300,9.2
14541,Juraj Kolnik,2008-09,28.0,8,35,77,77,15,20,35,145.0,1102.0,176,35,35,70,307.0,82,6.05,85,480,2458,10.1
14542,Juraj Kolnik,2009-10,29.0,9,25,64,64,11,14,25,113.0,774.0,240,46,49,95,420.0,82,5.76,70,398,2426,9.7
14543,Jussi Jokinen,2008-09,25.0,4,55,81,81,17,38,55,107.0,1099.0,81,17,38,55,107.0,82,6.05,85,480,2458,10.1
14544,Jussi Jokinen,2009-10,26.0,5,48,82,82,14,34,48,121.0,1140.0,163,31,72,103,228.0,82,5.76,70,398,2426,9.7
14545,Jussi Jokinen,2010-11,27.0,6,42,72,72,16,26,42,131.0,1041.0,235,47,98,145,359.0,82,5.44,62,351,2383,9.4
14546,Jussi Jokinen,2011-12,28.0,7,27,71,71,7,20,27,101.0,1087.0,306,54,118,172,460.0,82,5.7,65,341,2477,9.4
14547,Jussi Jokinen,2012-13,29.0,8,65,81,81,30,35,65,160.0,1362.0,387,84,153,237,620.0,82,5.53,56,304,2486,9.1
14548,Jussi Jokinen,2013-14,30.0,9,52,70,70,19,33,52,136.0,1206.0,457,103,186,289,756.0,82,5.46,52,291,2492,9.0
14549,Jussi Jokinen,2014-15,31.0,10,46,79,79,12,34,46,118.0,1396.0,536,115,220,335,874.0,82,5.32,47,271,2439,8.9
14550,Jussi Jokinen,2015-16,32.0,11,22,43,43,13,9,22,74.0,664.0,579,128,229,357,948.0,48,5.31,29,160,1399,9.1
14551,Jussi Jokinen,2016-17,33.0,12,57,81,81,21,36,57,172.0,1272.0,660,149,265,414,1120.0,82,5.34,48,269,2463,8.9
14552,Jussi Jokinen,2017-18,34.0,13,44,81,81,8,36,44,134.0,1356.0,741,157,301,458,1254.0,82,5.32,47,251,2453,8.9
14553,Jussi Jokinen,2018-19,35.0,14,60,81,81,18,42,60,153.0,1482.0,822,175,343,518,1407.0,82,5.34,48,255,2438,9.0
14554,Jussi Jokinen,2019-20,36.0,15,28,69,69,11,17,28,118.0,1201.0,891,186,360,546,1525.0,82,5.45,47,245,2478,9.0
14555,Jussi Jokinen,2020-21,37.0,16,17,60,60,5,12,17,73.0,695.0,951,191,372,563,1598.0,82,5.86,50,250,2620,9.2
14556,Jussi Timonen,2009-10,26.0,4,4,14,14,0,4,4,8.0,199.0,14,0,4,4,8.0,82,5.76,70,398,2426,9.7
14557,Justin Abdelkader,2010-11,23.0,4,0,2,2,0,0,0,6.0,24.0,2,0,0,0,6.0,82,5.44,62,351,2383,9.4
14558,Justin Abdelkader,2011-12,24.0,5,0,2,2,0,0,0,2.0,19.0,4,0,0,0,8.0,82,5.7,65,341,2477,9.4
14559,Justin Abdelkader,2012-13,25.0,6,6,50,50,3,3,6,79.0,530.0,54,3,3,6,87.0,82,5.53,56,304,2486,9.1
14560,Justin Abdelkader,2013-14,26.0,7,19,74,74,7,12,19,129.0,910.0,128,10,15,25,216.0,82,5.46,52,291,2492,9.0
14561,Justin Abdelkader,2014-15,27.0,8,22,81,81,8,14,22,121.0,997.0,209,18,29,47,337.0,82,5.32,47,271,2439,8.9
14562,Justin Abdelkader,2015-16,28.0,9,13,48,48,10,3,13,96.0,711.0,257,28,32,60,433.0,48,5.31,29,160,1399,9.1
14563,Justin Abdelkader,2016-17,29.0,10,28,70,70,10,18,28,147.0,1070.0,327,38,50,88,580.0,82,5.34,48,269,2463,8.9
14564,Justin Abdelkader,2017-18,30.0,11,44,71,71,23,21,44,154.0,1272.0,398,61,71,132,734.0,82,5.32,47,251,2453,8.9
14565,Justin Abdelkader,2018-19,31.0,12,42,82,82,19,23,42,155.0,1512.0,480,80,94,174,889.0,82,5.34,48,255,2438,9.0
14566,Justin Abdelkader,2019-20,32.0,13,21,64,64,7,14,21,104.0,1066.0,544,87,108,195,993.0,82,5.45,47,245,2478,9.0
14567,Justin Abdelkader,2020-21,33.0,14,35,75,75,13,22,35,110.0,1241.0,619,100,130,230,1103.0,82,5.86,50,250,2620,9.2
14568,Justin Abdelkader,2021-22,34.0,15,19,71,71,6,13,19,95.0,1093.0,690,106,143,249,1198.0,82,5.96,47,239,2579,9.5
14569,Justin Abdelkader,2022-23,35.0,16,3,49,49,0,3,3,40.0,565.0,739,106,146,252,1238.0,70,5.96,42,208,2192,9.5
14570,Justin Auger,2020-21,26.0,4,0,2,2,0,0,0,1.0,16.0,2,0,0,0,1.0,82,5.86,50,250,2620,9.2
14571,Justin Bailey,2018-19,23.0,4,0,8,8,0,0,0,22.0,93.0,8,0,0,0,22.0,82,5.34,48,255,2438,9.0
14572,Justin Bailey,2019-20,24.0,5,4,32,32,2,2,4,36.0,340.0,40,2,2,4,58.0,82,5.45,47,245,2478,9.0
14573,Justin Bailey,2020-21,25.0,6,4,12,12,3,1,4,19.0,135.0,52,5,3,8,77.0,82,5.86,50,250,2620,9.2
14574,Justin Bailey,2021-22,26.0,7,1,11,11,0,1,1,5.0,63.0,63,5,4,9,82.0,82,5.96,47,239,2579,9.5
14575,Justin Bailey,2022-23,27.0,8,0,2,2,0,0,0,1.0,11.0,65,5,4,9,83.0,70,5.96,42,208,2192,9.5
14576,Justin Braun,2013-14,26.0,4,11,28,28,2,9,11,44.0,462.0,28,2,9,11,44.0,82,5.46,52,291,2492,9.0
14577,Justin Braun,2014-15,27.0,5,11,66,66,2,9,11,113.0,1092.0,94,4,18,22,157.0,82,5.32,47,271,2439,8.9
14578,Justin Braun,2015-16,28.0,6,7,41,41,0,7,7,48.0,771.0,135,4,25,29,205.0,48,5.31,29,160,1399,9.1
14579,Justin Braun,2016-17,29.0,7,17,82,82,4,13,17,121.0,1721.0,217,8,38,46,326.0,82,5.34,48,269,2463,8.9
14580,Justin Braun,2017-18,30.0,8,23,70,70,1,22,23,94.0,1472.0,287,9,60,69,420.0,82,5.32,47,251,2453,8.9
14581,Justin Braun,2018-19,31.0,9,23,80,80,4,19,23,114.0,1645.0,367,13,79,92,534.0,82,5.34,48,255,2438,9.0
14582,Justin Braun,2019-20,32.0,10,13,81,81,4,9,13,95.0,1626.0,448,17,88,105,629.0,82,5.45,47,245,2478,9.0
14583,Justin Braun,2020-21,33.0,11,33,81,81,5,28,33,115.0,1728.0,529,22,116,138,744.0,82,5.86,50,250,2620,9.2
14584,Justin Braun,2021-22,34.0,12,16,78,78,2,14,16,105.0,1584.0,607,24,130,154,849.0,82,5.96,47,239,2579,9.5
14585,Justin Braun,2022-23,35.0,13,19,62,62,3,16,19,70.0,1071.0,669,27,146,173,919.0,70,5.96,42,208,2192,9.5
14586,Justin Dibenedetto,2013-14,25.0,4,1,8,8,0,1,1,6.0,73.0,8,0,1,1,6.0,82,5.46,52,291,2492,9.0
14587,Justin Dowling,2019-20,29.0,4,2,9,9,0,2,2,11.0,94.0,9,0,2,2,11.0,82,5.45,47,245,2478,9.0
14588,Justin Dowling,2021-22,31.0,5,1,11,11,0,1,1,9.0,139.0,20,0,3,3,20.0,82,5.96,47,239,2579,9.5
14589,Justin Dowling,2022-23,32.0,6,6,29,29,3,3,6,29.0,318.0,49,3,6,9,49.0,70,5.96,42,208,2192,9.5
14590,Justin Duberman,1996-97,26.0,4,0,4,4,0,0,0,2.0,,4,0,0,0,2.0,84,6.48,76,407,2545,10.7
14591,Justin Falk,2012-13,24.0,4,0,3,3,0,0,0,1.0,23.0,3,0,0,0,1.0,82,5.53,56,304,2486,9.1
14592,Justin Falk,2013-14,25.0,5,3,22,22,0,3,3,7.0,311.0,25,0,3,3,8.0,82,5.46,52,291,2492,9.0
14593,Justin Falk,2014-15,26.0,6,9,47,47,1,8,9,46.0,916.0,72,1,11,12,54.0,82,5.32,47,271,2439,8.9
14594,Justin Falk,2015-16,27.0,7,3,36,36,0,3,3,27.0,476.0,108,1,14,15,81.0,48,5.31,29,160,1399,9.1
14595,Justin Falk,2016-17,28.0,8,2,21,21,0,2,2,10.0,252.0,129,1,16,17,91.0,82,5.34,48,269,2463,8.9
14596,Justin Falk,2017-18,29.0,9,2,18,18,1,1,2,18.0,195.0,147,2,17,19,109.0,82,5.32,47,251,2453,8.9
14597,Justin Falk,2018-19,30.0,10,4,24,24,0,4,4,16.0,341.0,171,2,21,23,125.0,82,5.34,48,255,2438,9.0
14598,Justin Falk,2019-20,31.0,11,8,52,52,0,8,8,33.0,712.0,223,2,29,31,158.0,82,5.45,47,245,2478,9.0
14599,Justin Falk,2020-21,32.0,12,2,46,46,1,1,2,36.0,740.0,269,3,30,33,194.0,82,5.86,50,250,2620,9.2
14600,Justin Falk,2021-22,33.0,13,0,10,10,0,0,0,7.0,129.0,279,3,30,33,201.0,82,5.96,47,239,2579,9.5
14601,Justin Faulk,2014-15,22.0,4,22,66,66,8,14,22,101.0,1508.0,66,8,14,22,101.0,82,5.32,47,271,2439,8.9
14602,Justin Faulk,2015-16,23.0,5,15,38,38,5,10,15,76.0,912.0,104,13,24,37,177.0,48,5.31,29,160,1399,9.1
14603,Justin Faulk,2016-17,24.0,6,32,76,76,5,27,32,152.0,1779.0,180,18,51,69,329.0,82,5.34,48,269,2463,8.9
14604,Justin Faulk,2017-18,25.0,7,49,82,82,15,34,49,238.0,2003.0,262,33,85,118,567.0,82,5.32,47,251,2453,8.9
14605,Justin Faulk,2018-19,26.0,8,37,64,64,16,21,37,184.0,1539.0,326,49,106,155,751.0,82,5.34,48,255,2438,9.0
14606,Justin Faulk,2019-20,27.0,9,37,75,75,17,20,37,225.0,1736.0,401,66,126,192,976.0,82,5.45,47,245,2478,9.0
14607,Justin Faulk,2020-21,28.0,10,31,76,76,8,23,31,211.0,1692.0,477,74,149,223,1187.0,82,5.86,50,250,2620,9.2
14608,Justin Faulk,2021-22,29.0,11,35,82,82,11,24,35,217.0,1839.0,559,85,173,258,1404.0,82,5.96,47,239,2579,9.5
14609,Justin Faulk,2022-23,30.0,12,16,69,69,5,11,16,147.0,1419.0,628,90,184,274,1551.0,70,5.96,42,208,2192,9.5
14610,Justin Florek,2016-17,26.0,4,2,4,4,1,1,2,5.0,47.0,4,1,1,2,5.0,82,5.34,48,269,2463,8.9
14611,Justin Fontaine,2016-17,29.0,4,21,66,66,13,8,21,79.0,809.0,66,13,8,21,79.0,82,5.34,48,269,2463,8.9
14612,Justin Fontaine,2017-18,30.0,5,31,71,71,9,22,31,104.0,849.0,137,22,30,52,183.0,82,5.32,47,251,2453,8.9
14613,Justin Fontaine,2018-19,31.0,6,16,60,60,5,11,16,54.0,711.0,197,27,41,68,237.0,82,5.34,48,255,2438,9.0
14614,Justin Hocking,1996-97,23.0,4,0,1,1,0,0,0,0.0,,1,0,0,0,0.0,84,6.48,76,407,2545,10.7
14615,Justin Hodgman,2017-18,29.0,4,1,5,5,1,0,1,3.0,57.0,5,1,0,1,3.0,82,5.32,47,251,2453,8.9
14616,Justin Holl,2020-21,29.0,4,2,2,2,2,0,2,2.0,35.0,2,2,0,2,2.0,82,5.86,50,250,2620,9.2
14617,Justin Holl,2021-22,30.0,5,1,11,11,0,1,1,6.0,137.0,13,2,1,3,8.0,82,5.96,47,239,2579,9.5
14618,Justin Holl,2022-23,31.0,6,18,68,68,2,16,18,89.0,1259.0,81,4,17,21,97.0,70,5.96,42,208,2192,9.5
14619,Justin Johnson,2016-17,35.0,4,0,2,2,0,0,0,0.0,13.0,2,0,0,0,0.0,82,5.34,48,269,2463,8.9
14620,Justin Kloos,2020-21,27.0,4,0,1,1,0,0,0,0.0,9.0,1,0,0,0,0.0,82,5.86,50,250,2620,9.2
14621,Justin Kloos,2021-22,28.0,5,0,1,1,0,0,0,2.0,7.0,2,0,0,0,2.0,82,5.96,47,239,2579,9.5
14622,Justin Kurtz,2004-05,28.0,4,8,27,27,3,5,8,30.0,431.0,27,3,5,8,30.0,82,5.24,53,338,2262,9.5
14623,Justin Mapletoft,2005-06,25.0,4,4,11,11,2,2,4,12.0,135.0,11,2,2,4,12.0,82,5.31,60,363,2326,9.4
14624,Justin Mapletoft,2006-07,26.0,5,5,27,27,1,4,5,15.0,166.0,38,3,6,9,27.0,82,5.14,57,348,2300,9.2
14625,Justin Mercier,2012-13,25.0,4,2,9,9,1,1,2,5.0,65.0,9,1,1,2,5.0,82,5.53,56,304,2486,9.1
14626,Justin Papineau,2004-05,25.0,4,0,1,1,0,0,0,0.0,9.0,1,0,0,0,0.0,82,5.24,53,338,2262,9.5
14627,Justin Papineau,2005-06,26.0,5,6,16,16,3,3,6,23.0,195.0,17,3,3,6,23.0,82,5.31,60,363,2326,9.4
14628,Justin Papineau,2006-07,27.0,6,13,64,64,8,5,13,44.0,492.0,81,11,8,19,67.0,82,5.14,57,348,2300,9.2
14629,Justin Schultz,2015-16,25.0,4,27,48,48,8,19,27,85.0,1030.0,48,8,19,27,85.0,48,5.31,29,160,1399,9.1
14630,Justin Schultz,2016-17,26.0,5,33,74,74,11,22,33,109.0,1728.0,122,19,41,60,194.0,82,5.34,48,269,2463,8.9
14631,Justin Schultz,2017-18,27.0,6,31,81,81,6,25,31,122.0,1832.0,203,25,66,91,316.0,82,5.32,47,251,2453,8.9
14632,Justin Schultz,2018-19,28.0,7,18,63,63,4,14,18,82.0,1162.0,266,29,80,109,398.0,82,5.34,48,255,2438,9.0
14633,Justin Schultz,2019-20,29.0,8,51,78,78,12,39,51,154.0,1595.0,344,41,119,160,552.0,82,5.45,47,245,2478,9.0
14634,Justin Schultz,2020-21,30.0,9,27,63,63,4,23,27,109.0,1229.0,407,45,142,187,661.0,82,5.86,50,250,2620,9.2
14635,Justin Schultz,2021-22,31.0,10,15,29,29,2,13,15,47.0,595.0,436,47,155,202,708.0,82,5.96,47,239,2579,9.5
14636,Justin Schultz,2022-23,32.0,11,12,46,46,3,9,12,86.0,914.0,482,50,164,214,794.0,70,5.96,42,208,2192,9.5
14637,Justin Shugg,2017-18,26.0,4,0,3,3,0,0,0,3.0,17.0,3,0,0,0,3.0,82,5.32,47,251,2453,8.9
14638,Justin Williams,2003-04,22.0,4,25,63,63,12,13,25,99.0,789.0,63,12,13,25,99.0,82,5.51,63,376,2272,9.9
14639,Justin Williams,2004-05,23.0,5,40,75,75,17,23,40,162.0,1084.0,138,29,36,65,261.0,82,5.24,53,338,2262,9.5
14640,Justin Williams,2005-06,24.0,6,24,41,41,8,16,24,105.0,654.0,179,37,52,89,366.0,82,5.31,60,363,2326,9.4
14641,Justin Williams,2006-07,25.0,7,44,79,79,11,33,44,203.0,1332.0,258,48,85,133,569.0,82,5.14,57,348,2300,9.2
14642,Justin Williams,2008-09,27.0,8,76,82,82,31,45,76,255.0,1733.0,340,79,130,209,824.0,82,6.05,85,480,2458,10.1
14643,Justin Williams,2009-10,28.0,9,67,82,82,33,34,67,258.0,1710.0,422,112,164,276,1082.0,82,5.76,70,398,2426,9.7
14644,Justin Williams,2010-11,29.0,10,30,37,37,9,21,30,106.0,714.0,459,121,185,306,1188.0,82,5.44,62,351,2383,9.4
14645,Justin Williams,2011-12,30.0,11,14,44,44,4,10,14,108.0,699.0,503,125,195,320,1296.0,82,5.7,65,341,2477,9.4
14646,Justin Williams,2012-13,31.0,12,29,49,49,10,19,29,140.0,802.0,552,135,214,349,1436.0,82,5.53,56,304,2486,9.1
14647,Justin Williams,2013-14,32.0,13,57,73,73,22,35,57,213.0,1259.0,625,157,249,406,1649.0,82,5.46,52,291,2492,9.0
14648,Justin Williams,2014-15,33.0,14,59,82,82,22,37,59,241.0,1406.0,707,179,286,465,1890.0,82,5.32,47,271,2439,8.9
14649,Justin Williams,2015-16,34.0,15,33,48,48,11,22,33,142.0,816.0,755,190,308,498,2032.0,48,5.31,29,160,1399,9.1
14650,Justin Williams,2016-17,35.0,16,43,82,82,19,24,43,239.0,1390.0,837,209,332,541,2271.0,82,5.34,48,269,2463,8.9
14651,Justin Williams,2017-18,36.0,17,41,81,81,18,23,41,174.0,1281.0,918,227,355,582,2445.0,82,5.32,47,251,2453,8.9
14652,Justin Williams,2018-19,37.0,18,52,82,82,22,30,52,201.0,1366.0,1000,249,385,634,2646.0,82,5.34,48,255,2438,9.0
14653,Justin Williams,2019-20,38.0,19,48,80,80,24,24,48,167.0,1238.0,1080,273,409,682,2813.0,82,5.45,47,245,2478,9.0
14654,Justin Williams,2020-21,39.0,20,51,82,82,16,35,51,198.0,1360.0,1162,289,444,733,3011.0,82,5.86,50,250,2620,9.2
14655,Justin Williams,2021-22,40.0,21,53,82,82,23,30,53,237.0,1430.0,1244,312,474,786,3248.0,82,5.96,47,239,2579,9.5
14656,Justin Williams,2022-23,41.0,22,11,20,20,8,3,11,60.0,272.0,1264,320,477,797,3308.0,70,5.96,42,208,2192,9.5
14657,Juuso Riikola,2021-22,28.0,4,5,37,37,2,3,5,43.0,617.0,37,2,3,5,43.0,82,5.96,47,239,2579,9.5
14658,Juuso Riikola,2022-23,29.0,5,7,36,36,1,6,7,38.0,500.0,73,3,9,12,81.0,70,5.96,42,208,2192,9.5
14659,Juuso Valimaki,2021-22,23.0,4,3,24,24,1,2,3,28.0,372.0,24,1,2,3,28.0,82,5.96,47,239,2579,9.5
14660,Jyrki Jokipakka,2017-18,26.0,4,10,51,51,0,10,10,40.0,842.0,51,0,10,10,40.0,82,5.32,47,251,2453,8.9
14661,Jyrki Jokipakka,2018-19,27.0,5,12,58,58,2,10,12,45.0,902.0,109,2,20,22,85.0,82,5.34,48,255,2438,9.0
14662,Jyrki Jokipakka,2019-20,28.0,6,6,41,41,1,5,6,29.0,592.0,150,3,25,28,114.0,82,5.45,47,245,2478,9.0
14663,Jyrki Lumme,1991-92,25.0,4,4,21,21,1,3,4,18.0,,21,1,3,4,18.0,80,7.48,85,403,2430,12.3
14664,Jyrki Lumme,1992-93,26.0,5,30,65,65,4,26,30,109.0,,86,5,29,34,127.0,80,7.37,76,367,2421,12.2
14665,Jyrki Lumme,1993-94,27.0,6,32,80,80,5,27,32,157.0,,166,10,56,66,284.0,80,6.91,71,366,2385,11.6
14666,Jyrki Lumme,1994-95,28.0,7,44,75,75,12,32,44,106.0,,241,22,88,110,390.0,80,6.96,77,402,2440,11.4
14667,Jyrki Lumme,1995-96,29.0,8,44,74,74,8,36,44,123.0,,315,30,124,154,513.0,84,7.25,87,443,2603,11.7
14668,Jyrki Lumme,1996-97,30.0,9,55,83,83,13,42,55,161.0,,398,43,166,209,674.0,84,6.48,76,407,2545,10.7
14669,Jyrki Lumme,1997-98,31.0,10,17,36,36,5,12,17,78.0,,434,48,178,226,752.0,48,5.97,37,209,1408,10.2
14670,Jyrki Lumme,1998-99,32.0,11,54,80,80,17,37,54,192.0,,514,65,215,280,944.0,82,6.29,74,413,2481,10.4
14671,Jyrki Lumme,1999-00,33.0,12,35,66,66,11,24,35,107.0,,580,76,239,315,1051.0,82,5.83,55,336,2444,9.8
14672,Jyrki Lumme,2000-01,34.0,13,30,74,74,9,21,30,117.0,,654,85,260,345,1168.0,82,5.28,57,380,2242,9.6
14673,Jyrki Lumme,2001-02,35.0,14,28,60,60,7,21,28,121.0,1400.0,714,92,281,373,1289.0,82,5.27,57,359,2285,9.4
14674,Jyrki Lumme,2002-03,36.0,15,40,74,74,8,32,40,142.0,1746.0,788,100,313,413,1431.0,82,5.49,53,331,2294,9.8
14675,Jyrki Lumme,2003-04,37.0,16,25,58,58,4,21,25,77.0,1260.0,846,104,334,438,1508.0,82,5.51,63,376,2272,9.9
14676,Jyrki Lumme,2004-05,38.0,17,13,66,66,4,9,13,73.0,1222.0,912,108,343,451,1581.0,82,5.24,53,338,2262,9.5
14677,Jyrki Lumme,2005-06,39.0,18,17,73,73,6,11,17,72.0,1505.0,985,114,354,468,1653.0,82,5.31,60,363,2326,9.4
14678,Jyrki Seppa,1986-87,25.0,4,2,13,13,0,2,2,7.0,,13,0,2,2,7.0,80,7.89,74,336,2448,12.9
14679,Kaapo Kakko,2022-23,21.0,4,23,66,66,10,13,23,109.0,942.0,66,10,13,23,109.0,70,5.96,42,208,2192,9.5
14680,Kael Mouillierat,2017-18,30.0,4,2,6,6,1,1,2,1.0,52.0,6,1,1,2,1.0,82,5.32,47,251,2453,8.9
14681,Kael Mouillierat,2018-19,31.0,5,0,1,1,0,0,0,1.0,11.0,7,1,1,2,2.0,82,5.34,48,255,2438,9.0
14682,Kai Nurminen,1999-00,30.0,4,27,67,67,16,11,27,112.0,,67,16,11,27,112.0,82,5.83,55,336,2444,9.8
14683,Kai Nurminen,2003-04,34.0,5,1,2,2,1,0,1,1.0,31.0,69,17,11,28,113.0,82,5.51,63,376,2272,9.9
14684,Kai Suikkanen,1984-85,25.0,4,0,1,1,0,0,0,0.0,,1,0,0,0,0.0,80,8.03,73,320,2489,12.9
14685,Kai Suikkanen,1985-86,26.0,5,0,1,1,0,0,0,1.0,,2,0,0,0,1.0,80,7.73,71,310,2444,12.7
14686,Kailer Yamamoto,2020-21,22.0,4,3,9,9,0,3,3,23.0,136.0,9,0,3,3,23.0,82,5.86,50,250,2620,9.2
14687,Kailer Yamamoto,2021-22,23.0,5,2,17,17,1,1,2,13.0,222.0,26,1,4,5,36.0,82,5.96,47,239,2579,9.5
14688,Kailer Yamamoto,2022-23,24.0,6,26,27,27,11,15,26,44.0,469.0,53,12,19,31,80.0,70,5.96,42,208,2192,9.5
14689,Kale Clague,2022-23,24.0,4,0,4,4,0,0,0,2.0,58.0,4,0,0,0,2.0,70,5.96,42,208,2192,9.5
14690,Kalle Kossila,2019-20,26.0,4,0,1,1,0,0,0,1.0,7.0,1,0,0,0,1.0,82,5.45,47,245,2478,9.0
14691,Kalle Kossila,2020-21,27.0,5,2,10,10,1,1,2,9.0,91.0,11,1,1,2,10.0,82,5.86,50,250,2620,9.2
14692,Kalle Kossila,2021-22,28.0,6,1,8,8,1,0,1,11.0,82.0,19,2,1,3,21.0,82,5.96,47,239,2579,9.5
14693,Kamil Kreps,2009-10,25.0,4,2,14,14,1,1,2,20.0,157.0,14,1,1,2,20.0,82,5.76,70,398,2426,9.7
14694,Kamil Kreps,2010-11,26.0,5,25,76,76,8,17,25,99.0,986.0,90,9,18,27,119.0,82,5.44,62,351,2383,9.4
14695,Kamil Kreps,2011-12,27.0,6,19,66,66,4,15,19,77.0,922.0,156,13,33,46,196.0,82,5.7,65,341,2477,9.4
14696,Kamil Kreps,2012-13,28.0,7,14,76,76,5,9,14,83.0,966.0,232,18,42,60,279.0,82,5.53,56,304,2486,9.1
14697,Kamil Piros,2004-05,26.0,4,1,8,8,0,1,1,4.0,98.0,8,0,1,1,4.0,82,5.24,53,338,2262,9.5
14698,Kamil Piros,2005-06,27.0,5,5,3,3,3,2,5,8.0,51.0,11,3,3,6,12.0,82,5.31,60,363,2326,9.4
14699,Kamil Piros,2006-07,28.0,6,2,17,17,1,1,2,11.0,160.0,28,4,4,8,23.0,82,5.14,57,348,2300,9.2
14700,Karel Betik,2001-02,23.0,4,2,3,3,0,2,2,2.0,40.0,3,0,2,2,2.0,82,5.27,57,359,2285,9.4
14701,Karel Pilar,2004-05,27.0,4,4,23,23,1,3,4,32.0,369.0,23,1,3,4,32.0,82,5.24,53,338,2262,9.5
14702,Karel Pilar,2005-06,28.0,5,7,17,17,3,4,7,22.0,314.0,40,4,7,11,54.0,82,5.31,60,363,2326,9.4
14703,Karel Pilar,2006-07,29.0,6,19,50,50,2,17,19,74.0,903.0,90,6,24,30,128.0,82,5.14,57,348,2300,9.2
14704,Karel Rachunek,2002-03,23.0,4,0,6,6,0,0,0,3.0,48.0,6,0,0,0,3.0,82,5.49,53,331,2294,9.8
14705,Karel Rachunek,2003-04,24.0,5,33,71,71,3,30,33,77.0,1483.0,77,3,30,33,80.0,82,5.51,63,376,2272,9.9
14706,Karel Rachunek,2004-05,25.0,6,18,51,51,3,15,18,55.0,985.0,128,6,45,51,135.0,82,5.24,53,338,2262,9.5
14707,Karel Rachunek,2005-06,26.0,7,29,58,58,4,25,29,110.0,1262.0,186,10,70,80,245.0,82,5.31,60,363,2326,9.4
14708,Karel Rachunek,2006-07,27.0,8,21,72,72,2,19,21,120.0,1412.0,258,12,89,101,365.0,82,5.14,57,348,2300,9.2
14709,Karel Rachunek,2009-10,30.0,9,26,66,66,6,20,26,99.0,1279.0,324,18,109,127,464.0,82,5.76,70,398,2426,9.7
14710,Karel Rachunek,2010-11,31.0,10,13,47,47,4,9,13,68.0,911.0,371,22,118,140,532.0,82,5.44,62,351,2383,9.4
14711,Kari Eloranta,1984-85,28.0,4,13,31,31,1,12,13,33.0,,31,1,12,13,33.0,80,8.03,73,320,2489,12.9
14712,Kari Eloranta,1985-86,29.0,5,44,80,80,4,40,44,68.0,,111,5,52,57,101.0,80,7.73,71,310,2444,12.7
14713,Kari Eloranta,1986-87,30.0,6,39,78,78,5,34,39,59.0,,189,10,86,96,160.0,80,7.89,74,336,2448,12.9
14714,Kari Eloranta,1987-88,31.0,7,13,65,65,2,11,13,46.0,,254,12,97,109,206.0,80,7.77,71,321,2447,12.7
14715,Kari Eloranta,1989-90,33.0,8,7,13,13,1,6,7,11.0,,267,13,103,116,217.0,80,7.34,72,344,2400,12.2
14716,Kari Haakana,2005-06,32.0,4,0,13,13,0,0,0,2.0,103.0,13,0,0,0,2.0,82,5.31,60,363,2326,9.4
14717,Kari Jalonen,1985-86,26.0,4,12,25,25,9,3,12,32.0,,25,9,3,12,32.0,80,7.73,71,310,2444,12.7
14718,Kari Jalonen,1986-87,27.0,5,3,12,12,0,3,3,4.0,,37,9,6,15,36.0,80,7.89,74,336,2448,12.9
14719,Kari Makkonen,1982-83,28.0,4,4,9,9,2,2,4,11.0,,9,2,2,4,11.0,80,7.03,61,280,2352,12.0
14720,Karl Alzner,2011-12,23.0,4,5,30,30,1,4,5,31.0,583.0,30,1,4,5,31.0,82,5.7,65,341,2477,9.4
14721,Karl Alzner,2012-13,24.0,5,5,21,21,0,5,5,16.0,344.0,51,1,9,10,47.0,82,5.53,56,304,2486,9.1
14722,Karl Alzner,2013-14,25.0,6,12,82,82,2,10,12,64.0,1641.0,133,3,19,22,111.0,82,5.46,52,291,2492,9.0
14723,Karl Alzner,2014-15,26.0,7,17,82,82,1,16,17,56.0,1712.0,215,4,35,39,167.0,82,5.32,47,271,2439,8.9
14724,Karl Alzner,2015-16,27.0,8,5,48,48,1,4,5,39.0,1006.0,263,5,39,44,206.0,48,5.31,29,160,1399,9.1
14725,Karl Alzner,2016-17,28.0,9,18,82,82,2,16,18,95.0,1684.0,345,7,55,62,301.0,82,5.34,48,269,2463,8.9
14726,Karl Alzner,2017-18,29.0,10,21,82,82,5,16,21,72.0,1593.0,427,12,71,83,373.0,82,5.32,47,251,2453,8.9
14727,Karl Alzner,2018-19,30.0,11,21,82,82,4,17,21,75.0,1753.0,509,16,88,104,448.0,82,5.34,48,255,2438,9.0
14728,Karl Alzner,2019-20,31.0,12,13,82,82,3,10,13,81.0,1623.0,591,19,98,117,529.0,82,5.45,47,245,2478,9.0
14729,Karl Alzner,2020-21,32.0,13,12,82,82,1,11,12,84.0,1647.0,673,20,109,129,613.0,82,5.86,50,250,2620,9.2
14730,Karl Alzner,2021-22,33.0,14,1,9,9,0,1,1,8.0,156.0,682,20,110,130,621.0,82,5.96,47,239,2579,9.5
14731,Karl Alzner,2022-23,34.0,15,0,4,4,0,0,0,4.0,56.0,686,20,110,130,625.0,70,5.96,42,208,2192,9.5
14732,Karl Dykhuis,1994-95,22.0,4,4,6,6,1,3,4,12.0,,6,1,3,4,12.0,80,6.96,77,402,2440,11.4
14733,Karl Dykhuis,1995-96,23.0,5,5,12,12,0,5,5,10.0,,18,1,8,9,22.0,84,7.25,87,443,2603,11.7
14734,Karl Dykhuis,1997-98,25.0,6,8,33,33,2,6,8,46.0,,51,3,14,17,68.0,48,5.97,37,209,1408,10.2
14735,Karl Dykhuis,1998-99,26.0,7,20,82,82,5,15,20,104.0,,133,8,29,37,172.0,82,6.29,74,413,2481,10.4
14736,Karl Dykhuis,1999-00,27.0,8,19,62,62,4,15,19,101.0,,195,12,44,56,273.0,82,5.83,55,336,2444,9.8
14737,Karl Dykhuis,2000-01,28.0,9,14,78,78,5,9,14,91.0,,273,17,53,70,364.0,82,5.28,57,380,2242,9.6
14738,Karl Dykhuis,2001-02,29.0,10,9,78,78,4,5,9,88.0,1489.0,351,21,58,79,452.0,82,5.27,57,359,2285,9.4
14739,Karl Dykhuis,2002-03,30.0,11,20,72,72,7,13,20,69.0,1406.0,423,28,71,99,521.0,82,5.49,53,331,2294,9.8
14740,Karl Dykhuis,2003-04,31.0,12,17,67,67,8,9,17,66.0,1049.0,490,36,80,116,587.0,82,5.51,63,376,2272,9.9
14741,Karl Dykhuis,2004-05,32.0,13,12,80,80,5,7,12,85.0,1592.0,570,41,87,128,672.0,82,5.24,53,338,2262,9.5
14742,Karl Dykhuis,2005-06,33.0,14,5,65,65,1,4,5,24.0,975.0,635,42,91,133,696.0,82,5.31,60,363,2326,9.4
14743,Karl Dykhuis,2006-07,34.0,15,0,9,9,0,0,0,6.0,117.0,644,42,91,133,702.0,82,5.14,57,348,2300,9.2
14744,Karl Stewart,2006-07,23.0,4,1,5,5,0,1,1,2.0,22.0,5,0,1,1,2.0,82,5.14,57,348,2300,9.2
14745,Karl Stewart,2008-09,25.0,5,0,8,8,0,0,0,6.0,45.0,13,0,1,1,8.0,82,6.05,85,480,2458,10.1
14746,Karl Stewart,2009-10,26.0,6,5,47,47,2,3,5,21.0,407.0,60,2,4,6,29.0,82,5.76,70,398,2426,9.7
14747,Karl Stewart,2010-11,27.0,7,0,9,9,0,0,0,2.0,37.0,69,2,4,6,31.0,82,5.44,62,351,2383,9.4
14748,Karl Stollery,2016-17,29.0,4,0,2,2,0,0,0,1.0,13.0,2,0,0,0,1.0,82,5.34,48,269,2463,8.9
14749,Karl Stollery,2017-18,30.0,5,0,10,10,0,0,0,9.0,147.0,12,0,0,0,10.0,82,5.32,47,251,2453,8.9
14750,Karl Stollery,2019-20,32.0,6,3,11,11,0,3,3,11.0,186.0,23,0,3,3,21.0,82,5.45,47,245,2478,9.0
14751,Karlis Skrastins,2001-02,27.0,4,1,2,2,0,1,1,0.0,24.0,2,0,1,1,0.0,82,5.27,57,359,2285,9.4
14752,Karlis Skrastins,2002-03,28.0,5,11,59,59,5,6,11,51.0,1230.0,61,5,7,12,51.0,82,5.49,53,331,2294,9.8
14753,Karlis Skrastins,2003-04,29.0,6,12,82,82,1,11,12,66.0,1574.0,143,6,18,24,117.0,82,5.51,63,376,2272,9.9
14754,Karlis Skrastins,2004-05,30.0,7,17,82,82,4,13,17,84.0,1679.0,225,10,31,41,201.0,82,5.24,53,338,2262,9.5
14755,Karlis Skrastins,2005-06,31.0,8,13,82,82,3,10,13,86.0,1664.0,307,13,41,54,287.0,82,5.31,60,363,2326,9.4
14756,Karlis Skrastins,2006-07,32.0,9,13,82,82,5,8,13,102.0,1789.0,389,18,49,67,389.0,82,5.14,57,348,2300,9.2
14757,Karlis Skrastins,2008-09,34.0,10,14,82,82,3,11,14,58.0,1789.0,471,21,60,81,447.0,82,6.05,85,480,2458,10.1
14758,Karlis Skrastins,2009-10,35.0,11,11,68,68,0,11,11,65.0,1443.0,539,21,71,92,512.0,82,5.76,70,398,2426,9.7
14759,Karlis Skrastins,2010-11,36.0,12,5,60,60,2,3,5,45.0,1116.0,599,23,74,97,557.0,82,5.44,62,351,2383,9.4
14760,Karlis Skrastins,2011-12,37.0,13,18,80,80,4,14,18,55.0,1645.0,679,27,88,115,612.0,82,5.7,65,341,2477,9.4
14761,Karlis Skrastins,2012-13,38.0,14,13,79,79,2,11,13,53.0,1546.0,758,29,99,128,665.0,82,5.53,56,304,2486,9.1
14762,Karlis Skrastins,2013-14,39.0,15,8,74,74,3,5,8,30.0,1328.0,832,32,104,136,695.0,82,5.46,52,291,2492,9.0
14763,Karson Kuhlman,2021-22,26.0,4,5,11,11,3,2,5,15.0,134.0,11,3,2,5,15.0,82,5.96,47,239,2579,9.5
14764,Karson Kuhlman,2022-23,27.0,5,6,25,25,1,5,6,45.0,313.0,36,4,7,11,60.0,70,5.96,42,208,2192,9.5
14765,Kaspars Astashenko,2002-03,27.0,4,1,8,8,0,1,1,3.0,134.0,8,0,1,1,3.0,82,5.49,53,331,2294,9.8
14766,Kaspars Astashenko,2003-04,28.0,5,2,15,15,1,1,2,4.0,103.0,23,1,2,3,7.0,82,5.51,63,376,2272,9.9
14767,Kaspars Daugavins,2012-13,24.0,4,0,1,1,0,0,0,2.0,8.0,1,0,0,0,2.0,82,5.53,56,304,2486,9.1
14768,Kaspars Daugavins,2014-15,26.0,5,11,65,65,5,6,11,77.0,737.0,66,5,6,11,79.0,82,5.32,47,271,2439,8.9
14769,Kaspars Daugavins,2015-16,27.0,6,4,25,25,1,3,4,36.0,275.0,91,6,9,15,115.0,48,5.31,29,160,1399,9.1
14770,Kasperi Kapanen,2018-19,22.0,4,0,9,9,0,0,0,14.0,133.0,9,0,0,0,14.0,82,5.34,48,255,2438,9.0
14771,Kasperi Kapanen,2019-20,23.0,5,1,8,8,1,0,1,11.0,86.0,17,1,0,1,25.0,82,5.45,47,245,2478,9.0
14772,Kasperi Kapanen,2020-21,24.0,6,9,38,38,7,2,9,55.0,427.0,55,8,2,10,80.0,82,5.86,50,250,2620,9.2
14773,Kasperi Kapanen,2021-22,25.0,7,44,78,78,20,24,44,174.0,1296.0,133,28,26,54,254.0,82,5.96,47,239,2579,9.5
14774,Kasperi Kapanen,2022-23,26.0,8,36,69,69,13,23,36,121.0,1090.0,202,41,49,90,375.0,70,5.96,42,208,2192,9.5
14775,Keaton Ellerby,2012-13,24.0,4,0,22,22,0,0,0,5.0,119.0,22,0,0,0,5.0,82,5.53,56,304,2486,9.1
14776,Keaton Ellerby,2013-14,25.0,5,12,54,54,2,10,12,56.0,869.0,76,2,10,12,61.0,82,5.46,52,291,2492,9.0
14777,Keaton Ellerby,2014-15,26.0,6,5,40,40,0,5,5,45.0,616.0,116,2,15,17,106.0,82,5.32,47,271,2439,8.9
14778,Keaton Ellerby,2015-16,27.0,7,3,44,44,0,3,3,23.0,637.0,160,2,18,20,129.0,48,5.31,29,160,1399,9.1
14779,Keaton Ellerby,2016-17,28.0,8,6,51,51,2,4,6,33.0,709.0,211,4,22,26,162.0,82,5.34,48,269,2463,8.9
14780,Keaton Ellerby,2017-18,29.0,9,1,1,1,0,1,1,0.0,17.0,212,4,23,27,162.0,82,5.32,47,251,2453,8.9
14781,Keegan Kolesar,2022-23,25.0,4,0,1,1,0,0,0,1.0,12.0,1,0,0,0,1.0,70,5.96,42,208,2192,9.5
14782,Keegan Lowe,2017-18,24.0,4,0,2,2,0,0,0,0.0,28.0,2,0,0,0,0.0,82,5.32,47,251,2453,8.9
14783,Keegan Lowe,2020-21,27.0,5,0,2,2,0,0,0,4.0,28.0,4,0,0,0,4.0,82,5.86,50,250,2620,9.2
14784,Keith Acton,1982-83,24.0,4,1,2,2,0,1,1,1.0,,2,0,1,1,1.0,80,7.03,61,280,2352,12.0
14785,Keith Acton,1983-84,25.0,5,39,61,61,15,24,39,101.0,,63,15,25,40,102.0,80,7.69,77,340,2441,12.6
14786,Keith Acton,1984-85,26.0,6,88,78,78,36,52,88,218.0,,141,51,77,128,320.0,80,8.03,73,320,2489,12.9
14787,Keith Acton,1985-86,27.0,7,50,78,78,24,26,50,154.0,,219,75,103,178,474.0,80,7.73,71,310,2444,12.7
14788,Keith Acton,1986-87,28.0,8,65,71,71,20,45,65,165.0,,290,95,148,243,639.0,80,7.89,74,336,2448,12.9
14789,Keith Acton,1987-88,29.0,9,58,78,78,20,38,58,168.0,,368,115,186,301,807.0,80,7.77,71,321,2447,12.7
14790,Keith Acton,1988-89,30.0,10,58,79,79,26,32,58,169.0,,447,141,218,359,976.0,80,7.94,82,370,2484,12.8
14791,Keith Acton,1989-90,31.0,11,45,78,78,16,29,45,126.0,,525,157,247,404,1102.0,80,7.34,72,344,2400,12.2
14792,Keith Acton,1990-91,32.0,12,28,72,72,11,17,28,75.0,,597,168,264,432,1177.0,80,7.43,89,437,2435,12.2
14793,Keith Acton,1991-92,33.0,13,39,71,71,14,25,39,112.0,,668,182,289,471,1289.0,80,7.48,85,403,2430,12.3
14794,Keith Acton,1992-93,34.0,14,27,69,69,13,14,27,94.0,,737,195,303,498,1383.0,80,7.37,76,367,2421,12.2
14795,Keith Acton,1993-94,35.0,15,37,76,76,14,23,37,120.0,,813,209,326,535,1503.0,80,6.91,71,366,2385,11.6
14796,Keith Acton,1994-95,36.0,16,17,50,50,7,10,17,79.0,,863,216,336,552,1582.0,80,6.96,77,402,2440,11.4
14797,Keith Acton,1995-96,37.0,17,23,83,83,8,15,23,74.0,,946,224,351,575,1656.0,84,7.25,87,443,2603,11.7
14798,Keith Acton,1996-97,38.0,18,9,77,77,2,7,9,35.0,,1023,226,358,584,1691.0,84,6.48,76,407,2545,10.7
14799,Keith Aldridge,2002-03,29.0,4,0,4,4,0,0,0,6.0,44.0,4,0,0,0,6.0,82,5.49,53,331,2294,9.8
14800,Keith Aucoin,2008-09,30.0,4,1,7,7,0,1,1,3.0,37.0,7,0,1,1,3.0,82,6.05,85,480,2458,10.1
14801,Keith Aucoin,2009-10,31.0,5,1,8,8,0,1,1,6.0,50.0,15,0,2,2,9.0,82,5.76,70,398,2426,9.7
14802,Keith Aucoin,2010-11,32.0,6,13,38,38,5,8,13,65.0,511.0,53,5,10,15,74.0,82,5.44,62,351,2383,9.4
14803,Keith Aucoin,2011-12,33.0,7,6,12,12,2,4,6,15.0,124.0,65,7,14,21,89.0,82,5.7,65,341,2477,9.4
14804,Keith Aucoin,2012-13,34.0,8,5,9,9,1,4,5,4.0,79.0,74,8,18,26,93.0,82,5.53,56,304,2486,9.1
14805,Keith Aucoin,2013-14,35.0,9,0,1,1,0,0,0,0.0,12.0,75,8,18,26,93.0,82,5.46,52,291,2492,9.0
14806,Keith Aucoin,2014-15,36.0,10,11,27,27,3,8,11,21.0,299.0,102,11,26,37,114.0,82,5.32,47,271,2439,8.9
14807,Keith Aucoin,2015-16,37.0,11,12,41,41,6,6,12,50.0,512.0,143,17,32,49,164.0,48,5.31,29,160,1399,9.1
14808,Keith Aucoin,2016-17,38.0,12,0,2,2,0,0,0,1.0,27.0,145,17,32,49,165.0,82,5.34,48,269,2463,8.9
14809,Keith Aulie,2013-14,24.0,4,2,40,40,2,0,2,32.0,765.0,40,2,0,2,32.0,82,5.46,52,291,2492,9.0
14810,Keith Aulie,2014-15,25.0,5,3,36,36,0,3,3,18.0,484.0,76,2,3,5,50.0,82,5.32,47,271,2439,8.9
14811,Keith Aulie,2015-16,26.0,6,7,45,45,2,5,7,37.0,577.0,121,4,8,12,87.0,48,5.31,29,160,1399,9.1
14812,Keith Aulie,2016-17,27.0,7,1,15,15,0,1,1,6.0,147.0,136,4,9,13,93.0,82,5.34,48,269,2463,8.9
14813,Keith Aulie,2017-18,28.0,8,1,31,31,0,1,1,25.0,443.0,167,4,10,14,118.0,82,5.32,47,251,2453,8.9
14814,Keith Ballard,2008-09,26.0,4,39,82,82,8,31,39,102.0,1638.0,82,8,31,39,102.0,82,6.05,85,480,2458,10.1
14815,Keith Ballard,2009-10,27.0,5,27,69,69,5,22,27,79.0,1518.0,151,13,53,66,181.0,82,5.76,70,398,2426,9.7
14816,Keith Ballard,2010-11,28.0,6,21,82,82,6,15,21,105.0,1744.0,233,19,68,87,286.0,82,5.44,62,351,2383,9.4
14817,Keith Ballard,2011-12,29.0,7,34,82,82,6,28,34,106.0,1835.0,315,25,96,121,392.0,82,5.7,65,341,2477,9.4
14818,Keith Ballard,2012-13,30.0,8,28,82,82,8,20,28,90.0,1837.0,397,33,116,149,482.0,82,5.53,56,304,2486,9.1
14819,Keith Ballard,2013-14,31.0,9,7,65,65,2,5,7,53.0,1034.0,462,35,121,156,535.0,82,5.46,52,291,2492,9.0
14820,Keith Ballard,2014-15,32.0,10,7,47,47,1,6,7,41.0,731.0,509,36,127,163,576.0,82,5.32,47,271,2439,8.9
14821,Keith Ballard,2015-16,33.0,11,2,36,36,0,2,2,35.0,557.0,545,36,129,165,611.0,48,5.31,29,160,1399,9.1
14822,Keith Ballard,2016-17,34.0,12,9,45,45,2,7,9,29.0,612.0,590,38,136,174,640.0,82,5.34,48,269,2463,8.9
14823,Keith Ballard,2017-18,35.0,13,1,14,14,0,1,1,5.0,169.0,604,38,137,175,645.0,82,5.32,47,251,2453,8.9
14824,Keith Brown,1982-83,22.0,4,20,76,76,2,18,20,105.0,,76,2,18,20,105.0,80,7.03,61,280,2352,12.0
14825,Keith Brown,1983-84,23.0,5,43,80,80,9,34,43,130.0,,156,11,52,63,235.0,80,7.69,77,340,2441,12.6
14826,Keith Brown,1984-85,24.0,6,24,33,33,4,20,24,87.0,,189,15,72,87,322.0,80,8.03,73,320,2489,12.9
14827,Keith Brown,1985-86,25.0,7,31,50,50,4,27,31,115.0,,239,19,99,118,437.0,80,7.73,71,310,2444,12.7
14828,Keith Brown,1986-87,26.0,8,35,74,74,10,25,35,144.0,,313,29,124,153,581.0,80,7.89,74,336,2448,12.9
14829,Keith Brown,1987-88,27.0,9,23,56,56,1,22,23,100.0,,369,30,146,176,681.0,80,7.77,71,321,2447,12.7
14830,Keith Brown,1988-89,28.0,10,40,70,70,11,29,40,151.0,,439,41,175,216,832.0,80,7.94,82,370,2484,12.8
14831,Keith Brown,1989-90,29.0,11,27,73,73,4,23,27,99.0,,512,45,198,243,931.0,80,7.34,72,344,2400,12.2
14832,Keith Brown,1990-91,30.0,12,9,24,24,3,6,9,39.0,,536,48,204,252,970.0,80,7.43,89,437,2435,12.2
14833,Keith Brown,1991-92,31.0,13,18,74,74,2,16,18,105.0,,610,50,220,270,1075.0,80,7.48,85,403,2430,12.3
14834,Keith Brown,1992-93,32.0,14,25,67,67,5,20,25,111.0,,677,55,240,295,1186.0,80,7.37,76,367,2421,12.2
14835,Keith Brown,1993-94,33.0,15,11,45,45,1,10,11,71.0,,722,56,250,306,1257.0,80,6.91,71,366,2385,11.6
14836,Keith Brown,1994-95,34.0,16,16,57,57,6,10,16,105.0,,779,62,260,322,1362.0,80,6.96,77,402,2440,11.4
14837,Keith Brown,1995-96,35.0,17,8,33,33,2,6,8,47.0,,812,64,266,330,1409.0,84,7.25,87,443,2603,11.7
14838,Keith Brown,1996-97,36.0,18,12,51,51,4,8,12,52.0,,863,68,274,342,1461.0,84,6.48,76,407,2545,10.7
14839,Keith Brown,1997-98,37.0,19,0,13,13,0,0,0,10.0,,876,68,274,342,1471.0,48,5.97,37,209,1408,10.2
14840,Keith Carney,1994-95,24.0,4,3,14,14,1,2,3,17.0,,14,1,2,3,17.0,80,6.96,77,402,2440,11.4
14841,Keith Carney,1995-96,25.0,5,6,30,30,2,4,6,26.0,,44,3,6,9,43.0,84,7.25,87,443,2603,11.7
14842,Keith Carney,1996-97,26.0,6,12,37,37,4,8,12,37.0,,81,7,14,21,80.0,84,6.48,76,407,2545,10.7
14843,Keith Carney,1997-98,27.0,7,1,18,18,1,0,1,14.0,,99,8,14,22,94.0,48,5.97,37,209,1408,10.2
14844,Keith Carney,1998-99,28.0,8,19,82,82,5,14,19,69.0,,181,13,28,41,163.0,82,6.29,74,413,2481,10.4
14845,Keith Carney,1999-00,29.0,9,18,81,81,3,15,18,77.0,,262,16,43,59,240.0,82,5.83,55,336,2444,9.8
14846,Keith Carney,2000-01,30.0,10,22,80,80,3,19,22,71.0,,342,19,62,81,311.0,82,5.28,57,380,2242,9.6
14847,Keith Carney,2001-02,31.0,11,16,82,82,2,14,16,62.0,1867.0,424,21,76,97,373.0,82,5.27,57,359,2285,9.4
14848,Keith Carney,2002-03,32.0,12,24,82,82,4,20,24,73.0,1738.0,506,25,96,121,446.0,82,5.49,53,331,2294,9.8
14849,Keith Carney,2003-04,33.0,13,16,82,82,2,14,16,65.0,1712.0,588,27,110,137,511.0,82,5.51,63,376,2272,9.9
14850,Keith Carney,2004-05,34.0,14,14,60,60,5,9,14,66.0,1247.0,648,32,119,151,577.0,82,5.24,53,338,2262,9.5
14851,Keith Carney,2005-06,35.0,15,22,81,81,4,18,22,87.0,1828.0,729,36,137,173,664.0,82,5.31,60,363,2326,9.4
14852,Keith Carney,2006-07,36.0,16,7,69,69,2,5,7,58.0,1498.0,798,38,142,180,722.0,82,5.14,57,348,2300,9.2
14853,Keith Carney,2008-09,38.0,17,20,79,79,2,18,20,85.0,1619.0,877,40,160,200,807.0,82,6.05,85,480,2458,10.1
14854,Keith Carney,2009-10,39.0,18,17,80,80,4,13,17,31.0,1242.0,957,44,173,217,838.0,82,5.76,70,398,2426,9.7
14855,Keith Carney,2010-11,40.0,19,11,61,61,1,10,11,27.0,816.0,1018,45,183,228,865.0,82,5.44,62,351,2383,9.4
14856,Keith Crowder,1983-84,25.0,4,25,47,47,13,12,25,69.0,,47,13,12,25,69.0,80,7.69,77,340,2441,12.6
14857,Keith Crowder,1984-85,26.0,5,44,71,71,23,21,44,130.0,,118,36,33,69,199.0,80,8.03,73,320,2489,12.9
14858,Keith Crowder,1985-86,27.0,6,74,74,74,35,39,74,158.0,,192,71,72,143,357.0,80,7.73,71,310,2444,12.7
14859,Keith Crowder,1986-87,28.0,7,52,63,63,24,28,52,110.0,,255,95,100,195,467.0,80,7.89,74,336,2448,12.9
14860,Keith Crowder,1987-88,29.0,8,70,79,79,32,38,70,173.0,,334,127,138,265,640.0,80,7.77,71,321,2447,12.7
14861,Keith Crowder,1988-89,30.0,9,84,78,78,38,46,84,181.0,,412,165,184,349,821.0,80,7.94,82,370,2484,12.8
14862,Keith Crowder,1989-90,31.0,10,52,58,58,22,30,52,114.0,,470,187,214,401,935.0,80,7.34,72,344,2400,12.2
14863,Keith Crowder,1990-91,32.0,11,43,68,68,17,26,43,123.0,,538,204,240,444,1058.0,80,7.43,89,437,2435,12.2
14864,Keith Crowder,1991-92,33.0,12,33,69,69,15,18,33,121.0,,607,219,258,477,1179.0,80,7.48,85,403,2430,12.3
14865,Keith Crowder,1992-93,34.0,13,17,55,55,4,13,17,48.0,,662,223,271,494,1227.0,80,7.37,76,367,2421,12.2
14866,Keith Hanson,1986-87,29.0,4,2,25,25,0,2,2,19.0,,25,0,2,2,19.0,80,7.89,74,336,2448,12.9
14867,Keith Jones,1995-96,27.0,4,26,71,71,12,14,26,73.0,,71,12,14,26,73.0,84,7.25,87,443,2603,11.7
14868,Keith Jones,1996-97,28.0,5,35,68,68,16,19,35,97.0,,139,28,33,61,170.0,84,6.48,76,407,2545,10.7
14869,Keith Jones,1997-98,29.0,6,20,40,40,14,6,20,85.0,,179,42,39,81,255.0,48,5.97,37,209,1408,10.2
14870,Keith Jones,1998-99,30.0,7,41,68,68,18,23,41,155.0,,247,60,62,122,410.0,82,6.29,74,413,2481,10.4
14871,Keith Jones,1999-00,31.0,8,48,78,78,25,23,48,170.0,,325,85,85,170,580.0,82,5.83,55,336,2444,9.8
14872,Keith Jones,2000-01,32.0,9,10,23,23,3,7,10,31.0,,348,88,92,180,611.0,82,5.28,57,380,2242,9.6
14873,Keith Jones,2001-02,33.0,10,53,78,78,20,33,53,135.0,1287.0,426,108,125,233,746.0,82,5.27,57,359,2285,9.4
14874,Keith Jones,2002-03,34.0,11,25,57,57,9,16,25,92.0,778.0,483,117,141,258,838.0,82,5.49,53,331,2294,9.8
14875,Keith Jones,2003-04,35.0,12,0,8,8,0,0,0,11.0,88.0,491,117,141,258,849.0,82,5.51,63,376,2272,9.9
14876,Keith Osborne,1992-93,23.0,4,2,5,5,0,2,2,4.0,,5,0,2,2,4.0,80,7.37,76,367,2421,12.2
14877,Keith Osborne,1995-96,26.0,5,2,11,11,1,1,2,11.0,,16,1,3,4,15.0,84,7.25,87,443,2603,11.7
14878,Keith Primeau,1993-94,22.0,4,15,58,58,3,12,15,33.0,,58,3,12,15,33.0,80,6.91,71,366,2385,11.6
14879,Keith Primeau,1994-95,23.0,5,16,35,35,6,10,16,27.0,,93,9,22,31,60.0,80,6.96,77,402,2440,11.4
14880,Keith Primeau,1995-96,24.0,6,32,73,73,15,17,32,75.0,,166,24,39,63,135.0,84,7.25,87,443,2603,11.7
14881,Keith Primeau,1996-97,25.0,7,73,78,78,31,42,73,155.0,,244,55,81,136,290.0,84,6.48,76,407,2545,10.7
14882,Keith Primeau,1997-98,26.0,8,42,45,45,15,27,42,96.0,,289,70,108,178,386.0,48,5.97,37,209,1408,10.2
14883,Keith Primeau,1998-99,27.0,9,52,74,74,27,25,52,150.0,,363,97,133,230,536.0,82,6.29,74,413,2481,10.4
14884,Keith Primeau,1999-00,28.0,10,51,75,75,26,25,51,169.0,,438,123,158,281,705.0,82,5.83,55,336,2444,9.8
14885,Keith Primeau,2000-01,29.0,11,63,81,81,26,37,63,180.0,,519,149,195,344,885.0,82,5.28,57,380,2242,9.6
14886,Keith Primeau,2001-02,30.0,12,62,78,78,30,32,62,178.0,1665.0,597,179,227,406,1063.0,82,5.27,57,359,2285,9.4
14887,Keith Primeau,2002-03,31.0,13,17,23,23,7,10,17,51.0,406.0,620,186,237,423,1114.0,82,5.49,53,331,2294,9.8
14888,Keith Primeau,2003-04,32.0,14,73,71,71,34,39,73,165.0,1418.0,691,220,276,496,1279.0,82,5.51,63,376,2272,9.9
14889,Keith Primeau,2004-05,33.0,15,48,75,75,19,29,48,151.0,1350.0,766,239,305,544,1430.0,82,5.24,53,338,2262,9.5
14890,Keith Primeau,2005-06,34.0,16,46,80,80,19,27,46,171.0,1542.0,846,258,332,590,1601.0,82,5.31,60,363,2326,9.4
14891,Keith Primeau,2006-07,35.0,17,22,54,54,7,15,22,86.0,897.0,900,265,347,612,1687.0,82,5.14,57,348,2300,9.2
14892,Keith Primeau,2008-09,37.0,18,7,9,9,1,6,7,12.0,143.0,909,266,353,619,1699.0,82,6.05,85,480,2458,10.1
14893,Keith Redmond,1996-97,24.0,4,1,12,12,1,0,1,9.0,,12,1,0,1,9.0,84,6.48,76,407,2545,10.7
14894,Keith Tkachuk,1994-95,22.0,4,8,17,17,3,5,8,22.0,,17,3,5,8,22.0,80,6.96,77,402,2440,11.4
14895,Keith Tkachuk,1995-96,23.0,5,51,83,83,28,23,51,199.0,,100,31,28,59,221.0,84,7.25,87,443,2603,11.7
14896,Keith Tkachuk,1996-97,24.0,6,81,84,84,41,40,81,218.0,,184,72,68,140,439.0,84,6.48,76,407,2545,10.7
14897,Keith Tkachuk,1997-98,25.0,7,51,48,48,22,29,51,129.0,,232,94,97,191,568.0,48,5.97,37,209,1408,10.2
14898,Keith Tkachuk,1998-99,26.0,8,98,76,76,50,48,98,249.0,,308,144,145,289,817.0,82,6.29,74,413,2481,10.4
14899,Keith Tkachuk,1999-00,27.0,9,86,81,81,52,34,86,296.0,,389,196,179,375,1113.0,82,5.83,55,336,2444,9.8
14900,Keith Tkachuk,2000-01,28.0,10,66,69,69,40,26,66,232.0,,458,236,205,441,1345.0,82,5.28,57,380,2242,9.6
14901,Keith Tkachuk,2001-02,29.0,11,68,68,68,36,32,68,258.0,1427.0,526,272,237,509,1603.0,82,5.27,57,359,2285,9.4
14902,Keith Tkachuk,2002-03,30.0,12,43,50,50,22,21,43,183.0,967.0,576,294,258,552,1786.0,82,5.49,53,331,2294,9.8
14903,Keith Tkachuk,2003-04,31.0,13,79,76,76,35,44,79,271.0,1527.0,652,329,302,631,2057.0,82,5.51,63,376,2272,9.9
14904,Keith Tkachuk,2004-05,32.0,14,75,73,73,38,37,75,244.0,1433.0,725,367,339,706,2301.0,82,5.24,53,338,2262,9.5
14905,Keith Tkachuk,2005-06,33.0,15,55,56,56,31,24,55,185.0,1079.0,781,398,363,761,2486.0,82,5.31,60,363,2326,9.4
14906,Keith Tkachuk,2006-07,34.0,16,71,75,75,33,38,71,233.0,1474.0,856,431,401,832,2719.0,82,5.14,57,348,2300,9.2
14907,Keith Tkachuk,2008-09,36.0,17,36,41,41,15,21,36,133.0,798.0,897,446,422,868,2852.0,82,6.05,85,480,2458,10.1
14908,Keith Tkachuk,2009-10,37.0,18,58,79,79,27,31,58,196.0,1382.0,976,473,453,926,3048.0,82,5.76,70,398,2426,9.7
14909,Keith Tkachuk,2010-11,38.0,19,58,79,79,27,31,58,177.0,1331.0,1055,500,484,984,3225.0,82,5.44,62,351,2383,9.4
14910,Keith Tkachuk,2011-12,39.0,20,49,79,79,25,24,49,185.0,1340.0,1134,525,508,1033,3410.0,82,5.7,65,341,2477,9.4
14911,Keith Tkachuk,2012-13,40.0,21,32,67,67,13,19,32,120.0,905.0,1201,538,527,1065,3530.0,82,5.53,56,304,2486,9.1
14912,Keith Yandle,2009-10,23.0,4,2,7,7,0,2,2,10.0,141.0,7,0,2,2,10.0,82,5.76,70,398,2426,9.7
14913,Keith Yandle,2010-11,24.0,5,12,43,43,5,7,12,72.0,605.0,50,5,9,14,82.0,82,5.44,62,351,2383,9.4
14914,Keith Yandle,2011-12,25.0,6,30,69,69,4,26,30,118.0,1147.0,119,9,35,44,200.0,82,5.7,65,341,2477,9.4
14915,Keith Yandle,2012-13,26.0,7,41,82,82,12,29,41,145.0,1659.0,201,21,64,85,345.0,82,5.53,56,304,2486,9.1
14916,Keith Yandle,2013-14,27.0,8,59,82,82,11,48,59,199.0,1999.0,283,32,112,144,544.0,82,5.46,52,291,2492,9.0
14917,Keith Yandle,2014-15,28.0,9,43,82,82,11,32,43,196.0,1832.0,365,43,144,187,740.0,82,5.32,47,271,2439,8.9
14918,Keith Yandle,2015-16,29.0,10,30,48,48,10,20,30,130.0,1068.0,413,53,164,217,870.0,48,5.31,29,160,1399,9.1
14919,Keith Yandle,2016-17,30.0,11,53,82,82,8,45,53,241.0,1980.0,495,61,209,270,1111.0,82,5.34,48,269,2463,8.9
14920,Keith Yandle,2017-18,31.0,12,52,84,84,6,46,52,232.0,1925.0,579,67,255,322,1343.0,82,5.32,47,251,2453,8.9
14921,Keith Yandle,2018-19,32.0,13,47,82,82,5,42,47,160.0,1637.0,661,72,297,369,1503.0,82,5.34,48,255,2438,9.0
14922,Keith Yandle,2019-20,33.0,14,41,82,82,5,36,41,178.0,1807.0,743,77,333,410,1681.0,82,5.45,47,245,2478,9.0
14923,Keith Yandle,2020-21,34.0,15,56,82,82,8,48,56,179.0,2008.0,825,85,381,466,1860.0,82,5.86,50,250,2620,9.2
14924,Keith Yandle,2021-22,35.0,16,62,82,82,9,53,62,199.0,1840.0,907,94,434,528,2059.0,82,5.96,47,239,2579,9.5
14925,Keith Yandle,2022-23,36.0,17,45,69,69,5,40,45,129.0,1359.0,976,99,474,573,2188.0,70,5.96,42,208,2192,9.5
14926,Kellan Lain,2016-17,27.0,4,1,9,9,1,0,1,7.0,47.0,9,1,0,1,7.0,82,5.34,48,269,2463,8.9
14927,Kelly Buchberger,1990-91,24.0,4,1,19,19,1,0,1,10.0,,19,1,0,1,10.0,80,7.43,89,437,2435,12.2
14928,Kelly Buchberger,1991-92,25.0,5,14,66,66,5,9,14,57.0,,85,6,9,15,67.0,80,7.48,85,403,2430,12.3
14929,Kelly Buchberger,1992-93,26.0,6,8,55,55,2,6,8,35.0,,140,8,15,23,102.0,80,7.37,76,367,2421,12.2
14930,Kelly Buchberger,1993-94,27.0,7,4,64,64,3,1,4,54.0,,204,11,16,27,156.0,80,6.91,71,366,2385,11.6
14931,Kelly Buchberger,1994-95,28.0,8,44,79,79,20,24,44,90.0,,283,31,40,71,246.0,80,6.96,77,402,2440,11.4
14932,Kelly Buchberger,1995-96,29.0,9,30,83,83,12,18,30,92.0,,366,43,58,101,338.0,84,7.25,87,443,2603,11.7
14933,Kelly Buchberger,1996-97,30.0,10,21,84,84,3,18,21,93.0,,450,46,76,122,431.0,84,6.48,76,407,2545,10.7
14934,Kelly Buchberger,1997-98,31.0,11,24,48,48,7,17,24,73.0,,498,53,93,146,504.0,48,5.97,37,209,1408,10.2
14935,Kelly Buchberger,1998-99,32.0,12,25,82,82,11,14,25,119.0,,580,64,107,171,623.0,82,6.29,74,413,2481,10.4
14936,Kelly Buchberger,1999-00,33.0,13,38,81,81,8,30,38,78.0,,661,72,137,209,701.0,82,5.83,55,336,2444,9.8
14937,Kelly Buchberger,2000-01,34.0,14,23,82,82,6,17,23,86.0,,743,78,154,232,787.0,82,5.28,57,380,2242,9.6
14938,Kelly Buchberger,2001-02,35.0,15,8,52,52,4,4,8,29.0,614.0,795,82,158,240,816.0,82,5.27,57,359,2285,9.4
14939,Kelly Buchberger,2002-03,36.0,16,20,81,81,7,13,20,76.0,1303.0,876,89,171,260,892.0,82,5.49,53,331,2294,9.8
14940,Kelly Buchberger,2003-04,37.0,17,20,82,82,6,14,20,66.0,1183.0,958,95,185,280,958.0,82,5.51,63,376,2272,9.9
14941,Kelly Buchberger,2004-05,38.0,18,13,74,74,6,7,13,39.0,765.0,1032,101,192,293,997.0,82,5.24,53,338,2262,9.5
14942,Kelly Buchberger,2005-06,39.0,19,12,79,79,3,9,12,32.0,788.0,1111,104,201,305,1029.0,82,5.31,60,363,2326,9.4
14943,Kelly Buchberger,2006-07,40.0,20,4,71,71,1,3,4,34.0,735.0,1182,105,204,309,1063.0,82,5.14,57,348,2300,9.2
14944,Kelly Chase,1992-93,25.0,4,4,43,43,1,3,4,9.0,,43,1,3,4,9.0,80,7.37,76,367,2421,12.2
14945,Kelly Chase,1993-94,26.0,5,1,2,2,1,0,1,1.0,,45,2,3,5,10.0,80,6.91,71,366,2385,11.6
14946,Kelly Chase,1994-95,27.0,6,3,46,46,1,2,3,29.0,,91,3,5,8,39.0,80,6.96,77,402,2440,11.4
14947,Kelly Chase,1995-96,28.0,7,7,49,49,2,5,7,28.0,,140,5,10,15,67.0,84,7.25,87,443,2603,11.7
14948,Kelly Chase,1996-97,29.0,8,7,68,68,2,5,7,57.0,,208,7,15,22,124.0,84,6.48,76,407,2545,10.7
14949,Kelly Chase,1997-98,30.0,9,4,28,28,0,4,4,15.0,,236,7,19,26,139.0,48,5.97,37,209,1408,10.2
14950,Kelly Chase,1998-99,31.0,10,6,55,55,2,4,6,19.0,,291,9,23,32,158.0,82,6.29,74,413,2481,10.4
14951,Kelly Chase,1999-00,32.0,11,3,30,30,1,2,3,6.0,,321,10,25,35,164.0,82,5.83,55,336,2444,9.8
14952,Kelly Chase,2000-01,33.0,12,7,67,67,4,3,7,29.0,,388,14,28,42,193.0,82,5.28,57,380,2242,9.6
14953,Kelly Chase,2001-02,34.0,13,10,45,45,3,7,10,25.0,267.0,433,17,35,52,218.0,82,5.27,57,359,2285,9.4
14954,Kelly Chase,2002-03,35.0,14,1,25,25,0,1,1,14.0,194.0,458,17,36,53,232.0,82,5.49,53,331,2294,9.8
14955,Kelly Fairchild,1998-99,25.0,4,1,1,1,0,1,1,1.0,,1,0,1,1,1.0,82,6.29,74,413,2481,10.4
14956,Kelly Fairchild,1999-00,26.0,5,2,22,22,0,2,2,14.0,,23,0,3,3,15.0,82,5.83,55,336,2444,9.8
14957,Kelly Fairchild,2001-02,28.0,6,0,1,1,0,0,0,4.0,13.0,24,0,3,3,19.0,82,5.27,57,359,2285,9.4
14958,Kelly Fairchild,2004-05,31.0,7,2,10,10,2,0,2,6.0,66.0,34,2,3,5,25.0,82,5.24,53,338,2262,9.5
14959,Kelly Kisio,1985-86,26.0,4,7,15,15,4,3,7,16.0,,15,4,3,7,16.0,80,7.73,71,310,2444,12.7
14960,Kelly Kisio,1986-87,27.0,5,60,70,70,23,37,60,146.0,,85,27,40,67,162.0,80,7.89,74,336,2448,12.9
14961,Kelly Kisio,1987-88,28.0,6,61,75,75,20,41,61,126.0,,160,47,81,128,288.0,80,7.77,71,321,2447,12.7
14962,Kelly Kisio,1988-89,29.0,7,69,76,76,21,48,69,140.0,,236,68,129,197,428.0,80,7.94,82,370,2484,12.8
14963,Kelly Kisio,1989-90,30.0,8,64,70,70,24,40,64,136.0,,306,92,169,261,564.0,80,7.34,72,344,2400,12.2
14964,Kelly Kisio,1990-91,31.0,9,78,77,77,23,55,78,145.0,,383,115,224,339,709.0,80,7.43,89,437,2435,12.2
14965,Kelly Kisio,1991-92,32.0,10,62,70,70,26,36,62,128.0,,453,141,260,401,837.0,80,7.48,85,403,2430,12.3
14966,Kelly Kisio,1992-93,33.0,11,66,68,68,22,44,66,128.0,,521,163,304,467,965.0,80,7.37,76,367,2421,12.2
14967,Kelly Kisio,1993-94,34.0,12,35,51,51,15,20,35,74.0,,572,178,324,502,1039.0,80,6.91,71,366,2385,11.6
14968,Kelly Kisio,1994-95,35.0,13,37,48,48,11,26,37,68.0,,620,189,350,539,1107.0,80,6.96,77,402,2440,11.4
14969,Kelly Kisio,1995-96,36.0,14,78,78,78,26,52,78,152.0,,698,215,402,617,1259.0,84,7.25,87,443,2603,11.7
14970,Kelly Kisio,1996-97,37.0,15,30,51,51,7,23,30,62.0,,749,222,425,647,1321.0,84,6.48,76,407,2545,10.7
14971,Kelly Kisio,1997-98,38.0,16,11,12,12,7,4,11,26.0,,761,229,429,658,1347.0,48,5.97,37,209,1408,10.2
14972,Kelly Miller,1987-88,24.0,4,2,5,5,0,2,2,5.0,,5,0,2,2,5.0,80,7.77,71,321,2447,12.7
14973,Kelly Miller,1988-89,25.0,5,33,74,74,13,20,33,111.0,,79,13,22,35,116.0,80,7.94,82,370,2484,12.8
14974,Kelly Miller,1989-90,26.0,6,42,77,77,16,26,42,108.0,,156,29,48,77,224.0,80,7.34,72,344,2400,12.2
14975,Kelly Miller,1990-91,27.0,7,32,80,80,9,23,32,96.0,,236,38,71,109,320.0,80,7.43,89,437,2435,12.2
14976,Kelly Miller,1991-92,28.0,8,40,78,78,19,21,40,121.0,,314,57,92,149,441.0,80,7.48,85,403,2430,12.3
14977,Kelly Miller,1992-93,29.0,9,40,80,80,18,22,40,107.0,,394,75,114,189,548.0,80,7.37,76,367,2421,12.2
14978,Kelly Miller,1993-94,30.0,10,50,80,80,24,26,50,155.0,,474,99,140,239,703.0,80,6.91,71,366,2385,11.6
14979,Kelly Miller,1994-95,31.0,11,52,78,78,14,38,52,144.0,,552,113,178,291,847.0,80,6.96,77,402,2440,11.4
14980,Kelly Miller,1995-96,32.0,12,45,84,84,18,27,45,144.0,,636,131,205,336,991.0,84,7.25,87,443,2603,11.7
14981,Kelly Miller,1996-97,33.0,13,39,84,84,14,25,39,138.0,,720,145,230,375,1129.0,84,6.48,76,407,2545,10.7
14982,Kelly Miller,1997-98,34.0,14,23,48,48,10,13,23,70.0,,768,155,243,398,1199.0,48,5.97,37,209,1408,10.2
14983,Kelly Miller,1998-99,35.0,15,20,74,74,7,13,20,93.0,,842,162,256,418,1292.0,82,6.29,74,413,2481,10.4
14984,Kelly Miller,1999-00,36.0,16,24,77,77,10,14,24,95.0,,919,172,270,442,1387.0,82,5.83,55,336,2444,9.8
14985,Kelly Miller,2000-01,37.0,17,14,76,76,7,7,14,68.0,,995,179,277,456,1455.0,82,5.28,57,380,2242,9.6
14986,Kelly Miller,2001-02,38.0,18,7,62,62,2,5,7,49.0,693.0,1057,181,282,463,1504.0,82,5.27,57,359,2285,9.4
14987,Ken Baumgartner,1990-91,24.0,4,5,30,30,2,3,5,17.0,,30,2,3,5,17.0,80,7.43,89,437,2435,12.2
14988,Ken Baumgartner,1991-92,25.0,5,4,49,49,1,3,4,15.0,,79,3,6,9,32.0,80,7.48,85,403,2430,12.3
14989,Ken Baumgartner,1992-93,26.0,6,6,65,65,1,5,6,48.0,,144,4,11,15,80.0,80,7.37,76,367,2421,12.2
14990,Ken Baumgartner,1993-94,27.0,7,7,78,78,1,6,7,41.0,,222,5,17,22,121.0,80,6.91,71,366,2385,11.6
14991,Ken Baumgartner,1994-95,28.0,8,1,55,55,0,1,1,16.0,,277,5,18,23,137.0,80,6.96,77,402,2440,11.4
14992,Ken Baumgartner,1995-96,29.0,9,1,63,63,1,0,1,23.0,,340,6,18,24,160.0,84,7.25,87,443,2603,11.7
14993,Ken Baumgartner,1996-97,30.0,10,8,64,64,4,4,8,34.0,,404,10,22,32,194.0,84,6.48,76,407,2545,10.7
14994,Ken Baumgartner,1997-98,31.0,11,0,2,2,0,0,0,1.0,,406,10,22,32,195.0,48,5.97,37,209,1408,10.2
14995,Ken Baumgartner,1998-99,32.0,12,6,72,72,2,4,6,32.0,,478,12,26,38,227.0,82,6.29,74,413,2481,10.4
14996,Ken Baumgartner,1999-00,33.0,13,11,67,67,0,11,11,20.0,,545,12,37,49,247.0,82,5.83,55,336,2444,9.8
14997,Ken Baumgartner,2000-01,34.0,14,1,82,82,0,1,1,28.0,,627,12,38,50,275.0,82,5.28,57,380,2242,9.6
14998,Ken Baumgartner,2001-02,35.0,15,4,69,69,1,3,4,15.0,354.0,696,13,41,54,290.0,82,5.27,57,359,2285,9.4
14999,Ken Belanger,1997-98,23.0,4,0,3,3,0,0,0,1.0,,3,0,0,0,1.0,48,5.97,37,209,1408,10.2
15000,Ken Belanger,1998-99,24.0,5,0,7,7,0,0,0,0.0,,10,0,0,0,1.0,82,6.29,74,413,2481,10.4
15001,Ken Belanger,1999-00,25.0,6,2,18,18,0,2,2,5.0,,28,0,2,2,6.0,82,5.83,55,336,2444,9.8
15002,Ken Belanger,2000-01,26.0,7,4,37,37,3,1,4,10.0,,65,3,3,6,16.0,82,5.28,57,380,2242,9.6
15003,Ken Belanger,2001-02,27.0,8,7,54,54,2,5,7,19.0,254.0,119,5,8,13,35.0,82,5.27,57,359,2285,9.4
15004,Ken Belanger,2002-03,28.0,9,4,37,37,2,2,4,20.0,196.0,156,7,10,17,55.0,82,5.49,53,331,2294,9.8
15005,Ken Belanger,2003-04,29.0,10,4,40,40,2,2,4,35.0,284.0,196,9,12,21,90.0,82,5.51,63,376,2272,9.9
15006,Ken Belanger,2004-05,30.0,11,2,43,43,2,0,2,22.0,188.0,239,11,12,23,112.0,82,5.24,53,338,2262,9.5
15007,Ken Belanger,2005-06,31.0,12,0,4,4,0,0,0,0.0,16.0,243,11,12,23,112.0,82,5.31,60,363,2326,9.4
15008,Ken Belanger,2008-09,34.0,13,0,5,5,0,0,0,0.0,18.0,248,11,12,23,112.0,82,6.05,85,480,2458,10.1
15009,Ken Berry,1984-85,24.0,4,5,15,15,2,3,5,9.0,,15,2,3,5,9.0,80,8.03,73,320,2489,12.9
15010,Ken Berry,1986-87,26.0,5,5,13,13,2,3,5,18.0,,28,4,6,10,27.0,80,7.89,74,336,2448,12.9
15011,Ken Berry,1990-91,30.0,6,5,14,14,2,3,5,26.0,,42,6,9,15,53.0,80,7.43,89,437,2435,12.2
15012,Ken Berry,1991-92,31.0,7,3,13,13,2,1,3,10.0,,55,8,10,18,63.0,80,7.48,85,403,2430,12.3
15013,Ken Daneyko,1986-87,22.0,4,5,11,11,1,4,5,17.0,,11,1,4,5,17.0,80,7.89,74,336,2448,12.9
15014,Ken Daneyko,1987-88,23.0,5,0,1,1,0,0,0,1.0,,12,1,4,5,18.0,80,7.77,71,321,2447,12.7
15015,Ken Daneyko,1988-89,24.0,6,10,44,44,0,10,10,48.0,,56,1,14,15,66.0,80,7.94,82,370,2484,12.8
15016,Ken Daneyko,1989-90,25.0,7,14,79,79,2,12,14,112.0,,135,3,26,29,178.0,80,7.34,72,344,2400,12.2
15017,Ken Daneyko,1990-91,26.0,8,12,80,80,5,7,12,82.0,,215,8,33,41,260.0,80,7.43,89,437,2435,12.2
15018,Ken Daneyko,1991-92,27.0,9,10,80,80,5,5,10,108.0,,295,13,38,51,368.0,80,7.48,85,403,2430,12.3
15019,Ken Daneyko,1992-93,28.0,10,21,74,74,6,15,21,64.0,,369,19,53,72,432.0,80,7.37,76,367,2421,12.2
15020,Ken Daneyko,1993-94,29.0,11,20,80,80,4,16,20,106.0,,449,23,69,92,538.0,80,6.91,71,366,2385,11.6
15021,Ken Daneyko,1994-95,30.0,12,8,80,80,1,7,8,57.0,,529,24,76,100,595.0,80,6.96,77,402,2440,11.4
15022,Ken Daneyko,1995-96,31.0,13,13,84,84,2,11,13,71.0,,613,26,87,113,666.0,84,7.25,87,443,2603,11.7
15023,Ken Daneyko,1996-97,32.0,14,10,78,78,1,9,10,60.0,,691,27,96,123,726.0,84,6.48,76,407,2545,10.7
15024,Ken Daneyko,1997-98,33.0,15,3,25,25,1,2,3,27.0,,716,28,98,126,753.0,48,5.97,37,209,1408,10.2
15025,Ken Daneyko,1998-99,34.0,16,6,80,80,2,4,6,67.0,,796,30,102,132,820.0,82,6.29,74,413,2481,10.4
15026,Ken Daneyko,1999-00,35.0,17,9,77,77,2,7,9,63.0,,873,32,109,141,883.0,82,5.83,55,336,2444,9.8
15027,Ken Daneyko,2000-01,36.0,18,1,37,37,0,1,1,18.0,,910,32,110,142,901.0,82,5.28,57,380,2242,9.6
15028,Ken Daneyko,2001-02,37.0,19,11,82,82,2,9,11,63.0,1644.0,992,34,119,153,964.0,82,5.27,57,359,2285,9.4
15029,Ken Daneyko,2002-03,38.0,20,6,78,78,0,6,6,74.0,1411.0,1070,34,125,159,1038.0,82,5.49,53,331,2294,9.8
15030,Ken Daneyko,2003-04,39.0,21,4,77,77,0,4,4,50.0,1330.0,1147,34,129,163,1088.0,82,5.51,63,376,2272,9.9
15031,Ken Daneyko,2004-05,40.0,22,6,67,67,0,6,6,44.0,1040.0,1214,34,135,169,1132.0,82,5.24,53,338,2262,9.5
15032,Ken Daneyko,2005-06,41.0,23,9,69,69,2,7,9,38.0,1077.0,1283,36,142,178,1170.0,82,5.31,60,363,2326,9.4
15033,Ken Duggan,1990-91,27.0,4,0,1,1,0,0,0,0.0,,1,0,0,0,0.0,80,7.43,89,437,2435,12.2
15034,Ken Gernander,1998-99,29.0,4,5,10,10,2,3,5,10.0,,10,2,3,5,10.0,82,6.29,74,413,2481,10.4
15035,Ken Gernander,2006-07,37.0,5,0,2,2,0,0,0,0.0,13.0,12,2,3,5,10.0,82,5.14,57,348,2300,9.2
15036,Ken Hammond,1987-88,24.0,4,1,3,3,1,0,1,3.0,,3,1,0,1,3.0,80,7.77,71,321,2447,12.7
15037,Ken Hammond,1988-89,25.0,5,1,3,3,0,1,1,2.0,,6,1,1,2,5.0,80,7.94,82,370,2484,12.8
15038,Ken Hammond,1989-90,26.0,6,2,10,10,0,2,2,7.0,,16,1,3,4,12.0,80,7.34,72,344,2400,12.2
15039,Ken Hammond,1990-91,27.0,7,16,46,46,7,9,16,52.0,,62,8,12,20,64.0,80,7.43,89,437,2435,12.2
15040,Ken Hammond,1991-92,28.0,8,3,22,22,0,3,3,12.0,,84,8,15,23,76.0,80,7.48,85,403,2430,12.3
15041,Ken Hammond,1993-94,30.0,9,1,1,1,1,0,1,3.0,,85,9,15,24,79.0,80,6.91,71,366,2385,11.6
15042,Ken Hammond,1994-95,31.0,10,15,46,46,5,10,15,93.0,,131,14,25,39,172.0,80,6.96,77,402,2440,11.4
15043,Ken Hammond,1995-96,32.0,11,8,62,62,4,4,8,64.0,,193,18,29,47,236.0,84,7.25,87,443,2603,11.7
15044,Ken Hodge,1991-92,25.0,4,2,5,5,1,1,2,6.0,,5,1,1,2,6.0,80,7.48,85,403,2430,12.3
15045,Ken Hodge,1993-94,27.0,5,59,70,70,30,29,59,137.0,,75,31,30,61,143.0,80,6.91,71,366,2385,11.6
15046,Ken Hodge,1994-95,28.0,6,17,42,42,6,11,17,62.0,,117,37,41,78,205.0,80,6.96,77,402,2440,11.4
15047,Ken Hodge,1995-96,29.0,7,9,25,25,2,7,9,32.0,,142,39,48,87,237.0,84,7.25,87,443,2603,11.7
15048,Ken Klee,1997-98,26.0,4,4,23,23,3,1,4,18.0,,23,3,1,4,18.0,48,5.97,37,209,1408,10.2
15049,Ken Klee,1998-99,27.0,5,11,66,66,8,3,11,76.0,,89,11,4,15,94.0,82,6.29,74,413,2481,10.4
15050,Ken Klee,1999-00,28.0,6,11,80,80,3,8,11,108.0,,169,14,12,26,202.0,82,5.83,55,336,2444,9.8
15051,Ken Klee,2000-01,29.0,7,6,51,51,4,2,6,44.0,,220,18,14,32,246.0,82,5.28,57,380,2242,9.6
15052,Ken Klee,2001-02,30.0,8,20,78,78,7,13,20,132.0,1491.0,298,25,27,52,378.0,82,5.27,57,359,2285,9.4
15053,Ken Klee,2002-03,31.0,9,20,80,80,7,13,20,113.0,1638.0,378,32,40,72,491.0,82,5.49,53,331,2294,9.8
15054,Ken Klee,2003-04,32.0,10,6,54,54,2,4,6,58.0,932.0,432,34,44,78,549.0,82,5.51,63,376,2272,9.9
15055,Ken Klee,2004-05,33.0,11,16,68,68,8,8,16,85.0,1319.0,500,42,52,94,634.0,82,5.24,53,338,2262,9.5
15056,Ken Klee,2005-06,34.0,12,17,70,70,1,16,17,67.0,1527.0,570,43,68,111,701.0,82,5.31,60,363,2326,9.4
15057,Ken Klee,2006-07,35.0,13,29,66,66,4,25,29,85.0,1461.0,636,47,93,140,786.0,82,5.14,57,348,2300,9.2
15058,Ken Klee,2008-09,37.0,14,15,74,74,3,12,15,70.0,1393.0,710,50,105,155,856.0,82,6.05,85,480,2458,10.1
15059,Ken Klee,2009-10,38.0,15,19,81,81,3,16,19,90.0,1671.0,791,53,121,174,946.0,82,5.76,70,398,2426,9.7
15060,Ken Klee,2010-11,39.0,16,10,72,72,1,9,10,56.0,1443.0,863,54,130,184,1002.0,82,5.44,62,351,2383,9.4
15061,Ken Klee,2011-12,40.0,17,11,71,71,1,10,11,51.0,1096.0,934,55,140,195,1053.0,82,5.7,65,341,2477,9.4
15062,Ken Leiter,1987-88,26.0,4,2,5,5,0,2,2,9.0,,5,0,2,2,9.0,80,7.77,71,321,2447,12.7
15063,Ken Leiter,1988-89,27.0,5,2,9,9,1,1,2,9.0,,14,1,3,4,18.0,80,7.94,82,370,2484,12.8
15064,Ken Leiter,1989-90,28.0,6,29,74,74,9,20,29,160.0,,88,10,23,33,178.0,80,7.34,72,344,2400,12.2
15065,Ken Leiter,1990-91,29.0,7,17,51,51,4,13,17,104.0,,139,14,36,50,282.0,80,7.43,89,437,2435,12.2
15066,Ken Leiter,1992-93,31.0,8,0,4,4,0,0,0,5.0,,143,14,36,50,287.0,80,7.37,76,367,2421,12.2
15067,Ken Lovsin,1993-94,27.0,4,0,1,1,0,0,0,2.0,,1,0,0,0,2.0,80,6.91,71,366,2385,11.6
15068,Ken McRae,1990-91,22.0,4,0,1,1,0,0,0,1.0,,1,0,0,0,1.0,80,7.43,89,437,2435,12.2
15069,Ken McRae,1991-92,23.0,5,17,37,37,6,11,17,47.0,,38,6,11,17,48.0,80,7.48,85,403,2430,12.3
15070,Ken McRae,1992-93,24.0,6,15,66,66,7,8,15,83.0,,104,13,19,32,131.0,80,7.37,76,367,2421,12.2
15071,Ken McRae,1993-94,25.0,7,0,12,12,0,0,0,6.0,,116,13,19,32,137.0,80,6.91,71,366,2385,11.6
15072,Ken McRae,1994-95,26.0,8,1,10,10,0,1,1,10.0,,126,13,20,33,147.0,80,6.96,77,402,2440,11.4
15073,Ken McRae,1995-96,27.0,9,0,2,2,0,0,0,3.0,,128,13,20,33,150.0,84,7.25,87,443,2603,11.7
15074,Ken McRae,1996-97,28.0,10,2,9,9,1,1,2,11.0,,137,14,21,35,161.0,84,6.48,76,407,2545,10.7
15075,Ken Morrow,1982-83,26.0,4,3,18,18,0,3,3,19.0,,18,0,3,3,19.0,80,7.03,61,280,2352,12.0
15076,Ken Morrow,1983-84,27.0,5,13,80,80,2,11,13,69.0,,98,2,14,16,88.0,80,7.69,77,340,2441,12.6
15077,Ken Morrow,1984-85,28.0,6,19,75,75,1,18,19,91.0,,173,3,32,35,179.0,80,8.03,73,320,2489,12.9
15078,Ken Morrow,1985-86,29.0,7,16,79,79,5,11,16,135.0,,252,8,43,51,314.0,80,7.73,71,310,2444,12.7
15079,Ken Morrow,1986-87,30.0,8,14,63,63,3,11,14,71.0,,315,11,54,65,385.0,80,7.89,74,336,2448,12.9
15080,Ken Morrow,1987-88,31.0,9,8,15,15,1,7,8,15.0,,330,12,61,73,400.0,80,7.77,71,321,2447,12.7
15081,Ken Morrow,1988-89,32.0,10,12,69,69,0,12,12,55.0,,399,12,73,85,455.0,80,7.94,82,370,2484,12.8
15082,Ken Morrow,1989-90,33.0,11,11,64,64,3,8,11,52.0,,463,15,81,96,507.0,80,7.34,72,344,2400,12.2
15083,Ken Morrow,1990-91,34.0,12,5,53,53,1,4,5,50.0,,516,16,85,101,557.0,80,7.43,89,437,2435,12.2
15084,Ken Morrow,1991-92,35.0,13,4,34,34,1,3,4,27.0,,550,17,88,105,584.0,80,7.48,85,403,2430,12.3
15085,Ken Priestlay,1989-90,22.0,4,17,34,34,11,6,17,49.0,,34,11,6,17,49.0,80,7.34,72,344,2400,12.2
15086,Ken Priestlay,1990-91,23.0,5,17,33,33,5,12,17,63.0,,67,16,18,34,112.0,80,7.43,89,437,2435,12.2
15087,Ken Priestlay,1991-92,24.0,6,2,15,15,2,0,2,20.0,,82,18,18,36,132.0,80,7.48,85,403,2430,12.3
15088,Ken Priestlay,1992-93,25.0,7,14,35,35,7,7,14,66.0,,117,25,25,50,198.0,80,7.37,76,367,2421,12.2
15089,Ken Priestlay,1993-94,26.0,8,1,2,2,0,1,1,2.0,,119,25,26,51,200.0,80,6.91,71,366,2385,11.6
15090,Ken Priestlay,1994-95,27.0,9,10,49,49,2,8,10,20.0,,168,27,34,61,220.0,80,6.96,77,402,2440,11.4
15091,Ken Quinney,1989-90,24.0,4,9,25,25,2,7,9,22.0,,25,2,7,9,22.0,80,7.34,72,344,2400,12.2
15092,Ken Quinney,1990-91,25.0,5,4,15,15,2,2,4,20.0,,40,4,9,13,42.0,80,7.43,89,437,2435,12.2
15093,Ken Quinney,1993-94,28.0,6,7,19,19,3,4,7,19.0,,59,7,13,20,61.0,80,6.91,71,366,2385,11.6
15094,Ken Sabourin,1991-92,25.0,4,1,6,6,0,1,1,2.0,,6,0,1,1,2.0,80,7.48,85,403,2430,12.3
15095,Ken Sabourin,1992-93,26.0,5,0,5,5,0,0,0,3.0,,11,0,1,1,5.0,80,7.37,76,367,2421,12.2
15096,Ken Sabourin,1993-94,27.0,6,9,44,44,2,7,9,23.0,,55,2,8,10,28.0,80,6.91,71,366,2385,11.6
15097,Ken Sabourin,1994-95,28.0,7,0,19,19,0,0,0,12.0,,74,2,8,10,40.0,80,6.96,77,402,2440,11.4
15098,Ken Solheim,1983-84,22.0,4,5,10,10,4,1,5,17.0,,10,4,1,5,17.0,80,7.69,77,340,2441,12.6
15099,Ken Solheim,1984-85,23.0,5,9,29,29,4,5,9,46.0,,39,8,6,14,63.0,80,8.03,73,320,2489,12.9
15100,Ken Solheim,1985-86,24.0,6,6,35,35,2,4,6,39.0,,74,10,10,20,102.0,80,7.73,71,310,2444,12.7
15101,Ken Solheim,1987-88,26.0,7,18,55,55,8,10,18,87.0,,129,18,20,38,189.0,80,7.77,71,321,2447,12.7
15102,Ken Solheim,1988-89,27.0,8,1,6,6,1,0,1,8.0,,135,19,20,39,197.0,80,7.94,82,370,2484,12.8
15103,Ken Strong,1985-86,22.0,4,0,2,2,0,0,0,2.0,,2,0,0,0,2.0,80,7.73,71,310,2444,12.7
15104,Ken Strong,1986-87,23.0,5,2,2,2,0,2,2,3.0,,4,0,2,2,5.0,80,7.89,74,336,2448,12.9
15105,Ken Strong,1987-88,24.0,6,2,11,11,2,0,2,19.0,,15,2,2,4,24.0,80,7.77,71,321,2447,12.7
15106,Ken Sutton,1993-94,24.0,4,9,15,15,3,6,9,26.0,,15,3,6,9,26.0,80,6.91,71,366,2385,11.6
15107,Ken Sutton,1994-95,25.0,5,20,64,64,2,18,20,81.0,,79,5,24,29,107.0,80,6.96,77,402,2440,11.4
15108,Ken Sutton,1995-96,26.0,6,22,63,63,8,14,22,77.0,,142,13,38,51,184.0,84,7.25,87,443,2603,11.7
15109,Ken Sutton,1996-97,27.0,7,24,78,78,4,20,24,95.0,,220,17,58,75,279.0,84,6.48,76,407,2545,10.7
15110,Ken Sutton,1997-98,28.0,8,7,24,24,4,3,7,40.0,,244,21,61,82,319.0,48,5.97,37,209,1408,10.2
15111,Ken Sutton,1998-99,29.0,9,8,38,38,0,8,8,41.0,,282,21,69,90,360.0,82,6.29,74,413,2481,10.4
15112,Ken Sutton,2000-01,31.0,10,0,21,21,0,0,0,12.0,,303,21,69,90,372.0,82,5.28,57,380,2242,9.6
15113,Ken Sutton,2001-02,32.0,11,1,5,5,1,0,1,5.0,65.0,308,22,69,91,377.0,82,5.27,57,359,2285,9.4
15114,Ken Sutton,2002-03,33.0,12,2,6,6,0,2,2,10.0,104.0,314,22,71,93,387.0,82,5.49,53,331,2294,9.8
15115,Ken Sutton,2003-04,34.0,13,8,53,53,1,7,8,35.0,834.0,367,23,78,101,422.0,82,5.51,63,376,2272,9.9
15116,Ken Sutton,2004-05,35.0,14,2,21,21,0,2,2,22.0,267.0,388,23,80,103,444.0,82,5.24,53,338,2262,9.5
15117,Ken Yaremchuk,1986-87,23.0,4,13,47,47,6,7,13,49.0,,47,6,7,13,49.0,80,7.89,74,336,2448,12.9
15118,Ken Yaremchuk,1987-88,24.0,5,26,63,63,10,16,26,73.0,,110,16,23,39,122.0,80,7.77,71,321,2447,12.7
15119,Ken Yaremchuk,1988-89,25.0,6,34,78,78,14,20,34,81.0,,188,30,43,73,203.0,80,7.94,82,370,2484,12.8
15120,Ken Yaremchuk,1989-90,26.0,7,11,20,20,3,8,11,33.0,,208,33,51,84,236.0,80,7.34,72,344,2400,12.2
15121,Ken Yaremchuk,1990-91,27.0,8,7,16,16,2,5,7,14.0,,224,35,56,91,250.0,80,7.43,89,437,2435,12.2
15122,Ken Yaremchuk,1991-92,28.0,9,1,11,11,1,0,1,13.0,,235,36,56,92,263.0,80,7.48,85,403,2430,12.3
15123,Kenndal McArdle,2011-12,25.0,4,0,3,3,0,0,0,1.0,23.0,3,0,0,0,1.0,82,5.7,65,341,2477,9.4
15124,Kenndal McArdle,2012-13,26.0,5,3,19,19,1,2,3,10.0,169.0,22,1,2,3,11.0,82,5.53,56,304,2486,9.1
15125,Kenndal McArdle,2013-14,27.0,6,0,11,11,0,0,0,6.0,109.0,33,1,2,3,17.0,82,5.46,52,291,2492,9.0
15126,Kenndal McArdle,2014-15,28.0,7,0,9,9,0,0,0,3.0,55.0,42,1,2,3,20.0,82,5.32,47,271,2439,8.9
15127,Kenny Agostino,2016-17,24.0,4,2,8,8,1,1,2,12.0,89.0,8,1,1,2,12.0,82,5.34,48,269,2463,8.9
15128,Kenny Agostino,2018-19,26.0,5,0,2,2,0,0,0,3.0,27.0,10,1,1,2,15.0,82,5.34,48,255,2438,9.0
15129,Kenny Agostino,2019-20,27.0,6,3,7,7,1,2,3,17.0,89.0,17,2,3,5,32.0,82,5.45,47,245,2478,9.0
15130,Kenny Agostino,2020-21,28.0,7,1,5,5,0,1,1,11.0,60.0,22,2,4,6,43.0,82,5.86,50,250,2620,9.2
15131,Kenny Agostino,2021-22,29.0,8,24,63,63,6,18,24,79.0,814.0,85,8,22,30,122.0,82,5.96,47,239,2579,9.5
15132,Kenny Jonsson,1997-98,23.0,4,9,39,39,2,7,9,50.0,,39,2,7,9,50.0,48,5.97,37,209,1408,10.2
15133,Kenny Jonsson,1998-99,24.0,5,30,66,66,4,26,30,130.0,,105,6,33,39,180.0,82,6.29,74,413,2481,10.4
15134,Kenny Jonsson,1999-00,25.0,6,21,81,81,3,18,21,92.0,,186,9,51,60,272.0,82,5.83,55,336,2444,9.8
15135,Kenny Jonsson,2000-01,26.0,7,40,81,81,14,26,40,108.0,,267,23,77,100,380.0,82,5.28,57,380,2242,9.6
15136,Kenny Jonsson,2001-02,27.0,8,26,63,63,8,18,26,91.0,1574.0,330,31,95,126,471.0,82,5.27,57,359,2285,9.4
15137,Kenny Jonsson,2002-03,28.0,9,25,65,65,1,24,25,84.0,1592.0,395,32,119,151,555.0,82,5.49,53,331,2294,9.8
15138,Kenny Jonsson,2003-04,29.0,10,29,65,65,8,21,29,91.0,1564.0,460,40,140,180,646.0,82,5.51,63,376,2272,9.9
15139,Kenny Jonsson,2004-05,30.0,11,32,76,76,10,22,32,107.0,1943.0,536,50,162,212,753.0,82,5.24,53,338,2262,9.5
15140,Kenny Jonsson,2005-06,31.0,12,26,71,71,8,18,26,108.0,1647.0,607,58,180,238,861.0,82,5.31,60,363,2326,9.4
15141,Kenny Jonsson,2006-07,32.0,13,29,79,79,5,24,29,106.0,1812.0,686,63,204,267,967.0,82,5.14,57,348,2300,9.2
15142,Kent Carlson,1986-87,25.0,4,10,65,65,3,7,10,42.0,,65,3,7,10,42.0,80,7.89,74,336,2448,12.9
15143,Kent Carlson,1987-88,26.0,5,2,18,18,1,1,2,5.0,,83,4,8,12,47.0,80,7.77,71,321,2447,12.7
15144,Kent Carlson,1988-89,27.0,6,5,28,28,2,3,5,14.0,,111,6,11,17,61.0,80,7.94,82,370,2484,12.8
15145,Kent Carlson,1991-92,30.0,7,1,2,2,1,0,1,1.0,,113,7,11,18,62.0,80,7.48,85,403,2430,12.3
15146,Kent Huskins,2009-10,30.0,4,3,33,33,0,3,3,16.0,464.0,33,0,3,3,16.0,82,5.76,70,398,2426,9.7
15147,Kent Huskins,2010-11,31.0,5,19,76,76,4,15,19,46.0,1222.0,109,4,18,22,62.0,82,5.44,62,351,2383,9.4
15148,Kent Huskins,2011-12,32.0,6,6,33,33,2,4,6,20.0,620.0,142,6,22,28,82.0,82,5.7,65,341,2477,9.4
15149,Kent Huskins,2012-13,33.0,7,22,82,82,3,19,22,47.0,1434.0,224,9,41,50,129.0,82,5.53,56,304,2486,9.1
15150,Kent Huskins,2013-14,34.0,8,10,50,50,2,8,10,38.0,831.0,274,11,49,60,167.0,82,5.46,52,291,2492,9.0
15151,Kent Huskins,2014-15,35.0,9,7,25,25,2,5,7,16.0,387.0,299,13,54,67,183.0,82,5.32,47,271,2439,8.9
15152,Kent Huskins,2015-16,36.0,10,1,19,19,0,1,1,4.0,298.0,318,13,55,68,187.0,48,5.31,29,160,1399,9.1
15153,Kent Manderville,1994-95,23.0,4,4,15,15,0,4,4,14.0,,15,0,4,4,14.0,80,6.96,77,402,2440,11.4
15154,Kent Manderville,1995-96,24.0,5,2,18,18,1,1,2,15.0,,33,1,5,6,29.0,84,7.25,87,443,2603,11.7
15155,Kent Manderville,1996-97,25.0,6,16,67,67,7,9,16,81.0,,100,8,14,22,110.0,84,6.48,76,407,2545,10.7
15156,Kent Manderville,1997-98,26.0,7,1,36,36,0,1,1,43.0,,136,8,15,23,153.0,48,5.97,37,209,1408,10.2
15157,Kent Manderville,1998-99,27.0,8,8,37,37,3,5,8,63.0,,173,11,20,31,216.0,82,6.29,74,413,2481,10.4
15158,Kent Manderville,1999-00,28.0,9,11,44,44,6,5,11,51.0,,217,17,25,42,267.0,82,5.83,55,336,2444,9.8
15159,Kent Manderville,2000-01,29.0,10,8,77,77,4,4,8,80.0,,294,21,29,50,347.0,82,5.28,57,380,2242,9.6
15160,Kent Manderville,2001-02,30.0,11,16,81,81,5,11,16,71.0,657.0,375,26,40,66,418.0,82,5.27,57,359,2285,9.4
15161,Kent Manderville,2002-03,31.0,12,8,69,69,1,7,8,62.0,617.0,444,27,47,74,480.0,82,5.49,53,331,2294,9.8
15162,Kent Manderville,2003-04,32.0,13,15,82,82,5,10,15,136.0,1035.0,526,32,57,89,616.0,82,5.51,63,376,2272,9.9
15163,Kent Manderville,2004-05,33.0,14,8,38,38,3,5,8,43.0,352.0,564,35,62,97,659.0,82,5.24,53,338,2262,9.5
15164,Kent Manderville,2005-06,34.0,15,7,82,82,2,5,7,72.0,909.0,646,37,67,104,731.0,82,5.31,60,363,2326,9.4
15165,Kent McDonell,2005-06,26.0,4,0,3,3,0,0,0,4.0,26.0,3,0,0,0,4.0,82,5.31,60,363,2326,9.4
15166,Kent McDonell,2006-07,27.0,5,3,29,29,1,2,3,23.0,299.0,32,1,2,3,27.0,82,5.14,57,348,2300,9.2
15167,Kent Nilsson,1982-83,26.0,4,93,80,80,40,53,93,217.0,,80,40,53,93,217.0,80,7.03,61,280,2352,12.0
15168,Kent Nilsson,1983-84,27.0,5,131,80,80,49,82,131,217.0,,160,89,135,224,434.0,80,7.69,77,340,2441,12.6
15169,Kent Nilsson,1984-85,28.0,6,55,41,41,26,29,55,103.0,,201,115,164,279,537.0,80,8.03,73,320,2489,12.9
15170,Kent Nilsson,1985-86,29.0,7,104,80,80,46,58,104,217.0,,281,161,222,383,754.0,80,7.73,71,310,2444,12.7
15171,Kent Nilsson,1986-87,30.0,8,80,67,67,31,49,80,181.0,,348,192,271,463,935.0,80,7.89,74,336,2448,12.9
15172,Kent Nilsson,1987-88,31.0,9,99,77,77,37,62,99,201.0,,425,229,333,562,1136.0,80,7.77,71,321,2447,12.7
15173,Kent Nilsson,1988-89,32.0,10,60,61,61,16,44,60,122.0,,486,245,377,622,1258.0,80,7.94,82,370,2484,12.8
15174,Kent Nilsson,1989-90,33.0,11,63,61,61,18,45,63,114.0,,547,263,422,685,1372.0,80,7.34,72,344,2400,12.2
15175,Kent Nilsson,1997-98,41.0,12,1,6,6,1,0,1,2.0,,553,264,422,686,1374.0,48,5.97,37,209,1408,10.2
15176,Kent Paynter,1990-91,25.0,4,0,2,2,0,0,0,0.0,,2,0,0,0,0.0,80,7.43,89,437,2435,12.2
15177,Kent Paynter,1991-92,26.0,5,0,1,1,0,0,0,0.0,,3,0,0,0,0.0,80,7.48,85,403,2430,12.3
15178,Kent Paynter,1992-93,27.0,6,3,13,13,1,2,3,15.0,,16,1,2,3,15.0,80,7.37,76,367,2421,12.2
15179,Kent Paynter,1993-94,28.0,7,0,1,1,0,0,0,0.0,,17,1,2,3,15.0,80,6.91,71,366,2385,11.6
15180,Kent Paynter,1994-95,29.0,8,0,5,5,0,0,0,6.0,,22,1,2,3,21.0,80,6.96,77,402,2440,11.4
15181,Kent Paynter,1995-96,30.0,9,0,6,6,0,0,0,3.0,,28,1,2,3,24.0,84,7.25,87,443,2603,11.7
15182,Kent Paynter,1996-97,31.0,10,1,9,9,0,1,1,8.0,,37,1,3,4,32.0,84,6.48,76,407,2545,10.7
15183,Kerby Rychel,2017-18,23.0,4,3,5,5,0,3,3,4.0,53.0,5,0,3,3,4.0,82,5.32,47,251,2453,8.9
15184,Kerby Rychel,2018-19,24.0,5,9,32,32,2,7,9,32.0,304.0,37,2,10,12,36.0,82,5.34,48,255,2438,9.0
15185,Kerby Rychel,2020-21,26.0,6,2,4,4,1,1,2,7.0,44.0,41,3,11,14,43.0,82,5.86,50,250,2620,9.2
15186,Kerby Rychel,2021-22,27.0,7,0,2,2,0,0,0,1.0,18.0,43,3,11,14,44.0,82,5.96,47,239,2579,9.5
15187,Kerry Huffman,1989-90,22.0,4,0,9,9,0,0,0,3.0,,9,0,0,0,3.0,80,7.34,72,344,2400,12.2
15188,Kerry Huffman,1990-91,23.0,5,23,52,52,6,17,23,84.0,,61,6,17,23,87.0,80,7.43,89,437,2435,12.2
15189,Kerry Huffman,1991-92,24.0,6,11,29,29,0,11,11,23.0,,90,6,28,34,110.0,80,7.48,85,403,2430,12.3
15190,Kerry Huffman,1992-93,25.0,7,13,43,43,1,12,13,70.0,,133,7,40,47,180.0,80,7.37,76,367,2421,12.2
15191,Kerry Huffman,1993-94,26.0,8,3,10,10,1,2,3,14.0,,143,8,42,50,194.0,80,6.91,71,366,2385,11.6
15192,Kerry Huffman,1994-95,27.0,9,32,60,60,14,18,32,123.0,,203,22,60,82,317.0,80,6.96,77,402,2440,11.4
15193,Kerry Huffman,1995-96,28.0,10,22,52,52,4,18,22,86.0,,255,26,78,104,403.0,84,7.25,87,443,2603,11.7
15194,Kerry Huffman,1996-97,29.0,11,18,62,62,4,14,18,112.0,,317,30,92,122,515.0,84,6.48,76,407,2545,10.7
15195,Kerry Huffman,1997-98,30.0,12,6,37,37,2,4,6,68.0,,354,32,96,128,583.0,48,5.97,37,209,1408,10.2
15196,Kerry Huffman,1998-99,31.0,13,17,47,47,5,12,17,91.0,,401,37,108,145,674.0,82,6.29,74,413,2481,10.4
15197,Kevan Guy,1989-90,24.0,4,4,24,24,0,4,4,24.0,,24,0,4,4,24.0,80,7.34,72,344,2400,12.2
15198,Kevan Guy,1990-91,25.0,5,3,11,11,0,3,3,4.0,,35,0,7,7,28.0,80,7.43,89,437,2435,12.2
15199,Kevan Guy,1991-92,26.0,6,4,45,45,2,2,4,40.0,,80,2,9,11,68.0,80,7.48,85,403,2430,12.3
15200,Kevan Guy,1992-93,27.0,7,7,30,30,2,5,7,44.0,,110,4,14,18,112.0,80,7.37,76,367,2421,12.2
15201,Kevan Guy,1993-94,28.0,8,7,43,43,1,6,7,43.0,,153,5,20,25,155.0,80,6.91,71,366,2385,11.6
15202,Kevan Guy,1994-95,29.0,9,0,3,3,0,0,0,3.0,,156,5,20,25,158.0,80,6.96,77,402,2440,11.4
15203,Kevan Miller,2016-17,29.0,4,6,47,47,1,5,6,41.0,821.0,47,1,5,6,41.0,82,5.34,48,269,2463,8.9
15204,Kevan Miller,2017-18,30.0,5,7,41,41,2,5,7,37.0,739.0,88,3,10,13,78.0,82,5.32,47,251,2453,8.9
15205,Kevan Miller,2018-19,31.0,6,18,71,71,5,13,18,64.0,1353.0,159,8,23,31,142.0,82,5.34,48,255,2438,9.0
15206,Kevan Miller,2019-20,32.0,7,13,58,58,3,10,13,49.0,1032.0,217,11,33,44,191.0,82,5.45,47,245,2478,9.0
15207,Kevan Miller,2020-21,33.0,8,16,68,68,1,15,16,64.0,1323.0,285,12,48,60,255.0,82,5.86,50,250,2620,9.2
15208,Kevan Miller,2021-22,34.0,9,7,39,39,0,7,7,32.0,692.0,324,12,55,67,287.0,82,5.96,47,239,2579,9.5
15209,Kevin Bieksa,2008-09,27.0,4,6,39,39,0,6,6,38.0,628.0,39,0,6,6,38.0,82,6.05,85,480,2458,10.1
15210,Kevin Bieksa,2009-10,28.0,5,42,81,81,12,30,42,203.0,1966.0,120,12,36,48,241.0,82,5.76,70,398,2426,9.7
15211,Kevin Bieksa,2010-11,29.0,6,12,34,34,2,10,12,64.0,795.0,154,14,46,60,305.0,82,5.44,62,351,2383,9.4
15212,Kevin Bieksa,2011-12,30.0,7,43,72,72,11,32,43,153.0,1691.0,226,25,78,103,458.0,82,5.7,65,341,2477,9.4
15213,Kevin Bieksa,2012-13,31.0,8,22,55,55,3,19,22,95.0,1200.0,281,28,97,125,553.0,82,5.53,56,304,2486,9.1
15214,Kevin Bieksa,2013-14,32.0,9,22,66,66,6,16,22,105.0,1483.0,347,34,113,147,658.0,82,5.46,52,291,2492,9.0
15215,Kevin Bieksa,2014-15,33.0,10,44,78,78,8,36,44,166.0,1844.0,425,42,149,191,824.0,82,5.32,47,271,2439,8.9
15216,Kevin Bieksa,2015-16,34.0,11,12,36,36,6,6,12,77.0,790.0,461,48,155,203,901.0,48,5.31,29,160,1399,9.1
15217,Kevin Bieksa,2016-17,35.0,12,24,76,76,4,20,24,167.0,1731.0,537,52,175,227,1068.0,82,5.34,48,269,2463,8.9
15218,Kevin Bieksa,2017-18,36.0,13,14,60,60,4,10,14,99.0,1250.0,597,56,185,241,1167.0,82,5.32,47,251,2453,8.9
15219,Kevin Bieksa,2018-19,37.0,14,15,71,71,4,11,15,109.0,1492.0,668,60,196,256,1276.0,82,5.34,48,255,2438,9.0
15220,Kevin Bieksa,2019-20,38.0,15,14,81,81,3,11,14,94.0,1519.0,749,63,207,270,1370.0,82,5.45,47,245,2478,9.0
15221,Kevin Bieksa,2020-21,39.0,16,8,59,59,0,8,8,66.0,1063.0,808,63,215,278,1436.0,82,5.86,50,250,2620,9.2
15222,Kevin Brown,1997-98,23.0,4,5,23,23,2,3,5,25.0,,23,2,3,5,25.0,48,5.97,37,209,1408,10.2
15223,Kevin Brown,1998-99,24.0,5,1,7,7,1,0,1,9.0,,30,3,3,6,34.0,82,6.29,74,413,2481,10.4
15224,Kevin Brown,1999-00,25.0,6,4,11,11,0,4,4,12.0,,41,3,7,10,46.0,82,5.83,55,336,2444,9.8
15225,Kevin Brown,2000-01,26.0,7,0,4,4,0,0,0,0.0,,45,3,7,10,46.0,82,5.28,57,380,2242,9.6
15226,Kevin Brown,2001-02,27.0,8,6,12,12,4,2,6,13.0,110.0,57,7,9,16,59.0,82,5.27,57,359,2285,9.4
15227,Kevin Brown,2002-03,28.0,9,0,7,7,0,0,0,5.0,58.0,64,7,9,16,64.0,82,5.49,53,331,2294,9.8
15228,Kevin Colley,2008-09,30.0,4,0,16,16,0,0,0,4.0,76.0,16,0,0,0,4.0,82,6.05,85,480,2458,10.1
15229,Kevin Connauton,2016-17,26.0,4,8,36,36,1,7,8,56.0,552.0,36,1,7,8,56.0,82,5.34,48,269,2463,8.9
15230,Kevin Connauton,2017-18,27.0,5,21,62,62,9,12,21,96.0,1005.0,98,10,19,29,152.0,82,5.32,47,251,2453,8.9
15231,Kevin Connauton,2018-19,28.0,6,17,65,65,5,12,17,109.0,1088.0,163,15,31,46,261.0,82,5.34,48,255,2438,9.0
15232,Kevin Connauton,2019-20,29.0,7,1,24,24,0,1,1,21.0,315.0,187,15,32,47,282.0,82,5.45,47,245,2478,9.0
15233,Kevin Connauton,2020-21,30.0,8,21,73,73,11,10,21,102.0,1108.0,260,26,42,68,384.0,82,5.86,50,250,2620,9.2
15234,Kevin Connauton,2021-22,31.0,9,8,50,50,1,7,8,76.0,918.0,310,27,49,76,460.0,82,5.96,47,239,2579,9.5
15235,Kevin Connauton,2022-23,32.0,10,0,4,4,0,0,0,4.0,62.0,314,27,49,76,464.0,70,5.96,42,208,2192,9.5
15236,Kevin Czuczman,2016-17,26.0,4,2,13,13,0,2,2,24.0,254.0,13,0,2,2,24.0,82,5.34,48,269,2463,8.9
15237,Kevin Dahl,1995-96,27.0,4,11,61,61,2,9,11,40.0,,61,2,9,11,40.0,84,7.25,87,443,2603,11.7
15238,Kevin Dahl,1996-97,28.0,5,3,33,33,0,3,3,20.0,,94,2,12,14,60.0,84,6.48,76,407,2545,10.7
15239,Kevin Dahl,1997-98,29.0,6,12,34,34,4,8,12,30.0,,128,6,20,26,90.0,48,5.97,37,209,1408,10.2
15240,Kevin Dahl,1998-99,30.0,7,2,32,32,1,1,2,17.0,,160,7,21,28,107.0,82,6.29,74,413,2481,10.4
15241,Kevin Dahl,1999-00,31.0,8,0,2,2,0,0,0,2.0,,162,7,21,28,109.0,82,5.83,55,336,2444,9.8
15242,Kevin Dahl,2000-01,32.0,9,1,19,19,0,1,1,17.0,,181,7,22,29,126.0,82,5.28,57,380,2242,9.6
15243,Kevin Dahl,2001-02,33.0,10,0,3,3,0,0,0,0.0,46.0,184,7,22,29,126.0,82,5.27,57,359,2285,9.4
15244,Kevin Dahl,2003-04,35.0,11,0,4,4,0,0,0,3.0,42.0,188,7,22,29,129.0,82,5.51,63,376,2272,9.9
15245,Kevin Dallman,2008-09,27.0,4,14,67,67,4,10,14,131.0,1273.0,67,4,10,14,131.0,82,6.05,85,480,2458,10.1
15246,Kevin Dallman,2009-10,28.0,5,10,53,53,1,9,10,76.0,678.0,120,5,19,24,207.0,82,5.76,70,398,2426,9.7
15247,Kevin Dallman,2010-11,29.0,6,7,34,34,3,4,7,41.0,438.0,154,8,23,31,248.0,82,5.44,62,351,2383,9.4
15248,Kevin Dean,1997-98,28.0,4,1,17,17,0,1,1,11.0,,17,0,1,1,11.0,48,5.97,37,209,1408,10.2
15249,Kevin Dean,1998-99,29.0,5,6,41,41,0,6,6,29.0,,58,0,7,7,40.0,82,6.29,74,413,2481,10.4
15250,Kevin Dean,1999-00,30.0,6,6,28,28,2,4,6,21.0,,86,2,11,13,61.0,82,5.83,55,336,2444,9.8
15251,Kevin Dean,2000-01,31.0,7,9,50,50,1,8,9,28.0,,136,3,19,22,89.0,82,5.28,57,380,2242,9.6
15252,Kevin Dean,2001-02,32.0,8,11,62,62,1,10,11,51.0,973.0,198,4,29,33,140.0,82,5.27,57,359,2285,9.4
15253,Kevin Dean,2002-03,33.0,9,11,64,64,3,8,11,47.0,1049.0,262,7,37,44,187.0,82,5.49,53,331,2294,9.8
15254,Kevin Dean,2003-04,34.0,10,11,69,69,0,11,11,75.0,1342.0,331,7,48,55,262.0,82,5.51,63,376,2272,9.9
15255,Kevin Devine,1985-86,31.0,4,1,2,2,0,1,1,3.0,,2,0,1,1,3.0,80,7.73,71,310,2444,12.7
15256,Kevin Dineen,1987-88,24.0,4,41,57,57,25,16,41,141.0,,57,25,16,41,141.0,80,7.77,71,321,2447,12.7
15257,Kevin Dineen,1988-89,25.0,5,68,57,57,33,35,68,167.0,,114,58,51,109,308.0,80,7.94,82,370,2484,12.8
15258,Kevin Dineen,1989-90,26.0,6,79,78,78,40,39,79,234.0,,192,98,90,188,542.0,80,7.34,72,344,2400,12.2
15259,Kevin Dineen,1990-91,27.0,7,50,74,74,25,25,50,223.0,,266,123,115,238,765.0,80,7.43,89,437,2435,12.2
15260,Kevin Dineen,1991-92,28.0,8,89,79,79,45,44,89,294.0,,345,168,159,327,1059.0,80,7.48,85,403,2430,12.3
15261,Kevin Dineen,1992-93,29.0,9,66,67,67,25,41,66,214.0,,412,193,200,393,1273.0,80,7.37,76,367,2421,12.2
15262,Kevin Dineen,1993-94,30.0,10,47,61,61,17,30,47,161.0,,473,210,230,440,1434.0,80,6.91,71,366,2385,11.6
15263,Kevin Dineen,1994-95,31.0,11,62,80,80,30,32,62,225.0,,553,240,262,502,1659.0,80,6.96,77,402,2440,11.4
15264,Kevin Dineen,1995-96,32.0,12,63,83,83,35,28,63,241.0,,636,275,290,565,1900.0,84,7.25,87,443,2603,11.7
15265,Kevin Dineen,1996-97,33.0,13,42,71,71,19,23,42,156.0,,707,294,313,607,2056.0,84,6.48,76,407,2545,10.7
15266,Kevin Dineen,1997-98,34.0,14,13,40,40,8,5,13,55.0,,747,302,318,620,2111.0,48,5.97,37,209,1408,10.2
15267,Kevin Dineen,1998-99,35.0,15,11,46,46,2,9,11,66.0,,793,304,327,631,2177.0,82,6.29,74,413,2481,10.4
15268,Kevin Dineen,1999-00,36.0,16,48,78,78,19,29,48,185.0,,871,323,356,679,2362.0,82,5.83,55,336,2444,9.8
15269,Kevin Dineen,2000-01,37.0,17,23,54,54,7,16,23,96.0,,925,330,372,702,2458.0,82,5.28,57,380,2242,9.6
15270,Kevin Dineen,2001-02,38.0,18,18,67,67,8,10,18,86.0,668.0,992,338,382,720,2544.0,82,5.27,57,359,2285,9.4
15271,Kevin Dineen,2002-03,39.0,19,12,67,67,4,8,12,71.0,638.0,1059,342,390,732,2615.0,82,5.49,53,331,2294,9.8
15272,Kevin Dineen,2003-04,40.0,20,15,66,66,8,7,15,74.0,701.0,1125,350,397,747,2689.0,82,5.51,63,376,2272,9.9
15273,Kevin Dineen,2004-05,41.0,21,13,59,59,5,8,13,73.0,597.0,1184,355,405,760,2762.0,82,5.24,53,338,2262,9.5
15274,Kevin Dineen,2005-06,42.0,22,0,4,4,0,0,0,7.0,43.0,1188,355,405,760,2769.0,82,5.31,60,363,2326,9.4
15275,Kevin Doell,2010-11,31.0,4,1,8,8,0,1,1,6.0,77.0,8,0,1,1,6.0,82,5.44,62,351,2383,9.4
15276,Kevin Evans,1993-94,28.0,4,0,4,4,0,0,0,2.0,,4,0,0,0,2.0,80,6.91,71,366,2385,11.6
15277,Kevin Evans,1994-95,29.0,5,1,5,5,0,1,1,4.0,,9,0,1,1,6.0,80,6.96,77,402,2440,11.4
15278,Kevin Fiala,2017-18,21.0,4,0,1,1,0,0,0,3.0,11.0,1,0,0,0,3.0,82,5.32,47,251,2453,8.9
15279,Kevin Fiala,2018-19,22.0,5,1,5,5,1,0,1,11.0,66.0,6,1,0,1,14.0,82,5.34,48,255,2438,9.0
15280,Kevin Fiala,2019-20,23.0,6,16,54,54,11,5,16,114.0,730.0,60,12,5,17,128.0,82,5.45,47,245,2478,9.0
15281,Kevin Fiala,2020-21,24.0,7,48,80,80,23,25,48,187.0,1212.0,140,35,30,65,315.0,82,5.86,50,250,2620,9.2
15282,Kevin Fiala,2021-22,25.0,8,39,83,83,13,26,39,174.0,1298.0,223,48,56,104,489.0,82,5.96,47,239,2579,9.5
15283,Kevin Fiala,2022-23,26.0,9,54,64,64,23,31,54,175.0,986.0,287,71,87,158,664.0,70,5.96,42,208,2192,9.5
15284,Kevin Gravel,2018-19,26.0,4,0,5,5,0,0,0,2.0,58.0,5,0,0,0,2.0,82,5.34,48,255,2438,9.0
15285,Kevin Gravel,2019-20,27.0,5,7,49,49,1,6,7,52.0,693.0,54,1,6,7,54.0,82,5.45,47,245,2478,9.0
15286,Kevin Gravel,2020-21,28.0,6,3,16,16,0,3,3,20.0,225.0,70,1,9,10,74.0,82,5.86,50,250,2620,9.2
15287,Kevin Gravel,2021-22,29.0,7,3,36,36,0,3,3,44.0,530.0,106,1,12,13,118.0,82,5.96,47,239,2579,9.5
15288,Kevin Gravel,2022-23,30.0,8,0,3,3,0,0,0,2.0,33.0,109,1,12,13,120.0,70,5.96,42,208,2192,9.5
15289,Kevin Haller,1992-93,22.0,4,0,2,2,0,0,0,1.0,,2,0,0,0,1.0,80,7.37,76,367,2421,12.2
15290,Kevin Haller,1993-94,23.0,5,9,21,21,1,8,9,42.0,,23,1,8,9,43.0,80,6.91,71,366,2385,11.6
15291,Kevin Haller,1994-95,24.0,6,25,66,66,8,17,25,85.0,,89,9,25,34,128.0,80,6.96,77,402,2440,11.4
15292,Kevin Haller,1995-96,25.0,7,25,73,73,11,14,25,126.0,,162,20,39,59,254.0,84,7.25,87,443,2603,11.7
15293,Kevin Haller,1996-97,26.0,8,13,68,68,4,9,13,72.0,,230,24,48,72,326.0,84,6.48,76,407,2545,10.7
15294,Kevin Haller,1997-98,27.0,9,10,36,36,2,8,10,26.0,,266,26,56,82,352.0,48,5.97,37,209,1408,10.2
15295,Kevin Haller,1998-99,28.0,10,14,69,69,5,9,14,89.0,,335,31,65,96,441.0,82,6.29,74,413,2481,10.4
15296,Kevin Haller,1999-00,29.0,11,13,62,62,2,11,13,77.0,,397,33,76,109,518.0,82,5.83,55,336,2444,9.8
15297,Kevin Haller,2000-01,30.0,12,8,65,65,3,5,8,67.0,,462,36,81,117,585.0,82,5.28,57,380,2242,9.6
15298,Kevin Haller,2001-02,31.0,13,7,82,82,1,6,7,64.0,1693.0,544,37,87,124,649.0,82,5.27,57,359,2285,9.4
15299,Kevin Haller,2002-03,32.0,14,8,67,67,3,5,8,50.0,1217.0,611,40,92,132,699.0,82,5.49,53,331,2294,9.8
15300,Kevin Haller,2003-04,33.0,15,6,30,30,1,5,6,19.0,574.0,641,41,97,138,718.0,82,5.51,63,376,2272,9.9
15301,Kevin Haller,2004-05,34.0,16,0,1,1,0,0,0,2.0,17.0,642,41,97,138,720.0,82,5.24,53,338,2262,9.5
15302,Kevin Hatcher,1987-88,21.0,4,1,2,2,1,0,1,3.0,,2,1,0,1,3.0,80,7.77,71,321,2447,12.7
15303,Kevin Hatcher,1988-89,22.0,5,19,79,79,9,10,19,132.0,,81,10,10,20,135.0,80,7.94,82,370,2484,12.8
15304,Kevin Hatcher,1989-90,23.0,6,24,78,78,8,16,24,100.0,,159,18,26,44,235.0,80,7.34,72,344,2400,12.2
15305,Kevin Hatcher,1990-91,24.0,7,41,71,71,14,27,41,181.0,,230,32,53,85,416.0,80,7.43,89,437,2435,12.2
15306,Kevin Hatcher,1991-92,25.0,8,40,62,62,13,27,40,148.0,,292,45,80,125,564.0,80,7.48,85,403,2430,12.3
15307,Kevin Hatcher,1992-93,26.0,9,54,80,80,13,41,54,240.0,,372,58,121,179,804.0,80,7.37,76,367,2421,12.2
15308,Kevin Hatcher,1993-94,27.0,10,74,79,79,24,50,74,267.0,,451,82,171,253,1071.0,80,6.91,71,366,2385,11.6
15309,Kevin Hatcher,1994-95,28.0,11,54,79,79,17,37,54,246.0,,530,99,208,307,1317.0,80,6.96,77,402,2440,11.4
15310,Kevin Hatcher,1995-96,29.0,12,79,83,83,34,45,79,329.0,,613,133,253,386,1646.0,84,7.25,87,443,2603,11.7
15311,Kevin Hatcher,1996-97,30.0,13,40,72,72,16,24,40,217.0,,685,149,277,426,1863.0,84,6.48,76,407,2545,10.7
15312,Kevin Hatcher,1997-98,31.0,14,29,47,47,10,19,29,138.0,,732,159,296,455,2001.0,48,5.97,37,209,1408,10.2
15313,Kevin Hatcher,1998-99,32.0,15,41,74,74,15,26,41,237.0,,806,174,322,496,2238.0,82,6.29,74,413,2481,10.4
15314,Kevin Hatcher,1999-00,33.0,16,54,80,80,15,39,54,199.0,,886,189,361,550,2437.0,82,5.83,55,336,2444,9.8
15315,Kevin Hatcher,2000-01,34.0,17,48,74,74,19,29,48,169.0,,960,208,390,598,2606.0,82,5.28,57,380,2242,9.6
15316,Kevin Hatcher,2001-02,35.0,18,38,66,66,11,27,38,131.0,1626.0,1026,219,417,636,2737.0,82,5.27,57,359,2285,9.4
15317,Kevin Hatcher,2002-03,36.0,19,23,74,74,4,19,23,112.0,1568.0,1100,223,436,659,2849.0,82,5.49,53,331,2294,9.8
15318,Kevin Hatcher,2003-04,37.0,20,18,57,57,4,14,18,98.0,1333.0,1157,227,450,677,2947.0,82,5.51,63,376,2272,9.9
15319,Kevin Hayes,2017-18,25.0,4,45,79,79,17,28,45,111.0,1030.0,79,17,28,45,111.0,82,5.32,47,251,2453,8.9
15320,Kevin Hayes,2018-19,26.0,5,36,79,79,14,22,36,133.0,1079.0,158,31,50,81,244.0,82,5.34,48,255,2438,9.0
15321,Kevin Hayes,2019-20,27.0,6,49,76,76,17,32,49,143.0,1258.0,234,48,82,130,387.0,82,5.45,47,245,2478,9.0
15322,Kevin Hayes,2020-21,28.0,7,44,76,76,25,19,44,172.0,1319.0,310,73,101,174,559.0,82,5.86,50,250,2620,9.2
15323,Kevin Hayes,2021-22,29.0,8,55,71,71,19,36,55,156.0,1298.0,381,92,137,229,715.0,82,5.96,47,239,2579,9.5
15324,Kevin Hayes,2022-23,30.0,9,41,69,69,23,18,41,175.0,1223.0,450,115,155,270,890.0,70,5.96,42,208,2192,9.5
15325,Kevin Henderson,2015-16,29.0,4,1,4,4,1,0,1,3.0,59.0,4,1,0,1,3.0,48,5.31,29,160,1399,9.1
15326,Kevin Kaminski,1991-92,22.0,4,0,1,1,0,0,0,0.0,,1,0,0,0,0.0,80,7.48,85,403,2430,12.3
15327,Kevin Kaminski,1992-93,23.0,5,0,1,1,0,0,0,0.0,,2,0,0,0,0.0,80,7.37,76,367,2421,12.2
15328,Kevin Kaminski,1994-95,25.0,6,0,5,5,0,0,0,6.0,,7,0,0,0,6.0,80,6.96,77,402,2440,11.4
15329,Kevin Kaminski,1996-97,27.0,7,5,13,13,0,5,5,9.0,,20,0,5,5,15.0,84,6.48,76,407,2545,10.7
15330,Kevin Kaminski,1997-98,28.0,8,2,27,27,1,1,2,12.0,,47,1,6,7,27.0,48,5.97,37,209,1408,10.2
15331,Kevin Kaminski,1998-99,29.0,9,3,54,54,1,2,3,17.0,,101,2,8,10,44.0,82,6.29,74,413,2481,10.4
15332,Kevin Kaminski,1999-00,30.0,10,3,38,38,1,2,3,12.0,,139,3,10,13,56.0,82,5.83,55,336,2444,9.8
15333,Kevin Kemp,1983-84,29.0,4,0,3,3,0,0,0,5.0,,3,0,0,0,5.0,80,7.69,77,340,2441,12.6
15334,Kevin Klein,2008-09,24.0,4,0,2,2,0,0,0,0.0,27.0,2,0,0,0,0.0,82,6.05,85,480,2458,10.1
15335,Kevin Klein,2009-10,25.0,5,1,3,3,1,0,1,2.0,50.0,5,1,0,1,2.0,82,5.76,70,398,2426,9.7
15336,Kevin Klein,2010-11,26.0,6,2,13,13,0,2,2,14.0,187.0,18,1,2,3,16.0,82,5.44,62,351,2383,9.4
15337,Kevin Klein,2011-12,27.0,7,12,63,63,4,8,12,41.0,798.0,81,5,10,15,57.0,82,5.7,65,341,2477,9.4
15338,Kevin Klein,2012-13,28.0,8,11,81,81,1,10,11,67.0,1614.0,162,6,20,26,124.0,82,5.53,56,304,2486,9.1
15339,Kevin Klein,2013-14,29.0,9,18,81,81,2,16,18,99.0,1684.0,243,8,36,44,223.0,82,5.46,52,291,2492,9.0
15340,Kevin Klein,2014-15,30.0,10,21,66,66,4,17,21,91.0,1316.0,309,12,53,65,314.0,82,5.32,47,271,2439,8.9
15341,Kevin Klein,2015-16,31.0,11,14,47,47,3,11,14,54.0,960.0,356,15,64,79,368.0,48,5.31,29,160,1399,9.1
15342,Kevin Klein,2016-17,32.0,12,9,77,77,2,7,9,73.0,1335.0,433,17,71,88,441.0,82,5.34,48,269,2463,8.9
15343,Kevin Klein,2017-18,33.0,13,26,65,65,9,17,26,76.0,1202.0,498,26,88,114,517.0,82,5.32,47,251,2453,8.9
15344,Kevin Klein,2018-19,34.0,14,26,69,69,9,17,26,69.0,1407.0,567,35,105,140,586.0,82,5.34,48,255,2438,9.0
15345,Kevin Klein,2019-20,35.0,15,14,60,60,3,11,14,54.0,1058.0,627,38,116,154,640.0,82,5.45,47,245,2478,9.0
15346,Kevin LaVallee,1983-84,22.0,4,35,77,77,15,20,35,131.0,,77,15,20,35,131.0,80,7.69,77,340,2441,12.6
15347,Kevin LaVallee,1984-85,23.0,5,61,75,75,32,29,61,169.0,,152,47,49,96,300.0,80,8.03,73,320,2489,12.9
15348,Kevin LaVallee,1985-86,24.0,6,35,60,60,19,16,35,138.0,,212,66,65,131,438.0,80,7.73,71,310,2444,12.7
15349,Kevin LaVallee,1986-87,25.0,7,6,19,19,3,3,6,41.0,,231,69,68,137,479.0,80,7.89,74,336,2448,12.9
15350,Kevin LaVallee,1987-88,26.0,8,32,38,38,15,17,32,67.0,,269,84,85,169,546.0,80,7.77,71,321,2447,12.7
15351,Kevin LaVallee,1988-89,27.0,9,38,64,64,18,20,38,129.0,,333,102,105,207,675.0,80,7.94,82,370,2484,12.8
15352,Kevin LaVallee,1989-90,28.0,10,28,33,33,8,20,28,80.0,,366,110,125,235,755.0,80,7.34,72,344,2400,12.2
15353,Kevin Labanc,2019-20,24.0,4,20,55,55,8,12,20,70.0,752.0,55,8,12,20,70.0,82,5.45,47,245,2478,9.0
15354,Kevin Labanc,2020-21,25.0,5,40,77,77,11,29,40,156.0,1105.0,132,19,41,60,226.0,82,5.86,50,250,2620,9.2
15355,Kevin Labanc,2021-22,26.0,6,56,82,82,17,39,56,130.0,1150.0,214,36,80,116,356.0,82,5.96,47,239,2579,9.5
15356,Kevin Labanc,2022-23,27.0,7,33,70,70,14,19,33,176.0,1125.0,284,50,99,149,532.0,70,5.96,42,208,2192,9.5
15357,Kevin Lowe,1982-83,23.0,4,21,64,64,2,19,21,86.0,,64,2,19,21,86.0,80,7.03,61,280,2352,12.0
15358,Kevin Lowe,1983-84,24.0,5,34,79,79,10,24,34,115.0,,143,12,43,55,201.0,80,7.69,77,340,2441,12.6
15359,Kevin Lowe,1984-85,25.0,6,40,80,80,9,31,40,110.0,,223,21,74,95,311.0,80,8.03,73,320,2489,12.9
15360,Kevin Lowe,1985-86,26.0,7,40,80,80,6,34,40,92.0,,303,27,108,135,403.0,80,7.73,71,310,2444,12.7
15361,Kevin Lowe,1986-87,27.0,8,46,80,80,4,42,46,82.0,,383,31,150,181,485.0,80,7.89,74,336,2448,12.9
15362,Kevin Lowe,1987-88,28.0,9,25,80,80,4,21,25,82.0,,463,35,171,206,567.0,80,7.77,71,321,2447,12.7
15363,Kevin Lowe,1988-89,29.0,10,18,74,74,2,16,18,57.0,,537,37,187,224,624.0,80,7.94,82,370,2484,12.8
15364,Kevin Lowe,1989-90,30.0,11,37,77,77,8,29,37,97.0,,614,45,216,261,721.0,80,7.34,72,344,2400,12.2
15365,Kevin Lowe,1990-91,31.0,12,24,70,70,9,15,24,82.0,,684,54,231,285,803.0,80,7.43,89,437,2435,12.2
15366,Kevin Lowe,1991-92,32.0,13,25,76,76,7,18,25,85.0,,760,61,249,310,888.0,80,7.48,85,403,2430,12.3
15367,Kevin Lowe,1992-93,33.0,14,33,78,78,7,26,33,74.0,,838,68,275,343,962.0,80,7.37,76,367,2421,12.2
15368,Kevin Lowe,1993-94,34.0,15,16,73,73,3,13,16,51.0,,911,71,288,359,1013.0,80,6.91,71,366,2385,11.6
15369,Kevin Lowe,1994-95,35.0,16,10,55,55,2,8,10,33.0,,966,73,296,369,1046.0,80,6.96,77,402,2440,11.4
15370,Kevin Lowe,1995-96,36.0,17,15,49,49,3,12,15,52.0,,1015,76,308,384,1098.0,84,7.25,87,443,2603,11.7
15371,Kevin Lowe,1996-97,37.0,18,19,71,71,5,14,19,50.0,,1086,81,322,403,1148.0,84,6.48,76,407,2545,10.7
15372,Kevin Lowe,1997-98,38.0,19,8,44,44,1,7,8,35.0,,1130,82,329,411,1183.0,48,5.97,37,209,1408,10.2
15373,Kevin Lowe,1998-99,39.0,20,6,53,53,1,5,6,30.0,,1183,83,334,417,1213.0,82,6.29,74,413,2481,10.4
15374,Kevin Lowe,1999-00,40.0,21,14,64,64,1,13,14,46.0,,1247,84,347,431,1259.0,82,5.83,55,336,2444,9.8
15375,Kevin Lowe,2000-01,41.0,22,0,7,7,0,0,0,5.0,,1254,84,347,431,1264.0,82,5.28,57,380,2242,9.6
15376,Kevin MacDonald,1996-97,30.0,4,0,1,1,0,0,0,0.0,,1,0,0,0,0.0,84,6.48,76,407,2545,10.7
15377,Kevin Maguire,1989-90,27.0,4,0,17,17,0,0,0,2.0,,17,0,0,0,2.0,80,7.34,72,344,2400,12.2
15378,Kevin Maguire,1990-91,28.0,5,10,46,46,4,6,10,25.0,,63,4,6,10,27.0,80,7.43,89,437,2435,12.2
15379,Kevin Maguire,1991-92,29.0,6,18,60,60,8,10,18,35.0,,123,12,16,28,62.0,80,7.48,85,403,2430,12.3
15380,Kevin Maguire,1992-93,30.0,7,16,66,66,7,9,16,69.0,,189,19,25,44,131.0,80,7.37,76,367,2421,12.2
15381,Kevin Maguire,1993-94,31.0,8,14,63,63,9,5,14,52.0,,252,28,30,58,183.0,80,6.91,71,366,2385,11.6
15382,Kevin Maguire,1994-95,32.0,9,1,8,8,1,0,1,8.0,,260,29,30,59,191.0,80,6.96,77,402,2440,11.4
15383,Kevin Marshall,2014-15,25.0,4,0,10,10,0,0,0,6.0,88.0,10,0,0,0,6.0,82,5.32,47,271,2439,8.9
15384,Kevin Maxwell,1983-84,23.0,4,3,6,6,0,3,3,9.0,,6,0,3,3,9.0,80,7.69,77,340,2441,12.6
15385,Kevin Maxwell,1984-85,24.0,5,15,46,46,6,9,15,72.0,,52,6,12,18,81.0,80,8.03,73,320,2489,12.9
15386,Kevin Maxwell,1986-87,26.0,6,3,14,14,0,3,3,8.0,,66,6,15,21,89.0,80,7.89,74,336,2448,12.9
15387,Kevin McClelland,1984-85,22.0,4,5,10,10,1,4,5,18.0,,10,1,4,5,18.0,80,8.03,73,320,2489,12.9
15388,Kevin McClelland,1985-86,23.0,5,9,38,38,5,4,9,70.0,,48,6,8,14,88.0,80,7.73,71,310,2444,12.7
15389,Kevin McClelland,1986-87,24.0,6,34,76,76,10,24,34,103.0,,124,16,32,48,191.0,80,7.89,74,336,2448,12.9
15390,Kevin McClelland,1987-88,25.0,7,23,62,62,8,15,23,99.0,,186,24,47,71,290.0,80,7.77,71,321,2447,12.7
15391,Kevin McClelland,1988-89,26.0,8,36,79,79,11,25,36,104.0,,265,35,72,107,394.0,80,7.94,82,370,2484,12.8
15392,Kevin McClelland,1989-90,27.0,9,25,72,72,12,13,25,76.0,,337,47,85,132,470.0,80,7.34,72,344,2400,12.2
15393,Kevin McClelland,1990-91,28.0,10,16,74,74,10,6,16,61.0,,411,57,91,148,531.0,80,7.43,89,437,2435,12.2
15394,Kevin McClelland,1991-92,29.0,11,20,79,79,6,14,20,43.0,,490,63,105,168,574.0,80,7.48,85,403,2430,12.3
15395,Kevin McClelland,1992-93,30.0,12,11,71,71,5,6,11,31.0,,561,68,111,179,605.0,80,7.37,76,367,2421,12.2
15396,Kevin McClelland,1993-94,31.0,13,0,3,3,0,0,0,1.0,,564,68,111,179,606.0,80,6.91,71,366,2385,11.6
15397,Kevin McClelland,1994-95,32.0,14,1,18,18,0,1,1,5.0,,582,68,112,180,611.0,80,6.96,77,402,2440,11.4
15398,Kevin McClelland,1996-97,34.0,15,0,6,6,0,0,0,1.0,,588,68,112,180,612.0,84,6.48,76,407,2545,10.7
15399,Kevin Miehm,1995-96,26.0,4,4,8,8,1,3,4,5.0,,8,1,3,4,5.0,84,7.25,87,443,2603,11.7
15400,Kevin Miehm,1996-97,27.0,5,1,14,14,0,1,1,5.0,,22,1,4,5,10.0,84,6.48,76,407,2545,10.7
15401,Kevin Miller,1991-92,26.0,4,8,24,24,3,5,8,40.0,,24,3,5,8,40.0,80,7.48,85,403,2430,12.3
15402,Kevin Miller,1992-93,27.0,5,5,16,16,0,5,5,9.0,,40,3,10,13,49.0,80,7.37,76,367,2421,12.2
15403,Kevin Miller,1993-94,28.0,6,51,74,74,22,29,51,136.0,,114,25,39,64,185.0,80,6.91,71,366,2385,11.6
15404,Kevin Miller,1994-95,29.0,7,46,80,80,20,26,46,130.0,,194,45,65,110,315.0,80,6.96,77,402,2440,11.4
15405,Kevin Miller,1995-96,30.0,8,49,82,82,24,25,49,163.0,,276,69,90,159,478.0,84,7.25,87,443,2603,11.7
15406,Kevin Miller,1996-97,31.0,9,48,75,75,23,25,48,154.0,,351,92,115,207,632.0,84,6.48,76,407,2545,10.7
15407,Kevin Miller,1997-98,32.0,10,20,36,36,8,12,20,60.0,,387,100,127,227,692.0,48,5.97,37,209,1408,10.2
15408,Kevin Miller,1998-99,33.0,11,53,81,81,28,25,53,179.0,,468,128,152,280,871.0,82,6.29,74,413,2481,10.4
15409,Kevin Miller,1999-00,34.0,12,31,69,69,14,17,31,139.0,,537,142,169,311,1010.0,82,5.83,55,336,2444,9.8
15410,Kevin Miller,2000-01,35.0,13,11,37,37,4,7,11,37.0,,574,146,176,322,1047.0,82,5.28,57,380,2242,9.6
15411,Kevin Miller,2001-02,36.0,14,6,33,33,1,5,6,37.0,340.0,607,147,181,328,1084.0,82,5.27,57,359,2285,9.4
15412,Kevin Miller,2002-03,37.0,15,5,9,9,3,2,5,11.0,74.0,616,150,183,333,1095.0,82,5.49,53,331,2294,9.8
15413,Kevin Miller,2006-07,41.0,16,2,4,4,0,2,2,2.0,29.0,620,150,185,335,1097.0,82,5.14,57,348,2300,9.2
15414,Kevin Morrison,1982-83,33.0,4,15,41,41,4,11,15,64.0,,41,4,11,15,64.0,80,7.03,61,280,2352,12.0
15415,Kevin Porter,2011-12,25.0,4,10,34,34,5,5,10,39.0,463.0,34,5,5,10,39.0,82,5.7,65,341,2477,9.4
15416,Kevin Porter,2012-13,26.0,5,3,20,20,2,1,3,21.0,241.0,54,7,6,13,60.0,82,5.53,56,304,2486,9.1
15417,Kevin Porter,2013-14,27.0,6,25,74,74,14,11,25,102.0,1023.0,128,21,17,38,162.0,82,5.46,52,291,2492,9.0
15418,Kevin Porter,2014-15,28.0,7,7,35,35,4,3,7,32.0,321.0,163,25,20,45,194.0,82,5.32,47,271,2439,8.9
15419,Kevin Porter,2015-16,29.0,8,9,31,31,4,5,9,37.0,472.0,194,29,25,54,231.0,48,5.31,29,160,1399,9.1
15420,Kevin Porter,2016-17,30.0,9,1,12,12,0,1,1,3.0,140.0,206,29,26,55,234.0,82,5.34,48,269,2463,8.9
15421,Kevin Porter,2018-19,32.0,10,3,41,41,0,3,3,34.0,464.0,247,29,29,58,268.0,82,5.34,48,255,2438,9.0
15422,Kevin Porter,2019-20,33.0,11,0,2,2,0,0,0,0.0,23.0,249,29,29,58,268.0,82,5.45,47,245,2478,9.0
15423,Kevin Primeau,1983-84,28.0,4,0,2,2,0,0,0,0.0,,2,0,0,0,0.0,80,7.69,77,340,2441,12.6
15424,Kevin Quick,2011-12,23.0,4,1,6,6,0,1,1,7.0,80.0,6,0,1,1,7.0,82,5.7,65,341,2477,9.4
15425,Kevin Rooney,2019-20,26.0,4,0,4,4,0,0,0,2.0,41.0,4,0,0,0,2.0,82,5.45,47,245,2478,9.0
15426,Kevin Rooney,2020-21,27.0,5,0,1,1,0,0,0,3.0,12.0,5,0,0,0,5.0,82,5.86,50,250,2620,9.2
15427,Kevin Rooney,2021-22,28.0,6,10,41,41,6,4,10,39.0,517.0,46,6,4,10,44.0,82,5.96,47,239,2579,9.5
15428,Kevin Rooney,2022-23,29.0,7,9,49,49,4,5,9,59.0,575.0,95,10,9,19,103.0,70,5.96,42,208,2192,9.5
15429,Kevin Roy,2020-21,27.0,4,7,25,25,6,1,7,26.0,341.0,25,6,1,7,26.0,82,5.86,50,250,2620,9.2
15430,Kevin Roy,2021-22,28.0,5,0,3,3,0,0,0,2.0,39.0,28,6,1,7,28.0,82,5.96,47,239,2579,9.5
15431,Kevin Sawyer,1998-99,24.0,4,0,8,8,0,0,0,1.0,,8,0,0,0,1.0,82,6.29,74,413,2481,10.4
15432,Kevin Sawyer,1999-00,25.0,5,0,2,2,0,0,0,0.0,,10,0,0,0,1.0,82,5.83,55,336,2444,9.8
15433,Kevin Sawyer,2002-03,28.0,6,0,3,3,0,0,0,0.0,7.0,13,0,0,0,1.0,82,5.49,53,331,2294,9.8
15434,Kevin Sawyer,2003-04,29.0,7,1,9,9,0,1,1,6.0,59.0,22,0,1,1,7.0,82,5.51,63,376,2272,9.9
15435,Kevin Sawyer,2004-05,30.0,8,2,57,57,1,1,2,29.0,330.0,79,1,2,3,36.0,82,5.24,53,338,2262,9.5
15436,Kevin Sawyer,2005-06,31.0,9,3,31,31,2,1,3,11.0,189.0,110,3,3,6,47.0,82,5.31,60,363,2326,9.4
15437,Kevin Shattenkirk,2013-14,25.0,4,43,72,72,9,34,43,108.0,1429.0,72,9,34,43,108.0,82,5.46,52,291,2492,9.0
15438,Kevin Shattenkirk,2014-15,26.0,5,43,81,81,9,34,43,178.0,1750.0,153,18,68,86,286.0,82,5.32,47,271,2439,8.9
15439,Kevin Shattenkirk,2015-16,27.0,6,23,48,48,5,18,23,84.0,1022.0,201,23,86,109,370.0,48,5.31,29,160,1399,9.1
15440,Kevin Shattenkirk,2016-17,28.0,7,45,81,81,10,35,45,188.0,1666.0,282,33,121,154,558.0,82,5.34,48,269,2463,8.9
15441,Kevin Shattenkirk,2017-18,29.0,8,44,56,56,8,36,44,135.0,1263.0,338,41,157,198,693.0,82,5.32,47,251,2453,8.9
15442,Kevin Shattenkirk,2018-19,30.0,9,44,72,72,14,30,44,180.0,1614.0,410,55,187,242,873.0,82,5.34,48,255,2438,9.0
15443,Kevin Shattenkirk,2019-20,31.0,10,56,80,80,13,43,56,161.0,1595.0,490,68,230,298,1034.0,82,5.45,47,245,2478,9.0
15444,Kevin Shattenkirk,2020-21,32.0,11,23,46,46,5,18,23,94.0,933.0,536,73,248,321,1128.0,82,5.86,50,250,2620,9.2
15445,Kevin Shattenkirk,2021-22,33.0,12,28,73,73,2,26,28,148.0,1383.0,609,75,274,349,1276.0,82,5.96,47,239,2579,9.5
15446,Kevin Shattenkirk,2022-23,34.0,13,34,70,70,8,26,34,131.0,1323.0,679,83,300,383,1407.0,70,5.96,42,208,2192,9.5
15447,Kevin Smyth,1996-97,23.0,4,5,21,21,3,2,5,8.0,,21,3,2,5,8.0,84,6.48,76,407,2545,10.7
15448,Kevin Smyth,1997-98,24.0,5,6,16,16,1,5,6,20.0,,37,4,7,11,28.0,48,5.97,37,209,1408,10.2
15449,Kevin Smyth,1998-99,25.0,6,3,21,21,2,1,3,27.0,,58,6,8,14,55.0,82,6.29,74,413,2481,10.4
15450,Kevin Stenlund,2021-22,25.0,4,0,4,4,0,0,0,3.0,44.0,4,0,0,0,3.0,82,5.96,47,239,2579,9.5
15451,Kevin Stenlund,2022-23,26.0,5,10,32,32,6,4,10,57.0,447.0,36,6,4,10,60.0,70,5.96,42,208,2192,9.5
15452,Kevin Stevens,1990-91,25.0,4,7,16,16,5,2,7,22.0,,16,5,2,7,22.0,80,7.43,89,437,2435,12.2
15453,Kevin Stevens,1991-92,26.0,5,15,24,24,12,3,15,52.0,,40,17,5,22,74.0,80,7.48,85,403,2430,12.3
15454,Kevin Stevens,1992-93,27.0,6,70,76,76,29,41,70,179.0,,116,46,46,92,253.0,80,7.37,76,367,2421,12.2
15455,Kevin Stevens,1993-94,28.0,7,86,80,80,40,46,86,253.0,,196,86,92,178,506.0,80,6.91,71,366,2385,11.6
15456,Kevin Stevens,1994-95,29.0,8,123,80,80,54,69,123,325.0,,276,140,161,301,831.0,80,6.96,77,402,2440,11.4
15457,Kevin Stevens,1995-96,30.0,9,111,72,72,55,56,111,326.0,,348,195,217,412,1157.0,84,7.25,87,443,2603,11.7
15458,Kevin Stevens,1996-97,31.0,10,88,83,83,41,47,88,284.0,,431,236,264,500,1441.0,84,6.48,76,407,2545,10.7
15459,Kevin Stevens,1997-98,32.0,11,27,27,27,15,12,27,80.0,,458,251,276,527,1521.0,48,5.97,37,209,1408,10.2
15460,Kevin Stevens,1998-99,33.0,12,36,61,61,13,23,36,170.0,,519,264,299,563,1691.0,82,6.29,74,413,2481,10.4
15461,Kevin Stevens,1999-00,34.0,13,34,69,69,14,20,34,175.0,,588,278,319,597,1866.0,82,5.83,55,336,2444,9.8
15462,Kevin Stevens,2000-01,35.0,14,41,80,80,14,27,41,144.0,,668,292,346,638,2010.0,82,5.28,57,380,2242,9.6
15463,Kevin Stevens,2001-02,36.0,15,43,81,81,23,20,43,136.0,1231.0,749,315,366,681,2146.0,82,5.27,57,359,2285,9.4
15464,Kevin Stevens,2002-03,37.0,16,8,38,38,3,5,8,44.0,475.0,787,318,371,689,2190.0,82,5.49,53,331,2294,9.8
15465,Kevin Stevens,2003-04,38.0,17,32,55,55,10,22,32,107.0,877.0,842,328,393,721,2297.0,82,5.51,63,376,2272,9.9
15466,Kevin Stevens,2004-05,39.0,18,5,32,32,1,4,5,34.0,347.0,874,329,397,726,2331.0,82,5.24,53,338,2262,9.5
15467,Kevin Todd,1991-92,23.0,4,0,1,1,0,0,0,0.0,,1,0,0,0,0.0,80,7.48,85,403,2430,12.3
15468,Kevin Todd,1993-94,25.0,5,0,1,1,0,0,0,0.0,,2,0,0,0,0.0,80,6.91,71,366,2385,11.6
15469,Kevin Todd,1994-95,26.0,6,63,80,80,21,42,63,131.0,,82,21,42,63,131.0,80,6.96,77,402,2440,11.4
15470,Kevin Todd,1995-96,27.0,7,23,55,55,9,14,23,87.0,,137,30,56,86,218.0,84,7.25,87,443,2603,11.7
15471,Kevin Todd,1996-97,28.0,8,22,47,47,8,14,22,65.0,,184,38,70,108,283.0,84,6.48,76,407,2545,10.7
15472,Kevin Todd,1997-98,29.0,9,11,33,33,3,8,11,34.0,,217,41,78,119,317.0,48,5.97,37,209,1408,10.2
15473,Kevin Todd,1998-99,30.0,10,43,74,74,16,27,43,132.0,,291,57,105,162,449.0,82,6.29,74,413,2481,10.4
15474,Kevin Todd,1999-00,31.0,11,30,65,65,9,21,30,95.0,,356,66,126,192,544.0,82,5.83,55,336,2444,9.8
15475,Kevin Todd,2000-01,32.0,12,11,27,27,4,7,11,30.0,,383,70,133,203,574.0,82,5.28,57,380,2242,9.6
15476,Kevin Westgarth,2011-12,27.0,4,0,9,9,0,0,0,1.0,45.0,9,0,0,0,1.0,82,5.7,65,341,2477,9.4
15477,Kevin Westgarth,2013-14,29.0,5,3,56,56,0,3,3,20.0,304.0,65,0,3,3,21.0,82,5.46,52,291,2492,9.0
15478,Kevin Westgarth,2014-15,30.0,6,2,25,25,1,1,2,13.0,132.0,90,1,4,5,34.0,82,5.32,47,271,2439,8.9
15479,Kevin Westgarth,2015-16,31.0,7,4,31,31,2,2,4,16.0,177.0,121,3,6,9,50.0,48,5.31,29,160,1399,9.1
15480,Kevin Westgarth,2016-17,32.0,8,7,48,48,4,3,7,31.0,312.0,169,7,9,16,81.0,82,5.34,48,269,2463,8.9
15481,Kevin Wortman,1996-97,27.0,4,0,5,5,0,0,0,2.0,,5,0,0,0,2.0,84,6.48,76,407,2545,10.7
15482,Kevyn Adams,2000-01,26.0,4,0,5,5,0,0,0,3.0,,5,0,0,0,3.0,82,5.28,57,380,2242,9.6
15483,Kevyn Adams,2001-02,27.0,5,0,1,1,0,0,0,1.0,8.0,6,0,0,0,4.0,82,5.27,57,359,2285,9.4
15484,Kevyn Adams,2002-03,28.0,6,13,52,52,5,8,13,70.0,644.0,58,5,8,13,74.0,82,5.49,53,331,2294,9.8
15485,Kevyn Adams,2003-04,29.0,7,29,78,78,11,18,29,105.0,1219.0,136,16,26,42,179.0,82,5.51,63,376,2272,9.9
15486,Kevyn Adams,2004-05,30.0,8,17,77,77,6,11,17,108.0,887.0,213,22,37,59,287.0,82,5.24,53,338,2262,9.5
15487,Kevyn Adams,2005-06,31.0,9,18,77,77,9,9,18,169.0,1128.0,290,31,46,77,456.0,82,5.31,60,363,2326,9.4
15488,Kevyn Adams,2006-07,32.0,10,22,73,73,10,12,22,141.0,970.0,363,41,58,99,597.0,82,5.14,57,348,2300,9.2
15489,Kevyn Adams,2008-09,34.0,11,23,82,82,15,8,23,160.0,1057.0,445,56,66,122,757.0,82,6.05,85,480,2458,10.1
15490,Kevyn Adams,2009-10,35.0,12,12,68,68,3,9,12,87.0,742.0,513,59,75,134,844.0,82,5.76,70,398,2426,9.7
15491,Kevyn Adams,2010-11,36.0,13,2,27,27,0,2,2,32.0,295.0,540,59,77,136,876.0,82,5.44,62,351,2383,9.4
15492,Kiefer Sherwood,2021-22,26.0,4,12,50,50,6,6,12,60.0,569.0,50,6,6,12,60.0,82,5.96,47,239,2579,9.5
15493,Kiefer Sherwood,2022-23,27.0,5,1,10,10,0,1,1,17.0,133.0,60,6,7,13,77.0,70,5.96,42,208,2192,9.5
15494,Kieffer Bellows,2022-23,24.0,4,3,8,8,2,1,3,11.0,85.0,8,2,1,3,11.0,70,5.96,42,208,2192,9.5
15495,Kim Clackson,1982-83,27.0,4,3,45,45,0,3,3,12.0,,45,0,3,3,12.0,80,7.03,61,280,2352,12.0
15496,Kim Clackson,1983-84,28.0,5,5,61,61,0,5,5,20.0,,106,0,8,8,32.0,80,7.69,77,340,2441,12.6
15497,Kim Issel,1991-92,24.0,4,0,4,4,0,0,0,1.0,,4,0,0,0,1.0,80,7.48,85,403,2430,12.3
15498,Kim Johnsson,2002-03,26.0,4,21,76,76,6,15,21,101.0,1376.0,76,6,15,21,101.0,82,5.49,53,331,2294,9.8
15499,Kim Johnsson,2003-04,27.0,5,26,75,75,5,21,26,104.0,1595.0,151,11,36,47,205.0,82,5.51,63,376,2272,9.9
15500,Kim Johnsson,2004-05,28.0,6,41,82,82,11,30,41,150.0,1889.0,233,22,66,88,355.0,82,5.24,53,338,2262,9.5
15501,Kim Johnsson,2005-06,29.0,7,39,82,82,10,29,39,159.0,1975.0,315,32,95,127,514.0,82,5.31,60,363,2326,9.4
15502,Kim Johnsson,2006-07,30.0,8,42,80,80,13,29,42,189.0,1956.0,395,45,124,169,703.0,82,5.14,57,348,2300,9.2
15503,Kim Johnsson,2008-09,32.0,9,25,47,47,6,19,25,97.0,1095.0,442,51,143,194,800.0,82,6.05,85,480,2458,10.1
15504,Kim Johnsson,2009-10,33.0,10,22,76,76,3,19,22,98.0,1790.0,518,54,162,216,898.0,82,5.76,70,398,2426,9.7
15505,Kim Johnsson,2010-11,34.0,11,27,80,80,4,23,27,87.0,1876.0,598,58,185,243,985.0,82,5.44,62,351,2383,9.4
15506,Kim Johnsson,2011-12,35.0,12,24,81,81,2,22,24,93.0,1987.0,679,60,207,267,1078.0,82,5.7,65,341,2477,9.4
15507,Kim Johnsson,2012-13,36.0,13,17,60,60,7,10,17,94.0,1367.0,739,67,217,284,1172.0,82,5.53,56,304,2486,9.1
15508,Kimbi Daniels,1993-94,22.0,4,1,2,2,0,1,1,2.0,,2,0,1,1,2.0,80,6.91,71,366,2385,11.6
15509,Kimbi Daniels,1994-95,23.0,5,2,25,25,1,1,2,16.0,,27,1,2,3,18.0,80,6.96,77,402,2440,11.4
15510,Kimmo Timonen,2001-02,26.0,4,12,50,50,4,8,12,75.0,953.0,50,4,8,12,75.0,82,5.27,57,359,2285,9.4
15511,Kimmo Timonen,2002-03,27.0,5,33,51,51,8,25,33,97.0,1076.0,101,12,33,45,172.0,82,5.49,53,331,2294,9.8
15512,Kimmo Timonen,2003-04,28.0,6,25,82,82,12,13,25,151.0,1901.0,183,24,46,70,323.0,82,5.51,63,376,2272,9.9
15513,Kimmo Timonen,2004-05,29.0,7,42,82,82,13,29,42,154.0,1984.0,265,37,75,112,477.0,82,5.24,53,338,2262,9.5
15514,Kimmo Timonen,2005-06,30.0,8,40,72,72,6,34,40,144.0,1614.0,337,43,109,152,621.0,82,5.31,60,363,2326,9.4
15515,Kimmo Timonen,2006-07,31.0,9,44,77,77,12,32,44,180.0,1838.0,414,55,141,196,801.0,82,5.14,57,348,2300,9.2
15516,Kimmo Timonen,2008-09,33.0,10,50,79,79,11,39,50,156.0,1773.0,493,66,180,246,957.0,82,6.05,85,480,2458,10.1
15517,Kimmo Timonen,2009-10,34.0,11,55,80,80,13,42,55,121.0,1748.0,573,79,222,301,1078.0,82,5.76,70,398,2426,9.7
15518,Kimmo Timonen,2010-11,35.0,12,44,80,80,8,36,44,125.0,1886.0,653,87,258,345,1203.0,82,5.44,62,351,2383,9.4
15519,Kimmo Timonen,2011-12,36.0,13,43,77,77,3,40,43,104.0,1888.0,730,90,298,388,1307.0,82,5.7,65,341,2477,9.4
15520,Kimmo Timonen,2012-13,37.0,14,39,82,82,6,33,39,121.0,1876.0,812,96,331,427,1428.0,82,5.53,56,304,2486,9.1
15521,Kimmo Timonen,2013-14,38.0,15,37,82,82,6,31,37,147.0,1843.0,894,102,362,464,1575.0,82,5.46,52,291,2492,9.0
15522,Kimmo Timonen,2014-15,39.0,16,43,76,76,4,39,43,130.0,1614.0,970,106,401,507,1705.0,82,5.32,47,271,2439,8.9
15523,Kimmo Timonen,2015-16,40.0,17,29,45,45,5,24,29,78.0,979.0,1015,111,425,536,1783.0,48,5.31,29,160,1399,9.1
15524,Kimmo Timonen,2016-17,41.0,18,35,77,77,6,29,35,152.0,1565.0,1092,117,454,571,1935.0,82,5.34,48,269,2463,8.9
15525,Kimmo Timonen,2017-18,42.0,19,0,16,16,0,0,0,10.0,192.0,1108,117,454,571,1945.0,82,5.32,47,251,2453,8.9
15526,Kip Brennan,2004-05,24.0,4,0,4,4,0,0,0,0.0,19.0,4,0,0,0,0.0,82,5.24,53,338,2262,9.5
15527,Kip Brennan,2005-06,25.0,5,0,19,19,0,0,0,6.0,93.0,23,0,0,0,6.0,82,5.31,60,363,2326,9.4
15528,Kip Brennan,2006-07,26.0,6,1,23,23,1,0,1,8.0,108.0,46,1,0,1,14.0,82,5.14,57,348,2300,9.2
15529,Kip Brennan,2008-09,28.0,7,1,12,12,0,1,1,5.0,51.0,58,1,1,2,19.0,82,6.05,85,480,2458,10.1
15530,Kip Brennan,2010-11,30.0,8,0,3,3,0,0,0,0.0,13.0,61,1,1,2,19.0,82,5.44,62,351,2383,9.4
15531,Kip Miller,1993-94,24.0,4,7,13,13,4,3,7,16.0,,13,4,3,7,16.0,80,6.91,71,366,2385,11.6
15532,Kip Miller,1994-95,25.0,5,18,39,39,6,12,18,49.0,,52,10,15,25,65.0,80,6.96,77,402,2440,11.4
15533,Kip Miller,1996-97,27.0,6,4,11,11,2,2,4,21.0,,63,12,17,29,86.0,84,6.48,76,407,2545,10.7
15534,Kip Miller,1997-98,28.0,7,1,8,8,0,1,1,11.0,,71,12,18,30,97.0,48,5.97,37,209,1408,10.2
15535,Kip Miller,1998-99,29.0,8,5,10,10,1,4,5,12.0,,81,13,22,35,109.0,82,6.29,74,413,2481,10.4
15536,Kip Miller,2000-01,31.0,9,4,9,9,1,3,4,11.0,,90,14,25,39,120.0,82,5.28,57,380,2242,9.6
15537,Kip Miller,2001-02,32.0,10,42,77,77,19,23,42,125.0,1303.0,167,33,48,81,245.0,82,5.27,57,359,2285,9.4
15538,Kip Miller,2002-03,33.0,11,42,74,74,10,32,42,82.0,1041.0,241,43,80,123,327.0,82,5.49,53,331,2294,9.8
15539,Kip Miller,2003-04,34.0,12,11,33,33,3,8,11,38.0,323.0,274,46,88,134,365.0,82,5.51,63,376,2272,9.9
15540,Kip Miller,2004-05,35.0,13,24,37,37,7,17,24,52.0,523.0,311,53,105,158,417.0,82,5.24,53,338,2262,9.5
15541,Kip Miller,2005-06,36.0,14,50,72,72,12,38,50,89.0,1077.0,383,65,143,208,506.0,82,5.31,60,363,2326,9.4
15542,Kip Miller,2006-07,37.0,15,31,66,66,9,22,31,74.0,928.0,449,74,165,239,580.0,82,5.14,57,348,2300,9.2
15543,Kirby Dach,2022-23,22.0,4,23,64,64,8,15,23,101.0,913.0,64,8,15,23,101.0,70,5.96,42,208,2192,9.5
15544,Kirby Law,2003-04,26.0,4,0,1,1,0,0,0,0.0,3.0,1,0,0,0,0.0,82,5.51,63,376,2272,9.9
15545,Kirby Law,2005-06,28.0,5,0,2,2,0,0,0,0.0,3.0,3,0,0,0,0.0,82,5.31,60,363,2326,9.4
15546,Kirby Law,2006-07,29.0,6,1,6,6,0,1,1,1.0,49.0,9,0,1,1,1.0,82,5.14,57,348,2300,9.2
15547,Kirill Safronov,2004-05,23.0,4,0,3,3,0,0,0,2.0,49.0,3,0,0,0,2.0,82,5.24,53,338,2262,9.5
15548,Kirill Safronov,2005-06,24.0,5,4,32,32,2,2,4,21.0,481.0,35,2,2,4,23.0,82,5.31,60,363,2326,9.4
15549,Kirk Maltby,1996-97,24.0,4,19,68,68,11,8,19,89.0,,68,11,8,19,89.0,84,6.48,76,407,2545,10.7
15550,Kirk Maltby,1997-98,25.0,5,11,47,47,8,3,11,73.0,,115,19,11,30,162.0,48,5.97,37,209,1408,10.2
15551,Kirk Maltby,1998-99,26.0,6,9,55,55,3,6,9,55.0,,170,22,17,39,217.0,82,6.29,74,413,2481,10.4
15552,Kirk Maltby,1999-00,27.0,7,8,66,66,3,5,8,62.0,,236,25,22,47,279.0,82,5.83,55,336,2444,9.8
15553,Kirk Maltby,2000-01,28.0,8,23,65,65,14,9,23,106.0,,301,39,31,70,385.0,82,5.28,57,380,2242,9.6
15554,Kirk Maltby,2001-02,29.0,9,14,53,53,8,6,14,76.0,700.0,354,47,37,84,461.0,82,5.27,57,359,2285,9.4
15555,Kirk Maltby,2002-03,30.0,10,14,41,41,6,8,14,71.0,554.0,395,53,45,98,532.0,82,5.49,53,331,2294,9.8
15556,Kirk Maltby,2003-04,31.0,11,19,79,79,12,7,19,119.0,1129.0,474,65,52,117,651.0,82,5.51,63,376,2272,9.9
15557,Kirk Maltby,2004-05,32.0,12,24,82,82,9,15,24,108.0,1097.0,556,74,67,141,759.0,82,5.24,53,338,2262,9.5
15558,Kirk Maltby,2005-06,33.0,13,37,82,82,14,23,37,116.0,1326.0,638,88,90,178,875.0,82,5.31,60,363,2326,9.4
15559,Kirk Maltby,2006-07,34.0,14,33,79,79,14,19,33,123.0,1285.0,717,102,109,211,998.0,82,5.14,57,348,2300,9.2
15560,Kirk Maltby,2008-09,36.0,15,11,82,82,5,6,11,115.0,1126.0,799,107,115,222,1113.0,82,6.05,85,480,2458,10.1
15561,Kirk Maltby,2009-10,37.0,16,11,82,82,6,5,11,113.0,1081.0,881,113,120,233,1226.0,82,5.76,70,398,2426,9.7
15562,Kirk Maltby,2010-11,38.0,17,10,61,61,6,4,10,70.0,736.0,942,119,124,243,1296.0,82,5.44,62,351,2383,9.4
15563,Kirk Maltby,2011-12,39.0,18,11,78,78,5,6,11,58.0,713.0,1020,124,130,254,1354.0,82,5.7,65,341,2477,9.4
15564,Kirk Maltby,2012-13,40.0,19,6,52,52,4,2,6,43.0,526.0,1072,128,132,260,1397.0,82,5.53,56,304,2486,9.1
15565,Kirk Muller,1987-88,21.0,4,54,80,80,17,37,54,158.0,,80,17,37,54,158.0,80,7.77,71,321,2447,12.7
15566,Kirk Muller,1988-89,22.0,5,66,77,77,25,41,66,168.0,,157,42,78,120,326.0,80,7.94,82,370,2484,12.8
15567,Kirk Muller,1989-90,23.0,6,76,79,79,26,50,76,193.0,,236,68,128,196,519.0,80,7.34,72,344,2400,12.2
15568,Kirk Muller,1990-91,24.0,7,94,80,80,37,57,94,215.0,,316,105,185,290,734.0,80,7.43,89,437,2435,12.2
15569,Kirk Muller,1991-92,25.0,8,74,80,80,31,43,74,182.0,,396,136,228,364,916.0,80,7.48,85,403,2430,12.3
15570,Kirk Muller,1992-93,26.0,9,86,80,80,30,56,86,200.0,,476,166,284,450,1116.0,80,7.37,76,367,2421,12.2
15571,Kirk Muller,1993-94,27.0,10,70,80,80,19,51,70,221.0,,556,185,335,520,1337.0,80,6.91,71,366,2385,11.6
15572,Kirk Muller,1994-95,28.0,11,77,78,78,36,41,77,191.0,,634,221,376,597,1528.0,80,6.96,77,402,2440,11.4
15573,Kirk Muller,1995-96,29.0,12,94,80,80,37,57,94,231.0,,714,258,433,691,1759.0,84,7.25,87,443,2603,11.7
15574,Kirk Muller,1996-97,30.0,13,57,76,76,23,34,57,168.0,,790,281,467,748,1927.0,84,6.48,76,407,2545,10.7
15575,Kirk Muller,1997-98,31.0,14,27,45,45,11,16,27,97.0,,835,292,483,775,2024.0,48,5.97,37,209,1408,10.2
15576,Kirk Muller,1998-99,32.0,15,32,51,51,13,19,32,102.0,,886,305,502,807,2126.0,82,6.29,74,413,2481,10.4
15577,Kirk Muller,1999-00,33.0,16,40,76,76,21,19,40,174.0,,962,326,521,847,2300.0,82,5.83,55,336,2444,9.8
15578,Kirk Muller,2000-01,34.0,17,29,70,70,8,21,29,115.0,,1032,334,542,876,2415.0,82,5.28,57,380,2242,9.6
15579,Kirk Muller,2001-02,35.0,18,15,82,82,4,11,15,107.0,1186.0,1114,338,553,891,2522.0,82,5.27,57,359,2285,9.4
15580,Kirk Muller,2002-03,36.0,19,22,47,47,7,15,22,57.0,770.0,1161,345,568,913,2579.0,82,5.49,53,331,2294,9.8
15581,Kirk Muller,2003-04,37.0,20,10,55,55,1,9,10,54.0,680.0,1216,346,577,923,2633.0,82,5.51,63,376,2272,9.9
15582,Kirk Muller,2004-05,38.0,21,30,78,78,10,20,30,111.0,1076.0,1294,356,597,953,2744.0,82,5.24,53,338,2262,9.5
15583,Kirk Muller,2005-06,39.0,22,6,55,55,1,5,6,48.0,521.0,1349,357,602,959,2792.0,82,5.31,60,363,2326,9.4
15584,Kirk Nielsen,2000-01,27.0,4,0,6,6,0,0,0,1.0,,6,0,0,0,1.0,82,5.28,57,380,2242,9.6
15585,Kirk Tomlinson,1990-91,22.0,4,0,1,1,0,0,0,0.0,,1,0,0,0,0.0,80,7.43,89,437,2435,12.2
15586,Kjell Dahlin,1988-89,25.0,4,71,77,77,32,39,71,172.0,,77,32,39,71,172.0,80,7.94,82,370,2484,12.8
15587,Kjell Dahlin,1989-90,26.0,5,20,41,41,12,8,20,53.0,,118,44,47,91,225.0,80,7.34,72,344,2400,12.2
15588,Kjell Dahlin,1990-91,27.0,6,25,48,48,13,12,25,51.0,,166,57,59,116,276.0,80,7.43,89,437,2435,12.2
15589,Kjell Samuelsson,1988-89,30.0,4,0,9,9,0,0,0,7.0,,9,0,0,0,7.0,80,7.94,82,370,2484,12.8
15590,Kjell Samuelsson,1989-90,31.0,5,15,76,76,3,12,15,48.0,,85,3,12,15,55.0,80,7.34,72,344,2400,12.2
15591,Kjell Samuelsson,1990-91,32.0,6,30,74,74,6,24,30,118.0,,159,9,36,45,173.0,80,7.43,89,437,2435,12.2
15592,Kjell Samuelsson,1991-92,33.0,7,17,69,69,3,14,17,60.0,,228,12,50,62,233.0,80,7.48,85,403,2430,12.3
15593,Kjell Samuelsson,1992-93,34.0,8,22,66,66,5,17,22,88.0,,294,17,67,84,321.0,80,7.37,76,367,2421,12.2
15594,Kjell Samuelsson,1993-94,35.0,9,28,78,78,9,19,28,101.0,,372,26,86,112,422.0,80,6.91,71,366,2385,11.6
15595,Kjell Samuelsson,1994-95,36.0,10,16,74,74,5,11,16,91.0,,446,31,97,128,513.0,80,6.96,77,402,2440,11.4
15596,Kjell Samuelsson,1995-96,37.0,11,9,63,63,3,6,9,63.0,,509,34,103,137,576.0,84,7.25,87,443,2603,11.7
15597,Kjell Samuelsson,1996-97,38.0,12,13,59,59,5,8,13,57.0,,568,39,111,150,633.0,84,6.48,76,407,2545,10.7
15598,Kjell Samuelsson,1997-98,39.0,13,7,41,41,1,6,7,37.0,,609,40,117,157,670.0,48,5.97,37,209,1408,10.2
15599,Kjell Samuelsson,1998-99,40.0,14,14,75,75,3,11,14,62.0,,684,43,128,171,732.0,82,6.29,74,413,2481,10.4
15600,Kjell Samuelsson,1999-00,41.0,15,7,34,34,4,3,7,36.0,,718,47,131,178,768.0,82,5.83,55,336,2444,9.8
15601,Kjell Samuelsson,2000-01,42.0,16,3,49,49,0,3,3,23.0,,767,47,134,181,791.0,82,5.28,57,380,2242,9.6
15602,Kjell Samuelsson,2001-02,43.0,17,5,46,46,1,4,5,22.0,856.0,813,48,138,186,813.0,82,5.27,57,359,2285,9.4
15603,Klas Dahlbeck,2017-18,26.0,4,4,23,23,1,3,4,20.0,406.0,23,1,3,4,20.0,82,5.32,47,251,2453,8.9
15604,Klas Dahlbeck,2018-19,27.0,5,8,71,71,2,6,8,64.0,1117.0,94,3,9,12,84.0,82,5.34,48,255,2438,9.0
15605,Klas Dahlbeck,2019-20,28.0,6,6,43,43,2,4,6,37.0,597.0,137,5,13,18,121.0,82,5.45,47,245,2478,9.0
15606,Klas Dahlbeck,2020-21,29.0,7,5,33,33,1,4,5,43.0,540.0,170,6,17,23,164.0,82,5.86,50,250,2620,9.2
15607,Klim Kostin,2022-23,23.0,4,1,4,4,1,0,1,5.0,34.0,4,1,0,1,5.0,70,5.96,42,208,2192,9.5
15608,Kole Sherwood,2021-22,25.0,4,0,2,2,0,0,0,2.0,18.0,2,0,0,0,2.0,82,5.96,47,239,2579,9.5
15609,Kole Sherwood,2022-23,26.0,5,0,3,3,0,0,0,6.0,20.0,5,0,0,0,8.0,70,5.96,42,208,2192,9.5
15610,Konstantin Koltsov,2005-06,24.0,4,0,2,2,0,0,0,4.0,26.0,2,0,0,0,4.0,82,5.31,60,363,2326,9.4
15611,Konstantin Koltsov,2006-07,25.0,5,29,82,82,9,20,29,123.0,1259.0,84,9,20,29,127.0,82,5.14,57,348,2300,9.2
15612,Konstantin Koltsov,2008-09,27.0,6,9,60,60,3,6,9,72.0,795.0,144,12,26,38,199.0,82,6.05,85,480,2458,10.1
15613,Konstantin Pushkarev,2008-09,23.0,4,1,1,1,0,1,1,0.0,10.0,1,0,1,1,0.0,82,6.05,85,480,2458,10.1
15614,Konstantin Pushkarev,2009-10,24.0,5,4,16,16,2,2,4,10.0,147.0,17,2,3,5,10.0,82,5.76,70,398,2426,9.7
15615,Konstantin Shafranov,1999-00,31.0,4,3,5,5,2,1,3,8.0,,5,2,1,3,8.0,82,5.83,55,336,2444,9.8
15616,Korbinian Holzer,2013-14,25.0,4,0,2,2,0,0,0,1.0,26.0,2,0,0,0,1.0,82,5.46,52,291,2492,9.0
15617,Korbinian Holzer,2015-16,27.0,5,3,22,22,2,1,3,16.0,407.0,24,2,1,3,17.0,48,5.31,29,160,1399,9.1
15618,Korbinian Holzer,2017-18,29.0,6,6,34,34,0,6,6,32.0,582.0,58,2,7,9,49.0,82,5.32,47,251,2453,8.9
15619,Korbinian Holzer,2018-19,30.0,7,3,29,29,0,3,3,17.0,428.0,87,2,10,12,66.0,82,5.34,48,255,2438,9.0
15620,Korbinian Holzer,2019-20,31.0,8,7,32,32,2,5,7,14.0,432.0,119,4,15,19,80.0,82,5.45,47,245,2478,9.0
15621,Korbinian Holzer,2020-21,32.0,9,0,16,16,0,0,0,10.0,186.0,135,4,15,19,90.0,82,5.86,50,250,2620,9.2
15622,Korbinian Holzer,2021-22,33.0,10,4,22,22,1,3,4,15.0,353.0,157,5,18,23,105.0,82,5.96,47,239,2579,9.5
15623,Korbinian Holzer,2022-23,34.0,11,4,49,49,1,3,4,39.0,786.0,206,6,21,27,144.0,70,5.96,42,208,2192,9.5
15624,Kraig Nienhuis,1988-89,27.0,4,30,70,70,16,14,30,120.0,,70,16,14,30,120.0,80,7.94,82,370,2484,12.8
15625,Kraig Nienhuis,1989-90,28.0,5,6,16,16,4,2,6,24.0,,86,20,16,36,144.0,80,7.34,72,344,2400,12.2
15626,Kraig Nienhuis,1990-91,29.0,6,0,1,1,0,0,0,4.0,,87,20,16,36,148.0,80,7.43,89,437,2435,12.2
15627,Kris Beech,2003-04,22.0,4,0,4,4,0,0,0,0.0,30.0,4,0,0,0,0.0,82,5.51,63,376,2272,9.9
15628,Kris Beech,2004-05,23.0,5,25,79,79,10,15,25,126.0,1071.0,83,10,15,25,126.0,82,5.24,53,338,2262,9.5
15629,Kris Beech,2005-06,24.0,6,1,12,12,0,1,1,6.0,127.0,95,10,16,26,132.0,82,5.31,60,363,2326,9.4
15630,Kris Beech,2006-07,25.0,7,1,4,4,0,1,1,6.0,50.0,99,10,17,27,138.0,82,5.14,57,348,2300,9.2
15631,Kris Beech,2008-09,27.0,8,3,10,10,1,2,3,12.0,120.0,109,11,19,30,150.0,82,6.05,85,480,2458,10.1
15632,Kris Beech,2009-10,28.0,9,26,64,64,8,18,26,77.0,798.0,173,19,37,56,227.0,82,5.76,70,398,2426,9.7
15633,Kris Beech,2010-11,29.0,10,11,25,25,6,5,11,36.0,288.0,198,25,42,67,263.0,82,5.44,62,351,2383,9.4
15634,Kris Chucko,2011-12,25.0,4,0,2,2,0,0,0,0.0,14.0,2,0,0,0,0.0,82,5.7,65,341,2477,9.4
15635,Kris Draper,1993-94,22.0,4,1,3,3,1,0,1,1.0,,3,1,0,1,1.0,80,6.91,71,366,2385,11.6
15636,Kris Draper,1994-95,23.0,5,2,10,10,2,0,2,19.0,,13,3,0,3,20.0,80,6.96,77,402,2440,11.4
15637,Kris Draper,1995-96,24.0,6,0,7,7,0,0,0,5.0,,20,3,0,3,25.0,84,7.25,87,443,2603,11.7
15638,Kris Draper,1996-97,25.0,7,13,39,39,5,8,13,55.0,,59,8,8,16,80.0,84,6.48,76,407,2545,10.7
15639,Kris Draper,1997-98,26.0,8,8,36,36,2,6,8,44.0,,95,10,14,24,124.0,48,5.97,37,209,1408,10.2
15640,Kris Draper,1998-99,27.0,9,16,52,52,7,9,16,51.0,,147,17,23,40,175.0,82,6.29,74,413,2481,10.4
15641,Kris Draper,1999-00,28.0,10,13,76,76,8,5,13,85.0,,223,25,28,53,260.0,82,5.83,55,336,2444,9.8
15642,Kris Draper,2000-01,29.0,11,23,64,64,13,10,23,96.0,,287,38,38,76,356.0,82,5.28,57,380,2242,9.6
15643,Kris Draper,2001-02,30.0,12,18,80,80,4,14,18,78.0,1017.0,367,42,52,94,434.0,82,5.27,57,359,2285,9.4
15644,Kris Draper,2002-03,31.0,13,12,51,51,5,7,12,76.0,691.0,418,47,59,106,510.0,82,5.49,53,331,2294,9.8
15645,Kris Draper,2003-04,32.0,14,25,75,75,8,17,25,123.0,1008.0,493,55,76,131,633.0,82,5.51,63,376,2272,9.9
15646,Kris Draper,2004-05,33.0,15,30,82,82,15,15,30,137.0,1278.0,575,70,91,161,770.0,82,5.24,53,338,2262,9.5
15647,Kris Draper,2005-06,34.0,16,35,82,82,14,21,35,142.0,1328.0,657,84,112,196,912.0,82,5.31,60,363,2326,9.4
15648,Kris Draper,2006-07,35.0,17,40,67,67,24,16,40,149.0,1188.0,724,108,128,236,1061.0,82,5.14,57,348,2300,9.2
15649,Kris Draper,2008-09,37.0,18,32,80,80,10,22,32,153.0,1422.0,804,118,150,268,1214.0,82,6.05,85,480,2458,10.1
15650,Kris Draper,2009-10,38.0,19,29,81,81,14,15,29,157.0,1357.0,885,132,165,297,1371.0,82,5.76,70,398,2426,9.7
15651,Kris Draper,2010-11,39.0,20,17,65,65,9,8,17,97.0,1016.0,950,141,173,314,1468.0,82,5.44,62,351,2383,9.4
15652,Kris Draper,2011-12,40.0,21,17,79,79,7,10,17,93.0,947.0,1029,148,183,331,1561.0,82,5.7,65,341,2477,9.4
15653,Kris Draper,2012-13,41.0,22,22,81,81,7,15,22,98.0,935.0,1110,155,198,353,1659.0,82,5.53,56,304,2486,9.1
15654,Kris Draper,2013-14,42.0,23,11,47,47,6,5,11,57.0,491.0,1157,161,203,364,1716.0,82,5.46,52,291,2492,9.0
15655,Kris Foucault,2014-15,24.0,4,0,1,1,0,0,0,0.0,9.0,1,0,0,0,0.0,82,5.32,47,271,2439,8.9
15656,Kris Fredheim,2014-15,27.0,4,0,3,3,0,0,0,0.0,36.0,3,0,0,0,0.0,82,5.32,47,271,2439,8.9
15657,Kris King,1990-91,24.0,4,1,3,3,1,0,1,3.0,,3,1,0,1,3.0,80,7.43,89,437,2435,12.2
15658,Kris King,1991-92,25.0,5,5,55,55,2,3,5,34.0,,58,3,3,6,37.0,80,7.48,85,403,2430,12.3
15659,Kris King,1992-93,26.0,6,13,68,68,6,7,13,49.0,,126,9,10,19,86.0,80,7.37,76,367,2421,12.2
15660,Kris King,1993-94,27.0,7,25,72,72,11,14,25,107.0,,198,20,24,44,193.0,80,6.91,71,366,2385,11.6
15661,Kris King,1994-95,28.0,8,19,79,79,10,9,19,97.0,,277,30,33,63,290.0,80,6.96,77,402,2440,11.4
15662,Kris King,1995-96,29.0,9,19,78,78,8,11,19,74.0,,355,38,44,82,364.0,84,7.25,87,443,2603,11.7
15663,Kris King,1996-97,30.0,10,12,83,83,4,8,12,86.0,,438,42,52,94,450.0,84,6.48,76,407,2545,10.7
15664,Kris King,1997-98,31.0,11,6,48,48,4,2,6,58.0,,486,46,54,100,508.0,48,5.97,37,209,1408,10.2
15665,Kris King,1998-99,32.0,12,20,81,81,9,11,20,89.0,,567,55,65,120,597.0,82,6.29,74,413,2481,10.4
15666,Kris King,1999-00,33.0,13,14,81,81,3,11,14,57.0,,648,58,76,134,654.0,82,5.83,55,336,2444,9.8
15667,Kris King,2000-01,34.0,14,6,82,82,3,3,6,53.0,,730,61,79,140,707.0,82,5.28,57,380,2242,9.6
15668,Kris King,2001-02,35.0,15,4,67,67,2,2,4,34.0,628.0,797,63,81,144,741.0,82,5.27,57,359,2285,9.4
15669,Kris King,2002-03,36.0,16,6,39,39,2,4,6,24.0,332.0,836,65,85,150,765.0,82,5.49,53,331,2294,9.8
15670,Kris King,2003-04,37.0,17,1,13,13,1,0,1,12.0,130.0,849,66,85,151,777.0,82,5.51,63,376,2272,9.9
15671,Kris Letang,2009-10,22.0,4,2,7,7,2,0,2,8.0,81.0,7,2,0,2,8.0,82,5.76,70,398,2426,9.7
15672,Kris Letang,2010-11,23.0,5,17,63,63,6,11,17,68.0,1144.0,70,8,11,19,76.0,82,5.44,62,351,2383,9.4
15673,Kris Letang,2011-12,24.0,6,33,74,74,10,23,33,138.0,1565.0,144,18,34,52,214.0,82,5.7,65,341,2477,9.4
15674,Kris Letang,2012-13,25.0,7,27,73,73,3,24,27,174.0,1574.0,217,21,58,79,388.0,82,5.53,56,304,2486,9.1
15675,Kris Letang,2013-14,26.0,8,50,82,82,8,42,50,236.0,1971.0,299,29,100,129,624.0,82,5.46,52,291,2492,9.0
15676,Kris Letang,2014-15,27.0,9,42,51,51,10,32,42,142.0,1267.0,350,39,132,171,766.0,82,5.32,47,271,2439,8.9
15677,Kris Letang,2015-16,28.0,10,38,35,35,5,33,38,95.0,897.0,385,44,165,209,861.0,48,5.31,29,160,1399,9.1
15678,Kris Letang,2016-17,29.0,11,22,37,37,11,11,22,108.0,897.0,422,55,176,231,969.0,82,5.34,48,269,2463,8.9
15679,Kris Letang,2017-18,30.0,12,54,69,69,11,43,54,197.0,1759.0,491,66,219,285,1166.0,82,5.32,47,251,2453,8.9
15680,Kris Letang,2018-19,31.0,13,67,71,71,16,51,67,218.0,1913.0,562,82,270,352,1384.0,82,5.34,48,255,2438,9.0
15681,Kris Letang,2019-20,32.0,14,34,41,41,5,29,34,122.0,1046.0,603,87,299,386,1506.0,82,5.45,47,245,2478,9.0
15682,Kris Letang,2020-21,33.0,15,51,79,79,9,42,51,222.0,2001.0,682,96,341,437,1728.0,82,5.86,50,250,2620,9.2
15683,Kris Letang,2021-22,34.0,16,56,65,65,16,40,56,206.0,1687.0,747,112,381,493,1934.0,82,5.96,47,239,2579,9.5
15684,Kris Letang,2022-23,35.0,17,44,61,61,15,29,44,177.0,1569.0,808,127,410,537,2111.0,70,5.96,42,208,2192,9.5
15685,Kris Newbury,2009-10,27.0,4,4,15,15,2,2,4,30.0,115.0,15,2,2,4,30.0,82,5.76,70,398,2426,9.7
15686,Kris Newbury,2010-11,28.0,5,2,28,28,1,1,2,14.0,122.0,43,3,3,6,44.0,82,5.44,62,351,2383,9.4
15687,Kris Newbury,2011-12,29.0,6,0,1,1,0,0,0,0.0,5.0,44,3,3,6,44.0,82,5.7,65,341,2477,9.4
15688,Kris Newbury,2012-13,30.0,7,1,4,4,1,0,1,3.0,35.0,48,4,3,7,47.0,82,5.53,56,304,2486,9.1
15689,Kris Newbury,2013-14,31.0,8,1,11,11,0,1,1,6.0,84.0,59,4,4,8,53.0,82,5.46,52,291,2492,9.0
15690,Kris Newbury,2014-15,32.0,9,0,7,7,0,0,0,2.0,41.0,66,4,4,8,55.0,82,5.32,47,271,2439,8.9
15691,Kris Newbury,2015-16,33.0,10,1,6,6,0,1,1,4.0,47.0,72,4,5,9,59.0,48,5.31,29,160,1399,9.1
15692,Kris Newbury,2016-17,34.0,11,1,4,4,0,1,1,1.0,20.0,76,4,6,10,60.0,82,5.34,48,269,2463,8.9
15693,Kris Russell,2010-11,23.0,4,10,67,67,2,8,10,90.0,991.0,67,2,8,10,90.0,82,5.44,62,351,2383,9.4
15694,Kris Russell,2011-12,24.0,5,21,66,66,2,19,21,86.0,1064.0,133,4,27,31,176.0,82,5.7,65,341,2477,9.4
15695,Kris Russell,2012-13,25.0,6,22,70,70,7,15,22,108.0,1301.0,203,11,42,53,284.0,82,5.53,56,304,2486,9.1
15696,Kris Russell,2013-14,26.0,7,23,73,73,5,18,23,88.0,1279.0,276,16,60,76,372.0,82,5.46,52,291,2492,9.0
15697,Kris Russell,2014-15,27.0,8,12,55,55,6,6,12,56.0,936.0,331,22,66,88,428.0,82,5.32,47,271,2439,8.9
15698,Kris Russell,2015-16,28.0,9,7,33,33,1,6,7,41.0,530.0,364,23,72,95,469.0,48,5.31,29,160,1399,9.1
15699,Kris Russell,2016-17,29.0,10,29,68,68,7,22,29,109.0,1573.0,432,30,94,124,578.0,82,5.34,48,269,2463,8.9
15700,Kris Russell,2017-18,30.0,11,34,79,79,4,30,34,111.0,1892.0,511,34,124,158,689.0,82,5.32,47,251,2453,8.9
15701,Kris Russell,2018-19,31.0,12,19,62,62,4,15,19,70.0,1431.0,573,38,139,177,759.0,82,5.34,48,255,2438,9.0
15702,Kris Russell,2019-20,32.0,13,13,68,68,1,12,13,68.0,1443.0,641,39,151,190,827.0,82,5.45,47,245,2478,9.0
15703,Kris Russell,2020-21,33.0,14,21,78,78,4,17,21,90.0,1487.0,719,43,168,211,917.0,82,5.86,50,250,2620,9.2
15704,Kris Russell,2021-22,34.0,15,16,72,72,3,13,16,63.0,1471.0,791,46,181,227,980.0,82,5.96,47,239,2579,9.5
15705,Kris Russell,2022-23,35.0,16,9,55,55,0,9,9,45.0,923.0,846,46,190,236,1025.0,70,5.96,42,208,2192,9.5
15706,Kris Vernarsky,2005-06,23.0,4,1,14,14,1,0,1,18.0,144.0,14,1,0,1,18.0,82,5.31,60,363,2326,9.4
15707,Kris Vernarsky,2006-07,24.0,5,0,3,3,0,0,0,0.0,20.0,17,1,0,1,18.0,82,5.14,57,348,2300,9.2
15708,Kris Versteeg,2010-11,24.0,4,4,13,13,2,2,4,21.0,206.0,13,2,2,4,21.0,82,5.44,62,351,2383,9.4
15709,Kris Versteeg,2011-12,25.0,5,53,78,78,22,31,53,139.0,1329.0,91,24,33,57,160.0,82,5.7,65,341,2477,9.4
15710,Kris Versteeg,2012-13,26.0,6,44,79,79,20,24,44,184.0,1242.0,170,44,57,101,344.0,82,5.53,56,304,2486,9.1
15711,Kris Versteeg,2013-14,27.0,7,46,80,80,21,25,46,180.0,1418.0,250,65,82,147,524.0,82,5.46,52,291,2492,9.0
15712,Kris Versteeg,2014-15,28.0,8,54,71,71,23,31,54,181.0,1414.0,321,88,113,201,705.0,82,5.32,47,271,2439,8.9
15713,Kris Versteeg,2015-16,29.0,9,4,10,10,2,2,4,20.0,169.0,331,90,115,205,725.0,48,5.31,29,160,1399,9.1
15714,Kris Versteeg,2016-17,30.0,10,36,81,81,12,24,36,157.0,1171.0,412,102,139,241,882.0,82,5.34,48,269,2463,8.9
15715,Kris Versteeg,2017-18,31.0,11,34,61,61,14,20,34,134.0,967.0,473,116,159,275,1016.0,82,5.32,47,251,2453,8.9
15716,Kris Versteeg,2018-19,32.0,12,38,77,77,15,23,38,156.0,1185.0,550,131,182,313,1172.0,82,5.34,48,255,2438,9.0
15717,Kris Versteeg,2019-20,33.0,13,37,69,69,15,22,37,136.0,1016.0,619,146,204,350,1308.0,82,5.45,47,245,2478,9.0
15718,Kris Versteeg,2020-21,34.0,14,8,24,24,3,5,8,49.0,316.0,643,149,209,358,1357.0,82,5.86,50,250,2620,9.2
15719,Kristian Huselius,2004-05,26.0,4,45,79,79,23,22,45,169.0,1336.0,79,23,22,45,169.0,82,5.24,53,338,2262,9.5
15720,Kristian Huselius,2005-06,27.0,5,43,78,78,20,23,43,187.0,1352.0,157,43,45,88,356.0,82,5.31,60,363,2326,9.4
15721,Kristian Huselius,2006-07,28.0,6,31,76,76,10,21,31,168.0,1082.0,233,53,66,119,524.0,82,5.14,57,348,2300,9.2
15722,Kristian Huselius,2008-09,30.0,7,47,78,78,20,27,47,164.0,1159.0,311,73,93,166,688.0,82,6.05,85,480,2458,10.1
15723,Kristian Huselius,2009-10,31.0,8,77,81,81,34,43,77,173.0,1408.0,392,107,136,243,861.0,82,5.76,70,398,2426,9.7
15724,Kristian Huselius,2010-11,32.0,9,66,81,81,25,41,66,202.0,1433.0,473,132,177,309,1063.0,82,5.44,62,351,2383,9.4
15725,Kristian Huselius,2011-12,33.0,10,56,74,74,21,35,56,212.0,1444.0,547,153,212,365,1275.0,82,5.7,65,341,2477,9.4
15726,Kristian Huselius,2012-13,34.0,11,63,74,74,23,40,63,162.0,1361.0,621,176,252,428,1437.0,82,5.53,56,304,2486,9.1
15727,Kristian Huselius,2013-14,35.0,12,23,39,39,14,9,23,94.0,639.0,660,190,261,451,1531.0,82,5.46,52,291,2492,9.0
15728,Kristian Huselius,2014-15,36.0,13,0,2,2,0,0,0,2.0,32.0,662,190,261,451,1533.0,82,5.32,47,271,2439,8.9
15729,Kristian Kudroc,2003-04,22.0,4,4,22,22,2,2,4,12.0,201.0,22,2,2,4,12.0,82,5.51,63,376,2272,9.9
15730,Kristian Kudroc,2004-05,23.0,5,0,2,2,0,0,0,0.0,16.0,24,2,2,4,12.0,82,5.24,53,338,2262,9.5
15731,Kristian Kudroc,2006-07,25.0,6,0,2,2,0,0,0,0.0,15.0,26,2,2,4,12.0,82,5.14,57,348,2300,9.2
15732,Kristian Vesalainen,2021-22,22.0,4,1,5,5,0,1,1,1.0,34.0,5,0,1,1,1.0,82,5.96,47,239,2579,9.5
15733,Krys Barch,2009-10,29.0,4,5,26,26,3,2,5,12.0,147.0,26,3,2,5,12.0,82,5.76,70,398,2426,9.7
15734,Krys Barch,2010-11,30.0,5,3,48,48,1,2,3,23.0,312.0,74,4,4,8,35.0,82,5.44,62,351,2383,9.4
15735,Krys Barch,2011-12,31.0,6,9,72,72,4,5,9,27.0,465.0,146,8,9,17,62.0,82,5.7,65,341,2477,9.4
15736,Krys Barch,2012-13,32.0,7,6,63,63,0,6,6,29.0,444.0,209,8,15,23,91.0,82,5.53,56,304,2486,9.1
15737,Krys Barch,2013-14,33.0,8,3,44,44,2,1,3,16.0,230.0,253,10,16,26,107.0,82,5.46,52,291,2492,9.0
15738,Krys Barch,2014-15,34.0,9,5,51,51,2,3,5,24.0,375.0,304,12,19,31,131.0,82,5.32,47,271,2439,8.9
15739,Krys Barch,2015-16,35.0,10,0,22,22,0,0,0,4.0,129.0,326,12,19,31,135.0,48,5.31,29,160,1399,9.1
15740,Krys Barch,2016-17,36.0,11,4,55,55,0,4,4,19.0,329.0,381,12,23,35,154.0,82,5.34,48,269,2463,8.9
15741,Krys Kolanos,2004-05,23.0,4,22,57,57,11,11,22,81.0,745.0,57,11,11,22,81.0,82,5.24,53,338,2262,9.5
15742,Krys Kolanos,2005-06,24.0,5,0,2,2,0,0,0,8.0,28.0,59,11,11,22,89.0,82,5.31,60,363,2326,9.4
15743,Krys Kolanos,2006-07,25.0,6,10,41,41,4,6,10,61.0,554.0,100,15,17,32,150.0,82,5.14,57,348,2300,9.2
15744,Krys Kolanos,2008-09,27.0,7,3,15,15,2,1,3,22.0,149.0,115,17,18,35,172.0,82,6.05,85,480,2458,10.1
15745,Krys Kolanos,2011-12,30.0,8,6,21,21,3,3,6,30.0,223.0,136,20,21,41,202.0,82,5.7,65,341,2477,9.4
15746,Krys Kolanos,2014-15,33.0,9,1,13,13,0,1,1,29.0,128.0,149,20,22,42,231.0,82,5.32,47,271,2439,8.9
15747,Krzysztof Oliwa,1999-00,26.0,4,0,1,1,0,0,0,0.0,,1,0,0,0,0.0,82,5.83,55,336,2444,9.8
15748,Krzysztof Oliwa,2000-01,27.0,5,5,73,73,2,3,5,53.0,,74,2,3,5,53.0,82,5.28,57,380,2242,9.6
15749,Krzysztof Oliwa,2001-02,28.0,6,12,64,64,5,7,12,59.0,450.0,138,7,10,17,112.0,82,5.27,57,359,2285,9.4
15750,Krzysztof Oliwa,2002-03,29.0,7,16,69,69,6,10,16,61.0,466.0,207,13,20,33,173.0,82,5.49,53,331,2294,9.8
15751,Krzysztof Oliwa,2003-04,30.0,8,5,36,36,1,4,5,22.0,182.0,243,14,24,38,195.0,82,5.51,63,376,2272,9.9
15752,Krzysztof Oliwa,2004-05,31.0,9,2,57,57,0,2,2,31.0,318.0,300,14,26,40,226.0,82,5.24,53,338,2262,9.5
15753,Krzysztof Oliwa,2005-06,32.0,10,0,42,42,0,0,0,14.0,165.0,342,14,26,40,240.0,82,5.31,60,363,2326,9.4
15754,Krzysztof Oliwa,2006-07,33.0,11,5,65,65,3,2,5,32.0,320.0,407,17,28,45,272.0,82,5.14,57,348,2300,9.2
15755,Krzysztof Oliwa,2008-09,35.0,12,0,3,3,0,0,0,1.0,19.0,410,17,28,45,273.0,82,6.05,85,480,2458,10.1
15756,Kurt Sauer,2005-06,25.0,4,3,80,80,1,2,3,50.0,1484.0,80,1,2,3,50.0,82,5.31,60,363,2326,9.4
15757,Kurt Sauer,2006-07,26.0,5,6,69,69,1,5,6,44.0,1140.0,149,2,7,9,94.0,82,5.14,57,348,2300,9.2
15758,Kurt Sauer,2008-09,28.0,6,5,37,37,1,4,5,19.0,474.0,186,3,11,14,113.0,82,6.05,85,480,2458,10.1
15759,Kurt Sauer,2009-10,29.0,7,6,48,48,0,6,6,29.0,880.0,234,3,17,20,142.0,82,5.76,70,398,2426,9.7
15760,Kurt Sauer,2010-11,30.0,8,6,54,54,1,5,6,28.0,1009.0,288,4,22,26,170.0,82,5.44,62,351,2383,9.4
15761,Kurt Sauer,2011-12,31.0,9,7,68,68,1,6,7,33.0,1402.0,356,5,28,33,203.0,82,5.7,65,341,2477,9.4
15762,Kurt Sauer,2012-13,32.0,10,0,1,1,0,0,0,2.0,17.0,357,5,28,33,205.0,82,5.53,56,304,2486,9.1
15763,Kurtis Foster,2005-06,24.0,4,0,2,2,0,0,0,1.0,22.0,2,0,0,0,1.0,82,5.31,60,363,2326,9.4
15764,Kurtis Foster,2006-07,25.0,5,1,3,3,0,1,1,1.0,21.0,5,0,1,1,2.0,82,5.14,57,348,2300,9.2
15765,Kurtis Foster,2008-09,27.0,6,28,58,58,10,18,28,124.0,1115.0,63,10,19,29,126.0,82,6.05,85,480,2458,10.1
15766,Kurtis Foster,2009-10,28.0,7,23,57,57,3,20,23,135.0,1025.0,120,13,39,52,261.0,82,5.76,70,398,2426,9.7
15767,Kurtis Foster,2010-11,29.0,8,19,56,56,7,12,19,118.0,919.0,176,20,51,71,379.0,82,5.44,62,351,2383,9.4
15768,Kurtis Foster,2011-12,30.0,9,6,10,10,1,5,6,10.0,136.0,186,21,56,77,389.0,82,5.7,65,341,2477,9.4
15769,Kurtis Foster,2012-13,31.0,10,42,71,71,8,34,42,165.0,1220.0,257,29,90,119,554.0,82,5.53,56,304,2486,9.1
15770,Kurtis Foster,2013-14,32.0,11,22,74,74,8,14,22,182.0,1307.0,331,37,104,141,736.0,82,5.46,52,291,2492,9.0
15771,Kurtis Foster,2014-15,33.0,12,14,51,51,4,10,14,85.0,811.0,382,41,114,155,821.0,82,5.32,47,271,2439,8.9
15772,Kurtis Foster,2015-16,34.0,13,5,23,23,1,4,5,21.0,301.0,405,42,118,160,842.0,48,5.31,29,160,1399,9.1
15773,Kurtis Gabriel,2018-19,25.0,4,0,3,3,0,0,0,1.0,13.0,3,0,0,0,1.0,82,5.34,48,255,2438,9.0
15774,Kurtis Gabriel,2019-20,26.0,5,1,13,13,0,1,1,3.0,76.0,16,0,1,1,4.0,82,5.45,47,245,2478,9.0
15775,Kurtis Gabriel,2021-22,28.0,6,4,22,22,2,2,4,7.0,162.0,38,2,3,5,11.0,82,5.96,47,239,2579,9.5
15776,Kurtis MacDermid,2020-21,26.0,4,4,34,34,1,3,4,19.0,395.0,34,1,3,4,19.0,82,5.86,50,250,2620,9.2
15777,Kurtis MacDermid,2021-22,27.0,5,1,11,11,0,1,1,5.0,103.0,45,1,4,5,24.0,82,5.96,47,239,2579,9.5
15778,Kurtis MacDermid,2022-23,28.0,6,8,45,45,3,5,8,51.0,617.0,90,4,9,13,75.0,70,5.96,42,208,2192,9.5
15779,Kurtis McLean,2011-12,31.0,4,1,4,4,1,0,1,5.0,42.0,4,1,0,1,5.0,82,5.7,65,341,2477,9.4
15780,Kyle Baun,2017-18,25.0,4,0,3,3,0,0,0,4.0,38.0,3,0,0,0,4.0,82,5.32,47,251,2453,8.9
15781,Kyle Baun,2018-19,26.0,5,0,2,2,0,0,0,1.0,18.0,5,0,0,0,5.0,82,5.34,48,255,2438,9.0
15782,Kyle Brodziak,2008-09,24.0,4,0,10,10,0,0,0,7.0,110.0,10,0,0,0,7.0,82,6.05,85,480,2458,10.1
15783,Kyle Brodziak,2009-10,25.0,5,1,6,6,1,0,1,11.0,103.0,16,1,0,1,18.0,82,5.76,70,398,2426,9.7
15784,Kyle Brodziak,2010-11,26.0,6,31,80,80,14,17,31,125.0,1033.0,96,15,17,32,143.0,82,5.44,62,351,2383,9.4
15785,Kyle Brodziak,2011-12,27.0,7,27,79,79,11,16,27,99.0,1005.0,175,26,33,59,242.0,82,5.7,65,341,2477,9.4
15786,Kyle Brodziak,2012-13,28.0,8,32,82,82,9,23,32,140.0,1257.0,257,35,56,91,382.0,82,5.53,56,304,2486,9.1
15787,Kyle Brodziak,2013-14,29.0,9,37,80,80,16,21,37,126.0,1262.0,337,51,77,128,508.0,82,5.46,52,291,2492,9.0
15788,Kyle Brodziak,2014-15,30.0,10,44,82,82,22,22,44,160.0,1563.0,419,73,99,172,668.0,82,5.32,47,271,2439,8.9
15789,Kyle Brodziak,2015-16,31.0,11,12,48,48,8,4,12,88.0,833.0,467,81,103,184,756.0,48,5.31,29,160,1399,9.1
15790,Kyle Brodziak,2016-17,32.0,12,24,81,81,8,16,24,115.0,1314.0,548,89,119,208,871.0,82,5.34,48,269,2463,8.9
15791,Kyle Brodziak,2017-18,33.0,13,20,73,73,9,11,20,86.0,952.0,621,98,130,228,957.0,82,5.32,47,251,2453,8.9
15792,Kyle Brodziak,2018-19,34.0,14,11,76,76,7,4,11,49.0,821.0,697,105,134,239,1006.0,82,5.34,48,255,2438,9.0
15793,Kyle Brodziak,2019-20,35.0,15,15,69,69,8,7,15,55.0,773.0,766,113,141,254,1061.0,82,5.45,47,245,2478,9.0
15794,Kyle Brodziak,2020-21,36.0,16,33,81,81,10,23,33,113.0,1090.0,847,123,164,287,1174.0,82,5.86,50,250,2620,9.2
15795,Kyle Brodziak,2021-22,37.0,17,9,70,70,6,3,9,74.0,818.0,917,129,167,296,1248.0,82,5.96,47,239,2579,9.5
15796,Kyle Calder,2002-03,24.0,4,2,8,8,1,1,2,5.0,80.0,8,1,1,2,5.0,82,5.49,53,331,2294,9.8
15797,Kyle Calder,2003-04,25.0,5,15,43,43,5,10,15,63.0,547.0,51,6,11,17,68.0,82,5.51,63,376,2272,9.9
15798,Kyle Calder,2004-05,26.0,6,53,81,81,17,36,53,133.0,1341.0,132,23,47,70,201.0,82,5.24,53,338,2262,9.5
15799,Kyle Calder,2005-06,27.0,7,42,82,82,15,27,42,164.0,1371.0,214,38,74,112,365.0,82,5.31,60,363,2326,9.4
15800,Kyle Calder,2006-07,28.0,8,39,66,66,21,18,39,144.0,1131.0,280,59,92,151,509.0,82,5.14,57,348,2300,9.2
15801,Kyle Calder,2008-09,30.0,9,59,79,79,26,33,59,183.0,1452.0,359,85,125,210,692.0,82,6.05,85,480,2458,10.1
15802,Kyle Calder,2009-10,31.0,10,35,78,78,14,21,35,130.0,1212.0,437,99,146,245,822.0,82,5.76,70,398,2426,9.7
15803,Kyle Calder,2010-11,32.0,11,20,65,65,7,13,20,70.0,845.0,502,106,159,265,892.0,82,5.44,62,351,2383,9.4
15804,Kyle Calder,2011-12,33.0,12,27,74,74,8,19,27,93.0,974.0,576,114,178,292,985.0,82,5.7,65,341,2477,9.4
15805,Kyle Calder,2012-13,34.0,13,2,14,14,0,2,2,20.0,198.0,590,114,180,294,1005.0,82,5.53,56,304,2486,9.1
15806,Kyle Capobianco,2020-21,23.0,4,0,1,1,0,0,0,0.0,14.0,1,0,0,0,0.0,82,5.86,50,250,2620,9.2
15807,Kyle Capobianco,2021-22,24.0,5,0,2,2,0,0,0,1.0,32.0,3,0,0,0,1.0,82,5.96,47,239,2579,9.5
15808,Kyle Capobianco,2022-23,25.0,6,1,9,9,1,0,1,10.0,133.0,12,1,0,1,11.0,70,5.96,42,208,2192,9.5
15809,Kyle Chipchura,2010-11,24.0,4,11,36,36,4,7,11,36.0,409.0,36,4,7,11,36.0,82,5.44,62,351,2383,9.4
15810,Kyle Chipchura,2011-12,25.0,5,3,13,13,0,3,3,5.0,134.0,49,4,10,14,41.0,82,5.7,65,341,2477,9.4
15811,Kyle Chipchura,2012-13,26.0,6,12,74,74,6,6,12,54.0,850.0,123,10,16,26,95.0,82,5.53,56,304,2486,9.1
15812,Kyle Chipchura,2013-14,27.0,7,2,40,40,0,2,2,23.0,320.0,163,10,18,28,118.0,82,5.46,52,291,2492,9.0
15813,Kyle Chipchura,2014-15,28.0,8,16,53,53,3,13,16,43.0,558.0,216,13,31,44,161.0,82,5.32,47,271,2439,8.9
15814,Kyle Chipchura,2015-16,29.0,9,14,46,46,5,9,14,37.0,446.0,262,18,40,58,198.0,48,5.31,29,160,1399,9.1
15815,Kyle Chipchura,2016-17,30.0,10,20,80,80,5,15,20,46.0,777.0,342,23,55,78,244.0,82,5.34,48,269,2463,8.9
15816,Kyle Chipchura,2017-18,31.0,11,14,70,70,4,10,14,81.0,938.0,412,27,65,92,325.0,82,5.32,47,251,2453,8.9
15817,Kyle Chipchura,2018-19,32.0,12,12,70,70,4,8,12,47.0,716.0,482,31,73,104,372.0,82,5.34,48,255,2438,9.0
15818,Kyle Clifford,2013-14,23.0,4,14,76,76,7,7,14,69.0,722.0,76,7,7,14,69.0,82,5.46,52,291,2492,9.0
15819,Kyle Clifford,2014-15,24.0,5,12,81,81,5,7,12,88.0,762.0,157,12,14,26,157.0,82,5.32,47,271,2439,8.9
15820,Kyle Clifford,2015-16,25.0,6,14,48,48,7,7,14,56.0,509.0,205,19,21,40,213.0,48,5.31,29,160,1399,9.1
15821,Kyle Clifford,2016-17,26.0,7,8,71,71,3,5,8,74.0,721.0,276,22,26,48,287.0,82,5.34,48,269,2463,8.9
15822,Kyle Clifford,2017-18,27.0,8,15,80,80,6,9,15,117.0,859.0,356,28,35,63,404.0,82,5.32,47,251,2453,8.9
15823,Kyle Clifford,2018-19,28.0,9,9,56,56,3,6,9,68.0,524.0,412,31,41,72,472.0,82,5.34,48,255,2438,9.0
15824,Kyle Clifford,2019-20,29.0,10,12,73,73,6,6,12,122.0,783.0,485,37,47,84,594.0,82,5.45,47,245,2478,9.0
15825,Kyle Clifford,2020-21,30.0,11,10,50,50,6,4,10,81.0,527.0,535,43,51,94,675.0,82,5.86,50,250,2620,9.2
15826,Kyle Clifford,2021-22,31.0,12,21,72,72,11,10,21,115.0,755.0,607,54,61,115,790.0,82,5.96,47,239,2579,9.5
15827,Kyle Clifford,2022-23,32.0,13,17,69,69,7,10,17,110.0,772.0,676,61,71,132,900.0,70,5.96,42,208,2192,9.5
15828,Kyle Connor,2019-20,23.0,4,5,20,20,2,3,5,24.0,244.0,20,2,3,5,24.0,82,5.45,47,245,2478,9.0
15829,Kyle Connor,2020-21,24.0,5,57,76,76,31,26,57,192.0,1285.0,96,33,29,62,216.0,82,5.86,50,250,2620,9.2
15830,Kyle Connor,2021-22,25.0,6,66,82,82,34,32,66,227.0,1579.0,178,67,61,128,443.0,82,5.96,47,239,2579,9.5
15831,Kyle Connor,2022-23,26.0,7,73,71,71,38,35,73,239.0,1497.0,249,105,96,201,682.0,70,5.96,42,208,2192,9.5
15832,Kyle Criscuolo,2020-21,28.0,4,0,9,9,0,0,0,5.0,72.0,9,0,0,0,5.0,82,5.86,50,250,2620,9.2
15833,Kyle Cumiskey,2009-10,23.0,4,2,9,9,1,1,2,8.0,121.0,9,1,1,2,8.0,82,5.76,70,398,2426,9.7
15834,Kyle Cumiskey,2010-11,24.0,5,5,38,38,0,5,5,19.0,461.0,47,1,6,7,27.0,82,5.44,62,351,2383,9.4
15835,Kyle Cumiskey,2011-12,25.0,6,0,6,6,0,0,0,2.0,51.0,53,1,6,7,29.0,82,5.7,65,341,2477,9.4
15836,Kyle Cumiskey,2012-13,26.0,7,20,61,61,7,13,20,74.0,1208.0,114,8,19,27,103.0,82,5.53,56,304,2486,9.1
15837,Kyle Cumiskey,2013-14,27.0,8,8,18,18,1,7,8,21.0,354.0,132,9,26,35,124.0,82,5.46,52,291,2492,9.0
15838,Kyle Cumiskey,2017-18,31.0,9,0,7,7,0,0,0,5.0,93.0,139,9,26,35,129.0,82,5.32,47,251,2453,8.9
15839,Kyle Freadrich,2002-03,24.0,4,0,10,10,0,0,0,0.0,23.0,10,0,0,0,0.0,82,5.49,53,331,2294,9.8
15840,Kyle Freadrich,2003-04,25.0,5,1,13,13,0,1,1,3.0,46.0,23,0,1,1,3.0,82,5.51,63,376,2272,9.9
15841,Kyle Greentree,2010-11,27.0,4,0,2,2,0,0,0,3.0,18.0,2,0,0,0,3.0,82,5.44,62,351,2383,9.4
15842,Kyle Greentree,2011-12,28.0,5,0,2,2,0,0,0,3.0,19.0,4,0,0,0,6.0,82,5.7,65,341,2477,9.4
15843,Kyle McLaren,1998-99,21.0,4,17,74,74,5,12,17,74.0,,74,5,12,17,74.0,82,6.29,74,413,2481,10.4
15844,Kyle McLaren,1999-00,22.0,5,14,58,58,5,9,14,68.0,,132,10,21,31,142.0,82,5.83,55,336,2444,9.8
15845,Kyle McLaren,2000-01,23.0,6,25,66,66,5,20,25,101.0,,198,15,41,56,243.0,82,5.28,57,380,2242,9.6
15846,Kyle McLaren,2001-02,24.0,7,24,52,52,6,18,24,97.0,1218.0,250,21,59,80,340.0,82,5.27,57,359,2285,9.4
15847,Kyle McLaren,2002-03,25.0,8,19,71,71,8,11,19,142.0,1654.0,321,29,70,99,482.0,82,5.49,53,331,2294,9.8
15848,Kyle McLaren,2003-04,26.0,9,17,58,58,5,12,17,91.0,1405.0,379,34,82,116,573.0,82,5.51,63,376,2272,9.9
15849,Kyle McLaren,2004-05,27.0,10,8,38,38,0,8,8,57.0,735.0,417,34,90,124,630.0,82,5.24,53,338,2262,9.5
15850,Kyle McLaren,2005-06,28.0,11,8,33,33,0,8,8,43.0,748.0,450,34,98,132,673.0,82,5.31,60,363,2326,9.4
15851,Kyle McLaren,2006-07,29.0,12,24,64,64,2,22,24,67.0,1345.0,514,36,120,156,740.0,82,5.14,57,348,2300,9.2
15852,Kyle McLaren,2008-09,31.0,13,23,77,77,2,21,23,67.0,1761.0,591,38,141,179,807.0,82,6.05,85,480,2458,10.1
15853,Kyle McLaren,2009-10,32.0,14,17,67,67,5,12,17,43.0,1435.0,658,43,153,196,850.0,82,5.76,70,398,2426,9.7
15854,Kyle McLaren,2010-11,33.0,15,11,61,61,3,8,11,39.0,1120.0,719,46,161,207,889.0,82,5.44,62,351,2383,9.4
15855,Kyle Okposo,2010-11,22.0,4,5,9,9,2,3,5,15.0,148.0,9,2,3,5,15.0,82,5.44,62,351,2383,9.4
15856,Kyle Okposo,2011-12,23.0,5,39,65,65,18,21,39,165.0,1171.0,74,20,24,44,180.0,82,5.7,65,341,2477,9.4
15857,Kyle Okposo,2012-13,24.0,6,52,80,80,19,33,52,249.0,1643.0,154,39,57,96,429.0,82,5.53,56,304,2486,9.1
15858,Kyle Okposo,2013-14,25.0,7,20,38,38,5,15,20,72.0,630.0,192,44,72,116,501.0,82,5.46,52,291,2492,9.0
15859,Kyle Okposo,2014-15,26.0,8,45,79,79,24,21,45,152.0,1348.0,271,68,93,161,653.0,82,5.32,47,271,2439,8.9
15860,Kyle Okposo,2015-16,27.0,9,24,48,48,4,20,24,101.0,814.0,319,72,113,185,754.0,48,5.31,29,160,1399,9.1
15861,Kyle Okposo,2016-17,28.0,10,69,71,71,27,42,69,195.0,1451.0,390,99,155,254,949.0,82,5.34,48,269,2463,8.9
15862,Kyle Okposo,2017-18,29.0,11,51,60,60,18,33,51,195.0,1173.0,450,117,188,305,1144.0,82,5.32,47,251,2453,8.9
15863,Kyle Okposo,2018-19,30.0,12,64,79,79,22,42,64,202.0,1438.0,529,139,230,369,1346.0,82,5.34,48,255,2438,9.0
15864,Kyle Okposo,2019-20,31.0,13,45,65,65,19,26,45,156.0,1233.0,594,158,256,414,1502.0,82,5.45,47,245,2478,9.0
15865,Kyle Okposo,2020-21,32.0,14,44,76,76,15,29,44,161.0,1294.0,670,173,285,458,1663.0,82,5.86,50,250,2620,9.2
15866,Kyle Okposo,2021-22,33.0,15,29,78,78,14,15,29,147.0,1075.0,748,187,300,487,1810.0,82,5.96,47,239,2579,9.5
15867,Kyle Okposo,2022-23,34.0,16,19,52,52,9,10,19,82.0,668.0,800,196,310,506,1892.0,70,5.96,42,208,2192,9.5
15868,Kyle Palmieri,2013-14,22.0,4,1,10,10,1,0,1,10.0,87.0,10,1,0,1,10.0,82,5.46,52,291,2492,9.0
15869,Kyle Palmieri,2014-15,23.0,5,7,18,18,4,3,7,34.0,207.0,28,5,3,8,44.0,82,5.32,47,271,2439,8.9
15870,Kyle Palmieri,2015-16,24.0,6,21,42,42,10,11,21,92.0,518.0,70,15,14,29,136.0,48,5.31,29,160,1399,9.1
15871,Kyle Palmieri,2016-17,25.0,7,31,71,71,14,17,31,147.0,848.0,141,29,31,60,283.0,82,5.34,48,269,2463,8.9
15872,Kyle Palmieri,2017-18,26.0,8,29,57,57,14,15,29,112.0,804.0,198,43,46,89,395.0,82,5.32,47,251,2453,8.9
15873,Kyle Palmieri,2018-19,27.0,9,57,82,82,30,27,57,222.0,1460.0,280,73,73,146,617.0,82,5.34,48,255,2438,9.0
15874,Kyle Palmieri,2019-20,28.0,10,53,80,80,26,27,53,192.0,1388.0,360,99,100,199,809.0,82,5.45,47,245,2478,9.0
15875,Kyle Palmieri,2020-21,29.0,11,44,62,62,24,20,44,181.0,1073.0,422,123,120,243,990.0,82,5.86,50,250,2620,9.2
15876,Kyle Palmieri,2021-22,30.0,12,50,74,74,27,23,50,224.0,1343.0,496,150,143,293,1214.0,82,5.96,47,239,2579,9.5
15877,Kyle Palmieri,2022-23,31.0,13,45,65,65,25,20,45,155.0,1112.0,561,175,163,338,1369.0,70,5.96,42,208,2192,9.5
15878,Kyle Quincey,2008-09,23.0,4,0,1,1,0,0,0,1.0,12.0,1,0,0,0,1.0,82,6.05,85,480,2458,10.1
15879,Kyle Quincey,2009-10,24.0,5,1,6,6,1,0,1,7.0,69.0,7,1,0,1,8.0,82,5.76,70,398,2426,9.7
15880,Kyle Quincey,2010-11,25.0,6,0,6,6,0,0,0,5.0,84.0,13,1,0,1,13.0,82,5.44,62,351,2383,9.4
15881,Kyle Quincey,2011-12,26.0,7,38,72,72,4,34,38,150.0,1511.0,85,5,34,39,163.0,82,5.7,65,341,2477,9.4
15882,Kyle Quincey,2012-13,27.0,8,29,79,79,6,23,29,139.0,1865.0,164,11,57,68,302.0,82,5.53,56,304,2486,9.1
15883,Kyle Quincey,2013-14,28.0,9,1,21,21,0,1,1,39.0,411.0,185,11,58,69,341.0,82,5.46,52,291,2492,9.0
15884,Kyle Quincey,2014-15,29.0,10,26,72,72,7,19,26,168.0,1574.0,257,18,77,95,509.0,82,5.32,47,271,2439,8.9
15885,Kyle Quincey,2015-16,30.0,11,3,36,36,1,2,3,36.0,692.0,293,19,79,98,545.0,48,5.31,29,160,1399,9.1
15886,Kyle Quincey,2016-17,31.0,12,13,82,82,4,9,13,106.0,1706.0,375,23,88,111,651.0,82,5.34,48,269,2463,8.9
15887,Kyle Quincey,2017-18,32.0,13,18,73,73,3,15,18,90.0,1422.0,448,26,103,129,741.0,82,5.32,47,251,2453,8.9
15888,Kyle Quincey,2018-19,33.0,14,11,47,47,4,7,11,62.0,929.0,495,30,110,140,803.0,82,5.34,48,255,2438,9.0
15889,Kyle Quincey,2019-20,34.0,15,15,73,73,6,9,15,79.0,1306.0,568,36,119,155,882.0,82,5.45,47,245,2478,9.0
15890,Kyle Quincey,2020-21,35.0,16,3,18,18,0,3,3,11.0,257.0,586,36,122,158,893.0,82,5.86,50,250,2620,9.2
15891,Kyle Rau,2018-19,26.0,4,0,9,9,0,0,0,15.0,113.0,9,0,0,0,15.0,82,5.34,48,255,2438,9.0
15892,Kyle Rau,2019-20,27.0,5,3,24,24,2,1,3,21.0,230.0,33,2,1,3,36.0,82,5.45,47,245,2478,9.0
15893,Kyle Rau,2020-21,28.0,6,1,3,3,0,1,1,4.0,33.0,36,2,2,4,40.0,82,5.86,50,250,2620,9.2
15894,Kyle Rau,2021-22,29.0,7,1,6,6,0,1,1,6.0,42.0,42,2,3,5,46.0,82,5.96,47,239,2579,9.5
15895,Kyle Rossiter,2004-05,24.0,4,0,2,2,0,0,0,0.0,31.0,2,0,0,0,0.0,82,5.24,53,338,2262,9.5
15896,Kyle Rossiter,2005-06,25.0,5,0,3,3,0,0,0,0.0,30.0,5,0,0,0,0.0,82,5.31,60,363,2326,9.4
15897,Kyle Rossiter,2006-07,26.0,6,1,6,6,0,1,1,1.0,68.0,11,0,1,1,1.0,82,5.14,57,348,2300,9.2
15898,Kyle Turris,2010-11,21.0,4,1,3,3,0,1,1,11.0,59.0,3,0,1,1,11.0,82,5.44,62,351,2383,9.4
15899,Kyle Turris,2011-12,22.0,5,20,63,63,8,12,20,91.0,814.0,66,8,13,21,102.0,82,5.7,65,341,2477,9.4
15900,Kyle Turris,2013-14,24.0,6,25,65,65,11,14,25,116.0,733.0,131,19,27,46,218.0,82,5.46,52,291,2492,9.0
15901,Kyle Turris,2014-15,25.0,7,29,55,55,12,17,29,142.0,927.0,186,31,44,75,360.0,82,5.32,47,271,2439,8.9
15902,Kyle Turris,2015-16,26.0,8,29,48,48,12,17,29,118.0,943.0,234,43,61,104,478.0,48,5.31,29,160,1399,9.1
15903,Kyle Turris,2016-17,27.0,9,58,82,82,26,32,58,215.0,1536.0,316,69,93,162,693.0,82,5.34,48,269,2463,8.9
15904,Kyle Turris,2017-18,28.0,10,64,82,82,24,40,64,215.0,1576.0,398,93,133,226,908.0,82,5.32,47,251,2453,8.9
15905,Kyle Turris,2018-19,29.0,11,30,57,57,13,17,30,122.0,1123.0,455,106,150,256,1030.0,82,5.34,48,255,2438,9.0
15906,Kyle Turris,2019-20,30.0,12,55,78,78,27,28,55,185.0,1521.0,533,133,178,311,1215.0,82,5.45,47,245,2478,9.0
15907,Kyle Turris,2020-21,31.0,13,51,76,76,16,35,51,145.0,1263.0,609,149,213,362,1360.0,82,5.86,50,250,2620,9.2
15908,Kyle Turris,2021-22,32.0,14,23,55,55,7,16,23,78.0,863.0,664,156,229,385,1438.0,82,5.96,47,239,2579,9.5
15909,Kyle Turris,2022-23,33.0,15,31,62,62,9,22,31,88.0,956.0,726,165,251,416,1526.0,70,5.96,42,208,2192,9.5
15910,Kyle Wanvig,2005-06,25.0,4,1,7,7,1,0,1,5.0,65.0,7,1,0,1,5.0,82,5.31,60,363,2326,9.4
15911,Kyle Wanvig,2006-07,26.0,5,1,6,6,0,1,1,16.0,83.0,13,1,1,2,21.0,82,5.14,57,348,2300,9.2
15912,Kyle Wanvig,2008-09,28.0,6,12,51,51,4,8,12,55.0,543.0,64,5,9,14,76.0,82,6.05,85,480,2458,10.1
15913,Kyle Wanvig,2009-10,29.0,7,0,4,4,0,0,0,0.0,21.0,68,5,9,14,76.0,82,5.76,70,398,2426,9.7
15914,Kyle Wanvig,2010-11,30.0,8,1,7,7,1,0,1,10.0,71.0,75,6,9,15,86.0,82,5.44,62,351,2383,9.4
15915,Kyle Wellwood,2006-07,23.0,4,0,1,1,0,0,0,1.0,8.0,1,0,0,0,1.0,82,5.14,57,348,2300,9.2
15916,Kyle Wellwood,2008-09,25.0,5,45,81,81,11,34,45,117.0,1035.0,82,11,34,45,118.0,82,6.05,85,480,2458,10.1
15917,Kyle Wellwood,2009-10,26.0,6,42,48,48,12,30,42,99.0,798.0,130,23,64,87,217.0,82,5.76,70,398,2426,9.7
15918,Kyle Wellwood,2010-11,27.0,7,21,59,59,8,13,21,57.0,746.0,189,31,77,108,274.0,82,5.44,62,351,2383,9.4
15919,Kyle Wellwood,2011-12,28.0,8,27,74,74,18,9,27,94.0,1021.0,263,49,86,135,368.0,82,5.7,65,341,2477,9.4
15920,Kyle Wellwood,2012-13,29.0,9,25,75,75,14,11,25,98.0,1040.0,338,63,97,160,466.0,82,5.53,56,304,2486,9.1
15921,Kyle Wellwood,2013-14,30.0,10,13,35,35,5,8,13,50.0,479.0,373,68,105,173,516.0,82,5.46,52,291,2492,9.0
15922,Kyle Wellwood,2014-15,31.0,11,47,77,77,18,29,47,93.0,1151.0,450,86,134,220,609.0,82,5.32,47,271,2439,8.9
15923,Kyle Wellwood,2015-16,32.0,12,15,39,39,6,9,15,37.0,506.0,489,92,143,235,646.0,48,5.31,29,160,1399,9.1
15924,Kyle Wilson,2012-13,28.0,4,2,2,2,0,2,2,1.0,19.0,2,0,2,2,1.0,82,5.53,56,304,2486,9.1
15925,Kyle Wilson,2013-14,29.0,5,11,32,32,4,7,11,38.0,340.0,34,4,9,13,39.0,82,5.46,52,291,2492,9.0
15926,Kyle Wilson,2014-15,30.0,6,0,5,5,0,0,0,2.0,41.0,39,4,9,13,41.0,82,5.32,47,271,2439,8.9
15927,Kyosti Karjalainen,1994-95,27.0,4,9,28,28,1,8,9,20.0,,28,1,8,9,20.0,80,6.96,77,402,2440,11.4
15928,Ladislav Benysek,2000-01,25.0,4,0,2,2,0,0,0,0.0,,2,0,0,0,0.0,82,5.28,57,380,2242,9.6
15929,Ladislav Benysek,2003-04,28.0,5,7,71,71,2,5,7,48.0,1307.0,73,2,5,7,48.0,82,5.51,63,376,2272,9.9
15930,Ladislav Benysek,2004-05,29.0,6,8,74,74,1,7,8,44.0,1417.0,147,3,12,15,92.0,82,5.24,53,338,2262,9.5
15931,Ladislav Benysek,2005-06,30.0,7,0,14,14,0,0,0,7.0,160.0,161,3,12,15,99.0,82,5.31,60,363,2326,9.4
15932,Ladislav Karabin,1996-97,26.0,4,0,9,9,0,0,0,3.0,,9,0,0,0,3.0,84,6.48,76,407,2545,10.7
15933,Ladislav Kohn,1998-99,23.0,4,1,5,5,1,0,1,8.0,,5,1,0,1,8.0,82,6.29,74,413,2481,10.4
15934,Ladislav Kohn,2000-01,25.0,5,1,4,4,0,1,1,2.0,,9,1,1,2,10.0,82,5.28,57,380,2242,9.6
15935,Ladislav Kohn,2001-02,26.0,6,4,16,16,1,3,4,23.0,201.0,25,2,4,6,33.0,82,5.27,57,359,2285,9.4
15936,Ladislav Kohn,2002-03,27.0,7,21,77,77,5,16,21,123.0,932.0,102,7,20,27,156.0,82,5.49,53,331,2294,9.8
15937,Ladislav Kohn,2003-04,28.0,8,14,77,77,7,7,14,129.0,914.0,179,14,27,41,285.0,82,5.51,63,376,2272,9.9
15938,Ladislav Kohn,2004-05,29.0,9,0,4,4,0,0,0,2.0,21.0,183,14,27,41,287.0,82,5.24,53,338,2262,9.5
15939,Ladislav Kohn,2005-06,30.0,10,1,3,3,0,1,1,3.0,27.0,186,14,28,42,290.0,82,5.31,60,363,2326,9.4
15940,Ladislav Nagy,2002-03,23.0,4,6,11,11,2,4,6,15.0,136.0,11,2,4,6,15.0,82,5.49,53,331,2294,9.8
15941,Ladislav Nagy,2003-04,24.0,5,17,46,46,8,9,17,64.0,598.0,57,10,13,23,79.0,82,5.51,63,376,2272,9.9
15942,Ladislav Nagy,2004-05,25.0,6,42,74,74,23,19,42,187.0,1115.0,131,33,32,65,266.0,82,5.24,53,338,2262,9.5
15943,Ladislav Nagy,2005-06,26.0,7,57,80,80,22,35,57,209.0,1397.0,211,55,67,122,475.0,82,5.31,60,363,2326,9.4
15944,Ladislav Nagy,2006-07,27.0,8,52,55,55,24,28,52,160.0,999.0,266,79,95,174,635.0,82,5.14,57,348,2300,9.2
15945,Ladislav Nagy,2008-09,29.0,9,56,51,51,15,41,56,132.0,963.0,317,94,136,230,767.0,82,6.05,85,480,2458,10.1
15946,Ladislav Nagy,2009-10,30.0,10,55,80,80,12,43,55,146.0,1386.0,397,106,179,285,913.0,82,5.76,70,398,2426,9.7
15947,Ladislav Nagy,2010-11,31.0,11,26,38,38,9,17,26,78.0,524.0,435,115,196,311,991.0,82,5.44,62,351,2383,9.4
15948,Ladislav Smid,2009-10,23.0,4,10,77,77,3,7,10,53.0,1481.0,77,3,7,10,53.0,82,5.76,70,398,2426,9.7
15949,Ladislav Smid,2010-11,24.0,5,4,65,65,0,4,4,45.0,1161.0,142,3,11,14,98.0,82,5.44,62,351,2383,9.4
15950,Ladislav Smid,2011-12,25.0,6,11,60,60,0,11,11,33.0,897.0,202,3,22,25,131.0,82,5.7,65,341,2477,9.4
15951,Ladislav Smid,2012-13,26.0,7,9,51,51,1,8,9,36.0,978.0,253,4,30,34,167.0,82,5.53,56,304,2486,9.1
15952,Ladislav Smid,2013-14,27.0,8,10,78,78,0,10,10,48.0,1582.0,331,4,40,44,215.0,82,5.46,52,291,2492,9.0
15953,Ladislav Smid,2014-15,28.0,9,15,78,78,5,10,15,47.0,1631.0,409,9,50,59,262.0,82,5.32,47,271,2439,8.9
15954,Ladislav Smid,2015-16,29.0,10,4,48,48,1,3,4,30.0,975.0,457,10,53,63,292.0,48,5.31,29,160,1399,9.1
15955,Ladislav Smid,2016-17,30.0,11,8,73,73,2,6,8,41.0,1323.0,530,12,59,71,333.0,82,5.34,48,269,2463,8.9
15956,Ladislav Smid,2017-18,31.0,12,1,31,31,0,1,1,21.0,433.0,561,12,60,72,354.0,82,5.32,47,251,2453,8.9
15957,Ladislav Smid,2018-19,32.0,13,0,22,22,0,0,0,11.0,255.0,583,12,60,72,365.0,82,5.34,48,255,2438,9.0
15958,Lance Bouma,2013-14,23.0,4,1,16,16,0,1,1,9.0,94.0,16,0,1,1,9.0,82,5.46,52,291,2492,9.0
15959,Lance Bouma,2014-15,24.0,5,3,27,27,1,2,3,26.0,274.0,43,1,3,4,35.0,82,5.32,47,271,2439,8.9
15960,Lance Bouma,2016-17,26.0,6,15,78,78,5,10,15,82.0,983.0,121,6,13,19,117.0,82,5.34,48,269,2463,8.9
15961,Lance Bouma,2017-18,27.0,7,34,78,78,16,18,34,104.0,1093.0,199,22,31,53,221.0,82,5.32,47,251,2453,8.9
15962,Lance Bouma,2018-19,28.0,8,7,44,44,2,5,7,49.0,530.0,243,24,36,60,270.0,82,5.34,48,255,2438,9.0
15963,Lance Bouma,2019-20,29.0,9,7,61,61,3,4,7,53.0,692.0,304,27,40,67,323.0,82,5.45,47,245,2478,9.0
15964,Lance Bouma,2020-21,30.0,10,9,53,53,3,6,9,56.0,564.0,357,30,46,76,379.0,82,5.86,50,250,2620,9.2
15965,Lance Nethery,1983-84,26.0,4,23,33,33,11,12,23,47.0,,33,11,12,23,47.0,80,7.69,77,340,2441,12.6
15966,Lance Nethery,1984-85,27.0,5,2,8,8,0,2,2,5.0,,41,11,14,25,52.0,80,8.03,73,320,2489,12.9
15967,Lance Pitlick,1997-98,30.0,4,1,15,15,0,1,1,11.0,,15,0,1,1,11.0,48,5.97,37,209,1408,10.2
15968,Lance Pitlick,1998-99,31.0,5,7,28,28,1,6,7,13.0,,43,1,7,8,24.0,82,6.29,74,413,2481,10.4
15969,Lance Pitlick,1999-00,32.0,6,10,66,66,5,5,10,54.0,,109,6,12,18,78.0,82,5.83,55,336,2444,9.8
15970,Lance Pitlick,2000-01,33.0,7,9,69,69,2,7,9,66.0,,178,8,19,27,144.0,82,5.28,57,380,2242,9.6
15971,Lance Pitlick,2001-02,34.0,8,9,50,50,3,6,9,34.0,833.0,228,11,25,36,178.0,82,5.27,57,359,2285,9.4
15972,Lance Pitlick,2002-03,35.0,9,8,62,62,3,5,8,26.0,1027.0,290,14,30,44,204.0,82,5.49,53,331,2294,9.8
15973,Lance Pitlick,2003-04,36.0,10,3,68,68,1,2,3,24.0,924.0,358,15,32,47,228.0,82,5.51,63,376,2272,9.9
15974,Lance Pitlick,2004-05,37.0,11,2,35,35,1,1,2,15.0,328.0,393,16,33,49,243.0,82,5.24,53,338,2262,9.5
15975,Lance Ward,2003-04,25.0,4,2,30,30,0,2,2,17.0,475.0,30,0,2,2,17.0,82,5.51,63,376,2272,9.9
15976,Lance Ward,2004-05,26.0,5,5,68,68,1,4,5,39.0,987.0,98,1,6,7,56.0,82,5.24,53,338,2262,9.5
15977,Lance Ward,2005-06,27.0,6,5,65,65,3,2,5,52.0,535.0,163,4,8,12,108.0,82,5.31,60,363,2326,9.4
15978,Lance Ward,2006-07,28.0,7,4,46,46,0,4,4,26.0,399.0,209,4,12,16,134.0,82,5.14,57,348,2300,9.2
15979,Landon Ferraro,2016-17,25.0,4,0,4,4,0,0,0,2.0,36.0,4,0,0,0,2.0,82,5.34,48,269,2463,8.9
15980,Landon Ferraro,2017-18,26.0,5,1,3,3,1,0,1,4.0,36.0,7,1,0,1,6.0,82,5.32,47,251,2453,8.9
15981,Landon Ferraro,2018-19,27.0,6,10,68,68,5,5,10,77.0,722.0,75,6,5,11,83.0,82,5.34,48,255,2438,9.0
15982,Landon Ferraro,2020-21,29.0,7,1,2,2,1,0,1,3.0,9.0,77,7,5,12,86.0,82,5.86,50,250,2620,9.2
15983,Landon Wilson,1998-99,23.0,4,1,7,7,1,0,1,6.0,,7,1,0,1,6.0,82,6.29,74,413,2481,10.4
15984,Landon Wilson,1999-00,24.0,5,20,49,49,8,12,20,83.0,,56,9,12,21,89.0,82,5.83,55,336,2444,9.8
15985,Landon Wilson,2000-01,25.0,6,6,28,28,1,5,6,26.0,,84,10,17,27,115.0,82,5.28,57,380,2242,9.6
15986,Landon Wilson,2001-02,26.0,7,6,22,22,3,3,6,32.0,221.0,106,13,20,33,147.0,82,5.27,57,359,2285,9.4
15987,Landon Wilson,2002-03,27.0,8,4,40,40,1,3,4,67.0,406.0,146,14,23,37,214.0,82,5.49,53,331,2294,9.8
15988,Landon Wilson,2003-04,28.0,9,31,70,70,18,13,31,123.0,800.0,216,32,36,68,337.0,82,5.51,63,376,2272,9.9
15989,Landon Wilson,2004-05,29.0,10,19,47,47,7,12,19,100.0,604.0,263,39,48,87,437.0,82,5.24,53,338,2262,9.5
15990,Landon Wilson,2005-06,30.0,11,14,31,31,6,8,14,92.0,378.0,294,45,56,101,529.0,82,5.31,60,363,2326,9.4
15991,Landon Wilson,2006-07,31.0,12,10,54,54,6,4,10,76.0,560.0,348,51,60,111,605.0,82,5.14,57,348,2300,9.2
15992,Landon Wilson,2011-12,36.0,13,8,27,27,2,6,8,34.0,249.0,375,53,66,119,639.0,82,5.7,65,341,2477,9.4
15993,Lane Lambert,1986-87,22.0,4,35,73,73,20,15,35,88.0,,73,20,15,35,88.0,80,7.89,74,336,2448,12.9
15994,Lane Lambert,1987-88,23.0,5,25,69,69,14,11,25,67.0,,142,34,26,60,155.0,80,7.77,71,321,2447,12.7
15995,Lane Lambert,1988-89,24.0,6,5,34,34,2,3,5,32.0,,176,36,29,65,187.0,80,7.94,82,370,2484,12.8
15996,Lane Lambert,1989-90,25.0,7,14,33,33,7,7,14,43.0,,209,43,36,79,230.0,80,7.34,72,344,2400,12.2
15997,Lane Lambert,1990-91,26.0,8,41,61,61,13,28,41,98.0,,270,56,64,120,328.0,80,7.43,89,437,2435,12.2
15998,Lane Lambert,1991-92,27.0,9,4,13,13,2,2,4,19.0,,283,58,66,124,347.0,80,7.48,85,403,2430,12.3
15999,Lane MacDermid,2014-15,25.0,4,0,5,5,0,0,0,6.0,45.0,5,0,0,0,6.0,82,5.32,47,271,2439,8.9
16000,Lane MacDermid,2015-16,26.0,5,2,9,9,2,0,2,4.0,41.0,14,2,0,2,10.0,48,5.31,29,160,1399,9.1
16001,Lane MacDermid,2016-17,27.0,6,2,7,7,0,2,2,1.0,39.0,21,2,2,4,11.0,82,5.34,48,269,2463,8.9
16002,Larry Courville,1998-99,23.0,4,1,3,3,1,0,1,2.0,,3,1,0,1,2.0,82,6.29,74,413,2481,10.4
16003,Larry Courville,1999-00,24.0,5,2,19,19,0,2,2,11.0,,22,1,2,3,13.0,82,5.83,55,336,2444,9.8
16004,Larry Courville,2000-01,25.0,6,0,11,11,0,0,0,3.0,,33,1,2,3,16.0,82,5.28,57,380,2242,9.6
16005,Larry DePalma,1988-89,23.0,4,0,1,1,0,0,0,0.0,,1,0,0,0,0.0,80,7.94,82,370,2484,12.8
16006,Larry DePalma,1989-90,24.0,5,15,56,56,9,6,15,56.0,,57,9,6,15,56.0,80,7.34,72,344,2400,12.2
16007,Larry DePalma,1990-91,25.0,6,2,7,7,1,1,2,8.0,,64,10,7,17,64.0,80,7.43,89,437,2435,12.2
16008,Larry DePalma,1991-92,26.0,7,12,43,43,5,7,12,42.0,,107,15,14,29,106.0,80,7.48,85,403,2430,12.3
16009,Larry DePalma,1993-94,28.0,8,3,14,14,3,0,3,18.0,,121,18,14,32,124.0,80,6.91,71,366,2385,11.6
16010,Larry DePalma,1995-96,30.0,9,8,20,20,2,6,8,29.0,,141,20,20,40,153.0,84,7.25,87,443,2603,11.7
16011,Larry DePalma,1996-97,31.0,10,1,7,7,1,0,1,2.0,,148,21,20,41,155.0,84,6.48,76,407,2545,10.7
16012,Larry Floyd,1985-86,24.0,4,1,5,5,1,0,1,9.0,,5,1,0,1,9.0,80,7.73,71,310,2444,12.7
16013,Larry Floyd,1986-87,25.0,5,4,7,7,1,3,4,15.0,,12,2,3,5,24.0,80,7.89,74,336,2448,12.9
16014,Larry Landon,1986-87,28.0,4,0,2,2,0,0,0,5.0,,2,0,0,0,5.0,80,7.89,74,336,2448,12.9
16015,Larry Landon,1987-88,29.0,5,0,7,7,0,0,0,5.0,,9,0,0,0,10.0,80,7.77,71,321,2447,12.7
16016,Larry Melnyk,1983-84,23.0,4,4,26,26,0,4,4,30.0,,26,0,4,4,30.0,80,7.69,77,340,2441,12.6
16017,Larry Melnyk,1984-85,24.0,5,8,48,48,0,8,8,40.0,,74,0,12,12,70.0,80,8.03,73,320,2489,12.9
16018,Larry Melnyk,1985-86,25.0,6,0,1,1,0,0,0,2.0,,75,0,12,12,72.0,80,7.73,71,310,2444,12.7
16019,Larry Melnyk,1987-88,27.0,7,11,28,28,0,11,11,8.0,,103,0,23,23,80.0,80,7.77,71,321,2447,12.7
16020,Larry Melnyk,1988-89,28.0,8,14,52,52,3,11,14,37.0,,155,3,34,37,117.0,80,7.94,82,370,2484,12.8
16021,Larry Melnyk,1989-90,29.0,9,15,73,73,3,12,15,53.0,,228,6,46,52,170.0,80,7.34,72,344,2400,12.2
16022,Larry Melnyk,1990-91,30.0,10,6,63,63,2,4,6,40.0,,291,8,50,58,210.0,80,7.43,89,437,2435,12.2
16023,Larry Melnyk,1991-92,31.0,11,14,74,74,3,11,14,59.0,,365,11,61,72,269.0,80,7.48,85,403,2430,12.3
16024,Larry Melnyk,1992-93,32.0,12,2,67,67,0,2,2,45.0,,432,11,63,74,314.0,80,7.37,76,367,2421,12.2
16025,Larry Murphy,1983-84,22.0,4,76,80,80,16,60,76,153.0,,80,16,60,76,153.0,80,7.69,77,340,2441,12.6
16026,Larry Murphy,1984-85,23.0,5,66,79,79,22,44,66,191.0,,159,38,104,142,344.0,80,8.03,73,320,2489,12.9
16027,Larry Murphy,1985-86,24.0,6,62,77,77,14,48,62,172.0,,236,52,152,204,516.0,80,7.73,71,310,2444,12.7
16028,Larry Murphy,1986-87,25.0,7,49,78,78,13,36,49,149.0,,314,65,188,253,665.0,80,7.89,74,336,2448,12.9
16029,Larry Murphy,1987-88,26.0,8,56,79,79,14,42,56,153.0,,393,79,230,309,818.0,80,7.77,71,321,2447,12.7
16030,Larry Murphy,1988-89,27.0,9,65,78,78,21,44,65,180.0,,471,100,274,374,998.0,80,7.94,82,370,2484,12.8
16031,Larry Murphy,1989-90,28.0,10,81,80,80,23,58,81,224.0,,551,123,332,455,1222.0,80,7.34,72,344,2400,12.2
16032,Larry Murphy,1990-91,29.0,11,61,79,79,8,53,61,201.0,,630,131,385,516,1423.0,80,7.43,89,437,2435,12.2
16033,Larry Murphy,1991-92,30.0,12,46,78,78,11,35,46,160.0,,708,142,420,562,1583.0,80,7.48,85,403,2430,12.3
16034,Larry Murphy,1992-93,31.0,13,68,77,77,10,58,68,173.0,,785,152,478,630,1756.0,80,7.37,76,367,2421,12.2
16035,Larry Murphy,1993-94,32.0,14,43,75,75,9,34,43,188.0,,860,161,512,673,1944.0,80,6.91,71,366,2385,11.6
16036,Larry Murphy,1994-95,33.0,15,77,77,77,21,56,77,206.0,,937,182,568,750,2150.0,80,6.96,77,402,2440,11.4
16037,Larry Murphy,1995-96,34.0,16,85,83,83,22,63,85,230.0,,1020,204,631,835,2380.0,84,7.25,87,443,2603,11.7
16038,Larry Murphy,1996-97,35.0,17,73,84,84,17,56,73,236.0,,1104,221,687,908,2616.0,84,6.48,76,407,2545,10.7
16039,Larry Murphy,1997-98,36.0,18,38,48,48,13,25,38,124.0,,1152,234,712,946,2740.0,48,5.97,37,209,1408,10.2
16040,Larry Murphy,1998-99,37.0,19,61,82,82,12,49,61,182.0,,1234,246,761,1007,2922.0,82,6.29,74,413,2481,10.4
16041,Larry Murphy,1999-00,38.0,20,45,81,81,9,36,45,158.0,,1315,255,797,1052,3080.0,82,5.83,55,336,2444,9.8
16042,Larry Murphy,2000-01,39.0,21,52,82,82,11,41,52,129.0,,1397,266,838,1104,3209.0,82,5.28,57,380,2242,9.6
16043,Larry Murphy,2001-02,40.0,22,52,80,80,10,42,52,168.0,1940.0,1477,276,880,1156,3377.0,82,5.27,57,359,2285,9.4
16044,Larry Murphy,2002-03,41.0,23,40,81,81,10,30,40,146.0,1769.0,1558,286,910,1196,3523.0,82,5.49,53,331,2294,9.8
16045,Larry Murphy,2003-04,42.0,24,21,57,57,2,19,21,81.0,1083.0,1615,288,929,1217,3604.0,82,5.51,63,376,2272,9.9
16046,Larry Trader,1985-86,22.0,4,2,15,15,0,2,2,7.0,,15,0,2,2,7.0,80,7.73,71,310,2444,12.7
16047,Larry Trader,1987-88,24.0,5,10,40,40,3,7,10,47.0,,55,3,9,12,54.0,80,7.77,71,321,2447,12.7
16048,Larry Trader,1989-90,26.0,6,0,5,5,0,0,0,3.0,,60,3,9,12,57.0,80,7.34,72,344,2400,12.2
16049,Larry Trader,1990-91,27.0,7,6,31,31,2,4,6,19.0,,91,5,13,18,76.0,80,7.43,89,437,2435,12.2
16050,Lars Eller,2012-13,23.0,4,2,7,7,2,0,2,8.0,76.0,7,2,0,2,8.0,82,5.53,56,304,2486,9.1
16051,Lars Eller,2013-14,24.0,5,17,77,77,7,10,17,79.0,858.0,84,9,10,19,87.0,82,5.46,52,291,2492,9.0
16052,Lars Eller,2014-15,25.0,6,28,79,79,16,12,28,129.0,1210.0,163,25,22,47,216.0,82,5.32,47,271,2439,8.9
16053,Lars Eller,2015-16,26.0,7,30,46,46,8,22,30,84.0,682.0,209,33,44,77,300.0,48,5.31,29,160,1399,9.1
16054,Lars Eller,2016-17,27.0,8,26,77,77,12,14,26,137.0,1229.0,286,45,58,103,437.0,82,5.34,48,269,2463,8.9
16055,Lars Eller,2017-18,28.0,9,27,77,77,15,12,27,150.0,1193.0,363,60,70,130,587.0,82,5.32,47,251,2453,8.9
16056,Lars Eller,2018-19,29.0,10,26,79,79,13,13,26,149.0,1205.0,442,73,83,156,736.0,82,5.34,48,255,2438,9.0
16057,Lars Eller,2019-20,30.0,11,25,81,81,12,13,25,115.0,1126.0,523,85,96,181,851.0,82,5.45,47,245,2478,9.0
16058,Lars Eller,2020-21,31.0,12,38,81,81,18,20,38,161.0,1239.0,604,103,116,219,1012.0,82,5.86,50,250,2620,9.2
16059,Lars Eller,2021-22,32.0,13,36,81,81,13,23,36,163.0,1339.0,685,116,139,255,1175.0,82,5.96,47,239,2579,9.5
16060,Lars Eller,2022-23,33.0,14,39,69,69,16,23,39,151.0,1174.0,754,132,162,294,1326.0,70,5.96,42,208,2192,9.5
16061,Lars Jonsson,2009-10,28.0,4,2,8,8,0,2,2,4.0,99.0,8,0,2,2,4.0,82,5.76,70,398,2426,9.7
16062,Lars Molin,1984-85,28.0,4,46,72,72,15,31,46,150.0,,72,15,31,46,150.0,80,8.03,73,320,2489,12.9
16063,Lars Molin,1985-86,29.0,5,39,58,58,12,27,39,127.0,,130,27,58,85,277.0,80,7.73,71,310,2444,12.7
16064,Lars Molin,1986-87,30.0,6,13,42,42,6,7,13,47.0,,172,33,65,98,324.0,80,7.89,74,336,2448,12.9
16065,Lars-Erik Sjoberg,1982-83,38.0,4,34,79,79,7,27,34,145.0,,79,7,27,34,145.0,80,7.03,61,280,2352,12.0
16066,Lasse Kukkonen,2006-07,25.0,4,1,10,10,0,1,1,9.0,136.0,10,0,1,1,9.0,82,5.14,57,348,2300,9.2
16067,Lasse Kukkonen,2009-10,28.0,5,14,74,74,5,9,14,54.0,1266.0,84,5,10,15,63.0,82,5.76,70,398,2426,9.7
16068,Lasse Kukkonen,2010-11,29.0,6,5,53,53,1,4,5,31.0,834.0,137,6,14,20,94.0,82,5.44,62,351,2383,9.4
16069,Lasse Kukkonen,2011-12,30.0,7,2,22,22,0,2,2,10.0,236.0,159,6,16,22,104.0,82,5.7,65,341,2477,9.4
16070,Lasse Pirjeta,2005-06,31.0,4,21,51,51,11,10,21,80.0,585.0,51,11,10,21,80.0,82,5.31,60,363,2326,9.4
16071,Lasse Pirjeta,2006-07,32.0,5,22,70,70,8,14,22,111.0,800.0,121,19,24,43,191.0,82,5.14,57,348,2300,9.2
16072,Lasse Pirjeta,2008-09,34.0,6,7,25,25,4,3,7,30.0,231.0,146,23,27,50,221.0,82,6.05,85,480,2458,10.1
16073,Laurent Dauphin,2018-19,23.0,4,1,8,8,1,0,1,7.0,91.0,8,1,0,1,7.0,82,5.34,48,255,2438,9.0
16074,Laurent Dauphin,2019-20,24.0,5,3,24,24,2,1,3,32.0,262.0,32,3,1,4,39.0,82,5.45,47,245,2478,9.0
16075,Laurent Dauphin,2020-21,25.0,6,0,2,2,0,0,0,1.0,14.0,34,3,1,4,40.0,82,5.86,50,250,2620,9.2
16076,Laurent Dauphin,2021-22,26.0,7,0,1,1,0,0,0,2.0,12.0,35,3,1,4,42.0,82,5.96,47,239,2579,9.5
16077,Lauri Korpikoski,2011-12,25.0,4,14,68,68,6,8,14,63.0,742.0,68,6,8,14,63.0,82,5.7,65,341,2477,9.4
16078,Lauri Korpikoski,2012-13,26.0,5,11,71,71,5,6,11,68.0,874.0,139,11,14,25,131.0,82,5.53,56,304,2486,9.1
16079,Lauri Korpikoski,2013-14,27.0,6,40,79,79,19,21,40,103.0,1227.0,218,30,35,65,234.0,82,5.46,52,291,2492,9.0
16080,Lauri Korpikoski,2014-15,28.0,7,37,82,82,17,20,37,146.0,1405.0,300,47,55,102,380.0,82,5.32,47,271,2439,8.9
16081,Lauri Korpikoski,2015-16,29.0,8,11,36,36,6,5,11,83.0,616.0,336,53,60,113,463.0,48,5.31,29,160,1399,9.1
16082,Lauri Korpikoski,2016-17,30.0,9,25,64,64,9,16,25,109.0,1029.0,400,62,76,138,572.0,82,5.34,48,269,2463,8.9
16083,Lauri Korpikoski,2017-18,31.0,10,21,69,69,6,15,21,82.0,1052.0,469,68,91,159,654.0,82,5.32,47,251,2453,8.9
16084,Lauri Korpikoski,2018-19,32.0,11,22,71,71,10,12,22,88.0,989.0,540,78,103,181,742.0,82,5.34,48,255,2438,9.0
16085,Lauri Korpikoski,2019-20,33.0,12,20,69,69,8,12,20,108.0,856.0,609,86,115,201,850.0,82,5.45,47,245,2478,9.0
16086,Lauri Tukonen,2009-10,23.0,4,0,4,4,0,0,0,1.0,26.0,4,0,0,0,1.0,82,5.76,70,398,2426,9.7
16087,Lauri Tukonen,2010-11,24.0,5,0,1,1,0,0,0,1.0,10.0,5,0,0,0,2.0,82,5.44,62,351,2383,9.4
16088,Laurie Boschman,1982-83,22.0,4,48,80,80,16,32,48,99.0,,80,16,32,48,99.0,80,7.03,61,280,2352,12.0
16089,Laurie Boschman,1983-84,23.0,5,33,53,53,14,19,33,71.0,,133,30,51,81,170.0,80,7.69,77,340,2441,12.6
16090,Laurie Boschman,1984-85,24.0,6,33,65,65,11,22,33,68.0,,198,41,73,114,238.0,80,8.03,73,320,2489,12.9
16091,Laurie Boschman,1985-86,25.0,7,28,74,74,11,17,28,84.0,,272,52,90,142,322.0,80,7.73,71,310,2444,12.7
16092,Laurie Boschman,1986-87,26.0,8,74,61,61,28,46,74,137.0,,333,80,136,216,459.0,80,7.89,74,336,2448,12.9
16093,Laurie Boschman,1987-88,27.0,9,76,80,80,32,44,76,167.0,,413,112,180,292,626.0,80,7.77,71,321,2447,12.7
16094,Laurie Boschman,1988-89,28.0,10,69,77,77,27,42,69,158.0,,490,139,222,361,784.0,80,7.94,82,370,2484,12.8
16095,Laurie Boschman,1989-90,29.0,11,41,80,80,17,24,41,161.0,,570,156,246,402,945.0,80,7.34,72,344,2400,12.2
16096,Laurie Boschman,1990-91,30.0,12,48,80,80,25,23,48,166.0,,650,181,269,450,1111.0,80,7.43,89,437,2435,12.2
16097,Laurie Boschman,1991-92,31.0,13,36,70,70,10,26,36,113.0,,720,191,295,486,1224.0,80,7.48,85,403,2430,12.3
16098,Laurie Boschman,1992-93,32.0,14,27,66,66,10,17,27,87.0,,786,201,312,513,1311.0,80,7.37,76,367,2421,12.2
16099,Laurie Boschman,1993-94,33.0,15,20,78,78,11,9,20,91.0,,864,212,321,533,1402.0,80,6.91,71,366,2385,11.6
16100,Laurie Boschman,1994-95,34.0,16,28,75,75,8,20,28,89.0,,939,220,341,561,1491.0,80,6.96,77,402,2440,11.4
16101,Laurie Boschman,1995-96,35.0,17,16,70,70,9,7,16,84.0,,1009,229,348,577,1575.0,84,7.25,87,443,2603,11.7
16102,Lawrence Nycholat,2006-07,27.0,4,0,9,9,0,0,0,6.0,154.0,9,0,0,0,6.0,82,5.14,57,348,2300,9.2
16103,Lawrence Nycholat,2009-10,30.0,5,8,19,19,2,6,8,25.0,382.0,28,2,6,8,31.0,82,5.76,70,398,2426,9.7
16104,Lawrence Nycholat,2010-11,31.0,6,0,3,3,0,0,0,4.0,36.0,31,2,6,8,35.0,82,5.44,62,351,2383,9.4
16105,Lawrence Nycholat,2011-12,32.0,7,1,19,19,0,1,1,9.0,188.0,50,2,7,9,44.0,82,5.7,65,341,2477,9.4
16106,Lawrence Pilut,2021-22,26.0,4,6,33,33,1,5,6,37.0,575.0,33,1,5,6,37.0,82,5.96,47,239,2579,9.5
16107,Lawrence Pilut,2022-23,27.0,5,0,13,13,0,0,0,6.0,211.0,46,1,5,6,43.0,70,5.96,42,208,2192,9.5
16108,Lawson Crouse,2019-20,22.0,4,12,72,72,5,7,12,84.0,856.0,72,5,7,12,84.0,82,5.45,47,245,2478,9.0
16109,Lawson Crouse,2020-21,23.0,5,1,11,11,1,0,1,13.0,120.0,83,6,7,13,97.0,82,5.86,50,250,2620,9.2
16110,Lawson Crouse,2021-22,24.0,6,25,81,81,11,14,25,131.0,1049.0,164,17,21,38,228.0,82,5.96,47,239,2579,9.5
16111,Lawson Crouse,2022-23,25.0,7,25,66,66,15,10,25,109.0,896.0,230,32,31,63,337.0,70,5.96,42,208,2192,9.5
16112,Layne Ulmer,2006-07,26.0,4,0,1,1,0,0,0,1.0,9.0,1,0,0,0,1.0,82,5.14,57,348,2300,9.2
16113,Lean Bergmann,2022-23,24.0,4,1,12,12,0,1,1,11.0,99.0,12,0,1,1,11.0,70,5.96,42,208,2192,9.5
16114,Lee Giffin,1989-90,22.0,4,2,8,8,1,1,2,8.0,,8,1,1,2,8.0,80,7.34,72,344,2400,12.2
16115,Lee Giffin,1990-91,23.0,5,2,19,19,0,2,2,8.0,,27,1,3,4,16.0,80,7.43,89,437,2435,12.2
16116,Lee Goren,2003-04,26.0,4,2,21,21,2,0,2,9.0,92.0,21,2,0,2,9.0,82,5.51,63,376,2272,9.9
16117,Lee Goren,2005-06,28.0,5,3,14,14,2,1,3,15.0,115.0,35,4,1,5,24.0,82,5.31,60,363,2326,9.4
16118,Lee Goren,2006-07,29.0,6,1,2,2,0,1,1,1.0,27.0,37,4,2,6,25.0,82,5.14,57,348,2300,9.2
16119,Lee Goren,2008-09,31.0,7,3,28,28,1,2,3,37.0,207.0,65,5,4,9,62.0,82,6.05,85,480,2458,10.1
16120,Lee Goren,2009-10,32.0,8,0,2,2,0,0,0,2.0,23.0,67,5,4,9,64.0,82,5.76,70,398,2426,9.7
16121,Lee Norwood,1983-84,23.0,4,2,11,11,1,1,2,8.0,,11,1,1,2,8.0,80,7.69,77,340,2441,12.6
16122,Lee Norwood,1984-85,24.0,5,17,28,28,7,10,17,34.0,,39,8,11,19,42.0,80,8.03,73,320,2489,12.9
16123,Lee Norwood,1985-86,25.0,6,1,8,8,0,1,1,6.0,,47,8,12,20,48.0,80,7.73,71,310,2444,12.7
16124,Lee Norwood,1988-89,28.0,7,29,71,71,5,24,29,112.0,,118,13,36,49,160.0,80,7.94,82,370,2484,12.8
16125,Lee Norwood,1989-90,29.0,8,27,57,57,6,21,27,101.0,,175,19,57,76,261.0,80,7.34,72,344,2400,12.2
16126,Lee Norwood,1990-91,30.0,9,31,51,51,9,22,31,106.0,,226,28,79,107,367.0,80,7.43,89,437,2435,12.2
16127,Lee Norwood,1991-92,31.0,10,42,66,66,10,32,42,97.0,,292,38,111,149,464.0,80,7.48,85,403,2430,12.3
16128,Lee Norwood,1992-93,32.0,11,22,64,64,8,14,22,60.0,,356,46,125,171,524.0,80,7.37,76,367,2421,12.2
16129,Lee Norwood,1993-94,33.0,12,15,49,49,6,9,15,63.0,,405,52,134,186,587.0,80,6.91,71,366,2385,11.6
16130,Lee Norwood,1994-95,34.0,13,14,50,50,3,11,14,52.0,,455,55,145,200,639.0,80,6.96,77,402,2440,11.4
16131,Lee Norwood,1995-96,35.0,14,10,32,32,3,7,10,36.0,,487,58,152,210,675.0,84,7.25,87,443,2603,11.7
16132,Lee Norwood,1996-97,36.0,15,1,16,16,0,1,1,10.0,,503,58,153,211,685.0,84,6.48,76,407,2545,10.7
16133,Lee Sorochan,2001-02,26.0,4,0,2,2,0,0,0,5.0,31.0,2,0,0,0,5.0,82,5.27,57,359,2285,9.4
16134,Lee Sorochan,2002-03,27.0,5,0,1,1,0,0,0,0.0,4.0,3,0,0,0,5.0,82,5.49,53,331,2294,9.8
16135,Lee Stempniak,2008-09,25.0,4,27,57,57,14,13,27,100.0,819.0,57,14,13,27,100.0,82,6.05,85,480,2458,10.1
16136,Lee Stempniak,2009-10,26.0,5,52,82,82,27,25,52,166.0,1207.0,139,41,38,79,266.0,82,5.76,70,398,2426,9.7
16137,Lee Stempniak,2010-11,27.0,6,38,80,80,13,25,38,162.0,1271.0,219,54,63,117,428.0,82,5.44,62,351,2383,9.4
16138,Lee Stempniak,2011-12,28.0,7,44,75,75,14,30,44,171.0,1240.0,294,68,93,161,599.0,82,5.7,65,341,2477,9.4
16139,Lee Stempniak,2012-13,29.0,8,48,80,80,28,20,48,212.0,1386.0,374,96,113,209,811.0,82,5.53,56,304,2486,9.1
16140,Lee Stempniak,2013-14,30.0,9,38,82,82,19,19,38,199.0,1251.0,456,115,132,247,1010.0,82,5.46,52,291,2492,9.0
16141,Lee Stempniak,2014-15,31.0,10,28,61,61,14,14,28,130.0,990.0,517,129,146,275,1140.0,82,5.32,47,271,2439,8.9
16142,Lee Stempniak,2015-16,32.0,11,32,47,47,9,23,32,113.0,842.0,564,138,169,307,1253.0,48,5.31,29,160,1399,9.1
16143,Lee Stempniak,2016-17,33.0,12,34,73,73,12,22,34,178.0,1348.0,637,150,191,341,1431.0,82,5.34,48,269,2463,8.9
16144,Lee Stempniak,2017-18,34.0,13,28,71,71,15,13,28,115.0,903.0,708,165,204,369,1546.0,82,5.32,47,251,2453,8.9
16145,Lee Stempniak,2018-19,35.0,14,51,82,82,19,32,51,146.0,1471.0,790,184,236,420,1692.0,82,5.34,48,255,2438,9.0
16146,Lee Stempniak,2019-20,36.0,15,40,82,82,16,24,40,131.0,1299.0,872,200,260,460,1823.0,82,5.45,47,245,2478,9.0
16147,Lee Stempniak,2020-21,37.0,16,9,37,37,3,6,9,41.0,461.0,909,203,266,469,1864.0,82,5.86,50,250,2620,9.2
16148,Lee Stempniak,2021-22,38.0,17,0,2,2,0,0,0,0.0,16.0,911,203,266,469,1864.0,82,5.96,47,239,2579,9.5
16149,Lee Sweatt,2013-14,28.0,4,2,3,3,1,1,2,4.0,40.0,3,1,1,2,4.0,82,5.46,52,291,2492,9.0
16150,Leif Rohlin,1998-99,30.0,4,22,56,56,6,16,22,72.0,,56,6,16,22,72.0,82,6.29,74,413,2481,10.4
16151,Leif Rohlin,1999-00,31.0,5,10,40,40,2,8,10,37.0,,96,8,24,32,109.0,82,5.83,55,336,2444,9.8
16152,Leigh Verstraete,1985-86,24.0,4,0,3,3,0,0,0,0.0,,3,0,0,0,0.0,80,7.73,71,310,2444,12.7
16153,Leigh Verstraete,1987-88,26.0,5,0,2,2,0,0,0,2.0,,5,0,0,0,2.0,80,7.77,71,321,2447,12.7
16154,Leigh Verstraete,1990-91,29.0,6,1,3,3,0,1,1,0.0,,8,0,1,1,2.0,80,7.43,89,437,2435,12.2
16155,Len Barrie,1992-93,23.0,4,0,1,1,0,0,0,0.0,,1,0,0,0,0.0,80,7.37,76,367,2421,12.2
16156,Len Barrie,1995-96,26.0,5,4,8,8,2,2,4,14.0,,9,2,2,4,14.0,84,7.25,87,443,2603,11.7
16157,Len Barrie,1996-97,27.0,6,0,2,2,0,0,0,0.0,,11,2,2,4,14.0,84,6.48,76,407,2545,10.7
16158,Len Barrie,1997-98,28.0,7,14,48,48,3,11,14,37.0,,59,5,13,18,51.0,48,5.97,37,209,1408,10.2
16159,Len Barrie,1998-99,29.0,8,0,5,5,0,0,0,5.0,,64,5,13,18,56.0,82,6.29,74,413,2481,10.4
16160,Len Barrie,2002-03,33.0,9,23,60,60,9,14,23,61.0,741.0,124,14,27,41,117.0,82,5.49,53,331,2294,9.8
16161,Len Barrie,2003-04,34.0,10,23,60,60,5,18,23,48.0,754.0,184,19,45,64,165.0,82,5.51,63,376,2272,9.9
16162,Len Esau,1994-95,26.0,4,0,2,2,0,0,0,0.0,,2,0,0,0,0.0,80,6.96,77,402,2440,11.4
16163,Len Esau,1995-96,27.0,5,1,4,4,0,1,1,1.0,,6,0,1,1,1.0,84,7.25,87,443,2603,11.7
16164,Len Esau,1996-97,28.0,6,3,6,6,0,3,3,4.0,,12,0,4,4,5.0,84,6.48,76,407,2545,10.7
16165,Len Esau,1997-98,29.0,7,6,15,15,0,6,6,21.0,,27,0,10,10,26.0,48,5.97,37,209,1408,10.2
16166,Len Hachborn,1986-87,25.0,4,32,38,38,11,21,32,69.0,,38,11,21,32,69.0,80,7.89,74,336,2448,12.9
16167,Len Hachborn,1987-88,26.0,5,22,40,40,5,17,22,57.0,,78,16,38,54,126.0,80,7.77,71,321,2447,12.7
16168,Len Hachborn,1988-89,27.0,6,5,24,24,4,1,5,14.0,,102,20,39,59,140.0,80,7.94,82,370,2484,12.8
16169,Lennart Petrell,2014-15,30.0,4,9,60,60,4,5,9,36.0,578.0,60,4,5,9,36.0,82,5.32,47,271,2439,8.9
16170,Lennart Petrell,2015-16,31.0,5,9,35,35,3,6,9,23.0,404.0,95,7,11,18,59.0,48,5.31,29,160,1399,9.1
16171,Leo Komarov,2015-16,29.0,4,9,42,42,4,5,9,51.0,585.0,42,4,5,9,51.0,48,5.31,29,160,1399,9.1
16172,Leo Komarov,2017-18,31.0,5,26,62,62,8,18,26,84.0,911.0,104,12,23,35,135.0,82,5.32,47,251,2453,8.9
16173,Leo Komarov,2018-19,32.0,6,36,67,67,19,17,36,130.0,1195.0,171,31,40,71,265.0,82,5.34,48,255,2438,9.0
16174,Leo Komarov,2019-20,33.0,7,32,82,82,14,18,32,114.0,1400.0,253,45,58,103,379.0,82,5.45,47,245,2478,9.0
16175,Leo Komarov,2020-21,34.0,8,19,74,74,7,12,19,114.0,1168.0,327,52,70,122,493.0,82,5.86,50,250,2620,9.2
16176,Leo Komarov,2021-22,35.0,9,26,82,82,6,20,26,78.0,1139.0,409,58,90,148,571.0,82,5.96,47,239,2579,9.5
16177,Leo Komarov,2022-23,36.0,10,14,48,48,4,10,14,46.0,605.0,457,62,100,162,617.0,70,5.96,42,208,2192,9.5
16178,Leon Draisaitl,2017-18,22.0,4,9,37,37,2,7,9,49.0,470.0,37,2,7,9,49.0,82,5.32,47,251,2453,8.9
16179,Leon Draisaitl,2018-19,23.0,5,51,72,72,19,32,51,133.0,1300.0,109,21,39,60,182.0,82,5.34,48,255,2438,9.0
16180,Leon Draisaitl,2019-20,24.0,6,77,82,82,29,48,77,172.0,1548.0,191,50,87,137,354.0,82,5.45,47,245,2478,9.0
16181,Leon Draisaitl,2020-21,25.0,7,70,78,78,25,45,70,194.0,1507.0,269,75,132,207,548.0,82,5.86,50,250,2620,9.2
16182,Leon Draisaitl,2021-22,26.0,8,105,82,82,50,55,105,231.0,1852.0,351,125,187,312,779.0,82,5.96,47,239,2579,9.5
16183,Leon Draisaitl,2022-23,27.0,9,110,71,71,43,67,110,218.0,1605.0,422,168,254,422,997.0,70,5.96,42,208,2192,9.5
16184,Les Auge,1983-84,30.0,4,3,6,6,0,3,3,3.0,,6,0,3,3,3.0,80,7.69,77,340,2441,12.6
16185,Liam Foudy,2022-23,22.0,4,1,2,2,0,1,1,3.0,28.0,2,0,1,1,3.0,70,5.96,42,208,2192,9.5
16186,Liam O'Brien,2017-18,23.0,4,2,13,13,1,1,2,16.0,98.0,13,1,1,2,16.0,82,5.32,47,251,2453,8.9
16187,Liam O'Brien,2019-20,25.0,5,0,1,1,0,0,0,0.0,6.0,14,1,1,2,16.0,82,5.45,47,245,2478,9.0
16188,Liam O'Brien,2020-21,26.0,6,0,3,3,0,0,0,1.0,21.0,17,1,1,2,17.0,82,5.86,50,250,2620,9.2
16189,Liam Reddox,2010-11,25.0,4,0,1,1,0,0,0,1.0,6.0,1,0,0,0,1.0,82,5.44,62,351,2383,9.4
16190,Liam Reddox,2011-12,26.0,5,12,46,46,5,7,12,39.0,482.0,47,5,7,12,40.0,82,5.7,65,341,2477,9.4
16191,Liam Reddox,2012-13,27.0,6,2,9,9,0,2,2,11.0,113.0,56,5,9,14,51.0,82,5.53,56,304,2486,9.1
16192,Liam Reddox,2013-14,28.0,7,10,44,44,1,9,10,85.0,660.0,100,6,18,24,136.0,82,5.46,52,291,2492,9.0
16193,Lias Andersson,2020-21,22.0,4,2,7,7,1,1,2,5.0,84.0,7,1,1,2,5.0,82,5.86,50,250,2620,9.2
16194,Lias Andersson,2021-22,23.0,5,6,42,42,2,4,6,41.0,450.0,49,3,5,8,46.0,82,5.96,47,239,2579,9.5
16195,Lias Andersson,2022-23,24.0,6,1,17,17,0,1,1,13.0,162.0,66,3,6,9,59.0,70,5.96,42,208,2192,9.5
16196,Libor Hajek,2021-22,23.0,4,1,5,5,1,0,1,10.0,83.0,5,1,0,1,10.0,82,5.96,47,239,2579,9.5
16197,Libor Hajek,2022-23,24.0,5,5,28,28,0,5,5,23.0,448.0,33,1,5,6,33.0,70,5.96,42,208,2192,9.5
16198,Libor Pivko,2006-07,26.0,4,0,1,1,0,0,0,2.0,7.0,1,0,0,0,2.0,82,5.14,57,348,2300,9.2
16199,Libor Sulak,2021-22,27.0,4,0,6,6,0,0,0,7.0,116.0,6,0,0,0,7.0,82,5.96,47,239,2579,9.5
16200,Libor Zabransky,1999-00,26.0,4,6,34,34,1,5,6,26.0,,34,1,5,6,26.0,82,5.83,55,336,2444,9.8
16201,Libor Zabransky,2000-01,27.0,5,1,6,6,0,1,1,2.0,,40,1,6,7,28.0,82,5.28,57,380,2242,9.6
16202,Linden Vey,2016-17,25.0,4,5,18,18,0,5,5,8.0,218.0,18,0,5,5,8.0,82,5.34,48,269,2463,8.9
16203,Linden Vey,2017-18,26.0,5,24,75,75,10,14,24,61.0,988.0,93,10,19,29,69.0,82,5.32,47,251,2453,8.9
16204,Linden Vey,2018-19,27.0,6,15,41,41,4,11,15,40.0,646.0,134,14,30,44,109.0,82,5.34,48,255,2438,9.0
16205,Linden Vey,2019-20,28.0,7,0,4,4,0,0,0,1.0,44.0,138,14,30,44,110.0,82,5.45,47,245,2478,9.0
16206,Lindsay Carson,1984-85,24.0,4,1,18,18,0,1,1,24.0,,18,0,1,1,24.0,80,8.03,73,320,2489,12.9
16207,Lindsay Carson,1985-86,25.0,5,37,78,78,18,19,37,150.0,,96,18,20,38,174.0,80,7.73,71,310,2444,12.7
16208,Lindsay Carson,1986-87,26.0,6,4,16,16,1,3,4,16.0,,112,19,23,42,190.0,80,7.89,74,336,2448,12.9
16209,Lindsay Carson,1987-88,27.0,7,39,77,77,20,19,39,118.0,,189,39,42,81,308.0,80,7.77,71,321,2447,12.7
16210,Lindsay Carson,1988-89,28.0,8,21,50,50,9,12,21,59.0,,239,48,54,102,367.0,80,7.94,82,370,2484,12.8
16211,Lindsay Carson,1989-90,29.0,9,26,71,71,11,15,26,100.0,,310,59,69,128,467.0,80,7.34,72,344,2400,12.2
16212,Lindsay Carson,1990-91,30.0,10,18,63,63,7,11,18,73.0,,373,66,80,146,540.0,80,7.43,89,437,2435,12.2
16213,Lindsay Vallis,1996-97,26.0,4,0,1,1,0,0,0,0.0,,1,0,0,0,0.0,84,6.48,76,407,2545,10.7
16214,Lindy Ruff,1982-83,22.0,4,19,63,63,5,14,19,77.0,,63,5,14,19,77.0,80,7.03,61,280,2352,12.0
16215,Lindy Ruff,1983-84,23.0,5,26,65,65,8,18,26,97.0,,128,13,32,45,174.0,80,7.69,77,340,2441,12.6
16216,Lindy Ruff,1984-85,24.0,6,48,79,79,16,32,48,181.0,,207,29,64,93,355.0,80,8.03,73,320,2489,12.9
16217,Lindy Ruff,1985-86,25.0,7,29,60,60,12,17,29,110.0,,267,41,81,122,465.0,80,7.73,71,310,2444,12.7
16218,Lindy Ruff,1986-87,26.0,8,45,58,58,14,31,45,126.0,,325,55,112,167,591.0,80,7.89,74,336,2448,12.9
16219,Lindy Ruff,1987-88,27.0,9,24,39,39,13,11,24,71.0,,364,68,123,191,662.0,80,7.77,71,321,2447,12.7
16220,Lindy Ruff,1988-89,28.0,10,32,54,54,20,12,32,131.0,,418,88,135,223,793.0,80,7.94,82,370,2484,12.8
16221,Lindy Ruff,1989-90,29.0,11,20,50,50,6,14,20,95.0,,468,94,149,243,888.0,80,7.34,72,344,2400,12.2
16222,Lindy Ruff,1990-91,30.0,12,25,77,77,2,23,25,106.0,,545,96,172,268,994.0,80,7.43,89,437,2435,12.2
16223,Lindy Ruff,1991-92,31.0,13,22,76,76,6,16,22,88.0,,621,102,188,290,1082.0,80,7.48,85,403,2430,12.3
16224,Lindy Ruff,1992-93,32.0,14,9,56,56,3,6,9,59.0,,677,105,194,299,1141.0,80,7.37,76,367,2421,12.2
16225,Lindy Ruff,1993-94,33.0,15,1,14,14,0,1,1,10.0,,691,105,195,300,1151.0,80,6.91,71,366,2385,11.6
16226,Link Gaetz,1991-92,23.0,4,2,12,12,0,2,2,8.0,,12,0,2,2,8.0,80,7.48,85,403,2430,12.3
16227,Link Gaetz,1992-93,24.0,5,0,5,5,0,0,0,4.0,,17,0,2,2,12.0,80,7.37,76,367,2421,12.2
16228,Link Gaetz,1994-95,26.0,6,12,48,48,6,6,12,73.0,,65,6,8,14,85.0,80,6.96,77,402,2440,11.4
16229,Linus Klasen,2013-14,27.0,4,0,4,4,0,0,0,4.0,52.0,4,0,0,0,4.0,82,5.46,52,291,2492,9.0
16230,Linus Omark,2013-14,26.0,4,27,51,51,5,22,27,76.0,783.0,51,5,22,27,76.0,82,5.46,52,291,2492,9.0
16231,Linus Omark,2014-15,27.0,5,3,14,14,3,0,3,24.0,188.0,65,8,22,30,100.0,82,5.32,47,271,2439,8.9
16232,Linus Omark,2016-17,29.0,6,2,14,14,0,2,2,10.0,175.0,79,8,24,32,110.0,82,5.34,48,269,2463,8.9
16233,Logan Brown,2020-21,22.0,4,1,4,4,0,1,1,4.0,33.0,4,0,1,1,4.0,82,5.86,50,250,2620,9.2
16234,Logan Brown,2021-22,23.0,5,0,2,2,0,0,0,2.0,21.0,6,0,1,1,6.0,82,5.96,47,239,2579,9.5
16235,Logan Brown,2022-23,24.0,6,8,23,23,1,7,8,23.0,270.0,29,1,8,9,29.0,70,5.96,42,208,2192,9.5
16236,Logan Couture,2012-13,23.0,4,9,25,25,5,4,9,42.0,256.0,25,5,4,9,42.0,82,5.53,56,304,2486,9.1
16237,Logan Couture,2013-14,24.0,5,56,79,79,32,24,56,253.0,1408.0,104,37,28,65,295.0,82,5.46,52,291,2492,9.0
16238,Logan Couture,2014-15,25.0,6,65,80,80,31,34,65,245.0,1485.0,184,68,62,130,540.0,82,5.32,47,271,2439,8.9
16239,Logan Couture,2015-16,26.0,7,37,48,48,21,16,37,151.0,869.0,232,89,78,167,691.0,48,5.31,29,160,1399,9.1
16240,Logan Couture,2016-17,27.0,8,54,65,65,23,31,54,233.0,1231.0,297,112,109,221,924.0,82,5.34,48,269,2463,8.9
16241,Logan Couture,2017-18,28.0,9,67,82,82,27,40,67,263.0,1564.0,379,139,149,288,1187.0,82,5.32,47,251,2453,8.9
16242,Logan Couture,2018-19,29.0,10,36,52,52,15,21,36,137.0,904.0,431,154,170,324,1324.0,82,5.34,48,255,2438,9.0
16243,Logan Couture,2019-20,30.0,11,52,73,73,25,27,52,174.0,1285.0,504,179,197,376,1498.0,82,5.45,47,245,2478,9.0
16244,Logan Couture,2020-21,31.0,12,61,78,78,34,27,61,204.0,1447.0,582,213,224,437,1702.0,82,5.86,50,250,2620,9.2
16245,Logan Couture,2021-22,32.0,13,70,81,81,27,43,70,204.0,1506.0,663,240,267,507,1906.0,82,5.96,47,239,2579,9.5
16246,Logan Couture,2022-23,33.0,14,39,52,52,16,23,39,126.0,963.0,715,256,290,546,2032.0,70,5.96,42,208,2192,9.5
16247,Logan O'Connor,2021-22,25.0,4,0,5,5,0,0,0,1.0,34.0,5,0,0,0,1.0,82,5.96,47,239,2579,9.5
16248,Logan O'Connor,2022-23,26.0,5,2,16,16,2,0,2,15.0,135.0,21,2,0,2,16.0,70,5.96,42,208,2192,9.5
16249,Logan Shaw,2018-19,27.0,4,7,53,53,5,2,7,72.0,649.0,53,5,2,7,72.0,82,5.34,48,255,2438,9.0
16250,Logan Shaw,2019-20,28.0,5,10,55,55,3,7,10,59.0,534.0,108,8,9,17,131.0,82,5.45,47,245,2478,9.0
16251,Logan Shaw,2020-21,29.0,6,14,72,72,4,10,14,105.0,855.0,180,12,19,31,236.0,82,5.86,50,250,2620,9.2
16252,Logan Shaw,2022-23,31.0,7,5,35,35,3,2,5,20.0,239.0,215,15,21,36,256.0,70,5.96,42,208,2192,9.5
16253,Lonnie Loach,1995-96,27.0,4,23,53,53,10,13,23,58.0,,53,10,13,23,58.0,84,7.25,87,443,2603,11.7
16254,Lonnie Loach,1996-97,28.0,5,0,3,3,0,0,0,8.0,,56,10,13,23,66.0,84,6.48,76,407,2545,10.7
16255,Lonny Bohonos,1998-99,25.0,4,1,3,3,0,1,1,3.0,,3,0,1,1,3.0,82,6.29,74,413,2481,10.4
16256,Lonny Bohonos,1999-00,26.0,5,22,36,36,11,11,22,67.0,,39,11,12,23,70.0,82,5.83,55,336,2444,9.8
16257,Lonny Bohonos,2000-01,27.0,6,9,37,37,5,4,9,50.0,,76,16,16,32,120.0,82,5.28,57,380,2242,9.6
16258,Lonny Bohonos,2001-02,28.0,7,3,7,7,3,0,3,13.0,96.0,83,19,16,35,133.0,82,5.27,57,359,2285,9.4
16259,Lou Crawford,1992-93,30.0,4,0,7,7,0,0,0,6.0,,7,0,0,0,6.0,80,7.37,76,367,2421,12.2
16260,Lou Crawford,1994-95,32.0,5,3,19,19,2,1,3,14.0,,26,2,1,3,20.0,80,6.96,77,402,2440,11.4
16261,Lou Franceschetti,1984-85,26.0,4,12,30,30,2,10,12,25.0,,30,2,10,12,25.0,80,8.03,73,320,2489,12.9
16262,Lou Franceschetti,1986-87,28.0,5,0,2,2,0,0,0,2.0,,32,2,10,12,27.0,80,7.89,74,336,2448,12.9
16263,Lou Franceschetti,1987-88,29.0,6,11,22,22,4,7,11,19.0,,54,6,17,23,46.0,80,7.77,71,321,2447,12.7
16264,Lou Franceschetti,1988-89,30.0,7,21,76,76,7,14,21,57.0,,130,13,31,44,103.0,80,7.94,82,370,2484,12.8
16265,Lou Franceschetti,1989-90,31.0,8,21,75,75,12,9,21,77.0,,205,25,40,65,180.0,80,7.34,72,344,2400,12.2
16266,Lou Franceschetti,1990-91,32.0,9,12,59,59,4,8,12,53.0,,264,29,48,77,233.0,80,7.43,89,437,2435,12.2
16267,Lou Franceschetti,1991-92,33.0,10,17,63,63,7,10,17,55.0,,327,36,58,94,288.0,80,7.48,85,403,2430,12.3
16268,Lou Franceschetti,1992-93,34.0,11,36,80,80,21,15,36,76.0,,407,57,73,130,364.0,80,7.37,76,367,2421,12.2
16269,Lou Franceschetti,1993-94,35.0,12,10,51,51,2,8,10,27.0,,458,59,81,140,391.0,80,6.91,71,366,2385,11.6
16270,Lou Franceschetti,1994-95,36.0,13,0,1,1,0,0,0,0.0,,459,59,81,140,391.0,80,6.96,77,402,2440,11.4
16271,Loui Eriksson,2009-10,24.0,4,19,59,59,6,13,19,78.0,778.0,59,6,13,19,78.0,82,5.76,70,398,2426,9.7
16272,Loui Eriksson,2010-11,25.0,5,31,69,69,14,17,31,120.0,968.0,128,20,30,50,198.0,82,5.44,62,351,2383,9.4
16273,Loui Eriksson,2011-12,26.0,6,63,82,82,36,27,63,178.0,1626.0,210,56,57,113,376.0,82,5.7,65,341,2477,9.4
16274,Loui Eriksson,2012-13,27.0,7,71,82,82,29,42,71,214.0,1620.0,292,85,99,184,590.0,82,5.53,56,304,2486,9.1
16275,Loui Eriksson,2013-14,28.0,8,73,79,79,27,46,73,179.0,1625.0,371,112,145,257,769.0,82,5.46,52,291,2492,9.0
16276,Loui Eriksson,2014-15,29.0,9,71,82,82,26,45,71,187.0,1620.0,453,138,190,328,956.0,82,5.32,47,271,2439,8.9
16277,Loui Eriksson,2015-16,30.0,10,29,48,48,12,17,29,104.0,966.0,501,150,207,357,1060.0,48,5.31,29,160,1399,9.1
16278,Loui Eriksson,2016-17,31.0,11,37,61,61,10,27,37,115.0,1008.0,562,160,234,394,1175.0,82,5.34,48,269,2463,8.9
16279,Loui Eriksson,2017-18,32.0,12,47,81,81,22,25,47,169.0,1497.0,643,182,259,441,1344.0,82,5.32,47,251,2453,8.9
16280,Loui Eriksson,2018-19,33.0,13,63,82,82,30,33,63,184.0,1598.0,725,212,292,504,1528.0,82,5.34,48,255,2438,9.0
16281,Loui Eriksson,2019-20,34.0,14,24,65,65,11,13,24,132.0,1214.0,790,223,305,528,1660.0,82,5.45,47,245,2478,9.0
16282,Loui Eriksson,2020-21,35.0,15,23,50,50,10,13,23,101.0,813.0,840,233,318,551,1761.0,82,5.86,50,250,2620,9.2
16283,Loui Eriksson,2021-22,36.0,16,29,81,81,11,18,29,107.0,1139.0,921,244,336,580,1868.0,82,5.96,47,239,2579,9.5
16284,Loui Eriksson,2022-23,37.0,17,13,49,49,6,7,13,59.0,606.0,970,250,343,593,1927.0,70,5.96,42,208,2192,9.5
16285,Louie DeBrusk,1994-95,23.0,4,3,25,25,2,1,3,7.0,,25,2,1,3,7.0,80,6.96,77,402,2440,11.4
16286,Louie DeBrusk,1995-96,24.0,5,10,51,51,8,2,10,33.0,,76,10,3,13,40.0,84,7.25,87,443,2603,11.7
16287,Louie DeBrusk,1996-97,25.0,6,10,48,48,4,6,10,27.0,,124,14,9,23,67.0,84,6.48,76,407,2545,10.7
16288,Louie DeBrusk,1997-98,26.0,7,2,34,34,2,0,2,14.0,,158,16,9,25,81.0,48,5.97,37,209,1408,10.2
16289,Louie DeBrusk,1998-99,27.0,8,4,38,38,1,3,4,17.0,,196,17,12,29,98.0,82,6.29,74,413,2481,10.4
16290,Louie DeBrusk,1999-00,28.0,9,2,32,32,2,0,2,10.0,,228,19,12,31,108.0,82,5.83,55,336,2444,9.8
16291,Louie DeBrusk,2000-01,29.0,10,3,54,54,1,2,3,14.0,,282,20,14,34,122.0,82,5.28,57,380,2242,9.6
16292,Louie DeBrusk,2001-02,30.0,11,0,15,15,0,0,0,6.0,89.0,297,20,14,34,128.0,82,5.27,57,359,2285,9.4
16293,Louie DeBrusk,2002-03,31.0,12,7,61,61,4,3,7,24.0,327.0,358,24,17,41,152.0,82,5.49,53,331,2294,9.8
16294,Louie DeBrusk,2003-04,32.0,13,0,39,39,0,0,0,12.0,188.0,397,24,17,41,164.0,82,5.51,63,376,2272,9.9
16295,Louie DeBrusk,2005-06,34.0,14,0,4,4,0,0,0,0.0,25.0,401,24,17,41,164.0,82,5.31,60,363,2326,9.4
16296,Louis Belpedio,2020-21,24.0,4,2,1,1,0,2,2,0.0,16.0,1,0,2,2,0.0,82,5.86,50,250,2620,9.2
16297,Louis Belpedio,2021-22,25.0,5,0,2,2,0,0,0,0.0,26.0,3,0,2,2,0.0,82,5.96,47,239,2579,9.5
16298,Louis Leblanc,2014-15,24.0,4,10,42,42,5,5,10,58.0,470.0,42,5,5,10,58.0,82,5.32,47,271,2439,8.9
16299,Louis Leblanc,2016-17,26.0,5,0,8,8,0,0,0,7.0,79.0,50,5,5,10,65.0,82,5.34,48,269,2463,8.9
16300,Louis Robitaille,2008-09,26.0,4,0,2,2,0,0,0,0.0,9.0,2,0,0,0,0.0,82,6.05,85,480,2458,10.1
16301,Louis Sleigher,1982-83,24.0,4,1,2,2,0,1,1,0.0,,2,0,1,1,0.0,80,7.03,61,280,2352,12.0
16302,Louis Sleigher,1984-85,26.0,5,0,8,8,0,0,0,3.0,,10,0,1,1,3.0,80,8.03,73,320,2489,12.9
16303,Louis Sleigher,1985-86,27.0,6,24,51,51,14,10,24,55.0,,61,14,11,25,58.0,80,7.73,71,310,2444,12.7
16304,Louis Sleigher,1986-87,28.0,7,34,44,44,15,19,34,74.0,,105,29,30,59,132.0,80,7.89,74,336,2448,12.9
16305,Louis Sleigher,1987-88,29.0,8,34,76,76,13,21,34,113.0,,181,42,51,93,245.0,80,7.77,71,321,2447,12.7
16306,Louis Sleigher,1988-89,30.0,9,6,13,13,4,2,6,18.0,,194,46,53,99,263.0,80,7.94,82,370,2484,12.8
16307,Lubomir Sekeras,2003-04,35.0,4,34,80,80,11,23,34,102.0,1697.0,80,11,23,34,102.0,82,5.51,63,376,2272,9.9
16308,Lubomir Sekeras,2004-05,36.0,5,24,69,69,4,20,24,82.0,1561.0,149,15,43,58,184.0,82,5.24,53,338,2262,9.5
16309,Lubomir Sekeras,2005-06,37.0,6,11,60,60,2,9,11,50.0,1132.0,209,17,52,69,234.0,82,5.31,60,363,2326,9.4
16310,Lubomir Sekeras,2006-07,38.0,7,2,4,4,1,1,2,2.0,66.0,213,18,53,71,236.0,82,5.14,57,348,2300,9.2
16311,Lubomir Vaic,2000-01,23.0,4,2,5,5,1,1,2,8.0,,5,1,1,2,8.0,82,5.28,57,380,2242,9.6
16312,Lubomir Vaic,2002-03,25.0,5,0,4,4,0,0,0,2.0,30.0,9,1,1,2,10.0,82,5.49,53,331,2294,9.8
16313,Lubomir Visnovsky,2003-04,27.0,4,39,81,81,7,32,39,105.0,1375.0,81,7,32,39,105.0,82,5.51,63,376,2272,9.9
16314,Lubomir Visnovsky,2004-05,28.0,5,21,72,72,4,17,21,95.0,1170.0,153,11,49,60,200.0,82,5.24,53,338,2262,9.5
16315,Lubomir Visnovsky,2005-06,29.0,6,24,57,57,8,16,24,85.0,1102.0,210,19,65,84,285.0,82,5.31,60,363,2326,9.4
16316,Lubomir Visnovsky,2006-07,30.0,7,29,58,58,8,21,29,114.0,1394.0,268,27,86,113,399.0,82,5.14,57,348,2300,9.2
16317,Lubomir Visnovsky,2008-09,32.0,8,67,80,80,17,50,67,152.0,1862.0,348,44,136,180,551.0,82,6.05,85,480,2458,10.1
16318,Lubomir Visnovsky,2009-10,33.0,9,58,69,69,18,40,58,159.0,1687.0,417,62,176,238,710.0,82,5.76,70,398,2426,9.7
16319,Lubomir Visnovsky,2010-11,34.0,10,41,82,82,8,33,41,153.0,1886.0,499,70,209,279,863.0,82,5.44,62,351,2383,9.4
16320,Lubomir Visnovsky,2011-12,35.0,11,31,50,50,8,23,31,86.0,1151.0,549,78,232,310,949.0,82,5.7,65,341,2477,9.4
16321,Lubomir Visnovsky,2012-13,36.0,12,45,73,73,15,30,45,131.0,1599.0,622,93,262,355,1080.0,82,5.53,56,304,2486,9.1
16322,Lubomir Visnovsky,2013-14,37.0,13,68,81,81,18,50,68,152.0,1968.0,703,111,312,423,1232.0,82,5.46,52,291,2492,9.0
16323,Lubomir Visnovsky,2014-15,38.0,14,27,68,68,6,21,27,112.0,1414.0,771,117,333,450,1344.0,82,5.32,47,271,2439,8.9
16324,Lubomir Visnovsky,2015-16,39.0,15,14,35,35,3,11,14,69.0,798.0,806,120,344,464,1413.0,48,5.31,29,160,1399,9.1
16325,Lubomir Visnovsky,2016-17,40.0,16,11,24,24,3,8,11,34.0,493.0,830,123,352,475,1447.0,82,5.34,48,269,2463,8.9
16326,Lubomir Visnovsky,2017-18,41.0,17,20,53,53,5,15,20,85.0,1035.0,883,128,367,495,1532.0,82,5.32,47,251,2453,8.9
16327,Lubos Bartecko,2001-02,25.0,4,16,32,32,5,11,16,37.0,423.0,32,5,11,16,37.0,82,5.27,57,359,2285,9.4
16328,Lubos Bartecko,2002-03,26.0,5,39,67,67,16,23,39,75.0,908.0,99,21,34,55,112.0,82,5.49,53,331,2294,9.8
16329,Lubos Bartecko,2003-04,27.0,6,13,50,50,5,8,13,51.0,521.0,149,26,42,68,163.0,82,5.51,63,376,2272,9.9
16330,Lubos Bartecko,2004-05,28.0,7,27,71,71,13,14,27,96.0,1028.0,220,39,56,95,259.0,82,5.24,53,338,2262,9.5
16331,Lubos Bartecko,2005-06,29.0,8,16,37,37,7,9,16,54.0,463.0,257,46,65,111,313.0,82,5.31,60,363,2326,9.4
16332,Luc Bourdon,2009-10,22.0,4,0,9,9,0,0,0,3.0,80.0,9,0,0,0,3.0,82,5.76,70,398,2426,9.7
16333,Luc Bourdon,2010-11,23.0,5,2,27,27,2,0,2,26.0,348.0,36,2,0,2,29.0,82,5.44,62,351,2383,9.4
16334,Luc Dufour,1985-86,22.0,4,25,73,73,14,11,25,121.0,,73,14,11,25,121.0,80,7.73,71,310,2444,12.7
16335,Luc Dufour,1986-87,23.0,5,10,41,41,6,4,10,39.0,,114,20,15,35,160.0,80,7.89,74,336,2448,12.9
16336,Luc Dufour,1987-88,24.0,6,9,53,53,3,6,9,56.0,,167,23,21,44,216.0,80,7.77,71,321,2447,12.7
16337,Luc Gauthier,1993-94,29.0,4,0,3,3,0,0,0,0.0,,3,0,0,0,0.0,80,6.91,71,366,2385,11.6
16338,Luc Robitaille,1989-90,23.0,4,84,79,79,45,39,84,199.0,,79,45,39,84,199.0,80,7.34,72,344,2400,12.2
16339,Luc Robitaille,1990-91,24.0,5,111,80,80,53,58,111,220.0,,159,98,97,195,419.0,80,7.43,89,437,2435,12.2
16340,Luc Robitaille,1991-92,25.0,6,98,78,78,46,52,98,237.0,,237,144,149,293,656.0,80,7.48,85,403,2430,12.3
16341,Luc Robitaille,1992-93,26.0,7,101,80,80,52,49,101,210.0,,317,196,198,394,866.0,80,7.37,76,367,2421,12.2
16342,Luc Robitaille,1993-94,27.0,8,91,76,76,45,46,91,229.0,,393,241,244,485,1095.0,80,6.91,71,366,2385,11.6
16343,Luc Robitaille,1994-95,28.0,9,107,80,80,44,63,107,240.0,,473,285,307,592,1335.0,80,6.96,77,402,2440,11.4
16344,Luc Robitaille,1995-96,29.0,10,125,84,84,63,62,125,265.0,,557,348,369,717,1600.0,84,7.25,87,443,2603,11.7
16345,Luc Robitaille,1996-97,30.0,11,86,83,83,44,42,86,267.0,,640,392,411,803,1867.0,84,6.48,76,407,2545,10.7
16346,Luc Robitaille,1997-98,31.0,12,42,46,46,23,19,42,109.0,,686,415,430,845,1976.0,48,5.97,37,209,1408,10.2
16347,Luc Robitaille,1998-99,32.0,13,69,77,77,23,46,69,223.0,,763,438,476,914,2199.0,82,6.29,74,413,2481,10.4
16348,Luc Robitaille,1999-00,33.0,14,48,69,69,24,24,48,200.0,,832,462,500,962,2399.0,82,5.83,55,336,2444,9.8
16349,Luc Robitaille,2000-01,34.0,15,40,57,57,16,24,40,130.0,,889,478,524,1002,2529.0,82,5.28,57,380,2242,9.6
16350,Luc Robitaille,2001-02,35.0,16,74,82,82,39,35,74,292.0,1573.0,971,517,559,1076,2821.0,82,5.27,57,359,2285,9.4
16351,Luc Robitaille,2002-03,36.0,17,74,71,71,36,38,74,221.0,1318.0,1042,553,597,1150,3042.0,82,5.49,53,331,2294,9.8
16352,Luc Robitaille,2003-04,37.0,18,88,82,82,37,51,88,235.0,1534.0,1124,590,648,1238,3277.0,82,5.51,63,376,2272,9.9
16353,Luc Robitaille,2004-05,38.0,19,50,81,81,30,20,50,190.0,1203.0,1205,620,668,1288,3467.0,82,5.24,53,338,2262,9.5
16354,Luc Robitaille,2005-06,39.0,20,31,81,81,11,20,31,148.0,1038.0,1286,631,688,1319,3615.0,82,5.31,60,363,2326,9.4
16355,Luc Robitaille,2006-07,40.0,21,51,80,80,22,29,51,221.0,1334.0,1366,653,717,1370,3836.0,82,5.14,57,348,2300,9.2
16356,Luc Robitaille,2008-09,42.0,22,24,65,65,15,9,24,125.0,914.0,1431,668,726,1394,3961.0,82,6.05,85,480,2458,10.1
16357,Luca Caputi,2011-12,23.0,4,1,5,5,1,0,1,7.0,51.0,5,1,0,1,7.0,82,5.7,65,341,2477,9.4
16358,Luca Caputi,2012-13,24.0,5,8,23,23,2,6,8,36.0,325.0,28,3,6,9,43.0,82,5.53,56,304,2486,9.1
16359,Luca Caputi,2013-14,25.0,6,0,7,7,0,0,0,8.0,77.0,35,3,6,9,51.0,82,5.46,52,291,2492,9.0
16360,Luca Sbisa,2011-12,22.0,4,7,39,39,0,7,7,38.0,682.0,39,0,7,7,38.0,82,5.7,65,341,2477,9.4
16361,Luca Sbisa,2012-13,23.0,5,0,8,8,0,0,0,3.0,101.0,47,0,7,7,41.0,82,5.53,56,304,2486,9.1
16362,Luca Sbisa,2013-14,24.0,6,11,68,68,2,9,11,76.0,1142.0,115,2,16,18,117.0,82,5.46,52,291,2492,9.0
16363,Luca Sbisa,2014-15,25.0,7,24,80,80,5,19,24,88.0,1434.0,195,7,35,42,205.0,82,5.32,47,271,2439,8.9
16364,Luca Sbisa,2015-16,26.0,8,8,41,41,1,7,8,39.0,813.0,236,8,42,50,244.0,48,5.31,29,160,1399,9.1
16365,Luca Sbisa,2016-17,27.0,9,6,30,30,1,5,6,30.0,512.0,266,9,47,56,274.0,82,5.34,48,269,2463,8.9
16366,Luca Sbisa,2017-18,28.0,10,11,76,76,3,8,11,79.0,1427.0,342,12,55,67,353.0,82,5.32,47,251,2453,8.9
16367,Luca Sbisa,2018-19,29.0,11,8,41,41,2,6,8,29.0,712.0,383,14,61,75,382.0,82,5.34,48,255,2438,9.0
16368,Luca Sbisa,2019-20,30.0,12,13,82,82,2,11,13,75.0,1556.0,465,16,72,88,457.0,82,5.45,47,245,2478,9.0
16369,Luca Sbisa,2020-21,31.0,13,14,30,30,2,12,14,26.0,586.0,495,18,84,102,483.0,82,5.86,50,250,2620,9.2
16370,Luca Sbisa,2021-22,32.0,14,1,9,9,0,1,1,5.0,139.0,504,18,85,103,488.0,82,5.96,47,239,2579,9.5
16371,Luca Sbisa,2022-23,33.0,15,10,44,44,2,8,10,49.0,789.0,548,20,93,113,537.0,70,5.96,42,208,2192,9.5
16372,Lucas Carlsson,2022-23,25.0,4,1,6,6,0,1,1,3.0,85.0,6,0,1,1,3.0,70,5.96,42,208,2192,9.5
16373,Lucas Lessio,2016-17,24.0,4,0,3,3,0,0,0,4.0,35.0,3,0,0,0,4.0,82,5.34,48,269,2463,8.9
16374,Lucas Lessio,2017-18,25.0,5,5,26,26,2,3,5,44.0,332.0,29,2,3,5,48.0,82,5.32,47,251,2453,8.9
16375,Lucas Lessio,2018-19,26.0,6,2,12,12,1,1,2,14.0,126.0,41,3,4,7,62.0,82,5.34,48,255,2438,9.0
16376,Lucas Wallmark,2019-20,24.0,4,2,8,8,0,2,2,11.0,87.0,8,0,2,2,11.0,82,5.45,47,245,2478,9.0
16377,Lucas Wallmark,2020-21,25.0,5,1,11,11,1,0,1,16.0,104.0,19,1,2,3,27.0,82,5.86,50,250,2620,9.2
16378,Lucas Wallmark,2021-22,26.0,6,28,81,81,10,18,28,131.0,1198.0,100,11,20,31,158.0,82,5.96,47,239,2579,9.5
16379,Lucas Wallmark,2022-23,27.0,7,25,67,67,12,13,25,84.0,856.0,167,23,33,56,242.0,70,5.96,42,208,2192,9.5
16380,Luciano Borsato,1993-94,28.0,4,1,1,1,0,1,1,1.0,,1,0,1,1,1.0,80,6.91,71,366,2385,11.6
16381,Luciano Borsato,1994-95,29.0,5,36,56,56,15,21,36,81.0,,57,15,22,37,82.0,80,6.96,77,402,2440,11.4
16382,Luciano Borsato,1995-96,30.0,6,35,67,67,15,20,35,101.0,,124,30,42,72,183.0,84,7.25,87,443,2603,11.7
16383,Luciano Borsato,1996-97,31.0,7,18,75,75,5,13,18,65.0,,199,35,55,90,248.0,84,6.48,76,407,2545,10.7
16384,Luciano Borsato,1997-98,32.0,8,0,4,4,0,0,0,2.0,,203,35,55,90,250.0,48,5.97,37,209,1408,10.2
16385,Lukas Kaspar,2010-11,25.0,4,0,3,3,0,0,0,5.0,37.0,3,0,0,0,5.0,82,5.44,62,351,2383,9.4
16386,Lukas Kaspar,2011-12,26.0,5,4,13,13,2,2,4,14.0,119.0,16,2,2,4,19.0,82,5.7,65,341,2477,9.4
16387,Lukas Krajicek,2004-05,21.0,4,0,5,5,0,0,0,3.0,67.0,5,0,0,0,3.0,82,5.24,53,338,2262,9.5
16388,Lukas Krajicek,2006-07,23.0,5,7,18,18,1,6,7,16.0,244.0,23,1,6,7,19.0,82,5.14,57,348,2300,9.2
16389,Lukas Krajicek,2008-09,25.0,6,16,67,67,2,14,16,89.0,1240.0,90,3,20,23,108.0,82,6.05,85,480,2458,10.1
16390,Lukas Krajicek,2009-10,26.0,7,16,78,78,3,13,16,105.0,1444.0,168,6,33,39,213.0,82,5.76,70,398,2426,9.7
16391,Lukas Krajicek,2010-11,27.0,8,11,39,39,2,9,11,28.0,709.0,207,8,42,50,241.0,82,5.44,62,351,2383,9.4
16392,Lukas Krajicek,2011-12,28.0,9,19,71,71,2,17,19,66.0,1393.0,278,10,59,69,307.0,82,5.7,65,341,2477,9.4
16393,Lukas Krajicek,2012-13,29.0,10,3,50,50,1,2,3,42.0,861.0,328,11,61,72,349.0,82,5.53,56,304,2486,9.1
16394,Lukas Radil,2021-22,31.0,4,11,36,36,7,4,11,40.0,385.0,36,7,4,11,40.0,82,5.96,47,239,2579,9.5
16395,Lukas Radil,2022-23,32.0,5,0,14,14,0,0,0,12.0,132.0,50,7,4,11,52.0,70,5.96,42,208,2192,9.5
16396,Lukas Sedlak,2019-20,26.0,4,13,62,62,7,6,13,57.0,603.0,62,7,6,13,57.0,82,5.45,47,245,2478,9.0
16397,Lukas Sedlak,2020-21,27.0,5,8,53,53,4,4,8,50.0,498.0,115,11,10,21,107.0,82,5.86,50,250,2620,9.2
16398,Lukas Sedlak,2021-22,28.0,6,6,47,47,4,2,6,43.0,423.0,162,15,12,27,150.0,82,5.96,47,239,2579,9.5
16399,Lukas Vejdemo,2022-23,27.0,4,1,7,7,1,0,1,7.0,56.0,7,1,0,1,7.0,70,5.96,42,208,2192,9.5
16400,Luke Adam,2013-14,23.0,4,4,19,19,3,1,4,31.0,213.0,19,3,1,4,31.0,82,5.46,52,291,2492,9.0
16401,Luke Adam,2014-15,24.0,5,20,52,52,10,10,20,89.0,645.0,71,13,11,24,120.0,82,5.32,47,271,2439,8.9
16402,Luke Adam,2015-16,25.0,6,1,4,4,1,0,1,2.0,39.0,75,14,11,25,122.0,48,5.31,29,160,1399,9.1
16403,Luke Adam,2016-17,26.0,7,1,12,12,1,0,1,16.0,154.0,87,15,11,26,138.0,82,5.34,48,269,2463,8.9
16404,Luke Adam,2017-18,27.0,8,0,3,3,0,0,0,0.0,19.0,90,15,11,26,138.0,82,5.32,47,251,2453,8.9
16405,Luke Gazdic,2016-17,27.0,4,4,67,67,2,2,4,30.0,389.0,67,2,2,4,30.0,82,5.34,48,269,2463,8.9
16406,Luke Gazdic,2017-18,28.0,5,3,40,40,2,1,3,26.0,296.0,107,4,3,7,56.0,82,5.32,47,251,2453,8.9
16407,Luke Gazdic,2018-19,29.0,6,1,29,29,1,0,1,18.0,180.0,136,5,3,8,74.0,82,5.34,48,255,2438,9.0
16408,Luke Gazdic,2019-20,30.0,7,0,11,11,0,0,0,3.0,78.0,147,5,3,8,77.0,82,5.45,47,245,2478,9.0
16409,Luke Glendening,2016-17,27.0,4,7,56,56,1,6,7,54.0,779.0,56,1,6,7,54.0,82,5.34,48,269,2463,8.9
16410,Luke Glendening,2017-18,28.0,5,18,82,82,12,6,18,104.0,1207.0,138,13,12,25,158.0,82,5.32,47,251,2453,8.9
16411,Luke Glendening,2018-19,29.0,6,21,81,81,8,13,21,88.0,1181.0,219,21,25,46,246.0,82,5.34,48,255,2438,9.0
16412,Luke Glendening,2019-20,30.0,7,14,74,74,3,11,14,76.0,956.0,293,24,36,60,322.0,82,5.45,47,245,2478,9.0
16413,Luke Glendening,2020-21,31.0,8,19,69,69,11,8,19,88.0,911.0,362,35,44,79,410.0,82,5.86,50,250,2620,9.2
16414,Luke Glendening,2021-22,32.0,9,23,78,78,10,13,23,102.0,1231.0,440,45,57,102,512.0,82,5.96,47,239,2579,9.5
16415,Luke Glendening,2022-23,33.0,10,9,60,60,6,3,9,76.0,921.0,500,51,60,111,588.0,70,5.96,42,208,2192,9.5
16416,Luke Johnson,2021-22,27.0,4,1,15,15,0,1,1,19.0,162.0,15,0,1,1,19.0,82,5.96,47,239,2579,9.5
16417,Luke Johnson,2022-23,28.0,5,0,3,3,0,0,0,1.0,35.0,18,0,1,1,20.0,70,5.96,42,208,2192,9.5
16418,Luke Kunin,2020-21,23.0,4,4,19,19,2,2,4,32.0,247.0,19,2,2,4,32.0,82,5.86,50,250,2620,9.2
16419,Luke Kunin,2021-22,24.0,5,17,49,49,6,11,17,88.0,778.0,68,8,13,21,120.0,82,5.96,47,239,2579,9.5
16420,Luke Kunin,2022-23,25.0,6,31,63,63,15,16,31,128.0,974.0,131,23,29,52,248.0,70,5.96,42,208,2192,9.5
16421,Luke Richardson,1990-91,21.0,4,10,78,78,4,6,10,49.0,,78,4,6,10,49.0,80,7.43,89,437,2435,12.2
16422,Luke Richardson,1991-92,22.0,5,9,55,55,2,7,9,59.0,,133,6,13,19,108.0,80,7.48,85,403,2430,12.3
16423,Luke Richardson,1992-93,23.0,6,18,67,67,4,14,18,80.0,,200,10,27,37,188.0,80,7.37,76,367,2421,12.2
16424,Luke Richardson,1993-94,24.0,7,10,78,78,1,9,10,68.0,,278,11,36,47,256.0,80,6.91,71,366,2385,11.6
16425,Luke Richardson,1994-95,25.0,8,21,75,75,2,19,21,85.0,,353,13,55,68,341.0,80,6.96,77,402,2440,11.4
16426,Luke Richardson,1995-96,26.0,9,13,82,82,3,10,13,78.0,,435,16,65,81,419.0,84,7.25,87,443,2603,11.7
16427,Luke Richardson,1996-97,27.0,10,8,69,69,2,6,8,92.0,,504,18,71,89,511.0,84,6.48,76,407,2545,10.7
16428,Luke Richardson,1997-98,28.0,11,13,46,46,3,10,13,51.0,,550,21,81,102,562.0,48,5.97,37,209,1408,10.2
16429,Luke Richardson,1998-99,29.0,12,11,82,82,2,9,11,61.0,,632,23,90,113,623.0,82,6.29,74,413,2481,10.4
16430,Luke Richardson,1999-00,30.0,13,12,82,82,1,11,12,67.0,,714,24,101,125,690.0,82,5.83,55,336,2444,9.8
16431,Luke Richardson,2000-01,31.0,14,5,81,81,2,3,5,57.0,,795,26,104,130,747.0,82,5.28,57,380,2242,9.6
16432,Luke Richardson,2001-02,32.0,15,6,78,78,0,6,6,49.0,1291.0,873,26,110,136,796.0,82,5.27,57,359,2285,9.4
16433,Luke Richardson,2002-03,33.0,16,7,74,74,2,5,7,50.0,1197.0,947,28,115,143,846.0,82,5.49,53,331,2294,9.8
16434,Luke Richardson,2003-04,34.0,17,8,82,82,2,6,8,75.0,1698.0,1029,30,121,151,921.0,82,5.51,63,376,2272,9.9
16435,Luke Richardson,2004-05,35.0,18,9,72,72,1,8,9,65.0,1316.0,1101,31,129,160,986.0,82,5.24,53,338,2262,9.5
16436,Luke Richardson,2005-06,36.0,19,13,82,82,0,13,13,56.0,1929.0,1183,31,142,173,1042.0,82,5.31,60,363,2326,9.4
16437,Luke Richardson,2006-07,37.0,20,6,64,64,1,5,6,34.0,1288.0,1247,32,147,179,1076.0,82,5.14,57,348,2300,9.2
16438,Luke Richardson,2008-09,39.0,21,10,65,65,1,9,10,40.0,1066.0,1312,33,156,189,1116.0,82,6.05,85,480,2458,10.1
16439,Luke Richardson,2009-10,40.0,22,3,27,27,0,3,3,3.0,192.0,1339,33,159,192,1119.0,82,5.76,70,398,2426,9.7
16440,Luke Richardson,2010-11,41.0,23,9,76,76,2,7,9,41.0,936.0,1415,35,166,201,1160.0,82,5.44,62,351,2383,9.4
16441,Luke Richardson,2011-12,42.0,24,0,2,2,0,0,0,0.0,26.0,1417,35,166,201,1160.0,82,5.7,65,341,2477,9.4
16442,Luke Schenn,2011-12,22.0,4,14,70,70,2,12,14,102.0,1507.0,70,2,12,14,102.0,82,5.7,65,341,2477,9.4
16443,Luke Schenn,2012-13,23.0,5,17,79,79,5,12,17,101.0,1333.0,149,7,24,31,203.0,82,5.53,56,304,2486,9.1
16444,Luke Schenn,2013-14,24.0,6,22,82,82,5,17,22,128.0,1834.0,231,12,41,53,331.0,82,5.46,52,291,2492,9.0
16445,Luke Schenn,2014-15,25.0,7,22,79,79,2,20,22,81.0,1267.0,310,14,61,75,412.0,82,5.32,47,271,2439,8.9
16446,Luke Schenn,2015-16,26.0,8,11,47,47,3,8,11,81.0,1028.0,357,17,69,86,493.0,48,5.31,29,160,1399,9.1
16447,Luke Schenn,2016-17,27.0,9,12,79,79,4,8,12,78.0,1307.0,436,21,77,98,571.0,82,5.34,48,269,2463,8.9
16448,Luke Schenn,2017-18,28.0,10,14,58,58,3,11,14,67.0,1048.0,494,24,88,112,638.0,82,5.32,47,251,2453,8.9
16449,Luke Schenn,2018-19,29.0,11,16,72,72,4,12,16,76.0,1265.0,566,28,100,128,714.0,82,5.34,48,255,2438,9.0
16450,Luke Schenn,2019-20,30.0,12,8,78,78,1,7,8,94.0,1408.0,644,29,107,136,808.0,82,5.45,47,245,2478,9.0
16451,Luke Schenn,2020-21,31.0,13,7,64,64,1,6,7,59.0,1049.0,708,30,113,143,867.0,82,5.86,50,250,2620,9.2
16452,Luke Schenn,2021-22,32.0,14,2,26,26,0,2,2,30.0,362.0,734,30,115,145,897.0,82,5.96,47,239,2579,9.5
16453,Luke Schenn,2022-23,33.0,15,3,25,25,1,2,3,31.0,311.0,759,31,117,148,928.0,70,5.96,42,208,2192,9.5
16454,Luke Sellars,2004-05,23.0,4,0,1,1,0,0,0,0.0,3.0,1,0,0,0,0.0,82,5.24,53,338,2262,9.5
16455,Luke Witkowski,2017-18,27.0,4,0,16,16,0,0,0,10.0,243.0,16,0,0,0,10.0,82,5.32,47,251,2453,8.9
16456,Luke Witkowski,2018-19,28.0,5,0,4,4,0,0,0,1.0,29.0,20,0,0,0,11.0,82,5.34,48,255,2438,9.0
16457,Luke Witkowski,2019-20,29.0,6,4,34,34,0,4,4,24.0,336.0,54,0,4,4,35.0,82,5.45,47,245,2478,9.0
16458,Luke Witkowski,2020-21,30.0,7,4,31,31,1,3,4,16.0,213.0,85,1,7,8,51.0,82,5.86,50,250,2620,9.2
16459,Luke Witkowski,2021-22,31.0,8,2,34,34,0,2,2,14.0,326.0,119,1,9,10,65.0,82,5.96,47,239,2579,9.5
16460,Luke Witkowski,2022-23,32.0,9,3,12,12,1,2,3,10.0,106.0,131,2,11,13,75.0,70,5.96,42,208,2192,9.5
16461,Lyle Odelein,1992-93,24.0,4,2,8,8,0,2,2,1.0,,8,0,2,2,1.0,80,7.37,76,367,2421,12.2
16462,Lyle Odelein,1993-94,25.0,5,2,52,52,0,2,2,25.0,,60,0,4,4,26.0,80,6.91,71,366,2385,11.6
16463,Lyle Odelein,1994-95,26.0,6,8,71,71,1,7,8,43.0,,131,1,11,12,69.0,80,6.96,77,402,2440,11.4
16464,Lyle Odelein,1995-96,27.0,7,16,83,83,2,14,16,79.0,,214,3,25,28,148.0,84,7.25,87,443,2603,11.7
16465,Lyle Odelein,1996-97,28.0,8,40,79,79,11,29,40,116.0,,293,14,54,68,264.0,84,6.48,76,407,2545,10.7
16466,Lyle Odelein,1997-98,29.0,9,10,48,48,3,7,10,74.0,,341,17,61,78,338.0,48,5.97,37,209,1408,10.2
16467,Lyle Odelein,1998-99,30.0,10,17,79,79,3,14,17,74.0,,420,20,75,95,412.0,82,6.29,74,413,2481,10.4
16468,Lyle Odelein,1999-00,31.0,11,16,79,79,3,13,16,93.0,,499,23,88,111,505.0,82,5.83,55,336,2444,9.8
16469,Lyle Odelein,2000-01,32.0,12,23,79,79,4,19,23,76.0,,578,27,107,134,581.0,82,5.28,57,380,2242,9.6
16470,Lyle Odelein,2001-02,33.0,13,31,70,70,5,26,31,101.0,1392.0,648,32,133,165,682.0,82,5.27,57,359,2285,9.4
16471,Lyle Odelein,2002-03,34.0,14,24,73,73,2,22,24,89.0,1300.0,721,34,155,189,771.0,82,5.49,53,331,2294,9.8
16472,Lyle Odelein,2003-04,35.0,15,17,81,81,3,14,17,104.0,1743.0,802,37,169,206,875.0,82,5.51,63,376,2272,9.9
16473,Lyle Odelein,2004-05,36.0,16,18,77,77,2,16,18,86.0,1735.0,879,39,185,224,961.0,82,5.24,53,338,2262,9.5
16474,Lyle Odelein,2005-06,37.0,17,11,68,68,7,4,11,78.0,1294.0,947,46,189,235,1039.0,82,5.31,60,363,2326,9.4
16475,Lyle Odelein,2006-07,38.0,18,16,82,82,4,12,16,67.0,1549.0,1029,50,201,251,1106.0,82,5.14,57,348,2300,9.2
16476,Lyle Odelein,2008-09,40.0,19,1,27,27,0,1,1,17.0,438.0,1056,50,202,252,1123.0,82,6.05,85,480,2458,10.1
16477,Lyle Phair,1988-89,27.0,4,1,15,15,0,1,1,11.0,,15,0,1,1,11.0,80,7.94,82,370,2484,12.8
16478,Lyle Phair,1989-90,28.0,5,2,5,5,2,0,2,4.0,,20,2,1,3,15.0,80,7.34,72,344,2400,12.2
16479,Lyle Phair,1990-91,29.0,6,10,28,28,4,6,10,35.0,,48,6,7,13,50.0,80,7.43,89,437,2435,12.2
16480,Lyndon Byers,1986-87,22.0,4,6,10,10,2,4,6,11.0,,10,2,4,6,11.0,80,7.89,74,336,2448,12.9
16481,Lyndon Byers,1987-88,23.0,5,11,33,33,3,8,11,25.0,,43,5,12,17,36.0,80,7.77,71,321,2447,12.7
16482,Lyndon Byers,1988-89,24.0,6,2,5,5,0,2,2,1.0,,48,5,14,19,37.0,80,7.94,82,370,2484,12.8
16483,Lyndon Byers,1989-90,25.0,7,5,18,18,2,3,5,14.0,,66,7,17,24,51.0,80,7.34,72,344,2400,12.2
16484,Lyndon Byers,1990-91,26.0,8,24,53,53,10,14,24,69.0,,119,17,31,48,120.0,80,7.43,89,437,2435,12.2
16485,Lyndon Byers,1991-92,27.0,9,4,49,49,0,4,4,25.0,,168,17,35,52,145.0,80,7.48,85,403,2430,12.3
16486,Lyndon Byers,1992-93,28.0,10,8,43,43,4,4,8,43.0,,211,21,39,60,188.0,80,7.37,76,367,2421,12.2
16487,Lyndon Byers,1993-94,29.0,11,4,19,19,2,2,4,20.0,,230,23,41,64,208.0,80,6.91,71,366,2385,11.6
16488,Lyndon Byers,1994-95,30.0,12,2,31,31,1,1,2,12.0,,261,24,42,66,220.0,80,6.96,77,402,2440,11.4
16489,Lyndon Byers,1995-96,31.0,13,5,18,18,4,1,5,18.0,,279,28,43,71,238.0,84,7.25,87,443,2603,11.7
16490,Lynn Loyns,2005-06,24.0,4,3,19,19,3,0,3,12.0,149.0,19,3,0,3,12.0,82,5.31,60,363,2326,9.4
16491,Lynn Loyns,2006-07,25.0,5,2,14,14,0,2,2,6.0,150.0,33,3,2,5,18.0,82,5.14,57,348,2300,9.2
16492,Lynn Loyns,2008-09,27.0,6,0,1,1,0,0,0,0.0,6.0,34,3,2,5,18.0,82,6.05,85,480,2458,10.1
16493,MacGregor Sharp,2012-13,27.0,4,0,8,8,0,0,0,6.0,33.0,8,0,0,0,6.0,82,5.53,56,304,2486,9.1
16494,MacKenzie Weegar,2019-20,26.0,4,0,3,3,0,0,0,3.0,52.0,3,0,0,0,3.0,82,5.45,47,245,2478,9.0
16495,MacKenzie Weegar,2020-21,27.0,5,8,60,60,2,6,8,58.0,874.0,63,2,6,8,61.0,82,5.86,50,250,2620,9.2
16496,MacKenzie Weegar,2021-22,28.0,6,15,64,64,4,11,15,79.0,1086.0,127,6,17,23,140.0,82,5.96,47,239,2579,9.5
16497,MacKenzie Weegar,2022-23,29.0,7,18,45,45,7,11,18,77.0,905.0,172,13,28,41,217.0,70,5.96,42,208,2192,9.5
16498,Mackenzie MacEachern,2021-22,27.0,4,5,29,29,3,2,5,33.0,233.0,29,3,2,5,33.0,82,5.96,47,239,2579,9.5
16499,Mackenzie MacEachern,2022-23,28.0,5,10,51,51,7,3,10,63.0,457.0,80,10,5,15,96.0,70,5.96,42,208,2192,9.5
16500,Madison Bowey,2020-21,25.0,4,12,51,51,0,12,12,47.0,699.0,51,0,12,12,47.0,82,5.86,50,250,2620,9.2
16501,Madison Bowey,2021-22,26.0,5,10,50,50,2,8,10,48.0,763.0,101,2,20,22,95.0,82,5.96,47,239,2579,9.5
16502,Madison Bowey,2022-23,27.0,6,17,53,53,3,14,17,70.0,949.0,154,5,34,39,165.0,70,5.96,42,208,2192,9.5
16503,Magnus Arvedson,2000-01,29.0,4,26,61,61,11,15,26,90.0,,61,11,15,26,90.0,82,5.28,57,380,2242,9.6
16504,Magnus Arvedson,2001-02,30.0,5,47,80,80,21,26,47,136.0,1371.0,141,32,41,73,226.0,82,5.27,57,359,2285,9.4
16505,Magnus Arvedson,2002-03,31.0,6,28,47,47,15,13,28,91.0,849.0,188,47,54,101,317.0,82,5.49,53,331,2294,9.8
16506,Magnus Arvedson,2003-04,32.0,7,33,51,51,17,16,33,79.0,817.0,239,64,70,134,396.0,82,5.51,63,376,2272,9.9
16507,Magnus Arvedson,2004-05,33.0,8,39,74,74,12,27,39,121.0,1312.0,313,76,97,173,517.0,82,5.24,53,338,2262,9.5
16508,Magnus Arvedson,2005-06,34.0,9,37,80,80,16,21,37,138.0,1433.0,393,92,118,210,655.0,82,5.31,60,363,2326,9.4
16509,Magnus Arvedson,2006-07,35.0,10,15,41,41,8,7,15,54.0,594.0,434,100,125,225,709.0,82,5.14,57,348,2300,9.2
16510,Magnus Johansson,2010-11,37.0,4,14,45,45,0,14,14,37.0,709.0,45,0,14,14,37.0,82,5.44,62,351,2383,9.4
16511,Magnus Paajarvi,2013-14,22.0,4,34,80,80,15,19,34,180.0,1231.0,80,15,19,34,180.0,82,5.46,52,291,2492,9.0
16512,Magnus Paajarvi,2014-15,23.0,5,8,41,41,2,6,8,79.0,540.0,121,17,25,42,259.0,82,5.32,47,271,2439,8.9
16513,Magnus Paajarvi,2015-16,24.0,6,16,42,42,9,7,16,75.0,593.0,163,26,32,58,334.0,48,5.31,29,160,1399,9.1
16514,Magnus Paajarvi,2016-17,25.0,7,12,55,55,6,6,12,60.0,564.0,218,32,38,70,394.0,82,5.34,48,269,2463,8.9
16515,Magnus Paajarvi,2017-18,26.0,8,1,10,10,0,1,1,9.0,98.0,228,32,39,71,403.0,82,5.32,47,251,2453,8.9
16516,Magnus Paajarvi,2018-19,27.0,9,9,48,48,3,6,9,88.0,617.0,276,35,45,80,491.0,82,5.34,48,255,2438,9.0
16517,Magnus Paajarvi,2019-20,28.0,10,13,32,32,8,5,13,51.0,389.0,308,43,50,93,542.0,82,5.45,47,245,2478,9.0
16518,Magnus Paajarvi,2020-21,29.0,11,12,79,79,8,4,12,126.0,984.0,387,51,54,105,668.0,82,5.86,50,250,2620,9.2
16519,Magnus Paajarvi,2021-22,30.0,12,19,80,80,11,8,19,119.0,1078.0,467,62,62,124,787.0,82,5.96,47,239,2579,9.5
16520,Magnus Roupe,1990-91,27.0,4,6,33,33,2,4,6,37.0,,33,2,4,6,37.0,80,7.43,89,437,2435,12.2
16521,Magnus Roupe,1991-92,28.0,5,2,7,7,1,1,2,15.0,,40,3,5,8,52.0,80,7.48,85,403,2430,12.3
16522,Magnus Svensson,1997-98,34.0,4,7,19,19,2,5,7,41.0,,19,2,5,7,41.0,48,5.97,37,209,1408,10.2
16523,Magnus Svensson,1998-99,35.0,5,11,27,27,2,9,11,58.0,,46,4,14,18,99.0,82,6.29,74,413,2481,10.4
16524,Maksim Mayorov,2011-12,22.0,4,0,3,3,0,0,0,1.0,17.0,3,0,0,0,1.0,82,5.7,65,341,2477,9.4
16525,Maksim Mayorov,2012-13,23.0,5,0,4,4,0,0,0,4.0,31.0,7,0,0,0,5.0,82,5.53,56,304,2486,9.1
16526,Maksim Mayorov,2013-14,24.0,6,1,5,5,1,0,1,3.0,44.0,12,1,0,1,8.0,82,5.46,52,291,2492,9.0
16527,Maksim Mayorov,2014-15,25.0,7,2,10,10,1,1,2,9.0,107.0,22,2,1,3,17.0,82,5.32,47,271,2439,8.9
16528,Manny Malhotra,2001-02,21.0,4,16,73,73,8,8,16,61.0,628.0,73,8,8,16,61.0,82,5.27,57,359,2285,9.4
16529,Manny Malhotra,2002-03,22.0,5,0,27,27,0,0,0,18.0,181.0,100,8,8,16,79.0,82,5.49,53,331,2294,9.8
16530,Manny Malhotra,2003-04,23.0,6,12,50,50,4,8,12,46.0,453.0,150,12,16,28,125.0,82,5.51,63,376,2272,9.9
16531,Manny Malhotra,2004-05,24.0,7,14,72,72,8,6,14,60.0,743.0,222,20,22,42,185.0,82,5.24,53,338,2262,9.5
16532,Manny Malhotra,2005-06,25.0,8,10,59,59,3,7,10,62.0,552.0,281,23,29,52,247.0,82,5.31,60,363,2326,9.4
16533,Manny Malhotra,2006-07,26.0,9,25,65,65,12,13,25,107.0,898.0,346,35,42,77,354.0,82,5.14,57,348,2300,9.2
16534,Manny Malhotra,2008-09,28.0,10,31,58,58,10,21,31,102.0,949.0,404,45,63,108,456.0,82,6.05,85,480,2458,10.1
16535,Manny Malhotra,2009-10,29.0,11,25,82,82,9,16,25,109.0,1214.0,486,54,79,133,565.0,82,5.76,70,398,2426,9.7
16536,Manny Malhotra,2010-11,30.0,12,29,71,71,11,18,29,112.0,1169.0,557,65,97,162,677.0,82,5.44,62,351,2383,9.4
16537,Manny Malhotra,2011-12,31.0,13,35,77,77,11,24,35,116.0,1387.0,634,76,121,197,793.0,82,5.7,65,341,2477,9.4
16538,Manny Malhotra,2012-13,32.0,14,33,71,71,14,19,33,111.0,1109.0,705,90,140,230,904.0,82,5.53,56,304,2486,9.1
16539,Manny Malhotra,2013-14,33.0,15,30,72,72,11,19,30,111.0,1164.0,777,101,159,260,1015.0,82,5.46,52,291,2492,9.0
16540,Manny Malhotra,2014-15,34.0,16,18,78,78,7,11,18,60.0,963.0,855,108,170,278,1075.0,82,5.32,47,271,2439,8.9
16541,Manny Malhotra,2015-16,35.0,17,0,9,9,0,0,0,2.0,100.0,864,108,170,278,1077.0,48,5.31,29,160,1399,9.1
16542,Manny Malhotra,2016-17,36.0,18,13,69,69,7,6,13,53.0,800.0,933,115,176,291,1130.0,82,5.34,48,269,2463,8.9
16543,Manny Malhotra,2017-18,37.0,19,4,58,58,1,3,4,46.0,629.0,991,116,179,295,1176.0,82,5.32,47,251,2453,8.9
16544,Marc Bergevin,1987-88,22.0,4,6,60,60,0,6,6,41.0,,60,0,6,6,41.0,80,7.77,71,321,2447,12.7
16545,Marc Bergevin,1988-89,23.0,5,14,71,71,7,7,14,50.0,,131,7,13,20,91.0,80,7.94,82,370,2484,12.8
16546,Marc Bergevin,1989-90,24.0,6,14,66,66,4,10,14,55.0,,197,11,23,34,146.0,80,7.34,72,344,2400,12.2
16547,Marc Bergevin,1990-91,25.0,7,7,58,58,1,6,7,51.0,,255,12,29,41,197.0,80,7.43,89,437,2435,12.2
16548,Marc Bergevin,1991-92,26.0,8,15,69,69,2,13,15,65.0,,324,14,42,56,262.0,80,7.48,85,403,2430,12.3
16549,Marc Bergevin,1992-93,27.0,9,4,18,18,0,4,4,12.0,,342,14,46,60,274.0,80,7.37,76,367,2421,12.2
16550,Marc Bergevin,1993-94,28.0,10,0,4,4,0,0,0,2.0,,346,14,46,60,276.0,80,6.91,71,366,2385,11.6
16551,Marc Bergevin,1994-95,29.0,11,24,75,75,7,17,24,96.0,,421,21,63,84,372.0,80,6.96,77,402,2440,11.4
16552,Marc Bergevin,1995-96,30.0,12,14,78,78,2,12,14,69.0,,499,23,75,98,441.0,84,7.25,87,443,2603,11.7
16553,Marc Bergevin,1996-97,31.0,13,16,83,83,1,15,16,76.0,,582,24,90,114,517.0,84,6.48,76,407,2545,10.7
16554,Marc Bergevin,1997-98,32.0,14,6,44,44,2,4,6,32.0,,626,26,94,120,549.0,48,5.97,37,209,1408,10.2
16555,Marc Bergevin,1998-99,33.0,15,10,70,70,1,9,10,26.0,,696,27,103,130,575.0,82,6.29,74,413,2481,10.4
16556,Marc Bergevin,1999-00,34.0,16,4,82,82,0,4,4,30.0,,778,27,107,134,605.0,82,5.83,55,336,2444,9.8
16557,Marc Bergevin,2000-01,35.0,17,10,81,81,3,7,10,40.0,,859,30,114,144,645.0,82,5.28,57,380,2242,9.6
16558,Marc Bergevin,2001-02,36.0,18,2,52,52,1,1,2,40.0,840.0,911,31,115,146,685.0,82,5.27,57,359,2285,9.4
16559,Marc Bergevin,2002-03,37.0,19,9,81,81,1,8,9,54.0,1723.0,992,32,123,155,739.0,82,5.49,53,331,2294,9.8
16560,Marc Bergevin,2003-04,38.0,20,5,38,38,1,4,5,12.0,640.0,1030,33,127,160,751.0,82,5.51,63,376,2272,9.9
16561,Marc Bergevin,2004-05,39.0,21,3,30,30,0,3,3,13.0,368.0,1060,33,130,163,764.0,82,5.24,53,338,2262,9.5
16562,Marc Bergevin,2005-06,40.0,22,7,70,70,2,5,7,27.0,1313.0,1130,35,135,170,791.0,82,5.31,60,363,2326,9.4
16563,Marc Bergevin,2006-07,41.0,23,11,61,61,1,10,11,30.0,978.0,1191,36,145,181,821.0,82,5.14,57,348,2300,9.2
16564,Marc Bureau,1992-93,26.0,4,0,5,5,0,0,0,3.0,,5,0,0,0,3.0,80,7.37,76,367,2421,12.2
16565,Marc Bureau,1993-94,27.0,5,6,14,14,0,6,6,12.0,,19,0,6,6,15.0,80,6.91,71,366,2385,11.6
16566,Marc Bureau,1994-95,28.0,6,10,46,46,6,4,10,53.0,,65,6,10,16,68.0,80,6.96,77,402,2440,11.4
16567,Marc Bureau,1995-96,29.0,7,31,63,63,10,21,31,132.0,,128,16,31,47,200.0,84,7.25,87,443,2603,11.7
16568,Marc Bureau,1996-97,30.0,8,15,75,75,8,7,15,110.0,,203,24,38,62,310.0,84,6.48,76,407,2545,10.7
16569,Marc Bureau,1997-98,31.0,9,14,48,48,2,12,14,72.0,,251,26,50,76,382.0,48,5.97,37,209,1408,10.2
16570,Marc Bureau,1998-99,32.0,10,10,65,65,3,7,10,43.0,,316,29,57,86,425.0,82,6.29,74,413,2481,10.4
16571,Marc Bureau,1999-00,33.0,11,15,43,43,6,9,15,56.0,,359,35,66,101,481.0,82,5.83,55,336,2444,9.8
16572,Marc Bureau,2000-01,34.0,12,19,74,74,13,6,19,82.0,,433,48,72,120,563.0,82,5.28,57,380,2242,9.6
16573,Marc Bureau,2001-02,35.0,13,10,71,71,4,6,10,52.0,783.0,504,52,78,130,615.0,82,5.27,57,359,2285,9.4
16574,Marc Bureau,2002-03,36.0,14,8,63,63,3,5,8,51.0,724.0,567,55,83,138,666.0,82,5.49,53,331,2294,9.8
16575,Marc Chorney,1983-84,24.0,4,7,8,8,1,6,7,3.0,,8,1,6,7,3.0,80,7.69,77,340,2441,12.6
16576,Marc Chorney,1984-85,25.0,5,7,60,60,1,6,7,37.0,,68,2,12,14,40.0,80,8.03,73,320,2489,12.9
16577,Marc Chorney,1985-86,26.0,6,8,67,67,3,5,8,65.0,,135,5,17,22,105.0,80,7.73,71,310,2444,12.7
16578,Marc Chorney,1986-87,27.0,7,13,75,75,3,10,13,62.0,,210,8,27,35,167.0,80,7.89,74,336,2448,12.9
16579,Marc Chouinard,2003-04,26.0,4,7,44,44,3,4,7,26.0,345.0,44,3,4,7,26.0,82,5.51,63,376,2272,9.9
16580,Marc Chouinard,2004-05,27.0,5,9,45,45,4,5,9,40.0,477.0,89,7,9,16,66.0,82,5.24,53,338,2262,9.5
16581,Marc Chouinard,2005-06,28.0,6,7,70,70,3,4,7,52.0,659.0,159,10,13,23,118.0,82,5.31,60,363,2326,9.4
16582,Marc Chouinard,2006-07,29.0,7,21,45,45,11,10,21,70.0,719.0,204,21,23,44,188.0,82,5.14,57,348,2300,9.2
16583,Marc Chouinard,2008-09,31.0,8,30,74,74,14,16,30,112.0,1220.0,278,35,39,74,300.0,82,6.05,85,480,2458,10.1
16584,Marc Chouinard,2009-10,32.0,9,4,42,42,2,2,4,15.0,396.0,320,37,41,78,315.0,82,5.76,70,398,2426,9.7
16585,Marc Crawford,1984-85,23.0,4,12,40,40,4,8,12,57.0,,40,4,8,12,57.0,80,8.03,73,320,2489,12.9
16586,Marc Crawford,1985-86,24.0,5,9,41,41,4,5,9,34.0,,81,8,13,21,91.0,80,7.73,71,310,2444,12.7
16587,Marc Crawford,1986-87,25.0,6,1,19,19,0,1,1,12.0,,100,8,14,22,103.0,80,7.89,74,336,2448,12.9
16588,Marc Crawford,1987-88,26.0,7,0,1,1,0,0,0,0.0,,101,8,14,22,103.0,80,7.77,71,321,2447,12.7
16589,Marc Crawford,1988-89,27.0,8,25,54,54,11,14,25,80.0,,155,19,28,47,183.0,80,7.94,82,370,2484,12.8
16590,Marc Crawford,1989-90,28.0,9,3,21,21,0,3,3,19.0,,176,19,31,50,202.0,80,7.34,72,344,2400,12.2
16591,Marc Fortier,1990-91,24.0,4,14,27,27,4,10,14,40.0,,27,4,10,14,40.0,80,7.43,89,437,2435,12.2
16592,Marc Fortier,1991-92,25.0,5,39,57,57,20,19,39,90.0,,84,24,29,53,130.0,80,7.48,85,403,2430,12.3
16593,Marc Fortier,1992-93,26.0,6,30,59,59,13,17,30,89.0,,143,37,46,83,219.0,80,7.37,76,367,2421,12.2
16594,Marc Fortier,1993-94,27.0,7,4,14,14,0,4,4,13.0,,157,37,50,87,232.0,80,6.91,71,366,2385,11.6
16595,Marc Fortier,1994-95,28.0,8,14,39,39,5,9,14,42.0,,196,42,59,101,274.0,80,6.96,77,402,2440,11.4
16596,Marc Fortier,1995-96,29.0,9,1,16,16,0,1,1,14.0,,212,42,60,102,288.0,84,7.25,87,443,2603,11.7
16597,Marc Habscheid,1984-85,21.0,4,4,7,7,1,3,4,7.0,,7,1,3,4,7.0,80,8.03,73,320,2489,12.9
16598,Marc Habscheid,1985-86,22.0,5,13,32,32,3,10,13,19.0,,39,4,13,17,26.0,80,7.73,71,310,2444,12.7
16599,Marc Habscheid,1986-87,23.0,6,1,9,9,1,0,1,6.0,,48,5,13,18,32.0,80,7.89,74,336,2448,12.9
16600,Marc Habscheid,1987-88,24.0,7,8,26,26,5,3,8,30.0,,74,10,16,26,62.0,80,7.77,71,321,2447,12.7
16601,Marc Habscheid,1988-89,25.0,8,5,6,6,2,3,5,8.0,,80,12,19,31,70.0,80,7.94,82,370,2484,12.8
16602,Marc Habscheid,1989-90,26.0,9,2,15,15,2,0,2,14.0,,95,14,19,33,84.0,80,7.34,72,344,2400,12.2
16603,Marc Habscheid,1990-91,27.0,10,15,16,16,4,11,15,44.0,,111,18,30,48,128.0,80,7.43,89,437,2435,12.2
16604,Marc Habscheid,1991-92,28.0,11,54,76,76,23,31,54,182.0,,187,41,61,102,310.0,80,7.48,85,403,2430,12.3
16605,Marc Habscheid,1992-93,29.0,12,26,66,66,15,11,26,114.0,,253,56,72,128,424.0,80,7.37,76,367,2421,12.2
16606,Marc Habscheid,1993-94,30.0,13,17,46,46,9,8,17,54.0,,299,65,80,145,478.0,80,6.91,71,366,2385,11.6
16607,Marc Habscheid,1994-95,31.0,14,18,46,46,7,11,18,60.0,,345,72,91,163,538.0,80,6.96,77,402,2440,11.4
16608,Marc Labelle,1999-00,30.0,4,0,9,9,0,0,0,2.0,,9,0,0,0,2.0,82,5.83,55,336,2444,9.8
16609,Marc Laforge,1992-93,25.0,4,0,9,9,0,0,0,0.0,,9,0,0,0,0.0,80,7.37,76,367,2421,12.2
16610,Marc Laforge,1996-97,29.0,5,0,5,5,0,0,0,0.0,,14,0,0,0,0.0,84,6.48,76,407,2545,10.7
16611,Marc Magnan,1985-86,23.0,4,1,4,4,0,1,1,1.0,,4,0,1,1,1.0,80,7.73,71,310,2444,12.7
16612,Marc Methot,2009-10,24.0,4,4,20,20,0,4,4,11.0,293.0,20,0,4,4,11.0,82,5.76,70,398,2426,9.7
16613,Marc Methot,2010-11,25.0,5,0,9,9,0,0,0,9.0,128.0,29,0,4,4,20.0,82,5.44,62,351,2383,9.4
16614,Marc Methot,2011-12,26.0,6,17,66,66,4,13,17,58.0,1185.0,95,4,17,21,78.0,82,5.7,65,341,2477,9.4
16615,Marc Methot,2012-13,27.0,7,8,60,60,2,6,8,42.0,1171.0,155,6,23,29,120.0,82,5.53,56,304,2486,9.1
16616,Marc Methot,2013-14,28.0,8,15,74,74,0,15,15,58.0,1472.0,229,6,38,44,178.0,82,5.46,52,291,2492,9.0
16617,Marc Methot,2014-15,29.0,9,7,46,46,1,6,7,42.0,922.0,275,7,44,51,220.0,82,5.32,47,271,2439,8.9
16618,Marc Methot,2015-16,30.0,10,11,47,47,2,9,11,53.0,1045.0,322,9,53,62,273.0,48,5.31,29,160,1399,9.1
16619,Marc Methot,2016-17,31.0,11,23,75,75,6,17,23,117.0,1632.0,397,15,70,85,390.0,82,5.34,48,269,2463,8.9
16620,Marc Methot,2017-18,32.0,12,11,45,45,1,10,11,49.0,1020.0,442,16,80,96,439.0,82,5.32,47,251,2453,8.9
16621,Marc Methot,2018-19,33.0,13,12,69,69,5,7,12,74.0,1425.0,511,21,87,108,513.0,82,5.34,48,255,2438,9.0
16622,Marc Methot,2019-20,34.0,14,12,68,68,0,12,12,69.0,1348.0,579,21,99,120,582.0,82,5.45,47,245,2478,9.0
16623,Marc Methot,2020-21,35.0,15,3,36,36,1,2,3,25.0,644.0,615,22,101,123,607.0,82,5.86,50,250,2620,9.2
16624,Marc Methot,2021-22,36.0,16,0,9,9,0,0,0,3.0,152.0,624,22,101,123,610.0,82,5.96,47,239,2579,9.5
16625,Marc Moro,2000-01,23.0,4,0,1,1,0,0,0,0.0,,1,0,0,0,0.0,82,5.28,57,380,2242,9.6
16626,Marc Moro,2002-03,25.0,5,0,8,8,0,0,0,3.0,87.0,9,0,0,0,3.0,82,5.49,53,331,2294,9.8
16627,Marc Moro,2003-04,26.0,6,0,6,6,0,0,0,1.0,21.0,15,0,0,0,4.0,82,5.51,63,376,2272,9.9
16628,Marc Moro,2004-05,27.0,7,0,15,15,0,0,0,7.0,179.0,30,0,0,0,11.0,82,5.24,53,338,2262,9.5
16629,Marc Potvin,1993-94,27.0,4,0,9,9,0,0,0,13.0,,9,0,0,0,13.0,80,6.91,71,366,2385,11.6
16630,Marc Potvin,1994-95,28.0,5,1,5,5,1,0,1,4.0,,14,1,0,1,17.0,80,6.96,77,402,2440,11.4
16631,Marc Potvin,1995-96,29.0,6,1,20,20,0,1,1,7.0,,34,1,1,2,24.0,84,7.25,87,443,2603,11.7
16632,Marc Potvin,1996-97,30.0,7,5,54,54,2,3,5,26.0,,88,3,4,7,50.0,84,6.48,76,407,2545,10.7
16633,Marc Potvin,1997-98,31.0,8,1,6,6,0,1,1,4.0,,94,3,5,8,54.0,48,5.97,37,209,1408,10.2
16634,Marc Potvin,1998-99,32.0,9,0,27,27,0,0,0,14.0,,121,3,5,8,68.0,82,6.29,74,413,2481,10.4
16635,Marc Pouliot,2008-09,23.0,4,1,8,8,1,0,1,5.0,68.0,8,1,0,1,5.0,82,6.05,85,480,2458,10.1
16636,Marc Pouliot,2009-10,24.0,5,11,46,46,4,7,11,73.0,600.0,54,5,7,12,78.0,82,5.76,70,398,2426,9.7
16637,Marc Pouliot,2010-11,25.0,6,7,24,24,1,6,7,32.0,248.0,78,6,13,19,110.0,82,5.44,62,351,2383,9.4
16638,Marc Pouliot,2011-12,26.0,7,20,63,63,8,12,20,94.0,725.0,141,14,25,39,204.0,82,5.7,65,341,2477,9.4
16639,Marc Pouliot,2012-13,27.0,8,14,35,35,7,7,14,60.0,448.0,176,21,32,53,264.0,82,5.53,56,304,2486,9.1
16640,Marc Pouliot,2013-14,28.0,9,0,3,3,0,0,0,2.0,32.0,179,21,32,53,266.0,82,5.46,52,291,2492,9.0
16641,Marc Pouliot,2014-15,29.0,10,4,13,13,0,4,4,19.0,145.0,192,21,36,57,285.0,82,5.32,47,271,2439,8.9
16642,Marc Rodgers,2002-03,30.0,4,2,21,21,1,1,2,17.0,166.0,21,1,1,2,17.0,82,5.49,53,331,2294,9.8
16643,Marc Savard,2000-01,23.0,4,6,28,28,1,5,6,32.0,,28,1,5,6,32.0,82,5.28,57,380,2242,9.6
16644,Marc Savard,2001-02,24.0,5,45,70,70,9,36,45,116.0,1021.0,98,10,41,51,148.0,82,5.27,57,359,2285,9.4
16645,Marc Savard,2002-03,25.0,6,53,78,78,22,31,53,184.0,1294.0,176,32,72,104,332.0,82,5.49,53,331,2294,9.8
16646,Marc Savard,2003-04,26.0,7,65,77,77,23,42,65,197.0,1480.0,253,55,114,169,529.0,82,5.51,63,376,2272,9.9
16647,Marc Savard,2004-05,27.0,8,33,56,56,14,19,33,140.0,970.0,309,69,133,202,669.0,82,5.24,53,338,2262,9.5
16648,Marc Savard,2005-06,28.0,9,50,67,67,17,33,50,148.0,1277.0,376,86,166,252,817.0,82,5.31,60,363,2326,9.4
16649,Marc Savard,2006-07,29.0,10,52,45,45,19,33,52,133.0,1004.0,421,105,199,304,950.0,82,5.14,57,348,2300,9.2
16650,Marc Savard,2008-09,31.0,11,97,82,82,28,69,97,212.0,1682.0,503,133,268,401,1162.0,82,6.05,85,480,2458,10.1
16651,Marc Savard,2009-10,32.0,12,96,82,82,22,74,96,221.0,1658.0,585,155,342,497,1383.0,82,5.76,70,398,2426,9.7
16652,Marc Savard,2010-11,33.0,13,78,74,74,15,63,78,196.0,1519.0,659,170,405,575,1579.0,82,5.44,62,351,2383,9.4
16653,Marc Savard,2011-12,34.0,14,88,82,82,25,63,88,213.0,1602.0,741,195,468,663,1792.0,82,5.7,65,341,2477,9.4
16654,Marc Savard,2012-13,35.0,15,33,41,41,10,23,33,90.0,762.0,782,205,491,696,1882.0,82,5.53,56,304,2486,9.1
16655,Marc Savard,2013-14,36.0,16,10,25,25,2,8,10,50.0,395.0,807,207,499,706,1932.0,82,5.46,52,291,2492,9.0
16656,Marc Staal,2010-11,24.0,4,10,80,80,2,8,10,78.0,1504.0,80,2,8,10,78.0,82,5.44,62,351,2383,9.4
16657,Marc Staal,2011-12,25.0,5,15,82,82,3,12,15,96.0,1733.0,162,5,20,25,174.0,82,5.7,65,341,2477,9.4
16658,Marc Staal,2012-13,26.0,6,27,82,82,8,19,27,78.0,1897.0,244,13,39,52,252.0,82,5.53,56,304,2486,9.1
16659,Marc Staal,2013-14,27.0,7,29,77,77,7,22,29,116.0,1982.0,321,20,61,81,368.0,82,5.46,52,291,2492,9.0
16660,Marc Staal,2014-15,28.0,8,5,46,46,2,3,5,61.0,915.0,367,22,64,86,429.0,82,5.32,47,271,2439,8.9
16661,Marc Staal,2015-16,29.0,9,11,21,21,2,9,11,20.0,513.0,388,24,73,97,449.0,48,5.31,29,160,1399,9.1
16662,Marc Staal,2016-17,30.0,10,14,72,72,3,11,14,92.0,1477.0,460,27,84,111,541.0,82,5.34,48,269,2463,8.9
16663,Marc Staal,2017-18,31.0,11,20,80,80,5,15,20,97.0,1691.0,540,32,99,131,638.0,82,5.32,47,251,2453,8.9
16664,Marc Staal,2018-19,32.0,12,15,77,77,2,13,15,65.0,1515.0,617,34,112,146,703.0,82,5.34,48,255,2438,9.0
16665,Marc Staal,2019-20,33.0,13,10,72,72,3,7,10,70.0,1381.0,689,37,119,156,773.0,82,5.45,47,245,2478,9.0
16666,Marc Staal,2020-21,34.0,14,8,72,72,1,7,8,68.0,1334.0,761,38,126,164,841.0,82,5.86,50,250,2620,9.2
16667,Marc Staal,2021-22,35.0,15,13,79,79,3,10,13,84.0,1534.0,840,41,136,177,925.0,82,5.96,47,239,2579,9.5
16668,Marc Staal,2022-23,36.0,16,11,52,52,2,9,11,46.0,917.0,892,43,145,188,971.0,70,5.96,42,208,2192,9.5
16669,Marc-Andre Bergeron,2005-06,25.0,4,2,5,5,1,1,2,5.0,83.0,5,1,1,2,5.0,82,5.31,60,363,2326,9.4
16670,Marc-Andre Bergeron,2006-07,26.0,5,26,54,54,9,17,26,105.0,953.0,59,10,18,28,110.0,82,5.14,57,348,2300,9.2
16671,Marc-Andre Bergeron,2008-09,28.0,6,35,75,75,15,20,35,144.0,1592.0,134,25,38,63,254.0,82,6.05,85,480,2458,10.1
16672,Marc-Andre Bergeron,2009-10,29.0,7,46,78,78,14,32,46,166.0,1491.0,212,39,70,109,420.0,82,5.76,70,398,2426,9.7
16673,Marc-Andre Bergeron,2010-11,30.0,8,19,55,55,9,10,19,108.0,957.0,267,48,80,128,528.0,82,5.44,62,351,2383,9.4
16674,Marc-Andre Bergeron,2011-12,31.0,9,32,72,72,14,18,32,140.0,1217.0,339,62,98,160,668.0,82,5.7,65,341,2477,9.4
16675,Marc-Andre Bergeron,2012-13,32.0,10,34,60,60,13,21,34,123.0,904.0,399,75,119,194,791.0,82,5.53,56,304,2486,9.1
16676,Marc-Andre Bergeron,2013-14,33.0,11,8,23,23,2,6,8,37.0,329.0,422,77,125,202,828.0,82,5.46,52,291,2492,9.0
16677,Marc-Andre Bergeron,2014-15,34.0,12,24,43,43,4,20,24,80.0,832.0,465,81,145,226,908.0,82,5.32,47,271,2439,8.9
16678,Marc-Andre Bergeron,2015-16,35.0,13,9,25,25,1,8,9,43.0,344.0,490,82,153,235,951.0,48,5.31,29,160,1399,9.1
16679,Marc-Andre Bourdon,2014-15,25.0,4,7,45,45,4,3,7,45.0,729.0,45,4,3,7,45.0,82,5.32,47,271,2439,8.9
16680,Marc-Andre Cliche,2012-13,25.0,4,0,1,1,0,0,0,0.0,7.0,1,0,0,0,0.0,82,5.53,56,304,2486,9.1
16681,Marc-Andre Cliche,2016-17,29.0,5,7,76,76,1,6,7,69.0,803.0,77,1,6,7,69.0,82,5.34,48,269,2463,8.9
16682,Marc-Andre Cliche,2017-18,30.0,6,7,74,74,2,5,7,68.0,785.0,151,3,11,14,137.0,82,5.32,47,251,2453,8.9
16683,Marc-Andre Gragnani,2010-11,23.0,4,0,2,2,0,0,0,1.0,13.0,2,0,0,0,1.0,82,5.44,62,351,2383,9.4
16684,Marc-Andre Gragnani,2011-12,24.0,5,0,4,4,0,0,0,3.0,62.0,6,0,0,0,4.0,82,5.7,65,341,2477,9.4
16685,Marc-Andre Gragnani,2013-14,26.0,6,3,9,9,1,2,3,11.0,138.0,15,1,2,3,15.0,82,5.46,52,291,2492,9.0
16686,Marc-Andre Gragnani,2014-15,27.0,7,15,58,58,2,13,15,47.0,936.0,73,3,15,18,62.0,82,5.32,47,271,2439,8.9
16687,Marc-Andre Gragnani,2015-16,28.0,8,0,1,1,0,0,0,0.0,8.0,74,3,15,18,62.0,48,5.31,29,160,1399,9.1
16688,Marc-Andre Gragnani,2018-19,31.0,9,0,4,4,0,0,0,0.0,57.0,78,3,15,18,62.0,82,5.34,48,255,2438,9.0
16689,Marc-Edouard Vlasic,2009-10,22.0,4,26,81,81,3,23,26,66.0,1798.0,81,3,23,26,66.0,82,5.76,70,398,2426,9.7
16690,Marc-Edouard Vlasic,2010-11,23.0,5,14,82,82,2,12,14,72.0,1772.0,163,5,35,40,138.0,82,5.44,62,351,2383,9.4
16691,Marc-Edouard Vlasic,2011-12,24.0,6,36,82,82,6,30,36,104.0,1960.0,245,11,65,76,242.0,82,5.7,65,341,2477,9.4
16692,Marc-Edouard Vlasic,2012-13,25.0,7,16,64,64,3,13,16,74.0,1414.0,309,14,78,92,316.0,82,5.53,56,304,2486,9.1
16693,Marc-Edouard Vlasic,2013-14,26.0,8,18,80,80,4,14,18,116.0,1669.0,389,18,92,110,432.0,82,5.46,52,291,2492,9.0
16694,Marc-Edouard Vlasic,2014-15,27.0,9,23,82,82,4,19,23,119.0,1899.0,471,22,111,133,551.0,82,5.32,47,271,2439,8.9
16695,Marc-Edouard Vlasic,2015-16,28.0,10,7,48,48,3,4,7,59.0,1000.0,519,25,115,140,610.0,48,5.31,29,160,1399,9.1
16696,Marc-Edouard Vlasic,2016-17,29.0,11,24,81,81,5,19,24,138.0,1678.0,600,30,134,164,748.0,82,5.34,48,269,2463,8.9
16697,Marc-Edouard Vlasic,2017-18,30.0,12,23,70,70,9,14,23,98.0,1548.0,670,39,148,187,846.0,82,5.32,47,251,2453,8.9
16698,Marc-Edouard Vlasic,2018-19,31.0,13,39,67,67,8,31,39,116.0,1550.0,737,47,179,226,962.0,82,5.34,48,255,2438,9.0
16699,Marc-Edouard Vlasic,2019-20,32.0,14,28,75,75,6,22,28,144.0,1593.0,812,53,201,254,1106.0,82,5.45,47,245,2478,9.0
16700,Marc-Edouard Vlasic,2020-21,33.0,15,32,81,81,11,21,32,161.0,1826.0,893,64,222,286,1267.0,82,5.86,50,250,2620,9.2
16701,Marc-Edouard Vlasic,2021-22,34.0,16,25,72,72,3,22,25,100.0,1515.0,965,67,244,311,1367.0,82,5.96,47,239,2579,9.5
16702,Marc-Edouard Vlasic,2022-23,35.0,17,15,70,70,5,10,15,74.0,1421.0,1035,72,254,326,1441.0,70,5.96,42,208,2192,9.5
16703,Marcel Goc,2008-09,25.0,4,22,81,81,8,14,22,96.0,948.0,81,8,14,22,96.0,82,6.05,85,480,2458,10.1
16704,Marcel Goc,2009-10,26.0,5,13,78,78,5,8,13,96.0,937.0,159,13,22,35,192.0,82,5.76,70,398,2426,9.7
16705,Marcel Goc,2010-11,27.0,6,8,51,51,5,3,8,87.0,545.0,210,18,25,43,279.0,82,5.44,62,351,2383,9.4
16706,Marcel Goc,2011-12,28.0,7,11,55,55,2,9,11,104.0,765.0,265,20,34,54,383.0,82,5.7,65,341,2477,9.4
16707,Marcel Goc,2012-13,29.0,8,30,73,73,12,18,30,118.0,1072.0,338,32,52,84,501.0,82,5.53,56,304,2486,9.1
16708,Marcel Goc,2013-14,30.0,9,24,51,51,9,15,24,111.0,818.0,389,41,67,108,612.0,82,5.46,52,291,2492,9.0
16709,Marcel Goc,2014-15,31.0,10,27,57,57,11,16,27,97.0,1004.0,446,52,83,135,709.0,82,5.32,47,271,2439,8.9
16710,Marcel Goc,2015-16,32.0,11,19,42,42,9,10,19,92.0,767.0,488,61,93,154,801.0,48,5.31,29,160,1399,9.1
16711,Marcel Goc,2016-17,33.0,12,25,74,74,11,14,25,117.0,1208.0,562,72,107,179,918.0,82,5.34,48,269,2463,8.9
16712,Marcel Goc,2017-18,34.0,13,9,74,74,3,6,9,77.0,864.0,636,75,113,188,995.0,82,5.32,47,251,2453,8.9
16713,Marcel Hossa,2004-05,23.0,4,4,10,10,3,1,4,20.0,111.0,10,3,1,4,20.0,82,5.24,53,338,2262,9.5
16714,Marcel Hossa,2005-06,24.0,5,13,34,34,6,7,13,51.0,475.0,44,9,8,17,71.0,82,5.31,60,363,2326,9.4
16715,Marcel Hossa,2006-07,25.0,6,2,15,15,1,1,2,19.0,223.0,59,10,9,19,90.0,82,5.14,57,348,2300,9.2
16716,Marcel Hossa,2008-09,27.0,7,16,64,64,10,6,16,105.0,688.0,123,20,15,35,195.0,82,6.05,85,480,2458,10.1
16717,Marcel Hossa,2009-10,28.0,8,18,64,64,10,8,18,83.0,797.0,187,30,23,53,278.0,82,5.76,70,398,2426,9.7
16718,Marcel Hossa,2010-11,29.0,9,8,50,50,1,7,8,66.0,689.0,237,31,30,61,344.0,82,5.44,62,351,2383,9.4
16719,Marcel Mueller,2013-14,25.0,4,0,3,3,0,0,0,5.0,30.0,3,0,0,0,5.0,82,5.46,52,291,2492,9.0
16720,Marco Scandella,2013-14,23.0,4,2,20,20,0,2,2,13.0,299.0,20,0,2,2,13.0,82,5.46,52,291,2492,9.0
16721,Marco Scandella,2014-15,24.0,5,12,63,63,3,9,12,77.0,1372.0,83,3,11,14,90.0,82,5.32,47,271,2439,8.9
16722,Marco Scandella,2015-16,25.0,6,1,6,6,1,0,1,7.0,87.0,89,4,11,15,97.0,48,5.31,29,160,1399,9.1
16723,Marco Scandella,2016-17,26.0,7,17,76,76,3,14,17,80.0,1430.0,165,7,25,32,177.0,82,5.34,48,269,2463,8.9
16724,Marco Scandella,2017-18,27.0,8,23,64,64,11,12,23,112.0,1390.0,229,18,37,55,289.0,82,5.32,47,251,2453,8.9
16725,Marco Scandella,2018-19,28.0,9,21,73,73,5,16,21,126.0,1511.0,302,23,53,76,415.0,82,5.34,48,255,2438,9.0
16726,Marco Scandella,2019-20,29.0,10,13,71,71,4,9,13,88.0,1302.0,373,27,62,89,503.0,82,5.45,47,245,2478,9.0
16727,Marco Scandella,2020-21,30.0,11,22,82,82,5,17,22,138.0,1912.0,455,32,79,111,641.0,82,5.86,50,250,2620,9.2
16728,Marco Scandella,2021-22,31.0,12,13,63,63,6,7,13,83.0,1109.0,518,38,86,124,724.0,82,5.96,47,239,2579,9.5
16729,Marco Scandella,2022-23,32.0,13,13,62,62,4,9,13,77.0,1090.0,580,42,95,137,801.0,70,5.96,42,208,2192,9.5
16730,Marco Sturm,2000-01,22.0,4,30,74,74,10,20,30,118.0,,74,10,20,30,118.0,82,5.28,57,380,2242,9.6
16731,Marco Sturm,2001-02,23.0,5,38,78,78,16,22,38,140.0,1200.0,152,26,42,68,258.0,82,5.27,57,359,2285,9.4
16732,Marco Sturm,2002-03,24.0,6,27,74,74,12,15,27,120.0,1044.0,226,38,57,95,378.0,82,5.49,53,331,2294,9.8
16733,Marco Sturm,2003-04,25.0,7,32,81,81,14,18,32,153.0,1304.0,307,52,75,127,531.0,82,5.51,63,376,2272,9.9
16734,Marco Sturm,2004-05,26.0,8,41,77,77,21,20,41,174.0,1205.0,384,73,95,168,705.0,82,5.24,53,338,2262,9.5
16735,Marco Sturm,2005-06,27.0,9,48,82,82,28,20,48,208.0,1354.0,466,101,115,216,913.0,82,5.31,60,363,2326,9.4
16736,Marco Sturm,2006-07,28.0,10,41,64,64,21,20,41,158.0,1050.0,530,122,135,257,1071.0,82,5.14,57,348,2300,9.2
16737,Marco Sturm,2008-09,30.0,11,59,74,74,29,30,59,180.0,1357.0,604,151,165,316,1251.0,82,6.05,85,480,2458,10.1
16738,Marco Sturm,2009-10,31.0,12,44,76,76,27,17,44,224.0,1413.0,680,178,182,360,1475.0,82,5.76,70,398,2426,9.7
16739,Marco Sturm,2010-11,32.0,13,56,80,80,27,29,56,229.0,1440.0,760,205,211,416,1704.0,82,5.44,62,351,2383,9.4
16740,Marco Sturm,2011-12,33.0,14,13,19,19,7,6,13,45.0,304.0,779,212,217,429,1749.0,82,5.7,65,341,2477,9.4
16741,Marco Sturm,2012-13,34.0,15,37,76,76,22,15,37,203.0,1275.0,855,234,232,466,1952.0,82,5.53,56,304,2486,9.1
16742,Marco Sturm,2013-14,35.0,16,16,35,35,5,11,16,57.0,498.0,890,239,243,482,2009.0,82,5.46,52,291,2492,9.0
16743,Marco Sturm,2014-15,36.0,17,5,48,48,3,2,5,65.0,591.0,938,242,245,487,2074.0,82,5.32,47,271,2439,8.9
16744,Marcus Foligno,2014-15,23.0,4,13,14,14,6,7,13,23.0,221.0,14,6,7,13,23.0,82,5.32,47,271,2439,8.9
16745,Marcus Foligno,2015-16,24.0,5,18,47,47,5,13,18,55.0,640.0,61,11,20,31,78.0,48,5.31,29,160,1399,9.1
16746,Marcus Foligno,2016-17,25.0,6,19,74,74,7,12,19,79.0,1115.0,135,18,32,50,157.0,82,5.34,48,269,2463,8.9
16747,Marcus Foligno,2017-18,26.0,7,20,57,57,8,12,20,66.0,925.0,192,26,44,70,223.0,82,5.32,47,251,2453,8.9
16748,Marcus Foligno,2018-19,27.0,8,23,75,75,10,13,23,81.0,989.0,267,36,57,93,304.0,82,5.34,48,255,2438,9.0
16749,Marcus Foligno,2019-20,28.0,9,23,80,80,13,10,23,97.0,1238.0,347,49,67,116,401.0,82,5.45,47,245,2478,9.0
16750,Marcus Foligno,2020-21,29.0,10,23,77,77,8,15,23,79.0,836.0,424,57,82,139,480.0,82,5.86,50,250,2620,9.2
16751,Marcus Foligno,2021-22,30.0,11,19,82,82,7,12,19,91.0,982.0,506,64,94,158,571.0,82,5.96,47,239,2579,9.5
16752,Marcus Foligno,2022-23,31.0,12,25,59,59,11,14,25,86.0,861.0,565,75,108,183,657.0,70,5.96,42,208,2192,9.5
16753,Marcus Johansson,2013-14,23.0,4,27,69,69,13,14,27,102.0,1016.0,69,13,14,27,102.0,82,5.46,52,291,2492,9.0
16754,Marcus Johansson,2014-15,24.0,5,46,80,80,14,32,46,90.0,1344.0,149,27,46,73,192.0,82,5.32,47,271,2439,8.9
16755,Marcus Johansson,2015-16,25.0,6,22,34,34,6,16,22,40.0,564.0,183,33,62,95,232.0,48,5.31,29,160,1399,9.1
16756,Marcus Johansson,2016-17,26.0,7,44,80,80,8,36,44,107.0,1403.0,263,41,98,139,339.0,82,5.34,48,269,2463,8.9
16757,Marcus Johansson,2017-18,27.0,8,47,82,82,20,27,47,138.0,1351.0,345,61,125,186,477.0,82,5.32,47,251,2453,8.9
16758,Marcus Johansson,2018-19,28.0,9,46,74,74,17,29,46,132.0,1231.0,419,78,154,232,609.0,82,5.34,48,255,2438,9.0
16759,Marcus Johansson,2019-20,29.0,10,58,82,82,24,34,58,129.0,1394.0,501,102,188,290,738.0,82,5.45,47,245,2478,9.0
16760,Marcus Johansson,2020-21,30.0,11,14,29,29,5,9,14,42.0,464.0,530,107,197,304,780.0,82,5.86,50,250,2620,9.2
16761,Marcus Johansson,2021-22,31.0,12,30,58,58,13,17,30,115.0,924.0,588,120,214,334,895.0,82,5.96,47,239,2579,9.5
16762,Marcus Johansson,2022-23,32.0,13,30,60,60,9,21,30,87.0,1029.0,648,129,235,364,982.0,70,5.96,42,208,2192,9.5
16763,Marcus Kruger,2013-14,23.0,4,0,7,7,0,0,0,7.0,84.0,7,0,0,0,7.0,82,5.46,52,291,2492,9.0
16764,Marcus Kruger,2014-15,24.0,5,26,71,71,9,17,26,89.0,1093.0,78,9,17,26,96.0,82,5.32,47,271,2439,8.9
16765,Marcus Kruger,2015-16,25.0,6,13,47,47,4,9,13,50.0,666.0,125,13,26,39,146.0,48,5.31,29,160,1399,9.1
16766,Marcus Kruger,2016-17,26.0,7,28,81,81,8,20,28,96.0,1124.0,206,21,46,67,242.0,82,5.34,48,269,2463,8.9
16767,Marcus Kruger,2017-18,27.0,8,17,81,81,7,10,17,126.0,1060.0,287,28,56,84,368.0,82,5.32,47,251,2453,8.9
16768,Marcus Kruger,2018-19,28.0,9,4,41,41,0,4,4,50.0,554.0,328,28,60,88,418.0,82,5.34,48,255,2438,9.0
16769,Marcus Kruger,2019-20,29.0,10,17,70,70,5,12,17,83.0,981.0,398,33,72,105,501.0,82,5.45,47,245,2478,9.0
16770,Marcus Kruger,2020-21,30.0,11,6,48,48,1,5,6,30.0,520.0,446,34,77,111,531.0,82,5.86,50,250,2620,9.2
16771,Marcus Kruger,2021-22,31.0,12,12,74,74,4,8,12,74.0,771.0,520,38,85,123,605.0,82,5.96,47,239,2579,9.5
16772,Marcus Nilson,2001-02,23.0,4,2,8,8,1,1,2,7.0,99.0,8,1,1,2,7.0,82,5.27,57,359,2285,9.4
16773,Marcus Nilson,2002-03,24.0,5,2,9,9,0,2,2,6.0,71.0,17,1,3,4,13.0,82,5.49,53,331,2294,9.8
16774,Marcus Nilson,2003-04,25.0,6,36,78,78,12,24,36,141.0,1230.0,95,13,27,40,154.0,82,5.51,63,376,2272,9.9
16775,Marcus Nilson,2004-05,26.0,7,33,81,81,14,19,33,147.0,1338.0,176,27,46,73,301.0,82,5.24,53,338,2262,9.5
16776,Marcus Nilson,2005-06,27.0,8,34,82,82,15,19,34,187.0,1273.0,258,42,65,107,488.0,82,5.31,60,363,2326,9.4
16777,Marcus Nilson,2006-07,28.0,9,24,83,83,11,13,24,133.0,1304.0,341,53,78,131,621.0,82,5.14,57,348,2300,9.2
16778,Marcus Nilson,2008-09,30.0,10,17,70,70,6,11,17,83.0,1038.0,411,59,89,148,704.0,82,6.05,85,480,2458,10.1
16779,Marcus Nilson,2009-10,31.0,11,15,63,63,5,10,15,69.0,826.0,474,64,99,163,773.0,82,5.76,70,398,2426,9.7
16780,Marcus Nilson,2010-11,32.0,12,5,47,47,3,2,5,47.0,461.0,521,67,101,168,820.0,82,5.44,62,351,2383,9.4
16781,Marcus Pettersson,2020-21,24.0,4,4,22,22,1,3,4,16.0,299.0,22,1,3,4,16.0,82,5.86,50,250,2620,9.2
16782,Marcus Pettersson,2021-22,25.0,5,25,84,84,2,23,25,87.0,1401.0,106,3,26,29,103.0,82,5.96,47,239,2579,9.5
16783,Marcus Pettersson,2022-23,26.0,6,22,69,69,2,20,22,79.0,1339.0,175,5,46,51,182.0,70,5.96,42,208,2192,9.5
16784,Marcus Ragnarsson,1998-99,27.0,4,39,71,71,8,31,39,94.0,,71,8,31,39,94.0,82,6.29,74,413,2481,10.4
16785,Marcus Ragnarsson,1999-00,28.0,5,17,69,69,3,14,17,57.0,,140,11,45,56,151.0,82,5.83,55,336,2444,9.8
16786,Marcus Ragnarsson,2000-01,29.0,6,25,79,79,5,20,25,91.0,,219,16,65,81,242.0,82,5.28,57,380,2242,9.6
16787,Marcus Ragnarsson,2001-02,30.0,7,13,74,74,0,13,13,87.0,1622.0,293,16,78,94,329.0,82,5.27,57,359,2285,9.4
16788,Marcus Ragnarsson,2002-03,31.0,8,16,63,63,3,13,16,60.0,1440.0,356,19,91,110,389.0,82,5.49,53,331,2294,9.8
16789,Marcus Ragnarsson,2003-04,32.0,9,15,68,68,3,12,15,74.0,1605.0,424,22,103,125,463.0,82,5.51,63,376,2272,9.9
16790,Marcus Ragnarsson,2004-05,33.0,10,20,70,70,5,15,20,68.0,1583.0,494,27,118,145,531.0,82,5.24,53,338,2262,9.5
16791,Marcus Ragnarsson,2005-06,34.0,11,16,68,68,3,13,16,79.0,1533.0,562,30,131,161,610.0,82,5.31,60,363,2326,9.4
16792,Marcus Ragnarsson,2006-07,35.0,12,16,70,70,7,9,16,82.0,1464.0,632,37,140,177,692.0,82,5.14,57,348,2300,9.2
16793,Marcus Sorensen,2019-20,27.0,4,4,19,19,1,3,4,27.0,205.0,19,1,3,4,27.0,82,5.45,47,245,2478,9.0
16794,Marcus Sorensen,2020-21,28.0,5,7,32,32,5,2,7,25.0,325.0,51,6,5,11,52.0,82,5.86,50,250,2620,9.2
16795,Marcus Sorensen,2021-22,29.0,6,30,80,80,17,13,30,100.0,1037.0,131,23,18,41,152.0,82,5.96,47,239,2579,9.5
16796,Marcus Sorensen,2022-23,30.0,7,18,66,66,7,11,18,78.0,914.0,197,30,29,59,230.0,70,5.96,42,208,2192,9.5
16797,Marek Hrivik,2018-19,27.0,4,1,5,5,0,1,1,3.0,54.0,5,0,1,1,3.0,82,5.34,48,255,2438,9.0
16798,Marek Hrivik,2019-20,28.0,5,2,16,16,0,2,2,15.0,167.0,21,0,3,3,18.0,82,5.45,47,245,2478,9.0
16799,Marek Hrivik,2020-21,29.0,6,0,3,3,0,0,0,2.0,26.0,24,0,3,3,20.0,82,5.86,50,250,2620,9.2
16800,Marek Malik,1997-98,22.0,4,1,1,1,0,1,1,0.0,,1,0,1,1,0.0,48,5.97,37,209,1408,10.2
16801,Marek Malik,1998-99,23.0,5,0,7,7,0,0,0,2.0,,8,0,1,1,2.0,82,6.29,74,413,2481,10.4
16802,Marek Malik,1999-00,24.0,6,6,47,47,1,5,6,33.0,,55,1,6,7,35.0,82,5.83,55,336,2444,9.8
16803,Marek Malik,2001-02,26.0,7,11,52,52,2,9,11,36.0,1104.0,107,3,15,18,71.0,82,5.27,57,359,2285,9.4
16804,Marek Malik,2002-03,27.0,8,14,57,57,4,10,14,57.0,1026.0,164,7,25,32,128.0,82,5.49,53,331,2294,9.8
16805,Marek Malik,2003-04,28.0,9,20,61,61,6,14,20,72.0,1195.0,225,13,39,52,200.0,82,5.51,63,376,2272,9.9
16806,Marek Malik,2004-05,29.0,10,23,82,82,4,19,23,91.0,1679.0,307,17,58,75,291.0,82,5.24,53,338,2262,9.5
16807,Marek Malik,2005-06,30.0,11,20,79,79,7,13,20,77.0,1419.0,386,24,71,95,368.0,82,5.31,60,363,2326,9.4
16808,Marek Malik,2006-07,31.0,12,19,78,78,3,16,19,61.0,1411.0,464,27,87,114,429.0,82,5.14,57,348,2300,9.2
16809,Marek Malik,2008-09,33.0,13,18,74,74,2,16,18,70.0,1512.0,538,29,103,132,499.0,82,6.05,85,480,2458,10.1
16810,Marek Malik,2009-10,34.0,14,21,69,69,2,19,21,57.0,1329.0,607,31,122,153,556.0,82,5.76,70,398,2426,9.7
16811,Marek Malik,2010-11,35.0,15,10,42,42,2,8,10,34.0,808.0,649,33,130,163,590.0,82,5.44,62,351,2383,9.4
16812,Marek Malik,2011-12,36.0,16,5,42,42,0,5,5,22.0,805.0,691,33,135,168,612.0,82,5.7,65,341,2477,9.4
16813,Marek Posmyk,2002-03,24.0,4,3,18,18,1,2,3,22.0,237.0,18,1,2,3,22.0,82,5.49,53,331,2294,9.8
16814,Marek Posmyk,2003-04,25.0,5,0,1,1,0,0,0,0.0,13.0,19,1,2,3,22.0,82,5.51,63,376,2272,9.9
16815,Marek Svatos,2006-07,24.0,4,2,4,4,2,0,2,6.0,41.0,4,2,0,2,6.0,82,5.14,57,348,2300,9.2
16816,Marek Svatos,2008-09,26.0,5,50,61,61,32,18,50,165.0,838.0,65,34,18,52,171.0,82,6.05,85,480,2458,10.1
16817,Marek Svatos,2009-10,27.0,6,30,66,66,15,15,30,179.0,825.0,131,49,33,82,350.0,82,5.76,70,398,2426,9.7
16818,Marek Svatos,2010-11,28.0,7,37,62,62,26,11,37,140.0,847.0,193,75,44,119,490.0,82,5.44,62,351,2383,9.4
16819,Marek Svatos,2011-12,29.0,8,34,69,69,14,20,34,140.0,904.0,262,89,64,153,630.0,82,5.7,65,341,2477,9.4
16820,Marek Svatos,2012-13,30.0,9,11,54,54,7,4,11,84.0,616.0,316,96,68,164,714.0,82,5.53,56,304,2486,9.1
16821,Marek Svatos,2013-14,31.0,10,8,28,28,4,4,8,50.0,328.0,344,100,72,172,764.0,82,5.46,52,291,2492,9.0
16822,Marek Zidlicky,2006-07,29.0,4,53,82,82,14,39,53,143.0,1643.0,82,14,39,53,143.0,82,5.14,57,348,2300,9.2
16823,Marek Zidlicky,2008-09,31.0,5,49,67,67,12,37,49,113.0,1344.0,149,26,76,102,256.0,82,6.05,85,480,2458,10.1
16824,Marek Zidlicky,2009-10,32.0,6,30,79,79,4,26,30,114.0,1558.0,228,30,102,132,370.0,82,5.76,70,398,2426,9.7
16825,Marek Zidlicky,2010-11,33.0,7,43,79,79,5,38,43,122.0,1645.0,307,35,140,175,492.0,82,5.44,62,351,2383,9.4
16826,Marek Zidlicky,2011-12,34.0,8,42,76,76,12,30,42,147.0,1680.0,383,47,170,217,639.0,82,5.7,65,341,2477,9.4
16827,Marek Zidlicky,2012-13,35.0,9,43,78,78,6,37,43,116.0,1885.0,461,53,207,260,755.0,82,5.53,56,304,2486,9.1
16828,Marek Zidlicky,2013-14,36.0,10,24,46,46,7,17,24,53.0,1002.0,507,60,224,284,808.0,82,5.46,52,291,2492,9.0
16829,Marek Zidlicky,2014-15,37.0,11,22,63,63,2,20,22,70.0,1344.0,570,62,244,306,878.0,82,5.32,47,271,2439,8.9
16830,Marek Zidlicky,2015-16,38.0,12,19,48,48,4,15,19,101.0,1008.0,618,66,259,325,979.0,48,5.31,29,160,1399,9.1
16831,Marek Zidlicky,2016-17,39.0,13,42,81,81,12,30,42,128.0,1754.0,699,78,289,367,1107.0,82,5.34,48,269,2463,8.9
16832,Marek Zidlicky,2017-18,40.0,14,34,84,84,7,27,34,130.0,1760.0,783,85,316,401,1237.0,82,5.32,47,251,2453,8.9
16833,Marek Zidlicky,2018-19,41.0,15,16,53,53,4,12,16,48.0,826.0,836,89,328,417,1285.0,82,5.34,48,255,2438,9.0
16834,Marian Cisar,2002-03,24.0,4,0,3,3,0,0,0,2.0,25.0,3,0,0,0,2.0,82,5.49,53,331,2294,9.8
16835,Marian Cisar,2003-04,25.0,5,27,60,60,12,15,27,97.0,790.0,63,12,15,27,99.0,82,5.51,63,376,2272,9.9
16836,Marian Cisar,2004-05,26.0,6,3,10,10,1,2,3,16.0,129.0,73,13,17,30,115.0,82,5.24,53,338,2262,9.5
16837,Marian Gaborik,2003-04,21.0,4,36,71,71,18,18,36,179.0,1096.0,71,18,18,36,179.0,82,5.51,63,376,2272,9.9
16838,Marian Gaborik,2004-05,22.0,5,67,78,78,30,37,67,221.0,1308.0,149,48,55,103,400.0,82,5.24,53,338,2262,9.5
16839,Marian Gaborik,2005-06,23.0,6,65,81,81,30,35,65,280.0,1410.0,230,78,90,168,680.0,82,5.31,60,363,2326,9.4
16840,Marian Gaborik,2006-07,24.0,7,40,65,65,18,22,40,220.0,1188.0,295,96,112,208,900.0,82,5.14,57,348,2300,9.2
16841,Marian Gaborik,2008-09,26.0,8,66,65,65,38,28,66,252.0,1198.0,360,134,140,274,1152.0,82,6.05,85,480,2458,10.1
16842,Marian Gaborik,2009-10,27.0,9,57,48,48,30,27,57,196.0,942.0,408,164,167,331,1348.0,82,5.76,70,398,2426,9.7
16843,Marian Gaborik,2010-11,28.0,10,83,77,77,42,41,83,278.0,1509.0,485,206,208,414,1626.0,82,5.44,62,351,2383,9.4
16844,Marian Gaborik,2011-12,29.0,11,23,17,17,13,10,23,68.0,340.0,502,219,218,437,1694.0,82,5.7,65,341,2477,9.4
16845,Marian Gaborik,2012-13,30.0,12,86,76,76,42,44,86,272.0,1615.0,578,261,262,523,1966.0,82,5.53,56,304,2486,9.1
16846,Marian Gaborik,2013-14,31.0,13,48,62,62,22,26,48,192.0,1121.0,640,283,288,571,2158.0,82,5.46,52,291,2492,9.0
16847,Marian Gaborik,2014-15,32.0,14,76,82,82,41,35,76,276.0,1600.0,722,324,323,647,2434.0,82,5.32,47,271,2439,8.9
16848,Marian Gaborik,2015-16,33.0,15,27,47,47,12,15,27,151.0,870.0,769,336,338,674,2585.0,48,5.31,29,160,1399,9.1
16849,Marian Gaborik,2016-17,34.0,16,30,41,41,11,19,30,103.0,697.0,810,347,357,704,2688.0,82,5.34,48,269,2463,8.9
16850,Marian Gaborik,2017-18,35.0,17,47,69,69,27,20,47,174.0,1167.0,879,374,377,751,2862.0,82,5.32,47,251,2453,8.9
16851,Marian Gaborik,2018-19,36.0,18,22,54,54,12,10,22,142.0,807.0,933,386,387,773,3004.0,82,5.34,48,255,2438,9.0
16852,Marian Gaborik,2019-20,37.0,19,21,56,56,10,11,21,123.0,828.0,989,396,398,794,3127.0,82,5.45,47,245,2478,9.0
16853,Marian Gaborik,2020-21,38.0,20,21,46,46,11,10,21,80.0,643.0,1035,407,408,815,3207.0,82,5.86,50,250,2620,9.2
16854,Marian Hossa,2000-01,22.0,4,1,7,7,0,1,1,10.0,,7,0,1,1,10.0,82,5.28,57,380,2242,9.6
16855,Marian Hossa,2001-02,23.0,5,30,60,60,15,15,30,124.0,839.0,67,15,16,31,134.0,82,5.27,57,359,2285,9.4
16856,Marian Hossa,2002-03,24.0,6,56,78,78,29,27,56,240.0,1341.0,145,44,43,87,374.0,82,5.49,53,331,2294,9.8
16857,Marian Hossa,2003-04,25.0,7,75,81,81,32,43,75,249.0,1460.0,226,76,86,162,623.0,82,5.51,63,376,2272,9.9
16858,Marian Hossa,2004-05,26.0,8,66,80,80,31,35,66,278.0,1479.0,306,107,121,228,901.0,82,5.24,53,338,2262,9.5
16859,Marian Hossa,2005-06,27.0,9,80,80,80,45,35,80,229.0,1481.0,386,152,156,308,1130.0,82,5.31,60,363,2326,9.4
16860,Marian Hossa,2006-07,28.0,10,82,81,81,36,46,82,233.0,1509.0,467,188,202,390,1363.0,82,5.14,57,348,2300,9.2
16861,Marian Hossa,2008-09,30.0,11,92,80,80,39,53,92,341.0,1735.0,547,227,255,482,1704.0,82,6.05,85,480,2458,10.1
16862,Marian Hossa,2009-10,31.0,12,100,82,82,43,57,100,340.0,1778.0,629,270,312,582,2044.0,82,5.76,70,398,2426,9.7
16863,Marian Hossa,2010-11,32.0,13,66,72,72,29,37,66,264.0,1538.0,701,299,349,648,2308.0,82,5.44,62,351,2383,9.4
16864,Marian Hossa,2011-12,33.0,14,71,74,74,40,31,71,307.0,1317.0,775,339,380,719,2615.0,82,5.7,65,341,2477,9.4
16865,Marian Hossa,2012-13,34.0,15,51,57,57,24,27,51,199.0,1067.0,832,363,407,770,2814.0,82,5.53,56,304,2486,9.1
16866,Marian Hossa,2013-14,35.0,16,57,65,65,25,32,57,205.0,1281.0,897,388,439,827,3019.0,82,5.46,52,291,2492,9.0
16867,Marian Hossa,2014-15,36.0,17,77,81,81,29,48,77,248.0,1617.0,978,417,487,904,3267.0,82,5.32,47,271,2439,8.9
16868,Marian Hossa,2015-16,37.0,18,31,40,40,17,14,31,116.0,722.0,1018,434,501,935,3383.0,48,5.31,29,160,1399,9.1
16869,Marian Hossa,2016-17,38.0,19,60,72,72,30,30,60,241.0,1316.0,1090,464,531,995,3624.0,82,5.34,48,269,2463,8.9
16870,Marian Hossa,2017-18,39.0,20,61,82,82,22,39,61,247.0,1521.0,1172,486,570,1056,3871.0,82,5.32,47,251,2453,8.9
16871,Marian Hossa,2018-19,40.0,21,33,64,64,13,20,33,191.0,1105.0,1236,499,590,1089,4062.0,82,5.34,48,255,2438,9.0
16872,Marian Hossa,2019-20,41.0,22,45,73,73,26,19,45,167.0,1231.0,1309,525,609,1134,4229.0,82,5.45,47,245,2478,9.0
16873,Marian Stastny,1984-85,32.0,4,89,74,74,35,54,89,174.0,,74,35,54,89,174.0,80,8.03,73,320,2489,12.9
16874,Marian Stastny,1985-86,33.0,5,79,60,60,36,43,79,169.0,,134,71,97,168,343.0,80,7.73,71,310,2444,12.7
16875,Marian Stastny,1986-87,34.0,6,52,68,68,20,32,52,113.0,,202,91,129,220,456.0,80,7.89,74,336,2448,12.9
16876,Marian Stastny,1987-88,35.0,7,21,50,50,7,14,21,45.0,,252,98,143,241,501.0,80,7.77,71,321,2447,12.7
16877,Marian Stastny,1988-89,36.0,8,53,70,70,23,30,53,132.0,,322,121,173,294,633.0,80,7.94,82,370,2484,12.8
16878,Mario Bliznak,2012-13,25.0,4,0,2,2,0,0,0,1.0,17.0,2,0,0,0,1.0,82,5.53,56,304,2486,9.1
16879,Mario Bliznak,2013-14,26.0,5,1,4,4,1,0,1,1.0,26.0,6,1,0,1,2.0,82,5.46,52,291,2492,9.0
16880,Mario Doyon,1991-92,23.0,4,2,7,7,1,1,2,7.0,,7,1,1,2,7.0,80,7.48,85,403,2430,12.3
16881,Mario Doyon,1992-93,24.0,5,5,9,9,2,3,5,19.0,,16,3,4,7,26.0,80,7.37,76,367,2421,12.2
16882,Mario Doyon,1993-94,25.0,6,0,12,12,0,0,0,12.0,,28,3,4,7,38.0,80,6.91,71,366,2385,11.6
16883,Mario Ferraro,2022-23,24.0,4,11,61,61,2,9,11,63.0,969.0,61,2,9,11,63.0,70,5.96,42,208,2192,9.5
16884,Mario Giallonardo,1982-83,25.0,4,1,8,8,0,1,1,4.0,,8,0,1,1,4.0,80,7.03,61,280,2352,12.0
16885,Mario Giallonardo,1983-84,26.0,5,2,15,15,0,2,2,8.0,,23,0,3,3,12.0,80,7.69,77,340,2441,12.6
16886,Mario Kempe,2020-21,32.0,4,4,18,18,2,2,4,20.0,200.0,18,2,2,4,20.0,82,5.86,50,250,2620,9.2
16887,Mario Kempe,2021-22,33.0,5,9,52,52,4,5,9,57.0,582.0,70,6,7,13,77.0,82,5.96,47,239,2579,9.5
16888,Mario Larocque,2001-02,23.0,4,0,5,5,0,0,0,3.0,63.0,5,0,0,0,3.0,82,5.27,57,359,2285,9.4
16889,Mario Lemieux,1987-88,22.0,4,100,73,73,43,57,100,209.0,,73,43,57,100,209.0,80,7.77,71,321,2447,12.7
16890,Mario Lemieux,1988-89,23.0,5,141,79,79,48,93,141,276.0,,152,91,150,241,485.0,80,7.94,82,370,2484,12.8
16891,Mario Lemieux,1989-90,24.0,6,107,63,63,54,53,107,267.0,,215,145,203,348,752.0,80,7.34,72,344,2400,12.2
16892,Mario Lemieux,1990-91,25.0,7,168,77,77,70,98,168,382.0,,292,215,301,516,1134.0,80,7.43,89,437,2435,12.2
16893,Mario Lemieux,1991-92,26.0,8,199,76,76,85,114,199,313.0,,368,300,415,715,1447.0,80,7.48,85,403,2430,12.3
16894,Mario Lemieux,1992-93,27.0,9,123,59,59,45,78,123,226.0,,427,345,493,838,1673.0,80,7.37,76,367,2421,12.2
16895,Mario Lemieux,1993-94,28.0,10,45,26,26,19,26,45,89.0,,453,364,519,883,1762.0,80,6.91,71,366,2385,11.6
16896,Mario Lemieux,1994-95,29.0,11,131,64,64,44,87,131,249.0,,517,408,606,1014,2011.0,80,6.96,77,402,2440,11.4
16897,Mario Lemieux,1995-96,30.0,12,160,60,60,69,91,160,286.0,,577,477,697,1174,2297.0,84,7.25,87,443,2603,11.7
16898,Mario Lemieux,1996-97,31.0,13,37,22,22,17,20,37,92.0,,599,494,717,1211,2389.0,84,6.48,76,407,2545,10.7
16899,Mario Lemieux,1998-99,33.0,14,161,70,70,69,92,161,338.0,,669,563,809,1372,2727.0,82,6.29,74,413,2481,10.4
16900,Mario Lemieux,1999-00,34.0,15,122,76,76,50,72,122,327.0,,745,613,881,1494,3054.0,82,5.83,55,336,2444,9.8
16901,Mario Lemieux,2003-04,38.0,16,76,43,43,35,41,76,171.0,1047.0,788,648,922,1570,3225.0,82,5.51,63,376,2272,9.9
16902,Mario Lemieux,2004-05,39.0,17,31,24,24,6,25,31,75.0,534.0,812,654,947,1601,3300.0,82,5.24,53,338,2262,9.5
16903,Mario Lemieux,2005-06,40.0,18,91,67,67,28,63,91,235.0,1546.0,879,682,1010,1692,3535.0,82,5.31,60,363,2326,9.4
16904,Mario Lemieux,2006-07,41.0,19,9,10,10,1,8,9,21.0,224.0,889,683,1018,1701,3556.0,82,5.14,57,348,2300,9.2
16905,Mario Lemieux,2008-09,43.0,20,22,26,26,7,15,22,77.0,504.0,915,690,1033,1723,3633.0,82,6.05,85,480,2458,10.1
16906,Mario Roberge,1993-94,30.0,4,0,5,5,0,0,0,2.0,,5,0,0,0,2.0,80,6.91,71,366,2385,11.6
16907,Mario Roberge,1994-95,31.0,5,3,20,20,2,1,3,7.0,,25,2,1,3,9.0,80,6.96,77,402,2440,11.4
16908,Mario Roberge,1995-96,32.0,6,8,50,50,4,4,8,23.0,,75,6,5,11,32.0,84,7.25,87,443,2603,11.7
16909,Mario Roberge,1996-97,33.0,7,3,28,28,1,2,3,5.0,,103,7,7,14,37.0,84,6.48,76,407,2545,10.7
16910,Mario Roberge,1997-98,34.0,8,0,9,9,0,0,0,0.0,,112,7,7,14,37.0,48,5.97,37,209,1408,10.2
16911,Mario Thyer,1992-93,26.0,4,0,5,5,0,0,0,4.0,,5,0,0,0,4.0,80,7.37,76,367,2421,12.2
16912,Mariusz Czerkawski,1996-97,24.0,4,3,4,4,2,1,3,11.0,,4,2,1,3,11.0,84,6.48,76,407,2545,10.7
16913,Mariusz Czerkawski,1997-98,25.0,5,26,47,47,12,14,26,126.0,,51,14,15,29,137.0,48,5.97,37,209,1408,10.2
16914,Mariusz Czerkawski,1998-99,26.0,6,40,70,70,17,23,40,142.0,,121,31,38,69,279.0,82,6.29,74,413,2481,10.4
16915,Mariusz Czerkawski,1999-00,27.0,7,47,76,76,26,21,47,182.0,,197,57,59,116,461.0,82,5.83,55,336,2444,9.8
16916,Mariusz Czerkawski,2000-01,28.0,8,25,68,68,12,13,25,136.0,,265,69,72,141,597.0,82,5.28,57,380,2242,9.6
16917,Mariusz Czerkawski,2001-02,29.0,9,38,78,78,21,17,38,205.0,1115.0,343,90,89,179,802.0,82,5.27,57,359,2285,9.4
16918,Mariusz Czerkawski,2002-03,30.0,10,70,79,79,35,35,70,276.0,1402.0,422,125,124,249,1078.0,82,5.49,53,331,2294,9.8
16919,Mariusz Czerkawski,2003-04,31.0,11,62,82,82,30,32,62,287.0,1536.0,504,155,156,311,1365.0,82,5.51,63,376,2272,9.9
16920,Mariusz Czerkawski,2004-05,32.0,12,51,82,82,22,29,51,169.0,1309.0,586,177,185,362,1534.0,82,5.24,53,338,2262,9.5
16921,Mariusz Czerkawski,2005-06,33.0,13,14,43,43,5,9,14,77.0,566.0,629,182,194,376,1611.0,82,5.31,60,363,2326,9.4
16922,Mariusz Czerkawski,2006-07,34.0,14,49,81,81,25,24,49,157.0,1056.0,710,207,218,425,1768.0,82,5.14,57,348,2300,9.2
16923,Mariusz Czerkawski,2008-09,36.0,15,10,35,35,8,2,10,72.0,449.0,745,215,220,435,1840.0,82,6.05,85,480,2458,10.1
16924,Mark Alt,2017-18,26.0,4,0,1,1,0,0,0,0.0,9.0,1,0,0,0,0.0,82,5.32,47,251,2453,8.9
16925,Mark Alt,2020-21,29.0,5,0,15,15,0,0,0,11.0,187.0,16,0,0,0,11.0,82,5.86,50,250,2620,9.2
16926,Mark Alt,2021-22,30.0,6,0,2,2,0,0,0,2.0,20.0,18,0,0,0,13.0,82,5.96,47,239,2579,9.5
16927,Mark Arcobello,2015-16,27.0,4,0,1,1,0,0,0,0.0,18.0,1,0,0,0,0.0,48,5.31,29,160,1399,9.1
16928,Mark Arcobello,2016-17,28.0,5,18,41,41,4,14,18,70.0,618.0,42,4,14,18,70.0,82,5.34,48,269,2463,8.9
16929,Mark Arcobello,2017-18,29.0,6,31,77,77,17,14,31,129.0,1140.0,119,21,28,49,199.0,82,5.32,47,251,2453,8.9
16930,Mark Arcobello,2018-19,30.0,7,4,20,20,3,1,4,43.0,254.0,139,24,29,53,242.0,82,5.34,48,255,2438,9.0
16931,Mark Astley,1996-97,27.0,4,0,1,1,0,0,0,2.0,,1,0,0,0,2.0,84,6.48,76,407,2545,10.7
16932,Mark Astley,1997-98,28.0,5,3,14,14,2,1,3,21.0,,15,2,1,3,23.0,48,5.97,37,209,1408,10.2
16933,Mark Astley,1998-99,29.0,6,20,60,60,2,18,20,80.0,,75,4,19,23,103.0,82,6.29,74,413,2481,10.4
16934,Mark Barberio,2015-16,25.0,4,0,2,2,0,0,0,1.0,31.0,2,0,0,0,1.0,48,5.31,29,160,1399,9.1
16935,Mark Barberio,2016-17,26.0,5,10,49,49,5,5,10,54.0,714.0,51,5,5,10,55.0,82,5.34,48,269,2463,8.9
16936,Mark Barberio,2017-18,27.0,6,7,52,52,1,6,7,53.0,873.0,103,6,11,17,108.0,82,5.32,47,251,2453,8.9
16937,Mark Barberio,2018-19,28.0,7,10,30,30,2,8,10,32.0,450.0,133,8,19,27,140.0,82,5.34,48,255,2438,9.0
16938,Mark Barberio,2019-20,29.0,8,13,60,60,2,11,13,80.0,1096.0,193,10,30,40,220.0,82,5.45,47,245,2478,9.0
16939,Mark Barberio,2020-21,30.0,9,13,46,46,3,10,13,52.0,795.0,239,13,40,53,272.0,82,5.86,50,250,2620,9.2
16940,Mark Barberio,2021-22,31.0,10,1,12,12,1,0,1,11.0,183.0,251,14,40,54,283.0,82,5.96,47,239,2579,9.5
16941,Mark Barberio,2022-23,32.0,11,2,21,21,0,2,2,29.0,296.0,272,14,42,56,312.0,70,5.96,42,208,2192,9.5
16942,Mark Beaufait,1995-96,25.0,4,1,5,5,1,0,1,3.0,,5,1,0,1,3.0,84,7.25,87,443,2603,11.7
16943,Mark Bell,2003-04,23.0,4,1,13,13,0,1,1,14.0,156.0,13,0,1,1,14.0,82,5.51,63,376,2272,9.9
16944,Mark Bell,2004-05,24.0,5,28,80,80,12,16,28,120.0,1012.0,93,12,17,29,134.0,82,5.24,53,338,2262,9.5
16945,Mark Bell,2005-06,25.0,6,29,82,82,14,15,29,127.0,1154.0,175,26,32,58,261.0,82,5.31,60,363,2326,9.4
16946,Mark Bell,2006-07,26.0,7,45,82,82,21,24,45,202.0,1445.0,257,47,56,103,463.0,82,5.14,57,348,2300,9.2
16947,Mark Bell,2008-09,28.0,8,48,82,82,25,23,48,227.0,1444.0,339,72,79,151,690.0,82,6.05,85,480,2458,10.1
16948,Mark Bell,2009-10,29.0,9,21,71,71,11,10,21,116.0,920.0,410,83,89,172,806.0,82,5.76,70,398,2426,9.7
16949,Mark Bell,2010-11,30.0,10,10,35,35,4,6,10,42.0,341.0,445,87,95,182,848.0,82,5.44,62,351,2383,9.4
16950,Mark Bell,2014-15,34.0,11,0,5,5,0,0,0,0.0,32.0,450,87,95,182,848.0,82,5.32,47,271,2439,8.9
16951,Mark Borowiecki,2014-15,25.0,4,0,2,2,0,0,0,1.0,25.0,2,0,0,0,1.0,82,5.32,47,271,2439,8.9
16952,Mark Borowiecki,2015-16,26.0,5,0,6,6,0,0,0,1.0,78.0,8,0,0,0,2.0,48,5.31,29,160,1399,9.1
16953,Mark Borowiecki,2016-17,27.0,6,1,13,13,1,0,1,6.0,164.0,21,1,0,1,8.0,82,5.34,48,269,2463,8.9
16954,Mark Borowiecki,2017-18,28.0,7,11,63,63,1,10,11,30.0,1002.0,84,2,10,12,38.0,82,5.32,47,251,2453,8.9
16955,Mark Borowiecki,2018-19,29.0,8,2,63,63,1,1,2,27.0,922.0,147,3,11,14,65.0,82,5.34,48,255,2438,9.0
16956,Mark Borowiecki,2019-20,30.0,9,3,70,70,1,2,3,50.0,981.0,217,4,13,17,115.0,82,5.45,47,245,2478,9.0
16957,Mark Borowiecki,2020-21,31.0,10,11,52,52,3,8,11,66.0,761.0,269,7,21,28,181.0,82,5.86,50,250,2620,9.2
16958,Mark Borowiecki,2021-22,32.0,11,5,53,53,1,4,5,59.0,825.0,322,8,25,33,240.0,82,5.96,47,239,2579,9.5
16959,Mark Borowiecki,2022-23,33.0,12,18,53,53,7,11,18,63.0,951.0,375,15,36,51,303.0,70,5.96,42,208,2192,9.5
16960,Mark Botell,1984-85,23.0,4,14,32,32,4,10,14,50.0,,32,4,10,14,50.0,80,8.03,73,320,2489,12.9
16961,Mark Cornforth,1998-99,26.0,4,0,6,6,0,0,0,1.0,,6,0,0,0,1.0,82,6.29,74,413,2481,10.4
16962,Mark Cullen,2008-09,30.0,4,16,29,29,7,9,16,45.0,384.0,29,7,9,16,45.0,82,6.05,85,480,2458,10.1
16963,Mark Cullen,2009-10,31.0,5,0,3,3,0,0,0,4.0,19.0,32,7,9,16,49.0,82,5.76,70,398,2426,9.7
16964,Mark Cullen,2014-15,36.0,6,1,6,6,0,1,1,1.0,48.0,38,7,10,17,50.0,82,5.32,47,271,2439,8.9
16965,Mark Cundari,2015-16,25.0,4,3,4,4,1,2,3,8.0,79.0,4,1,2,3,8.0,48,5.31,29,160,1399,9.1
16966,Mark Cundari,2016-17,26.0,5,0,4,4,0,0,0,6.0,43.0,8,1,2,3,14.0,82,5.34,48,269,2463,8.9
16967,Mark Eaton,2002-03,25.0,4,2,27,27,1,1,2,25.0,494.0,27,1,1,2,25.0,82,5.49,53,331,2294,9.8
16968,Mark Eaton,2003-04,26.0,5,11,34,34,3,8,11,32.0,585.0,61,4,9,13,57.0,82,5.51,63,376,2272,9.9
16969,Mark Eaton,2004-05,27.0,6,8,58,58,3,5,8,52.0,998.0,119,7,14,21,109.0,82,5.24,53,338,2262,9.5
16970,Mark Eaton,2005-06,28.0,7,9,50,50,2,7,9,52.0,788.0,169,9,21,30,161.0,82,5.31,60,363,2326,9.4
16971,Mark Eaton,2006-07,29.0,8,13,75,75,4,9,13,82.0,1570.0,244,13,30,43,243.0,82,5.14,57,348,2300,9.2
16972,Mark Eaton,2008-09,31.0,9,4,69,69,3,1,4,28.0,1361.0,313,16,31,47,271.0,82,6.05,85,480,2458,10.1
16973,Mark Eaton,2009-10,32.0,10,3,35,35,0,3,3,22.0,672.0,348,16,34,50,293.0,82,5.76,70,398,2426,9.7
16974,Mark Eaton,2010-11,33.0,11,3,36,36,0,3,3,28.0,708.0,384,16,37,53,321.0,82,5.44,62,351,2383,9.4
16975,Mark Eaton,2011-12,34.0,12,9,68,68,4,5,9,34.0,1208.0,452,20,42,62,355.0,82,5.7,65,341,2477,9.4
16976,Mark Eaton,2012-13,35.0,13,16,79,79,3,13,16,65.0,1561.0,531,23,55,78,420.0,82,5.53,56,304,2486,9.1
16977,Mark Eaton,2013-14,36.0,14,3,34,34,0,3,3,29.0,692.0,565,23,58,81,449.0,82,5.46,52,291,2492,9.0
16978,Mark Eaton,2014-15,37.0,15,4,62,62,1,3,4,44.0,995.0,627,24,61,85,493.0,82,5.32,47,271,2439,8.9
16979,Mark Eaton,2015-16,38.0,16,0,23,23,0,0,0,8.0,414.0,650,24,61,85,501.0,48,5.31,29,160,1399,9.1
16980,Mark Fayne,2013-14,26.0,4,14,57,57,4,10,14,77.0,1017.0,57,4,10,14,77.0,82,5.46,52,291,2492,9.0
16981,Mark Fayne,2014-15,27.0,5,17,82,82,4,13,17,94.0,1656.0,139,8,23,31,171.0,82,5.32,47,271,2439,8.9
16982,Mark Fayne,2015-16,28.0,6,6,31,31,1,5,6,34.0,561.0,170,9,28,37,205.0,48,5.31,29,160,1399,9.1
16983,Mark Fayne,2016-17,29.0,7,11,72,72,4,7,11,88.0,1318.0,242,13,35,48,293.0,82,5.34,48,269,2463,8.9
16984,Mark Fayne,2017-18,30.0,8,8,74,74,2,6,8,78.0,1327.0,316,15,41,56,371.0,82,5.32,47,251,2453,8.9
16985,Mark Fayne,2018-19,31.0,9,7,69,69,2,5,7,61.0,1153.0,385,17,46,63,432.0,82,5.34,48,255,2438,9.0
16986,Mark Fayne,2019-20,32.0,10,2,4,4,0,2,2,4.0,32.0,389,17,48,65,436.0,82,5.45,47,245,2478,9.0
16987,Mark Ferner,1989-90,24.0,4,3,13,13,0,3,3,5.0,,13,0,3,3,5.0,80,7.34,72,344,2400,12.2
16988,Mark Ferner,1991-92,26.0,5,0,2,2,0,0,0,0.0,,15,0,3,3,5.0,80,7.48,85,403,2430,12.3
16989,Mark Ferner,1992-93,27.0,6,0,2,2,0,0,0,2.0,,17,0,3,3,7.0,80,7.37,76,367,2421,12.2
16990,Mark Ferner,1993-94,28.0,7,1,7,7,0,1,1,3.0,,24,0,4,4,10.0,80,6.91,71,366,2385,11.6
16991,Mark Ferner,1996-97,31.0,8,8,50,50,3,5,8,44.0,,74,3,9,12,54.0,84,6.48,76,407,2545,10.7
16992,Mark Ferner,1997-98,32.0,9,1,17,17,0,1,1,16.0,,91,3,10,13,70.0,48,5.97,37,209,1408,10.2
16993,Mark Fistric,2010-11,24.0,4,2,37,37,0,2,2,17.0,471.0,37,0,2,2,17.0,82,5.44,62,351,2383,9.4
16994,Mark Fistric,2011-12,25.0,5,4,36,36,0,4,4,35.0,574.0,73,0,6,6,52.0,82,5.7,65,341,2477,9.4
16995,Mark Fistric,2012-13,26.0,6,10,67,67,1,9,10,46.0,1000.0,140,1,15,16,98.0,82,5.53,56,304,2486,9.1
16996,Mark Fistric,2013-14,27.0,7,5,57,57,2,3,5,26.0,820.0,197,3,18,21,124.0,82,5.46,52,291,2492,9.0
16997,Mark Fistric,2014-15,28.0,8,2,60,60,0,2,2,30.0,991.0,257,3,20,23,154.0,82,5.32,47,271,2439,8.9
16998,Mark Fistric,2015-16,29.0,9,6,25,25,0,6,6,9.0,383.0,282,3,26,29,163.0,48,5.31,29,160,1399,9.1
16999,Mark Fistric,2016-17,30.0,10,5,34,34,1,4,5,22.0,524.0,316,4,30,34,185.0,82,5.34,48,269,2463,8.9
17000,Mark Fistric,2017-18,31.0,11,0,9,9,0,0,0,1.0,133.0,325,4,30,34,186.0,82,5.32,47,251,2453,8.9
17001,Mark Flood,2012-13,28.0,4,1,6,6,0,1,1,5.0,76.0,6,0,1,1,5.0,82,5.53,56,304,2486,9.1
17002,Mark Flood,2014-15,30.0,5,7,33,33,3,4,7,30.0,507.0,39,3,5,8,35.0,82,5.32,47,271,2439,8.9
17003,Mark Fraser,2009-10,23.0,4,0,7,7,0,0,0,1.0,25.0,7,0,0,0,1.0,82,5.76,70,398,2426,9.7
17004,Mark Fraser,2012-13,26.0,5,6,61,61,3,3,6,24.0,755.0,68,3,3,6,25.0,82,5.53,56,304,2486,9.1
17005,Mark Fraser,2013-14,27.0,6,2,26,26,0,2,2,16.0,363.0,94,3,5,8,41.0,82,5.46,52,291,2492,9.0
17006,Mark Fraser,2014-15,28.0,7,0,4,4,0,0,0,0.0,57.0,98,3,5,8,41.0,82,5.32,47,271,2439,8.9
17007,Mark Fraser,2015-16,29.0,8,8,45,45,0,8,8,33.0,763.0,143,3,13,16,74.0,48,5.31,29,160,1399,9.1
17008,Mark Fraser,2016-17,30.0,9,2,42,42,1,1,2,11.0,646.0,185,4,14,18,85.0,82,5.34,48,269,2463,8.9
17009,Mark Fraser,2017-18,31.0,10,4,34,34,0,4,4,19.0,553.0,219,4,18,22,104.0,82,5.32,47,251,2453,8.9
17010,Mark Freer,1989-90,21.0,4,1,1,1,0,1,1,0.0,,1,0,1,1,0.0,80,7.34,72,344,2400,12.2
17011,Mark Freer,1990-91,22.0,5,0,1,1,0,0,0,0.0,,2,0,1,1,0.0,80,7.43,89,437,2435,12.2
17012,Mark Freer,1991-92,23.0,6,1,5,5,0,1,1,1.0,,7,0,2,2,1.0,80,7.48,85,403,2430,12.3
17013,Mark Freer,1992-93,24.0,7,0,2,2,0,0,0,2.0,,9,0,2,2,3.0,80,7.37,76,367,2421,12.2
17014,Mark Freer,1994-95,26.0,8,13,50,50,6,7,13,41.0,,59,6,9,15,44.0,80,6.96,77,402,2440,11.4
17015,Mark Freer,1995-96,27.0,9,24,63,63,10,14,24,80.0,,122,16,23,39,124.0,84,7.25,87,443,2603,11.7
17016,Mark Freer,1996-97,28.0,10,0,2,2,0,0,0,0.0,,124,16,23,39,124.0,84,6.48,76,407,2545,10.7
17017,Mark Friedman,2021-22,26.0,4,0,1,1,0,0,0,1.0,13.0,1,0,0,0,1.0,82,5.96,47,239,2579,9.5
17018,Mark Friedman,2022-23,27.0,5,1,6,6,0,1,1,2.0,82.0,7,0,1,1,3.0,70,5.96,42,208,2192,9.5
17019,Mark Fusco,1986-87,25.0,4,4,17,17,0,4,4,17.0,,17,0,4,4,17.0,80,7.89,74,336,2448,12.9
17020,Mark Fusco,1987-88,26.0,5,11,63,63,3,8,11,71.0,,80,3,12,15,88.0,80,7.77,71,321,2447,12.7
17021,Mark Giordano,2008-09,25.0,4,1,7,7,0,1,1,5.0,85.0,7,0,1,1,5.0,82,6.05,85,480,2458,10.1
17022,Mark Giordano,2009-10,26.0,5,15,48,48,7,8,15,49.0,645.0,55,7,9,16,54.0,82,5.76,70,398,2426,9.7
17023,Mark Giordano,2011-12,28.0,6,19,58,58,2,17,19,82.0,940.0,113,9,26,35,136.0,82,5.7,65,341,2477,9.4
17024,Mark Giordano,2012-13,29.0,7,30,82,82,11,19,30,111.0,1709.0,195,20,45,65,247.0,82,5.53,56,304,2486,9.1
17025,Mark Giordano,2013-14,30.0,8,43,82,82,8,35,43,165.0,1898.0,277,28,80,108,412.0,82,5.46,52,291,2492,9.0
17026,Mark Giordano,2014-15,31.0,9,27,61,61,9,18,27,125.0,1404.0,338,37,98,135,537.0,82,5.32,47,271,2439,8.9
17027,Mark Giordano,2015-16,32.0,10,15,47,47,4,11,15,58.0,1089.0,385,41,109,150,595.0,48,5.31,29,160,1399,9.1
17028,Mark Giordano,2016-17,33.0,11,47,64,64,14,33,47,180.0,1615.0,449,55,142,197,775.0,82,5.34,48,269,2463,8.9
17029,Mark Giordano,2017-18,34.0,12,48,61,61,11,37,48,157.0,1536.0,510,66,179,245,932.0,82,5.32,47,251,2453,8.9
17030,Mark Giordano,2018-19,35.0,13,56,82,82,21,35,56,212.0,2032.0,592,87,214,301,1144.0,82,5.34,48,255,2438,9.0
17031,Mark Giordano,2019-20,36.0,14,39,81,81,12,27,39,151.0,1910.0,673,99,241,340,1295.0,82,5.45,47,245,2478,9.0
17032,Mark Giordano,2020-21,37.0,15,38,82,82,13,25,38,214.0,2033.0,755,112,266,378,1509.0,82,5.86,50,250,2620,9.2
17033,Mark Giordano,2021-22,38.0,16,74,78,78,17,57,74,221.0,1891.0,833,129,323,452,1730.0,82,5.96,47,239,2579,9.5
17034,Mark Giordano,2022-23,39.0,17,31,60,60,5,26,31,157.0,1433.0,893,134,349,483,1887.0,70,5.96,42,208,2192,9.5
17035,Mark Greig,1993-94,24.0,4,0,4,4,0,0,0,1.0,,4,0,0,0,1.0,80,6.91,71,366,2385,11.6
17036,Mark Greig,1994-95,25.0,5,5,17,17,0,5,5,18.0,,21,0,5,5,19.0,80,6.96,77,402,2440,11.4
17037,Mark Greig,1995-96,26.0,6,8,22,22,1,7,8,16.0,,43,1,12,13,35.0,84,7.25,87,443,2603,11.7
17038,Mark Greig,1996-97,27.0,7,13,44,44,6,7,13,55.0,,87,7,19,26,90.0,84,6.48,76,407,2545,10.7
17039,Mark Greig,1997-98,28.0,8,2,8,8,1,1,2,5.0,,95,8,20,28,95.0,48,5.97,37,209,1408,10.2
17040,Mark Greig,2001-02,32.0,9,4,7,7,1,3,4,9.0,69.0,102,9,23,32,104.0,82,5.27,57,359,2285,9.4
17041,Mark Greig,2002-03,33.0,10,5,11,11,3,2,5,14.0,125.0,113,12,25,37,118.0,82,5.49,53,331,2294,9.8
17042,Mark Greig,2003-04,34.0,11,2,7,7,1,1,2,7.0,101.0,120,13,26,39,125.0,82,5.51,63,376,2272,9.9
17043,Mark Greig,2005-06,36.0,12,1,5,5,0,1,1,2.0,25.0,125,13,27,40,127.0,82,5.31,60,363,2326,9.4
17044,Mark Hamway,1987-88,26.0,4,0,2,2,0,0,0,1.0,,2,0,0,0,1.0,80,7.77,71,321,2447,12.7
17045,Mark Hamway,1988-89,27.0,5,17,49,49,5,12,17,50.0,,51,5,12,17,51.0,80,7.94,82,370,2484,12.8
17046,Mark Hamway,1989-90,28.0,6,1,2,2,0,1,1,1.0,,53,5,13,18,52.0,80,7.34,72,344,2400,12.2
17047,Mark Hardy,1982-83,23.0,4,1,15,15,0,1,1,14.0,,15,0,1,1,14.0,80,7.03,61,280,2352,12.0
17048,Mark Hardy,1983-84,24.0,5,25,77,77,5,20,25,90.0,,92,5,21,26,104.0,80,7.69,77,340,2441,12.6
17049,Mark Hardy,1984-85,25.0,6,45,77,77,6,39,45,121.0,,169,11,60,71,225.0,80,8.03,73,320,2489,12.9
17050,Mark Hardy,1985-86,26.0,7,39,74,74,5,34,39,162.0,,243,16,94,110,387.0,80,7.73,71,310,2444,12.7
17051,Mark Hardy,1986-87,27.0,8,49,79,79,8,41,49,175.0,,322,24,135,159,562.0,80,7.89,74,336,2448,12.9
17052,Mark Hardy,1987-88,28.0,9,53,78,78,14,39,53,151.0,,400,38,174,212,713.0,80,7.77,71,321,2447,12.7
17053,Mark Hardy,1988-89,29.0,10,27,55,55,6,21,27,113.0,,455,44,195,239,826.0,80,7.94,82,370,2484,12.8
17054,Mark Hardy,1989-90,30.0,11,30,73,73,3,27,30,97.0,,528,47,222,269,923.0,80,7.34,72,344,2400,12.2
17055,Mark Hardy,1990-91,31.0,12,32,80,80,8,24,32,134.0,,608,55,246,301,1057.0,80,7.43,89,437,2435,12.2
17056,Mark Hardy,1991-92,32.0,13,20,60,60,4,16,20,70.0,,668,59,262,321,1127.0,80,7.48,85,403,2430,12.3
17057,Mark Hardy,1992-93,33.0,14,15,54,54,0,15,15,55.0,,722,59,277,336,1182.0,80,7.37,76,367,2421,12.2
17058,Mark Hardy,1993-94,34.0,15,6,70,70,1,5,6,63.0,,792,60,282,342,1245.0,80,6.91,71,366,2385,11.6
17059,Mark Hardy,1994-95,35.0,16,9,52,52,1,8,9,42.0,,844,61,290,351,1287.0,80,6.96,77,402,2440,11.4
17060,Mark Hardy,1995-96,36.0,17,14,55,55,1,13,14,48.0,,899,62,303,365,1335.0,84,7.25,87,443,2603,11.7
17061,Mark Hardy,1996-97,37.0,18,3,16,16,0,3,3,8.0,,915,62,306,368,1343.0,84,6.48,76,407,2545,10.7
17062,Mark Hartigan,2004-05,27.0,4,0,2,2,0,0,0,3.0,27.0,2,0,0,0,3.0,82,5.24,53,338,2262,9.5
17063,Mark Hartigan,2005-06,28.0,5,7,23,23,5,2,7,25.0,250.0,25,5,2,7,28.0,82,5.31,60,363,2326,9.4
17064,Mark Hartigan,2006-07,29.0,6,4,9,9,1,3,4,15.0,147.0,34,6,5,11,43.0,82,5.14,57,348,2300,9.2
17065,Mark Hartigan,2008-09,31.0,7,12,33,33,9,3,12,54.0,384.0,67,15,8,23,97.0,82,6.05,85,480,2458,10.1
17066,Mark Hartigan,2009-10,32.0,8,3,12,12,1,2,3,15.0,129.0,79,16,10,26,112.0,82,5.76,70,398,2426,9.7
17067,Mark Hartigan,2010-11,33.0,9,4,23,23,3,1,4,19.0,165.0,102,19,11,30,131.0,82,5.44,62,351,2383,9.4
17068,Mark Howe,1982-83,27.0,4,80,74,74,24,56,80,178.0,,74,24,56,80,178.0,80,7.03,61,280,2352,12.0
17069,Mark Howe,1983-84,28.0,5,65,63,63,19,46,65,172.0,,137,43,102,145,350.0,80,7.69,77,340,2441,12.6
17070,Mark Howe,1984-85,29.0,6,53,76,76,8,45,53,225.0,,213,51,147,198,575.0,80,8.03,73,320,2489,12.9
17071,Mark Howe,1985-86,30.0,7,67,76,76,20,47,67,219.0,,289,71,194,265,794.0,80,7.73,71,310,2444,12.7
17072,Mark Howe,1986-87,31.0,8,53,71,71,19,34,53,184.0,,360,90,228,318,978.0,80,7.89,74,336,2448,12.9
17073,Mark Howe,1987-88,32.0,9,57,73,73,18,39,57,215.0,,433,108,267,375,1193.0,80,7.77,71,321,2447,12.7
17074,Mark Howe,1988-89,33.0,10,82,77,77,24,58,82,193.0,,510,132,325,457,1386.0,80,7.94,82,370,2484,12.8
17075,Mark Howe,1989-90,34.0,11,58,69,69,15,43,58,150.0,,579,147,368,515,1536.0,80,7.34,72,344,2400,12.2
17076,Mark Howe,1990-91,35.0,12,62,75,75,19,43,62,177.0,,654,166,411,577,1713.0,80,7.43,89,437,2435,12.2
17077,Mark Howe,1991-92,36.0,13,38,52,52,9,29,38,95.0,,706,175,440,615,1808.0,80,7.48,85,403,2430,12.3
17078,Mark Howe,1992-93,37.0,14,28,40,40,7,21,28,63.0,,746,182,461,643,1871.0,80,7.37,76,367,2421,12.2
17079,Mark Howe,1993-94,38.0,15,10,19,19,0,10,10,40.0,,765,182,471,653,1911.0,80,6.91,71,366,2385,11.6
17080,Mark Howe,1994-95,39.0,16,25,42,42,7,18,25,63.0,,807,189,489,678,1974.0,80,6.96,77,402,2440,11.4
17081,Mark Howe,1995-96,40.0,17,34,60,60,3,31,34,72.0,,867,192,520,712,2046.0,84,7.25,87,443,2603,11.7
17082,Mark Howe,1996-97,41.0,18,24,44,44,4,20,24,72.0,,911,196,540,736,2118.0,84,6.48,76,407,2545,10.7
17083,Mark Howe,1997-98,42.0,19,6,18,18,1,5,6,14.0,,929,197,545,742,2132.0,48,5.97,37,209,1408,10.2
17084,Mark Hunter,1984-85,22.0,4,29,71,71,18,11,29,79.0,,71,18,11,29,79.0,80,8.03,73,320,2489,12.9
17085,Mark Hunter,1985-86,23.0,5,16,31,31,8,8,16,39.0,,102,26,19,45,118.0,80,7.73,71,310,2444,12.7
17086,Mark Hunter,1986-87,24.0,6,10,22,22,6,4,10,24.0,,124,32,23,55,142.0,80,7.89,74,336,2448,12.9
17087,Mark Hunter,1987-88,25.0,7,33,72,72,21,12,33,107.0,,196,53,35,88,249.0,80,7.77,71,321,2447,12.7
17088,Mark Hunter,1988-89,26.0,8,74,78,78,44,30,74,204.0,,274,97,65,162,453.0,80,7.94,82,370,2484,12.8
17089,Mark Hunter,1989-90,27.0,9,69,74,74,36,33,69,178.0,,348,133,98,231,631.0,80,7.34,72,344,2400,12.2
17090,Mark Hunter,1990-91,28.0,10,63,66,66,32,31,63,164.0,,414,165,129,294,795.0,80,7.43,89,437,2435,12.2
17091,Mark Hunter,1991-92,29.0,11,30,66,66,22,8,30,116.0,,480,187,137,324,911.0,80,7.48,85,403,2430,12.3
17092,Mark Hunter,1992-93,30.0,12,5,10,10,2,3,5,15.0,,490,189,140,329,926.0,80,7.37,76,367,2421,12.2
17093,Mark Hunter,1993-94,31.0,13,32,68,68,14,18,32,110.0,,558,203,158,361,1036.0,80,6.91,71,366,2385,11.6
17094,Mark Hunter,1994-95,32.0,14,23,63,63,10,13,23,92.0,,621,213,171,384,1128.0,80,6.96,77,402,2440,11.4
17095,Mark Hunter,1995-96,33.0,15,0,7,7,0,0,0,5.0,,628,213,171,384,1133.0,84,7.25,87,443,2603,11.7
17096,Mark Jankowski,2019-20,25.0,4,0,1,1,0,0,0,0.0,10.0,1,0,0,0,0.0,82,5.45,47,245,2478,9.0
17097,Mark Jankowski,2020-21,26.0,5,25,72,72,17,8,25,118.0,962.0,73,17,8,25,118.0,82,5.86,50,250,2620,9.2
17098,Mark Jankowski,2021-22,27.0,6,32,79,79,14,18,32,99.0,1004.0,152,31,26,57,217.0,82,5.96,47,239,2579,9.5
17099,Mark Jankowski,2022-23,28.0,7,7,56,56,5,2,7,38.0,621.0,208,36,28,64,255.0,70,5.96,42,208,2192,9.5
17100,Mark Janssens,1990-91,22.0,4,0,1,1,0,0,0,0.0,,1,0,0,0,0.0,80,7.43,89,437,2435,12.2
17101,Mark Janssens,1991-92,23.0,5,0,5,5,0,0,0,4.0,,6,0,0,0,4.0,80,7.48,85,403,2430,12.3
17102,Mark Janssens,1992-93,24.0,6,13,80,80,5,8,13,61.0,,86,5,8,13,65.0,80,7.37,76,367,2421,12.2
17103,Mark Janssens,1993-94,25.0,7,16,67,67,9,7,16,45.0,,153,14,15,29,110.0,80,6.91,71,366,2385,11.6
17104,Mark Janssens,1994-95,26.0,8,0,7,7,0,0,0,1.0,,160,14,15,29,111.0,80,6.96,77,402,2440,11.4
17105,Mark Janssens,1995-96,27.0,9,29,76,76,12,17,29,63.0,,236,26,32,58,174.0,84,7.25,87,443,2603,11.7
17106,Mark Janssens,1996-97,28.0,10,12,84,84,2,10,12,52.0,,320,28,42,70,226.0,84,6.48,76,407,2545,10.7
17107,Mark Janssens,1997-98,29.0,11,7,46,46,2,5,7,33.0,,366,30,47,77,259.0,48,5.97,37,209,1408,10.2
17108,Mark Janssens,1998-99,30.0,12,9,81,81,2,7,9,63.0,,447,32,54,86,322.0,82,6.29,74,413,2481,10.4
17109,Mark Janssens,1999-00,31.0,13,8,66,66,2,6,8,39.0,,513,34,60,94,361.0,82,5.83,55,336,2444,9.8
17110,Mark Janssens,2000-01,32.0,14,12,74,74,5,7,12,53.0,,587,39,67,106,414.0,82,5.28,57,380,2242,9.6
17111,Mark Janssens,2001-02,33.0,15,1,60,60,1,0,1,27.0,497.0,647,40,67,107,441.0,82,5.27,57,359,2285,9.4
17112,Mark Janssens,2002-03,34.0,16,6,36,36,0,6,6,14.0,259.0,683,40,73,113,455.0,82,5.49,53,331,2294,9.8
17113,Mark Janssens,2003-04,35.0,17,0,28,28,0,0,0,15.0,293.0,711,40,73,113,470.0,82,5.51,63,376,2272,9.9
17114,Mark Johnson,1982-83,25.0,4,8,17,17,3,5,8,32.0,,17,3,5,8,32.0,80,7.03,61,280,2352,12.0
17115,Mark Johnson,1983-84,26.0,5,33,73,73,10,23,33,109.0,,90,13,28,41,141.0,80,7.69,77,340,2441,12.6
17116,Mark Johnson,1984-85,27.0,6,25,56,56,12,13,25,111.0,,146,25,41,66,252.0,80,8.03,73,320,2489,12.9
17117,Mark Johnson,1985-86,28.0,7,69,73,73,31,38,69,167.0,,219,56,79,135,419.0,80,7.73,71,310,2444,12.7
17118,Mark Johnson,1986-87,29.0,8,87,79,79,35,52,87,184.0,,298,91,131,222,603.0,80,7.89,74,336,2448,12.9
17119,Mark Johnson,1987-88,30.0,9,57,66,66,23,34,57,143.0,,364,114,165,279,746.0,80,7.77,71,321,2447,12.7
17120,Mark Johnson,1988-89,31.0,10,62,80,80,21,41,62,167.0,,444,135,206,341,913.0,80,7.94,82,370,2484,12.8
17121,Mark Johnson,1989-90,32.0,11,51,68,68,25,26,51,193.0,,512,160,232,392,1106.0,80,7.34,72,344,2400,12.2
17122,Mark Johnson,1990-91,33.0,12,33,54,54,14,19,33,121.0,,566,174,251,425,1227.0,80,7.43,89,437,2435,12.2
17123,Mark Johnson,1991-92,34.0,13,38,40,40,13,25,38,95.0,,606,187,276,463,1322.0,80,7.48,85,403,2430,12.3
17124,Mark Johnson,1992-93,35.0,14,45,63,63,16,29,45,82.0,,669,203,305,508,1404.0,80,7.37,76,367,2421,12.2
17125,Mark Kachowski,1990-91,25.0,4,8,38,38,5,3,8,21.0,,38,5,3,8,21.0,80,7.43,89,437,2435,12.2
17126,Mark Kachowski,1991-92,26.0,5,2,12,12,1,1,2,3.0,,50,6,4,10,24.0,80,7.48,85,403,2430,12.3
17127,Mark Kachowski,1992-93,27.0,6,1,14,14,0,1,1,4.0,,64,6,5,11,28.0,80,7.37,76,367,2421,12.2
17128,Mark Katic,2013-14,24.0,4,1,11,11,0,1,1,8.0,181.0,11,0,1,1,8.0,82,5.46,52,291,2492,9.0
17129,Mark Kirton,1982-83,24.0,4,1,2,2,1,0,1,3.0,,2,1,0,1,3.0,80,7.03,61,280,2352,12.0
17130,Mark Kirton,1983-84,25.0,5,31,61,61,18,13,31,102.0,,63,19,13,32,105.0,80,7.69,77,340,2441,12.6
17131,Mark Kirton,1984-85,26.0,6,42,74,74,14,28,42,121.0,,137,33,41,74,226.0,80,8.03,73,320,2489,12.9
17132,Mark Kirton,1985-86,27.0,7,12,41,41,5,7,12,49.0,,178,38,48,86,275.0,80,7.73,71,310,2444,12.7
17133,Mark Kirton,1986-87,28.0,8,5,26,26,2,3,5,26.0,,204,40,51,91,301.0,80,7.89,74,336,2448,12.9
17134,Mark Kirton,1987-88,29.0,9,22,62,62,17,5,22,94.0,,266,57,56,113,395.0,80,7.77,71,321,2447,12.7
17135,Mark Kolesar,1998-99,26.0,4,4,21,21,2,2,4,10.0,,21,2,2,4,10.0,82,6.29,74,413,2481,10.4
17136,Mark Kolesar,1999-00,27.0,5,0,7,7,0,0,0,3.0,,28,2,2,4,13.0,82,5.83,55,336,2444,9.8
17137,Mark Kumpel,1987-88,26.0,4,15,42,42,8,7,15,48.0,,42,8,7,15,48.0,80,7.77,71,321,2447,12.7
17138,Mark Kumpel,1988-89,27.0,5,22,47,47,10,12,22,76.0,,89,18,19,37,124.0,80,7.94,82,370,2484,12.8
17139,Mark Kumpel,1989-90,28.0,6,10,45,45,1,9,10,48.0,,134,19,28,47,172.0,80,7.34,72,344,2400,12.2
17140,Mark Kumpel,1990-91,29.0,7,10,45,45,4,6,10,42.0,,179,23,34,57,214.0,80,7.43,89,437,2435,12.2
17141,Mark Kumpel,1992-93,31.0,8,17,56,56,8,9,17,74.0,,235,31,43,74,288.0,80,7.37,76,367,2421,12.2
17142,Mark Kumpel,1993-94,32.0,9,10,53,53,7,3,10,65.0,,288,38,46,84,353.0,80,6.91,71,366,2385,11.6
17143,Mark LaVarre,1988-89,23.0,4,0,2,2,0,0,0,2.0,,2,0,0,0,2.0,80,7.94,82,370,2484,12.8
17144,Mark LaVarre,1989-90,24.0,5,23,58,58,8,15,23,46.0,,60,8,15,23,48.0,80,7.34,72,344,2400,12.2
17145,Mark LaVarre,1990-91,25.0,6,2,18,18,1,1,2,17.0,,78,9,16,25,65.0,80,7.43,89,437,2435,12.2
17146,Mark Lamb,1988-89,24.0,4,0,1,1,0,0,0,0.0,,1,0,0,0,0.0,80,7.94,82,370,2484,12.8
17147,Mark Lamb,1989-90,25.0,5,3,22,22,2,1,3,8.0,,23,2,1,3,8.0,80,7.34,72,344,2400,12.2
17148,Mark Lamb,1990-91,26.0,6,0,2,2,0,0,0,0.0,,25,2,1,3,8.0,80,7.43,89,437,2435,12.2
17149,Mark Lamb,1991-92,27.0,7,10,20,20,2,8,10,20.0,,45,4,9,13,28.0,80,7.48,85,403,2430,12.3
17150,Mark Lamb,1992-93,28.0,8,28,58,58,12,16,28,81.0,,103,16,25,41,109.0,80,7.37,76,367,2421,12.2
17151,Mark Lamb,1993-94,29.0,9,12,37,37,4,8,12,41.0,,140,20,33,53,150.0,80,6.91,71,366,2385,11.6
17152,Mark Lamb,1994-95,30.0,10,28,59,59,6,22,28,61.0,,199,26,55,81,211.0,80,6.96,77,402,2440,11.4
17153,Mark Lamb,1995-96,31.0,11,26,71,71,7,19,26,123.0,,270,33,74,107,334.0,84,7.25,87,443,2603,11.7
17154,Mark Lamb,1996-97,32.0,12,36,85,85,12,24,36,124.0,,355,45,98,143,458.0,84,6.48,76,407,2545,10.7
17155,Mark Lamb,1997-98,33.0,13,3,47,47,1,2,3,30.0,,402,46,100,146,488.0,48,5.97,37,209,1408,10.2
17156,Mark Lamb,1998-99,34.0,14,0,1,1,0,0,0,0.0,,403,46,100,146,488.0,82,6.29,74,413,2481,10.4
17157,Mark Lawrence,1997-98,26.0,4,0,2,2,0,0,0,3.0,,2,0,0,0,3.0,48,5.97,37,209,1408,10.2
17158,Mark Lawrence,1998-99,27.0,5,1,13,13,0,1,1,13.0,,15,0,1,1,16.0,82,6.29,74,413,2481,10.4
17159,Mark Lawrence,2000-01,29.0,6,0,2,2,0,0,0,4.0,,17,0,1,1,20.0,82,5.28,57,380,2242,9.6
17160,Mark Lawrence,2001-02,30.0,7,30,60,60,14,16,30,88.0,848.0,77,14,17,31,108.0,82,5.27,57,359,2285,9.4
17161,Mark Lawrence,2002-03,31.0,8,6,29,29,1,5,6,33.0,405.0,106,15,22,37,141.0,82,5.49,53,331,2294,9.8
17162,Mark Lawrence,2003-04,32.0,9,7,36,36,3,4,7,32.0,355.0,142,18,26,44,173.0,82,5.51,63,376,2272,9.9
17163,Mark Letestu,2012-13,27.0,4,1,10,10,1,0,1,9.0,96.0,10,1,0,1,9.0,82,5.53,56,304,2486,9.1
17164,Mark Letestu,2013-14,28.0,5,27,64,64,14,13,27,128.0,912.0,74,15,13,28,137.0,82,5.46,52,291,2492,9.0
17165,Mark Letestu,2014-15,29.0,6,25,62,62,11,14,25,114.0,970.0,136,26,27,53,251.0,82,5.32,47,271,2439,8.9
17166,Mark Letestu,2015-16,30.0,7,27,46,46,13,14,27,92.0,760.0,182,39,41,80,343.0,48,5.31,29,160,1399,9.1
17167,Mark Letestu,2016-17,31.0,8,34,82,82,12,22,34,122.0,1205.0,264,51,63,114,465.0,82,5.34,48,269,2463,8.9
17168,Mark Letestu,2017-18,32.0,9,13,54,54,7,6,13,63.0,720.0,318,58,69,127,528.0,82,5.32,47,251,2453,8.9
17169,Mark Letestu,2018-19,33.0,10,25,82,82,10,15,25,107.0,1294.0,400,68,84,152,635.0,82,5.34,48,255,2438,9.0
17170,Mark Letestu,2019-20,34.0,11,35,78,78,16,19,35,120.0,1111.0,478,84,103,187,755.0,82,5.45,47,245,2478,9.0
17171,Mark Letestu,2020-21,35.0,12,23,80,80,9,14,23,111.0,1028.0,558,93,117,210,866.0,82,5.86,50,250,2620,9.2
17172,Mark Letestu,2021-22,36.0,13,0,2,2,0,0,0,1.0,19.0,560,93,117,210,867.0,82,5.96,47,239,2579,9.5
17173,Mark Letestu,2022-23,37.0,14,0,7,7,0,0,0,5.0,74.0,567,93,117,210,872.0,70,5.96,42,208,2192,9.5
17174,Mark Major,1999-00,29.0,4,0,2,2,0,0,0,0.0,,2,0,0,0,0.0,82,5.83,55,336,2444,9.8
17175,Mark Mancari,2009-10,24.0,4,1,3,3,0,1,1,1.0,19.0,3,0,1,1,1.0,82,5.76,70,398,2426,9.7
17176,Mark Mancari,2011-12,26.0,5,2,7,7,1,1,2,21.0,93.0,10,1,2,3,22.0,82,5.7,65,341,2477,9.4
17177,Mark Mancari,2012-13,27.0,6,2,6,6,1,1,2,19.0,84.0,16,2,3,5,41.0,82,5.53,56,304,2486,9.1
17178,Mark Mancari,2013-14,28.0,7,8,20,20,1,7,8,43.0,246.0,36,3,10,13,84.0,82,5.46,52,291,2492,9.0
17179,Mark Mancari,2014-15,29.0,8,0,6,6,0,0,0,5.0,50.0,42,3,10,13,89.0,82,5.32,47,271,2439,8.9
17180,Mark McNeill,2018-19,25.0,4,0,1,1,0,0,0,0.0,13.0,1,0,0,0,0.0,82,5.34,48,255,2438,9.0
17181,Mark McNeill,2019-20,26.0,5,0,1,1,0,0,0,1.0,14.0,2,0,0,0,1.0,82,5.45,47,245,2478,9.0
17182,Mark Messier,1982-83,22.0,4,33,75,75,12,21,33,113.0,,75,12,21,33,113.0,80,7.03,61,280,2352,12.0
17183,Mark Messier,1983-84,23.0,5,63,72,72,23,40,63,179.0,,147,35,61,96,292.0,80,7.69,77,340,2441,12.6
17184,Mark Messier,1984-85,24.0,6,88,78,78,50,38,88,235.0,,225,85,99,184,527.0,80,8.03,73,320,2489,12.9
17185,Mark Messier,1985-86,25.0,7,106,77,77,48,58,106,237.0,,302,133,157,290,764.0,80,7.73,71,310,2444,12.7
17186,Mark Messier,1986-87,26.0,8,101,73,73,37,64,101,220.0,,375,170,221,391,984.0,80,7.89,74,336,2448,12.9
17187,Mark Messier,1987-88,27.0,9,54,55,55,23,31,54,138.0,,430,193,252,445,1122.0,80,7.77,71,321,2447,12.7
17188,Mark Messier,1988-89,28.0,10,84,63,63,35,49,84,198.0,,493,228,301,529,1320.0,80,7.94,82,370,2484,12.8
17189,Mark Messier,1989-90,29.0,11,107,77,77,37,70,107,210.0,,570,265,371,636,1530.0,80,7.34,72,344,2400,12.2
17190,Mark Messier,1990-91,30.0,12,111,77,77,37,74,111,182.0,,647,302,445,747,1712.0,80,7.43,89,437,2435,12.2
17191,Mark Messier,1991-92,31.0,13,94,72,72,33,61,94,164.0,,719,335,506,841,1876.0,80,7.48,85,403,2430,12.3
17192,Mark Messier,1992-93,32.0,14,129,79,79,45,84,129,211.0,,798,380,590,970,2087.0,80,7.37,76,367,2421,12.2
17193,Mark Messier,1993-94,33.0,15,64,53,53,12,52,64,109.0,,851,392,642,1034,2196.0,80,6.91,71,366,2385,11.6
17194,Mark Messier,1994-95,34.0,16,107,79,79,35,72,107,212.0,,930,427,714,1141,2408.0,80,6.96,77,402,2440,11.4
17195,Mark Messier,1995-96,35.0,17,91,75,75,25,66,91,215.0,,1005,452,780,1232,2623.0,84,7.25,87,443,2603,11.7
17196,Mark Messier,1996-97,36.0,18,84,76,76,26,58,84,216.0,,1081,478,838,1316,2839.0,84,6.48,76,407,2545,10.7
17197,Mark Messier,1997-98,37.0,19,53,46,46,14,39,53,126.0,,1127,492,877,1369,2965.0,48,5.97,37,209,1408,10.2
17198,Mark Messier,1998-99,38.0,20,99,74,74,47,52,99,241.0,,1201,539,929,1468,3206.0,82,6.29,74,413,2481,10.4
17199,Mark Messier,1999-00,39.0,21,84,71,71,36,48,84,227.0,,1272,575,977,1552,3433.0,82,5.83,55,336,2444,9.8
17200,Mark Messier,2000-01,40.0,22,60,82,82,22,38,60,139.0,,1354,597,1015,1612,3572.0,82,5.28,57,380,2242,9.6
17201,Mark Messier,2001-02,41.0,23,48,59,59,13,35,48,97.0,1333.0,1413,610,1050,1660,3669.0,82,5.27,57,359,2285,9.4
17202,Mark Messier,2002-03,42.0,24,54,66,66,17,37,54,131.0,1399.0,1479,627,1087,1714,3800.0,82,5.49,53,331,2294,9.8
17203,Mark Messier,2003-04,43.0,25,67,82,82,24,43,67,131.0,1578.0,1561,651,1130,1781,3931.0,82,5.51,63,376,2272,9.9
17204,Mark Messier,2004-05,44.0,26,23,41,41,7,16,23,69.0,759.0,1602,658,1146,1804,4000.0,82,5.24,53,338,2262,9.5
17205,Mark Messier,2005-06,45.0,27,40,78,78,18,22,40,117.0,1453.0,1680,676,1168,1844,4117.0,82,5.31,60,363,2326,9.4
17206,Mark Messier,2006-07,46.0,28,43,76,76,18,25,43,104.0,1253.0,1756,694,1193,1887,4221.0,82,5.14,57,348,2300,9.2
17207,Mark Morrison,1984-85,21.0,4,2,9,9,1,1,2,6.0,,9,1,1,2,6.0,80,8.03,73,320,2489,12.9
17208,Mark Morrison,1986-87,23.0,5,0,1,1,0,0,0,5.0,,10,1,1,2,11.0,80,7.89,74,336,2448,12.9
17209,Mark Mowers,2001-02,27.0,4,6,30,30,0,6,6,24.0,281.0,30,0,6,6,24.0,82,5.27,57,359,2285,9.4
17210,Mark Mowers,2002-03,28.0,5,9,41,41,4,5,9,50.0,449.0,71,4,11,15,74.0,82,5.49,53,331,2294,9.8
17211,Mark Mowers,2004-05,30.0,6,3,14,14,1,2,3,5.0,119.0,85,5,13,18,79.0,82,5.24,53,338,2262,9.5
17212,Mark Mowers,2006-07,32.0,7,11,52,52,3,8,11,48.0,544.0,137,8,21,29,127.0,82,5.14,57,348,2300,9.2
17213,Mark Mowers,2008-09,34.0,8,15,46,46,4,11,15,65.0,382.0,183,12,32,44,192.0,82,6.05,85,480,2458,10.1
17214,Mark Mowers,2009-10,35.0,9,17,78,78,5,12,17,60.0,936.0,261,17,44,61,252.0,82,5.76,70,398,2426,9.7
17215,Mark Mowers,2010-11,36.0,10,1,17,17,1,0,1,6.0,154.0,278,18,44,62,258.0,82,5.44,62,351,2383,9.4
17216,Mark Olver,2013-14,26.0,4,9,18,18,2,7,9,25.0,214.0,18,2,7,9,25.0,82,5.46,52,291,2492,9.0
17217,Mark Olver,2014-15,27.0,5,7,24,24,4,3,7,25.0,311.0,42,6,10,16,50.0,82,5.32,47,271,2439,8.9
17218,Mark Olver,2015-16,28.0,6,6,32,32,4,2,6,33.0,289.0,74,10,12,22,83.0,48,5.31,29,160,1399,9.1
17219,Mark Osborne,1984-85,23.0,4,67,80,80,26,41,67,181.0,,80,26,41,67,181.0,80,8.03,73,320,2489,12.9
17220,Mark Osborne,1985-86,24.0,5,43,80,80,19,24,43,159.0,,160,45,65,110,340.0,80,7.73,71,310,2444,12.7
17221,Mark Osborne,1986-87,25.0,6,51,73,73,23,28,51,139.0,,233,68,93,161,479.0,80,7.89,74,336,2448,12.9
17222,Mark Osborne,1987-88,26.0,7,8,23,23,4,4,8,29.0,,256,72,97,169,508.0,80,7.77,71,321,2447,12.7
17223,Mark Osborne,1988-89,27.0,8,40,62,62,16,24,40,134.0,,318,88,121,209,642.0,80,7.94,82,370,2484,12.8
17224,Mark Osborne,1989-90,28.0,9,47,74,74,22,25,47,160.0,,392,110,146,256,802.0,80,7.34,72,344,2400,12.2
17225,Mark Osborne,1990-91,29.0,10,60,79,79,23,37,60,155.0,,471,133,183,316,957.0,80,7.43,89,437,2435,12.2
17226,Mark Osborne,1991-92,30.0,11,46,75,75,16,30,46,118.0,,546,149,213,362,1075.0,80,7.48,85,403,2430,12.3
17227,Mark Osborne,1992-93,31.0,12,73,78,78,23,50,73,137.0,,624,172,263,435,1212.0,80,7.37,76,367,2421,12.2
17228,Mark Osborne,1993-94,32.0,13,22,55,55,11,11,22,87.0,,679,183,274,457,1299.0,80,6.91,71,366,2385,11.6
17229,Mark Osborne,1994-95,33.0,14,20,54,54,7,13,20,66.0,,733,190,287,477,1365.0,80,6.96,77,402,2440,11.4
17230,Mark Osborne,1995-96,34.0,15,26,76,76,12,14,26,110.0,,809,202,301,503,1475.0,84,7.25,87,443,2603,11.7
17231,Mark Osborne,1996-97,35.0,16,24,73,73,9,15,24,103.0,,882,211,316,527,1578.0,84,6.48,76,407,2545,10.7
17232,Mark Osborne,1997-98,36.0,17,4,37,37,1,3,4,32.0,,919,212,319,531,1610.0,48,5.97,37,209,1408,10.2
17233,Mark Osiecki,1994-95,26.0,4,9,50,50,2,7,9,44.0,,50,2,7,9,44.0,80,6.96,77,402,2440,11.4
17234,Mark Osiecki,1995-96,27.0,5,5,43,43,1,4,5,26.0,,93,3,11,14,70.0,84,7.25,87,443,2603,11.7
17235,Mark Parrish,2001-02,24.0,4,37,73,73,24,13,37,129.0,1021.0,73,24,13,37,129.0,82,5.27,57,359,2285,9.4
17236,Mark Parrish,2002-03,25.0,5,44,81,81,26,18,44,152.0,1139.0,154,50,31,81,281.0,82,5.49,53,331,2294,9.8
17237,Mark Parrish,2003-04,26.0,6,30,70,70,17,13,30,123.0,1082.0,224,67,44,111,404.0,82,5.51,63,376,2272,9.9
17238,Mark Parrish,2004-05,27.0,7,60,78,78,30,30,60,162.0,1311.0,302,97,74,171,566.0,82,5.24,53,338,2262,9.5
17239,Mark Parrish,2005-06,28.0,8,48,81,81,23,25,48,147.0,1312.0,383,120,99,219,713.0,82,5.31,60,363,2326,9.4
17240,Mark Parrish,2006-07,29.0,9,35,59,59,24,11,35,105.0,1023.0,442,144,110,254,818.0,82,5.14,57,348,2300,9.2
17241,Mark Parrish,2008-09,31.0,10,49,76,76,29,20,49,137.0,1409.0,518,173,130,303,955.0,82,6.05,85,480,2458,10.1
17242,Mark Parrish,2009-10,32.0,11,39,76,76,19,20,39,141.0,1089.0,594,192,150,342,1096.0,82,5.76,70,398,2426,9.7
17243,Mark Parrish,2010-11,33.0,12,30,66,66,16,14,30,95.0,986.0,660,208,164,372,1191.0,82,5.44,62,351,2383,9.4
17244,Mark Parrish,2011-12,34.0,13,13,44,44,8,5,13,46.0,496.0,704,216,169,385,1237.0,82,5.7,65,341,2477,9.4
17245,Mark Parrish,2012-13,35.0,14,2,16,16,0,2,2,10.0,243.0,720,216,171,387,1247.0,82,5.53,56,304,2486,9.1
17246,Mark Parrish,2013-14,36.0,15,0,2,2,0,0,0,0.0,24.0,722,216,171,387,1247.0,82,5.46,52,291,2492,9.0
17247,Mark Paterson,1985-86,21.0,4,0,2,2,0,0,0,1.0,,2,0,0,0,1.0,80,7.73,71,310,2444,12.7
17248,Mark Paterson,1986-87,22.0,5,2,9,9,2,0,2,10.0,,11,2,0,2,11.0,80,7.89,74,336,2448,12.9
17249,Mark Paterson,1987-88,23.0,6,4,13,13,1,3,4,9.0,,24,3,3,6,20.0,80,7.77,71,321,2447,12.7
17250,Mark Paterson,1988-89,24.0,7,0,5,5,0,0,0,0.0,,29,3,3,6,20.0,80,7.94,82,370,2484,12.8
17251,Mark Pavelich,1984-85,26.0,4,76,79,79,33,43,76,181.0,,79,33,43,76,181.0,80,8.03,73,320,2489,12.9
17252,Mark Pavelich,1985-86,27.0,5,75,78,78,37,38,75,154.0,,157,70,81,151,335.0,80,7.73,71,310,2444,12.7
17253,Mark Pavelich,1986-87,28.0,6,82,77,77,29,53,82,163.0,,234,99,134,233,498.0,80,7.89,74,336,2448,12.9
17254,Mark Pavelich,1987-88,29.0,7,45,48,48,14,31,45,87.0,,282,113,165,278,585.0,80,7.77,71,321,2447,12.7
17255,Mark Pavelich,1988-89,30.0,8,40,59,59,20,20,40,104.0,,341,133,185,318,689.0,80,7.94,82,370,2484,12.8
17256,Mark Pavelich,1989-90,31.0,9,10,12,12,4,6,10,25.0,,353,137,191,328,714.0,80,7.34,72,344,2400,12.2
17257,Mark Pavelich,1994-95,36.0,10,1,2,2,0,1,1,0.0,,355,137,192,329,714.0,80,6.96,77,402,2440,11.4
17258,Mark Pederson,1992-93,25.0,4,2,9,9,0,2,2,10.0,,9,0,2,2,10.0,80,7.37,76,367,2421,12.2
17259,Mark Pederson,1993-94,26.0,5,26,59,59,10,16,26,76.0,,68,10,18,28,86.0,80,6.91,71,366,2385,11.6
17260,Mark Pederson,1994-95,27.0,6,40,58,58,15,25,40,94.0,,126,25,43,68,180.0,80,6.96,77,402,2440,11.4
17261,Mark Pederson,1995-96,28.0,7,17,41,41,10,7,17,63.0,,167,35,50,85,243.0,84,7.25,87,443,2603,11.7
17262,Mark Pederson,1996-97,29.0,8,0,2,2,0,0,0,0.0,,169,35,50,85,243.0,84,6.48,76,407,2545,10.7
17263,Mark Plantery,1983-84,24.0,4,6,25,25,1,5,6,18.0,,25,1,5,6,18.0,80,7.69,77,340,2441,12.6
17264,Mark Popovic,2006-07,24.0,4,0,1,1,0,0,0,1.0,14.0,1,0,0,0,1.0,82,5.14,57,348,2300,9.2
17265,Mark Popovic,2008-09,26.0,5,0,7,7,0,0,0,6.0,77.0,8,0,0,0,7.0,82,6.05,85,480,2458,10.1
17266,Mark Popovic,2009-10,27.0,6,1,3,3,0,1,1,1.0,31.0,11,0,1,1,8.0,82,5.76,70,398,2426,9.7
17267,Mark Popovic,2010-11,28.0,7,2,33,33,0,2,2,25.0,478.0,44,0,3,3,33.0,82,5.44,62,351,2383,9.4
17268,Mark Popovic,2012-13,30.0,8,4,37,37,2,2,4,24.0,547.0,81,2,5,7,57.0,82,5.53,56,304,2486,9.1
17269,Mark Pysyk,2015-16,24.0,4,5,19,19,1,4,5,21.0,309.0,19,1,4,5,21.0,48,5.31,29,160,1399,9.1
17270,Mark Pysyk,2016-17,25.0,5,7,44,44,1,6,7,51.0,863.0,63,2,10,12,72.0,82,5.34,48,269,2463,8.9
17271,Mark Pysyk,2017-18,26.0,6,3,7,7,2,1,3,4.0,127.0,70,4,11,15,76.0,82,5.32,47,251,2453,8.9
17272,Mark Pysyk,2018-19,27.0,7,11,55,55,1,10,11,44.0,875.0,125,5,21,26,120.0,82,5.34,48,255,2438,9.0
17273,Mark Pysyk,2019-20,28.0,8,17,82,82,4,13,17,86.0,1522.0,207,9,34,43,206.0,82,5.45,47,245,2478,9.0
17274,Mark Pysyk,2020-21,29.0,9,16,82,82,3,13,16,106.0,1538.0,289,12,47,59,312.0,82,5.86,50,250,2620,9.2
17275,Mark Pysyk,2021-22,30.0,10,11,70,70,1,10,11,64.0,1279.0,359,13,57,70,376.0,82,5.96,47,239,2579,9.5
17276,Mark Pysyk,2022-23,31.0,11,18,58,58,9,9,18,64.0,740.0,417,22,66,88,440.0,70,5.96,42,208,2192,9.5
17277,Mark Recchi,1991-92,23.0,4,2,15,15,1,1,2,11.0,,15,1,1,2,11.0,80,7.48,85,403,2430,12.3
17278,Mark Recchi,1992-93,24.0,5,67,74,74,30,37,67,143.0,,89,31,38,69,154.0,80,7.37,76,367,2421,12.2
17279,Mark Recchi,1993-94,25.0,6,113,78,78,40,73,113,184.0,,167,71,111,182,338.0,80,6.91,71,366,2385,11.6
17280,Mark Recchi,1994-95,26.0,7,97,80,80,43,54,97,210.0,,247,114,165,279,548.0,80,6.96,77,402,2440,11.4
17281,Mark Recchi,1995-96,27.0,8,123,84,84,53,70,123,274.0,,331,167,235,402,822.0,84,7.25,87,443,2603,11.7
17282,Mark Recchi,1996-97,28.0,9,107,84,84,40,67,107,217.0,,415,207,302,509,1039.0,84,6.48,76,407,2545,10.7
17283,Mark Recchi,1997-98,29.0,10,48,49,49,16,32,48,121.0,,464,223,334,557,1160.0,48,5.97,37,209,1408,10.2
17284,Mark Recchi,1998-99,30.0,11,78,82,82,28,50,78,191.0,,546,251,384,635,1351.0,82,6.29,74,413,2481,10.4
17285,Mark Recchi,1999-00,31.0,12,80,82,82,34,46,80,202.0,,628,285,430,715,1553.0,82,5.83,55,336,2444,9.8
17286,Mark Recchi,2000-01,32.0,13,74,82,82,32,42,74,216.0,,710,317,472,789,1769.0,82,5.28,57,380,2242,9.6
17287,Mark Recchi,2001-02,33.0,14,53,71,71,16,37,53,171.0,1453.0,781,333,509,842,1940.0,82,5.27,57,359,2285,9.4
17288,Mark Recchi,2002-03,34.0,15,91,82,82,28,63,91,223.0,1781.0,863,361,572,933,2163.0,82,5.49,53,331,2294,9.8
17289,Mark Recchi,2003-04,35.0,16,77,69,69,27,50,77,191.0,1495.0,932,388,622,1010,2354.0,82,5.51,63,376,2272,9.9
17290,Mark Recchi,2004-05,36.0,17,64,80,80,22,42,64,205.0,1653.0,1012,410,664,1074,2559.0,82,5.24,53,338,2262,9.5
17291,Mark Recchi,2005-06,37.0,18,52,79,79,20,32,52,171.0,1488.0,1091,430,696,1126,2730.0,82,5.31,60,363,2326,9.4
17292,Mark Recchi,2006-07,38.0,19,75,82,82,26,49,75,167.0,1410.0,1173,456,745,1201,2897.0,82,5.14,57,348,2300,9.2
17293,Mark Recchi,2008-09,40.0,20,64,83,83,28,36,64,199.0,1693.0,1256,484,781,1265,3096.0,82,6.05,85,480,2458,10.1
17294,Mark Recchi,2009-10,41.0,21,68,82,82,24,44,68,190.0,1616.0,1338,508,825,1333,3286.0,82,5.76,70,398,2426,9.7
17295,Mark Recchi,2010-11,42.0,22,48,72,72,14,34,48,121.0,1287.0,1410,522,859,1381,3407.0,82,5.44,62,351,2383,9.4
17296,Mark Recchi,2011-12,43.0,23,61,80,80,23,38,61,129.0,1342.0,1490,545,897,1442,3536.0,82,5.7,65,341,2477,9.4
17297,Mark Recchi,2012-13,44.0,24,43,81,81,18,25,43,152.0,1381.0,1571,563,922,1485,3688.0,82,5.53,56,304,2486,9.1
17298,Mark Recchi,2013-14,45.0,25,48,81,81,14,34,48,132.0,1304.0,1652,577,956,1533,3820.0,82,5.46,52,291,2492,9.0
17299,Mark Reeds,1984-85,25.0,4,4,9,9,1,3,4,8.0,,9,1,3,4,8.0,80,8.03,73,320,2489,12.9
17300,Mark Reeds,1985-86,26.0,5,19,20,20,5,14,19,35.0,,29,6,17,23,43.0,80,7.73,71,310,2444,12.7
17301,Mark Reeds,1986-87,27.0,6,25,65,65,11,14,25,72.0,,94,17,31,48,115.0,80,7.89,74,336,2448,12.9
17302,Mark Reeds,1987-88,28.0,7,39,80,80,9,30,39,100.0,,174,26,61,87,215.0,80,7.77,71,321,2447,12.7
17303,Mark Reeds,1988-89,29.0,8,38,78,78,10,28,38,108.0,,252,36,89,125,323.0,80,7.94,82,370,2484,12.8
17304,Mark Reeds,1989-90,30.0,9,25,68,68,9,16,25,106.0,,320,45,105,150,429.0,80,7.34,72,344,2400,12.2
17305,Mark Reeds,1990-91,31.0,10,7,38,38,0,7,7,36.0,,358,45,112,157,465.0,80,7.43,89,437,2435,12.2
17306,Mark Reeds,1991-92,32.0,11,2,7,7,0,2,2,6.0,,365,45,114,159,471.0,80,7.48,85,403,2430,12.3
17307,Mark Renaud,1982-83,23.0,4,2,13,13,0,2,2,9.0,,13,0,2,2,9.0,80,7.03,61,280,2352,12.0
17308,Mark Renaud,1983-84,24.0,5,1,4,4,1,0,1,1.0,,17,1,2,3,10.0,80,7.69,77,340,2441,12.6
17309,Mark Renaud,1984-85,25.0,6,18,48,48,1,17,18,72.0,,65,2,19,21,82.0,80,8.03,73,320,2489,12.9
17310,Mark Renaud,1985-86,26.0,7,31,77,77,3,28,31,86.0,,142,5,47,52,168.0,80,7.73,71,310,2444,12.7
17311,Mark Renaud,1986-87,27.0,8,4,10,10,1,3,4,10.0,,152,6,50,56,178.0,80,7.89,74,336,2448,12.9
17312,Mark Rycroft,2004-05,26.0,4,3,9,9,0,3,3,14.0,88.0,9,0,3,3,14.0,82,5.24,53,338,2262,9.5
17313,Mark Rycroft,2006-07,28.0,5,21,71,71,9,12,21,110.0,1021.0,80,9,15,24,124.0,82,5.14,57,348,2300,9.2
17314,Mark Rycroft,2008-09,30.0,6,10,80,80,6,4,10,77.0,836.0,160,15,19,34,201.0,82,6.05,85,480,2458,10.1
17315,Mark Rycroft,2009-10,31.0,7,12,66,66,6,6,12,74.0,622.0,226,21,25,46,275.0,82,5.76,70,398,2426,9.7
17316,Mark Scheifele,2014-15,21.0,4,1,7,7,1,0,1,5.0,77.0,7,1,0,1,5.0,82,5.32,47,271,2439,8.9
17317,Mark Scheifele,2015-16,22.0,5,0,4,4,0,0,0,6.0,46.0,11,1,0,1,11.0,48,5.31,29,160,1399,9.1
17318,Mark Scheifele,2016-17,23.0,6,34,63,63,13,21,34,100.0,1031.0,74,14,21,35,111.0,82,5.34,48,269,2463,8.9
17319,Mark Scheifele,2017-18,24.0,7,49,82,82,15,34,49,170.0,1524.0,156,29,55,84,281.0,82,5.32,47,251,2453,8.9
17320,Mark Scheifele,2018-19,25.0,8,61,71,71,29,32,61,194.0,1317.0,227,58,87,145,475.0,82,5.34,48,255,2438,9.0
17321,Mark Scheifele,2019-20,26.0,9,82,79,79,32,50,82,160.0,1624.0,306,90,137,227,635.0,82,5.45,47,245,2478,9.0
17322,Mark Scheifele,2020-21,27.0,10,60,60,60,23,37,60,125.0,1241.0,366,113,174,287,760.0,82,5.86,50,250,2620,9.2
17323,Mark Scheifele,2021-22,28.0,11,84,82,82,38,46,84,199.0,1793.0,448,151,220,371,959.0,82,5.96,47,239,2579,9.5
17324,Mark Scheifele,2022-23,29.0,12,73,71,71,29,44,73,170.0,1548.0,519,180,264,444,1129.0,70,5.96,42,208,2192,9.5
17325,Mark Smith,2003-04,26.0,4,4,42,42,2,2,4,39.0,370.0,42,2,2,4,39.0,82,5.51,63,376,2272,9.9
17326,Mark Smith,2004-05,27.0,5,6,49,49,3,3,6,40.0,395.0,91,5,5,10,79.0,82,5.24,53,338,2262,9.5
17327,Mark Smith,2005-06,28.0,6,15,75,75,4,11,15,68.0,701.0,166,9,16,25,147.0,82,5.31,60,363,2326,9.4
17328,Mark Smith,2006-07,29.0,7,4,36,36,1,3,4,31.0,301.0,202,10,19,29,178.0,82,5.14,57,348,2300,9.2
17329,Mark Smith,2008-09,31.0,8,24,80,80,9,15,24,100.0,964.0,282,19,34,53,278.0,82,6.05,85,480,2458,10.1
17330,Mark Smith,2009-10,32.0,9,13,41,41,3,10,13,38.0,427.0,323,22,44,66,316.0,82,5.76,70,398,2426,9.7
17331,Mark Smith,2010-11,33.0,10,4,54,54,1,3,4,27.0,320.0,377,23,47,70,343.0,82,5.44,62,351,2383,9.4
17332,Mark Stone,2015-16,23.0,4,0,4,4,0,0,0,3.0,40.0,4,0,0,0,3.0,48,5.31,29,160,1399,9.1
17333,Mark Stone,2016-17,24.0,5,8,19,19,4,4,8,36.0,275.0,23,4,4,8,39.0,82,5.34,48,269,2463,8.9
17334,Mark Stone,2017-18,25.0,6,64,80,80,26,38,64,157.0,1362.0,103,30,42,72,196.0,82,5.32,47,251,2453,8.9
17335,Mark Stone,2018-19,26.0,7,61,75,75,23,38,61,151.0,1508.0,178,53,80,133,347.0,82,5.34,48,255,2438,9.0
17336,Mark Stone,2019-20,27.0,8,54,71,71,22,32,54,134.0,1318.0,249,75,112,187,481.0,82,5.45,47,245,2478,9.0
17337,Mark Stone,2020-21,28.0,9,62,58,58,20,42,62,132.0,1199.0,307,95,154,249,613.0,82,5.86,50,250,2620,9.2
17338,Mark Stone,2021-22,29.0,10,73,77,77,33,40,73,199.0,1531.0,384,128,194,322,812.0,82,5.96,47,239,2579,9.5
17339,Mark Stone,2022-23,30.0,11,63,65,65,21,42,63,168.0,1262.0,449,149,236,385,980.0,70,5.96,42,208,2192,9.5
17340,Mark Streit,2008-09,31.0,4,11,48,48,2,9,11,52.0,700.0,48,2,9,11,52.0,82,6.05,85,480,2458,10.1
17341,Mark Streit,2009-10,32.0,5,36,76,76,10,26,36,102.0,1065.0,124,12,35,47,154.0,82,5.76,70,398,2426,9.7
17342,Mark Streit,2010-11,33.0,6,62,81,81,13,49,62,165.0,1419.0,205,25,84,109,319.0,82,5.44,62,351,2383,9.4
17343,Mark Streit,2011-12,34.0,7,56,74,74,16,40,56,150.0,1866.0,279,41,124,165,469.0,82,5.7,65,341,2477,9.4
17344,Mark Streit,2012-13,35.0,8,49,82,82,11,38,49,187.0,2107.0,361,52,162,214,656.0,82,5.53,56,304,2486,9.1
17345,Mark Streit,2014-15,37.0,9,47,82,82,7,40,47,149.0,1917.0,443,59,202,261,805.0,82,5.32,47,271,2439,8.9
17346,Mark Streit,2015-16,38.0,10,27,48,48,6,21,27,83.0,1121.0,491,65,223,288,888.0,48,5.31,29,160,1399,9.1
17347,Mark Streit,2016-17,39.0,11,44,82,82,10,34,44,121.0,1693.0,573,75,257,332,1009.0,82,5.34,48,269,2463,8.9
17348,Mark Streit,2017-18,40.0,12,52,81,81,9,43,52,144.0,1812.0,654,84,300,384,1153.0,82,5.32,47,251,2453,8.9
17349,Mark Streit,2018-19,41.0,13,23,62,62,6,17,23,110.0,1356.0,716,90,317,407,1263.0,82,5.34,48,255,2438,9.0
17350,Mark Streit,2019-20,42.0,14,27,68,68,6,21,27,114.0,1275.0,784,96,338,434,1377.0,82,5.45,47,245,2478,9.0
17351,Mark Streit,2020-21,43.0,15,0,2,2,0,0,0,3.0,28.0,786,96,338,434,1380.0,82,5.86,50,250,2620,9.2
17352,Mark Stuart,2008-09,24.0,4,2,17,17,1,1,2,9.0,302.0,17,1,1,2,9.0,82,6.05,85,480,2458,10.1
17353,Mark Stuart,2009-10,25.0,5,1,15,15,0,1,1,4.0,156.0,32,1,2,3,13.0,82,5.76,70,398,2426,9.7
17354,Mark Stuart,2010-11,26.0,6,8,82,82,4,4,8,60.0,1261.0,114,5,6,11,73.0,82,5.44,62,351,2383,9.4
17355,Mark Stuart,2011-12,27.0,7,17,82,82,5,12,17,61.0,1264.0,196,10,18,28,134.0,82,5.7,65,341,2477,9.4
17356,Mark Stuart,2012-13,28.0,8,7,56,56,2,5,7,53.0,953.0,252,12,23,35,187.0,82,5.53,56,304,2486,9.1
17357,Mark Stuart,2013-14,29.0,9,6,54,54,2,4,6,41.0,845.0,306,14,27,41,228.0,82,5.46,52,291,2492,9.0
17358,Mark Stuart,2014-15,30.0,10,14,80,80,3,11,14,60.0,1376.0,386,17,38,55,288.0,82,5.32,47,271,2439,8.9
17359,Mark Stuart,2015-16,31.0,11,4,42,42,2,2,4,40.0,702.0,428,19,40,59,328.0,48,5.31,29,160,1399,9.1
17360,Mark Stuart,2016-17,32.0,12,13,69,69,2,11,13,73.0,1286.0,497,21,51,72,401.0,82,5.34,48,269,2463,8.9
17361,Mark Stuart,2017-18,33.0,13,14,70,70,2,12,14,51.0,1345.0,567,23,63,86,452.0,82,5.32,47,251,2453,8.9
17362,Mark Stuart,2018-19,34.0,14,3,64,64,1,2,3,39.0,1046.0,631,24,65,89,491.0,82,5.34,48,255,2438,9.0
17363,Mark Stuart,2019-20,35.0,15,4,42,42,2,2,4,24.0,523.0,673,26,67,93,515.0,82,5.45,47,245,2478,9.0
17364,Mark Taylor,1984-85,27.0,4,0,2,2,0,0,0,1.0,,2,0,0,0,1.0,80,8.03,73,320,2489,12.9
17365,Mark Taylor,1985-86,28.0,5,33,61,61,8,25,33,72.0,,63,8,25,33,73.0,80,7.73,71,310,2444,12.7
17366,Mark Taylor,1986-87,29.0,6,55,60,60,24,31,55,107.0,,123,32,56,88,180.0,80,7.89,74,336,2448,12.9
17367,Mark Taylor,1987-88,30.0,7,19,56,56,8,11,19,55.0,,179,40,67,107,235.0,80,7.77,71,321,2447,12.7
17368,Mark Taylor,1988-89,31.0,8,3,30,30,2,1,3,23.0,,209,42,68,110,258.0,80,7.94,82,370,2484,12.8
17369,Mark Tinordi,1990-91,24.0,4,3,24,24,1,2,3,13.0,,24,1,2,3,13.0,80,7.43,89,437,2435,12.2
17370,Mark Tinordi,1991-92,25.0,5,5,47,47,2,3,5,39.0,,71,3,5,8,52.0,80,7.48,85,403,2430,12.3
17371,Mark Tinordi,1992-93,26.0,6,10,66,66,3,7,10,50.0,,137,6,12,18,102.0,80,7.37,76,367,2421,12.2
17372,Mark Tinordi,1993-94,27.0,7,32,69,69,5,27,32,92.0,,206,11,39,50,194.0,80,6.91,71,366,2385,11.6
17373,Mark Tinordi,1994-95,28.0,8,28,63,63,4,24,28,93.0,,269,15,63,78,287.0,80,6.96,77,402,2440,11.4
17374,Mark Tinordi,1995-96,29.0,9,42,69,69,15,27,42,122.0,,338,30,90,120,409.0,84,7.25,87,443,2603,11.7
17375,Mark Tinordi,1996-97,30.0,10,24,61,61,6,18,24,112.0,,399,36,108,144,521.0,84,6.48,76,407,2545,10.7
17376,Mark Tinordi,1997-98,31.0,11,12,42,42,3,9,12,71.0,,441,39,117,156,592.0,48,5.97,37,209,1408,10.2
17377,Mark Tinordi,1998-99,32.0,12,13,71,71,3,10,13,82.0,,512,42,127,169,674.0,82,6.29,74,413,2481,10.4
17378,Mark Tinordi,1999-00,33.0,13,8,56,56,2,6,8,53.0,,568,44,133,177,727.0,82,5.83,55,336,2444,9.8
17379,Mark Tinordi,2000-01,34.0,14,17,47,47,8,9,17,57.0,,615,52,142,194,784.0,82,5.28,57,380,2242,9.6
17380,Mark Tinordi,2001-02,35.0,15,6,48,48,0,6,6,32.0,980.0,663,52,148,200,816.0,82,5.27,57,359,2285,9.4
17381,Mark Van Guilder,2016-17,33.0,4,0,1,1,0,0,0,0.0,8.0,1,0,0,0,0.0,82,5.34,48,269,2463,8.9
17382,Mark Vermette,1991-92,24.0,4,4,12,12,0,4,4,10.0,,12,0,4,4,10.0,80,7.48,85,403,2430,12.3
17383,Mark Vermette,1992-93,25.0,5,6,11,11,1,5,6,16.0,,23,1,9,10,26.0,80,7.37,76,367,2421,12.2
17384,Mark Vermette,1993-94,26.0,6,7,34,34,3,4,7,42.0,,57,4,13,17,68.0,80,6.91,71,366,2385,11.6
17385,Mark Vermette,1994-95,27.0,7,1,10,10,1,0,1,12.0,,67,5,13,18,80.0,80,6.96,77,402,2440,11.4
17386,Mark Visheau,1996-97,23.0,4,0,1,1,0,0,0,1.0,,1,0,0,0,1.0,84,6.48,76,407,2545,10.7
17387,Mark Visheau,2001-02,28.0,5,4,28,28,1,3,4,10.0,267.0,29,1,3,4,11.0,82,5.27,57,359,2285,9.4
17388,Mark Wotton,1997-98,24.0,4,0,1,1,0,0,0,2.0,,1,0,0,0,2.0,48,5.97,37,209,1408,10.2
17389,Mark Wotton,1999-00,26.0,5,9,36,36,3,6,9,41.0,,37,3,6,9,43.0,82,5.83,55,336,2444,9.8
17390,Mark Wotton,2000-01,27.0,6,0,5,5,0,0,0,3.0,,42,3,6,9,46.0,82,5.28,57,380,2242,9.6
17391,Mark Wotton,2003-04,30.0,7,0,1,1,0,0,0,0.0,14.0,43,3,6,9,46.0,82,5.51,63,376,2272,9.9
17392,Markku Kyllonen,1991-92,29.0,4,2,9,9,0,2,2,7.0,,9,0,2,2,7.0,80,7.48,85,403,2430,12.3
17393,Marko Daňo,2017-18,23.0,4,21,35,35,8,13,21,84.0,464.0,35,8,13,21,84.0,82,5.32,47,251,2453,8.9
17394,Marko Daňo,2018-19,24.0,5,10,34,34,5,5,10,54.0,417.0,69,13,18,31,138.0,82,5.34,48,255,2438,9.0
17395,Marko Daňo,2019-20,25.0,6,11,38,38,4,7,11,44.0,406.0,107,17,25,42,182.0,82,5.45,47,245,2478,9.0
17396,Marko Daňo,2020-21,26.0,7,3,23,23,2,1,3,22.0,165.0,130,19,26,45,204.0,82,5.86,50,250,2620,9.2
17397,Marko Daňo,2021-22,27.0,8,0,8,8,0,0,0,3.0,55.0,138,19,26,45,207.0,82,5.96,47,239,2579,9.5
17398,Marko Daňo,2022-23,28.0,9,0,3,3,0,0,0,2.0,22.0,141,19,26,45,209.0,70,5.96,42,208,2192,9.5
17399,Marko Jantunen,1999-00,28.0,4,0,3,3,0,0,0,7.0,,3,0,0,0,7.0,82,5.83,55,336,2444,9.8
17400,Marko Kiprusoff,1998-99,26.0,4,4,24,24,0,4,4,36.0,,24,0,4,4,36.0,82,6.29,74,413,2481,10.4
17401,Marko Kiprusoff,2004-05,32.0,5,6,27,27,0,6,6,17.0,378.0,51,0,10,10,53.0,82,5.24,53,338,2262,9.5
17402,Marko Tuomainen,1997-98,25.0,4,0,4,4,0,0,0,5.0,,4,0,0,0,5.0,48,5.97,37,209,1408,10.2
17403,Marko Tuomainen,2002-03,30.0,5,17,63,63,9,8,17,74.0,725.0,67,9,8,17,79.0,82,5.49,53,331,2294,9.8
17404,Marko Tuomainen,2003-04,31.0,6,1,11,11,0,1,1,12.0,103.0,78,9,9,18,91.0,82,5.51,63,376,2272,9.9
17405,Marko Tuomainen,2004-05,32.0,7,0,1,1,0,0,0,0.0,7.0,79,9,9,18,91.0,82,5.24,53,338,2262,9.5
17406,Markus Granlund,2016-17,23.0,4,3,7,7,2,1,3,9.0,85.0,7,2,1,3,9.0,82,5.34,48,269,2463,8.9
17407,Markus Granlund,2017-18,24.0,5,18,48,48,8,10,18,65.0,642.0,55,10,11,21,74.0,82,5.32,47,251,2453,8.9
17408,Markus Granlund,2018-19,25.0,6,10,47,47,6,4,10,56.0,648.0,102,16,15,31,130.0,82,5.34,48,255,2438,9.0
17409,Markus Granlund,2019-20,26.0,7,32,69,69,19,13,32,122.0,1194.0,171,35,28,63,252.0,82,5.45,47,245,2478,9.0
17410,Markus Granlund,2020-21,27.0,8,12,53,53,8,4,12,93.0,862.0,224,43,32,75,345.0,82,5.86,50,250,2620,9.2
17411,Markus Granlund,2021-22,28.0,9,22,77,77,12,10,22,123.0,1158.0,301,55,42,97,468.0,82,5.96,47,239,2579,9.5
17412,Markus Granlund,2022-23,29.0,10,4,34,34,3,1,4,26.0,368.0,335,58,43,101,494.0,70,5.96,42,208,2192,9.5
17413,Markus Hannikainen,2018-19,25.0,4,0,4,4,0,0,0,3.0,29.0,4,0,0,0,3.0,82,5.34,48,255,2438,9.0
17414,Markus Hannikainen,2019-20,26.0,5,2,10,10,1,1,2,8.0,91.0,14,1,1,2,11.0,82,5.45,47,245,2478,9.0
17415,Markus Hannikainen,2020-21,27.0,6,6,33,33,3,3,6,31.0,276.0,47,4,4,8,42.0,82,5.86,50,250,2620,9.2
17416,Markus Hannikainen,2021-22,28.0,7,7,44,44,4,3,7,52.0,417.0,91,8,7,15,94.0,82,5.96,47,239,2579,9.5
17417,Markus Naslund,1996-97,23.0,4,11,71,71,4,7,11,80.0,,71,4,7,11,80.0,84,6.48,76,407,2545,10.7
17418,Markus Naslund,1997-98,24.0,5,4,14,14,2,2,4,13.0,,85,6,9,15,93.0,48,5.97,37,209,1408,10.2
17419,Markus Naslund,1998-99,25.0,6,55,76,76,22,33,55,144.0,,161,28,42,70,237.0,82,6.29,74,413,2481,10.4
17420,Markus Naslund,1999-00,26.0,7,41,78,78,21,20,41,120.0,,239,49,62,111,357.0,82,5.83,55,336,2444,9.8
17421,Markus Naslund,2000-01,27.0,8,34,76,76,14,20,34,106.0,,315,63,82,145,463.0,82,5.28,57,380,2242,9.6
17422,Markus Naslund,2001-02,28.0,9,66,80,80,36,30,66,205.0,1596.0,395,99,112,211,668.0,82,5.27,57,359,2285,9.4
17423,Markus Naslund,2002-03,29.0,10,65,82,82,27,38,65,271.0,1657.0,477,126,150,276,939.0,82,5.49,53,331,2294,9.8
17424,Markus Naslund,2003-04,30.0,11,75,72,72,41,34,75,277.0,1371.0,549,167,184,351,1216.0,82,5.51,63,376,2272,9.9
17425,Markus Naslund,2004-05,31.0,12,90,81,81,40,50,90,302.0,1580.0,630,207,234,441,1518.0,82,5.24,53,338,2262,9.5
17426,Markus Naslund,2005-06,32.0,13,104,82,82,48,56,104,294.0,1632.0,712,255,290,545,1812.0,82,5.31,60,363,2326,9.4
17427,Markus Naslund,2006-07,33.0,14,84,78,78,35,49,84,296.0,1512.0,790,290,339,629,2108.0,82,5.14,57,348,2300,9.2
17428,Markus Naslund,2008-09,35.0,15,79,81,81,32,47,79,264.0,1496.0,871,322,386,708,2372.0,82,6.05,85,480,2458,10.1
17429,Markus Naslund,2009-10,36.0,16,60,82,82,24,36,60,222.0,1455.0,953,346,422,768,2594.0,82,5.76,70,398,2426,9.7
17430,Markus Naslund,2010-11,37.0,17,55,82,82,25,30,55,237.0,1425.0,1035,371,452,823,2831.0,82,5.44,62,351,2383,9.4
17431,Markus Naslund,2011-12,38.0,18,46,82,82,24,22,46,215.0,1409.0,1117,395,474,869,3046.0,82,5.7,65,341,2477,9.4
17432,Markus Nutivaara,2019-20,25.0,4,7,66,66,2,5,7,66.0,872.0,66,2,5,7,66.0,82,5.45,47,245,2478,9.0
17433,Markus Nutivaara,2020-21,26.0,5,23,61,61,7,16,23,79.0,978.0,127,9,21,30,145.0,82,5.86,50,250,2620,9.2
17434,Markus Nutivaara,2021-22,27.0,6,21,80,80,5,16,21,99.0,1414.0,207,14,37,51,244.0,82,5.96,47,239,2579,9.5
17435,Markus Nutivaara,2022-23,28.0,7,9,37,37,3,6,9,47.0,589.0,244,17,43,60,291.0,70,5.96,42,208,2192,9.5
17436,Marquis Mathieu,2001-02,28.0,4,0,9,9,0,0,0,4.0,66.0,9,0,0,0,4.0,82,5.27,57,359,2285,9.4
17437,Marquis Mathieu,2002-03,29.0,5,2,6,6,0,2,2,3.0,36.0,15,0,2,2,7.0,82,5.49,53,331,2294,9.8
17438,Marquis Mathieu,2003-04,30.0,6,0,1,1,0,0,0,0.0,7.0,16,0,2,2,7.0,82,5.51,63,376,2272,9.9
17439,Martin Cibak,2004-05,24.0,4,6,26,26,1,5,6,22.0,290.0,26,1,5,6,22.0,82,5.24,53,338,2262,9.5
17440,Martin Cibak,2006-07,26.0,5,9,63,63,2,7,9,44.0,478.0,89,3,12,15,66.0,82,5.14,57,348,2300,9.2
17441,Martin Cibak,2008-09,28.0,6,8,65,65,2,6,8,50.0,429.0,154,5,18,23,116.0,82,6.05,85,480,2458,10.1
17442,Martin Desjardins,1992-93,26.0,4,2,8,8,0,2,2,7.0,,8,0,2,2,7.0,80,7.37,76,367,2421,12.2
17443,Martin Erat,2004-05,23.0,4,33,80,80,9,24,33,84.0,1053.0,80,9,24,33,84.0,82,5.24,53,338,2262,9.5
17444,Martin Erat,2005-06,24.0,5,8,27,27,1,7,8,39.0,345.0,107,10,31,41,123.0,82,5.31,60,363,2326,9.4
17445,Martin Erat,2006-07,25.0,6,49,76,76,16,33,49,137.0,1140.0,183,26,64,90,260.0,82,5.14,57,348,2300,9.2
17446,Martin Erat,2008-09,27.0,7,49,80,80,20,29,49,143.0,1180.0,263,46,93,139,403.0,82,6.05,85,480,2458,10.1
17447,Martin Erat,2009-10,28.0,8,57,68,68,16,41,57,132.0,1290.0,331,62,134,196,535.0,82,5.76,70,398,2426,9.7
17448,Martin Erat,2010-11,29.0,9,57,76,76,23,34,57,163.0,1418.0,407,85,168,253,698.0,82,5.44,62,351,2383,9.4
17449,Martin Erat,2011-12,30.0,10,50,71,71,17,33,50,149.0,1318.0,478,102,201,303,847.0,82,5.7,65,341,2477,9.4
17450,Martin Erat,2012-13,31.0,11,49,74,74,21,28,49,168.0,1331.0,552,123,229,352,1015.0,82,5.53,56,304,2486,9.1
17451,Martin Erat,2013-14,32.0,12,50,64,64,17,33,50,135.0,1158.0,616,140,262,402,1150.0,82,5.46,52,291,2492,9.0
17452,Martin Erat,2014-15,33.0,13,58,71,71,19,39,58,107.0,1312.0,687,159,301,460,1257.0,82,5.32,47,271,2439,8.9
17453,Martin Erat,2015-16,34.0,14,24,45,45,5,19,24,69.0,806.0,732,164,320,484,1326.0,48,5.31,29,160,1399,9.1
17454,Martin Erat,2016-17,35.0,15,29,70,70,3,26,29,53.0,1027.0,802,167,346,513,1379.0,82,5.34,48,269,2463,8.9
17455,Martin Erat,2017-18,36.0,16,32,79,79,9,23,32,91.0,1253.0,881,176,369,545,1470.0,82,5.32,47,251,2453,8.9
17456,Martin Fehervary,2022-23,23.0,4,1,6,6,0,1,1,7.0,96.0,6,0,1,1,7.0,70,5.96,42,208,2192,9.5
17457,Martin Frk,2019-20,26.0,4,0,2,2,0,0,0,1.0,17.0,2,0,0,0,1.0,82,5.45,47,245,2478,9.0
17458,Martin Frk,2020-21,27.0,5,25,68,68,11,14,25,99.0,700.0,70,11,14,25,100.0,82,5.86,50,250,2620,9.2
17459,Martin Frk,2021-22,28.0,6,6,30,30,1,5,6,28.0,276.0,100,12,19,31,128.0,82,5.96,47,239,2579,9.5
17460,Martin Frk,2022-23,29.0,7,8,17,17,6,2,8,26.0,235.0,117,18,21,39,154.0,70,5.96,42,208,2192,9.5
17461,Martin Gelinas,1991-92,21.0,4,3,6,6,1,2,3,14.0,,6,1,2,3,14.0,80,7.48,85,403,2430,12.3
17462,Martin Gelinas,1992-93,22.0,5,25,46,46,17,8,25,71.0,,52,18,10,28,85.0,80,7.37,76,367,2421,12.2
17463,Martin Gelinas,1993-94,23.0,6,40,73,73,20,20,40,124.0,,125,38,30,68,209.0,80,6.91,71,366,2385,11.6
17464,Martin Gelinas,1994-95,24.0,7,29,68,68,11,18,29,94.0,,193,49,48,97,303.0,80,6.96,77,402,2440,11.4
17465,Martin Gelinas,1995-96,25.0,8,23,65,65,11,12,23,93.0,,258,60,60,120,396.0,84,7.25,87,443,2603,11.7
17466,Martin Gelinas,1996-97,26.0,9,28,64,64,14,14,28,107.0,,322,74,74,148,503.0,84,6.48,76,407,2545,10.7
17467,Martin Gelinas,1997-98,27.0,10,23,46,46,13,10,23,75.0,,368,87,84,171,578.0,48,5.97,37,209,1408,10.2
17468,Martin Gelinas,1998-99,28.0,11,56,81,81,30,26,56,181.0,,449,117,110,227,759.0,82,6.29,74,413,2481,10.4
17469,Martin Gelinas,1999-00,29.0,12,68,74,74,35,33,68,177.0,,523,152,143,295,936.0,82,5.83,55,336,2444,9.8
17470,Martin Gelinas,2000-01,30.0,13,34,64,64,16,18,34,147.0,,587,168,161,329,1083.0,82,5.28,57,380,2242,9.6
17471,Martin Gelinas,2001-02,31.0,14,28,76,76,13,15,28,111.0,1004.0,663,181,176,357,1194.0,82,5.27,57,359,2285,9.4
17472,Martin Gelinas,2002-03,32.0,15,30,81,81,14,16,30,139.0,1106.0,744,195,192,387,1333.0,82,5.49,53,331,2294,9.8
17473,Martin Gelinas,2003-04,33.0,16,52,79,79,23,29,52,170.0,1414.0,823,218,221,439,1503.0,82,5.51,63,376,2272,9.9
17474,Martin Gelinas,2004-05,34.0,17,29,72,72,13,16,29,121.0,1158.0,895,231,237,468,1624.0,82,5.24,53,338,2262,9.5
17475,Martin Gelinas,2005-06,35.0,18,52,81,81,21,31,52,152.0,1341.0,976,252,268,520,1776.0,82,5.31,60,363,2326,9.4
17476,Martin Gelinas,2006-07,36.0,19,35,76,76,17,18,35,139.0,1127.0,1052,269,286,555,1915.0,82,5.14,57,348,2300,9.2
17477,Martin Gelinas,2008-09,38.0,20,41,82,82,17,24,41,186.0,1311.0,1134,286,310,596,2101.0,82,6.05,85,480,2458,10.1
17478,Martin Gelinas,2009-10,39.0,21,44,82,82,14,30,44,171.0,1101.0,1216,300,340,640,2272.0,82,5.76,70,398,2426,9.7
17479,Martin Gelinas,2010-11,40.0,22,20,57,57,9,11,20,110.0,805.0,1273,309,351,660,2382.0,82,5.44,62,351,2383,9.4
17480,Martin Gendron,1997-98,23.0,4,3,8,8,2,1,3,11.0,,8,2,1,3,11.0,48,5.97,37,209,1408,10.2
17481,Martin Gendron,1998-99,24.0,5,3,20,20,2,1,3,22.0,,28,4,2,6,33.0,82,6.29,74,413,2481,10.4
17482,Martin Gendron,2000-01,26.0,6,0,2,2,0,0,0,3.0,,30,4,2,6,36.0,82,5.28,57,380,2242,9.6
17483,Martin Grenier,2004-05,24.0,4,0,5,5,0,0,0,1.0,30.0,5,0,0,0,1.0,82,5.24,53,338,2262,9.5
17484,Martin Grenier,2005-06,25.0,5,0,3,3,0,0,0,0.0,19.0,8,0,0,0,1.0,82,5.31,60,363,2326,9.4
17485,Martin Grenier,2006-07,26.0,6,1,7,7,1,0,1,6.0,48.0,15,1,0,1,7.0,82,5.14,57,348,2300,9.2
17486,Martin Grenier,2009-10,29.0,7,0,3,3,0,0,0,0.0,14.0,18,1,0,1,7.0,82,5.76,70,398,2426,9.7
17487,Martin Hanzal,2010-11,23.0,4,35,72,72,8,27,35,111.0,1206.0,72,8,27,35,111.0,82,5.44,62,351,2383,9.4
17488,Martin Hanzal,2011-12,24.0,5,31,74,74,11,20,31,97.0,1210.0,146,19,47,66,208.0,82,5.7,65,341,2477,9.4
17489,Martin Hanzal,2012-13,25.0,6,33,81,81,11,22,33,147.0,1497.0,227,30,69,99,355.0,82,5.53,56,304,2486,9.1
17490,Martin Hanzal,2013-14,26.0,7,26,61,61,16,10,26,149.0,1190.0,288,46,79,125,504.0,82,5.46,52,291,2492,9.0
17491,Martin Hanzal,2014-15,27.0,8,34,64,64,8,26,34,145.0,1180.0,352,54,105,159,649.0,82,5.32,47,271,2439,8.9
17492,Martin Hanzal,2015-16,28.0,9,23,39,39,11,12,23,93.0,723.0,391,65,117,182,742.0,48,5.31,29,160,1399,9.1
17493,Martin Hanzal,2016-17,29.0,10,40,65,65,15,25,40,169.0,1214.0,456,80,142,222,911.0,82,5.34,48,269,2463,8.9
17494,Martin Hanzal,2017-18,30.0,11,24,37,37,8,16,24,85.0,656.0,493,88,158,246,996.0,82,5.32,47,251,2453,8.9
17495,Martin Hanzal,2018-19,31.0,12,41,64,64,13,28,41,141.0,1139.0,557,101,186,287,1137.0,82,5.34,48,255,2438,9.0
17496,Martin Hanzal,2019-20,32.0,13,39,71,71,20,19,39,169.0,1258.0,628,121,205,326,1306.0,82,5.45,47,245,2478,9.0
17497,Martin Hanzal,2020-21,33.0,14,10,38,38,5,5,10,62.0,536.0,666,126,210,336,1368.0,82,5.86,50,250,2620,9.2
17498,Martin Hanzal,2021-22,34.0,15,2,7,7,1,1,2,14.0,90.0,673,127,211,338,1382.0,82,5.96,47,239,2579,9.5
17499,Martin Havlat,2003-04,22.0,4,42,73,73,19,23,42,133.0,1006.0,73,19,23,42,133.0,82,5.51,63,376,2272,9.9
17500,Martin Havlat,2004-05,23.0,5,50,72,72,22,28,50,145.0,1063.0,145,41,51,92,278.0,82,5.24,53,338,2262,9.5
17501,Martin Havlat,2005-06,24.0,6,59,67,67,24,35,59,179.0,1102.0,212,65,86,151,457.0,82,5.31,60,363,2326,9.4
17502,Martin Havlat,2006-07,25.0,7,68,68,68,31,37,68,175.0,1138.0,280,96,123,219,632.0,82,5.14,57,348,2300,9.2
17503,Martin Havlat,2008-09,27.0,8,16,18,18,9,7,16,57.0,327.0,298,105,130,235,689.0,82,6.05,85,480,2458,10.1
17504,Martin Havlat,2009-10,28.0,9,57,56,56,25,32,57,176.0,1198.0,354,130,162,292,865.0,82,5.76,70,398,2426,9.7
17505,Martin Havlat,2010-11,29.0,10,27,35,35,10,17,27,87.0,650.0,389,140,179,319,952.0,82,5.44,62,351,2383,9.4
17506,Martin Havlat,2011-12,30.0,11,77,81,81,29,48,77,249.0,1410.0,470,169,227,396,1201.0,82,5.7,65,341,2477,9.4
17507,Martin Havlat,2012-13,31.0,12,54,73,73,18,36,54,169.0,1309.0,543,187,263,450,1370.0,82,5.53,56,304,2486,9.1
17508,Martin Havlat,2013-14,32.0,13,62,78,78,22,40,62,229.0,1431.0,621,209,303,512,1599.0,82,5.46,52,291,2492,9.0
17509,Martin Havlat,2014-15,33.0,14,27,39,39,7,20,27,96.0,687.0,660,216,323,539,1695.0,82,5.32,47,271,2439,8.9
17510,Martin Havlat,2015-16,34.0,15,18,40,40,8,10,18,89.0,634.0,700,224,333,557,1784.0,48,5.31,29,160,1399,9.1
17511,Martin Havlat,2016-17,35.0,16,22,48,48,12,10,22,72.0,707.0,748,236,343,579,1856.0,82,5.34,48,269,2463,8.9
17512,Martin Havlat,2017-18,36.0,17,14,40,40,5,9,14,49.0,592.0,788,241,352,593,1905.0,82,5.32,47,251,2453,8.9
17513,Martin Havlat,2018-19,37.0,18,1,2,2,1,0,1,3.0,22.0,790,242,352,594,1908.0,82,5.34,48,255,2438,9.0
17514,Martin Hostak,1993-94,26.0,4,13,50,50,3,10,13,64.0,,50,3,10,13,64.0,80,6.91,71,366,2385,11.6
17515,Martin Hostak,1994-95,27.0,5,1,5,5,0,1,1,8.0,,55,3,11,14,72.0,80,6.96,77,402,2440,11.4
17516,Martin Kaut,2022-23,23.0,4,3,9,9,2,1,3,13.0,91.0,9,2,1,3,13.0,70,5.96,42,208,2192,9.5
17517,Martin Lapointe,1994-95,21.0,4,1,4,4,0,1,1,2.0,,4,0,1,1,2.0,80,6.96,77,402,2440,11.4
17518,Martin Lapointe,1995-96,22.0,5,0,3,3,0,0,0,2.0,,7,0,1,1,4.0,84,7.25,87,443,2603,11.7
17519,Martin Lapointe,1996-97,23.0,6,16,50,50,8,8,16,45.0,,57,8,9,17,49.0,84,6.48,76,407,2545,10.7
17520,Martin Lapointe,1997-98,24.0,7,10,39,39,4,6,10,46.0,,96,12,15,27,95.0,48,5.97,37,209,1408,10.2
17521,Martin Lapointe,1998-99,25.0,8,9,58,58,6,3,9,76.0,,154,18,18,36,171.0,82,6.29,74,413,2481,10.4
17522,Martin Lapointe,1999-00,26.0,9,33,78,78,16,17,33,149.0,,232,34,35,69,320.0,82,5.83,55,336,2444,9.8
17523,Martin Lapointe,2000-01,27.0,10,34,79,79,15,19,34,154.0,,311,49,54,103,474.0,82,5.28,57,380,2242,9.6
17524,Martin Lapointe,2001-02,28.0,11,29,77,77,16,13,29,153.0,1163.0,388,65,67,132,627.0,82,5.27,57,359,2285,9.4
17525,Martin Lapointe,2002-03,29.0,12,41,82,82,16,25,41,127.0,1207.0,470,81,92,173,754.0,82,5.49,53,331,2294,9.8
17526,Martin Lapointe,2003-04,30.0,13,57,82,82,27,30,57,181.0,1320.0,552,108,122,230,935.0,82,5.51,63,376,2272,9.9
17527,Martin Lapointe,2004-05,31.0,14,40,68,68,17,23,40,141.0,1180.0,620,125,145,270,1076.0,82,5.24,53,338,2262,9.5
17528,Martin Lapointe,2005-06,32.0,15,18,59,59,8,10,18,110.0,906.0,679,133,155,288,1186.0,82,5.31,60,363,2326,9.4
17529,Martin Lapointe,2006-07,33.0,16,25,78,78,15,10,25,136.0,1126.0,757,148,165,313,1322.0,82,5.14,57,348,2300,9.2
17530,Martin Lapointe,2008-09,35.0,17,31,82,82,14,17,31,135.0,1211.0,839,162,182,344,1457.0,82,6.05,85,480,2458,10.1
17531,Martin Lapointe,2009-10,36.0,18,24,82,82,13,11,24,102.0,1147.0,921,175,193,368,1559.0,82,5.76,70,398,2426,9.7
17532,Martin Lapointe,2010-11,37.0,19,13,70,70,6,7,13,63.0,658.0,991,181,200,381,1622.0,82,5.44,62,351,2383,9.4
17533,Martin Lojek,2009-10,24.0,4,1,3,3,0,1,1,0.0,25.0,3,0,1,1,0.0,82,5.76,70,398,2426,9.7
17534,Martin Lojek,2010-11,25.0,5,0,2,2,0,0,0,2.0,12.0,5,0,1,1,2.0,82,5.44,62,351,2383,9.4
17535,Martin Marincin,2016-17,24.0,4,6,44,44,0,6,6,28.0,843.0,44,0,6,6,28.0,82,5.34,48,269,2463,8.9
17536,Martin Marincin,2017-18,25.0,5,5,41,41,1,4,5,38.0,765.0,85,1,10,11,66.0,82,5.32,47,251,2453,8.9
17537,Martin Marincin,2018-19,26.0,6,7,65,65,1,6,7,55.0,1090.0,150,2,16,18,121.0,82,5.34,48,255,2438,9.0
17538,Martin Marincin,2019-20,27.0,7,7,25,25,1,6,7,22.0,451.0,175,3,22,25,143.0,82,5.45,47,245,2478,9.0
17539,Martin Marincin,2020-21,28.0,8,0,2,2,0,0,0,0.0,33.0,177,3,22,25,143.0,82,5.86,50,250,2620,9.2
17540,Martin Marincin,2021-22,29.0,9,5,24,24,1,4,5,34.0,365.0,201,4,26,30,177.0,82,5.96,47,239,2579,9.5
17541,Martin Marincin,2022-23,30.0,10,4,26,26,1,3,4,28.0,395.0,227,5,29,34,205.0,70,5.96,42,208,2192,9.5
17542,Martin Necas,2020-21,22.0,4,0,1,1,0,0,0,0.0,7.0,1,0,0,0,0.0,82,5.86,50,250,2620,9.2
17543,Martin Necas,2021-22,23.0,5,2,7,7,1,1,2,6.0,70.0,8,1,1,2,6.0,82,5.96,47,239,2579,9.5
17544,Martin Necas,2022-23,24.0,6,36,64,64,16,20,36,88.0,907.0,72,17,21,38,94.0,70,5.96,42,208,2192,9.5
17545,Martin Prochazka,2000-01,28.0,4,6,29,29,2,4,6,40.0,,29,2,4,6,40.0,82,5.28,57,380,2242,9.6
17546,Martin Prochazka,2002-03,30.0,5,1,3,3,0,1,1,5.0,50.0,32,2,5,7,45.0,82,5.49,53,331,2294,9.8
17547,Martin Rucinsky,1994-95,23.0,4,2,6,6,1,1,2,5.0,,6,1,1,2,5.0,80,6.96,77,402,2440,11.4
17548,Martin Rucinsky,1995-96,24.0,5,48,77,77,18,30,48,133.0,,83,19,31,50,138.0,84,7.25,87,443,2603,11.7
17549,Martin Rucinsky,1996-97,25.0,6,32,60,60,9,23,32,96.0,,143,28,54,82,234.0,84,6.48,76,407,2545,10.7
17550,Martin Rucinsky,1997-98,26.0,7,9,20,20,3,6,9,32.0,,163,31,60,91,266.0,48,5.97,37,209,1408,10.2
17551,Martin Rucinsky,1998-99,27.0,8,75,78,78,29,46,75,181.0,,241,60,106,166,447.0,82,6.29,74,413,2481,10.4
17552,Martin Rucinsky,1999-00,28.0,9,55,70,70,28,27,55,172.0,,311,88,133,221,619.0,82,5.83,55,336,2444,9.8
17553,Martin Rucinsky,2000-01,29.0,10,53,78,78,21,32,53,192.0,,389,109,165,274,811.0,82,5.28,57,380,2242,9.6
17554,Martin Rucinsky,2001-02,30.0,11,34,73,73,17,17,34,180.0,1329.0,462,126,182,308,991.0,82,5.27,57,359,2285,9.4
17555,Martin Rucinsky,2002-03,31.0,12,49,80,80,25,24,49,242.0,1512.0,542,151,206,357,1233.0,82,5.49,53,331,2294,9.8
17556,Martin Rucinsky,2003-04,32.0,13,38,57,57,16,22,38,141.0,1093.0,599,167,228,395,1374.0,82,5.51,63,376,2272,9.9
17557,Martin Rucinsky,2004-05,33.0,14,38,75,75,11,27,38,128.0,1153.0,674,178,255,433,1502.0,82,5.24,53,338,2262,9.5
17558,Martin Rucinsky,2005-06,34.0,15,30,61,61,16,14,30,135.0,1032.0,735,194,269,463,1637.0,82,5.31,60,363,2326,9.4
17559,Martin Rucinsky,2006-07,35.0,16,45,82,82,14,31,45,206.0,1548.0,817,208,300,508,1843.0,82,5.14,57,348,2300,9.2
17560,Martin Rucinsky,2008-09,37.0,17,55,52,52,16,39,55,152.0,958.0,869,224,339,563,1995.0,82,6.05,85,480,2458,10.1
17561,Martin Rucinsky,2009-10,38.0,18,33,52,52,12,21,33,96.0,870.0,921,236,360,596,2091.0,82,5.76,70,398,2426,9.7
17562,Martin Rucinsky,2010-11,39.0,19,16,40,40,5,11,16,67.0,600.0,961,241,371,612,2158.0,82,5.44,62,351,2383,9.4
17563,Martin Samuelsson,2005-06,24.0,4,1,8,8,0,1,1,3.0,94.0,8,0,1,1,3.0,82,5.31,60,363,2326,9.4
17564,Martin Samuelsson,2006-07,25.0,5,0,6,6,0,0,0,7.0,34.0,14,0,1,1,10.0,82,5.14,57,348,2300,9.2
17565,Martin Simard,1993-94,27.0,4,2,16,16,0,2,2,7.0,,16,0,2,2,7.0,80,6.91,71,366,2385,11.6
17566,Martin Simard,1994-95,28.0,5,4,21,21,1,3,4,11.0,,37,1,5,6,18.0,80,6.96,77,402,2440,11.4
17567,Martin Simard,1995-96,29.0,6,0,7,7,0,0,0,1.0,,44,1,5,6,19.0,84,7.25,87,443,2603,11.7
17568,Martin Skoula,2002-03,23.0,4,16,80,80,3,13,16,66.0,1460.0,80,3,13,16,66.0,82,5.49,53,331,2294,9.8
17569,Martin Skoula,2003-04,24.0,5,25,82,82,8,17,25,108.0,1697.0,162,11,30,41,174.0,82,5.51,63,376,2272,9.9
17570,Martin Skoula,2004-05,25.0,6,31,82,82,10,21,31,100.0,1829.0,244,21,51,72,274.0,82,5.24,53,338,2262,9.5
17571,Martin Skoula,2005-06,26.0,7,25,81,81,4,21,25,93.0,1495.0,325,25,72,97,367.0,82,5.31,60,363,2326,9.4
17572,Martin Skoula,2006-07,27.0,8,25,79,79,4,21,25,84.0,1452.0,404,29,93,122,451.0,82,5.14,57,348,2300,9.2
17573,Martin Skoula,2008-09,29.0,9,21,78,78,5,16,21,92.0,1493.0,482,34,109,143,543.0,82,6.05,85,480,2458,10.1
17574,Martin Skoula,2009-10,30.0,10,15,81,81,0,15,15,91.0,1639.0,563,34,124,158,634.0,82,5.76,70,398,2426,9.7
17575,Martin Skoula,2010-11,31.0,11,11,80,80,3,8,11,63.0,1639.0,643,37,132,169,697.0,82,5.44,62,351,2383,9.4
17576,Martin Skoula,2011-12,32.0,12,16,81,81,4,12,16,55.0,1617.0,724,41,144,185,752.0,82,5.7,65,341,2477,9.4
17577,Martin Skoula,2012-13,33.0,13,11,52,52,3,8,11,34.0,905.0,776,44,152,196,786.0,82,5.53,56,304,2486,9.1
17578,Martin Sonnenberg,2001-02,24.0,4,2,44,44,1,1,2,12.0,176.0,44,1,1,2,12.0,82,5.27,57,359,2285,9.4
17579,Martin Sonnenberg,2002-03,25.0,5,3,14,14,1,2,3,19.0,104.0,58,2,3,5,31.0,82,5.49,53,331,2294,9.8
17580,Martin Sonnenberg,2006-07,29.0,6,0,5,5,0,0,0,7.0,44.0,63,2,3,5,38.0,82,5.14,57,348,2300,9.2
17581,Martin Spanhel,2003-04,26.0,4,1,6,6,1,0,1,8.0,75.0,6,1,0,1,8.0,82,5.51,63,376,2272,9.9
17582,Martin Spanhel,2004-05,27.0,5,1,4,4,1,0,1,6.0,45.0,10,2,0,2,14.0,82,5.24,53,338,2262,9.5
17583,Martin St. Amour,1995-96,26.0,4,0,1,1,0,0,0,2.0,,1,0,0,0,2.0,84,7.25,87,443,2603,11.7
17584,Martin St. Louis,2001-02,26.0,4,2,13,13,1,1,2,14.0,107.0,13,1,1,2,14.0,82,5.27,57,359,2285,9.4
17585,Martin St. Louis,2002-03,27.0,5,18,56,56,3,15,18,73.0,823.0,69,4,16,20,87.0,82,5.49,53,331,2294,9.8
17586,Martin St. Louis,2003-04,28.0,6,40,78,78,18,22,40,141.0,1189.0,147,22,38,60,228.0,82,5.51,63,376,2272,9.9
17587,Martin St. Louis,2004-05,29.0,7,35,53,53,16,19,35,105.0,990.0,200,38,57,95,333.0,82,5.24,53,338,2262,9.5
17588,Martin St. Louis,2005-06,30.0,8,70,82,82,33,37,70,201.0,1616.0,282,71,94,165,534.0,82,5.31,60,363,2326,9.4
17589,Martin St. Louis,2006-07,31.0,9,94,82,82,38,56,94,212.0,1688.0,364,109,150,259,746.0,82,5.14,57,348,2300,9.2
17590,Martin St. Louis,2008-09,33.0,10,61,80,80,31,30,61,221.0,1679.0,444,140,180,320,967.0,82,6.05,85,480,2458,10.1
17591,Martin St. Louis,2009-10,34.0,11,102,82,82,43,59,102,273.0,1981.0,526,183,239,422,1240.0,82,5.76,70,398,2426,9.7
17592,Martin St. Louis,2010-11,35.0,12,83,82,82,25,58,83,241.0,1991.0,608,208,297,505,1481.0,82,5.44,62,351,2383,9.4
17593,Martin St. Louis,2011-12,36.0,13,80,82,82,30,50,80,262.0,1745.0,690,238,347,585,1743.0,82,5.7,65,341,2477,9.4
17594,Martin St. Louis,2012-13,37.0,14,94,82,82,29,65,94,242.0,1788.0,772,267,412,679,1985.0,82,5.53,56,304,2486,9.1
17595,Martin St. Louis,2013-14,38.0,15,99,82,82,31,68,99,254.0,1720.0,854,298,480,778,2239.0,82,5.46,52,291,2492,9.0
17596,Martin St. Louis,2014-15,39.0,16,74,77,77,25,49,74,185.0,1743.0,931,323,529,852,2424.0,82,5.32,47,271,2439,8.9
17597,Martin St. Louis,2015-16,40.0,17,60,48,48,17,43,60,112.0,1055.0,979,340,572,912,2536.0,48,5.31,29,160,1399,9.1
17598,Martin St. Louis,2016-17,41.0,18,69,81,81,30,39,69,204.0,1696.0,1060,370,611,981,2740.0,82,5.34,48,269,2463,8.9
17599,Martin St. Louis,2017-18,42.0,19,52,74,74,21,31,52,144.0,1300.0,1134,391,642,1033,2884.0,82,5.32,47,251,2453,8.9
17600,Martin St. Pierre,2008-09,25.0,4,0,2,2,0,0,0,1.0,24.0,2,0,0,0,1.0,82,6.05,85,480,2458,10.1
17601,Martin St. Pierre,2009-10,26.0,5,4,14,14,1,3,4,13.0,175.0,16,1,3,4,14.0,82,5.76,70,398,2426,9.7
17602,Martin St. Pierre,2010-11,27.0,6,0,5,5,0,0,0,2.0,76.0,21,1,3,4,16.0,82,5.44,62,351,2383,9.4
17603,Martin St. Pierre,2011-12,28.0,7,4,14,14,2,2,4,15.0,160.0,35,3,5,8,31.0,82,5.7,65,341,2477,9.4
17604,Martin St. Pierre,2012-13,29.0,8,0,3,3,0,0,0,0.0,29.0,38,3,5,8,31.0,82,5.53,56,304,2486,9.1
17605,Martin St. Pierre,2016-17,33.0,9,0,1,1,0,0,0,0.0,10.0,39,3,5,8,31.0,82,5.34,48,269,2463,8.9
17606,Martin Straka,1995-96,23.0,4,16,42,42,3,13,16,28.0,,42,3,13,16,28.0,84,7.25,87,443,2603,11.7
17607,Martin Straka,1996-97,24.0,5,64,84,84,30,34,64,130.0,,126,33,47,80,158.0,84,6.48,76,407,2545,10.7
17608,Martin Straka,1997-98,25.0,6,18,37,37,5,13,18,49.0,,163,38,60,98,207.0,48,5.97,37,209,1408,10.2
17609,Martin Straka,1998-99,26.0,7,43,77,77,13,30,43,98.0,,240,51,90,141,305.0,82,6.29,74,413,2481,10.4
17610,Martin Straka,1999-00,27.0,8,29,55,55,7,22,29,94.0,,295,58,112,170,399.0,82,5.83,55,336,2444,9.8
17611,Martin Straka,2000-01,28.0,9,42,75,75,19,23,42,117.0,,370,77,135,212,516.0,82,5.28,57,380,2242,9.6
17612,Martin Straka,2001-02,29.0,10,83,80,80,35,48,83,177.0,1887.0,450,112,183,295,693.0,82,5.27,57,359,2285,9.4
17613,Martin Straka,2002-03,30.0,11,59,71,71,20,39,59,146.0,1701.0,521,132,222,354,839.0,82,5.49,53,331,2294,9.8
17614,Martin Straka,2003-04,31.0,12,95,82,82,27,68,95,185.0,1888.0,603,159,290,449,1024.0,82,5.51,63,376,2272,9.9
17615,Martin Straka,2004-05,32.0,13,9,13,13,5,4,9,33.0,234.0,616,164,294,458,1057.0,82,5.24,53,338,2262,9.5
17616,Martin Straka,2005-06,33.0,14,46,60,60,18,28,46,136.0,1237.0,676,182,322,504,1193.0,82,5.31,60,363,2326,9.4
17617,Martin Straka,2006-07,34.0,15,26,54,54,10,16,26,68.0,1011.0,730,192,338,530,1261.0,82,5.14,57,348,2300,9.2
17618,Martin Straka,2008-09,36.0,16,76,82,82,22,54,76,171.0,1571.0,812,214,392,606,1432.0,82,6.05,85,480,2458,10.1
17619,Martin Straka,2009-10,37.0,17,70,77,77,29,41,70,165.0,1536.0,889,243,433,676,1597.0,82,5.76,70,398,2426,9.7
17620,Martin Straka,2010-11,38.0,18,41,65,65,14,27,41,116.0,1210.0,954,257,460,717,1713.0,82,5.44,62,351,2383,9.4
17621,Martin Strbak,2006-07,32.0,4,16,49,49,5,11,16,54.0,955.0,49,5,11,16,54.0,82,5.14,57,348,2300,9.2
17622,Martins Karsums,2011-12,25.0,4,6,24,24,1,5,6,28.0,269.0,24,1,5,6,28.0,82,5.7,65,341,2477,9.4
17623,Martti Jarventie,2004-05,28.0,4,0,1,1,0,0,0,0.0,13.0,1,0,0,0,0.0,82,5.24,53,338,2262,9.5
17624,Marty Dallman,1990-91,27.0,4,1,2,2,0,1,1,1.0,,2,0,1,1,1.0,80,7.43,89,437,2435,12.2
17625,Marty Dallman,1991-92,28.0,5,0,4,4,0,0,0,2.0,,6,0,1,1,3.0,80,7.48,85,403,2430,12.3
17626,Marty Howe,1982-83,28.0,4,1,6,6,0,1,1,6.0,,6,0,1,1,6.0,80,7.03,61,280,2352,12.0
17627,Marty Howe,1983-84,29.0,5,1,12,12,0,1,1,3.0,,18,0,2,2,9.0,80,7.69,77,340,2441,12.6
17628,Marty Howe,1984-85,30.0,6,4,13,13,0,4,4,21.0,,31,0,6,6,30.0,80,8.03,73,320,2489,12.9
17629,Marty Howe,1985-86,31.0,7,12,78,78,1,11,12,67.0,,109,1,17,18,97.0,80,7.73,71,310,2444,12.7
17630,Marty Howe,1986-87,32.0,8,11,69,69,0,11,11,58.0,,178,1,28,29,155.0,80,7.89,74,336,2448,12.9
17631,Marty Howe,1987-88,33.0,9,2,19,19,1,1,2,23.0,,197,2,29,31,178.0,80,7.77,71,321,2447,12.7
17632,Marty McInnis,1994-95,24.0,4,8,15,15,3,5,8,24.0,,15,3,5,8,24.0,80,6.96,77,402,2440,11.4
17633,Marty McInnis,1995-96,25.0,5,30,56,56,10,20,30,60.0,,71,13,25,38,84.0,84,7.25,87,443,2603,11.7
17634,Marty McInnis,1996-97,26.0,6,56,81,81,25,31,56,136.0,,152,38,56,94,220.0,84,6.48,76,407,2545,10.7
17635,Marty McInnis,1997-98,27.0,7,16,41,41,9,7,16,68.0,,193,47,63,110,288.0,48,5.97,37,209,1408,10.2
17636,Marty McInnis,1998-99,28.0,8,46,74,74,12,34,46,167.0,,267,59,97,156,455.0,82,6.29,74,413,2481,10.4
17637,Marty McInnis,1999-00,29.0,9,49,80,80,23,26,49,182.0,,347,82,123,205,637.0,82,5.83,55,336,2444,9.8
17638,Marty McInnis,2000-01,30.0,10,44,75,75,19,25,44,128.0,,422,101,148,249,765.0,82,5.28,57,380,2242,9.6
17639,Marty McInnis,2001-02,31.0,11,54,81,81,19,35,54,146.0,1507.0,503,120,183,303,911.0,82,5.27,57,359,2285,9.4
17640,Marty McInnis,2002-03,32.0,12,28,62,62,10,18,28,129.0,1182.0,565,130,201,331,1040.0,82,5.49,53,331,2294,9.8
17641,Marty McInnis,2003-04,33.0,13,42,75,75,20,22,42,136.0,1387.0,640,150,223,373,1176.0,82,5.51,63,376,2272,9.9
17642,Marty McInnis,2004-05,34.0,14,28,79,79,11,17,28,157.0,1255.0,719,161,240,401,1333.0,82,5.24,53,338,2262,9.5
17643,Marty McInnis,2005-06,35.0,15,19,77,77,9,10,19,121.0,1095.0,796,170,250,420,1454.0,82,5.31,60,363,2326,9.4
17644,Marty McSorley,1986-87,23.0,4,9,72,72,2,7,9,75.0,,72,2,7,9,75.0,80,7.89,74,336,2448,12.9
17645,Marty McSorley,1987-88,24.0,5,0,15,15,0,0,0,11.0,,87,2,7,9,86.0,80,7.77,71,321,2447,12.7
17646,Marty McSorley,1988-89,25.0,6,23,59,59,11,12,23,72.0,,146,13,19,32,158.0,80,7.94,82,370,2484,12.8
17647,Marty McSorley,1989-90,26.0,7,6,41,41,2,4,6,33.0,,187,15,23,38,191.0,80,7.34,72,344,2400,12.2
17648,Marty McSorley,1990-91,27.0,8,26,60,60,9,17,26,66.0,,247,24,40,64,257.0,80,7.43,89,437,2435,12.2
17649,Marty McSorley,1991-92,28.0,9,27,66,66,10,17,27,87.0,,313,34,57,91,344.0,80,7.48,85,403,2430,12.3
17650,Marty McSorley,1992-93,29.0,10,36,75,75,15,21,36,127.0,,388,49,78,127,471.0,80,7.37,76,367,2421,12.2
17651,Marty McSorley,1993-94,30.0,11,39,61,61,7,32,39,100.0,,449,56,110,166,571.0,80,6.91,71,366,2385,11.6
17652,Marty McSorley,1994-95,31.0,12,29,71,71,7,22,29,119.0,,520,63,132,195,690.0,80,6.96,77,402,2440,11.4
17653,Marty McSorley,1995-96,32.0,13,41,81,81,15,26,41,197.0,,601,78,158,236,887.0,84,7.25,87,443,2603,11.7
17654,Marty McSorley,1996-97,33.0,14,31,65,65,7,24,31,160.0,,666,85,182,267,1047.0,84,6.48,76,407,2545,10.7
17655,Marty McSorley,1997-98,34.0,15,21,41,41,3,18,21,75.0,,707,88,200,288,1122.0,48,5.97,37,209,1408,10.2
17656,Marty McSorley,1998-99,35.0,16,33,68,68,10,23,33,130.0,,775,98,223,321,1252.0,82,6.29,74,413,2481,10.4
17657,Marty McSorley,1999-00,36.0,17,16,57,57,4,12,16,74.0,,832,102,235,337,1326.0,82,5.83,55,336,2444,9.8
17658,Marty McSorley,2000-01,37.0,18,12,56,56,2,10,12,46.0,,888,104,245,349,1372.0,82,5.28,57,380,2242,9.6
17659,Marty McSorley,2001-02,38.0,19,5,46,46,2,3,5,29.0,780.0,934,106,248,354,1401.0,82,5.27,57,359,2285,9.4
17660,Marty McSorley,2002-03,39.0,20,5,27,27,2,3,5,24.0,379.0,961,108,251,359,1425.0,82,5.49,53,331,2294,9.8
17661,Marty Murray,1998-99,23.0,4,6,15,15,3,3,6,22.0,,15,3,3,6,22.0,82,6.29,74,413,2481,10.4
17662,Marty Murray,1999-00,24.0,5,0,2,2,0,0,0,2.0,,17,3,3,6,24.0,82,5.83,55,336,2444,9.8
17663,Marty Murray,2000-01,25.0,6,0,2,2,0,0,0,2.0,,19,3,3,6,26.0,82,5.28,57,380,2242,9.6
17664,Marty Murray,2003-04,28.0,7,0,7,7,0,0,0,6.0,101.0,26,3,3,6,32.0,82,5.51,63,376,2272,9.9
17665,Marty Murray,2004-05,29.0,8,27,74,74,12,15,27,109.0,1031.0,100,15,18,33,141.0,82,5.24,53,338,2262,9.5
17666,Marty Murray,2005-06,30.0,9,26,76,76,11,15,26,105.0,940.0,176,26,33,59,246.0,82,5.31,60,363,2326,9.4
17667,Marty Murray,2006-07,31.0,10,12,66,66,5,7,12,56.0,780.0,242,31,40,71,302.0,82,5.14,57,348,2300,9.2
17668,Marty Murray,2009-10,34.0,11,2,19,19,0,2,2,4.0,181.0,261,31,42,73,306.0,82,5.76,70,398,2426,9.7
17669,Marty Reasoner,2001-02,24.0,4,10,22,22,3,7,10,33.0,306.0,22,3,7,10,33.0,82,5.27,57,359,2285,9.4
17670,Marty Reasoner,2002-03,25.0,5,24,32,32,10,14,24,51.0,491.0,54,13,21,34,84.0,82,5.49,53,331,2294,9.8
17671,Marty Reasoner,2003-04,26.0,6,13,41,41,4,9,13,65.0,574.0,95,17,30,47,149.0,82,5.51,63,376,2272,9.9
17672,Marty Reasoner,2004-05,27.0,7,11,52,52,6,5,11,66.0,611.0,147,23,35,58,215.0,82,5.24,53,338,2262,9.5
17673,Marty Reasoner,2005-06,28.0,8,31,70,70,11,20,31,102.0,1038.0,217,34,55,89,317.0,82,5.31,60,363,2326,9.4
17674,Marty Reasoner,2006-07,29.0,9,8,17,17,2,6,8,28.0,281.0,234,36,61,97,345.0,82,5.14,57,348,2300,9.2
17675,Marty Reasoner,2008-09,31.0,10,34,77,77,11,23,34,102.0,1027.0,311,47,84,131,447.0,82,6.05,85,480,2458,10.1
17676,Marty Reasoner,2009-10,32.0,11,20,72,72,6,14,20,84.0,999.0,383,53,98,151,531.0,82,5.76,70,398,2426,9.7
17677,Marty Reasoner,2010-11,33.0,12,25,82,82,11,14,25,113.0,1227.0,465,64,112,176,644.0,82,5.44,62,351,2383,9.4
17678,Marty Reasoner,2011-12,34.0,13,30,79,79,14,16,30,131.0,1209.0,544,78,128,206,775.0,82,5.7,65,341,2477,9.4
17679,Marty Reasoner,2012-13,35.0,14,17,80,80,4,13,17,86.0,1000.0,624,82,141,223,861.0,82,5.53,56,304,2486,9.1
17680,Marty Reasoner,2013-14,36.0,15,32,82,82,14,18,32,124.0,1407.0,706,96,159,255,985.0,82,5.46,52,291,2492,9.0
17681,Marty Reasoner,2014-15,37.0,16,6,61,61,1,5,6,69.0,708.0,767,97,164,261,1054.0,82,5.32,47,271,2439,8.9
17682,Marty Reasoner,2015-16,38.0,17,5,31,31,0,5,5,34.0,348.0,798,97,169,266,1088.0,48,5.31,29,160,1399,9.1
17683,Masi Marjamaki,2008-09,24.0,4,0,1,1,0,0,0,0.0,5.0,1,0,0,0,0.0,82,6.05,85,480,2458,10.1
17684,Mason Appleton,2021-22,26.0,4,10,36,36,3,7,10,29.0,295.0,36,3,7,10,29.0,82,5.96,47,239,2579,9.5
17685,Mason Appleton,2022-23,27.0,5,8,46,46,5,3,8,55.0,513.0,82,8,10,18,84.0,70,5.96,42,208,2192,9.5
17686,Mason Marchment,2022-23,27.0,4,1,4,4,0,1,1,3.0,32.0,4,0,1,1,3.0,70,5.96,42,208,2192,9.5
17687,Mason Raymond,2010-11,25.0,4,21,49,49,9,12,21,80.0,614.0,49,9,12,21,80.0,82,5.44,62,351,2383,9.4
17688,Mason Raymond,2011-12,26.0,5,23,72,72,11,12,23,145.0,987.0,121,20,24,44,225.0,82,5.7,65,341,2477,9.4
17689,Mason Raymond,2012-13,27.0,6,53,82,82,25,28,53,217.0,1421.0,203,45,52,97,442.0,82,5.53,56,304,2486,9.1
17690,Mason Raymond,2013-14,28.0,7,39,70,70,15,24,39,197.0,1106.0,273,60,76,136,639.0,82,5.46,52,291,2492,9.0
17691,Mason Raymond,2014-15,29.0,8,20,55,55,10,10,20,125.0,857.0,328,70,86,156,764.0,82,5.32,47,271,2439,8.9
17692,Mason Raymond,2015-16,30.0,9,22,46,46,10,12,22,79.0,728.0,374,80,98,178,843.0,48,5.31,29,160,1399,9.1
17693,Mason Raymond,2016-17,31.0,10,45,82,82,19,26,45,178.0,1421.0,456,99,124,223,1021.0,82,5.34,48,269,2463,8.9
17694,Mason Raymond,2017-18,32.0,11,23,57,57,12,11,23,123.0,844.0,513,111,135,246,1144.0,82,5.32,47,251,2453,8.9
17695,Mason Raymond,2018-19,33.0,12,5,29,29,4,1,5,53.0,358.0,542,115,136,251,1197.0,82,5.34,48,255,2438,9.0
17696,Mason Raymond,2019-20,34.0,13,0,4,4,0,0,0,3.0,36.0,546,115,136,251,1200.0,82,5.45,47,245,2478,9.0
17697,Mat Clark,2014-15,24.0,4,0,2,2,0,0,0,2.0,22.0,2,0,0,0,2.0,82,5.32,47,271,2439,8.9
17698,Mat Clark,2017-18,27.0,5,1,7,7,0,1,1,2.0,89.0,9,0,1,1,4.0,82,5.32,47,251,2453,8.9
17699,Mathew Barzal,2019-20,22.0,4,0,2,2,0,0,0,0.0,20.0,2,0,0,0,0.0,82,5.45,47,245,2478,9.0
17700,Mathew Barzal,2020-21,23.0,5,85,82,82,22,63,85,170.0,1457.0,84,22,63,85,170.0,82,5.86,50,250,2620,9.2
17701,Mathew Barzal,2021-22,24.0,6,62,82,82,18,44,62,179.0,1470.0,166,40,107,147,349.0,82,5.96,47,239,2579,9.5
17702,Mathew Barzal,2022-23,25.0,7,60,68,68,19,41,60,171.0,1363.0,234,59,148,207,520.0,70,5.96,42,208,2192,9.5
17703,Mathew Dumba,2016-17,22.0,4,2,13,13,1,1,2,12.0,162.0,13,1,1,2,12.0,82,5.34,48,269,2463,8.9
17704,Mathew Dumba,2017-18,23.0,5,16,58,58,8,8,16,86.0,871.0,71,9,9,18,98.0,82,5.32,47,251,2453,8.9
17705,Mathew Dumba,2018-19,24.0,6,26,81,81,10,16,26,152.0,1364.0,152,19,25,44,250.0,82,5.34,48,255,2438,9.0
17706,Mathew Dumba,2019-20,25.0,7,34,76,76,11,23,34,131.0,1545.0,228,30,48,78,381.0,82,5.45,47,245,2478,9.0
17707,Mathew Dumba,2020-21,26.0,8,50,82,82,14,36,50,176.0,1953.0,310,44,84,128,557.0,82,5.86,50,250,2620,9.2
17708,Mathew Dumba,2021-22,27.0,9,22,32,32,12,10,22,93.0,748.0,342,56,94,150,650.0,82,5.96,47,239,2579,9.5
17709,Mathew Dumba,2022-23,28.0,10,24,69,69,6,18,24,167.0,1552.0,411,62,112,174,817.0,70,5.96,42,208,2192,9.5
17710,Mathias Johansson,2005-06,31.0,4,15,58,58,5,10,15,70.0,787.0,58,5,10,15,70.0,82,5.31,60,363,2326,9.4
17711,Mathias Tjarnqvist,2006-07,27.0,4,2,18,18,1,1,2,11.0,175.0,18,1,1,2,11.0,82,5.14,57,348,2300,9.2
17712,Mathias Tjarnqvist,2008-09,29.0,5,6,33,33,2,4,6,36.0,269.0,51,3,5,8,47.0,82,6.05,85,480,2458,10.1
17713,Mathias Tjarnqvist,2009-10,30.0,6,13,44,44,6,7,13,44.0,552.0,95,9,12,21,91.0,82,5.76,70,398,2426,9.7
17714,Mathias Tjarnqvist,2010-11,31.0,7,11,78,78,4,7,11,90.0,1064.0,173,13,19,32,181.0,82,5.44,62,351,2383,9.4
17715,Mathieu Biron,2002-03,22.0,4,8,60,60,4,4,8,70.0,902.0,60,4,4,8,70.0,82,5.49,53,331,2294,9.8
17716,Mathieu Biron,2003-04,23.0,5,1,14,14,0,1,1,10.0,173.0,74,4,5,9,80.0,82,5.51,63,376,2272,9.9
17717,Mathieu Biron,2004-05,24.0,6,0,36,36,0,0,0,35.0,532.0,110,4,5,9,115.0,82,5.24,53,338,2262,9.5
17718,Mathieu Biron,2005-06,25.0,7,9,34,34,1,8,9,52.0,719.0,144,5,13,18,167.0,82,5.31,60,363,2326,9.4
17719,Mathieu Biron,2006-07,26.0,8,13,57,57,3,10,13,75.0,1038.0,201,8,23,31,242.0,82,5.14,57,348,2300,9.2
17720,Mathieu Biron,2008-09,28.0,9,13,52,52,4,9,13,61.0,636.0,253,12,32,44,303.0,82,6.05,85,480,2458,10.1
17721,Mathieu Carle,2012-13,25.0,4,0,3,3,0,0,0,2.0,43.0,3,0,0,0,2.0,82,5.53,56,304,2486,9.1
17722,Mathieu Dandenault,1998-99,22.0,4,12,34,34,5,7,12,32.0,,34,5,7,12,32.0,82,6.29,74,413,2481,10.4
17723,Mathieu Dandenault,1999-00,23.0,5,12,65,65,3,9,12,81.0,,99,8,16,24,113.0,82,5.83,55,336,2444,9.8
17724,Mathieu Dandenault,2000-01,24.0,6,17,68,68,5,12,17,75.0,,167,13,28,41,188.0,82,5.28,57,380,2242,9.6
17725,Mathieu Dandenault,2001-02,25.0,7,14,75,75,4,10,14,94.0,1138.0,242,17,38,55,282.0,82,5.27,57,359,2285,9.4
17726,Mathieu Dandenault,2002-03,26.0,8,18,81,81,6,12,18,98.0,986.0,323,23,50,73,380.0,82,5.49,53,331,2294,9.8
17727,Mathieu Dandenault,2003-04,27.0,9,25,73,73,10,15,25,95.0,1175.0,396,33,65,98,475.0,82,5.51,63,376,2272,9.9
17728,Mathieu Dandenault,2004-05,28.0,10,20,81,81,8,12,20,97.0,1354.0,477,41,77,118,572.0,82,5.24,53,338,2262,9.5
17729,Mathieu Dandenault,2005-06,29.0,11,19,74,74,4,15,19,74.0,1415.0,551,45,92,137,646.0,82,5.31,60,363,2326,9.4
17730,Mathieu Dandenault,2006-07,30.0,12,12,65,65,3,9,12,68.0,896.0,616,48,101,149,714.0,82,5.14,57,348,2300,9.2
17731,Mathieu Dandenault,2008-09,32.0,13,20,82,82,5,15,20,101.0,1528.0,698,53,116,169,815.0,82,6.05,85,480,2458,10.1
17732,Mathieu Dandenault,2009-10,33.0,14,8,68,68,2,6,8,54.0,1096.0,766,55,122,177,869.0,82,5.76,70,398,2426,9.7
17733,Mathieu Dandenault,2010-11,34.0,15,14,61,61,9,5,14,69.0,679.0,827,64,127,191,938.0,82,5.44,62,351,2383,9.4
17734,Mathieu Dandenault,2011-12,35.0,16,12,41,41,4,8,12,46.0,482.0,868,68,135,203,984.0,82,5.7,65,341,2477,9.4
17735,Mathieu Darche,2003-04,27.0,4,0,9,9,0,0,0,9.0,91.0,9,0,0,0,9.0,82,5.51,63,376,2272,9.9
17736,Mathieu Darche,2004-05,28.0,5,2,14,14,1,1,2,15.0,138.0,23,1,1,2,24.0,82,5.24,53,338,2262,9.5
17737,Mathieu Darche,2005-06,29.0,6,0,1,1,0,0,0,0.0,7.0,24,1,1,2,24.0,82,5.31,60,363,2326,9.4
17738,Mathieu Darche,2006-07,30.0,7,0,2,2,0,0,0,1.0,13.0,26,1,1,2,25.0,82,5.14,57,348,2300,9.2
17739,Mathieu Darche,2009-10,33.0,8,0,2,2,0,0,0,3.0,18.0,28,1,1,2,28.0,82,5.76,70,398,2426,9.7
17740,Mathieu Darche,2010-11,34.0,9,22,73,73,7,15,22,120.0,1053.0,101,8,16,24,148.0,82,5.44,62,351,2383,9.4
17741,Mathieu Darche,2012-13,36.0,10,10,29,29,5,5,10,43.0,314.0,130,13,21,34,191.0,82,5.53,56,304,2486,9.1
17742,Mathieu Darche,2013-14,37.0,11,26,59,59,12,14,26,90.0,665.0,189,25,35,60,281.0,82,5.46,52,291,2492,9.0
17743,Mathieu Darche,2014-15,38.0,12,12,61,61,5,7,12,77.0,740.0,250,30,42,72,358.0,82,5.32,47,271,2439,8.9
17744,Mathieu Joseph,2021-22,24.0,4,26,70,70,13,13,26,95.0,795.0,70,13,13,26,95.0,82,5.96,47,239,2579,9.5
17745,Mathieu Joseph,2022-23,25.0,5,7,37,37,4,3,7,35.0,426.0,107,17,16,33,130.0,70,5.96,42,208,2192,9.5
17746,Mathieu Olivier,2022-23,25.0,4,1,8,8,0,1,1,6.0,60.0,8,0,1,1,6.0,70,5.96,42,208,2192,9.5
17747,Mathieu Perreault,2012-13,25.0,4,9,21,21,4,5,9,27.0,238.0,21,4,5,9,27.0,82,5.53,56,304,2486,9.1
17748,Mathieu Perreault,2013-14,26.0,5,14,35,35,7,7,14,41.0,416.0,56,11,12,23,68.0,82,5.46,52,291,2492,9.0
17749,Mathieu Perreault,2014-15,27.0,6,30,64,64,16,14,30,60.0,770.0,120,27,26,53,128.0,82,5.32,47,271,2439,8.9
17750,Mathieu Perreault,2015-16,28.0,7,17,39,39,6,11,17,47.0,455.0,159,33,37,70,175.0,48,5.31,29,160,1399,9.1
17751,Mathieu Perreault,2016-17,29.0,8,43,69,69,18,25,43,120.0,957.0,228,51,62,113,295.0,82,5.34,48,269,2463,8.9
17752,Mathieu Perreault,2017-18,30.0,9,41,62,62,18,23,41,129.0,1008.0,290,69,85,154,424.0,82,5.32,47,251,2453,8.9
17753,Mathieu Perreault,2018-19,31.0,10,41,71,71,9,32,41,133.0,1175.0,361,78,117,195,557.0,82,5.34,48,255,2438,9.0
17754,Mathieu Perreault,2019-20,32.0,11,45,65,65,13,32,45,134.0,1059.0,426,91,149,240,691.0,82,5.45,47,245,2478,9.0
17755,Mathieu Perreault,2020-21,33.0,12,39,70,70,17,22,39,139.0,1012.0,496,108,171,279,830.0,82,5.86,50,250,2620,9.2
17756,Mathieu Perreault,2021-22,34.0,13,30,82,82,15,15,30,95.0,1003.0,578,123,186,309,925.0,82,5.96,47,239,2579,9.5
17757,Mathieu Perreault,2022-23,35.0,14,15,49,49,7,8,15,71.0,642.0,627,130,194,324,996.0,70,5.96,42,208,2192,9.5
17758,Mathieu Roy,2008-09,25.0,4,0,1,1,0,0,0,0.0,13.0,1,0,0,0,0.0,82,6.05,85,480,2458,10.1
17759,Mathieu Roy,2009-10,26.0,5,2,16,16,2,0,2,18.0,226.0,17,2,0,2,18.0,82,5.76,70,398,2426,9.7
17760,Mathieu Roy,2010-11,27.0,6,1,13,13,0,1,1,8.0,135.0,30,2,1,3,26.0,82,5.44,62,351,2383,9.4
17761,Mathieu Roy,2012-13,29.0,7,10,31,31,0,10,10,32.0,568.0,61,2,11,13,58.0,82,5.53,56,304,2486,9.1
17762,Mathieu Roy,2013-14,30.0,8,0,4,4,0,0,0,1.0,19.0,65,2,11,13,59.0,82,5.46,52,291,2492,9.0
17763,Mathieu Roy,2015-16,32.0,9,0,1,1,0,0,0,0.0,14.0,66,2,11,13,59.0,48,5.31,29,160,1399,9.1
17764,Mathieu Schneider,1990-91,21.0,4,0,4,4,0,0,0,2.0,,4,0,0,0,2.0,80,7.43,89,437,2435,12.2
17765,Mathieu Schneider,1992-93,23.0,5,21,44,44,7,14,21,84.0,,48,7,14,21,86.0,80,7.37,76,367,2421,12.2
17766,Mathieu Schneider,1993-94,24.0,6,30,69,69,10,20,30,164.0,,117,17,34,51,250.0,80,6.91,71,366,2385,11.6
17767,Mathieu Schneider,1994-95,25.0,7,32,78,78,8,24,32,194.0,,195,25,58,83,444.0,80,6.96,77,402,2440,11.4
17768,Mathieu Schneider,1995-96,26.0,8,44,60,60,13,31,44,169.0,,255,38,89,127,613.0,84,7.25,87,443,2603,11.7
17769,Mathieu Schneider,1996-97,27.0,9,52,75,75,20,32,52,193.0,,330,58,121,179,806.0,84,6.48,76,407,2545,10.7
17770,Mathieu Schneider,1997-98,28.0,10,29,43,43,8,21,29,118.0,,373,66,142,208,924.0,48,5.97,37,209,1408,10.2
17771,Mathieu Schneider,1998-99,29.0,11,54,78,78,13,41,54,191.0,,451,79,183,262,1115.0,82,6.29,74,413,2481,10.4
17772,Mathieu Schneider,1999-00,30.0,12,12,26,26,5,7,12,63.0,,477,84,190,274,1178.0,82,5.83,55,336,2444,9.8
17773,Mathieu Schneider,2000-01,31.0,13,37,76,76,11,26,37,181.0,,553,95,216,311,1359.0,82,5.28,57,380,2242,9.6
17774,Mathieu Schneider,2001-02,32.0,14,34,75,75,10,24,34,159.0,1844.0,628,105,240,345,1518.0,82,5.27,57,359,2285,9.4
17775,Mathieu Schneider,2002-03,33.0,15,30,80,80,10,20,30,228.0,1801.0,708,115,260,375,1746.0,82,5.49,53,331,2294,9.8
17776,Mathieu Schneider,2003-04,34.0,16,51,73,73,16,35,51,183.0,1684.0,781,131,295,426,1929.0,82,5.51,63,376,2272,9.9
17777,Mathieu Schneider,2004-05,35.0,17,30,55,55,7,23,30,123.0,1233.0,836,138,318,456,2052.0,82,5.24,53,338,2262,9.5
17778,Mathieu Schneider,2005-06,36.0,18,50,78,78,16,34,50,199.0,1747.0,914,154,352,506,2251.0,82,5.31,60,363,2326,9.4
17779,Mathieu Schneider,2006-07,37.0,19,46,78,78,14,32,46,165.0,1910.0,992,168,384,552,2416.0,82,5.14,57,348,2300,9.2
17780,Mathieu Schneider,2008-09,39.0,20,59,72,72,21,38,59,188.0,1765.0,1064,189,422,611,2604.0,82,6.05,85,480,2458,10.1
17781,Mathieu Schneider,2009-10,40.0,21,52,68,68,11,41,52,184.0,1603.0,1132,200,463,663,2788.0,82,5.76,70,398,2426,9.7
17782,Mathieu Schneider,2010-11,41.0,22,39,65,65,12,27,39,139.0,1449.0,1197,212,490,702,2927.0,82,5.44,62,351,2383,9.4
17783,Mathieu Schneider,2011-12,42.0,23,32,67,67,9,23,32,128.0,1407.0,1264,221,513,734,3055.0,82,5.7,65,341,2477,9.4
17784,Mathieu Schneider,2012-13,43.0,24,9,25,25,2,7,9,37.0,426.0,1289,223,520,743,3092.0,82,5.53,56,304,2486,9.1
17785,Mats Hallin,1985-86,27.0,4,14,30,30,7,7,14,37.0,,30,7,7,14,37.0,80,7.73,71,310,2444,12.7
17786,Mats Hallin,1986-87,28.0,5,7,40,40,2,5,7,32.0,,70,9,12,21,69.0,80,7.89,74,336,2448,12.9
17787,Mats Hallin,1987-88,29.0,6,5,38,38,5,0,5,22.0,,108,14,12,26,91.0,80,7.77,71,321,2447,12.7
17788,Mats Hallin,1988-89,30.0,7,5,38,38,3,2,5,29.0,,146,17,14,31,120.0,80,7.94,82,370,2484,12.8
17789,Mats Hallin,1989-90,31.0,8,0,6,6,0,0,0,5.0,,152,17,14,31,125.0,80,7.34,72,344,2400,12.2
17790,Mats Lindgren,1999-00,25.0,4,25,69,69,11,14,25,71.0,,69,11,14,25,71.0,82,5.83,55,336,2444,9.8
17791,Mats Lindgren,2000-01,26.0,5,26,82,82,13,13,26,131.0,,151,24,27,51,202.0,82,5.28,57,380,2242,9.6
17792,Mats Lindgren,2001-02,27.0,6,25,60,60,10,15,25,83.0,794.0,211,34,42,76,285.0,82,5.27,57,359,2285,9.4
17793,Mats Lindgren,2002-03,28.0,7,16,43,43,9,7,16,68.0,829.0,254,43,49,92,353.0,82,5.49,53,331,2294,9.8
17794,Mats Lindgren,2003-04,29.0,8,7,20,20,3,4,7,34.0,305.0,274,46,53,99,387.0,82,5.51,63,376,2272,9.9
17795,Mats Lindgren,2004-05,30.0,9,15,59,59,3,12,15,35.0,493.0,333,49,65,114,422.0,82,5.24,53,338,2262,9.5
17796,Mats Lindgren,2005-06,31.0,10,14,54,54,5,9,14,51.0,751.0,387,54,74,128,473.0,82,5.31,60,363,2326,9.4
17797,Mats Naslund,1985-86,26.0,4,71,74,74,26,45,71,122.0,,74,26,45,71,122.0,80,7.73,71,310,2444,12.7
17798,Mats Naslund,1986-87,27.0,5,64,77,77,29,35,64,146.0,,151,55,80,135,268.0,80,7.89,74,336,2448,12.9
17799,Mats Naslund,1987-88,28.0,6,79,80,80,42,37,79,179.0,,231,97,117,214,447.0,80,7.77,71,321,2447,12.7
17800,Mats Naslund,1988-89,29.0,7,110,80,80,43,67,110,225.0,,311,140,184,324,672.0,80,7.94,82,370,2484,12.8
17801,Mats Naslund,1989-90,30.0,8,80,79,79,25,55,80,172.0,,390,165,239,404,844.0,80,7.34,72,344,2400,12.2
17802,Mats Naslund,1990-91,31.0,9,83,78,78,24,59,83,167.0,,468,189,298,487,1011.0,80,7.43,89,437,2435,12.2
17803,Mats Naslund,1991-92,32.0,10,84,77,77,33,51,84,165.0,,545,222,349,571,1176.0,80,7.48,85,403,2430,12.3
17804,Mats Naslund,1992-93,33.0,11,41,72,72,21,20,41,136.0,,617,243,369,612,1312.0,80,7.37,76,367,2421,12.2
17805,Mats Naslund,1997-98,38.0,12,22,34,34,8,14,22,48.0,,651,251,383,634,1360.0,48,5.97,37,209,1408,10.2
17806,Mats Sundin,1993-94,22.0,4,59,80,80,23,36,59,155.0,,80,23,36,59,155.0,80,6.91,71,366,2385,11.6
17807,Mats Sundin,1994-95,23.0,5,76,80,80,33,43,76,231.0,,160,56,79,135,386.0,80,6.96,77,402,2440,11.4
17808,Mats Sundin,1995-96,24.0,6,114,80,80,47,67,114,215.0,,240,103,146,249,601.0,84,7.25,87,443,2603,11.7
17809,Mats Sundin,1996-97,25.0,7,85,84,84,32,53,85,226.0,,324,135,199,334,827.0,84,6.48,76,407,2545,10.7
17810,Mats Sundin,1997-98,26.0,8,47,47,47,23,24,47,173.0,,371,158,223,381,1000.0,48,5.97,37,209,1408,10.2
17811,Mats Sundin,1998-99,27.0,9,83,76,76,33,50,83,301.0,,447,191,273,464,1301.0,82,6.29,74,413,2481,10.4
17812,Mats Sundin,1999-00,28.0,10,94,82,82,41,53,94,281.0,,529,232,326,558,1582.0,82,5.83,55,336,2444,9.8
17813,Mats Sundin,2000-01,29.0,11,74,82,82,33,41,74,219.0,,611,265,367,632,1801.0,82,5.28,57,380,2242,9.6
17814,Mats Sundin,2001-02,30.0,12,83,82,82,31,52,83,209.0,1696.0,693,296,419,715,2010.0,82,5.27,57,359,2285,9.4
17815,Mats Sundin,2002-03,31.0,13,73,73,73,32,41,73,184.0,1473.0,766,328,460,788,2194.0,82,5.49,53,331,2294,9.8
17816,Mats Sundin,2003-04,32.0,14,74,82,82,28,46,74,226.0,1587.0,848,356,506,862,2420.0,82,5.51,63,376,2272,9.9
17817,Mats Sundin,2004-05,33.0,15,80,82,82,41,39,80,262.0,1585.0,930,397,545,942,2682.0,82,5.24,53,338,2262,9.5
17818,Mats Sundin,2005-06,34.0,16,72,75,75,37,35,72,223.0,1519.0,1005,434,580,1014,2905.0,82,5.31,60,363,2326,9.4
17819,Mats Sundin,2006-07,35.0,17,75,81,81,31,44,75,226.0,1609.0,1086,465,624,1089,3131.0,82,5.14,57,348,2300,9.2
17820,Mats Sundin,2008-09,37.0,18,78,70,70,31,47,78,220.0,1399.0,1156,496,671,1167,3351.0,82,6.05,85,480,2458,10.1
17821,Mats Sundin,2009-10,38.0,19,76,75,75,27,49,76,321.0,1535.0,1231,523,720,1243,3672.0,82,5.76,70,398,2426,9.7
17822,Mats Sundin,2010-11,39.0,20,78,74,74,32,46,78,259.0,1485.0,1305,555,766,1321,3931.0,82,5.44,62,351,2383,9.4
17823,Mats Sundin,2011-12,40.0,21,28,41,41,9,19,28,84.0,691.0,1346,564,785,1349,4015.0,82,5.7,65,341,2477,9.4
17824,Mats Thelin,1987-88,26.0,4,18,73,73,5,13,18,91.0,,73,5,13,18,91.0,80,7.77,71,321,2447,12.7
17825,Mats Thelin,1988-89,27.0,5,5,31,31,2,3,5,29.0,,104,7,16,23,120.0,80,7.94,82,370,2484,12.8
17826,Mats Thelin,1989-90,28.0,6,4,59,59,1,3,4,41.0,,163,8,19,27,161.0,80,7.34,72,344,2400,12.2
17827,Mats Zuccarello,2013-14,26.0,4,23,42,42,6,17,23,74.0,595.0,42,6,17,23,74.0,82,5.46,52,291,2492,9.0
17828,Mats Zuccarello,2014-15,27.0,5,3,10,10,2,1,3,10.0,100.0,52,8,18,26,84.0,82,5.32,47,271,2439,8.9
17829,Mats Zuccarello,2015-16,28.0,6,8,15,15,3,5,8,27.0,246.0,67,11,23,34,111.0,48,5.31,29,160,1399,9.1
17830,Mats Zuccarello,2016-17,29.0,7,59,77,77,19,40,59,170.0,1320.0,144,30,63,93,281.0,82,5.34,48,269,2463,8.9
17831,Mats Zuccarello,2017-18,30.0,8,49,78,78,15,34,49,154.0,1346.0,222,45,97,142,435.0,82,5.32,47,251,2453,8.9
17832,Mats Zuccarello,2018-19,31.0,9,61,81,81,26,35,61,166.0,1497.0,303,71,132,203,601.0,82,5.34,48,255,2438,9.0
17833,Mats Zuccarello,2019-20,32.0,10,59,80,80,15,44,59,189.0,1506.0,383,86,176,262,790.0,82,5.45,47,245,2478,9.0
17834,Mats Zuccarello,2020-21,33.0,11,53,80,80,16,37,53,178.0,1514.0,463,102,213,315,968.0,82,5.86,50,250,2620,9.2
17835,Mats Zuccarello,2021-22,34.0,12,40,48,48,12,28,40,104.0,953.0,511,114,241,355,1072.0,82,5.96,47,239,2579,9.5
17836,Mats Zuccarello,2022-23,35.0,13,37,65,65,15,22,37,96.0,1036.0,576,129,263,392,1168.0,70,5.96,42,208,2192,9.5
17837,Matt Anderson,2015-16,33.0,4,1,2,2,0,1,1,0.0,12.0,2,0,1,1,0.0,48,5.31,29,160,1399,9.1
17838,Matt Bartkowski,2013-14,25.0,4,0,6,6,0,0,0,2.0,55.0,6,0,0,0,2.0,82,5.46,52,291,2492,9.0
17839,Matt Bartkowski,2014-15,26.0,5,0,3,3,0,0,0,0.0,18.0,9,0,0,0,2.0,82,5.32,47,271,2439,8.9
17840,Matt Bartkowski,2015-16,27.0,6,2,11,11,0,2,2,9.0,148.0,20,0,2,2,11.0,48,5.31,29,160,1399,9.1
17841,Matt Bartkowski,2016-17,28.0,7,18,64,64,0,18,18,91.0,1250.0,84,0,20,20,102.0,82,5.34,48,269,2463,8.9
17842,Matt Bartkowski,2017-18,29.0,8,4,47,47,0,4,4,67.0,796.0,131,0,24,24,169.0,82,5.32,47,251,2453,8.9
17843,Matt Bartkowski,2018-19,30.0,9,18,80,80,6,12,18,85.0,1490.0,211,6,36,42,254.0,82,5.34,48,255,2438,9.0
17844,Matt Bartkowski,2019-20,31.0,10,2,24,24,1,1,2,16.0,369.0,235,7,37,44,270.0,82,5.45,47,245,2478,9.0
17845,Matt Bartkowski,2020-21,32.0,11,3,18,18,0,3,3,21.0,240.0,253,7,40,47,291.0,82,5.86,50,250,2620,9.2
17846,Matt Bartkowski,2021-22,33.0,12,1,2,2,1,0,1,2.0,21.0,255,8,40,48,293.0,82,5.96,47,239,2579,9.5
17847,Matt Beleskey,2011-12,23.0,4,0,2,2,0,0,0,0.0,22.0,2,0,0,0,0.0,82,5.7,65,341,2477,9.4
17848,Matt Beleskey,2012-13,24.0,5,18,60,60,11,7,18,123.0,839.0,62,11,7,18,123.0,82,5.53,56,304,2486,9.1
17849,Matt Beleskey,2013-14,25.0,6,10,35,35,3,7,10,58.0,454.0,97,14,14,28,181.0,82,5.46,52,291,2492,9.0
17850,Matt Beleskey,2014-15,26.0,7,15,70,70,4,11,15,75.0,719.0,167,18,25,43,256.0,82,5.32,47,271,2439,8.9
17851,Matt Beleskey,2015-16,27.0,8,13,42,42,8,5,13,61.0,505.0,209,26,30,56,317.0,48,5.31,29,160,1399,9.1
17852,Matt Beleskey,2016-17,28.0,9,24,55,55,9,15,24,112.0,684.0,264,35,45,80,429.0,82,5.34,48,269,2463,8.9
17853,Matt Beleskey,2017-18,29.0,10,32,65,65,22,10,32,145.0,941.0,329,57,55,112,574.0,82,5.32,47,251,2453,8.9
17854,Matt Beleskey,2018-19,30.0,11,37,80,80,15,22,37,168.0,1269.0,409,72,77,149,742.0,82,5.34,48,255,2438,9.0
17855,Matt Beleskey,2019-20,31.0,12,8,49,49,3,5,8,79.0,650.0,458,75,82,157,821.0,82,5.45,47,245,2478,9.0
17856,Matt Beleskey,2020-21,32.0,13,0,15,15,0,0,0,17.0,165.0,473,75,82,157,838.0,82,5.86,50,250,2620,9.2
17857,Matt Beleskey,2021-22,33.0,14,1,4,4,1,0,1,3.0,29.0,477,76,82,158,841.0,82,5.96,47,239,2579,9.5
17858,Matt Benning,2019-20,25.0,4,15,62,62,3,12,15,69.0,1030.0,62,3,12,15,69.0,82,5.45,47,245,2478,9.0
17859,Matt Benning,2020-21,26.0,5,21,73,73,6,15,21,111.0,1262.0,135,9,27,36,180.0,82,5.86,50,250,2620,9.2
17860,Matt Benning,2021-22,27.0,6,17,70,70,5,12,17,94.0,1046.0,205,14,39,53,274.0,82,5.96,47,239,2579,9.5
17861,Matt Benning,2022-23,28.0,7,8,43,43,1,7,8,38.0,569.0,248,15,46,61,312.0,70,5.96,42,208,2192,9.5
17862,Matt Bradley,2003-04,25.0,4,2,21,21,1,1,2,16.0,146.0,21,1,1,2,16.0,82,5.51,63,376,2272,9.9
17863,Matt Bradley,2004-05,26.0,5,22,54,54,9,13,22,63.0,457.0,75,10,14,24,79.0,82,5.24,53,338,2262,9.5
17864,Matt Bradley,2005-06,27.0,6,5,46,46,2,3,5,21.0,363.0,121,12,17,29,100.0,82,5.31,60,363,2326,9.4
17865,Matt Bradley,2006-07,28.0,7,16,82,82,7,9,16,85.0,1049.0,203,19,26,45,185.0,82,5.14,57,348,2300,9.2
17866,Matt Bradley,2008-09,30.0,8,19,74,74,7,12,19,87.0,932.0,277,26,38,64,272.0,82,6.05,85,480,2458,10.1
17867,Matt Bradley,2009-10,31.0,9,13,57,57,4,9,13,77.0,679.0,334,30,47,77,349.0,82,5.76,70,398,2426,9.7
17868,Matt Bradley,2010-11,32.0,10,18,77,77,7,11,18,111.0,770.0,411,37,58,95,460.0,82,5.44,62,351,2383,9.4
17869,Matt Bradley,2011-12,33.0,11,11,81,81,5,6,11,98.0,859.0,492,42,64,106,558.0,82,5.7,65,341,2477,9.4
17870,Matt Bradley,2012-13,34.0,12,24,77,77,10,14,24,98.0,849.0,569,52,78,130,656.0,82,5.53,56,304,2486,9.1
17871,Matt Bradley,2013-14,35.0,13,11,61,61,4,7,11,58.0,640.0,630,56,85,141,714.0,82,5.46,52,291,2492,9.0
17872,Matt Bradley,2014-15,36.0,14,8,45,45,3,5,8,35.0,489.0,675,59,90,149,749.0,82,5.32,47,271,2439,8.9
17873,Matt Calvert,2013-14,24.0,4,20,42,42,11,9,20,50.0,466.0,42,11,9,20,50.0,82,5.46,52,291,2492,9.0
17874,Matt Calvert,2014-15,25.0,5,3,13,13,0,3,3,4.0,119.0,55,11,12,23,54.0,82,5.32,47,271,2439,8.9
17875,Matt Calvert,2015-16,26.0,6,16,42,42,9,7,16,63.0,596.0,97,20,19,39,117.0,48,5.31,29,160,1399,9.1
17876,Matt Calvert,2016-17,27.0,7,24,56,56,9,15,24,90.0,902.0,153,29,34,63,207.0,82,5.34,48,269,2463,8.9
17877,Matt Calvert,2017-18,28.0,8,23,56,56,13,10,23,93.0,896.0,209,42,44,86,300.0,82,5.32,47,251,2453,8.9
17878,Matt Calvert,2018-19,29.0,9,24,73,73,11,13,24,114.0,1104.0,282,53,57,110,414.0,82,5.34,48,255,2438,9.0
17879,Matt Calvert,2019-20,30.0,10,15,65,65,10,5,15,92.0,868.0,347,63,62,125,506.0,82,5.45,47,245,2478,9.0
17880,Matt Calvert,2020-21,31.0,11,24,69,69,9,15,24,108.0,923.0,416,72,77,149,614.0,82,5.86,50,250,2620,9.2
17881,Matt Calvert,2021-22,32.0,12,26,82,82,11,15,26,141.0,1164.0,498,83,92,175,755.0,82,5.96,47,239,2579,9.5
17882,Matt Calvert,2022-23,33.0,13,25,50,50,12,13,25,89.0,705.0,548,95,105,200,844.0,70,5.96,42,208,2192,9.5
17883,Matt Campanale,2013-14,25.0,4,0,1,1,0,0,0,0.0,8.0,1,0,0,0,0.0,82,5.46,52,291,2492,9.0
17884,Matt Carey,2016-17,24.0,4,1,2,2,1,0,1,1.0,19.0,2,1,0,1,1.0,82,5.34,48,269,2463,8.9
17885,Matt Carkner,2008-09,28.0,4,1,1,1,0,1,1,0.0,6.0,1,0,1,1,0.0,82,6.05,85,480,2458,10.1
17886,Matt Carkner,2011-12,31.0,5,0,1,1,0,0,0,0.0,4.0,2,0,1,1,0.0,82,5.7,65,341,2477,9.4
17887,Matt Carkner,2012-13,32.0,6,11,81,81,2,9,11,87.0,1370.0,83,2,10,12,87.0,82,5.53,56,304,2486,9.1
17888,Matt Carkner,2013-14,33.0,7,7,50,50,1,6,7,40.0,744.0,133,3,16,19,127.0,82,5.46,52,291,2492,9.0
17889,Matt Carkner,2014-15,34.0,8,3,29,29,1,2,3,17.0,345.0,162,4,18,22,144.0,82,5.32,47,271,2439,8.9
17890,Matt Carkner,2015-16,35.0,9,2,22,22,0,2,2,19.0,277.0,184,4,20,24,163.0,48,5.31,29,160,1399,9.1
17891,Matt Carkner,2016-17,36.0,10,3,53,53,0,3,3,50.0,635.0,237,4,23,27,213.0,82,5.34,48,269,2463,8.9
17892,Matt Carle,2008-09,24.0,4,6,12,12,3,3,6,11.0,193.0,12,3,3,6,11.0,82,6.05,85,480,2458,10.1
17893,Matt Carle,2009-10,25.0,5,42,77,77,11,31,42,111.0,1397.0,89,14,34,48,122.0,82,5.76,70,398,2426,9.7
17894,Matt Carle,2010-11,26.0,6,15,62,62,2,13,15,63.0,1026.0,151,16,47,63,185.0,82,5.44,62,351,2383,9.4
17895,Matt Carle,2011-12,27.0,7,26,76,76,5,21,26,85.0,1626.0,227,21,68,89,270.0,82,5.7,65,341,2477,9.4
17896,Matt Carle,2012-13,28.0,8,35,80,80,6,29,35,137.0,1871.0,307,27,97,124,407.0,82,5.53,56,304,2486,9.1
17897,Matt Carle,2013-14,29.0,9,40,82,82,1,39,40,117.0,1803.0,389,28,136,164,524.0,82,5.46,52,291,2492,9.0
17898,Matt Carle,2014-15,30.0,10,38,82,82,4,34,38,132.0,1888.0,471,32,170,202,656.0,82,5.32,47,271,2439,8.9
17899,Matt Carle,2015-16,31.0,11,22,48,48,5,17,22,66.0,1140.0,519,37,187,224,722.0,48,5.31,29,160,1399,9.1
17900,Matt Carle,2016-17,32.0,12,31,82,82,2,29,31,115.0,1819.0,601,39,216,255,837.0,82,5.34,48,269,2463,8.9
17901,Matt Carle,2017-18,33.0,13,18,59,59,4,14,18,73.0,1209.0,660,43,230,273,910.0,82,5.32,47,251,2453,8.9
17902,Matt Carle,2018-19,34.0,14,9,64,64,2,7,9,54.0,1074.0,724,45,237,282,964.0,82,5.34,48,255,2438,9.0
17903,Matt Carle,2019-20,35.0,15,1,6,6,0,1,1,2.0,79.0,730,45,238,283,966.0,82,5.45,47,245,2478,9.0
17904,Matt Cooke,2001-02,23.0,4,2,30,30,0,2,2,22.0,244.0,30,0,2,2,22.0,82,5.27,57,359,2285,9.4
17905,Matt Cooke,2002-03,24.0,5,12,51,51,5,7,12,58.0,602.0,81,5,9,14,80.0,82,5.49,53,331,2294,9.8
17906,Matt Cooke,2003-04,25.0,6,27,81,81,14,13,27,121.0,1181.0,162,19,22,41,201.0,82,5.51,63,376,2272,9.9
17907,Matt Cooke,2004-05,26.0,7,33,82,82,13,20,33,103.0,1153.0,244,32,42,74,304.0,82,5.24,53,338,2262,9.5
17908,Matt Cooke,2005-06,27.0,8,42,82,82,15,27,42,118.0,1098.0,326,47,69,116,422.0,82,5.31,60,363,2326,9.4
17909,Matt Cooke,2006-07,28.0,9,23,53,53,11,12,23,79.0,747.0,379,58,81,139,501.0,82,5.14,57,348,2300,9.2
17910,Matt Cooke,2008-09,30.0,10,18,45,45,8,10,18,67.0,628.0,424,66,91,157,568.0,82,6.05,85,480,2458,10.1
17911,Matt Cooke,2009-10,31.0,11,30,81,81,10,20,30,133.0,1264.0,505,76,111,187,701.0,82,5.76,70,398,2426,9.7
17912,Matt Cooke,2010-11,32.0,12,23,78,78,10,13,23,86.0,1027.0,583,86,124,210,787.0,82,5.44,62,351,2383,9.4
17913,Matt Cooke,2011-12,33.0,13,31,76,76,13,18,31,86.0,1080.0,659,99,142,241,873.0,82,5.7,65,341,2477,9.4
17914,Matt Cooke,2012-13,34.0,14,30,79,79,15,15,30,105.0,1168.0,738,114,157,271,978.0,82,5.53,56,304,2486,9.1
17915,Matt Cooke,2013-14,35.0,15,30,67,67,12,18,30,95.0,1048.0,805,126,175,301,1073.0,82,5.46,52,291,2492,9.0
17916,Matt Cooke,2014-15,36.0,16,38,82,82,19,19,38,147.0,1286.0,887,145,194,339,1220.0,82,5.32,47,271,2439,8.9
17917,Matt Cooke,2015-16,37.0,17,21,48,48,8,13,21,61.0,706.0,935,153,207,360,1281.0,48,5.31,29,160,1399,9.1
17918,Matt Cooke,2016-17,38.0,18,28,82,82,10,18,28,104.0,1263.0,1017,163,225,388,1385.0,82,5.34,48,269,2463,8.9
17919,Matt Cooke,2017-18,39.0,19,10,29,29,4,6,10,24.0,365.0,1046,167,231,398,1409.0,82,5.32,47,251,2453,8.9
17920,Matt Cullen,2000-01,24.0,4,27,61,61,6,21,27,75.0,,61,6,21,27,75.0,82,5.28,57,380,2242,9.6
17921,Matt Cullen,2001-02,25.0,5,25,75,75,11,14,25,112.0,1164.0,136,17,35,52,187.0,82,5.27,57,359,2285,9.4
17922,Matt Cullen,2002-03,26.0,6,39,80,80,13,26,39,137.0,1352.0,216,30,61,91,324.0,82,5.49,53,331,2294,9.8
17923,Matt Cullen,2003-04,27.0,7,40,82,82,10,30,40,159.0,1496.0,298,40,91,131,483.0,82,5.51,63,376,2272,9.9
17924,Matt Cullen,2004-05,28.0,8,48,79,79,18,30,48,164.0,1344.0,377,58,121,179,647.0,82,5.24,53,338,2262,9.5
17925,Matt Cullen,2005-06,29.0,9,33,80,80,13,20,33,131.0,1157.0,457,71,141,212,778.0,82,5.31,60,363,2326,9.4
17926,Matt Cullen,2006-07,30.0,10,19,56,56,6,13,19,75.0,795.0,513,77,154,231,853.0,82,5.14,57,348,2300,9.2
17927,Matt Cullen,2008-09,32.0,11,49,78,78,25,24,49,214.0,1282.0,591,102,178,280,1067.0,82,6.05,85,480,2458,10.1
17928,Matt Cullen,2009-10,33.0,12,41,80,80,16,25,41,217.0,1373.0,671,118,203,321,1284.0,82,5.76,70,398,2426,9.7
17929,Matt Cullen,2010-11,34.0,13,49,59,59,13,36,49,137.0,996.0,730,131,239,370,1421.0,82,5.44,62,351,2383,9.4
17930,Matt Cullen,2011-12,35.0,14,43,69,69,22,21,43,139.0,1159.0,799,153,260,413,1560.0,82,5.7,65,341,2477,9.4
17931,Matt Cullen,2012-13,36.0,15,48,81,81,16,32,48,195.0,1519.0,880,169,292,461,1755.0,82,5.53,56,304,2486,9.1
17932,Matt Cullen,2013-14,37.0,16,39,78,78,12,27,39,150.0,1406.0,958,181,319,500,1905.0,82,5.46,52,291,2492,9.0
17933,Matt Cullen,2014-15,38.0,17,35,73,73,14,21,35,164.0,1382.0,1031,195,340,535,2069.0,82,5.32,47,271,2439,8.9
17934,Matt Cullen,2015-16,39.0,18,27,42,42,7,20,27,79.0,667.0,1073,202,360,562,2148.0,48,5.31,29,160,1399,9.1
17935,Matt Cullen,2016-17,40.0,19,39,77,77,10,29,39,134.0,1193.0,1150,212,389,601,2282.0,82,5.34,48,269,2463,8.9
17936,Matt Cullen,2017-18,41.0,20,25,62,62,7,18,25,90.0,807.0,1212,219,407,626,2372.0,82,5.32,47,251,2453,8.9
17937,Matt Cullen,2018-19,42.0,21,32,82,82,16,16,32,118.0,1138.0,1294,235,423,658,2490.0,82,5.34,48,255,2438,9.0
17938,Matt Cullen,2019-20,43.0,22,31,72,72,13,18,31,93.0,1002.0,1366,248,441,689,2583.0,82,5.45,47,245,2478,9.0
17939,Matt Cullen,2020-21,44.0,23,22,79,79,11,11,22,104.0,939.0,1445,259,452,711,2687.0,82,5.86,50,250,2620,9.2
17940,Matt Cullen,2021-22,45.0,24,20,71,71,7,13,20,87.0,817.0,1516,266,465,731,2774.0,82,5.96,47,239,2579,9.5
17941,Matt D'Agostini,2010-11,24.0,4,0,1,1,0,0,0,0.0,9.0,1,0,0,0,0.0,82,5.44,62,351,2383,9.4
17942,Matt D'Agostini,2011-12,25.0,5,21,53,53,12,9,21,116.0,711.0,54,12,9,21,116.0,82,5.7,65,341,2477,9.4
17943,Matt D'Agostini,2012-13,26.0,6,4,47,47,2,2,4,54.0,460.0,101,14,11,25,170.0,82,5.53,56,304,2486,9.1
17944,Matt D'Agostini,2013-14,27.0,7,46,82,82,21,25,46,163.0,1210.0,183,35,36,71,333.0,82,5.46,52,291,2492,9.0
17945,Matt D'Agostini,2014-15,28.0,8,18,55,55,9,9,18,101.0,771.0,238,44,45,89,434.0,82,5.32,47,271,2439,8.9
17946,Matt D'Agostini,2015-16,29.0,9,6,29,29,3,3,6,33.0,357.0,267,47,48,95,467.0,48,5.31,29,160,1399,9.1
17947,Matt D'Agostini,2016-17,30.0,10,12,57,57,5,7,12,110.0,847.0,324,52,55,107,577.0,82,5.34,48,269,2463,8.9
17948,Matt Davidson,2003-04,26.0,4,0,5,5,0,0,0,2.0,36.0,5,0,0,0,2.0,82,5.51,63,376,2272,9.9
17949,Matt Davidson,2004-05,27.0,5,3,17,17,1,2,3,18.0,248.0,22,1,2,3,20.0,82,5.24,53,338,2262,9.5
17950,Matt Davidson,2005-06,28.0,6,9,34,34,4,5,9,28.0,402.0,56,5,7,12,48.0,82,5.31,60,363,2326,9.4
17951,Matt Donovan,2014-15,24.0,4,0,3,3,0,0,0,6.0,56.0,3,0,0,0,6.0,82,5.32,47,271,2439,8.9
17952,Matt Donovan,2016-17,26.0,5,16,52,52,2,14,16,86.0,940.0,55,2,14,16,92.0,82,5.34,48,269,2463,8.9
17953,Matt Donovan,2017-18,27.0,6,3,12,12,0,3,3,12.0,211.0,67,2,17,19,104.0,82,5.32,47,251,2453,8.9
17954,Matt Donovan,2021-22,31.0,7,1,2,2,0,1,1,1.0,15.0,69,2,18,20,105.0,82,5.96,47,239,2579,9.5
17955,Matt Duchene,2012-13,22.0,4,55,81,81,24,31,55,180.0,1436.0,81,24,31,55,180.0,82,5.53,56,304,2486,9.1
17956,Matt Duchene,2013-14,23.0,5,67,80,80,27,40,67,202.0,1516.0,161,51,71,122,382.0,82,5.46,52,291,2492,9.0
17957,Matt Duchene,2014-15,24.0,6,28,58,58,14,14,28,132.0,945.0,219,65,85,150,514.0,82,5.32,47,271,2439,8.9
17958,Matt Duchene,2015-16,25.0,7,43,47,47,17,26,43,132.0,983.0,266,82,111,193,646.0,48,5.31,29,160,1399,9.1
17959,Matt Duchene,2016-17,26.0,8,70,71,71,23,47,70,217.0,1313.0,337,105,158,263,863.0,82,5.34,48,269,2463,8.9
17960,Matt Duchene,2017-18,27.0,9,55,82,82,21,34,55,207.0,1523.0,419,126,192,318,1070.0,82,5.32,47,251,2453,8.9
17961,Matt Duchene,2018-19,28.0,10,59,76,76,30,29,59,200.0,1413.0,495,156,221,377,1270.0,82,5.34,48,255,2438,9.0
17962,Matt Duchene,2019-20,29.0,11,41,77,77,18,23,41,160.0,1409.0,572,174,244,418,1430.0,82,5.45,47,245,2478,9.0
17963,Matt Duchene,2020-21,30.0,12,59,82,82,27,32,59,190.0,1503.0,654,201,276,477,1620.0,82,5.86,50,250,2620,9.2
17964,Matt Duchene,2021-22,31.0,13,70,73,73,31,39,70,172.0,1375.0,727,232,315,547,1792.0,82,5.96,47,239,2579,9.5
17965,Matt Duchene,2022-23,32.0,14,42,66,66,13,29,42,136.0,1114.0,793,245,344,589,1928.0,70,5.96,42,208,2192,9.5
17966,Matt Elich,2002-03,23.0,4,2,8,8,1,1,2,5.0,49.0,8,1,1,2,5.0,82,5.49,53,331,2294,9.8
17967,Matt Elich,2003-04,24.0,5,0,8,8,0,0,0,7.0,72.0,16,1,1,2,12.0,82,5.51,63,376,2272,9.9
17968,Matt Ellis,2009-10,28.0,4,0,16,16,0,0,0,22.0,89.0,16,0,0,0,22.0,82,5.76,70,398,2426,9.7
17969,Matt Ellis,2010-11,29.0,5,8,54,54,3,5,8,66.0,429.0,70,3,5,8,88.0,82,5.44,62,351,2383,9.4
17970,Matt Ellis,2011-12,30.0,6,12,45,45,7,5,12,73.0,397.0,115,10,10,20,161.0,82,5.7,65,341,2477,9.4
17971,Matt Ellis,2012-13,31.0,7,13,72,72,3,10,13,112.0,652.0,187,13,20,33,273.0,82,5.53,56,304,2486,9.1
17972,Matt Ellis,2013-14,32.0,8,0,14,14,0,0,0,20.0,141.0,201,13,20,33,293.0,82,5.46,52,291,2492,9.0
17973,Matt Ellis,2014-15,33.0,9,8,60,60,3,5,8,85.0,583.0,261,16,25,41,378.0,82,5.32,47,271,2439,8.9
17974,Matt Ellis,2015-16,34.0,10,0,6,6,0,0,0,8.0,37.0,267,16,25,41,386.0,48,5.31,29,160,1399,9.1
17975,Matt Ellis,2016-17,35.0,11,6,50,50,4,2,6,70.0,474.0,317,20,27,47,456.0,82,5.34,48,269,2463,8.9
17976,Matt Ellis,2017-18,36.0,12,2,39,39,1,1,2,29.0,325.0,356,21,28,49,485.0,82,5.32,47,251,2453,8.9
17977,Matt Ellison,2006-07,23.0,4,1,10,10,0,1,1,4.0,127.0,10,0,1,1,4.0,82,5.14,57,348,2300,9.2
17978,Matt Ellison,2008-09,25.0,5,13,31,31,3,10,13,49.0,416.0,41,3,11,14,53.0,82,6.05,85,480,2458,10.1
17979,Matt Ellison,2009-10,26.0,6,0,2,2,0,0,0,1.0,12.0,43,3,11,14,54.0,82,5.76,70,398,2426,9.7
17980,Matt Foy,2008-09,25.0,4,5,19,19,2,3,5,21.0,209.0,19,2,3,5,21.0,82,6.05,85,480,2458,10.1
17981,Matt Foy,2009-10,26.0,5,0,9,9,0,0,0,6.0,65.0,28,2,3,5,27.0,82,5.76,70,398,2426,9.7
17982,Matt Foy,2010-11,27.0,6,8,28,28,4,4,8,38.0,219.0,56,6,7,13,65.0,82,5.44,62,351,2383,9.4
17983,Matt Fraser,2014-15,24.0,4,0,1,1,0,0,0,1.0,4.0,1,0,0,0,1.0,82,5.32,47,271,2439,8.9
17984,Matt Fraser,2015-16,25.0,5,3,12,12,1,2,3,17.0,142.0,13,1,2,3,18.0,48,5.31,29,160,1399,9.1
17985,Matt Fraser,2016-17,26.0,6,2,14,14,2,0,2,13.0,135.0,27,3,2,5,31.0,82,5.34,48,269,2463,8.9
17986,Matt Fraser,2017-18,27.0,7,12,60,60,8,4,12,92.0,673.0,87,11,6,17,123.0,82,5.32,47,251,2453,8.9
17987,Matt Frattin,2013-14,26.0,4,0,1,1,0,0,0,5.0,16.0,1,0,0,0,5.0,82,5.46,52,291,2492,9.0
17988,Matt Frattin,2014-15,27.0,5,15,56,56,8,7,15,92.0,737.0,57,8,7,15,97.0,82,5.32,47,271,2439,8.9
17989,Matt Frattin,2015-16,28.0,6,13,25,25,7,6,13,42.0,331.0,82,15,13,28,139.0,48,5.31,29,160,1399,9.1
17990,Matt Frattin,2016-17,29.0,7,7,44,44,2,5,7,61.0,529.0,126,17,18,35,200.0,82,5.34,48,269,2463,8.9
17991,Matt Frattin,2017-18,30.0,8,0,9,9,0,0,0,6.0,64.0,135,17,18,35,206.0,82,5.32,47,251,2453,8.9
17992,Matt Gilroy,2012-13,28.0,4,15,69,69,4,11,15,82.0,1126.0,69,4,11,15,82.0,82,5.53,56,304,2486,9.1
17993,Matt Gilroy,2013-14,29.0,5,11,58,58,3,8,11,75.0,822.0,127,7,19,26,157.0,82,5.46,52,291,2492,9.0
17994,Matt Gilroy,2014-15,30.0,6,20,67,67,3,17,20,80.0,1173.0,194,10,36,46,237.0,82,5.32,47,271,2439,8.9
17995,Matt Gilroy,2015-16,31.0,7,0,15,15,0,0,0,14.0,143.0,209,10,36,46,251.0,48,5.31,29,160,1399,9.1
17996,Matt Gilroy,2016-17,32.0,8,2,16,16,1,1,2,27.0,260.0,225,11,37,48,278.0,82,5.34,48,269,2463,8.9
17997,Matt Glennon,1994-95,26.0,4,0,3,3,0,0,0,2.0,,3,0,0,0,2.0,80,6.96,77,402,2440,11.4
17998,Matt Greene,2008-09,25.0,4,2,27,27,0,2,2,10.0,303.0,27,0,2,2,10.0,82,6.05,85,480,2458,10.1
17999,Matt Greene,2009-10,26.0,5,10,78,78,1,9,10,52.0,1373.0,105,1,11,12,62.0,82,5.76,70,398,2426,9.7
18000,Matt Greene,2010-11,27.0,6,1,46,46,0,1,1,28.0,768.0,151,1,12,13,90.0,82,5.44,62,351,2383,9.4
18001,Matt Greene,2011-12,28.0,7,14,82,82,2,12,14,76.0,1619.0,233,3,24,27,166.0,82,5.7,65,341,2477,9.4
18002,Matt Greene,2012-13,29.0,8,9,75,75,2,7,9,57.0,1311.0,308,5,31,36,223.0,82,5.53,56,304,2486,9.1
18003,Matt Greene,2013-14,30.0,9,11,71,71,2,9,11,50.0,1205.0,379,7,40,47,273.0,82,5.46,52,291,2492,9.0
18004,Matt Greene,2014-15,31.0,10,15,82,82,4,11,15,76.0,1367.0,461,11,51,62,349.0,82,5.32,47,271,2439,8.9
18005,Matt Greene,2015-16,32.0,11,1,5,5,0,1,1,3.0,76.0,466,11,52,63,352.0,48,5.31,29,160,1399,9.1
18006,Matt Greene,2016-17,33.0,12,6,38,38,2,4,6,38.0,604.0,504,13,56,69,390.0,82,5.34,48,269,2463,8.9
18007,Matt Greene,2017-18,34.0,13,9,82,82,3,6,9,69.0,1296.0,586,16,62,78,459.0,82,5.32,47,251,2453,8.9
18008,Matt Greene,2018-19,35.0,14,0,3,3,0,0,0,3.0,35.0,589,16,62,78,462.0,82,5.34,48,255,2438,9.0
18009,Matt Greene,2019-20,36.0,15,2,26,26,1,1,2,14.0,343.0,615,17,63,80,476.0,82,5.45,47,245,2478,9.0
18010,Matt Grzelcyk,2019-20,26.0,4,0,2,2,0,0,0,4.0,25.0,2,0,0,0,4.0,82,5.45,47,245,2478,9.0
18011,Matt Grzelcyk,2020-21,27.0,5,15,61,61,3,12,15,82.0,1021.0,63,3,12,15,86.0,82,5.86,50,250,2620,9.2
18012,Matt Grzelcyk,2021-22,28.0,6,18,66,66,3,15,18,90.0,1263.0,129,6,27,33,176.0,82,5.96,47,239,2579,9.5
18013,Matt Grzelcyk,2022-23,29.0,7,21,68,68,4,17,21,112.0,1228.0,197,10,44,54,288.0,70,5.96,42,208,2192,9.5
18014,Matt Halischuk,2011-12,23.0,4,1,1,1,0,1,1,0.0,10.0,1,0,1,1,0.0,82,5.7,65,341,2477,9.4
18015,Matt Halischuk,2012-13,24.0,5,2,20,20,1,1,2,22.0,226.0,21,1,2,3,22.0,82,5.53,56,304,2486,9.1
18016,Matt Halischuk,2013-14,25.0,6,12,27,27,4,8,12,29.0,273.0,48,5,10,15,51.0,82,5.46,52,291,2492,9.0
18017,Matt Halischuk,2014-15,26.0,7,28,73,73,15,13,28,96.0,822.0,121,20,23,43,147.0,82,5.32,47,271,2439,8.9
18018,Matt Halischuk,2015-16,27.0,8,11,36,36,5,6,11,51.0,430.0,157,25,29,54,198.0,48,5.31,29,160,1399,9.1
18019,Matt Halischuk,2016-17,28.0,9,10,46,46,5,5,10,56.0,521.0,203,30,34,64,254.0,82,5.34,48,269,2463,8.9
18020,Matt Halischuk,2017-18,29.0,10,8,47,47,3,5,8,59.0,458.0,250,33,39,72,313.0,82,5.32,47,251,2453,8.9
18021,Matt Halischuk,2018-19,30.0,11,3,30,30,0,3,3,39.0,284.0,280,33,42,75,352.0,82,5.34,48,255,2438,9.0
18022,Matt Henderson,2001-02,27.0,4,0,2,2,0,0,0,0.0,13.0,2,0,0,0,0.0,82,5.27,57,359,2285,9.4
18023,Matt Henderson,2004-05,30.0,5,1,4,4,0,1,1,3.0,29.0,6,0,1,1,3.0,82,5.24,53,338,2262,9.5
18024,Matt Hendricks,2011-12,30.0,4,0,4,4,0,0,0,5.0,34.0,4,0,0,0,5.0,82,5.7,65,341,2477,9.4
18025,Matt Hendricks,2012-13,31.0,5,16,56,56,9,7,16,63.0,519.0,60,9,7,16,68.0,82,5.53,56,304,2486,9.1
18026,Matt Hendricks,2013-14,32.0,6,25,77,77,9,16,25,113.0,882.0,137,18,23,41,181.0,82,5.46,52,291,2492,9.0
18027,Matt Hendricks,2014-15,33.0,7,9,78,78,4,5,9,97.0,946.0,215,22,28,50,278.0,82,5.32,47,271,2439,8.9
18028,Matt Hendricks,2015-16,34.0,8,8,48,48,5,3,8,54.0,563.0,263,27,31,58,332.0,48,5.31,29,160,1399,9.1
18029,Matt Hendricks,2016-17,35.0,9,7,77,77,5,2,7,102.0,981.0,340,32,33,65,434.0,82,5.34,48,269,2463,8.9
18030,Matt Hendricks,2017-18,36.0,10,16,71,71,8,8,16,103.0,934.0,411,40,41,81,537.0,82,5.32,47,251,2453,8.9
18031,Matt Hendricks,2018-19,37.0,11,12,68,68,5,7,12,62.0,900.0,479,45,48,93,599.0,82,5.34,48,255,2438,9.0
18032,Matt Hendricks,2019-20,38.0,12,7,42,42,4,3,7,42.0,451.0,521,49,51,100,641.0,82,5.45,47,245,2478,9.0
18033,Matt Hendricks,2020-21,39.0,13,13,60,60,5,8,13,56.0,565.0,581,54,59,113,697.0,82,5.86,50,250,2620,9.2
18034,Matt Hendricks,2021-22,40.0,14,3,26,26,0,3,3,23.0,230.0,607,54,62,116,720.0,82,5.96,47,239,2579,9.5
18035,Matt Herr,2001-02,25.0,4,4,30,30,2,2,4,40.0,333.0,30,2,2,4,40.0,82,5.27,57,359,2285,9.4
18036,Matt Herr,2003-04,27.0,5,5,22,22,2,3,5,20.0,179.0,52,4,5,9,60.0,82,5.51,63,376,2272,9.9
18037,Matt Herr,2004-05,28.0,6,0,3,3,0,0,0,1.0,19.0,55,4,5,9,61.0,82,5.24,53,338,2262,9.5
18038,Matt Herr,2005-06,29.0,7,0,3,3,0,0,0,1.0,25.0,58,4,5,9,62.0,82,5.31,60,363,2326,9.4
18039,Matt Hervey,1991-92,23.0,4,0,2,2,0,0,0,1.0,,2,0,0,0,1.0,80,7.48,85,403,2430,12.3
18040,Matt Hervey,1994-95,26.0,5,1,16,16,0,1,1,8.0,,18,0,1,1,9.0,80,6.96,77,402,2440,11.4
18041,Matt Hervey,1995-96,27.0,6,4,17,17,0,4,4,18.0,,35,0,5,5,27.0,84,7.25,87,443,2603,11.7
18042,Matt Higgins,2000-01,23.0,4,0,1,1,0,0,0,1.0,,1,0,0,0,1.0,82,5.28,57,380,2242,9.6
18043,Matt Higgins,2001-02,24.0,5,1,25,25,1,0,1,12.0,142.0,26,1,0,1,13.0,82,5.27,57,359,2285,9.4
18044,Matt Higgins,2002-03,25.0,6,2,25,25,0,2,2,9.0,199.0,51,1,2,3,22.0,82,5.49,53,331,2294,9.8
18045,Matt Higgins,2003-04,26.0,7,0,6,6,0,0,0,3.0,57.0,57,1,2,3,25.0,82,5.51,63,376,2272,9.9
18046,Matt Hunwick,2010-11,25.0,4,1,13,13,0,1,1,6.0,138.0,13,0,1,1,6.0,82,5.44,62,351,2383,9.4
18047,Matt Hunwick,2011-12,26.0,5,27,53,53,6,21,27,58.0,900.0,66,6,22,28,64.0,82,5.7,65,341,2477,9.4
18048,Matt Hunwick,2012-13,27.0,6,14,76,76,6,8,14,60.0,1365.0,142,12,30,42,124.0,82,5.53,56,304,2486,9.1
18049,Matt Hunwick,2013-14,28.0,7,13,73,73,1,12,13,100.0,1351.0,215,13,42,55,224.0,82,5.46,52,291,2492,9.0
18050,Matt Hunwick,2014-15,29.0,8,6,33,33,3,3,6,40.0,596.0,248,16,45,61,264.0,82,5.32,47,271,2439,8.9
18051,Matt Hunwick,2015-16,30.0,9,6,43,43,0,6,6,57.0,925.0,291,16,51,67,321.0,48,5.31,29,160,1399,9.1
18052,Matt Hunwick,2016-17,31.0,10,0,1,1,0,0,0,1.0,17.0,292,16,51,67,322.0,82,5.34,48,269,2463,8.9
18053,Matt Hunwick,2017-18,32.0,11,11,55,55,2,9,11,72.0,870.0,347,18,60,78,394.0,82,5.32,47,251,2453,8.9
18054,Matt Hunwick,2018-19,33.0,12,10,60,60,2,8,10,74.0,1354.0,407,20,68,88,468.0,82,5.34,48,255,2438,9.0
18055,Matt Hunwick,2019-20,34.0,13,19,72,72,1,18,19,73.0,1294.0,479,21,86,107,541.0,82,5.45,47,245,2478,9.0
18056,Matt Hunwick,2020-21,35.0,14,10,42,42,4,6,10,52.0,735.0,521,25,92,117,593.0,82,5.86,50,250,2620,9.2
18057,Matt Hunwick,2021-22,36.0,15,2,14,14,0,2,2,10.0,220.0,535,25,94,119,603.0,82,5.96,47,239,2579,9.5
18058,Matt Hussey,2006-07,27.0,4,3,3,3,2,1,3,8.0,41.0,3,2,1,3,8.0,82,5.14,57,348,2300,9.2
18059,Matt Hussey,2008-09,29.0,5,1,13,13,0,1,1,17.0,134.0,16,2,2,4,25.0,82,6.05,85,480,2458,10.1
18060,Matt Hussey,2009-10,30.0,6,0,5,5,0,0,0,6.0,28.0,21,2,2,4,31.0,82,5.76,70,398,2426,9.7
18061,Matt Irwin,2015-16,28.0,4,12,38,38,6,6,12,79.0,726.0,38,6,6,12,79.0,48,5.31,29,160,1399,9.1
18062,Matt Irwin,2016-17,29.0,5,19,62,62,2,17,19,147.0,1167.0,100,8,23,31,226.0,82,5.34,48,269,2463,8.9
18063,Matt Irwin,2017-18,30.0,6,19,53,53,8,11,19,93.0,902.0,153,16,34,50,319.0,82,5.32,47,251,2453,8.9
18064,Matt Irwin,2018-19,31.0,7,0,2,2,0,0,0,3.0,30.0,155,16,34,50,322.0,82,5.34,48,255,2438,9.0
18065,Matt Irwin,2019-20,32.0,8,14,74,74,3,11,14,98.0,1204.0,229,19,45,64,420.0,82,5.45,47,245,2478,9.0
18066,Matt Irwin,2020-21,33.0,9,8,50,50,2,6,8,62.0,672.0,279,21,51,72,482.0,82,5.86,50,250,2620,9.2
18067,Matt Irwin,2021-22,34.0,10,7,44,44,1,6,7,50.0,497.0,323,22,57,79,532.0,82,5.96,47,239,2579,9.5
18068,Matt Irwin,2022-23,35.0,11,3,36,36,0,3,3,58.0,521.0,359,22,60,82,590.0,70,5.96,42,208,2192,9.5
18069,Matt Johnson,1997-98,22.0,4,1,14,14,1,0,1,4.0,,14,1,0,1,4.0,48,5.97,37,209,1408,10.2
18070,Matt Johnson,1998-99,23.0,5,0,1,1,0,0,0,1.0,,15,1,0,1,5.0,82,6.29,74,413,2481,10.4
18071,Matt Johnson,1999-00,24.0,6,4,52,52,1,3,4,20.0,,67,2,3,5,25.0,82,5.83,55,336,2444,9.8
18072,Matt Johnson,2000-01,25.0,7,6,66,66,2,4,6,18.0,,133,4,7,11,43.0,82,5.28,57,380,2242,9.6
18073,Matt Johnson,2001-02,26.0,8,3,49,49,2,1,3,14.0,290.0,182,6,8,14,57.0,82,5.27,57,359,2285,9.4
18074,Matt Johnson,2002-03,27.0,9,7,64,64,2,5,7,54.0,539.0,246,8,13,21,111.0,82,5.49,53,331,2294,9.8
18075,Matt Johnson,2003-04,28.0,10,2,50,50,1,1,2,21.0,385.0,296,9,14,23,132.0,82,5.51,63,376,2272,9.9
18076,Matt Johnson,2004-05,29.0,11,4,60,60,4,0,4,23.0,443.0,356,13,14,27,155.0,82,5.24,53,338,2262,9.5
18077,Matt Johnson,2005-06,30.0,12,8,60,60,3,5,8,24.0,444.0,416,16,19,35,179.0,82,5.31,60,363,2326,9.4
18078,Matt Johnson,2006-07,31.0,13,8,57,57,7,1,8,21.0,368.0,473,23,20,43,200.0,82,5.14,57,348,2300,9.2
18079,Matt Jones,2008-09,25.0,4,2,16,16,0,2,2,10.0,185.0,16,0,2,2,10.0,82,6.05,85,480,2458,10.1
18080,Matt Jones,2009-10,26.0,5,7,45,45,1,6,7,20.0,737.0,61,1,8,9,30.0,82,5.76,70,398,2426,9.7
18081,Matt Jones,2010-11,27.0,6,2,45,45,0,2,2,25.0,655.0,106,1,10,11,55.0,82,5.44,62,351,2383,9.4
18082,Matt Kassian,2013-14,27.0,4,0,4,4,0,0,0,1.0,22.0,4,0,0,0,1.0,82,5.46,52,291,2492,9.0
18083,Matt Kassian,2014-15,28.0,5,2,24,24,2,0,2,13.0,133.0,28,2,0,2,14.0,82,5.32,47,271,2439,8.9
18084,Matt Kassian,2015-16,29.0,6,1,15,15,1,0,1,6.0,96.0,43,3,0,3,20.0,48,5.31,29,160,1399,9.1
18085,Matt Kassian,2016-17,30.0,7,2,33,33,1,1,2,12.0,146.0,76,4,1,5,32.0,82,5.34,48,269,2463,8.9
18086,Matt Keith,2006-07,23.0,4,5,20,20,2,3,5,21.0,239.0,20,2,3,5,21.0,82,5.14,57,348,2300,9.2
18087,Matt Keith,2008-09,25.0,5,0,2,2,0,0,0,6.0,23.0,22,2,3,5,27.0,82,6.05,85,480,2458,10.1
18088,Matt Keith,2009-10,26.0,6,0,2,2,0,0,0,0.0,19.0,24,2,3,5,27.0,82,5.76,70,398,2426,9.7
18089,Matt Keith,2010-11,27.0,7,0,3,3,0,0,0,3.0,32.0,27,2,3,5,30.0,82,5.44,62,351,2383,9.4
18090,Matt Koalska,2008-09,28.0,4,0,3,3,0,0,0,3.0,17.0,3,0,0,0,3.0,82,6.05,85,480,2458,10.1
18091,Matt Lashoff,2009-10,23.0,4,2,12,12,0,2,2,8.0,179.0,12,0,2,2,8.0,82,5.76,70,398,2426,9.7
18092,Matt Lashoff,2010-11,24.0,5,5,18,18,1,4,5,11.0,244.0,30,1,6,7,19.0,82,5.44,62,351,2383,9.4
18093,Matt Lashoff,2011-12,25.0,6,8,28,28,0,8,8,25.0,495.0,58,1,14,15,44.0,82,5.7,65,341,2477,9.4
18094,Matt Lashoff,2012-13,26.0,7,0,5,5,0,0,0,2.0,44.0,63,1,14,15,46.0,82,5.53,56,304,2486,9.1
18095,Matt Lashoff,2013-14,27.0,8,1,11,11,0,1,1,8.0,152.0,74,1,15,16,54.0,82,5.46,52,291,2492,9.0
18096,Matt Lindblad,2016-17,26.0,4,0,2,2,0,0,0,0.0,24.0,2,0,0,0,0.0,82,5.34,48,269,2463,8.9
18097,Matt Lindblad,2017-18,27.0,5,0,2,2,0,0,0,3.0,16.0,4,0,0,0,3.0,82,5.32,47,251,2453,8.9
18098,Matt Luff,2021-22,24.0,4,11,33,33,8,3,11,45.0,367.0,33,8,3,11,45.0,82,5.96,47,239,2579,9.5
18099,Matt Luff,2022-23,25.0,5,5,18,18,1,4,5,25.0,187.0,51,9,7,16,70.0,70,5.96,42,208,2192,9.5
18100,Matt Martin,1996-97,25.0,4,1,12,12,0,1,1,6.0,,12,0,1,1,6.0,84,6.48,76,407,2545,10.7
18101,Matt Martin,1997-98,26.0,5,0,15,15,0,0,0,14.0,,27,0,1,1,20.0,48,5.97,37,209,1408,10.2
18102,Matt Martin,1998-99,27.0,6,0,13,13,0,0,0,3.0,,40,0,1,1,23.0,82,6.29,74,413,2481,10.4
18103,Matt Martin,1999-00,28.0,7,4,36,36,0,4,4,30.0,,76,0,5,5,53.0,82,5.83,55,336,2444,9.8
18104,Matt Martin0,2012-13,23.0,4,2,5,5,0,2,2,10.0,66.0,5,0,2,2,10.0,82,5.53,56,304,2486,9.1
18105,Matt Martin0,2013-14,24.0,5,14,68,68,5,9,14,60.0,745.0,73,5,11,16,70.0,82,5.46,52,291,2492,9.0
18106,Matt Martin0,2014-15,25.0,6,14,80,80,7,7,14,130.0,973.0,153,12,18,30,200.0,82,5.32,47,271,2439,8.9
18107,Matt Martin0,2015-16,26.0,7,11,48,48,4,7,11,67.0,572.0,201,16,25,41,267.0,48,5.31,29,160,1399,9.1
18108,Matt Martin0,2016-17,27.0,8,14,79,79,8,6,14,120.0,940.0,280,24,31,55,387.0,82,5.34,48,269,2463,8.9
18109,Matt Martin0,2017-18,28.0,9,14,78,78,8,6,14,90.0,879.0,358,32,37,69,477.0,82,5.32,47,251,2453,8.9
18110,Matt Martin0,2018-19,29.0,10,19,80,80,10,9,19,86.0,845.0,438,42,46,88,563.0,82,5.34,48,255,2438,9.0
18111,Matt Martin0,2019-20,30.0,11,9,82,82,5,4,9,66.0,730.0,520,47,50,97,629.0,82,5.45,47,245,2478,9.0
18112,Matt Martin0,2020-21,31.0,12,12,50,50,3,9,12,46.0,399.0,570,50,59,109,675.0,82,5.86,50,250,2620,9.2
18113,Matt Martin0,2021-22,32.0,13,14,67,67,6,8,14,62.0,766.0,637,56,67,123,737.0,82,5.96,47,239,2579,9.5
18114,Matt Martin0,2022-23,33.0,14,8,55,55,5,3,8,49.0,573.0,692,61,70,131,786.0,70,5.96,42,208,2192,9.5
18115,Matt Moulson,2010-11,27.0,4,9,22,22,5,4,9,35.0,266.0,22,5,4,9,35.0,82,5.44,62,351,2383,9.4
18116,Matt Moulson,2011-12,28.0,5,1,7,7,1,0,1,6.0,101.0,29,6,4,10,41.0,82,5.7,65,341,2477,9.4
18117,Matt Moulson,2012-13,29.0,6,48,82,82,30,18,48,208.0,1364.0,111,36,22,58,249.0,82,5.53,56,304,2486,9.1
18118,Matt Moulson,2013-14,30.0,7,53,82,82,31,22,53,237.0,1547.0,193,67,44,111,486.0,82,5.46,52,291,2492,9.0
18119,Matt Moulson,2014-15,31.0,8,69,82,82,36,33,69,219.0,1583.0,275,103,77,180,705.0,82,5.32,47,271,2439,8.9
18120,Matt Moulson,2015-16,32.0,9,44,47,47,15,29,44,154.0,900.0,322,118,106,224,859.0,48,5.31,29,160,1399,9.1
18121,Matt Moulson,2016-17,33.0,10,51,75,75,23,28,51,176.0,1348.0,397,141,134,275,1035.0,82,5.34,48,269,2463,8.9
18122,Matt Moulson,2017-18,34.0,11,41,77,77,13,28,41,156.0,1362.0,474,154,162,316,1191.0,82,5.32,47,251,2453,8.9
18123,Matt Moulson,2018-19,35.0,12,21,81,81,8,13,21,111.0,964.0,555,162,175,337,1302.0,82,5.34,48,255,2438,9.0
18124,Matt Moulson,2019-20,36.0,13,32,81,81,14,18,32,134.0,940.0,636,176,193,369,1436.0,82,5.45,47,245,2478,9.0
18125,Matt Moulson,2020-21,37.0,14,0,14,14,0,0,0,13.0,144.0,650,176,193,369,1449.0,82,5.86,50,250,2620,9.2
18126,Matt Murley,2006-07,27.0,4,2,18,18,1,1,2,20.0,213.0,18,1,1,2,20.0,82,5.14,57,348,2300,9.2
18127,Matt Murley,2008-09,29.0,5,6,41,41,1,5,6,48.0,470.0,59,2,6,8,68.0,82,6.05,85,480,2458,10.1
18128,Matt Murley,2010-11,31.0,6,1,3,3,0,1,1,3.0,35.0,62,2,7,9,71.0,82,5.44,62,351,2383,9.4
18129,Matt Niskanen,2010-11,24.0,4,26,78,78,7,19,26,99.0,1598.0,78,7,19,26,99.0,82,5.44,62,351,2383,9.4
18130,Matt Niskanen,2011-12,25.0,5,35,80,80,6,29,35,111.0,1598.0,158,13,48,61,210.0,82,5.7,65,341,2477,9.4
18131,Matt Niskanen,2012-13,26.0,6,15,74,74,3,12,15,110.0,1351.0,232,16,60,76,320.0,82,5.53,56,304,2486,9.1
18132,Matt Niskanen,2013-14,27.0,7,10,63,63,1,9,10,77.0,1041.0,295,17,69,86,397.0,82,5.46,52,291,2492,9.0
18133,Matt Niskanen,2014-15,28.0,8,21,75,75,4,17,21,118.0,1345.0,370,21,86,107,515.0,82,5.32,47,271,2439,8.9
18134,Matt Niskanen,2015-16,29.0,9,14,40,40,4,10,14,67.0,814.0,410,25,96,121,582.0,48,5.31,29,160,1399,9.1
18135,Matt Niskanen,2016-17,30.0,10,46,81,81,10,36,46,162.0,1725.0,491,35,132,167,744.0,82,5.34,48,269,2463,8.9
18136,Matt Niskanen,2017-18,31.0,11,31,82,82,4,27,31,117.0,1833.0,573,39,159,198,861.0,82,5.32,47,251,2453,8.9
18137,Matt Niskanen,2018-19,32.0,12,32,82,82,5,27,32,150.0,2022.0,655,44,186,230,1011.0,82,5.34,48,255,2438,9.0
18138,Matt Niskanen,2019-20,33.0,13,39,78,78,5,34,39,154.0,1730.0,733,49,220,269,1165.0,82,5.45,47,245,2478,9.0
18139,Matt Niskanen,2020-21,34.0,14,29,68,68,7,22,29,120.0,1537.0,801,56,242,298,1285.0,82,5.86,50,250,2620,9.2
18140,Matt Niskanen,2021-22,35.0,15,25,80,80,8,17,25,143.0,1755.0,881,64,259,323,1428.0,82,5.96,47,239,2579,9.5
18141,Matt Niskanen,2022-23,36.0,16,33,68,68,8,25,33,126.0,1490.0,949,72,284,356,1554.0,70,5.96,42,208,2192,9.5
18142,Matt Pelech,2011-12,24.0,4,3,5,5,0,3,3,4.0,66.0,5,0,3,3,4.0,82,5.7,65,341,2477,9.4
18143,Matt Pelech,2015-16,28.0,5,0,2,2,0,0,0,0.0,18.0,7,0,3,3,4.0,48,5.31,29,160,1399,9.1
18144,Matt Pelech,2016-17,29.0,6,1,6,6,1,0,1,3.0,24.0,13,1,3,4,7.0,82,5.34,48,269,2463,8.9
18145,Matt Pettinger,2003-04,23.0,4,0,10,10,0,0,0,6.0,78.0,10,0,0,0,6.0,82,5.51,63,376,2272,9.9
18146,Matt Pettinger,2004-05,24.0,5,10,61,61,7,3,10,73.0,588.0,71,7,3,10,79.0,82,5.24,53,338,2262,9.5
18147,Matt Pettinger,2005-06,25.0,6,0,1,1,0,0,0,0.0,4.0,72,7,3,10,79.0,82,5.31,60,363,2326,9.4
18148,Matt Pettinger,2006-07,26.0,7,12,71,71,7,5,12,92.0,810.0,143,14,8,22,171.0,82,5.14,57,348,2300,9.2
18149,Matt Pettinger,2008-09,28.0,8,38,71,71,20,18,38,134.0,1099.0,214,34,26,60,305.0,82,6.05,85,480,2458,10.1
18150,Matt Pettinger,2009-10,29.0,9,32,64,64,16,16,32,111.0,1081.0,278,50,42,92,416.0,82,5.76,70,398,2426,9.7
18151,Matt Pettinger,2010-11,30.0,10,13,76,76,6,7,13,127.0,1087.0,354,56,49,105,543.0,82,5.44,62,351,2383,9.4
18152,Matt Pettinger,2011-12,31.0,11,15,59,59,8,7,15,82.0,727.0,413,64,56,120,625.0,82,5.7,65,341,2477,9.4
18153,Matt Pettinger,2012-13,32.0,12,3,9,9,1,2,3,8.0,97.0,422,65,58,123,633.0,82,5.53,56,304,2486,9.1
18154,Matt Puempel,2017-18,25.0,4,3,13,13,2,1,3,14.0,104.0,13,2,1,3,14.0,82,5.32,47,251,2453,8.9
18155,Matt Puempel,2018-19,26.0,5,3,26,26,2,1,3,26.0,295.0,39,4,2,6,40.0,82,5.34,48,255,2438,9.0
18156,Matt Puempel,2019-20,27.0,6,9,40,40,6,3,9,44.0,386.0,79,10,5,15,84.0,82,5.45,47,245,2478,9.0
18157,Matt Puempel,2021-22,29.0,7,1,8,8,1,0,1,10.0,83.0,87,11,5,16,94.0,82,5.96,47,239,2579,9.5
18158,Matt Read,2014-15,28.0,4,47,79,79,24,23,47,155.0,1348.0,79,24,23,47,155.0,82,5.32,47,271,2439,8.9
18159,Matt Read,2015-16,29.0,5,24,42,42,11,13,24,72.0,757.0,121,35,36,71,227.0,48,5.31,29,160,1399,9.1
18160,Matt Read,2016-17,30.0,6,40,75,75,22,18,40,151.0,1410.0,196,57,54,111,378.0,82,5.34,48,269,2463,8.9
18161,Matt Read,2017-18,31.0,7,30,80,80,8,22,30,142.0,1405.0,276,65,76,141,520.0,82,5.32,47,251,2453,8.9
18162,Matt Read,2018-19,32.0,8,26,79,79,11,15,26,127.0,1205.0,355,76,91,167,647.0,82,5.34,48,255,2438,9.0
18163,Matt Read,2019-20,33.0,9,19,63,63,10,9,19,92.0,869.0,418,86,100,186,739.0,82,5.45,47,245,2478,9.0
18164,Matt Read,2020-21,34.0,10,1,19,19,1,0,1,16.0,207.0,437,87,100,187,755.0,82,5.86,50,250,2620,9.2
18165,Matt Read,2021-22,35.0,11,1,12,12,1,0,1,13.0,141.0,449,88,100,188,768.0,82,5.96,47,239,2579,9.5
18166,Matt Roy,2021-22,26.0,4,6,25,25,2,4,6,34.0,428.0,25,2,4,6,34.0,82,5.96,47,239,2579,9.5
18167,Matt Roy,2022-23,27.0,5,18,70,70,4,14,18,112.0,1268.0,95,6,18,24,146.0,70,5.96,42,208,2192,9.5
18168,Matt Ryan,2008-09,25.0,4,1,12,12,0,1,1,8.0,73.0,12,0,1,1,8.0,82,6.05,85,480,2458,10.1
18169,Matt Smaby,2010-11,26.0,4,0,14,14,0,0,0,7.0,170.0,14,0,0,0,7.0,82,5.44,62,351,2383,9.4
18170,Matt Smaby,2011-12,27.0,5,4,43,43,0,4,4,28.0,821.0,57,0,4,4,35.0,82,5.7,65,341,2477,9.4
18171,Matt Smaby,2012-13,28.0,6,2,33,33,0,2,2,17.0,445.0,90,0,6,6,52.0,82,5.53,56,304,2486,9.1
18172,Matt Smaby,2013-14,29.0,7,0,32,32,0,0,0,9.0,224.0,122,0,6,6,61.0,82,5.46,52,291,2492,9.0
18173,Matt Stajan,2005-06,22.0,4,1,1,1,1,0,1,1.0,11.0,1,1,0,1,1.0,82,5.31,60,363,2326,9.4
18174,Matt Stajan,2006-07,23.0,5,27,69,69,14,13,27,63.0,759.0,70,15,13,28,64.0,82,5.14,57,348,2300,9.2
18175,Matt Stajan,2008-09,25.0,6,27,80,80,15,12,27,83.0,931.0,150,30,25,55,147.0,82,6.05,85,480,2458,10.1
18176,Matt Stajan,2009-10,26.0,7,39,82,82,10,29,39,132.0,1324.0,232,40,54,94,279.0,82,5.76,70,398,2426,9.7
18177,Matt Stajan,2010-11,27.0,8,33,82,82,16,17,33,127.0,1550.0,314,56,71,127,406.0,82,5.44,62,351,2383,9.4
18178,Matt Stajan,2011-12,28.0,9,55,76,76,15,40,55,114.0,1287.0,390,71,111,182,520.0,82,5.7,65,341,2477,9.4
18179,Matt Stajan,2012-13,29.0,10,57,82,82,19,38,57,132.0,1551.0,472,90,149,239,652.0,82,5.53,56,304,2486,9.1
18180,Matt Stajan,2013-14,30.0,11,31,76,76,6,25,31,81.0,1081.0,548,96,174,270,733.0,82,5.46,52,291,2492,9.0
18181,Matt Stajan,2014-15,31.0,12,18,61,61,8,10,18,77.0,794.0,609,104,184,288,810.0,82,5.32,47,271,2439,8.9
18182,Matt Stajan,2015-16,32.0,13,23,43,43,5,18,23,44.0,738.0,652,109,202,311,854.0,48,5.31,29,160,1399,9.1
18183,Matt Stajan,2016-17,33.0,14,33,63,63,14,19,33,70.0,1158.0,715,123,221,344,924.0,82,5.34,48,269,2463,8.9
18184,Matt Stajan,2017-18,34.0,15,17,59,59,7,10,17,46.0,708.0,774,130,231,361,970.0,82,5.32,47,251,2453,8.9
18185,Matt Stajan,2018-19,35.0,16,17,80,80,6,11,17,58.0,1016.0,854,136,242,378,1028.0,82,5.34,48,255,2438,9.0
18186,Matt Stajan,2019-20,36.0,17,23,81,81,6,17,23,59.0,1027.0,935,142,259,401,1087.0,82,5.45,47,245,2478,9.0
18187,Matt Stajan,2020-21,37.0,18,12,68,68,4,8,12,65.0,744.0,1003,146,267,413,1152.0,82,5.86,50,250,2620,9.2
18188,Matt Taormina,2013-14,27.0,4,5,17,17,3,2,5,38.0,351.0,17,3,2,5,38.0,82,5.46,52,291,2492,9.0
18189,Matt Taormina,2014-15,28.0,5,7,30,30,1,6,7,33.0,496.0,47,4,8,12,71.0,82,5.32,47,271,2439,8.9
18190,Matt Taormina,2015-16,29.0,6,0,2,2,0,0,0,0.0,33.0,49,4,8,12,71.0,48,5.31,29,160,1399,9.1
18191,Matt Taormina,2016-17,30.0,7,0,7,7,0,0,0,6.0,94.0,56,4,8,12,77.0,82,5.34,48,269,2463,8.9
18192,Matt Taormina,2018-19,32.0,8,0,3,3,0,0,0,2.0,42.0,59,4,8,12,79.0,82,5.34,48,255,2438,9.0
18193,Matt Tennyson,2015-16,25.0,4,2,4,4,0,2,2,8.0,63.0,4,0,2,2,8.0,48,5.31,29,160,1399,9.1
18194,Matt Tennyson,2017-18,27.0,5,8,27,27,2,6,8,37.0,474.0,31,2,8,10,45.0,82,5.32,47,251,2453,8.9
18195,Matt Tennyson,2018-19,28.0,6,4,29,29,1,3,4,23.0,305.0,60,3,11,14,68.0,82,5.34,48,255,2438,9.0
18196,Matt Tennyson,2019-20,29.0,7,6,45,45,0,6,6,36.0,598.0,105,3,17,20,104.0,82,5.45,47,245,2478,9.0
18197,Matt Tennyson,2020-21,30.0,8,0,15,15,0,0,0,25.0,270.0,120,3,17,20,129.0,82,5.86,50,250,2620,9.2
18198,Matt Tennyson,2021-22,31.0,9,0,4,4,0,0,0,4.0,43.0,124,3,17,20,133.0,82,5.96,47,239,2579,9.5
18199,Matt Tennyson,2022-23,32.0,10,3,20,20,0,3,3,14.0,243.0,144,3,20,23,147.0,70,5.96,42,208,2192,9.5
18200,Matt Walker,2005-06,25.0,4,1,16,16,0,1,1,13.0,178.0,16,0,1,1,13.0,82,5.31,60,363,2326,9.4
18201,Matt Walker,2006-07,26.0,5,1,14,14,0,1,1,8.0,159.0,30,0,2,2,21.0,82,5.14,57,348,2300,9.2
18202,Matt Walker,2008-09,28.0,6,2,54,54,0,2,2,59.0,770.0,84,0,4,4,80.0,82,6.05,85,480,2458,10.1
18203,Matt Walker,2009-10,29.0,7,5,48,48,0,5,5,34.0,732.0,132,0,9,9,114.0,82,5.76,70,398,2426,9.7
18204,Matt Walker,2010-11,30.0,8,2,43,43,1,1,2,47.0,684.0,175,1,10,11,161.0,82,5.44,62,351,2383,9.4
18205,Matt Walker,2011-12,31.0,9,14,65,65,1,13,14,83.0,1081.0,240,2,23,25,244.0,82,5.7,65,341,2477,9.4
18206,Matt Walker,2012-13,32.0,10,5,66,66,2,3,5,54.0,1066.0,306,4,26,30,298.0,82,5.53,56,304,2486,9.1
18207,Matt Walker,2013-14,33.0,11,0,4,4,0,0,0,3.0,47.0,310,4,26,30,301.0,82,5.46,52,291,2492,9.0
18208,Matt Walker,2014-15,34.0,12,0,4,4,0,0,0,2.0,44.0,314,4,26,30,303.0,82,5.32,47,271,2439,8.9
18209,Matt Watkins,2014-15,28.0,4,0,1,1,0,0,0,0.0,7.0,1,0,0,0,0.0,82,5.32,47,271,2439,8.9
18210,Matthew Barnaby,1995-96,22.0,4,1,2,2,1,0,1,8.0,,2,1,0,1,8.0,84,7.25,87,443,2603,11.7
18211,Matthew Barnaby,1996-97,23.0,5,6,35,35,2,4,6,13.0,,37,3,4,7,21.0,84,6.48,76,407,2545,10.7
18212,Matthew Barnaby,1997-98,24.0,6,2,23,23,1,1,2,27.0,,60,4,5,9,48.0,48,5.97,37,209,1408,10.2
18213,Matthew Barnaby,1998-99,25.0,7,31,73,73,15,16,31,131.0,,133,19,21,40,179.0,82,6.29,74,413,2481,10.4
18214,Matthew Barnaby,1999-00,26.0,8,43,68,68,19,24,43,121.0,,201,38,45,83,300.0,82,5.83,55,336,2444,9.8
18215,Matthew Barnaby,2000-01,27.0,9,25,72,72,5,20,25,96.0,,273,43,65,108,396.0,82,5.28,57,380,2242,9.6
18216,Matthew Barnaby,2001-02,28.0,10,22,62,62,6,16,22,79.0,857.0,335,49,81,130,475.0,82,5.27,57,359,2285,9.4
18217,Matthew Barnaby,2002-03,29.0,11,24,64,64,12,12,24,80.0,809.0,399,61,93,154,555.0,82,5.49,53,331,2294,9.8
18218,Matthew Barnaby,2003-04,30.0,12,13,76,76,5,8,13,67.0,732.0,475,66,101,167,622.0,82,5.51,63,376,2272,9.9
18219,Matthew Barnaby,2004-05,31.0,13,21,77,77,8,13,21,69.0,776.0,552,74,114,188,691.0,82,5.24,53,338,2262,9.5
18220,Matthew Barnaby,2005-06,32.0,14,36,79,79,14,22,36,104.0,1027.0,631,88,136,224,795.0,82,5.31,60,363,2326,9.4
18221,Matthew Barnaby,2006-07,33.0,15,41,82,82,16,25,41,104.0,1016.0,713,104,161,265,899.0,82,5.14,57,348,2300,9.2
18222,Matthew Barnaby,2008-09,35.0,16,28,82,82,8,20,28,85.0,1101.0,795,112,181,293,984.0,82,6.05,85,480,2458,10.1
18223,Matthew Barnaby,2009-10,36.0,17,7,39,39,1,6,7,22.0,317.0,834,113,187,300,1006.0,82,5.76,70,398,2426,9.7
18224,Matthew Corrente,2012-13,24.0,4,0,12,12,0,0,0,6.0,106.0,12,0,0,0,6.0,82,5.53,56,304,2486,9.1
18225,Matthew Corrente,2013-14,25.0,5,6,22,22,0,6,6,21.0,299.0,34,0,6,6,27.0,82,5.46,52,291,2492,9.0
18226,Matthew Highmore,2020-21,24.0,4,2,13,13,2,0,2,27.0,158.0,13,2,0,2,27.0,82,5.86,50,250,2620,9.2
18227,Matthew Highmore,2022-23,26.0,5,6,36,36,2,4,6,35.0,353.0,49,4,4,8,62.0,70,5.96,42,208,2192,9.5
18228,Matthew Konan,2015-16,24.0,4,0,2,2,0,0,0,4.0,32.0,2,0,0,0,4.0,48,5.31,29,160,1399,9.1
18229,Matthew Lombardi,2006-07,24.0,4,29,79,79,16,13,29,130.0,1140.0,79,16,13,29,130.0,82,5.14,57,348,2300,9.2
18230,Matthew Lombardi,2008-09,26.0,5,26,55,55,6,20,26,72.0,778.0,134,22,33,55,202.0,82,6.05,85,480,2458,10.1
18231,Matthew Lombardi,2009-10,27.0,6,46,81,81,20,26,46,176.0,1326.0,215,42,59,101,378.0,82,5.76,70,398,2426,9.7
18232,Matthew Lombardi,2010-11,28.0,7,36,82,82,14,22,36,181.0,1420.0,297,56,81,137,559.0,82,5.44,62,351,2383,9.4
18233,Matthew Lombardi,2011-12,29.0,8,46,69,69,14,32,46,177.0,1220.0,366,70,113,183,736.0,82,5.7,65,341,2477,9.4
18234,Matthew Lombardi,2012-13,30.0,9,53,78,78,19,34,53,174.0,1399.0,444,89,147,236,910.0,82,5.53,56,304,2486,9.1
18235,Matthew Lombardi,2013-14,31.0,10,0,2,2,0,0,0,6.0,30.0,446,89,147,236,916.0,82,5.46,52,291,2492,9.0
18236,Matthew Lombardi,2014-15,32.0,11,18,62,62,8,10,18,101.0,841.0,508,97,157,254,1017.0,82,5.32,47,271,2439,8.9
18237,Matthew Lombardi,2015-16,33.0,12,8,28,28,4,4,8,44.0,391.0,536,101,161,262,1061.0,48,5.31,29,160,1399,9.1
18238,Matthew Lorito,2019-20,29.0,4,1,2,2,0,1,1,6.0,29.0,2,0,1,1,6.0,82,5.45,47,245,2478,9.0
18239,Matthew Nieto,2016-17,24.0,4,24,66,66,10,14,24,124.0,929.0,66,10,14,24,124.0,82,5.34,48,269,2463,8.9
18240,Matthew Nieto,2017-18,25.0,5,27,72,72,10,17,27,135.0,1098.0,138,20,31,51,259.0,82,5.32,47,251,2453,8.9
18241,Matthew Nieto,2018-19,26.0,6,17,67,67,8,9,17,90.0,882.0,205,28,40,68,349.0,82,5.34,48,255,2438,9.0
18242,Matthew Nieto,2019-20,27.0,7,13,59,59,7,6,13,85.0,881.0,264,35,46,81,434.0,82,5.45,47,245,2478,9.0
18243,Matthew Nieto,2020-21,28.0,8,26,74,74,15,11,26,84.0,1103.0,338,50,57,107,518.0,82,5.86,50,250,2620,9.2
18244,Matthew Nieto,2021-22,29.0,9,23,64,64,4,19,23,86.0,881.0,402,54,76,130,604.0,82,5.96,47,239,2579,9.5
18245,Matthew Nieto,2022-23,30.0,10,21,70,70,8,13,21,85.0,945.0,472,62,89,151,689.0,70,5.96,42,208,2192,9.5
18246,Matthew Peca,2019-20,26.0,4,2,10,10,1,1,2,9.0,114.0,10,1,1,2,9.0,82,5.45,47,245,2478,9.0
18247,Matthew Peca,2020-21,27.0,5,5,10,10,2,3,5,17.0,137.0,20,3,4,7,26.0,82,5.86,50,250,2620,9.2
18248,Matthew Peca,2021-22,28.0,6,10,39,39,3,7,10,35.0,410.0,59,6,11,17,61.0,82,5.96,47,239,2579,9.5
18249,Matthew Peca,2022-23,29.0,7,2,14,14,0,2,2,7.0,146.0,73,6,13,19,68.0,70,5.96,42,208,2192,9.5
18250,Matthew Spiller,2006-07,23.0,4,0,51,51,0,0,0,22.0,546.0,51,0,0,0,22.0,82,5.14,57,348,2300,9.2
18251,Matthew Spiller,2008-09,25.0,5,1,8,8,0,1,1,3.0,84.0,59,0,1,1,25.0,82,6.05,85,480,2458,10.1
18252,Matthew Spiller,2010-11,27.0,6,1,9,9,0,1,1,6.0,178.0,68,0,2,2,31.0,82,5.44,62,351,2383,9.4
18253,Matthew Tkachuk,2019-20,22.0,4,48,76,76,13,35,48,142.0,1114.0,76,13,35,48,142.0,82,5.45,47,245,2478,9.0
18254,Matthew Tkachuk,2020-21,23.0,5,49,68,68,24,25,49,188.0,1173.0,144,37,60,97,330.0,82,5.86,50,250,2620,9.2
18255,Matthew Tkachuk,2021-22,24.0,6,77,80,80,34,43,77,207.0,1408.0,224,71,103,174,537.0,82,5.96,47,239,2579,9.5
18256,Matthew Tkachuk,2022-23,25.0,7,61,69,69,23,38,61,188.0,1263.0,293,94,141,235,725.0,70,5.96,42,208,2192,9.5
18257,Matthieu Descoteaux,2003-04,26.0,4,2,5,5,1,1,2,6.0,76.0,5,1,1,2,6.0,82,5.51,63,376,2272,9.9
18258,Mattias Ekholm,2014-15,24.0,4,0,2,2,0,0,0,1.0,25.0,2,0,0,0,1.0,82,5.32,47,271,2439,8.9
18259,Mattias Ekholm,2015-16,25.0,5,0,1,1,0,0,0,0.0,16.0,3,0,0,0,1.0,48,5.31,29,160,1399,9.1
18260,Mattias Ekholm,2016-17,26.0,6,9,62,62,1,8,9,58.0,1043.0,65,1,8,9,59.0,82,5.34,48,269,2463,8.9
18261,Mattias Ekholm,2017-18,27.0,7,18,80,80,7,11,18,86.0,1521.0,145,8,19,27,145.0,82,5.32,47,251,2453,8.9
18262,Mattias Ekholm,2018-19,28.0,8,35,82,82,8,27,35,114.0,1660.0,227,16,46,62,259.0,82,5.34,48,255,2438,9.0
18263,Mattias Ekholm,2019-20,29.0,9,23,82,82,3,20,23,120.0,1924.0,309,19,66,85,379.0,82,5.45,47,245,2478,9.0
18264,Mattias Ekholm,2020-21,30.0,10,34,81,81,10,24,34,135.0,1910.0,390,29,90,119,514.0,82,5.86,50,250,2620,9.2
18265,Mattias Ekholm,2021-22,31.0,11,44,80,80,8,36,44,146.0,1869.0,470,37,126,163,660.0,82,5.96,47,239,2579,9.5
18266,Mattias Ekholm,2022-23,32.0,12,33,68,68,8,25,33,154.0,1589.0,538,45,151,196,814.0,70,5.96,42,208,2192,9.5
18267,Mattias Janmark,2018-19,26.0,4,29,73,73,15,14,29,108.0,1035.0,73,15,14,29,108.0,82,5.34,48,255,2438,9.0
18268,Mattias Janmark,2020-21,28.0,5,34,81,81,19,15,34,136.0,1371.0,154,34,29,63,244.0,82,5.86,50,250,2620,9.2
18269,Mattias Janmark,2021-22,29.0,6,25,81,81,6,19,25,105.0,1233.0,235,40,48,88,349.0,82,5.96,47,239,2579,9.5
18270,Mattias Janmark,2022-23,30.0,7,21,62,62,6,15,21,86.0,906.0,297,46,63,109,435.0,70,5.96,42,208,2192,9.5
18271,Mattias Norstrom,1996-97,25.0,4,2,9,9,0,2,2,3.0,,9,0,2,2,3.0,84,6.48,76,407,2545,10.7
18272,Mattias Norstrom,1997-98,26.0,5,3,9,9,0,3,3,4.0,,18,0,5,5,7.0,48,5.97,37,209,1408,10.2
18273,Mattias Norstrom,1998-99,27.0,6,4,36,36,2,2,4,34.0,,54,2,7,9,41.0,82,6.29,74,413,2481,10.4
18274,Mattias Norstrom,1999-00,28.0,7,22,80,80,1,21,22,106.0,,134,3,28,31,147.0,82,5.83,55,336,2444,9.8
18275,Mattias Norstrom,2000-01,29.0,8,13,73,73,1,12,13,61.0,,207,4,40,44,208.0,82,5.28,57,380,2242,9.6
18276,Mattias Norstrom,2001-02,30.0,9,7,78,78,2,5,7,61.0,1586.0,285,6,45,51,269.0,82,5.27,57,359,2285,9.4
18277,Mattias Norstrom,2002-03,31.0,10,14,82,82,1,13,14,62.0,1789.0,367,7,58,65,331.0,82,5.49,53,331,2294,9.8
18278,Mattias Norstrom,2003-04,32.0,11,18,82,82,0,18,18,59.0,1790.0,449,7,76,83,390.0,82,5.51,63,376,2272,9.9
18279,Mattias Norstrom,2004-05,33.0,12,11,79,79,2,9,11,42.0,1819.0,528,9,85,94,432.0,82,5.24,53,338,2262,9.5
18280,Mattias Norstrom,2005-06,34.0,13,6,82,82,0,6,6,63.0,1763.0,610,9,91,100,495.0,82,5.31,60,363,2326,9.4
18281,Mattias Norstrom,2006-07,35.0,14,14,74,74,1,13,14,65.0,1660.0,684,10,104,114,560.0,82,5.14,57,348,2300,9.2
18282,Mattias Norstrom,2008-09,37.0,15,27,77,77,4,23,27,83.0,1625.0,761,14,127,141,643.0,82,6.05,85,480,2458,10.1
18283,Mattias Norstrom,2009-10,38.0,16,11,76,76,2,9,11,60.0,1562.0,837,16,136,152,703.0,82,5.76,70,398,2426,9.7
18284,Mattias Norstrom,2010-11,39.0,17,13,66,66,2,11,13,54.0,1287.0,903,18,147,165,757.0,82,5.44,62,351,2383,9.4
18285,Mattias Ohlund,2000-01,24.0,4,30,77,77,7,23,30,172.0,,77,7,23,30,172.0,82,5.28,57,380,2242,9.6
18286,Mattias Ohlund,2001-02,25.0,5,35,74,74,9,26,35,129.0,1929.0,151,16,49,65,301.0,82,5.27,57,359,2285,9.4
18287,Mattias Ohlund,2002-03,26.0,6,20,42,42,4,16,20,63.0,1163.0,193,20,65,85,364.0,82,5.49,53,331,2294,9.8
18288,Mattias Ohlund,2003-04,27.0,7,28,65,65,8,20,28,136.0,1625.0,258,28,85,113,500.0,82,5.51,63,376,2272,9.9
18289,Mattias Ohlund,2004-05,28.0,8,36,81,81,10,26,36,193.0,2048.0,339,38,111,149,693.0,82,5.24,53,338,2262,9.5
18290,Mattias Ohlund,2005-06,29.0,9,29,59,59,2,27,29,100.0,1498.0,398,40,138,178,793.0,82,5.31,60,363,2326,9.4
18291,Mattias Ohlund,2006-07,30.0,10,34,82,82,14,20,34,129.0,2115.0,480,54,158,212,922.0,82,5.14,57,348,2300,9.2
18292,Mattias Ohlund,2008-09,32.0,11,33,78,78,13,20,33,183.0,2002.0,558,67,178,245,1105.0,82,6.05,85,480,2458,10.1
18293,Mattias Ohlund,2009-10,33.0,12,31,77,77,11,20,31,170.0,1909.0,635,78,198,276,1275.0,82,5.76,70,398,2426,9.7
18294,Mattias Ohlund,2010-11,34.0,13,24,53,53,9,15,24,128.0,1260.0,688,87,213,300,1403.0,82,5.44,62,351,2383,9.4
18295,Mattias Ohlund,2011-12,35.0,14,25,82,82,6,19,25,131.0,1769.0,770,93,232,325,1534.0,82,5.7,65,341,2477,9.4
18296,Mattias Ohlund,2012-13,36.0,15,13,67,67,0,13,13,71.0,1529.0,837,93,245,338,1605.0,82,5.53,56,304,2486,9.1
18297,Mattias Ohlund,2013-14,37.0,16,5,72,72,0,5,5,39.0,1348.0,909,93,250,343,1644.0,82,5.46,52,291,2492,9.0
18298,Mattias Ritola,2010-11,23.0,4,1,2,2,0,1,1,2.0,12.0,2,0,1,1,2.0,82,5.44,62,351,2383,9.4
18299,Mattias Ritola,2012-13,25.0,5,0,5,5,0,0,0,9.0,58.0,7,0,1,1,11.0,82,5.53,56,304,2486,9.1
18300,Mattias Ritola,2013-14,26.0,6,8,31,31,4,4,8,42.0,312.0,38,4,5,9,53.0,82,5.46,52,291,2492,9.0
18301,Mattias Ritola,2014-15,27.0,7,0,5,5,0,0,0,14.0,54.0,43,4,5,9,67.0,82,5.32,47,271,2439,8.9
18302,Mattias Tedenby,2013-14,23.0,4,22,58,58,8,14,22,87.0,728.0,58,8,14,22,87.0,82,5.46,52,291,2492,9.0
18303,Mattias Tedenby,2014-15,24.0,5,6,43,43,1,5,6,46.0,462.0,101,9,19,28,133.0,82,5.32,47,271,2439,8.9
18304,Mattias Tedenby,2015-16,25.0,6,1,4,4,0,1,1,2.0,36.0,105,9,20,29,135.0,48,5.31,29,160,1399,9.1
18305,Mattias Tedenby,2016-17,26.0,7,1,15,15,1,0,1,9.0,150.0,120,10,20,30,144.0,82,5.34,48,269,2463,8.9
18306,Mattias Timander,1999-00,25.0,4,9,41,41,1,8,9,62.0,,41,1,8,9,62.0,82,5.83,55,336,2444,9.8
18307,Mattias Timander,2000-01,26.0,5,2,23,23,1,1,2,17.0,,64,2,9,11,79.0,82,5.28,57,380,2242,9.6
18308,Mattias Timander,2001-02,27.0,6,6,22,22,0,6,6,22.0,284.0,86,2,15,17,101.0,82,5.27,57,359,2285,9.4
18309,Mattias Timander,2002-03,28.0,7,8,60,60,0,8,8,39.0,749.0,146,2,23,25,140.0,82,5.49,53,331,2294,9.8
18310,Mattias Timander,2003-04,29.0,8,11,76,76,2,9,11,68.0,1599.0,222,4,32,36,208.0,82,5.51,63,376,2272,9.9
18311,Mattias Timander,2004-05,30.0,9,11,78,78,4,7,11,68.0,1549.0,300,8,39,47,276.0,82,5.24,53,338,2262,9.5
18312,Mattias Timander,2005-06,31.0,10,16,80,80,3,13,16,83.0,1399.0,380,11,52,63,359.0,82,5.31,60,363,2326,9.4
18313,Mattias Timander,2006-07,32.0,11,7,39,39,2,5,7,46.0,699.0,419,13,57,70,405.0,82,5.14,57,348,2300,9.2
18314,Mattias Weinhandl,2005-06,25.0,4,23,47,47,6,17,23,66.0,652.0,47,6,17,23,66.0,82,5.31,60,363,2326,9.4
18315,Mattias Weinhandl,2006-07,26.0,5,20,55,55,8,12,20,49.0,678.0,102,14,29,43,115.0,82,5.14,57,348,2300,9.2
18316,Mattias Weinhandl,2008-09,28.0,6,11,68,68,4,7,11,57.0,624.0,170,18,36,54,172.0,82,6.05,85,480,2458,10.1
18317,Mattias Weinhandl,2009-10,29.0,7,2,12,12,1,1,2,3.0,78.0,182,19,37,56,175.0,82,5.76,70,398,2426,9.7
18318,Max Comtois,2021-22,23.0,4,7,10,10,2,5,7,9.0,146.0,10,2,5,7,9.0,82,5.96,47,239,2579,9.5
18319,Max Comtois,2022-23,24.0,5,11,29,29,5,6,11,32.0,405.0,39,7,11,18,41.0,70,5.96,42,208,2192,9.5
18320,Max Domi,2018-19,23.0,4,52,81,81,18,34,52,156.0,1326.0,81,18,34,52,156.0,82,5.34,48,255,2438,9.0
18321,Max Domi,2019-20,24.0,5,38,59,59,9,29,38,108.0,1002.0,140,27,63,90,264.0,82,5.45,47,245,2478,9.0
18322,Max Domi,2020-21,25.0,6,45,82,82,9,36,45,150.0,1370.0,222,36,99,135,414.0,82,5.86,50,250,2620,9.2
18323,Max Domi,2021-22,26.0,7,72,82,82,28,44,72,203.0,1425.0,304,64,143,207,617.0,82,5.96,47,239,2579,9.5
18324,Max Domi,2022-23,27.0,8,44,71,71,17,27,44,179.0,1214.0,375,81,170,251,796.0,70,5.96,42,208,2192,9.5
18325,Max Friberg,2017-18,25.0,4,0,1,1,0,0,0,0.0,9.0,1,0,0,0,0.0,82,5.32,47,251,2453,8.9
18326,Max Friberg,2018-19,26.0,5,0,5,5,0,0,0,1.0,44.0,6,0,0,0,1.0,82,5.34,48,255,2438,9.0
18327,Max Jones,2021-22,23.0,4,5,30,30,2,3,5,58.0,395.0,30,2,3,5,58.0,82,5.96,47,239,2579,9.5
18328,Max Jones,2022-23,24.0,5,12,59,59,8,4,12,102.0,842.0,89,10,7,17,160.0,70,5.96,42,208,2192,9.5
18329,Max McCormick,2018-19,26.0,4,4,20,20,2,2,4,37.0,209.0,20,2,2,4,37.0,82,5.34,48,255,2438,9.0
18330,Max McCormick,2019-20,27.0,5,0,7,7,0,0,0,7.0,47.0,27,2,2,4,44.0,82,5.45,47,245,2478,9.0
18331,Max McCormick,2020-21,28.0,6,5,30,30,3,2,5,33.0,251.0,57,5,4,9,77.0,82,5.86,50,250,2620,9.2
18332,Max McCormick,2021-22,29.0,7,1,14,14,1,0,1,12.0,105.0,71,6,4,10,89.0,82,5.96,47,239,2579,9.5
18333,Max Middendorf,1989-90,22.0,4,5,6,6,1,4,5,4.0,,6,1,4,5,4.0,80,7.34,72,344,2400,12.2
18334,Max Middendorf,1990-91,23.0,5,0,1,1,0,0,0,0.0,,7,1,4,5,4.0,80,7.43,89,437,2435,12.2
18335,Max Middendorf,1992-93,25.0,6,0,3,3,0,0,0,5.0,,10,1,4,5,9.0,80,7.37,76,367,2421,12.2
18336,Max Middendorf,1993-94,26.0,7,1,3,3,1,0,1,1.0,,13,2,4,6,10.0,80,6.91,71,366,2385,11.6
18337,Max Pacioretty,2011-12,23.0,4,11,34,34,3,8,11,57.0,429.0,34,3,8,11,57.0,82,5.7,65,341,2477,9.4
18338,Max Pacioretty,2012-13,24.0,5,14,52,52,3,11,14,74.0,661.0,86,6,19,25,131.0,82,5.53,56,304,2486,9.1
18339,Max Pacioretty,2013-14,25.0,6,24,37,37,14,10,24,112.0,588.0,123,20,29,49,243.0,82,5.46,52,291,2492,9.0
18340,Max Pacioretty,2014-15,26.0,7,65,79,79,33,32,65,286.0,1443.0,202,53,61,114,529.0,82,5.32,47,271,2439,8.9
18341,Max Pacioretty,2015-16,27.0,8,39,44,44,15,24,39,163.0,726.0,246,68,85,153,692.0,48,5.31,29,160,1399,9.1
18342,Max Pacioretty,2016-17,28.0,9,60,73,73,39,21,60,270.0,1350.0,319,107,106,213,962.0,82,5.34,48,269,2463,8.9
18343,Max Pacioretty,2017-18,29.0,10,67,80,80,37,30,67,302.0,1552.0,399,144,136,280,1264.0,82,5.32,47,251,2453,8.9
18344,Max Pacioretty,2018-19,30.0,11,64,82,82,30,34,64,303.0,1519.0,481,174,170,344,1567.0,82,5.34,48,255,2438,9.0
18345,Max Pacioretty,2019-20,31.0,12,67,81,81,35,32,67,268.0,1553.0,562,209,202,411,1835.0,82,5.45,47,245,2478,9.0
18346,Max Pacioretty,2020-21,32.0,13,37,64,64,17,20,37,212.0,1217.0,626,226,222,448,2047.0,82,5.86,50,250,2620,9.2
18347,Max Pacioretty,2021-22,33.0,14,40,66,66,22,18,40,191.0,1122.0,692,248,240,488,2238.0,82,5.96,47,239,2579,9.5
18348,Max Pacioretty,2022-23,34.0,15,66,71,71,32,34,66,307.0,1272.0,763,280,274,554,2545.0,70,5.96,42,208,2192,9.5
18349,Max Reinhart,2015-16,23.0,4,3,11,11,1,2,3,26.0,159.0,11,1,2,3,26.0,48,5.31,29,160,1399,9.1
18350,Max Reinhart,2016-17,24.0,5,2,8,8,0,2,2,7.0,86.0,19,1,4,5,33.0,82,5.34,48,269,2463,8.9
18351,Max Reinhart,2017-18,25.0,6,0,4,4,0,0,0,3.0,32.0,23,1,4,5,36.0,82,5.32,47,251,2453,8.9
18352,Max Sauve,2014-15,25.0,4,0,1,1,0,0,0,0.0,4.0,1,0,0,0,0.0,82,5.32,47,271,2439,8.9
18353,Max Veronneau,2021-22,26.0,4,4,12,12,2,2,4,15.0,150.0,12,2,2,4,15.0,82,5.96,47,239,2579,9.5
18354,Max Veronneau,2022-23,27.0,5,0,4,4,0,0,0,3.0,34.0,16,2,2,4,18.0,70,5.96,42,208,2192,9.5
18355,Maxim Afinogenov,2002-03,23.0,4,34,65,65,16,18,34,128.0,854.0,65,16,18,34,128.0,82,5.49,53,331,2294,9.8
18356,Maxim Afinogenov,2003-04,24.0,5,36,78,78,14,22,36,190.0,1134.0,143,30,40,70,318.0,82,5.51,63,376,2272,9.9
18357,Maxim Afinogenov,2004-05,25.0,6,40,81,81,21,19,40,234.0,1245.0,224,51,59,110,552.0,82,5.24,53,338,2262,9.5
18358,Maxim Afinogenov,2005-06,26.0,7,11,35,35,5,6,11,77.0,469.0,259,56,65,121,629.0,82,5.31,60,363,2326,9.4
18359,Maxim Afinogenov,2006-07,27.0,8,31,73,73,17,14,31,148.0,1004.0,332,73,79,152,777.0,82,5.14,57,348,2300,9.2
18360,Maxim Afinogenov,2008-09,29.0,9,73,77,77,22,51,73,241.0,1258.0,409,95,130,225,1018.0,82,6.05,85,480,2458,10.1
18361,Maxim Afinogenov,2009-10,30.0,10,61,56,56,23,38,61,151.0,955.0,465,118,168,286,1169.0,82,5.76,70,398,2426,9.7
18362,Maxim Afinogenov,2010-11,31.0,11,28,56,56,10,18,28,114.0,899.0,521,128,186,314,1283.0,82,5.44,62,351,2383,9.4
18363,Maxim Afinogenov,2011-12,32.0,12,20,48,48,6,14,20,93.0,605.0,569,134,200,334,1376.0,82,5.7,65,341,2477,9.4
18364,Maxim Afinogenov,2012-13,33.0,13,61,82,82,24,37,61,181.0,1426.0,651,158,237,395,1557.0,82,5.53,56,304,2486,9.1
18365,Maxim Balmochnykh,2002-03,23.0,4,1,6,6,0,1,1,6.0,40.0,6,0,1,1,6.0,82,5.49,53,331,2294,9.8
18366,Maxim Bets,1996-97,23.0,4,0,3,3,0,0,0,1.0,,3,0,0,0,1.0,84,6.48,76,407,2545,10.7
18367,Maxim Galanov,2000-01,26.0,4,1,6,6,0,1,1,5.0,,6,0,1,1,5.0,82,5.28,57,380,2242,9.6
18368,Maxim Galanov,2001-02,27.0,5,7,51,51,4,3,7,44.0,776.0,57,4,4,8,49.0,82,5.27,57,359,2285,9.4
18369,Maxim Galanov,2002-03,28.0,6,7,40,40,4,3,7,47.0,861.0,97,8,7,15,96.0,82,5.49,53,331,2294,9.8
18370,Maxim Galanov,2003-04,29.0,7,5,25,25,0,5,5,10.0,405.0,122,8,12,20,106.0,82,5.51,63,376,2272,9.9
18371,Maxim Kondratiev,2006-07,24.0,4,0,7,7,0,0,0,6.0,109.0,7,0,0,0,6.0,82,5.14,57,348,2300,9.2
18372,Maxim Kondratiev,2008-09,26.0,5,3,29,29,1,2,3,16.0,472.0,36,1,2,3,22.0,82,6.05,85,480,2458,10.1
18373,Maxim Kondratiev,2010-11,28.0,6,0,4,4,0,0,0,1.0,30.0,40,1,2,3,23.0,82,5.44,62,351,2383,9.4
18374,Maxim Kuznetsov,2003-04,26.0,4,3,25,25,1,2,3,17.0,237.0,25,1,2,3,17.0,82,5.51,63,376,2272,9.9
18375,Maxim Kuznetsov,2004-05,27.0,5,3,39,39,1,2,3,27.0,462.0,64,2,4,6,44.0,82,5.24,53,338,2262,9.5
18376,Maxim Kuznetsov,2005-06,28.0,6,3,56,56,0,3,3,33.0,748.0,120,2,7,9,77.0,82,5.31,60,363,2326,9.4
18377,Maxim Kuznetsov,2006-07,29.0,7,1,16,16,0,1,1,11.0,243.0,136,2,8,10,88.0,82,5.14,57,348,2300,9.2
18378,Maxim Lapierre,2008-09,23.0,4,0,1,1,0,0,0,0.0,3.0,1,0,0,0,0.0,82,6.05,85,480,2458,10.1
18379,Maxim Lapierre,2009-10,24.0,5,12,46,46,6,6,12,82.0,525.0,47,6,6,12,82.0,82,5.76,70,398,2426,9.7
18380,Maxim Lapierre,2010-11,25.0,6,18,53,53,7,11,18,68.0,698.0,100,13,17,30,150.0,82,5.44,62,351,2383,9.4
18381,Maxim Lapierre,2011-12,26.0,7,28,79,79,15,13,28,165.0,1169.0,179,28,30,58,315.0,82,5.7,65,341,2477,9.4
18382,Maxim Lapierre,2012-13,27.0,8,14,76,76,7,7,14,101.0,933.0,255,35,37,72,416.0,82,5.53,56,304,2486,9.1
18383,Maxim Lapierre,2013-14,28.0,9,12,78,78,6,6,12,129.0,907.0,333,41,43,84,545.0,82,5.46,52,291,2492,9.0
18384,Maxim Lapierre,2014-15,29.0,10,19,82,82,9,10,19,103.0,921.0,415,50,53,103,648.0,82,5.32,47,271,2439,8.9
18385,Maxim Lapierre,2015-16,30.0,11,10,48,48,4,6,10,54.0,605.0,463,54,59,113,702.0,48,5.31,29,160,1399,9.1
18386,Maxim Lapierre,2016-17,31.0,12,15,71,71,9,6,15,78.0,793.0,534,63,65,128,780.0,82,5.34,48,269,2463,8.9
18387,Maxim Lapierre,2017-18,32.0,13,11,80,80,2,9,11,86.0,857.0,614,65,74,139,866.0,82,5.32,47,251,2453,8.9
18388,Maxim Letunov,2022-23,26.0,4,1,3,3,1,0,1,3.0,27.0,3,1,0,1,3.0,70,5.96,42,208,2192,9.5
18389,Maxim Mamin,2020-21,26.0,4,4,26,26,3,1,4,28.0,274.0,26,3,1,4,28.0,82,5.86,50,250,2620,9.2
18390,Maxim Mamin,2021-22,27.0,5,0,7,7,0,0,0,8.0,51.0,33,3,1,4,36.0,82,5.96,47,239,2579,9.5
18391,Maxim Noreau,2012-13,25.0,4,0,1,1,0,0,0,0.0,7.0,1,0,0,0,0.0,82,5.53,56,304,2486,9.1
18392,Maxim Noreau,2013-14,26.0,5,0,5,5,0,0,0,8.0,71.0,6,0,0,0,8.0,82,5.46,52,291,2492,9.0
18393,Maxim Sushinsky,2003-04,29.0,4,11,30,30,7,4,11,62.0,420.0,30,7,4,11,62.0,82,5.51,63,376,2272,9.9
18394,Maxime Fortunus,2012-13,29.0,4,0,8,8,0,0,0,5.0,121.0,8,0,0,0,5.0,82,5.53,56,304,2486,9.1
18395,Maxime Fortunus,2016-17,33.0,5,1,1,1,0,1,1,0.0,16.0,9,0,1,1,5.0,82,5.34,48,269,2463,8.9
18396,Maxime Lajoie,2021-22,24.0,4,15,56,56,7,8,15,79.0,1059.0,56,7,8,15,79.0,82,5.96,47,239,2579,9.5
18397,Maxime Lajoie,2022-23,25.0,5,0,6,6,0,0,0,3.0,47.0,62,7,8,15,82.0,70,5.96,42,208,2192,9.5
18398,Maxime Macenauer,2014-15,26.0,4,4,29,29,1,3,4,14.0,314.0,29,1,3,4,14.0,82,5.32,47,271,2439,8.9
18399,Maxime Talbot,2008-09,24.0,4,8,48,48,5,3,8,45.0,526.0,48,5,3,8,45.0,82,6.05,85,480,2458,10.1
18400,Maxime Talbot,2009-10,25.0,5,24,75,75,13,11,24,88.0,1042.0,123,18,14,32,133.0,82,5.76,70,398,2426,9.7
18401,Maxime Talbot,2010-11,26.0,6,26,63,63,12,14,26,80.0,974.0,186,30,28,58,213.0,82,5.44,62,351,2383,9.4
18402,Maxime Talbot,2011-12,27.0,7,22,75,75,12,10,22,102.0,1060.0,261,42,38,80,315.0,82,5.7,65,341,2477,9.4
18403,Maxime Talbot,2012-13,28.0,8,7,45,45,2,5,7,49.0,550.0,306,44,43,87,364.0,82,5.53,56,304,2486,9.1
18404,Maxime Talbot,2013-14,29.0,9,21,82,82,8,13,21,117.0,1236.0,388,52,56,108,481.0,82,5.46,52,291,2492,9.0
18405,Maxime Talbot,2014-15,30.0,10,34,81,81,19,15,34,115.0,1296.0,469,71,71,142,596.0,82,5.32,47,271,2439,8.9
18406,Maxime Talbot,2015-16,31.0,11,10,35,35,5,5,10,41.0,540.0,504,76,76,152,637.0,48,5.31,29,160,1399,9.1
18407,Maxime Talbot,2016-17,32.0,12,27,81,81,8,19,27,124.0,1309.0,585,84,95,179,761.0,82,5.34,48,269,2463,8.9
18408,Maxime Talbot,2017-18,33.0,13,18,81,81,5,13,18,97.0,1102.0,666,89,108,197,858.0,82,5.32,47,251,2453,8.9
18409,Maxime Talbot,2018-19,34.0,14,7,38,38,2,5,7,29.0,426.0,704,91,113,204,887.0,82,5.34,48,255,2438,9.0
18410,Maynard Schurman,1982-83,25.0,4,0,7,7,0,0,0,5.0,,7,0,0,0,5.0,80,7.03,61,280,2352,12.0
18411,Mel Angelstad,2006-07,34.0,4,0,2,2,0,0,0,1.0,26.0,2,0,0,0,1.0,82,5.14,57,348,2300,9.2
18412,Melker Karlsson,2017-18,27.0,4,24,53,53,13,11,24,100.0,818.0,53,13,11,24,100.0,82,5.32,47,251,2453,8.9
18413,Melker Karlsson,2018-19,28.0,5,19,65,65,10,9,19,96.0,879.0,118,23,20,43,196.0,82,5.34,48,255,2438,9.0
18414,Melker Karlsson,2019-20,29.0,6,22,67,67,11,11,22,73.0,858.0,185,34,31,65,269.0,82,5.45,47,245,2478,9.0
18415,Melker Karlsson,2020-21,30.0,7,19,71,71,8,11,19,76.0,941.0,256,42,42,84,345.0,82,5.86,50,250,2620,9.2
18416,Melker Karlsson,2021-22,31.0,8,16,79,79,12,4,16,79.0,908.0,335,54,46,100,424.0,82,5.96,47,239,2579,9.5
18417,Melker Karlsson,2022-23,32.0,9,12,61,61,6,6,12,56.0,748.0,396,60,52,112,480.0,70,5.96,42,208,2192,9.5
18418,Micah Aivazoff,1996-97,27.0,4,8,59,59,4,4,8,52.0,,59,4,4,8,52.0,84,6.48,76,407,2545,10.7
18419,Micah Aivazoff,1997-98,28.0,5,1,21,21,0,1,1,6.0,,80,4,5,9,58.0,48,5.97,37,209,1408,10.2
18420,Micah Aivazoff,1998-99,29.0,6,1,12,12,0,1,1,8.0,,92,4,6,10,66.0,82,6.29,74,413,2481,10.4
18421,Michael Amadio,2020-21,24.0,4,8,37,37,4,4,8,28.0,345.0,37,4,4,8,28.0,82,5.86,50,250,2620,9.2
18422,Michael Amadio,2021-22,25.0,5,13,43,43,6,7,13,37.0,439.0,80,10,11,21,65.0,82,5.96,47,239,2579,9.5
18423,Michael Amadio,2022-23,26.0,6,16,68,68,6,10,16,99.0,885.0,148,16,21,37,164.0,70,5.96,42,208,2192,9.5
18424,Michael Anderson,2022-23,23.0,4,1,6,6,1,0,1,9.0,109.0,6,1,0,1,9.0,70,5.96,42,208,2192,9.5
18425,Michael Bournival,2016-17,24.0,4,14,60,60,7,7,14,78.0,619.0,60,7,7,14,78.0,82,5.34,48,269,2463,8.9
18426,Michael Bournival,2017-18,25.0,5,5,29,29,3,2,5,27.0,229.0,89,10,9,19,105.0,82,5.32,47,251,2453,8.9
18427,Michael Bournival,2019-20,27.0,6,3,19,19,2,1,3,25.0,193.0,108,12,10,22,130.0,82,5.45,47,245,2478,9.0
18428,Michael Bournival,2020-21,28.0,7,0,5,5,0,0,0,5.0,47.0,113,12,10,22,135.0,82,5.86,50,250,2620,9.2
18429,Michael Bunting,2021-22,26.0,4,1,5,5,1,0,1,5.0,48.0,5,1,0,1,5.0,82,5.96,47,239,2579,9.5
18430,Michael Caruso,2015-16,27.0,4,0,2,2,0,0,0,0.0,16.0,2,0,0,0,0.0,48,5.31,29,160,1399,9.1
18431,Michael Chaput,2016-17,24.0,4,1,17,17,0,1,1,6.0,151.0,17,0,1,1,6.0,82,5.34,48,269,2463,8.9
18432,Michael Chaput,2017-18,25.0,5,5,33,33,1,4,5,23.0,337.0,50,1,5,6,29.0,82,5.32,47,251,2453,8.9
18433,Michael Chaput,2018-19,26.0,6,2,8,8,1,1,2,10.0,72.0,58,2,6,8,39.0,82,5.34,48,255,2438,9.0
18434,Michael Chaput,2019-20,27.0,7,9,68,68,4,5,9,64.0,750.0,126,6,11,17,103.0,82,5.45,47,245,2478,9.0
18435,Michael Chaput,2020-21,28.0,8,0,9,9,0,0,0,2.0,88.0,135,6,11,17,105.0,82,5.86,50,250,2620,9.2
18436,Michael Chaput,2021-22,29.0,9,5,32,32,0,5,5,31.0,359.0,167,6,16,22,136.0,82,5.96,47,239,2579,9.5
18437,Michael Chaput,2022-23,30.0,10,0,2,2,0,0,0,2.0,20.0,169,6,16,22,138.0,70,5.96,42,208,2192,9.5
18438,Michael Colman,1994-95,26.0,4,1,15,15,0,1,1,7.0,,15,0,1,1,7.0,80,6.96,77,402,2440,11.4
18439,Michael Dal Colle,2020-21,24.0,4,0,4,4,0,0,0,1.0,53.0,4,0,0,0,1.0,82,5.86,50,250,2620,9.2
18440,Michael Dal Colle,2021-22,25.0,5,7,28,28,3,4,7,34.0,339.0,32,3,4,7,35.0,82,5.96,47,239,2579,9.5
18441,Michael Dal Colle,2022-23,26.0,6,10,53,53,4,6,10,59.0,625.0,85,7,10,17,94.0,70,5.96,42,208,2192,9.5
18442,Michael Dark,1989-90,26.0,4,2,13,13,2,0,2,4.0,,13,2,0,2,4.0,80,7.34,72,344,2400,12.2
18443,Michael Dark,1990-91,27.0,5,9,30,30,3,6,9,27.0,,43,5,6,11,31.0,80,7.43,89,437,2435,12.2
18444,Michael Del Zotto,2012-13,22.0,4,37,80,80,9,28,37,81.0,1518.0,80,9,28,37,81.0,82,5.53,56,304,2486,9.1
18445,Michael Del Zotto,2013-14,23.0,5,11,47,47,2,9,11,58.0,916.0,127,11,37,48,139.0,82,5.46,52,291,2492,9.0
18446,Michael Del Zotto,2014-15,24.0,6,41,77,77,10,31,41,113.0,1728.0,204,21,68,89,252.0,82,5.32,47,271,2439,8.9
18447,Michael Del Zotto,2015-16,25.0,7,21,46,46,3,18,21,81.0,1066.0,250,24,86,110,333.0,48,5.31,29,160,1399,9.1
18448,Michael Del Zotto,2016-17,26.0,8,16,67,67,3,13,16,90.0,1153.0,317,27,99,126,423.0,82,5.34,48,269,2463,8.9
18449,Michael Del Zotto,2017-18,27.0,9,32,64,64,10,22,32,119.0,1403.0,381,37,121,158,542.0,82,5.32,47,251,2453,8.9
18450,Michael Del Zotto,2018-19,28.0,10,13,52,52,4,9,13,98.0,1217.0,433,41,130,171,640.0,82,5.34,48,255,2438,9.0
18451,Michael Del Zotto,2019-20,29.0,11,18,51,51,6,12,18,92.0,995.0,484,47,142,189,732.0,82,5.45,47,245,2478,9.0
18452,Michael Del Zotto,2020-21,30.0,12,22,82,82,6,16,22,128.0,1706.0,566,53,158,211,860.0,82,5.86,50,250,2620,9.2
18453,Michael Del Zotto,2021-22,31.0,13,10,42,42,1,9,10,45.0,715.0,608,54,167,221,905.0,82,5.96,47,239,2579,9.5
18454,Michael Del Zotto,2022-23,32.0,14,15,49,49,2,13,15,57.0,917.0,657,56,180,236,962.0,70,5.96,42,208,2192,9.5
18455,Michael Frolik,2011-12,23.0,4,45,79,79,21,24,45,158.0,1170.0,79,21,24,45,158.0,82,5.7,65,341,2477,9.4
18456,Michael Frolik,2012-13,24.0,5,43,82,82,21,22,43,219.0,1433.0,161,42,46,88,377.0,82,5.53,56,304,2486,9.1
18457,Michael Frolik,2013-14,25.0,6,38,80,80,11,27,38,251.0,1247.0,241,53,73,126,628.0,82,5.46,52,291,2492,9.0
18458,Michael Frolik,2014-15,26.0,7,15,63,63,5,10,15,117.0,811.0,304,58,83,141,745.0,82,5.32,47,271,2439,8.9
18459,Michael Frolik,2015-16,27.0,8,10,45,45,3,7,10,98.0,563.0,349,61,90,151,843.0,48,5.31,29,160,1399,9.1
18460,Michael Frolik,2016-17,28.0,9,42,81,81,15,27,42,189.0,1351.0,430,76,117,193,1032.0,82,5.34,48,269,2463,8.9
18461,Michael Frolik,2017-18,29.0,10,42,82,82,19,23,42,206.0,1435.0,512,95,140,235,1238.0,82,5.32,47,251,2453,8.9
18462,Michael Frolik,2018-19,30.0,11,32,64,64,15,17,32,155.0,1012.0,576,110,157,267,1393.0,82,5.34,48,255,2438,9.0
18463,Michael Frolik,2019-20,31.0,12,44,82,82,17,27,44,202.0,1401.0,658,127,184,311,1595.0,82,5.45,47,245,2478,9.0
18464,Michael Frolik,2020-21,32.0,13,25,70,70,10,15,25,167.0,1185.0,728,137,199,336,1762.0,82,5.86,50,250,2620,9.2
18465,Michael Frolik,2021-22,33.0,14,34,65,65,16,18,34,132.0,868.0,793,153,217,370,1894.0,82,5.96,47,239,2579,9.5
18466,Michael Frolik,2022-23,34.0,15,14,57,57,6,8,14,70.0,709.0,850,159,225,384,1964.0,70,5.96,42,208,2192,9.5
18467,Michael Funk,2009-10,23.0,4,2,5,5,0,2,2,1.0,17.0,5,0,2,2,1.0,82,5.76,70,398,2426,9.7
18468,Michael Funk,2010-11,24.0,5,0,4,4,0,0,0,1.0,46.0,9,0,2,2,2.0,82,5.44,62,351,2383,9.4
18469,Michael Grabner,2012-13,25.0,4,11,20,20,5,6,11,63.0,278.0,20,5,6,11,63.0,82,5.53,56,304,2486,9.1
18470,Michael Grabner,2013-14,26.0,5,52,76,76,34,18,52,228.0,1146.0,96,39,24,63,291.0,82,5.46,52,291,2492,9.0
18471,Michael Grabner,2014-15,27.0,6,32,78,78,20,12,32,174.0,1212.0,174,59,36,95,465.0,82,5.32,47,271,2439,8.9
18472,Michael Grabner,2015-16,28.0,7,21,45,45,16,5,21,108.0,666.0,219,75,41,116,573.0,48,5.31,29,160,1399,9.1
18473,Michael Grabner,2016-17,29.0,8,26,64,64,12,14,26,137.0,908.0,283,87,55,142,710.0,82,5.34,48,269,2463,8.9
18474,Michael Grabner,2017-18,30.0,9,13,34,34,8,5,13,63.0,440.0,317,95,60,155,773.0,82,5.32,47,251,2453,8.9
18475,Michael Grabner,2018-19,31.0,10,18,80,80,9,9,18,116.0,1158.0,397,104,69,173,889.0,82,5.34,48,255,2438,9.0
18476,Michael Grabner,2019-20,32.0,11,40,76,76,27,13,40,162.0,1071.0,473,131,82,213,1051.0,82,5.45,47,245,2478,9.0
18477,Michael Grabner,2020-21,33.0,12,36,80,80,27,9,36,167.0,1185.0,553,158,91,249,1218.0,82,5.86,50,250,2620,9.2
18478,Michael Grabner,2021-22,34.0,13,16,41,41,9,7,16,65.0,590.0,594,167,98,265,1283.0,82,5.96,47,239,2579,9.5
18479,Michael Grabner,2022-23,35.0,14,11,46,46,8,3,11,61.0,569.0,640,175,101,276,1344.0,70,5.96,42,208,2192,9.5
18480,Michael Holmqvist,2006-07,27.0,4,2,21,21,2,0,2,18.0,176.0,21,2,0,2,18.0,82,5.14,57,348,2300,9.2
18481,Michael Holmqvist,2008-09,29.0,5,20,72,72,10,10,20,106.0,975.0,93,12,10,22,124.0,82,6.05,85,480,2458,10.1
18482,Michael Holmqvist,2009-10,30.0,6,13,63,63,6,7,13,80.0,868.0,156,18,17,35,204.0,82,5.76,70,398,2426,9.7
18483,Michael Kapla,2019-20,25.0,4,0,5,5,0,0,0,4.0,87.0,5,0,0,0,4.0,82,5.45,47,245,2478,9.0
18484,Michael Keränen,2018-19,29.0,4,0,1,1,0,0,0,0.0,6.0,1,0,0,0,0.0,82,5.34,48,255,2438,9.0
18485,Michael Latta,2016-17,25.0,4,4,17,17,1,3,4,6.0,131.0,17,1,3,4,6.0,82,5.34,48,269,2463,8.9
18486,Michael Latta,2017-18,26.0,5,6,53,53,0,6,6,24.0,444.0,70,1,9,10,30.0,82,5.32,47,251,2453,8.9
18487,Michael Latta,2018-19,27.0,6,7,43,43,3,4,7,29.0,348.0,113,4,13,17,59.0,82,5.34,48,255,2438,9.0
18488,Michael Liambas,2019-20,30.0,4,0,1,1,0,0,0,0.0,5.0,1,0,0,0,0.0,82,5.45,47,245,2478,9.0
18489,Michael Liambas,2020-21,31.0,5,1,7,7,0,1,1,3.0,37.0,8,0,1,1,3.0,82,5.86,50,250,2620,9.2
18490,Michael McCarron,2018-19,23.0,4,2,20,20,1,1,2,41.0,234.0,20,1,1,2,41.0,82,5.34,48,255,2438,9.0
18491,Michael McCarron,2019-20,24.0,5,5,31,31,1,4,5,31.0,307.0,51,2,5,7,72.0,82,5.45,47,245,2478,9.0
18492,Michael McCarron,2020-21,25.0,6,1,18,18,0,1,1,15.0,158.0,69,2,6,8,87.0,82,5.86,50,250,2620,9.2
18493,Michael McLeod,2021-22,23.0,4,3,21,21,0,3,3,21.0,256.0,21,0,3,3,21.0,82,5.96,47,239,2579,9.5
18494,Michael McLeod,2022-23,24.0,5,2,12,12,0,2,2,11.0,123.0,33,0,5,5,32.0,70,5.96,42,208,2192,9.5
18495,Michael Mersch,2018-19,26.0,4,3,17,17,1,2,3,23.0,176.0,17,1,2,3,23.0,82,5.34,48,255,2438,9.0
18496,Michael Nylander,1995-96,23.0,4,33,59,59,11,22,33,85.0,,59,11,22,33,85.0,84,7.25,87,443,2603,11.7
18497,Michael Nylander,1996-97,24.0,5,55,73,73,13,42,55,95.0,,132,24,64,88,180.0,84,6.48,76,407,2545,10.7
18498,Michael Nylander,1997-98,25.0,6,1,6,6,0,1,1,2.0,,138,24,65,89,182.0,48,5.97,37,209,1408,10.2
18499,Michael Nylander,1998-99,26.0,7,55,73,73,17,38,55,163.0,,211,41,103,144,345.0,82,6.29,74,413,2481,10.4
18500,Michael Nylander,2000-01,28.0,8,36,65,65,13,23,36,117.0,,276,54,126,180,462.0,82,5.28,57,380,2242,9.6
18501,Michael Nylander,2001-02,29.0,9,14,33,33,4,10,14,33.0,424.0,309,58,136,194,495.0,82,5.27,57,359,2285,9.4
18502,Michael Nylander,2002-03,30.0,10,54,77,77,24,30,54,122.0,1214.0,386,82,166,248,617.0,82,5.49,53,331,2294,9.8
18503,Michael Nylander,2003-04,31.0,11,64,82,82,25,39,64,176.0,1547.0,468,107,205,312,793.0,82,5.51,63,376,2272,9.9
18504,Michael Nylander,2004-05,32.0,12,61,82,82,15,46,61,158.0,1275.0,550,122,251,373,951.0,82,5.24,53,338,2262,9.5
18505,Michael Nylander,2005-06,33.0,13,60,80,80,17,43,60,161.0,1465.0,630,139,294,433,1112.0,82,5.31,60,363,2326,9.4
18506,Michael Nylander,2006-07,34.0,14,14,18,18,1,13,14,30.0,281.0,648,140,307,447,1142.0,82,5.14,57,348,2300,9.2
18507,Michael Nylander,2008-09,36.0,15,79,81,81,23,56,79,172.0,1566.0,729,163,363,526,1314.0,82,6.05,85,480,2458,10.1
18508,Michael Nylander,2009-10,37.0,16,83,79,79,26,57,83,193.0,1610.0,808,189,420,609,1507.0,82,5.76,70,398,2426,9.7
18509,Michael Nylander,2010-11,38.0,17,37,40,40,11,26,37,77.0,766.0,848,200,446,646,1584.0,82,5.44,62,351,2383,9.4
18510,Michael Nylander,2011-12,39.0,18,33,72,72,9,24,33,87.0,1011.0,920,209,470,679,1671.0,82,5.7,65,341,2477,9.4
18511,Michael Paliotta,2017-18,24.0,4,1,1,1,0,1,1,2.0,13.0,1,0,1,1,2.0,82,5.32,47,251,2453,8.9
18512,Michael Paliotta,2018-19,25.0,5,0,1,1,0,0,0,2.0,8.0,2,0,1,1,4.0,82,5.34,48,255,2438,9.0
18513,Michael Peca,1996-97,22.0,4,0,4,4,0,0,0,5.0,,4,0,0,0,5.0,84,6.48,76,407,2545,10.7
18514,Michael Peca,1997-98,23.0,5,12,33,33,6,6,12,46.0,,37,6,6,12,51.0,48,5.97,37,209,1408,10.2
18515,Michael Peca,1998-99,24.0,6,31,68,68,11,20,31,109.0,,105,17,26,43,160.0,82,6.29,74,413,2481,10.4
18516,Michael Peca,1999-00,25.0,7,49,79,79,20,29,49,137.0,,184,37,55,92,297.0,82,5.83,55,336,2444,9.8
18517,Michael Peca,2000-01,26.0,8,40,61,61,18,22,40,132.0,,245,55,77,132,429.0,82,5.28,57,380,2242,9.6
18518,Michael Peca,2001-02,27.0,9,56,82,82,27,29,56,199.0,1700.0,327,82,106,188,628.0,82,5.27,57,359,2285,9.4
18519,Michael Peca,2002-03,28.0,10,41,73,73,20,21,41,144.0,1456.0,400,102,127,229,772.0,82,5.49,53,331,2294,9.8
18520,Michael Peca,2004-05,30.0,11,60,80,80,25,35,60,168.0,1618.0,480,127,162,289,940.0,82,5.24,53,338,2262,9.5
18521,Michael Peca,2005-06,31.0,12,42,66,66,13,29,42,117.0,1251.0,546,140,191,331,1057.0,82,5.31,60,363,2326,9.4
18522,Michael Peca,2006-07,32.0,13,40,76,76,11,29,40,117.0,1446.0,622,151,220,371,1174.0,82,5.14,57,348,2300,9.2
18523,Michael Peca,2008-09,34.0,14,23,71,71,9,14,23,108.0,1182.0,693,160,234,394,1282.0,82,6.05,85,480,2458,10.1
18524,Michael Peca,2009-10,35.0,15,15,35,35,4,11,15,42.0,609.0,728,164,245,409,1324.0,82,5.76,70,398,2426,9.7
18525,Michael Peca,2010-11,36.0,16,34,65,65,8,26,34,86.0,1207.0,793,172,271,443,1410.0,82,5.44,62,351,2383,9.4
18526,Michael Peca,2011-12,37.0,17,22,71,71,4,18,22,74.0,1001.0,864,176,289,465,1484.0,82,5.7,65,341,2477,9.4
18527,Michael Raffl,2016-17,28.0,4,22,68,68,9,13,22,101.0,883.0,68,9,13,22,101.0,82,5.34,48,269,2463,8.9
18528,Michael Raffl,2017-18,29.0,5,28,67,67,21,7,28,134.0,951.0,135,30,20,50,235.0,82,5.32,47,251,2453,8.9
18529,Michael Raffl,2018-19,30.0,6,31,82,82,13,18,31,132.0,1173.0,217,43,38,81,367.0,82,5.34,48,255,2438,9.0
18530,Michael Raffl,2019-20,31.0,7,11,52,52,8,3,11,63.0,690.0,269,51,41,92,430.0,82,5.45,47,245,2478,9.0
18531,Michael Raffl,2020-21,32.0,8,22,76,76,13,9,22,96.0,1007.0,345,64,50,114,526.0,82,5.86,50,250,2620,9.2
18532,Michael Raffl,2021-22,33.0,9,18,67,67,6,12,18,65.0,765.0,412,70,62,132,591.0,82,5.96,47,239,2579,9.5
18533,Michael Raffl,2022-23,34.0,10,20,58,58,8,12,20,66.0,717.0,470,78,74,152,657.0,70,5.96,42,208,2192,9.5
18534,Michael Rasmussen,2021-22,22.0,4,18,62,62,8,10,18,74.0,749.0,62,8,10,18,74.0,82,5.96,47,239,2579,9.5
18535,Michael Ryan,2009-10,29.0,4,5,19,19,3,2,5,34.0,260.0,19,3,2,5,34.0,82,5.76,70,398,2426,9.7
18536,Michael Ryan,2010-11,30.0,5,8,46,46,4,4,8,60.0,455.0,65,7,6,13,94.0,82,5.44,62,351,2383,9.4
18537,Michael Ryan,2011-12,31.0,6,2,18,18,0,2,2,24.0,148.0,83,7,8,15,118.0,82,5.7,65,341,2477,9.4
18538,Michael Ryder,2006-07,26.0,4,63,81,81,25,38,63,215.0,1296.0,81,25,38,63,215.0,82,5.14,57,348,2300,9.2
18539,Michael Ryder,2008-09,28.0,5,55,81,81,30,25,55,243.0,1310.0,162,55,63,118,458.0,82,6.05,85,480,2458,10.1
18540,Michael Ryder,2009-10,29.0,6,58,82,82,30,28,58,221.0,1335.0,244,85,91,176,679.0,82,5.76,70,398,2426,9.7
18541,Michael Ryder,2010-11,30.0,7,31,70,70,14,17,31,134.0,927.0,314,99,108,207,813.0,82,5.44,62,351,2383,9.4
18542,Michael Ryder,2011-12,31.0,8,53,74,74,27,26,53,185.0,1104.0,388,126,134,260,998.0,82,5.7,65,341,2477,9.4
18543,Michael Ryder,2012-13,32.0,9,33,82,82,18,15,33,191.0,1254.0,470,144,149,293,1189.0,82,5.53,56,304,2486,9.1
18544,Michael Ryder,2013-14,33.0,10,41,79,79,18,23,41,165.0,1144.0,549,162,172,334,1354.0,82,5.46,52,291,2492,9.0
18545,Michael Ryder,2014-15,34.0,11,62,82,82,35,27,62,211.0,1425.0,631,197,199,396,1565.0,82,5.32,47,271,2439,8.9
18546,Michael Ryder,2015-16,35.0,12,35,46,46,16,19,35,101.0,738.0,677,213,218,431,1666.0,48,5.31,29,160,1399,9.1
18547,Michael Ryder,2016-17,36.0,13,34,82,82,18,16,34,166.0,1294.0,759,231,234,465,1832.0,82,5.34,48,269,2463,8.9
18548,Michael Ryder,2017-18,37.0,14,19,47,47,6,13,19,89.0,681.0,806,237,247,484,1921.0,82,5.32,47,251,2453,8.9
18549,Michael Sauer,2011-12,24.0,4,0,3,3,0,0,0,2.0,28.0,3,0,0,0,2.0,82,5.7,65,341,2477,9.4
18550,Michael Sauer,2013-14,26.0,5,15,76,76,3,12,15,54.0,1331.0,79,3,12,15,56.0,82,5.46,52,291,2492,9.0
18551,Michael Sauer,2014-15,27.0,6,3,19,19,1,2,3,14.0,356.0,98,4,14,18,70.0,82,5.32,47,271,2439,8.9
18552,Michael Sgarbossa,2015-16,23.0,4,0,6,6,0,0,0,6.0,62.0,6,0,0,0,6.0,48,5.31,29,160,1399,9.1
18553,Michael Sgarbossa,2017-18,25.0,5,1,3,3,0,1,1,2.0,21.0,9,0,1,1,8.0,82,5.32,47,251,2453,8.9
18554,Michael Sgarbossa,2018-19,26.0,6,0,1,1,0,0,0,0.0,8.0,10,0,1,1,8.0,82,5.34,48,255,2438,9.0
18555,Michael Sgarbossa,2019-20,27.0,7,9,38,38,2,7,9,33.0,424.0,48,2,8,10,41.0,82,5.45,47,245,2478,9.0
18556,Michael Sgarbossa,2022-23,30.0,8,0,2,2,0,0,0,1.0,16.0,50,2,8,10,42.0,70,5.96,42,208,2192,9.5
18557,Michael Stone,2014-15,24.0,4,3,13,13,1,2,3,13.0,180.0,13,1,2,3,13.0,82,5.32,47,271,2439,8.9
18558,Michael Stone,2015-16,25.0,5,9,40,40,5,4,9,50.0,667.0,53,6,6,12,63.0,48,5.31,29,160,1399,9.1
18559,Michael Stone,2016-17,26.0,6,21,70,70,8,13,21,105.0,1274.0,123,14,19,33,168.0,82,5.34,48,269,2463,8.9
18560,Michael Stone,2017-18,27.0,7,18,81,81,3,15,18,144.0,1690.0,204,17,34,51,312.0,82,5.32,47,251,2453,8.9
18561,Michael Stone,2018-19,28.0,8,36,75,75,6,30,36,161.0,1687.0,279,23,64,87,473.0,82,5.34,48,255,2438,9.0
18562,Michael Stone,2019-20,29.0,9,15,64,64,3,12,15,81.0,1268.0,343,26,76,102,554.0,82,5.45,47,245,2478,9.0
18563,Michael Stone,2020-21,30.0,10,10,82,82,3,7,10,98.0,1373.0,425,29,83,112,652.0,82,5.86,50,250,2620,9.2
18564,Michael Stone,2021-22,31.0,11,5,14,14,0,5,5,12.0,223.0,439,29,88,117,664.0,82,5.96,47,239,2579,9.5
18565,Michael Stone,2022-23,32.0,12,7,33,33,2,5,7,57.0,539.0,472,31,93,124,721.0,70,5.96,42,208,2192,9.5
18566,Michael Thelven,1988-89,28.0,4,26,60,60,6,20,26,108.0,,60,6,20,26,108.0,80,7.94,82,370,2484,12.8
18567,Michael Thelven,1989-90,29.0,5,20,34,34,5,15,20,58.0,,94,11,35,46,166.0,80,7.34,72,344,2400,12.2
18568,Michael Thelven,1990-91,30.0,6,31,67,67,6,25,31,106.0,,161,17,60,77,272.0,80,7.43,89,437,2435,12.2
18569,Michael Thelven,1991-92,31.0,7,21,40,40,3,18,21,68.0,,201,20,78,98,340.0,80,7.48,85,403,2430,12.3
18570,Michael Thelven,1992-93,32.0,8,2,6,6,0,2,2,8.0,,207,20,80,100,348.0,80,7.37,76,367,2421,12.2
18571,Michael Ware,1991-92,24.0,4,1,2,2,0,1,1,0.0,,2,0,1,1,0.0,80,7.48,85,403,2430,12.3
18572,Michael Ware,1992-93,25.0,5,0,3,3,0,0,0,1.0,,5,0,1,1,1.0,80,7.37,76,367,2421,12.2
18573,Michael Zalewski,2016-17,24.0,4,1,2,2,0,1,1,2.0,24.0,2,0,1,1,2.0,82,5.34,48,269,2463,8.9
18574,Michael Zalewski,2018-19,26.0,5,1,3,3,0,1,1,2.0,36.0,5,0,2,2,4.0,82,5.34,48,255,2438,9.0
18575,Michael Zalewski,2019-20,27.0,6,0,1,1,0,0,0,0.0,8.0,6,0,2,2,4.0,82,5.45,47,245,2478,9.0
18576,Michal Barinka,2006-07,22.0,4,1,9,9,0,1,1,15.0,124.0,9,0,1,1,15.0,82,5.14,57,348,2300,9.2
18577,Michal Barinka,2008-09,24.0,5,1,25,25,0,1,1,19.0,366.0,34,0,2,2,34.0,82,6.05,85,480,2458,10.1
18578,Michal Grosek,1996-97,21.0,4,1,3,3,1,0,1,4.0,,3,1,0,1,4.0,84,6.48,76,407,2545,10.7
18579,Michal Grosek,1997-98,22.0,5,4,24,24,2,2,4,27.0,,27,3,2,5,31.0,48,5.97,37,209,1408,10.2
18580,Michal Grosek,1998-99,23.0,6,10,23,23,6,4,10,34.0,,50,9,6,15,65.0,82,6.29,74,413,2481,10.4
18581,Michal Grosek,1999-00,24.0,7,36,82,82,15,21,36,117.0,,132,24,27,51,182.0,82,5.83,55,336,2444,9.8
18582,Michal Grosek,2000-01,25.0,8,30,67,67,10,20,30,114.0,,199,34,47,81,296.0,82,5.28,57,380,2242,9.6
18583,Michal Grosek,2001-02,26.0,9,50,76,76,20,30,50,140.0,1310.0,275,54,77,131,436.0,82,5.27,57,359,2285,9.4
18584,Michal Grosek,2002-03,27.0,10,40,75,75,13,27,40,114.0,1177.0,350,67,104,171,550.0,82,5.49,53,331,2294,9.8
18585,Michal Grosek,2003-04,28.0,11,20,65,65,9,11,20,84.0,721.0,415,76,115,191,634.0,82,5.51,63,376,2272,9.9
18586,Michal Grosek,2004-05,29.0,12,5,15,15,3,2,5,23.0,186.0,430,79,117,196,657.0,82,5.24,53,338,2262,9.5
18587,Michal Grosek,2005-06,30.0,13,20,63,63,2,18,20,74.0,675.0,493,81,135,216,731.0,82,5.31,60,363,2326,9.4
18588,Michal Grosek,2006-07,31.0,14,5,33,33,3,2,5,24.0,206.0,526,84,137,221,755.0,82,5.14,57,348,2300,9.2
18589,Michal Handzus,2001-02,24.0,4,16,66,66,4,12,16,78.0,977.0,66,4,12,16,78.0,82,5.27,57,359,2285,9.4
18590,Michal Handzus,2002-03,25.0,5,53,81,81,25,28,53,166.0,1436.0,147,29,40,69,244.0,82,5.49,53,331,2294,9.8
18591,Michal Handzus,2003-04,26.0,6,32,46,46,14,18,32,72.0,802.0,193,43,58,101,316.0,82,5.51,63,376,2272,9.9
18592,Michal Handzus,2004-05,27.0,7,45,79,79,15,30,45,94.0,1276.0,272,58,88,146,410.0,82,5.24,53,338,2262,9.5
18593,Michal Handzus,2005-06,28.0,8,44,82,82,23,21,44,133.0,1439.0,354,81,109,190,543.0,82,5.31,60,363,2326,9.4
18594,Michal Handzus,2006-07,29.0,9,58,82,82,20,38,58,135.0,1535.0,436,101,147,248,678.0,82,5.14,57,348,2300,9.2
18595,Michal Handzus,2008-09,31.0,10,44,73,73,11,33,44,113.0,1348.0,509,112,180,292,791.0,82,6.05,85,480,2458,10.1
18596,Michal Handzus,2009-10,32.0,11,8,8,8,3,5,8,9.0,168.0,517,115,185,300,800.0,82,5.76,70,398,2426,9.7
18597,Michal Handzus,2010-11,33.0,12,21,82,82,7,14,21,89.0,1250.0,599,122,199,321,889.0,82,5.44,62,351,2383,9.4
18598,Michal Handzus,2011-12,34.0,13,42,82,82,18,24,42,143.0,1550.0,681,140,223,363,1032.0,82,5.7,65,341,2477,9.4
18599,Michal Handzus,2012-13,35.0,14,42,81,81,20,22,42,117.0,1483.0,762,160,245,405,1149.0,82,5.53,56,304,2486,9.1
18600,Michal Handzus,2013-14,36.0,15,30,82,82,12,18,30,94.0,1422.0,844,172,263,435,1243.0,82,5.46,52,291,2492,9.0
18601,Michal Handzus,2014-15,37.0,16,24,67,67,7,17,24,81.0,968.0,911,179,280,459,1324.0,82,5.32,47,271,2439,8.9
18602,Michal Handzus,2015-16,38.0,17,8,39,39,2,6,8,41.0,512.0,950,181,286,467,1365.0,48,5.31,29,160,1399,9.1
18603,Michal Handzus,2016-17,39.0,18,16,59,59,4,12,16,50.0,805.0,1009,185,298,483,1415.0,82,5.34,48,269,2463,8.9
18604,Michal Jordan,2015-16,25.0,4,0,5,5,0,0,0,2.0,53.0,5,0,0,0,2.0,48,5.31,29,160,1399,9.1
18605,Michal Jordan,2017-18,27.0,5,6,38,38,2,4,6,44.0,606.0,43,2,4,6,46.0,82,5.32,47,251,2453,8.9
18606,Michal Jordan,2018-19,28.0,6,1,36,36,1,0,1,36.0,546.0,79,3,4,7,82.0,82,5.34,48,255,2438,9.0
18607,Michal Kempny,2019-20,29.0,4,8,50,50,2,6,8,67.0,748.0,50,2,6,8,67.0,82,5.45,47,245,2478,9.0
18608,Michal Kempny,2020-21,30.0,5,10,53,53,3,7,10,82.0,843.0,103,5,13,18,149.0,82,5.86,50,250,2620,9.2
18609,Michal Kempny,2021-22,31.0,6,25,71,71,6,19,25,111.0,1362.0,174,11,32,43,260.0,82,5.96,47,239,2579,9.5
18610,Michal Kempny,2022-23,32.0,7,18,58,58,3,15,18,73.0,1081.0,232,14,47,61,333.0,70,5.96,42,208,2192,9.5
18611,Michal Pivonka,1989-90,24.0,4,43,73,73,18,25,43,117.0,,73,18,25,43,117.0,80,7.34,72,344,2400,12.2
18612,Michal Pivonka,1990-91,25.0,5,34,71,71,11,23,34,96.0,,144,29,48,77,213.0,80,7.43,89,437,2435,12.2
18613,Michal Pivonka,1991-92,26.0,6,27,52,52,8,19,27,73.0,,196,37,67,104,286.0,80,7.48,85,403,2430,12.3
18614,Michal Pivonka,1992-93,27.0,7,64,77,77,25,39,64,149.0,,273,62,106,168,435.0,80,7.37,76,367,2421,12.2
18615,Michal Pivonka,1993-94,28.0,8,70,79,79,20,50,70,172.0,,352,82,156,238,607.0,80,6.91,71,366,2385,11.6
18616,Michal Pivonka,1994-95,29.0,9,80,80,80,23,57,80,177.0,,432,105,213,318,784.0,80,6.96,77,402,2440,11.4
18617,Michal Pivonka,1995-96,30.0,10,74,69,69,21,53,74,147.0,,501,126,266,392,931.0,84,7.25,87,443,2603,11.7
18618,Michal Pivonka,1996-97,31.0,11,50,82,82,14,36,50,138.0,,583,140,302,442,1069.0,84,6.48,76,407,2545,10.7
18619,Michal Pivonka,1997-98,32.0,12,33,46,46,10,23,33,80.0,,629,150,325,475,1149.0,48,5.97,37,209,1408,10.2
18620,Michal Pivonka,1998-99,33.0,13,81,73,73,16,65,81,168.0,,702,166,390,556,1317.0,82,6.29,74,413,2481,10.4
18621,Michal Pivonka,1999-00,34.0,14,23,54,54,7,16,23,83.0,,756,173,406,579,1400.0,82,5.83,55,336,2444,9.8
18622,Michal Pivonka,2000-01,35.0,15,9,33,33,3,6,9,38.0,,789,176,412,588,1438.0,82,5.28,57,380,2242,9.6
18623,Michal Pivonka,2001-02,36.0,16,11,36,36,5,6,11,30.0,475.0,825,181,418,599,1468.0,82,5.27,57,359,2285,9.4
18624,Michal Repik,2011-12,23.0,4,2,5,5,2,0,2,7.0,38.0,5,2,0,2,7.0,82,5.7,65,341,2477,9.4
18625,Michal Repik,2012-13,24.0,5,5,19,19,3,2,5,23.0,163.0,24,5,2,7,30.0,82,5.53,56,304,2486,9.1
18626,Michal Repik,2013-14,25.0,6,8,31,31,2,6,8,54.0,396.0,55,7,8,15,84.0,82,5.46,52,291,2492,9.0
18627,Michal Repik,2014-15,26.0,7,5,17,17,2,3,5,35.0,176.0,72,9,11,20,119.0,82,5.32,47,271,2439,8.9
18628,Michal Rozsival,2002-03,24.0,4,21,75,75,4,17,21,73.0,1426.0,75,4,17,21,73.0,82,5.49,53,331,2294,9.8
18629,Michal Rozsival,2003-04,25.0,5,5,30,30,1,4,5,17.0,513.0,105,5,21,26,90.0,82,5.51,63,376,2272,9.9
18630,Michal Rozsival,2004-05,26.0,6,29,79,79,9,20,29,89.0,1581.0,184,14,41,55,179.0,82,5.24,53,338,2262,9.5
18631,Michal Rozsival,2005-06,27.0,7,10,53,53,4,6,10,61.0,1082.0,237,18,47,65,240.0,82,5.31,60,363,2326,9.4
18632,Michal Rozsival,2008-09,30.0,8,30,82,82,5,25,30,115.0,1841.0,319,23,72,95,355.0,82,6.05,85,480,2458,10.1
18633,Michal Rozsival,2009-10,31.0,9,40,80,80,10,30,40,104.0,1902.0,399,33,102,135,459.0,82,5.76,70,398,2426,9.7
18634,Michal Rozsival,2010-11,32.0,10,38,80,80,13,25,38,127.0,1964.0,479,46,127,173,586.0,82,5.44,62,351,2383,9.4
18635,Michal Rozsival,2011-12,33.0,11,30,76,76,8,22,30,120.0,1711.0,555,54,149,203,706.0,82,5.7,65,341,2477,9.4
18636,Michal Rozsival,2012-13,34.0,12,23,82,82,3,20,23,80.0,1758.0,637,57,169,226,786.0,82,5.53,56,304,2486,9.1
18637,Michal Rozsival,2013-14,35.0,13,21,65,65,6,15,21,55.0,1365.0,702,63,184,247,841.0,82,5.46,52,291,2492,9.0
18638,Michal Rozsival,2014-15,36.0,14,13,54,54,1,12,13,49.0,1044.0,756,64,196,260,890.0,82,5.32,47,271,2439,8.9
18639,Michal Rozsival,2015-16,37.0,15,12,27,27,0,12,12,13.0,489.0,783,64,208,272,903.0,48,5.31,29,160,1399,9.1
18640,Michal Rozsival,2016-17,38.0,16,8,42,42,1,7,8,39.0,699.0,825,65,215,280,942.0,82,5.34,48,269,2463,8.9
18641,Michal Rozsival,2017-18,39.0,17,13,65,65,1,12,13,56.0,1106.0,890,66,227,293,998.0,82,5.32,47,251,2453,8.9
18642,Michal Rozsival,2018-19,40.0,18,13,51,51,1,12,13,41.0,824.0,941,67,239,306,1039.0,82,5.34,48,255,2438,9.0
18643,Michal Rozsival,2019-20,41.0,19,3,22,22,1,2,3,16.0,341.0,963,68,241,309,1055.0,82,5.45,47,245,2478,9.0
18644,Michal Sivek,2005-06,25.0,4,6,38,38,3,3,6,45.0,497.0,38,3,3,6,45.0,82,5.31,60,363,2326,9.4
18645,Michal Sykora,1996-97,23.0,4,5,22,22,1,4,5,22.0,,22,1,4,5,22.0,84,6.48,76,407,2545,10.7
18646,Michal Sykora,1997-98,24.0,5,4,16,16,0,4,4,6.0,,38,1,8,9,28.0,48,5.97,37,209,1408,10.2
18647,Michal Sykora,1998-99,25.0,6,20,79,79,4,16,20,80.0,,117,5,24,29,108.0,82,6.29,74,413,2481,10.4
18648,Michal Sykora,1999-00,26.0,7,17,63,63,3,14,17,77.0,,180,8,38,46,185.0,82,5.83,55,336,2444,9.8
18649,Michal Sykora,2000-01,27.0,8,4,28,28,1,3,4,35.0,,208,9,41,50,220.0,82,5.28,57,380,2242,9.6
18650,Michal Sykora,2001-02,28.0,9,3,10,10,1,2,3,24.0,163.0,218,10,43,53,244.0,82,5.27,57,359,2285,9.4
18651,Michal Sykora,2003-04,30.0,10,16,49,49,5,11,16,71.0,806.0,267,15,54,69,315.0,82,5.51,63,376,2272,9.9
18652,Micheal Ferland,2017-18,25.0,4,5,26,26,2,3,5,34.0,274.0,26,2,3,5,34.0,82,5.32,47,251,2453,8.9
18653,Micheal Ferland,2018-19,26.0,5,18,71,71,4,14,18,122.0,896.0,97,6,17,23,156.0,82,5.34,48,255,2438,9.0
18654,Micheal Ferland,2019-20,27.0,6,25,76,76,15,10,25,106.0,879.0,173,21,27,48,262.0,82,5.45,47,245,2478,9.0
18655,Micheal Ferland,2020-21,28.0,7,41,77,77,21,20,41,144.0,1156.0,250,42,47,89,406.0,82,5.86,50,250,2620,9.2
18656,Micheal Ferland,2021-22,29.0,8,40,71,71,17,23,40,156.0,1001.0,321,59,70,129,562.0,82,5.96,47,239,2579,9.5
18657,Micheal Ferland,2022-23,30.0,9,5,14,14,1,4,5,15.0,137.0,335,60,74,134,577.0,70,5.96,42,208,2192,9.5
18658,Micheal Haley,2012-13,26.0,4,0,2,2,0,0,0,0.0,15.0,2,0,0,0,0.0,82,5.53,56,304,2486,9.1
18659,Micheal Haley,2013-14,27.0,5,3,27,27,2,1,3,13.0,217.0,29,2,1,3,13.0,82,5.46,52,291,2492,9.0
18660,Micheal Haley,2014-15,28.0,6,0,14,14,0,0,0,13.0,111.0,43,2,1,3,26.0,82,5.32,47,271,2439,8.9
18661,Micheal Haley,2015-16,29.0,7,0,9,9,0,0,0,4.0,60.0,52,2,1,3,30.0,48,5.31,29,160,1399,9.1
18662,Micheal Haley,2017-18,31.0,8,0,4,4,0,0,0,1.0,30.0,56,2,1,3,31.0,82,5.32,47,251,2453,8.9
18663,Micheal Haley,2018-19,32.0,9,1,16,16,1,0,1,10.0,114.0,72,3,1,4,41.0,82,5.34,48,255,2438,9.0
18664,Micheal Haley,2019-20,33.0,10,12,58,58,2,10,12,37.0,532.0,130,5,11,16,78.0,82,5.45,47,245,2478,9.0
18665,Micheal Haley,2020-21,34.0,11,9,75,75,3,6,9,55.0,584.0,205,8,17,25,133.0,82,5.86,50,250,2620,9.2
18666,Micheal Haley,2021-22,35.0,12,6,43,43,2,4,6,34.0,348.0,248,10,21,31,167.0,82,5.96,47,239,2579,9.5
18667,Micheal Haley,2022-23,36.0,13,1,22,22,1,0,1,9.0,122.0,270,11,21,32,176.0,70,5.96,42,208,2192,9.5
18668,Michel Bolduc,1984-85,23.0,4,0,3,3,0,0,0,1.0,,3,0,0,0,1.0,80,8.03,73,320,2489,12.9
18669,Michel Bolduc,1985-86,24.0,5,0,7,7,0,0,0,4.0,,10,0,0,0,5.0,80,7.73,71,310,2444,12.7
18670,Michel Galarneau,1983-84,22.0,4,8,30,30,2,6,8,19.0,,30,2,6,8,19.0,80,7.69,77,340,2441,12.6
18671,Michel Galarneau,1984-85,23.0,5,0,10,10,0,0,0,10.0,,40,2,6,8,29.0,80,8.03,73,320,2489,12.9
18672,Michel Galarneau,1985-86,24.0,6,9,38,38,5,4,9,28.0,,78,7,10,17,57.0,80,7.73,71,310,2444,12.7
18673,Michel Goulet,1982-83,22.0,4,54,77,77,22,32,54,167.0,,77,22,32,54,167.0,80,7.03,61,280,2352,12.0
18674,Michel Goulet,1983-84,23.0,5,71,76,76,32,39,71,265.0,,153,54,71,125,432.0,80,7.69,77,340,2441,12.6
18675,Michel Goulet,1984-85,24.0,6,84,80,80,42,42,84,250.0,,233,96,113,209,682.0,80,8.03,73,320,2489,12.9
18676,Michel Goulet,1985-86,25.0,7,105,80,80,57,48,105,256.0,,313,153,161,314,938.0,80,7.73,71,310,2444,12.7
18677,Michel Goulet,1986-87,26.0,8,122,75,75,56,66,122,239.0,,388,209,227,436,1177.0,80,7.89,74,336,2448,12.9
18678,Michel Goulet,1987-88,27.0,9,95,69,69,55,40,95,260.0,,457,264,267,531,1437.0,80,7.77,71,321,2447,12.7
18679,Michel Goulet,1988-89,28.0,10,104,75,75,53,51,104,244.0,,532,317,318,635,1681.0,80,7.94,82,370,2484,12.8
18680,Michel Goulet,1989-90,29.0,11,96,75,75,49,47,96,276.0,,607,366,365,731,1957.0,80,7.34,72,344,2400,12.2
18681,Michel Goulet,1990-91,30.0,12,106,80,80,48,58,106,284.0,,687,414,423,837,2241.0,80,7.43,89,437,2435,12.2
18682,Michel Goulet,1991-92,31.0,13,64,69,69,26,38,64,162.0,,756,440,461,901,2403.0,80,7.48,85,403,2430,12.3
18683,Michel Goulet,1992-93,32.0,14,50,65,65,20,30,50,154.0,,821,460,491,951,2557.0,80,7.37,76,367,2421,12.2
18684,Michel Goulet,1993-94,33.0,15,65,74,74,27,38,65,167.0,,895,487,529,1016,2724.0,80,6.91,71,366,2385,11.6
18685,Michel Goulet,1994-95,34.0,16,63,75,75,22,41,63,176.0,,970,509,570,1079,2900.0,80,6.96,77,402,2440,11.4
18686,Michel Goulet,1995-96,35.0,17,44,63,63,23,21,44,125.0,,1033,532,591,1123,3025.0,84,7.25,87,443,2603,11.7
18687,Michel Goulet,1996-97,36.0,18,30,56,56,16,14,30,120.0,,1089,548,605,1153,3145.0,84,6.48,76,407,2545,10.7
18688,Michel Mongeau,1992-93,27.0,4,6,7,7,1,5,6,2.0,,7,1,5,6,2.0,80,7.37,76,367,2421,12.2
18689,Michel Mongeau,1993-94,28.0,5,2,7,7,1,1,2,13.0,,14,2,6,8,15.0,80,6.91,71,366,2385,11.6
18690,Michel Mongeau,1994-95,29.0,6,15,36,36,3,12,15,23.0,,50,5,18,23,38.0,80,6.96,77,402,2440,11.4
18691,Michel Mongeau,1995-96,30.0,7,2,4,4,1,1,2,2.0,,54,6,19,25,40.0,84,7.25,87,443,2603,11.7
18692,Michel Ouellet,2008-09,26.0,4,32,50,50,16,16,32,87.0,701.0,50,16,16,32,87.0,82,6.05,85,480,2458,10.1
18693,Michel Ouellet,2009-10,27.0,5,48,73,73,19,29,48,148.0,973.0,123,35,45,80,235.0,82,5.76,70,398,2426,9.7
18694,Michel Ouellet,2010-11,28.0,6,36,64,64,17,19,36,132.0,872.0,187,52,64,116,367.0,82,5.44,62,351,2383,9.4
18695,Michel Ouellet,2011-12,29.0,7,0,3,3,0,0,0,3.0,29.0,190,52,64,116,370.0,82,5.7,65,341,2477,9.4
18696,Michel Petit,1985-86,21.0,4,0,2,2,0,0,0,1.0,,2,0,0,0,1.0,80,7.73,71,310,2444,12.7
18697,Michel Petit,1986-87,22.0,5,15,44,44,6,9,15,80.0,,46,6,9,15,81.0,80,7.89,74,336,2448,12.9
18698,Michel Petit,1987-88,23.0,6,31,69,69,5,26,31,96.0,,115,11,35,46,177.0,80,7.77,71,321,2447,12.7
18699,Michel Petit,1988-89,24.0,7,7,32,32,1,6,7,43.0,,147,12,41,53,220.0,80,7.94,82,370,2484,12.8
18700,Michel Petit,1989-90,25.0,8,25,69,69,12,13,25,116.0,,216,24,54,78,336.0,80,7.34,72,344,2400,12.2
18701,Michel Petit,1990-91,26.0,9,36,74,74,9,27,36,109.0,,290,33,81,114,445.0,80,7.43,89,437,2435,12.2
18702,Michel Petit,1991-92,27.0,10,33,69,69,8,25,33,132.0,,359,41,106,147,577.0,80,7.48,85,403,2430,12.3
18703,Michel Petit,1992-93,28.0,11,36,63,63,12,24,36,137.0,,422,53,130,183,714.0,80,7.37,76,367,2421,12.2
18704,Michel Petit,1993-94,29.0,12,39,73,73,13,26,39,134.0,,495,66,156,222,848.0,80,6.91,71,366,2385,11.6
18705,Michel Petit,1994-95,30.0,13,27,70,70,4,23,27,129.0,,565,70,179,249,977.0,80,6.96,77,402,2440,11.4
18706,Michel Petit,1995-96,31.0,14,12,35,35,3,9,12,58.0,,600,73,188,261,1035.0,84,7.25,87,443,2603,11.7
18707,Michel Petit,1996-97,32.0,15,23,63,63,2,21,23,103.0,,663,75,209,284,1138.0,84,6.48,76,407,2545,10.7
18708,Michel Petit,1997-98,33.0,16,17,40,40,5,12,17,70.0,,703,80,221,301,1208.0,48,5.97,37,209,1408,10.2
18709,Michel Petit,1998-99,34.0,17,12,54,54,4,8,12,68.0,,757,84,229,313,1276.0,82,6.29,74,413,2481,10.4
18710,Michel Petit,1999-00,35.0,18,9,38,38,2,7,9,43.0,,795,86,236,322,1319.0,82,5.83,55,336,2444,9.8
18711,Michel Petit,2000-01,36.0,19,6,32,32,4,2,6,34.0,,827,90,238,328,1353.0,82,5.28,57,380,2242,9.6
18712,Michel Picard,1993-94,24.0,4,1,5,5,1,0,1,7.0,,5,1,0,1,7.0,80,6.91,71,366,2385,11.6
18713,Michel Picard,1994-95,25.0,5,8,25,25,3,5,8,41.0,,30,4,5,9,48.0,80,6.96,77,402,2440,11.4
18714,Michel Picard,1995-96,26.0,6,4,25,25,4,0,4,32.0,,55,8,5,13,80.0,84,7.25,87,443,2603,11.7
18715,Michel Picard,1997-98,28.0,7,13,24,24,5,8,13,33.0,,79,13,13,26,113.0,48,5.97,37,209,1408,10.2
18716,Michel Picard,1998-99,29.0,8,8,17,17,2,6,8,21.0,,96,15,19,34,134.0,82,6.29,74,413,2481,10.4
18717,Michel Picard,2000-01,31.0,9,9,16,16,1,8,9,19.0,,112,16,27,43,153.0,82,5.28,57,380,2242,9.6
18718,Michel Picard,2001-02,32.0,10,22,45,45,11,11,22,69.0,645.0,157,27,38,65,222.0,82,5.27,57,359,2285,9.4
18719,Michel Picard,2002-03,33.0,11,0,2,2,0,0,0,2.0,20.0,159,27,38,65,224.0,82,5.49,53,331,2294,9.8
18720,Michel Picard,2003-04,34.0,12,5,7,7,1,4,5,12.0,100.0,166,28,42,70,236.0,82,5.51,63,376,2272,9.9
18721,Michel Riesen,2003-04,24.0,4,1,12,12,0,1,1,16.0,119.0,12,0,1,1,16.0,82,5.51,63,376,2272,9.9
18722,Mick Vukota,1990-91,24.0,4,1,17,17,1,0,1,7.0,,17,1,0,1,7.0,80,7.43,89,437,2435,12.2
18723,Mick Vukota,1991-92,25.0,5,4,48,48,2,2,4,19.0,,65,3,2,5,26.0,80,7.48,85,403,2430,12.3
18724,Mick Vukota,1992-93,26.0,6,12,76,76,4,8,12,55.0,,141,7,10,17,81.0,80,7.37,76,367,2421,12.2
18725,Mick Vukota,1993-94,27.0,7,6,60,60,2,4,6,39.0,,201,9,14,23,120.0,80,6.91,71,366,2385,11.6
18726,Mick Vukota,1994-95,28.0,8,6,74,74,0,6,6,34.0,,275,9,20,29,154.0,80,6.96,77,402,2440,11.4
18727,Mick Vukota,1995-96,29.0,9,7,74,74,2,5,7,37.0,,349,11,25,36,191.0,84,7.25,87,443,2603,11.7
18728,Mick Vukota,1996-97,30.0,10,4,72,72,3,1,4,26.0,,421,14,26,40,217.0,84,6.48,76,407,2545,10.7
18729,Mick Vukota,1997-98,31.0,11,2,39,39,0,2,2,11.0,,460,14,28,42,228.0,48,5.97,37,209,1408,10.2
18730,Mick Vukota,1998-99,32.0,12,2,32,32,1,1,2,11.0,,492,15,29,44,239.0,82,6.29,74,413,2481,10.4
18731,Mick Vukota,1999-00,33.0,13,1,17,17,1,0,1,7.0,,509,16,29,45,246.0,82,5.83,55,336,2444,9.8
18732,Mick Vukota,2000-01,34.0,14,1,64,64,1,0,1,23.0,,573,17,29,46,269.0,82,5.28,57,380,2242,9.6
18733,Mickey Volcan,1983-84,21.0,4,13,49,49,2,11,13,49.0,,49,2,11,13,49.0,80,7.69,77,340,2441,12.6
18734,Mickey Volcan,1984-85,22.0,5,6,26,26,1,5,6,45.0,,75,3,16,19,94.0,80,8.03,73,320,2489,12.9
18735,Mickey Volcan,1985-86,23.0,6,17,68,68,4,13,17,72.0,,143,7,29,36,166.0,80,7.73,71,310,2444,12.7
18736,Mickey Volcan,1986-87,24.0,7,5,19,19,1,4,5,13.0,,162,8,33,41,179.0,80,7.89,74,336,2448,12.9
18737,Micki DuPont,2004-05,24.0,4,0,2,2,0,0,0,2.0,29.0,2,0,0,0,2.0,82,5.24,53,338,2262,9.5
18738,Micki DuPont,2005-06,25.0,5,3,16,16,1,2,3,27.0,268.0,18,1,2,3,29.0,82,5.31,60,363,2326,9.4
18739,Micki DuPont,2009-10,29.0,6,1,3,3,0,1,1,6.0,41.0,21,1,3,4,35.0,82,5.76,70,398,2426,9.7
18740,Micki DuPont,2010-11,30.0,7,0,2,2,0,0,0,3.0,25.0,23,1,3,4,38.0,82,5.44,62,351,2383,9.4
18741,Miika Elomo,2002-03,25.0,4,1,2,2,0,1,1,3.0,22.0,2,0,1,1,3.0,82,5.49,53,331,2294,9.8
18742,Miikka Salomaki,2017-18,24.0,4,1,1,1,1,0,1,4.0,11.0,1,1,0,1,4.0,82,5.32,47,251,2453,8.9
18743,Miikka Salomaki,2018-19,25.0,5,10,61,61,5,5,10,61.0,732.0,62,6,5,11,65.0,82,5.34,48,255,2438,9.0
18744,Miikka Salomaki,2019-20,26.0,6,0,5,5,0,0,0,3.0,61.0,67,6,5,11,68.0,82,5.45,47,245,2478,9.0
18745,Miikka Salomaki,2020-21,27.0,7,8,58,58,2,6,8,51.0,596.0,125,8,11,19,119.0,82,5.86,50,250,2620,9.2
18746,Miikka Salomaki,2021-22,28.0,8,7,37,37,3,4,7,51.0,387.0,162,11,15,26,170.0,82,5.96,47,239,2579,9.5
18747,Miikka Salomaki,2022-23,29.0,9,1,5,5,1,0,1,2.0,61.0,167,12,15,27,172.0,70,5.96,42,208,2192,9.5
18748,Mika Alatalo,2002-03,31.0,4,27,82,82,10,17,27,107.0,1035.0,82,10,17,27,107.0,82,5.49,53,331,2294,9.8
18749,Mika Alatalo,2003-04,32.0,5,19,70,70,7,12,19,64.0,769.0,152,17,29,46,171.0,82,5.51,63,376,2272,9.9
18750,Mika Pyorala,2012-13,31.0,4,4,36,36,2,2,4,41.0,489.0,36,2,2,4,41.0,82,5.53,56,304,2486,9.1
18751,Mika Zibanejad,2014-15,21.0,4,1,9,9,0,1,1,12.0,116.0,9,0,1,1,12.0,82,5.32,47,271,2439,8.9
18752,Mika Zibanejad,2015-16,22.0,5,20,42,42,7,13,20,90.0,570.0,51,7,14,21,102.0,48,5.31,29,160,1399,9.1
18753,Mika Zibanejad,2016-17,23.0,6,33,69,69,16,17,33,153.0,989.0,120,23,31,54,255.0,82,5.34,48,269,2463,8.9
18754,Mika Zibanejad,2017-18,24.0,7,46,80,80,20,26,46,150.0,1315.0,200,43,57,100,405.0,82,5.32,47,251,2453,8.9
18755,Mika Zibanejad,2018-19,25.0,8,51,81,81,21,30,51,184.0,1439.0,281,64,87,151,589.0,82,5.34,48,255,2438,9.0
18756,Mika Zibanejad,2019-20,26.0,9,37,56,56,14,23,37,119.0,956.0,337,78,110,188,708.0,82,5.45,47,245,2478,9.0
18757,Mika Zibanejad,2020-21,27.0,10,47,72,72,27,20,47,212.0,1293.0,409,105,130,235,920.0,82,5.86,50,250,2620,9.2
18758,Mika Zibanejad,2021-22,28.0,11,74,82,82,30,44,74,236.0,1686.0,491,135,174,309,1156.0,82,5.96,47,239,2579,9.5
18759,Mika Zibanejad,2022-23,29.0,12,75,57,57,41,34,75,208.0,1233.0,548,176,208,384,1364.0,70,5.96,42,208,2192,9.5
18760,Mikael Andersson,1988-89,22.0,4,10,32,32,1,9,10,13.0,,32,1,9,10,13.0,80,7.94,82,370,2484,12.8
18761,Mikael Andersson,1989-90,23.0,5,3,16,16,0,3,3,6.0,,48,1,12,13,19.0,80,7.34,72,344,2400,12.2
18762,Mikael Andersson,1990-91,24.0,6,23,37,37,3,20,23,34.0,,85,4,32,36,53.0,80,7.43,89,437,2435,12.2
18763,Mikael Andersson,1991-92,25.0,7,1,14,14,0,1,1,12.0,,99,4,33,37,65.0,80,7.48,85,403,2430,12.3
18764,Mikael Andersson,1992-93,26.0,8,37,50,50,13,24,37,86.0,,149,17,57,74,151.0,80,7.37,76,367,2421,12.2
18765,Mikael Andersson,1993-94,27.0,9,11,41,41,4,7,11,57.0,,190,21,64,85,208.0,80,6.91,71,366,2385,11.6
18766,Mikael Andersson,1994-95,28.0,10,47,74,74,18,29,47,149.0,,264,39,93,132,357.0,80,6.96,77,402,2440,11.4
18767,Mikael Andersson,1995-96,29.0,11,27,77,77,16,11,27,169.0,,341,55,104,159,526.0,84,7.25,87,443,2603,11.7
18768,Mikael Andersson,1996-97,30.0,12,25,76,76,13,12,25,136.0,,417,68,116,184,662.0,84,6.48,76,407,2545,10.7
18769,Mikael Andersson,1997-98,31.0,13,11,36,36,4,7,11,36.0,,453,72,123,195,698.0,48,5.97,37,209,1408,10.2
18770,Mikael Andersson,1998-99,32.0,14,19,64,64,8,11,19,104.0,,517,80,134,214,802.0,82,6.29,74,413,2481,10.4
18771,Mikael Andersson,1999-00,33.0,15,19,70,70,5,14,19,102.0,,587,85,148,233,904.0,82,5.83,55,336,2444,9.8
18772,Mikael Andersson,2000-01,34.0,16,17,72,72,6,11,17,105.0,,659,91,159,250,1009.0,82,5.28,57,380,2242,9.6
18773,Mikael Andersson,2001-02,35.0,17,6,47,47,2,4,6,51.0,597.0,706,93,163,256,1060.0,82,5.27,57,359,2285,9.4
18774,Mikael Andersson,2002-03,36.0,18,8,55,55,2,6,8,57.0,559.0,761,95,169,264,1117.0,82,5.49,53,331,2294,9.8
18775,Mikael Backlund,2011-12,22.0,4,0,1,1,0,0,0,1.0,11.0,1,0,0,0,1.0,82,5.7,65,341,2477,9.4
18776,Mikael Backlund,2012-13,23.0,5,10,23,23,1,9,10,47.0,290.0,24,1,9,10,48.0,82,5.53,56,304,2486,9.1
18777,Mikael Backlund,2013-14,24.0,6,25,73,73,10,15,25,144.0,882.0,97,11,24,35,192.0,82,5.46,52,291,2492,9.0
18778,Mikael Backlund,2014-15,25.0,7,11,41,41,4,7,11,85.0,631.0,138,15,31,46,277.0,82,5.32,47,271,2439,8.9
18779,Mikael Backlund,2015-16,26.0,8,16,32,32,8,8,16,88.0,484.0,170,23,39,62,365.0,48,5.31,29,160,1399,9.1
18780,Mikael Backlund,2016-17,27.0,9,39,76,76,18,21,39,178.0,1409.0,246,41,60,101,543.0,82,5.34,48,269,2463,8.9
18781,Mikael Backlund,2017-18,28.0,10,27,52,52,10,17,27,103.0,923.0,298,51,77,128,646.0,82,5.32,47,251,2453,8.9
18782,Mikael Backlund,2018-19,29.0,11,47,82,82,21,26,47,155.0,1347.0,380,72,103,175,801.0,82,5.34,48,255,2438,9.0
18783,Mikael Backlund,2019-20,30.0,12,53,81,81,22,31,53,197.0,1426.0,461,94,134,228,998.0,82,5.45,47,245,2478,9.0
18784,Mikael Backlund,2020-21,31.0,13,45,82,82,14,31,45,214.0,1560.0,543,108,165,273,1212.0,82,5.86,50,250,2620,9.2
18785,Mikael Backlund,2021-22,32.0,14,47,77,77,21,26,47,205.0,1378.0,620,129,191,320,1417.0,82,5.96,47,239,2579,9.5
18786,Mikael Backlund,2022-23,33.0,15,45,70,70,16,29,45,157.0,1256.0,690,145,220,365,1574.0,70,5.96,42,208,2192,9.5
18787,Mikael Granlund,2015-16,23.0,4,8,27,27,2,6,8,36.0,356.0,27,2,6,8,36.0,48,5.31,29,160,1399,9.1
18788,Mikael Granlund,2016-17,24.0,5,41,63,63,8,33,41,104.0,1091.0,90,10,39,49,140.0,82,5.34,48,269,2463,8.9
18789,Mikael Granlund,2017-18,25.0,6,39,68,68,8,31,39,99.0,1217.0,158,18,70,88,239.0,82,5.32,47,251,2453,8.9
18790,Mikael Granlund,2018-19,26.0,7,44,82,82,13,31,44,160.0,1486.0,240,31,101,132,399.0,82,5.34,48,255,2438,9.0
18791,Mikael Granlund,2019-20,27.0,8,69,81,81,26,43,69,177.0,1525.0,321,57,144,201,576.0,82,5.45,47,245,2478,9.0
18792,Mikael Granlund,2020-21,28.0,9,67,77,77,21,46,67,193.0,1446.0,398,78,190,268,769.0,82,5.86,50,250,2620,9.2
18793,Mikael Granlund,2021-22,29.0,10,54,79,79,16,38,54,189.0,1449.0,477,94,228,322,958.0,82,5.96,47,239,2579,9.5
18794,Mikael Granlund,2022-23,30.0,11,30,63,63,17,13,30,130.0,1122.0,540,111,241,352,1088.0,70,5.96,42,208,2192,9.5
18795,Mikael Lindholm,1992-93,28.0,4,4,18,18,2,2,4,10.0,,18,2,2,4,10.0,80,7.37,76,367,2421,12.2
18796,Mikael Renberg,1996-97,24.0,4,82,83,83,38,44,82,195.0,,83,38,44,82,195.0,84,6.48,76,407,2545,10.7
18797,Mikael Renberg,1997-98,25.0,5,57,47,47,26,31,57,143.0,,130,64,75,139,338.0,48,5.97,37,209,1408,10.2
18798,Mikael Renberg,1998-99,26.0,6,43,51,51,23,20,43,198.0,,181,87,95,182,536.0,82,6.29,74,413,2481,10.4
18799,Mikael Renberg,1999-00,27.0,7,59,77,77,22,37,59,249.0,,258,109,132,241,785.0,82,5.83,55,336,2444,9.8
18800,Mikael Renberg,2000-01,28.0,8,38,68,68,16,22,38,175.0,,326,125,154,279,960.0,82,5.28,57,380,2242,9.6
18801,Mikael Renberg,2001-02,29.0,9,38,66,66,15,23,38,154.0,1047.0,392,140,177,317,1114.0,82,5.27,57,359,2285,9.4
18802,Mikael Renberg,2002-03,30.0,10,35,72,72,10,25,35,122.0,989.0,464,150,202,352,1236.0,82,5.49,53,331,2294,9.8
18803,Mikael Renberg,2004-05,32.0,11,52,71,71,14,38,52,130.0,1035.0,535,164,240,404,1366.0,82,5.24,53,338,2262,9.5
18804,Mikael Renberg,2005-06,33.0,12,35,67,67,14,21,35,137.0,907.0,602,178,261,439,1503.0,82,5.31,60,363,2326,9.4
18805,Mikael Renberg,2006-07,34.0,13,25,59,59,12,13,25,88.0,783.0,661,190,274,464,1591.0,82,5.14,57,348,2300,9.2
18806,Mikael Samuelsson,2003-04,27.0,4,0,4,4,0,0,0,3.0,19.0,4,0,0,0,3.0,82,5.51,63,376,2272,9.9
18807,Mikael Samuelsson,2004-05,28.0,5,16,67,67,6,10,16,94.0,795.0,71,6,10,16,97.0,82,5.24,53,338,2262,9.5
18808,Mikael Samuelsson,2005-06,29.0,6,24,80,80,10,14,24,154.0,1211.0,151,16,24,40,251.0,82,5.31,60,363,2326,9.4
18809,Mikael Samuelsson,2006-07,30.0,7,9,37,37,3,6,9,50.0,454.0,188,19,30,49,301.0,82,5.14,57,348,2300,9.2
18810,Mikael Samuelsson,2008-09,32.0,8,45,71,71,23,22,45,187.0,960.0,259,42,52,94,488.0,82,6.05,85,480,2458,10.1
18811,Mikael Samuelsson,2009-10,33.0,9,34,53,53,14,20,34,189.0,803.0,312,56,72,128,677.0,82,5.76,70,398,2426,9.7
18812,Mikael Samuelsson,2010-11,34.0,10,40,73,73,11,29,40,249.0,1187.0,385,67,101,168,926.0,82,5.44,62,351,2383,9.4
18813,Mikael Samuelsson,2011-12,35.0,11,40,81,81,19,21,40,257.0,1245.0,466,86,122,208,1183.0,82,5.7,65,341,2477,9.4
18814,Mikael Samuelsson,2012-13,36.0,12,53,74,74,30,23,53,219.0,1271.0,540,116,145,261,1402.0,82,5.53,56,304,2486,9.1
18815,Mikael Samuelsson,2013-14,37.0,13,50,75,75,18,32,50,215.0,1247.0,615,134,177,311,1617.0,82,5.46,52,291,2492,9.0
18816,Mikael Samuelsson,2014-15,38.0,14,31,54,54,14,17,31,138.0,861.0,669,148,194,342,1755.0,82,5.32,47,271,2439,8.9
18817,Mikael Samuelsson,2015-16,39.0,15,1,4,4,0,1,1,4.0,51.0,673,148,195,343,1759.0,48,5.31,29,160,1399,9.1
18818,Mikael Samuelsson,2016-17,40.0,16,3,26,26,1,2,3,36.0,269.0,699,149,197,346,1795.0,82,5.34,48,269,2463,8.9
18819,Mike Allison,1983-84,22.0,4,64,75,75,26,38,64,122.0,,75,26,38,64,122.0,80,7.69,77,340,2441,12.6
18820,Mike Allison,1984-85,23.0,5,22,48,48,7,15,22,62.0,,123,33,53,86,184.0,80,8.03,73,320,2489,12.9
18821,Mike Allison,1985-86,24.0,6,20,39,39,11,9,20,45.0,,162,44,62,106,229.0,80,7.73,71,310,2444,12.7
18822,Mike Allison,1986-87,25.0,7,20,45,45,8,12,20,52.0,,207,52,74,126,281.0,80,7.89,74,336,2448,12.9
18823,Mike Allison,1987-88,26.0,8,24,31,31,9,15,24,46.0,,238,61,89,150,327.0,80,7.77,71,321,2447,12.7
18824,Mike Allison,1988-89,27.0,9,15,28,28,2,13,15,26.0,,266,63,102,165,353.0,80,7.94,82,370,2484,12.8
18825,Mike Allison,1989-90,28.0,10,23,71,71,7,16,23,48.0,,337,70,118,188,401.0,80,7.34,72,344,2400,12.2
18826,Mike Allison,1990-91,29.0,11,31,52,52,16,15,31,61.0,,389,86,133,219,462.0,80,7.43,89,437,2435,12.2
18827,Mike Allison,1991-92,30.0,12,36,55,55,14,22,36,71.0,,444,100,155,255,533.0,80,7.48,85,403,2430,12.3
18828,Mike Allison,1992-93,31.0,13,13,55,55,2,11,13,25.0,,499,102,166,268,558.0,80,7.37,76,367,2421,12.2
18829,Mike Amodeo,1982-83,30.0,4,0,19,19,0,0,0,14.0,,19,0,0,0,14.0,80,7.03,61,280,2352,12.0
18830,Mike Angelidis,2014-15,29.0,4,1,6,6,1,0,1,8.0,39.0,6,1,0,1,8.0,82,5.32,47,271,2439,8.9
18831,Mike Angelidis,2015-16,30.0,5,0,1,1,0,0,0,0.0,7.0,7,1,0,1,8.0,48,5.31,29,160,1399,9.1
18832,Mike Angelidis,2017-18,32.0,6,0,3,3,0,0,0,0.0,22.0,10,1,0,1,8.0,82,5.32,47,251,2453,8.9
18833,Mike Angelidis,2018-19,33.0,7,1,4,4,1,0,1,1.0,36.0,14,2,0,2,9.0,82,5.34,48,255,2438,9.0
18834,Mike Backman,1984-85,30.0,4,2,3,3,0,2,2,1.0,,3,0,2,2,1.0,80,8.03,73,320,2489,12.9
18835,Mike Backman,1985-86,31.0,5,4,7,7,1,3,4,9.0,,10,1,5,6,10.0,80,7.73,71,310,2444,12.7
18836,Mike Backman,1986-87,32.0,6,1,8,8,0,1,1,6.0,,18,1,6,7,16.0,80,7.89,74,336,2448,12.9
18837,Mike Berger,1990-91,23.0,4,4,29,29,3,1,4,41.0,,29,3,1,4,41.0,80,7.43,89,437,2435,12.2
18838,Mike Berger,1991-92,24.0,5,0,1,1,0,0,0,0.0,,30,3,1,4,41.0,80,7.48,85,403,2430,12.3
18839,Mike Bishai,2006-07,27.0,4,2,14,14,0,2,2,14.0,128.0,14,0,2,2,14.0,82,5.14,57,348,2300,9.2
18840,Mike Blaisdell,1983-84,24.0,4,9,32,32,3,6,9,45.0,,32,3,6,9,45.0,80,7.69,77,340,2441,12.6
18841,Mike Blaisdell,1984-85,25.0,5,55,80,80,23,32,55,165.0,,112,26,38,64,210.0,80,8.03,73,320,2489,12.9
18842,Mike Blaisdell,1985-86,26.0,6,41,80,80,18,23,41,171.0,,192,44,61,105,381.0,80,7.73,71,310,2444,12.7
18843,Mike Blaisdell,1986-87,27.0,7,11,36,36,5,6,11,61.0,,228,49,67,116,442.0,80,7.89,74,336,2448,12.9
18844,Mike Blaisdell,1987-88,28.0,8,1,12,12,1,0,1,20.0,,240,50,67,117,462.0,80,7.77,71,321,2447,12.7
18845,Mike Blaisdell,1988-89,29.0,9,29,66,66,15,14,29,124.0,,306,65,81,146,586.0,80,7.94,82,370,2484,12.8
18846,Mike Blaisdell,1989-90,30.0,10,2,10,10,1,1,2,12.0,,316,66,82,148,598.0,80,7.34,72,344,2400,12.2
18847,Mike Blaisdell,1990-91,31.0,11,5,18,18,3,2,5,32.0,,334,69,84,153,630.0,80,7.43,89,437,2435,12.2
18848,Mike Blaisdell,1991-92,32.0,12,1,9,9,1,0,1,8.0,,343,70,84,154,638.0,80,7.48,85,403,2430,12.3
18849,Mike Blunden,2009-10,23.0,4,0,9,9,0,0,0,10.0,102.0,9,0,0,0,10.0,82,5.76,70,398,2426,9.7
18850,Mike Blunden,2010-11,24.0,5,0,1,1,0,0,0,1.0,8.0,10,0,0,0,11.0,82,5.44,62,351,2383,9.4
18851,Mike Blunden,2012-13,26.0,6,4,40,40,2,2,4,40.0,324.0,50,2,2,4,51.0,82,5.53,56,304,2486,9.1
18852,Mike Blunden,2013-14,27.0,7,0,1,1,0,0,0,2.0,11.0,51,2,2,4,53.0,82,5.46,52,291,2492,9.0
18853,Mike Blunden,2014-15,28.0,8,4,39,39,2,2,4,34.0,365.0,90,4,4,8,87.0,82,5.32,47,271,2439,8.9
18854,Mike Blunden,2015-16,29.0,9,0,5,5,0,0,0,5.0,42.0,95,4,4,8,92.0,48,5.31,29,160,1399,9.1
18855,Mike Blunden,2016-17,30.0,10,0,7,7,0,0,0,2.0,43.0,102,4,4,8,94.0,82,5.34,48,269,2463,8.9
18856,Mike Blunden,2017-18,31.0,11,0,2,2,0,0,0,0.0,20.0,104,4,4,8,94.0,82,5.32,47,251,2453,8.9
18857,Mike Blunden,2018-19,32.0,12,5,20,20,3,2,5,14.0,173.0,124,7,6,13,108.0,82,5.34,48,255,2438,9.0
18858,Mike Blunden,2019-20,33.0,13,0,2,2,0,0,0,1.0,16.0,126,7,6,13,109.0,82,5.45,47,245,2478,9.0
18859,Mike Blunden,2020-21,34.0,14,0,1,1,0,0,0,1.0,7.0,127,7,6,13,110.0,82,5.86,50,250,2620,9.2
18860,Mike Brown,2003-04,24.0,4,0,1,1,0,0,0,1.0,5.0,1,0,0,0,1.0,82,5.51,63,376,2272,9.9
18861,Mike Brown,2004-05,25.0,5,0,15,15,0,0,0,2.0,52.0,16,0,0,0,3.0,82,5.24,53,338,2262,9.5
18862,Mike Brown,2005-06,26.0,6,2,16,16,1,1,2,8.0,80.0,32,1,1,2,11.0,82,5.31,60,363,2326,9.4
18863,Mike Brown,2008-09,29.0,7,1,2,2,0,1,1,1.0,12.0,34,1,2,3,12.0,82,6.05,85,480,2458,10.1
18864,Mike Brown0,2010-11,25.0,4,1,19,19,1,0,1,9.0,120.0,19,1,0,1,9.0,82,5.44,62,351,2383,9.4
18865,Mike Brown0,2011-12,26.0,5,4,48,48,2,2,4,44.0,391.0,67,3,2,5,53.0,82,5.7,65,341,2477,9.4
18866,Mike Brown0,2012-13,27.0,6,7,75,75,6,1,7,82.0,626.0,142,9,3,12,135.0,82,5.53,56,304,2486,9.1
18867,Mike Brown0,2013-14,28.0,7,8,50,50,3,5,8,59.0,505.0,192,12,8,20,194.0,82,5.46,52,291,2492,9.0
18868,Mike Brown0,2014-15,29.0,8,4,50,50,2,2,4,56.0,464.0,242,14,10,24,250.0,82,5.32,47,271,2439,8.9
18869,Mike Brown0,2015-16,30.0,9,2,39,39,1,1,2,18.0,293.0,281,15,11,26,268.0,48,5.31,29,160,1399,9.1
18870,Mike Brown0,2016-17,31.0,10,5,56,56,2,3,5,45.0,400.0,337,17,14,31,313.0,82,5.34,48,269,2463,8.9
18871,Mike Brown0,2017-18,32.0,11,0,12,12,0,0,0,11.0,98.0,349,17,14,31,324.0,82,5.32,47,251,2453,8.9
18872,Mike Brown0,2018-19,33.0,12,5,58,58,2,3,5,51.0,453.0,407,19,17,36,375.0,82,5.34,48,255,2438,9.0
18873,Mike Bullard,1983-84,22.0,4,3,15,15,1,2,3,18.0,,15,1,2,3,18.0,80,7.69,77,340,2441,12.6
18874,Mike Bullard,1984-85,23.0,5,63,75,75,36,27,63,145.0,,90,37,29,66,163.0,80,8.03,73,320,2489,12.9
18875,Mike Bullard,1985-86,24.0,6,44,57,57,22,22,44,149.0,,147,59,51,110,312.0,80,7.73,71,310,2444,12.7
18876,Mike Bullard,1986-87,25.0,7,92,76,76,51,41,92,213.0,,223,110,92,202,525.0,80,7.89,74,336,2448,12.9
18877,Mike Bullard,1987-88,26.0,8,63,68,68,32,31,63,186.0,,291,142,123,265,711.0,80,7.77,71,321,2447,12.7
18878,Mike Bullard,1988-89,27.0,9,83,77,77,41,42,83,216.0,,368,183,165,348,927.0,80,7.94,82,370,2484,12.8
18879,Mike Bullard,1989-90,28.0,10,66,71,71,30,36,66,180.0,,439,213,201,414,1107.0,80,7.34,72,344,2400,12.2
18880,Mike Bullard,1990-91,29.0,11,103,79,79,48,55,103,230.0,,518,261,256,517,1337.0,80,7.43,89,437,2435,12.2
18881,Mike Bullard,1991-92,30.0,12,65,74,74,27,38,65,189.0,,592,288,294,582,1526.0,80,7.48,85,403,2430,12.3
18882,Mike Bullard,1992-93,31.0,13,64,70,70,27,37,64,181.0,,662,315,331,646,1707.0,80,7.37,76,367,2421,12.2
18883,Mike Bullard,1994-95,33.0,14,28,65,65,14,14,28,140.0,,727,329,345,674,1847.0,80,6.96,77,402,2440,11.4
18884,Mike Busniuk,1982-83,31.0,4,20,71,71,2,18,20,56.0,,71,2,18,20,56.0,80,7.03,61,280,2352,12.0
18885,Mike Busniuk,1983-84,32.0,5,6,72,72,1,5,6,33.0,,143,3,23,26,89.0,80,7.69,77,340,2441,12.6
18886,Mike Cammalleri,2005-06,23.0,4,8,28,28,5,3,8,40.0,394.0,28,5,3,8,40.0,82,5.31,60,363,2326,9.4
18887,Mike Cammalleri,2006-07,24.0,5,15,31,31,9,6,15,53.0,412.0,59,14,9,23,93.0,82,5.14,57,348,2300,9.2
18888,Mike Cammalleri,2008-09,26.0,6,55,80,80,26,29,55,206.0,1340.0,139,40,38,78,299.0,82,6.05,85,480,2458,10.1
18889,Mike Cammalleri,2009-10,27.0,7,80,81,81,34,46,80,299.0,1462.0,220,74,84,158,598.0,82,5.76,70,398,2426,9.7
18890,Mike Cammalleri,2010-11,28.0,8,47,63,63,19,28,47,210.0,1170.0,283,93,112,205,808.0,82,5.44,62,351,2383,9.4
18891,Mike Cammalleri,2011-12,29.0,9,82,81,81,39,43,82,255.0,1422.0,364,132,155,287,1063.0,82,5.7,65,341,2477,9.4
18892,Mike Cammalleri,2012-13,30.0,10,50,65,65,26,24,50,218.0,1269.0,429,158,179,337,1281.0,82,5.53,56,304,2486,9.1
18893,Mike Cammalleri,2013-14,31.0,11,47,67,67,19,28,47,193.0,1238.0,496,177,207,384,1474.0,82,5.46,52,291,2492,9.0
18894,Mike Cammalleri,2014-15,32.0,12,41,66,66,20,21,41,175.0,1195.0,562,197,228,425,1649.0,82,5.32,47,271,2439,8.9
18895,Mike Cammalleri,2015-16,33.0,13,32,44,44,13,19,32,102.0,794.0,606,210,247,457,1751.0,48,5.31,29,160,1399,9.1
18896,Mike Cammalleri,2016-17,34.0,14,45,63,63,26,19,45,191.0,1250.0,669,236,266,502,1942.0,82,5.34,48,269,2463,8.9
18897,Mike Cammalleri,2017-18,35.0,15,42,68,68,27,15,42,156.0,1247.0,737,263,281,544,2098.0,82,5.32,47,251,2453,8.9
18898,Mike Cammalleri,2018-19,36.0,16,38,42,42,14,24,38,101.0,810.0,779,277,305,582,2199.0,82,5.34,48,255,2438,9.0
18899,Mike Cammalleri,2019-20,37.0,17,31,61,61,10,21,31,142.0,1059.0,840,287,326,613,2341.0,82,5.45,47,245,2478,9.0
18900,Mike Cammalleri,2020-21,38.0,18,29,66,66,7,22,29,128.0,909.0,906,294,348,642,2469.0,82,5.86,50,250,2620,9.2
18901,Mike Card,2009-10,23.0,4,0,4,4,0,0,0,0.0,18.0,4,0,0,0,0.0,82,5.76,70,398,2426,9.7
18902,Mike Casselman,1998-99,30.0,4,0,3,3,0,0,0,2.0,,3,0,0,0,2.0,82,6.29,74,413,2481,10.4
18903,Mike Commodore,2003-04,24.0,4,5,20,20,1,4,5,11.0,255.0,20,1,4,5,11.0,82,5.51,63,376,2272,9.9
18904,Mike Commodore,2004-05,25.0,5,1,37,37,0,1,1,22.0,467.0,57,1,5,6,33.0,82,5.24,53,338,2262,9.5
18905,Mike Commodore,2005-06,26.0,6,1,6,6,0,1,1,5.0,69.0,63,1,6,7,38.0,82,5.31,60,363,2326,9.4
18906,Mike Commodore,2006-07,27.0,7,0,12,12,0,0,0,10.0,183.0,75,1,6,7,48.0,82,5.14,57,348,2300,9.2
18907,Mike Commodore,2008-09,29.0,8,13,72,72,3,10,13,72.0,1116.0,147,4,16,20,120.0,82,6.05,85,480,2458,10.1
18908,Mike Commodore,2009-10,30.0,9,29,82,82,7,22,29,136.0,1631.0,229,11,38,49,256.0,82,5.76,70,398,2426,9.7
18909,Mike Commodore,2010-11,31.0,10,14,67,67,3,11,14,97.0,1220.0,296,14,49,63,353.0,82,5.44,62,351,2383,9.4
18910,Mike Commodore,2011-12,32.0,11,24,81,81,5,19,24,103.0,1854.0,377,19,68,87,456.0,82,5.7,65,341,2477,9.4
18911,Mike Commodore,2012-13,33.0,12,11,57,57,2,9,11,54.0,1083.0,434,21,77,98,510.0,82,5.53,56,304,2486,9.1
18912,Mike Commodore,2013-14,34.0,13,6,20,20,2,4,6,32.0,371.0,454,23,81,104,542.0,82,5.46,52,291,2492,9.0
18913,Mike Commodore,2014-15,35.0,14,2,30,30,0,2,2,23.0,378.0,484,23,83,106,565.0,82,5.32,47,271,2439,8.9
18914,Mike Comrie,2003-04,23.0,4,22,41,41,8,14,22,62.0,467.0,41,8,14,22,62.0,82,5.51,63,376,2272,9.9
18915,Mike Comrie,2004-05,24.0,5,60,82,82,33,27,60,170.0,1437.0,123,41,41,82,232.0,82,5.24,53,338,2262,9.5
18916,Mike Comrie,2005-06,25.0,6,51,69,69,20,31,51,170.0,1232.0,192,61,72,133,402.0,82,5.31,60,363,2326,9.4
18917,Mike Comrie,2006-07,26.0,7,24,49,49,12,12,24,101.0,769.0,241,73,84,157,503.0,82,5.14,57,348,2300,9.2
18918,Mike Comrie,2008-09,28.0,8,60,80,80,30,30,60,190.0,1282.0,321,103,114,217,693.0,82,6.05,85,480,2458,10.1
18919,Mike Comrie,2009-10,29.0,9,45,65,65,20,25,45,125.0,991.0,386,123,139,262,818.0,82,5.76,70,398,2426,9.7
18920,Mike Comrie,2010-11,30.0,10,49,76,76,21,28,49,194.0,1458.0,462,144,167,311,1012.0,82,5.44,62,351,2383,9.4
18921,Mike Comrie,2011-12,31.0,11,27,63,63,10,17,27,121.0,989.0,525,154,184,338,1133.0,82,5.7,65,341,2477,9.4
18922,Mike Comrie,2012-13,32.0,12,21,43,43,13,8,21,97.0,612.0,568,167,192,359,1230.0,82,5.53,56,304,2486,9.1
18923,Mike Comrie,2013-14,33.0,13,6,21,21,1,5,6,25.0,248.0,589,168,197,365,1255.0,82,5.46,52,291,2492,9.0
18924,Mike Connolly,2014-15,25.0,4,0,2,2,0,0,0,1.0,25.0,2,0,0,0,1.0,82,5.32,47,271,2439,8.9
18925,Mike Craig,1993-94,22.0,4,12,39,39,8,4,12,59.0,,39,8,4,12,59.0,80,6.91,71,366,2385,11.6
18926,Mike Craig,1994-95,23.0,5,31,67,67,15,16,31,136.0,,106,23,20,43,195.0,80,6.96,77,402,2440,11.4
18927,Mike Craig,1995-96,24.0,6,38,70,70,15,23,38,131.0,,176,38,43,81,326.0,84,7.25,87,443,2603,11.7
18928,Mike Craig,1996-97,25.0,7,37,72,72,13,24,37,150.0,,248,51,67,118,476.0,84,6.48,76,407,2545,10.7
18929,Mike Craig,1997-98,26.0,8,10,37,37,5,5,10,61.0,,285,56,72,128,537.0,48,5.97,37,209,1408,10.2
18930,Mike Craig,1998-99,27.0,9,20,70,70,8,12,20,108.0,,355,64,84,148,645.0,82,6.29,74,413,2481,10.4
18931,Mike Craig,1999-00,28.0,10,20,65,65,7,13,20,128.0,,420,71,97,168,773.0,82,5.83,55,336,2444,9.8
18932,Mike Craig,2001-02,30.0,11,0,1,1,0,0,0,1.0,11.0,421,71,97,168,774.0,82,5.27,57,359,2285,9.4
18933,Mike Craig,2004-05,33.0,12,0,2,2,0,0,0,2.0,16.0,423,71,97,168,776.0,82,5.24,53,338,2262,9.5
18934,Mike Crowley,2000-01,25.0,4,4,8,8,2,2,4,17.0,,8,2,2,4,17.0,82,5.28,57,380,2242,9.6
18935,Mike Crowley,2001-02,26.0,5,5,20,20,2,3,5,41.0,332.0,28,4,5,9,58.0,82,5.27,57,359,2285,9.4
18936,Mike Crowley,2003-04,28.0,6,11,39,39,1,10,11,45.0,677.0,67,5,15,20,103.0,82,5.51,63,376,2272,9.9
18937,Mike Danton,2003-04,23.0,4,0,2,2,0,0,0,3.0,16.0,2,0,0,0,3.0,82,5.51,63,376,2272,9.9
18938,Mike Danton,2005-06,25.0,5,2,17,17,2,0,2,18.0,153.0,19,2,0,2,21.0,82,5.31,60,363,2326,9.4
18939,Mike Danton,2006-07,26.0,6,12,68,68,7,5,12,72.0,812.0,87,9,5,14,93.0,82,5.14,57,348,2300,9.2
18940,Mike Donnelly,1989-90,26.0,4,2,5,5,1,1,2,5.0,,5,1,1,2,5.0,80,7.34,72,344,2400,12.2
18941,Mike Donnelly,1990-91,27.0,5,18,57,57,8,10,18,99.0,,62,9,11,20,104.0,80,7.43,89,437,2435,12.2
18942,Mike Donnelly,1991-92,28.0,6,10,22,22,4,6,10,25.0,,84,13,17,30,129.0,80,7.48,85,403,2430,12.3
18943,Mike Donnelly,1992-93,29.0,7,3,12,12,1,2,3,20.0,,96,14,19,33,149.0,80,7.37,76,367,2421,12.2
18944,Mike Donnelly,1993-94,30.0,8,12,53,53,7,5,12,76.0,,149,21,24,45,225.0,80,6.91,71,366,2385,11.6
18945,Mike Donnelly,1994-95,31.0,9,45,80,80,29,16,45,197.0,,229,50,40,90,422.0,80,6.96,77,402,2440,11.4
18946,Mike Donnelly,1995-96,32.0,10,69,84,84,29,40,69,244.0,,313,79,80,159,666.0,84,7.25,87,443,2603,11.7
18947,Mike Donnelly,1996-97,33.0,11,42,81,81,21,21,42,177.0,,394,100,101,201,843.0,84,6.48,76,407,2545,10.7
18948,Mike Donnelly,1997-98,34.0,12,27,44,44,12,15,27,116.0,,438,112,116,228,959.0,48,5.97,37,209,1408,10.2
18949,Mike Donnelly,1998-99,35.0,13,7,24,24,2,5,7,21.0,,462,114,121,235,980.0,82,6.29,74,413,2481,10.4
18950,Mike Donnelly,1999-00,36.0,14,0,3,3,0,0,0,5.0,,465,114,121,235,985.0,82,5.83,55,336,2444,9.8
18951,Mike Duco,2012-13,25.0,4,0,10,10,0,0,0,6.0,77.0,10,0,0,0,6.0,82,5.53,56,304,2486,9.1
18952,Mike Duco,2013-14,26.0,5,0,2,2,0,0,0,0.0,17.0,12,0,0,0,6.0,82,5.46,52,291,2492,9.0
18953,Mike Duco,2014-15,27.0,6,2,6,6,0,2,2,4.0,48.0,18,0,2,2,10.0,82,5.32,47,271,2439,8.9
18954,Mike Eagles,1985-86,22.0,4,0,2,2,0,0,0,1.0,,2,0,0,0,1.0,80,7.73,71,310,2444,12.7
18955,Mike Eagles,1988-89,25.0,5,23,73,73,11,12,23,69.0,,75,11,12,23,70.0,80,7.94,82,370,2484,12.8
18956,Mike Eagles,1989-90,26.0,6,32,73,73,13,19,32,95.0,,148,24,31,55,165.0,80,7.34,72,344,2400,12.2
18957,Mike Eagles,1990-91,27.0,7,20,76,76,10,10,20,89.0,,224,34,41,75,254.0,80,7.43,89,437,2435,12.2
18958,Mike Eagles,1991-92,28.0,8,16,47,47,5,11,16,39.0,,271,39,52,91,293.0,80,7.48,85,403,2430,12.3
18959,Mike Eagles,1992-93,29.0,9,3,23,23,1,2,3,23.0,,294,40,54,94,316.0,80,7.37,76,367,2421,12.2
18960,Mike Eagles,1993-94,30.0,10,9,44,44,0,9,9,51.0,,338,40,63,103,367.0,80,6.91,71,366,2385,11.6
18961,Mike Eagles,1994-95,31.0,11,17,65,65,7,10,17,60.0,,403,47,73,120,427.0,80,6.96,77,402,2440,11.4
18962,Mike Eagles,1995-96,32.0,12,26,84,84,8,18,26,67.0,,487,55,91,146,494.0,84,7.25,87,443,2603,11.7
18963,Mike Eagles,1996-97,33.0,13,12,73,73,4,8,12,53.0,,560,59,99,158,547.0,84,6.48,76,407,2545,10.7
18964,Mike Eagles,1997-98,34.0,14,7,40,40,3,4,7,28.0,,600,62,103,165,575.0,48,5.97,37,209,1408,10.2
18965,Mike Eagles,1998-99,35.0,15,11,70,70,4,7,11,70.0,,670,66,110,176,645.0,82,6.29,74,413,2481,10.4
18966,Mike Eagles,1999-00,36.0,16,8,70,70,1,7,8,38.0,,740,67,117,184,683.0,82,5.83,55,336,2444,9.8
18967,Mike Eagles,2000-01,37.0,17,4,36,36,1,3,4,25.0,,776,68,120,188,708.0,82,5.28,57,380,2242,9.6
18968,Mike Eagles,2001-02,38.0,18,6,52,52,4,2,6,41.0,497.0,828,72,122,194,749.0,82,5.27,57,359,2285,9.4
18969,Mike Eagles,2002-03,39.0,19,2,25,25,2,0,2,13.0,190.0,853,74,122,196,762.0,82,5.49,53,331,2294,9.8
18970,Mike Eastwood,1994-95,27.0,4,2,9,9,0,2,2,6.0,,9,0,2,2,6.0,80,6.96,77,402,2440,11.4
18971,Mike Eastwood,1995-96,28.0,5,7,12,12,1,6,7,11.0,,21,1,8,9,17.0,84,7.25,87,443,2603,11.7
18972,Mike Eastwood,1996-97,29.0,6,18,54,54,8,10,18,41.0,,75,9,18,27,58.0,84,6.48,76,407,2545,10.7
18973,Mike Eastwood,1997-98,30.0,7,19,49,49,8,11,19,55.0,,124,17,29,46,113.0,48,5.97,37,209,1408,10.2
18974,Mike Eastwood,1998-99,31.0,8,28,80,80,14,14,28,94.0,,204,31,43,74,207.0,82,6.29,74,413,2481,10.4
18975,Mike Eastwood,1999-00,32.0,9,12,60,60,2,10,12,44.0,,264,33,53,86,251.0,82,5.83,55,336,2444,9.8
18976,Mike Eastwood,2000-01,33.0,10,11,58,58,6,5,11,38.0,,322,39,58,97,289.0,82,5.28,57,380,2242,9.6
18977,Mike Eastwood,2001-02,34.0,11,30,82,82,9,21,30,76.0,1229.0,404,48,79,127,365.0,82,5.27,57,359,2285,9.4
18978,Mike Eastwood,2002-03,35.0,12,34,79,79,19,15,34,83.0,1196.0,483,67,94,161,448.0,82,5.49,53,331,2294,9.8
18979,Mike Eastwood,2003-04,36.0,13,23,77,77,6,17,23,51.0,1089.0,560,73,111,184,499.0,82,5.51,63,376,2272,9.9
18980,Mike Eastwood,2004-05,37.0,14,17,71,71,7,10,17,60.0,917.0,631,80,121,201,559.0,82,5.24,53,338,2262,9.5
18981,Mike Eastwood,2005-06,38.0,15,16,70,70,3,13,16,39.0,867.0,701,83,134,217,598.0,82,5.31,60,363,2326,9.4
18982,Mike Eastwood,2006-07,39.0,16,19,82,82,4,15,19,55.0,1160.0,783,87,149,236,653.0,82,5.14,57,348,2300,9.2
18983,Mike Farrell,2004-05,26.0,4,0,8,8,0,0,0,1.0,45.0,8,0,0,0,1.0,82,5.24,53,338,2262,9.5
18984,Mike Farrell,2005-06,27.0,5,0,4,4,0,0,0,2.0,11.0,12,0,0,0,3.0,82,5.31,60,363,2326,9.4
18985,Mike Farrell,2006-07,28.0,6,0,1,1,0,0,0,0.0,5.0,13,0,0,0,3.0,82,5.14,57,348,2300,9.2
18986,Mike Fisher,2002-03,22.0,4,9,32,32,4,5,9,49.0,414.0,32,4,5,9,49.0,82,5.49,53,331,2294,9.8
18987,Mike Fisher,2003-04,23.0,5,19,60,60,7,12,19,83.0,698.0,92,11,17,28,132.0,82,5.51,63,376,2272,9.9
18988,Mike Fisher,2004-05,24.0,6,24,58,58,15,9,24,123.0,817.0,150,26,26,52,255.0,82,5.24,53,338,2262,9.5
18989,Mike Fisher,2005-06,25.0,7,38,74,74,18,20,38,142.0,1183.0,224,44,46,90,397.0,82,5.31,60,363,2326,9.4
18990,Mike Fisher,2006-07,26.0,8,10,24,24,4,6,10,47.0,418.0,248,48,52,100,444.0,82,5.14,57,348,2300,9.2
18991,Mike Fisher,2008-09,28.0,9,44,68,68,22,22,44,150.0,1166.0,316,70,74,144,594.0,82,6.05,85,480,2458,10.1
18992,Mike Fisher,2009-10,29.0,10,48,68,68,22,26,48,193.0,1253.0,384,92,100,192,787.0,82,5.76,70,398,2426,9.7
18993,Mike Fisher,2010-11,30.0,11,47,79,79,23,24,47,215.0,1561.0,463,115,124,239,1002.0,82,5.44,62,351,2383,9.4
18994,Mike Fisher,2011-12,31.0,12,32,78,78,13,19,32,182.0,1443.0,541,128,143,271,1184.0,82,5.7,65,341,2477,9.4
18995,Mike Fisher,2012-13,32.0,13,53,79,79,25,28,53,212.0,1498.0,620,153,171,324,1396.0,82,5.53,56,304,2486,9.1
18996,Mike Fisher,2013-14,33.0,14,36,82,82,19,17,36,192.0,1506.0,702,172,188,360,1588.0,82,5.46,52,291,2492,9.0
18997,Mike Fisher,2014-15,34.0,15,51,72,72,24,27,51,157.0,1389.0,774,196,215,411,1745.0,82,5.32,47,271,2439,8.9
18998,Mike Fisher,2015-16,35.0,16,21,38,38,10,11,21,68.0,740.0,812,206,226,432,1813.0,48,5.31,29,160,1399,9.1
18999,Mike Fisher,2016-17,36.0,17,49,75,75,20,29,49,177.0,1482.0,887,226,255,481,1990.0,82,5.34,48,269,2463,8.9
19000,Mike Fisher,2017-18,37.0,18,39,59,59,19,20,39,111.0,1088.0,946,245,275,520,2101.0,82,5.32,47,251,2453,8.9
19001,Mike Fisher,2018-19,38.0,19,23,70,70,13,10,23,98.0,1201.0,1016,258,285,543,2199.0,82,5.34,48,255,2438,9.0
19002,Mike Fisher,2019-20,39.0,20,42,72,72,18,24,42,120.0,1196.0,1088,276,309,585,2319.0,82,5.45,47,245,2478,9.0
19003,Mike Fisher,2020-21,40.0,21,4,16,16,2,2,4,14.0,198.0,1104,278,311,589,2333.0,82,5.86,50,250,2620,9.2
19004,Mike Foligno,1982-83,24.0,4,71,80,80,36,35,71,196.0,,80,36,35,71,196.0,80,7.03,61,280,2352,12.0
19005,Mike Foligno,1983-84,25.0,5,63,80,80,28,35,63,181.0,,160,64,70,134,377.0,80,7.69,77,340,2441,12.6
19006,Mike Foligno,1984-85,26.0,6,77,82,82,33,44,77,194.0,,242,97,114,211,571.0,80,8.03,73,320,2489,12.9
19007,Mike Foligno,1985-86,27.0,7,47,66,66,22,25,47,132.0,,308,119,139,258,703.0,80,7.73,71,310,2444,12.7
19008,Mike Foligno,1986-87,28.0,8,63,70,70,32,31,63,183.0,,378,151,170,321,886.0,80,7.89,74,336,2448,12.9
19009,Mike Foligno,1987-88,29.0,9,56,77,77,27,29,56,167.0,,455,178,199,377,1053.0,80,7.77,71,321,2447,12.7
19010,Mike Foligno,1988-89,30.0,10,80,79,79,41,39,80,222.0,,534,219,238,457,1275.0,80,7.94,82,370,2484,12.8
19011,Mike Foligno,1989-90,31.0,11,59,75,75,30,29,59,185.0,,609,249,267,516,1460.0,80,7.34,72,344,2400,12.2
19012,Mike Foligno,1990-91,32.0,12,57,74,74,29,28,57,159.0,,683,278,295,573,1619.0,80,7.43,89,437,2435,12.2
19013,Mike Foligno,1991-92,33.0,13,49,75,75,27,22,49,144.0,,758,305,317,622,1763.0,80,7.48,85,403,2430,12.3
19014,Mike Foligno,1992-93,34.0,14,40,61,61,15,25,40,107.0,,819,320,342,662,1870.0,80,7.37,76,367,2421,12.2
19015,Mike Foligno,1993-94,35.0,15,24,68,68,12,12,24,83.0,,887,332,354,686,1953.0,80,6.91,71,366,2385,11.6
19016,Mike Foligno,1994-95,36.0,16,14,33,33,6,8,14,41.0,,920,338,362,700,1994.0,80,6.96,77,402,2440,11.4
19017,Mike Foligno,1995-96,37.0,17,18,55,55,13,5,18,95.0,,975,351,367,718,2089.0,84,7.25,87,443,2603,11.7
19018,Mike Foligno,1996-97,38.0,18,9,43,43,4,5,9,35.0,,1018,355,372,727,2124.0,84,6.48,76,407,2545,10.7
19019,Mike Gartner,1982-83,23.0,4,68,77,77,36,32,68,226.0,,77,36,32,68,226.0,80,7.03,61,280,2352,12.0
19020,Mike Gartner,1983-84,24.0,5,94,80,80,48,46,94,326.0,,157,84,78,162,552.0,80,7.69,77,340,2441,12.6
19021,Mike Gartner,1984-85,25.0,6,80,80,80,35,45,80,301.0,,237,119,123,242,853.0,80,8.03,73,320,2489,12.9
19022,Mike Gartner,1985-86,26.0,7,76,73,73,38,38,76,269.0,,310,157,161,318,1122.0,80,7.73,71,310,2444,12.7
19023,Mike Gartner,1986-87,27.0,8,85,80,80,40,45,85,286.0,,390,197,206,403,1408.0,80,7.89,74,336,2448,12.9
19024,Mike Gartner,1987-88,28.0,9,102,80,80,50,52,102,331.0,,470,247,258,505,1739.0,80,7.77,71,321,2447,12.7
19025,Mike Gartner,1988-89,29.0,10,75,74,74,35,40,75,279.0,,544,282,298,580,2018.0,80,7.94,82,370,2484,12.8
19026,Mike Gartner,1989-90,30.0,11,73,78,78,41,32,73,317.0,,622,323,330,653,2335.0,80,7.34,72,344,2400,12.2
19027,Mike Gartner,1990-91,31.0,12,81,80,80,48,33,81,316.0,,702,371,363,734,2651.0,80,7.43,89,437,2435,12.2
19028,Mike Gartner,1991-92,32.0,13,69,69,69,33,36,69,223.0,,771,404,399,803,2874.0,80,7.48,85,403,2430,12.3
19029,Mike Gartner,1992-93,33.0,14,86,79,79,45,41,86,288.0,,850,449,440,889,3162.0,80,7.37,76,367,2421,12.2
19030,Mike Gartner,1993-94,34.0,15,69,79,79,49,20,69,262.0,,929,498,460,958,3424.0,80,6.91,71,366,2385,11.6
19031,Mike Gartner,1994-95,35.0,16,81,76,76,40,41,81,286.0,,1005,538,501,1039,3710.0,80,6.96,77,402,2440,11.4
19032,Mike Gartner,1995-96,36.0,17,68,84,84,45,23,68,323.0,,1089,583,524,1107,4033.0,84,7.25,87,443,2603,11.7
19033,Mike Gartner,1996-97,37.0,18,64,81,81,34,30,64,275.0,,1170,617,554,1171,4308.0,84,6.48,76,407,2545,10.7
19034,Mike Gartner,1997-98,38.0,19,20,38,38,12,8,20,91.0,,1208,629,562,1191,4399.0,48,5.97,37,209,1408,10.2
19035,Mike Gartner,1998-99,39.0,20,54,82,82,35,19,54,275.0,,1290,664,581,1245,4674.0,82,6.29,74,413,2481,10.4
19036,Mike Gartner,1999-00,40.0,21,63,82,82,32,31,63,271.0,,1372,696,612,1308,4945.0,82,5.83,55,336,2444,9.8
19037,Mike Gartner,2000-01,41.0,22,27,60,60,12,15,27,145.0,,1432,708,627,1335,5090.0,82,5.28,57,380,2242,9.6
19038,Mike Gaul,2001-02,28.0,4,0,1,1,0,0,0,1.0,11.0,1,0,0,0,1.0,82,5.27,57,359,2285,9.4
19039,Mike Gaul,2003-04,30.0,5,0,2,2,0,0,0,3.0,27.0,3,0,0,0,4.0,82,5.51,63,376,2272,9.9
19040,Mike Glumac,2008-09,28.0,4,12,33,33,7,5,12,55.0,410.0,33,7,5,12,55.0,82,6.05,85,480,2458,10.1
19041,Mike Glumac,2009-10,29.0,5,1,3,3,0,1,1,4.0,25.0,36,7,6,13,59.0,82,5.76,70,398,2426,9.7
19042,Mike Glumac,2010-11,30.0,6,0,4,4,0,0,0,3.0,41.0,40,7,6,13,62.0,82,5.44,62,351,2383,9.4
19043,Mike Green,2006-07,27.0,4,4,24,24,1,3,4,20.0,219.0,24,1,3,4,20.0,82,5.14,57,348,2300,9.2
19044,Mike Green0,2008-09,23.0,4,3,22,22,1,2,3,13.0,328.0,22,1,2,3,13.0,82,6.05,85,480,2458,10.1
19045,Mike Green0,2009-10,24.0,5,12,70,70,2,10,12,68.0,1084.0,92,3,12,15,81.0,82,5.76,70,398,2426,9.7
19046,Mike Green0,2010-11,25.0,6,56,82,82,18,38,56,234.0,1938.0,174,21,50,71,315.0,82,5.44,62,351,2383,9.4
19047,Mike Green0,2011-12,26.0,7,73,68,68,31,42,73,243.0,1752.0,242,52,92,144,558.0,82,5.7,65,341,2477,9.4
19048,Mike Green0,2012-13,27.0,8,76,75,75,19,57,76,205.0,1911.0,317,71,149,220,763.0,82,5.53,56,304,2486,9.1
19049,Mike Green0,2013-14,28.0,9,24,49,49,8,16,24,115.0,1234.0,366,79,165,244,878.0,82,5.46,52,291,2492,9.0
19050,Mike Green0,2014-15,29.0,10,7,32,32,3,4,7,64.0,673.0,398,82,169,251,942.0,82,5.32,47,271,2439,8.9
19051,Mike Green0,2015-16,30.0,11,26,35,35,12,14,26,96.0,870.0,433,94,183,277,1038.0,48,5.31,29,160,1399,9.1
19052,Mike Green0,2016-17,31.0,12,38,70,70,9,29,38,172.0,1591.0,503,103,212,315,1210.0,82,5.34,48,269,2463,8.9
19053,Mike Green0,2017-18,32.0,13,45,72,72,10,35,45,159.0,1376.0,575,113,247,360,1369.0,82,5.32,47,251,2453,8.9
19054,Mike Green0,2018-19,33.0,14,35,74,74,7,28,35,124.0,1463.0,649,120,275,395,1493.0,82,5.34,48,255,2438,9.0
19055,Mike Green0,2019-20,34.0,15,36,72,72,14,22,36,125.0,1696.0,721,134,297,431,1618.0,82,5.45,47,245,2478,9.0
19056,Mike Green0,2020-21,35.0,16,33,66,66,8,25,33,132.0,1457.0,787,142,322,464,1750.0,82,5.86,50,250,2620,9.2
19057,Mike Green0,2021-22,36.0,17,26,43,43,5,21,26,92.0,932.0,830,147,343,490,1842.0,82,5.96,47,239,2579,9.5
19058,Mike Green0,2022-23,37.0,18,11,50,50,3,8,11,76.0,1044.0,880,150,351,501,1918.0,70,5.96,42,208,2192,9.5
19059,Mike Grier,1999-00,25.0,4,32,79,79,15,17,32,89.0,,79,15,17,32,89.0,82,5.83,55,336,2444,9.8
19060,Mike Grier,2000-01,26.0,5,15,66,66,9,6,15,90.0,,145,24,23,47,179.0,82,5.28,57,380,2242,9.6
19061,Mike Grier,2001-02,27.0,6,44,82,82,20,24,44,143.0,1308.0,227,44,47,91,322.0,82,5.27,57,359,2285,9.4
19062,Mike Grier,2002-03,28.0,7,31,65,65,9,22,31,115.0,1024.0,292,53,69,122,437.0,82,5.49,53,331,2294,9.8
19063,Mike Grier,2003-04,29.0,8,36,74,74,20,16,36,124.0,1239.0,366,73,85,158,561.0,82,5.51,63,376,2272,9.9
19064,Mike Grier,2004-05,30.0,9,25,82,82,8,17,25,112.0,1232.0,448,81,102,183,673.0,82,5.24,53,338,2262,9.5
19065,Mike Grier,2005-06,31.0,10,32,82,82,15,17,32,133.0,1459.0,530,96,119,215,806.0,82,5.31,60,363,2326,9.4
19066,Mike Grier,2006-07,32.0,11,29,82,82,9,20,29,133.0,1430.0,612,105,139,244,939.0,82,5.14,57,348,2300,9.2
19067,Mike Grier,2008-09,34.0,12,23,81,81,7,16,23,109.0,1164.0,693,112,155,267,1048.0,82,6.05,85,480,2458,10.1
19068,Mike Grier,2009-10,35.0,13,33,81,81,16,17,33,125.0,1332.0,774,128,172,300,1173.0,82,5.76,70,398,2426,9.7
19069,Mike Grier,2010-11,36.0,14,22,78,78,9,13,22,132.0,1264.0,852,137,185,322,1305.0,82,5.44,62,351,2383,9.4
19070,Mike Grier,2011-12,37.0,15,23,62,62,10,13,23,108.0,930.0,914,147,198,345,1413.0,82,5.7,65,341,2477,9.4
19071,Mike Grier,2012-13,38.0,16,22,73,73,10,12,22,123.0,1153.0,987,157,210,367,1536.0,82,5.53,56,304,2486,9.1
19072,Mike Grier,2013-14,39.0,17,16,73,73,5,11,16,107.0,1051.0,1060,162,221,383,1643.0,82,5.46,52,291,2492,9.0
19073,Mike Halmo,2016-17,25.0,4,1,20,20,1,0,1,25.0,190.0,20,1,0,1,25.0,82,5.34,48,269,2463,8.9
19074,Mike Hartman,1989-90,22.0,4,6,17,17,3,3,6,19.0,,17,3,3,6,19.0,80,7.34,72,344,2400,12.2
19075,Mike Hartman,1990-91,23.0,5,4,18,18,3,1,4,24.0,,35,6,4,10,43.0,80,7.43,89,437,2435,12.2
19076,Mike Hartman,1991-92,24.0,6,17,70,70,8,9,17,91.0,,105,14,13,27,134.0,80,7.48,85,403,2430,12.3
19077,Mike Hartman,1992-93,25.0,7,21,60,60,11,10,21,97.0,,165,25,23,48,231.0,80,7.37,76,367,2421,12.2
19078,Mike Hartman,1993-94,26.0,8,12,60,60,9,3,12,65.0,,225,34,26,60,296.0,80,6.91,71,366,2385,11.6
19079,Mike Hartman,1994-95,27.0,9,8,75,75,4,4,8,89.0,,300,38,30,68,385.0,80,6.96,77,402,2440,11.4
19080,Mike Hartman,1995-96,28.0,10,8,61,61,4,4,8,77.0,,361,42,34,76,462.0,84,7.25,87,443,2603,11.7
19081,Mike Hartman,1996-97,29.0,11,2,35,35,1,1,2,19.0,,396,43,35,78,481.0,84,6.48,76,407,2545,10.7
19082,Mike Hartman,1997-98,30.0,12,0,1,1,0,0,0,0.0,,397,43,35,78,481.0,48,5.97,37,209,1408,10.2
19083,Mike Heidt,1986-87,23.0,4,1,6,6,0,1,1,1.0,,6,0,1,1,1.0,80,7.89,74,336,2448,12.9
19084,Mike Hoffman,1985-86,22.0,4,1,2,2,0,1,1,2.0,,2,0,1,1,2.0,80,7.73,71,310,2444,12.7
19085,Mike Hoffman,1987-88,24.0,5,0,1,1,0,0,0,0.0,,3,0,1,1,2.0,80,7.77,71,321,2447,12.7
19086,Mike Hoffman,1988-89,25.0,6,3,6,6,1,2,3,7.0,,9,1,3,4,9.0,80,7.94,82,370,2484,12.8
19087,Mike Hoffman0,2014-15,25.0,4,0,1,1,0,0,0,0.0,9.0,1,0,0,0,0.0,82,5.32,47,271,2439,8.9
19088,Mike Hoffman0,2015-16,26.0,5,0,3,3,0,0,0,6.0,37.0,4,0,0,0,6.0,48,5.31,29,160,1399,9.1
19089,Mike Hoffman0,2016-17,27.0,6,6,25,25,3,3,6,61.0,330.0,29,3,3,6,67.0,82,5.34,48,269,2463,8.9
19090,Mike Hoffman0,2017-18,28.0,7,48,79,79,27,21,48,199.0,1150.0,108,30,24,54,266.0,82,5.32,47,251,2453,8.9
19091,Mike Hoffman0,2018-19,29.0,8,59,78,78,29,30,59,242.0,1368.0,186,59,54,113,508.0,82,5.34,48,255,2438,9.0
19092,Mike Hoffman0,2019-20,30.0,9,61,74,74,26,35,61,224.0,1302.0,260,85,89,174,732.0,82,5.45,47,245,2478,9.0
19093,Mike Hoffman0,2020-21,31.0,10,56,82,82,22,34,56,257.0,1509.0,342,107,123,230,989.0,82,5.86,50,250,2620,9.2
19094,Mike Hoffman0,2021-22,32.0,11,70,82,82,36,34,70,253.0,1463.0,424,143,157,300,1242.0,82,5.96,47,239,2579,9.5
19095,Mike Hoffman0,2022-23,33.0,12,59,69,69,29,30,59,214.0,1162.0,493,172,187,359,1456.0,70,5.96,42,208,2192,9.5
19096,Mike Hough,1989-90,26.0,4,14,56,56,6,8,14,60.0,,56,6,8,14,60.0,80,7.34,72,344,2400,12.2
19097,Mike Hough,1990-91,27.0,5,5,17,17,3,2,5,23.0,,73,9,10,19,83.0,80,7.43,89,437,2435,12.2
19098,Mike Hough,1991-92,28.0,6,19,46,46,9,10,19,51.0,,119,18,20,38,134.0,80,7.48,85,403,2430,12.3
19099,Mike Hough,1992-93,29.0,7,26,43,43,13,13,26,93.0,,162,31,33,64,227.0,80,7.37,76,367,2421,12.2
19100,Mike Hough,1993-94,30.0,8,33,63,63,13,20,33,106.0,,225,44,53,97,333.0,80,6.91,71,366,2385,11.6
19101,Mike Hough,1994-95,31.0,9,38,61,61,16,22,38,92.0,,286,60,75,135,425.0,80,6.96,77,402,2440,11.4
19102,Mike Hough,1995-96,32.0,10,30,77,77,8,22,30,98.0,,363,68,97,165,523.0,84,7.25,87,443,2603,11.7
19103,Mike Hough,1996-97,33.0,11,29,78,78,6,23,29,106.0,,441,74,120,194,629.0,84,6.48,76,407,2545,10.7
19104,Mike Hough,1997-98,34.0,12,13,48,48,6,7,13,58.0,,489,80,127,207,687.0,48,5.97,37,209,1408,10.2
19105,Mike Hough,1998-99,35.0,13,23,64,64,7,16,23,66.0,,553,87,143,230,753.0,82,6.29,74,413,2481,10.4
19106,Mike Hough,1999-00,36.0,14,14,69,69,8,6,14,85.0,,622,95,149,244,838.0,82,5.83,55,336,2444,9.8
19107,Mike Hough,2000-01,37.0,15,12,74,74,5,7,12,44.0,,696,100,156,256,882.0,82,5.28,57,380,2242,9.6
19108,Mike Hough,2001-02,38.0,16,0,11,11,0,0,0,4.0,92.0,707,100,156,256,886.0,82,5.27,57,359,2285,9.4
19109,Mike Hudson,1991-92,24.0,4,23,41,41,7,16,23,45.0,,41,7,16,23,45.0,80,7.48,85,403,2430,12.3
19110,Mike Hudson,1992-93,25.0,5,21,49,49,9,12,21,51.0,,90,16,28,44,96.0,80,7.37,76,367,2421,12.2
19111,Mike Hudson,1993-94,26.0,6,16,55,55,7,9,16,53.0,,145,23,37,60,149.0,80,6.91,71,366,2385,11.6
19112,Mike Hudson,1994-95,27.0,7,29,76,76,14,15,29,97.0,,221,37,52,89,246.0,80,6.96,77,402,2440,11.4
19113,Mike Hudson,1995-96,28.0,8,8,41,41,1,7,8,35.0,,262,38,59,97,281.0,84,7.25,87,443,2603,11.7
19114,Mike Hudson,1996-97,29.0,9,11,48,48,4,7,11,48.0,,310,42,66,108,329.0,84,6.48,76,407,2545,10.7
19115,Mike Hudson,1997-98,30.0,10,11,40,40,2,9,11,33.0,,350,44,75,119,362.0,48,5.97,37,209,1408,10.2
19116,Mike Hudson,1998-99,31.0,11,17,59,59,5,12,17,59.0,,409,49,87,136,421.0,82,6.29,74,413,2481,10.4
19117,Mike Hudson,1999-00,32.0,12,0,7,7,0,0,0,9.0,,416,49,87,136,430.0,82,5.83,55,336,2444,9.8
19118,Mike Hurlbut,1995-96,29.0,4,9,23,23,1,8,9,26.0,,23,1,8,9,26.0,84,7.25,87,443,2603,11.7
19119,Mike Hurlbut,1996-97,30.0,5,0,1,1,0,0,0,1.0,,24,1,8,9,27.0,84,6.48,76,407,2545,10.7
19120,Mike Hurlbut,2000-01,34.0,6,0,3,3,0,0,0,3.0,,27,1,8,9,30.0,82,5.28,57,380,2242,9.6
19121,Mike Hurlbut,2001-02,35.0,7,0,1,1,0,0,0,2.0,18.0,28,1,8,9,32.0,82,5.27,57,359,2285,9.4
19122,Mike Hurlbut,2002-03,36.0,8,0,1,1,0,0,0,1.0,12.0,29,1,8,9,33.0,82,5.49,53,331,2294,9.8
19123,Mike Iggulden,2010-11,28.0,4,0,1,1,0,0,0,1.0,7.0,1,0,0,0,1.0,82,5.44,62,351,2383,9.4
19124,Mike Iggulden,2011-12,29.0,5,5,11,11,1,4,5,16.0,133.0,12,1,4,5,17.0,82,5.7,65,341,2477,9.4
19125,Mike Johnson,1999-00,25.0,4,4,13,13,2,2,4,27.0,,13,2,2,4,27.0,82,5.83,55,336,2444,9.8
19126,Mike Johnson,2000-01,26.0,5,47,82,82,15,32,47,143.0,,95,17,34,51,170.0,82,5.28,57,380,2242,9.6
19127,Mike Johnson,2001-02,27.0,6,44,79,79,20,24,44,149.0,1285.0,174,37,58,95,319.0,82,5.27,57,359,2285,9.4
19128,Mike Johnson,2002-03,28.0,7,47,80,80,21,26,47,132.0,1375.0,254,58,84,142,451.0,82,5.49,53,331,2294,9.8
19129,Mike Johnson,2003-04,29.0,8,43,76,76,13,30,43,124.0,1313.0,330,71,114,185,575.0,82,5.51,63,376,2272,9.9
19130,Mike Johnson,2004-05,30.0,9,27,57,57,5,22,27,73.0,901.0,387,76,136,212,648.0,82,5.24,53,338,2262,9.5
19131,Mike Johnson,2005-06,31.0,10,63,82,82,23,40,63,178.0,1611.0,469,99,176,275,826.0,82,5.31,60,363,2326,9.4
19132,Mike Johnson,2006-07,32.0,11,10,11,11,1,9,10,17.0,218.0,480,100,185,285,843.0,82,5.14,57,348,2300,9.2
19133,Mike Johnson,2008-09,34.0,12,54,80,80,16,38,54,145.0,1326.0,560,116,223,339,988.0,82,6.05,85,480,2458,10.1
19134,Mike Johnson,2009-10,35.0,13,31,80,80,11,20,31,131.0,1231.0,640,127,243,370,1119.0,82,5.76,70,398,2426,9.7
19135,Mike Johnson,2010-11,36.0,14,5,21,21,2,3,5,21.0,273.0,661,129,246,375,1140.0,82,5.44,62,351,2383,9.4
19136,Mike Keane,1991-92,24.0,4,35,69,69,16,19,35,90.0,,69,16,19,35,90.0,80,7.48,85,403,2430,12.3
19137,Mike Keane,1992-93,25.0,5,24,74,74,9,15,24,92.0,,143,25,34,59,182.0,80,7.37,76,367,2421,12.2
19138,Mike Keane,1993-94,26.0,6,36,73,73,13,23,36,109.0,,216,38,57,95,291.0,80,6.91,71,366,2385,11.6
19139,Mike Keane,1994-95,27.0,7,41,67,67,11,30,41,116.0,,283,49,87,136,407.0,80,6.96,77,402,2440,11.4
19140,Mike Keane,1995-96,28.0,8,60,77,77,15,45,60,120.0,,360,64,132,196,527.0,84,7.25,87,443,2603,11.7
19141,Mike Keane,1996-97,29.0,9,46,80,80,16,30,46,129.0,,440,80,162,242,656.0,84,6.48,76,407,2545,10.7
19142,Mike Keane,1997-98,30.0,10,20,48,48,10,10,20,75.0,,488,90,172,262,731.0,48,5.97,37,209,1408,10.2
19143,Mike Keane,1998-99,31.0,11,27,73,73,10,17,27,84.0,,561,100,189,289,815.0,82,6.29,74,413,2481,10.4
19144,Mike Keane,1999-00,32.0,12,27,81,81,10,17,27,91.0,,642,110,206,316,906.0,82,5.83,55,336,2444,9.8
19145,Mike Keane,2000-01,33.0,13,23,83,83,10,13,23,128.0,,725,120,219,339,1034.0,82,5.28,57,380,2242,9.6
19146,Mike Keane,2001-02,34.0,14,29,81,81,6,23,29,106.0,1130.0,806,126,242,368,1140.0,82,5.27,57,359,2285,9.4
19147,Mike Keane,2002-03,35.0,15,34,81,81,13,21,34,85.0,1310.0,887,139,263,402,1225.0,82,5.49,53,331,2294,9.8
19148,Mike Keane,2003-04,36.0,16,24,67,67,10,14,24,64.0,1036.0,954,149,277,426,1289.0,82,5.51,63,376,2272,9.9
19149,Mike Keane,2004-05,37.0,17,17,78,78,6,11,17,73.0,1174.0,1032,155,288,443,1362.0,82,5.24,53,338,2262,9.5
19150,Mike Keane,2005-06,38.0,18,10,65,65,5,5,10,35.0,796.0,1097,160,293,453,1397.0,82,5.31,60,363,2326,9.4
19151,Mike Keane,2006-07,39.0,19,17,64,64,8,9,17,41.0,716.0,1161,168,302,470,1438.0,82,5.14,57,348,2300,9.2
19152,Mike Kennedy,1997-98,25.0,4,18,44,44,6,12,18,76.0,,44,6,12,18,76.0,48,5.97,37,209,1408,10.2
19153,Mike Kennedy,1998-99,26.0,5,26,61,61,9,17,26,111.0,,105,15,29,44,187.0,82,6.29,74,413,2481,10.4
19154,Mike Kennedy,1999-00,27.0,6,7,24,24,1,6,7,26.0,,129,16,35,51,213.0,82,5.83,55,336,2444,9.8
19155,Mike Kennedy,2000-01,28.0,7,1,15,15,0,1,1,12.0,,144,16,36,52,225.0,82,5.28,57,380,2242,9.6
19156,Mike Kennedy,2001-02,29.0,8,0,1,1,0,0,0,0.0,11.0,145,16,36,52,225.0,82,5.27,57,359,2285,9.4
19157,Mike Knuble,1999-00,27.0,4,1,9,9,1,0,1,10.0,,9,1,0,1,10.0,82,5.83,55,336,2444,9.8
19158,Mike Knuble,2000-01,28.0,5,13,53,53,7,6,13,54.0,,62,8,6,14,64.0,82,5.28,57,380,2242,9.6
19159,Mike Knuble,2001-02,29.0,6,35,82,82,15,20,35,113.0,1219.0,144,23,26,49,177.0,82,5.27,57,359,2285,9.4
19160,Mike Knuble,2002-03,30.0,7,20,73,73,12,8,20,78.0,901.0,217,35,34,69,255.0,82,5.49,53,331,2294,9.8
19161,Mike Knuble,2003-04,31.0,8,20,82,82,7,13,20,92.0,867.0,299,42,47,89,347.0,82,5.51,63,376,2272,9.9
19162,Mike Knuble,2004-05,32.0,9,14,54,54,8,6,14,77.0,527.0,353,50,53,103,424.0,82,5.24,53,338,2262,9.5
19163,Mike Knuble,2005-06,33.0,10,59,75,75,30,29,59,185.0,1305.0,428,80,82,162,609.0,82,5.31,60,363,2326,9.4
19164,Mike Knuble,2006-07,34.0,11,46,82,82,21,25,46,192.0,1540.0,510,101,107,208,801.0,82,5.14,57,348,2300,9.2
19165,Mike Knuble,2008-09,36.0,12,65,82,82,34,31,65,217.0,1668.0,592,135,138,273,1018.0,82,6.05,85,480,2458,10.1
19166,Mike Knuble,2009-10,37.0,13,54,64,64,24,30,54,160.0,1256.0,656,159,168,327,1178.0,82,5.76,70,398,2426,9.7
19167,Mike Knuble,2010-11,38.0,14,55,82,82,29,26,55,177.0,1551.0,738,188,194,382,1355.0,82,5.44,62,351,2383,9.4
19168,Mike Knuble,2011-12,39.0,15,47,82,82,27,20,47,173.0,1490.0,820,215,214,429,1528.0,82,5.7,65,341,2477,9.4
19169,Mike Knuble,2012-13,40.0,16,53,69,69,29,24,53,151.0,1164.0,889,244,238,482,1679.0,82,5.53,56,304,2486,9.1
19170,Mike Knuble,2013-14,41.0,17,40,79,79,24,16,40,203.0,1413.0,968,268,254,522,1882.0,82,5.46,52,291,2492,9.0
19171,Mike Knuble,2014-15,42.0,18,18,72,72,6,12,18,91.0,1004.0,1040,274,266,540,1973.0,82,5.32,47,271,2439,8.9
19172,Mike Knuble,2015-16,43.0,19,8,28,28,4,4,8,31.0,362.0,1068,278,270,548,2004.0,48,5.31,29,160,1399,9.1
19173,Mike Komisarek,2005-06,24.0,4,1,21,21,0,1,1,26.0,351.0,21,0,1,1,26.0,82,5.31,60,363,2326,9.4
19174,Mike Komisarek,2006-07,25.0,5,4,46,46,0,4,4,40.0,552.0,67,0,5,5,66.0,82,5.14,57,348,2300,9.2
19175,Mike Komisarek,2008-09,27.0,6,6,71,71,2,4,6,66.0,1042.0,138,2,9,11,132.0,82,6.05,85,480,2458,10.1
19176,Mike Komisarek,2009-10,28.0,7,19,82,82,4,15,19,78.0,1580.0,220,6,24,30,210.0,82,5.76,70,398,2426,9.7
19177,Mike Komisarek,2010-11,29.0,8,17,75,75,4,13,17,75.0,1587.0,295,10,37,47,285.0,82,5.44,62,351,2383,9.4
19178,Mike Komisarek,2011-12,30.0,9,11,66,66,2,9,11,56.0,1361.0,361,12,46,58,341.0,82,5.7,65,341,2477,9.4
19179,Mike Komisarek,2012-13,31.0,10,4,34,34,0,4,4,35.0,678.0,395,12,50,62,376.0,82,5.53,56,304,2486,9.1
19180,Mike Komisarek,2013-14,32.0,11,10,75,75,1,9,10,48.0,1022.0,470,13,59,72,424.0,82,5.46,52,291,2492,9.0
19181,Mike Komisarek,2014-15,33.0,12,5,45,45,1,4,5,34.0,750.0,515,14,63,77,458.0,82,5.32,47,271,2439,8.9
19182,Mike Komisarek,2015-16,34.0,13,0,4,4,0,0,0,1.0,61.0,519,14,63,77,459.0,48,5.31,29,160,1399,9.1
19183,Mike Komisarek,2016-17,35.0,14,4,32,32,0,4,4,20.0,374.0,551,14,67,81,479.0,82,5.34,48,269,2463,8.9
19184,Mike Kostka,2015-16,30.0,4,8,35,35,0,8,8,49.0,773.0,35,0,8,8,49.0,48,5.31,29,160,1399,9.1
19185,Mike Kostka,2016-17,31.0,5,11,28,28,4,7,11,49.0,432.0,63,4,15,19,98.0,82,5.34,48,269,2463,8.9
19186,Mike Kostka,2017-18,32.0,6,1,7,7,0,1,1,7.0,108.0,70,4,16,20,105.0,82,5.32,47,251,2453,8.9
19187,Mike Kostka,2018-19,33.0,7,1,15,15,0,1,1,9.0,223.0,85,4,17,21,114.0,82,5.34,48,255,2438,9.0
19188,Mike Krushelnyski,1984-85,24.0,4,6,17,17,3,3,6,19.0,,17,3,3,6,19.0,80,8.03,73,320,2489,12.9
19189,Mike Krushelnyski,1985-86,25.0,5,65,79,79,23,42,65,153.0,,96,26,45,71,172.0,80,7.73,71,310,2444,12.7
19190,Mike Krushelnyski,1986-87,26.0,6,45,66,66,25,20,45,152.0,,162,51,65,116,324.0,80,7.89,74,336,2448,12.9
19191,Mike Krushelnyski,1987-88,27.0,7,88,80,80,43,45,88,191.0,,242,94,110,204,515.0,80,7.77,71,321,2447,12.7
19192,Mike Krushelnyski,1988-89,28.0,8,40,54,54,16,24,40,98.0,,296,110,134,244,613.0,80,7.94,82,370,2484,12.8
19193,Mike Krushelnyski,1989-90,29.0,9,51,80,80,16,35,51,88.0,,376,126,169,295,701.0,80,7.34,72,344,2400,12.2
19194,Mike Krushelnyski,1990-91,30.0,10,47,76,76,20,27,47,124.0,,452,146,196,342,825.0,80,7.43,89,437,2435,12.2
19195,Mike Krushelnyski,1991-92,31.0,11,62,78,78,26,36,62,143.0,,530,172,232,404,968.0,80,7.48,85,403,2430,12.3
19196,Mike Krushelnyski,1992-93,32.0,12,41,63,63,16,25,41,101.0,,593,188,257,445,1069.0,80,7.37,76,367,2421,12.2
19197,Mike Krushelnyski,1993-94,33.0,13,45,74,74,18,27,45,109.0,,667,206,284,490,1178.0,80,6.91,71,366,2385,11.6
19198,Mike Krushelnyski,1994-95,34.0,14,24,72,72,9,15,24,100.0,,739,215,299,514,1278.0,80,6.96,77,402,2440,11.4
19199,Mike Krushelnyski,1995-96,35.0,15,39,84,84,19,20,39,130.0,,823,234,319,553,1408.0,84,7.25,87,443,2603,11.7
19200,Mike Krushelnyski,1996-97,36.0,16,11,54,54,5,6,11,71.0,,877,239,325,564,1479.0,84,6.48,76,407,2545,10.7
19201,Mike Krushelnyski,1997-98,37.0,17,5,20,20,2,3,5,20.0,,897,241,328,569,1499.0,48,5.97,37,209,1408,10.2
19202,Mike Lalor,1988-89,25.0,4,8,62,62,3,5,8,44.0,,62,3,5,8,44.0,80,7.94,82,370,2484,12.8
19203,Mike Lalor,1989-90,26.0,5,10,57,57,0,10,10,58.0,,119,3,15,18,102.0,80,7.34,72,344,2400,12.2
19204,Mike Lalor,1990-91,27.0,6,11,66,66,1,10,11,41.0,,185,4,25,29,143.0,80,7.43,89,437,2435,12.2
19205,Mike Lalor,1991-92,28.0,7,20,48,48,2,18,20,52.0,,233,6,43,49,195.0,80,7.48,85,403,2430,12.3
19206,Mike Lalor,1992-93,29.0,8,16,78,78,0,16,16,79.0,,311,6,59,65,274.0,80,7.37,76,367,2421,12.2
19207,Mike Lalor,1993-94,30.0,9,6,68,68,1,5,6,49.0,,379,7,64,71,323.0,80,6.91,71,366,2385,11.6
19208,Mike Lalor,1994-95,31.0,10,17,79,79,7,10,17,74.0,,458,14,74,88,397.0,80,6.96,77,402,2440,11.4
19209,Mike Lalor,1995-96,32.0,11,9,64,64,1,8,9,75.0,,522,15,82,97,472.0,84,7.25,87,443,2603,11.7
19210,Mike Lalor,1996-97,33.0,12,3,35,35,0,3,3,22.0,,557,15,85,100,494.0,84,6.48,76,407,2545,10.7
19211,Mike Lalor,1997-98,34.0,13,0,12,12,0,0,0,6.0,,569,15,85,100,500.0,48,5.97,37,209,1408,10.2
19212,Mike Lalor,1998-99,35.0,14,3,63,63,1,2,3,46.0,,632,16,87,103,546.0,82,6.29,74,413,2481,10.4
19213,Mike Lalor,1999-00,36.0,15,2,55,55,1,1,2,32.0,,687,17,88,105,578.0,82,5.83,55,336,2444,9.8
19214,Mike Lauen,1986-87,25.0,4,1,4,4,0,1,1,3.0,,4,0,1,1,3.0,80,7.89,74,336,2448,12.9
19215,Mike Leclerc,1999-00,23.0,4,2,5,5,1,1,2,3.0,,5,1,1,2,3.0,82,5.83,55,336,2444,9.8
19216,Mike Leclerc,2000-01,24.0,5,0,7,7,0,0,0,11.0,,12,1,1,2,14.0,82,5.28,57,380,2242,9.6
19217,Mike Leclerc,2001-02,25.0,6,0,7,7,0,0,0,1.0,41.0,19,1,1,2,15.0,82,5.27,57,359,2285,9.4
19218,Mike Leclerc,2002-03,26.0,7,19,69,69,8,11,19,105.0,837.0,88,9,12,21,120.0,82,5.49,53,331,2294,9.8
19219,Mike Leclerc,2003-04,27.0,8,35,54,54,15,20,35,130.0,950.0,142,24,32,56,250.0,82,5.51,63,376,2272,9.9
19220,Mike Leclerc,2004-05,28.0,9,44,82,82,20,24,44,178.0,1425.0,224,44,56,100,428.0,82,5.24,53,338,2262,9.5
19221,Mike Leclerc,2005-06,29.0,10,28,57,57,9,19,28,122.0,966.0,281,53,75,128,550.0,82,5.31,60,363,2326,9.4
19222,Mike Leclerc,2006-07,30.0,11,4,10,10,1,3,4,19.0,156.0,291,54,78,132,569.0,82,5.14,57,348,2300,9.2
19223,Mike Leclerc,2008-09,32.0,12,26,50,50,10,16,26,65.0,668.0,341,64,94,158,634.0,82,6.05,85,480,2458,10.1
19224,Mike Lundin,2010-11,26.0,4,6,81,81,0,6,6,33.0,1117.0,81,0,6,6,33.0,82,5.44,62,351,2383,9.4
19225,Mike Lundin,2011-12,27.0,5,2,25,25,0,2,2,8.0,416.0,106,0,8,8,41.0,82,5.7,65,341,2477,9.4
19226,Mike Lundin,2012-13,28.0,6,13,49,49,3,10,13,42.0,1075.0,155,3,18,21,83.0,82,5.53,56,304,2486,9.1
19227,Mike Lundin,2013-14,29.0,7,12,69,69,1,11,12,55.0,1408.0,224,4,29,33,138.0,82,5.46,52,291,2492,9.0
19228,Mike Lundin,2014-15,30.0,8,2,17,17,0,2,2,9.0,344.0,241,4,31,35,147.0,82,5.32,47,271,2439,8.9
19229,Mike Lundin,2015-16,31.0,9,1,11,11,0,1,1,13.0,171.0,252,4,32,36,160.0,48,5.31,29,160,1399,9.1
19230,Mike MacWilliam,1998-99,31.0,4,0,6,6,0,0,0,4.0,,6,0,0,0,4.0,82,6.29,74,413,2481,10.4
19231,Mike Maneluk,2001-02,28.0,4,15,45,45,6,9,15,55.0,533.0,45,6,9,15,55.0,82,5.27,57,359,2285,9.4
19232,Mike Maneluk,2002-03,29.0,5,0,1,1,0,0,0,2.0,8.0,46,6,9,15,57.0,82,5.49,53,331,2294,9.8
19233,Mike Maneluk,2003-04,30.0,6,6,39,39,5,1,6,31.0,458.0,85,11,10,21,88.0,82,5.51,63,376,2272,9.9
19234,Mike Matheson,2018-19,24.0,4,0,3,3,0,0,0,4.0,53.0,3,0,0,0,4.0,82,5.34,48,255,2438,9.0
19235,Mike Matheson,2019-20,25.0,5,17,81,81,7,10,17,179.0,1705.0,84,7,10,17,183.0,82,5.45,47,245,2478,9.0
19236,Mike Matheson,2020-21,26.0,6,27,81,81,10,17,27,167.0,1728.0,165,17,27,44,350.0,82,5.86,50,250,2620,9.2
19237,Mike Matheson,2021-22,27.0,7,27,75,75,8,19,27,129.0,1674.0,240,25,46,71,479.0,82,5.96,47,239,2579,9.5
19238,Mike Matheson,2022-23,28.0,8,20,59,59,8,12,20,104.0,1064.0,299,33,58,91,583.0,70,5.96,42,208,2192,9.5
19239,Mike Matteucci,2003-04,32.0,4,0,3,3,0,0,0,3.0,34.0,3,0,0,0,3.0,82,5.51,63,376,2272,9.9
19240,Mike Matteucci,2004-05,33.0,5,0,3,3,0,0,0,0.0,30.0,6,0,0,0,3.0,82,5.24,53,338,2262,9.5
19241,Mike McBain,2000-01,24.0,4,1,27,27,0,1,1,17.0,,27,0,1,1,17.0,82,5.28,57,380,2242,9.6
19242,Mike McBain,2001-02,25.0,5,6,37,37,0,6,6,22.0,548.0,64,0,7,7,39.0,82,5.27,57,359,2285,9.4
19243,Mike McHugh,1991-92,26.0,4,0,3,3,0,0,0,1.0,,3,0,0,0,1.0,80,7.48,85,403,2430,12.3
19244,Mike McHugh,1992-93,27.0,5,0,3,3,0,0,0,2.0,,6,0,0,0,3.0,80,7.37,76,367,2421,12.2
19245,Mike McHugh,1993-94,28.0,6,0,6,6,0,0,0,4.0,,12,0,0,0,7.0,80,6.91,71,366,2385,11.6
19246,Mike McHugh,1994-95,29.0,7,1,8,8,1,0,1,5.0,,20,1,0,1,12.0,80,6.96,77,402,2440,11.4
19247,Mike McKee,1996-97,27.0,4,15,48,48,3,12,15,60.0,,48,3,12,15,60.0,84,6.48,76,407,2545,10.7
19248,Mike McNeill,1993-94,27.0,4,11,37,37,4,7,11,31.0,,37,4,7,11,31.0,80,6.91,71,366,2385,11.6
19249,Mike McNeill,1994-95,28.0,5,5,26,26,1,4,5,15.0,,63,5,11,16,46.0,80,6.96,77,402,2440,11.4
19250,Mike McPhee,1986-87,26.0,4,7,14,14,5,2,7,22.0,,14,5,2,7,22.0,80,7.89,74,336,2448,12.9
19251,Mike McPhee,1987-88,27.0,5,39,70,70,17,22,39,135.0,,84,22,24,46,157.0,80,7.77,71,321,2447,12.7
19252,Mike McPhee,1988-89,28.0,6,40,70,70,19,21,40,103.0,,154,41,45,86,260.0,80,7.94,82,370,2484,12.8
19253,Mike McPhee,1989-90,29.0,7,39,79,79,18,21,39,150.0,,233,59,66,125,410.0,80,7.34,72,344,2400,12.2
19254,Mike McPhee,1990-91,30.0,8,43,77,77,23,20,43,151.0,,310,82,86,168,561.0,80,7.43,89,437,2435,12.2
19255,Mike McPhee,1991-92,31.0,9,41,73,73,19,22,41,154.0,,383,101,108,209,715.0,80,7.48,85,403,2430,12.3
19256,Mike McPhee,1992-93,32.0,10,41,56,56,23,18,41,118.0,,439,124,126,250,833.0,80,7.37,76,367,2421,12.2
19257,Mike McPhee,1993-94,33.0,11,43,64,64,22,21,43,123.0,,503,146,147,293,956.0,80,6.91,71,366,2385,11.6
19258,Mike McPhee,1994-95,34.0,12,31,78,78,16,15,31,146.0,,581,162,162,324,1102.0,80,6.96,77,402,2440,11.4
19259,Mike McPhee,1995-96,35.0,13,40,84,84,18,22,40,161.0,,665,180,184,364,1263.0,84,7.25,87,443,2603,11.7
19260,Mike McPhee,1996-97,36.0,14,35,79,79,20,15,35,115.0,,744,200,199,399,1378.0,84,6.48,76,407,2545,10.7
19261,Mike Millar,1989-90,24.0,4,4,10,10,2,2,4,13.0,,10,2,2,4,13.0,80,7.34,72,344,2400,12.2
19262,Mike Millar,1990-91,25.0,5,14,28,28,7,7,14,58.0,,38,9,9,18,71.0,80,7.43,89,437,2435,12.2
19263,Mike Millar,1991-92,26.0,6,9,18,18,6,3,9,37.0,,56,15,12,27,108.0,80,7.48,85,403,2430,12.3
19264,Mike Millar,1992-93,27.0,7,5,15,15,1,4,5,18.0,,71,16,16,32,126.0,80,7.37,76,367,2421,12.2
19265,Mike Millar,1993-94,28.0,8,4,7,7,2,2,4,11.0,,78,18,18,36,137.0,80,6.91,71,366,2385,11.6
19266,Mike Modano,1992-93,22.0,4,75,80,80,29,46,75,172.0,,80,29,46,75,172.0,80,7.37,76,367,2421,12.2
19267,Mike Modano,1993-94,23.0,5,64,79,79,28,36,64,232.0,,159,57,82,139,404.0,80,6.91,71,366,2385,11.6
19268,Mike Modano,1994-95,24.0,6,77,76,76,33,44,77,256.0,,235,90,126,216,660.0,80,6.96,77,402,2440,11.4
19269,Mike Modano,1995-96,25.0,7,93,82,82,33,60,93,307.0,,317,123,186,309,967.0,84,7.25,87,443,2603,11.7
19270,Mike Modano,1996-97,26.0,8,93,76,76,50,43,93,281.0,,393,173,229,402,1248.0,84,6.48,76,407,2545,10.7
19271,Mike Modano,1997-98,27.0,9,29,30,30,12,17,29,100.0,,423,185,246,431,1348.0,48,5.97,37,209,1408,10.2
19272,Mike Modano,1998-99,28.0,10,81,78,78,36,45,81,320.0,,501,221,291,512,1668.0,82,6.29,74,413,2481,10.4
19273,Mike Modano,1999-00,29.0,11,83,80,80,35,48,83,291.0,,581,256,339,595,1959.0,82,5.83,55,336,2444,9.8
19274,Mike Modano,2000-01,30.0,12,59,52,52,21,38,59,191.0,,633,277,377,654,2150.0,82,5.28,57,380,2242,9.6
19275,Mike Modano,2001-02,31.0,13,81,77,77,34,47,81,224.0,1604.0,710,311,424,735,2374.0,82,5.27,57,359,2285,9.4
19276,Mike Modano,2002-03,32.0,14,81,77,77,38,43,81,188.0,1764.0,787,349,467,816,2562.0,82,5.49,53,331,2294,9.8
19277,Mike Modano,2003-04,33.0,15,84,81,81,33,51,84,208.0,1815.0,868,382,518,900,2770.0,82,5.51,63,376,2272,9.9
19278,Mike Modano,2004-05,34.0,16,77,78,78,34,43,77,219.0,1752.0,946,416,561,977,2989.0,82,5.24,53,338,2262,9.5
19279,Mike Modano,2005-06,35.0,17,85,79,79,28,57,85,193.0,1649.0,1025,444,618,1062,3182.0,82,5.31,60,363,2326,9.4
19280,Mike Modano,2006-07,36.0,18,44,76,76,14,30,44,152.0,1554.0,1101,458,648,1106,3334.0,82,5.14,57,348,2300,9.2
19281,Mike Modano,2008-09,38.0,19,77,78,78,27,50,77,207.0,1526.0,1179,485,698,1183,3541.0,82,6.05,85,480,2458,10.1
19282,Mike Modano,2009-10,39.0,20,43,59,59,22,21,43,141.0,1086.0,1238,507,719,1226,3682.0,82,5.76,70,398,2426,9.7
19283,Mike Modano,2010-11,40.0,21,57,82,82,21,36,57,200.0,1578.0,1320,528,755,1283,3882.0,82,5.44,62,351,2383,9.4
19284,Mike Modano,2011-12,41.0,22,46,80,80,15,31,46,197.0,1464.0,1400,543,786,1329,4079.0,82,5.7,65,341,2477,9.4
19285,Mike Modano,2012-13,42.0,23,30,59,59,14,16,30,115.0,844.0,1459,557,802,1359,4194.0,82,5.53,56,304,2486,9.1
19286,Mike Modano,2013-14,43.0,24,15,40,40,4,11,15,79.0,498.0,1499,561,813,1374,4273.0,82,5.46,52,291,2492,9.0
19287,Mike Moher,1985-86,23.0,4,1,9,9,0,1,1,8.0,,9,0,1,1,8.0,80,7.73,71,310,2444,12.7
19288,Mike Moller,1983-84,21.0,4,4,5,5,2,2,4,7.0,,5,2,2,4,7.0,80,7.69,77,340,2441,12.6
19289,Mike Moller,1984-85,22.0,5,0,9,9,0,0,0,2.0,,14,2,2,4,9.0,80,8.03,73,320,2489,12.9
19290,Mike Moller,1985-86,23.0,6,18,49,49,6,12,18,44.0,,63,8,14,22,53.0,80,7.73,71,310,2444,12.7
19291,Mike Moller,1986-87,24.0,7,16,59,59,5,11,16,42.0,,122,13,25,38,95.0,80,7.89,74,336,2448,12.9
19292,Mike Moller,1987-88,25.0,8,2,5,5,0,2,2,5.0,,127,13,27,40,100.0,80,7.77,71,321,2447,12.7
19293,Mike Moller,1988-89,26.0,9,0,1,1,0,0,0,2.0,,128,13,27,40,102.0,80,7.94,82,370,2484,12.8
19294,Mike Moller,1989-90,27.0,10,3,6,6,2,1,3,10.0,,134,15,28,43,112.0,80,7.34,72,344,2400,12.2
19295,Mike Moore,2013-14,29.0,4,1,6,6,1,0,1,5.0,61.0,6,1,0,1,5.0,82,5.46,52,291,2492,9.0
19296,Mike Mottau,2003-04,25.0,4,3,18,18,0,3,3,17.0,275.0,18,0,3,3,17.0,82,5.51,63,376,2272,9.9
19297,Mike Mottau,2004-05,26.0,5,0,1,1,0,0,0,0.0,6.0,19,0,3,3,17.0,82,5.24,53,338,2262,9.5
19298,Mike Mottau,2005-06,27.0,6,0,4,4,0,0,0,0.0,39.0,23,0,3,3,17.0,82,5.31,60,363,2326,9.4
19299,Mike Mottau,2010-11,32.0,7,17,76,76,4,13,17,68.0,1570.0,99,4,16,20,85.0,82,5.44,62,351,2383,9.4
19300,Mike Mottau,2011-12,33.0,8,15,80,80,1,14,15,71.0,1423.0,179,5,30,35,156.0,82,5.7,65,341,2477,9.4
19301,Mike Mottau,2012-13,34.0,9,18,79,79,2,16,18,74.0,1759.0,258,7,46,53,230.0,82,5.53,56,304,2486,9.1
19302,Mike Mottau,2013-14,35.0,10,3,20,20,0,3,3,21.0,407.0,278,7,49,56,251.0,82,5.46,52,291,2492,9.0
19303,Mike Mottau,2014-15,36.0,11,2,35,35,0,2,2,22.0,493.0,313,7,51,58,273.0,82,5.32,47,271,2439,8.9
19304,Mike Mottau,2016-17,38.0,12,0,8,8,0,0,0,1.0,101.0,321,7,51,58,274.0,82,5.34,48,269,2463,8.9
19305,Mike Murray,1990-91,24.0,4,0,1,1,0,0,0,1.0,,1,0,0,0,1.0,80,7.43,89,437,2435,12.2
19306,Mike Natyshak,1990-91,27.0,4,0,4,4,0,0,0,0.0,,4,0,0,0,0.0,80,7.43,89,437,2435,12.2
19307,Mike Needham,1995-96,25.0,4,13,56,56,8,5,13,49.0,,56,8,5,13,49.0,84,7.25,87,443,2603,11.7
19308,Mike Needham,1996-97,26.0,5,1,30,30,1,0,1,9.0,,86,9,5,14,58.0,84,6.48,76,407,2545,10.7
19309,Mike Pandolfo,2006-07,27.0,4,0,3,3,0,0,0,3.0,25.0,3,0,0,0,3.0,82,5.14,57,348,2300,9.2
19310,Mike Peluso,1992-93,27.0,4,0,2,2,0,0,0,0.0,,2,0,0,0,0.0,80,7.37,76,367,2421,12.2
19311,Mike Peluso,1993-94,28.0,5,7,53,53,6,1,7,29.0,,55,6,1,7,29.0,80,6.91,71,366,2385,11.6
19312,Mike Peluso,1994-95,29.0,6,9,63,63,6,3,9,32.0,,118,12,4,16,61.0,80,6.96,77,402,2440,11.4
19313,Mike Peluso,1995-96,30.0,7,25,81,81,15,10,25,93.0,,199,27,14,41,154.0,84,7.25,87,443,2603,11.7
19314,Mike Peluso,1996-97,31.0,8,20,69,69,4,16,20,44.0,,268,31,30,61,198.0,84,6.48,76,407,2545,10.7
19315,Mike Peluso,1997-98,32.0,9,11,46,46,2,9,11,27.0,,314,33,39,72,225.0,48,5.97,37,209,1408,10.2
19316,Mike Peluso,1998-99,33.0,10,11,57,57,3,8,11,41.0,,371,36,47,83,266.0,82,6.29,74,413,2481,10.4
19317,Mike Peluso,1999-00,34.0,11,7,64,64,2,5,7,37.0,,435,38,52,90,303.0,82,5.83,55,336,2444,9.8
19318,Mike Peluso,2000-01,35.0,12,0,23,23,0,0,0,8.0,,458,38,52,90,311.0,82,5.28,57,380,2242,9.6
19319,Mike Peluso0,2004-05,30.0,4,6,37,37,4,2,6,45.0,343.0,37,4,2,6,45.0,82,5.24,53,338,2262,9.5
19320,Mike Peluso0,2006-07,32.0,5,0,1,1,0,0,0,2.0,10.0,38,4,2,6,47.0,82,5.14,57,348,2300,9.2
19321,Mike Posavad,1988-89,25.0,4,0,6,6,0,0,0,2.0,,6,0,0,0,2.0,80,7.94,82,370,2484,12.8
19322,Mike Posavad,1989-90,26.0,5,0,2,2,0,0,0,0.0,,8,0,0,0,2.0,80,7.34,72,344,2400,12.2
19323,Mike Prokopec,1998-99,24.0,4,0,9,9,0,0,0,5.0,,9,0,0,0,5.0,82,6.29,74,413,2481,10.4
19324,Mike Prokopec,1999-00,25.0,5,0,6,6,0,0,0,2.0,,15,0,0,0,7.0,82,5.83,55,336,2444,9.8
19325,Mike Ramsey,1982-83,22.0,4,7,13,13,1,6,7,17.0,,13,1,6,7,17.0,80,7.03,61,280,2352,12.0
19326,Mike Ramsey,1983-84,23.0,5,17,72,72,3,14,17,72.0,,85,4,20,24,89.0,80,7.69,77,340,2441,12.6
19327,Mike Ramsey,1984-85,24.0,6,30,80,80,7,23,30,94.0,,165,11,43,54,183.0,80,8.03,73,320,2489,12.9
19328,Mike Ramsey,1985-86,25.0,7,38,77,77,8,30,38,117.0,,242,19,73,92,300.0,80,7.73,71,310,2444,12.7
19329,Mike Ramsey,1986-87,26.0,8,31,72,72,9,22,31,135.0,,314,28,95,123,435.0,80,7.89,74,336,2448,12.9
19330,Mike Ramsey,1987-88,27.0,9,30,79,79,8,22,30,161.0,,393,36,117,153,596.0,80,7.77,71,321,2447,12.7
19331,Mike Ramsey,1988-89,28.0,10,28,76,76,7,21,28,154.0,,469,43,138,181,750.0,80,7.94,82,370,2484,12.8
19332,Mike Ramsey,1989-90,29.0,11,39,80,80,8,31,39,156.0,,549,51,169,220,906.0,80,7.34,72,344,2400,12.2
19333,Mike Ramsey,1990-91,30.0,12,21,63,63,5,16,21,94.0,,612,56,185,241,1000.0,80,7.43,89,437,2435,12.2
19334,Mike Ramsey,1991-92,31.0,13,16,56,56,2,14,16,63.0,,668,58,199,257,1063.0,80,7.48,85,403,2430,12.3
19335,Mike Ramsey,1992-93,32.0,14,25,73,73,4,21,25,91.0,,741,62,220,282,1154.0,80,7.37,76,367,2421,12.2
19336,Mike Ramsey,1993-94,33.0,15,20,71,71,6,14,20,87.0,,812,68,234,302,1241.0,80,6.91,71,366,2385,11.6
19337,Mike Ramsey,1994-95,34.0,16,17,66,66,3,14,17,55.0,,878,71,248,319,1296.0,80,6.96,77,402,2440,11.4
19338,Mike Ramsey,1995-96,35.0,17,13,45,45,3,10,13,35.0,,923,74,258,332,1331.0,84,7.25,87,443,2603,11.7
19339,Mike Ramsey,1996-97,36.0,18,4,65,65,2,2,4,31.0,,988,76,260,336,1362.0,84,6.48,76,407,2545,10.7
19340,Mike Ramsey,1997-98,37.0,19,3,33,33,1,2,3,29.0,,1021,77,262,339,1391.0,48,5.97,37,209,1408,10.2
19341,Mike Ramsey,1998-99,38.0,20,6,47,47,2,4,6,35.0,,1068,79,266,345,1426.0,82,6.29,74,413,2481,10.4
19342,Mike Ramsey,1999-00,39.0,21,0,2,2,0,0,0,3.0,,1070,79,266,345,1429.0,82,5.83,55,336,2444,9.8
19343,Mike Rathje,1996-97,22.0,4,10,47,47,1,9,10,30.0,,47,1,9,10,30.0,84,6.48,76,407,2545,10.7
19344,Mike Rathje,1997-98,23.0,5,9,42,42,2,7,9,38.0,,89,3,16,19,68.0,48,5.97,37,209,1408,10.2
19345,Mike Rathje,1998-99,24.0,6,7,27,27,0,7,7,26.0,,116,3,23,26,94.0,82,6.29,74,413,2481,10.4
19346,Mike Rathje,1999-00,25.0,7,8,31,31,0,8,8,22.0,,147,3,31,34,116.0,82,5.83,55,336,2444,9.8
19347,Mike Rathje,2000-01,26.0,8,15,81,81,3,12,15,61.0,,228,6,43,49,177.0,82,5.28,57,380,2242,9.6
19348,Mike Rathje,2001-02,27.0,9,14,82,82,5,9,14,67.0,1650.0,310,11,52,63,244.0,82,5.27,57,359,2285,9.4
19349,Mike Rathje,2002-03,28.0,10,16,66,66,2,14,16,46.0,1464.0,376,13,66,79,290.0,82,5.49,53,331,2294,9.8
19350,Mike Rathje,2003-04,29.0,11,11,81,81,0,11,11,89.0,1809.0,457,13,77,90,379.0,82,5.51,63,376,2272,9.9
19351,Mike Rathje,2004-05,30.0,12,17,52,52,5,12,17,56.0,1119.0,509,18,89,107,435.0,82,5.24,53,338,2262,9.5
19352,Mike Rathje,2005-06,31.0,13,29,82,82,7,22,29,147.0,1977.0,591,25,111,136,582.0,82,5.31,60,363,2326,9.4
19353,Mike Rathje,2006-07,32.0,14,19,80,80,2,17,19,105.0,1876.0,671,27,128,155,687.0,82,5.14,57,348,2300,9.2
19354,Mike Rathje,2008-09,34.0,15,24,79,79,3,21,24,55.0,1590.0,750,30,149,179,742.0,82,6.05,85,480,2458,10.1
19355,Mike Rathje,2009-10,35.0,16,1,18,18,0,1,1,13.0,375.0,768,30,150,180,755.0,82,5.76,70,398,2426,9.7
19356,Mike Reilly,2018-19,25.0,4,7,29,29,1,6,7,27.0,350.0,29,1,6,7,27.0,82,5.34,48,255,2438,9.0
19357,Mike Reilly,2019-20,26.0,5,1,17,17,1,0,1,19.0,210.0,46,2,6,8,46.0,82,5.45,47,245,2478,9.0
19358,Mike Reilly,2020-21,27.0,6,18,57,57,2,16,18,65.0,853.0,103,4,22,26,111.0,82,5.86,50,250,2620,9.2
19359,Mike Reilly,2021-22,28.0,7,11,57,57,3,8,11,101.0,1065.0,160,7,30,37,212.0,82,5.96,47,239,2579,9.5
19360,Mike Reilly,2022-23,29.0,8,16,44,44,1,15,16,85.0,793.0,204,8,45,53,297.0,70,5.96,42,208,2192,9.5
19361,Mike Ribeiro,2002-03,22.0,4,2,19,19,1,1,2,18.0,203.0,19,1,1,2,18.0,82,5.49,53,331,2294,9.8
19362,Mike Ribeiro,2003-04,23.0,5,0,2,2,0,0,0,3.0,21.0,21,1,1,2,21.0,82,5.51,63,376,2272,9.9
19363,Mike Ribeiro,2004-05,24.0,6,18,43,43,8,10,18,48.0,599.0,64,9,11,20,69.0,82,5.24,53,338,2262,9.5
19364,Mike Ribeiro,2005-06,25.0,7,17,52,52,5,12,17,57.0,578.0,116,14,23,37,126.0,82,5.31,60,363,2326,9.4
19365,Mike Ribeiro,2006-07,26.0,8,65,81,81,20,45,65,103.0,1384.0,197,34,68,102,229.0,82,5.14,57,348,2300,9.2
19366,Mike Ribeiro,2008-09,28.0,9,51,79,79,16,35,51,130.0,1310.0,276,50,103,153,359.0,82,6.05,85,480,2458,10.1
19367,Mike Ribeiro,2009-10,29.0,10,59,81,81,18,41,59,111.0,1210.0,357,68,144,212,470.0,82,5.76,70,398,2426,9.7
19368,Mike Ribeiro,2010-11,30.0,11,83,76,76,27,56,83,107.0,1400.0,433,95,200,295,577.0,82,5.44,62,351,2383,9.4
19369,Mike Ribeiro,2011-12,31.0,12,78,82,82,22,56,78,163.0,1718.0,515,117,256,373,740.0,82,5.7,65,341,2477,9.4
19370,Mike Ribeiro,2012-13,32.0,13,53,66,66,19,34,53,155.0,1289.0,581,136,290,426,895.0,82,5.53,56,304,2486,9.1
19371,Mike Ribeiro,2013-14,33.0,14,71,82,82,19,52,71,161.0,1637.0,663,155,342,497,1056.0,82,5.46,52,291,2492,9.0
19372,Mike Ribeiro,2014-15,34.0,15,63,74,74,18,45,63,142.0,1484.0,737,173,387,560,1198.0,82,5.32,47,271,2439,8.9
19373,Mike Ribeiro,2015-16,35.0,16,49,48,48,13,36,49,63.0,856.0,785,186,423,609,1261.0,48,5.31,29,160,1399,9.1
19374,Mike Ribeiro,2016-17,36.0,17,47,80,80,16,31,47,110.0,1440.0,865,202,454,656,1371.0,82,5.34,48,269,2463,8.9
19375,Mike Ribeiro,2017-18,37.0,18,62,82,82,15,47,62,96.0,1537.0,947,217,501,718,1467.0,82,5.32,47,251,2453,8.9
19376,Mike Ribeiro,2018-19,38.0,19,50,81,81,7,43,50,76.0,1413.0,1028,224,544,768,1543.0,82,5.34,48,255,2438,9.0
19377,Mike Ribeiro,2019-20,39.0,20,25,46,46,4,21,25,38.0,735.0,1074,228,565,793,1581.0,82,5.45,47,245,2478,9.0
19378,Mike Ricci,1993-94,22.0,4,41,68,68,21,20,41,121.0,,68,21,20,41,121.0,80,6.91,71,366,2385,11.6
19379,Mike Ricci,1994-95,23.0,5,56,78,78,20,36,56,149.0,,146,41,56,97,270.0,80,6.96,77,402,2440,11.4
19380,Mike Ricci,1995-96,24.0,6,78,77,77,27,51,78,142.0,,223,68,107,175,412.0,84,7.25,87,443,2603,11.7
19381,Mike Ricci,1996-97,25.0,7,51,83,83,30,21,51,138.0,,306,98,128,226,550.0,84,6.48,76,407,2545,10.7
19382,Mike Ricci,1997-98,26.0,8,36,48,48,15,21,36,73.0,,354,113,149,262,623.0,48,5.97,37,209,1408,10.2
19383,Mike Ricci,1998-99,27.0,9,27,62,62,6,21,27,73.0,,416,119,170,289,696.0,82,6.29,74,413,2481,10.4
19384,Mike Ricci,1999-00,28.0,10,32,63,63,13,19,32,74.0,,479,132,189,321,770.0,82,5.83,55,336,2444,9.8
19385,Mike Ricci,2000-01,29.0,11,27,65,65,9,18,27,91.0,,544,141,207,348,861.0,82,5.28,57,380,2242,9.6
19386,Mike Ricci,2001-02,30.0,12,39,82,82,13,26,39,98.0,1261.0,626,154,233,387,959.0,82,5.27,57,359,2285,9.4
19387,Mike Ricci,2002-03,31.0,13,44,82,82,20,24,44,134.0,1384.0,708,174,257,431,1093.0,82,5.49,53,331,2294,9.8
19388,Mike Ricci,2003-04,32.0,14,44,81,81,22,22,44,141.0,1457.0,789,196,279,475,1234.0,82,5.51,63,376,2272,9.9
19389,Mike Ricci,2004-05,33.0,15,53,79,79,19,34,53,115.0,1348.0,868,215,313,528,1349.0,82,5.24,53,338,2262,9.5
19390,Mike Ricci,2005-06,34.0,16,34,75,75,11,23,34,101.0,1238.0,943,226,336,562,1450.0,82,5.31,60,363,2326,9.4
19391,Mike Ricci,2006-07,35.0,17,26,71,71,7,19,26,48.0,1019.0,1014,233,355,588,1498.0,82,5.14,57,348,2300,9.2
19392,Mike Ricci,2008-09,37.0,18,16,78,78,10,6,16,50.0,998.0,1092,243,361,604,1548.0,82,6.05,85,480,2458,10.1
19393,Mike Ricci,2009-10,38.0,19,1,7,7,0,1,1,4.0,69.0,1099,243,362,605,1552.0,82,5.76,70,398,2426,9.7
19394,Mike Richard,1990-91,24.0,4,0,4,4,0,0,0,5.0,,4,0,0,0,5.0,80,7.43,89,437,2435,12.2
19395,Mike Richard,1992-93,26.0,5,2,3,3,0,2,2,5.0,,7,0,2,2,10.0,80,7.37,76,367,2421,12.2
19396,Mike Richards,2008-09,23.0,4,34,79,79,11,23,34,168.0,1215.0,79,11,23,34,168.0,82,6.05,85,480,2458,10.1
19397,Mike Richards,2009-10,24.0,5,32,59,59,10,22,32,130.0,1052.0,138,21,45,66,298.0,82,5.76,70,398,2426,9.7
19398,Mike Richards,2010-11,25.0,6,75,73,73,28,47,75,212.0,1570.0,211,49,92,141,510.0,82,5.44,62,351,2383,9.4
19399,Mike Richards,2011-12,26.0,7,80,79,79,30,50,80,238.0,1717.0,290,79,142,221,748.0,82,5.7,65,341,2477,9.4
19400,Mike Richards,2012-13,27.0,8,62,82,82,31,31,62,237.0,1673.0,372,110,173,283,985.0,82,5.53,56,304,2486,9.1
19401,Mike Richards,2013-14,28.0,9,66,81,81,23,43,66,184.0,1529.0,453,133,216,349,1169.0,82,5.46,52,291,2492,9.0
19402,Mike Richards,2014-15,29.0,10,44,74,74,18,26,44,171.0,1398.0,527,151,242,393,1340.0,82,5.32,47,271,2439,8.9
19403,Mike Richards,2015-16,30.0,11,32,48,48,12,20,32,82.0,785.0,575,163,262,425,1422.0,48,5.31,29,160,1399,9.1
19404,Mike Richards,2016-17,31.0,12,41,82,82,11,30,41,157.0,1392.0,657,174,292,466,1579.0,82,5.34,48,269,2463,8.9
19405,Mike Richards,2017-18,32.0,13,16,53,53,5,11,16,63.0,708.0,710,179,303,482,1642.0,82,5.32,47,251,2453,8.9
19406,Mike Richards,2018-19,33.0,14,5,39,39,2,3,5,46.0,475.0,749,181,306,487,1688.0,82,5.34,48,255,2438,9.0
19407,Mike Ridley,1988-89,25.0,4,65,80,80,22,43,65,150.0,,80,22,43,65,150.0,80,7.94,82,370,2484,12.8
19408,Mike Ridley,1989-90,26.0,5,70,78,78,31,39,70,149.0,,158,53,82,135,299.0,80,7.34,72,344,2400,12.2
19409,Mike Ridley,1990-91,27.0,6,59,70,70,28,31,59,134.0,,228,81,113,194,433.0,80,7.43,89,437,2435,12.2
19410,Mike Ridley,1991-92,28.0,7,89,80,80,41,48,89,187.0,,308,122,161,283,620.0,80,7.48,85,403,2430,12.3
19411,Mike Ridley,1992-93,29.0,8,73,74,74,30,43,73,124.0,,382,152,204,356,744.0,80,7.37,76,367,2421,12.2
19412,Mike Ridley,1993-94,30.0,9,71,79,79,23,48,71,155.0,,461,175,252,427,899.0,80,6.91,71,366,2385,11.6
19413,Mike Ridley,1994-95,31.0,10,69,80,80,29,40,69,123.0,,541,204,292,496,1022.0,80,6.96,77,402,2440,11.4
19414,Mike Ridley,1995-96,32.0,11,82,84,84,26,56,82,148.0,,625,230,348,578,1170.0,84,7.25,87,443,2603,11.7
19415,Mike Ridley,1996-97,33.0,12,70,81,81,26,44,70,144.0,,706,256,392,648,1314.0,84,6.48,76,407,2545,10.7
19416,Mike Ridley,1997-98,34.0,13,37,48,48,10,27,37,88.0,,754,266,419,685,1402.0,48,5.97,37,209,1408,10.2
19417,Mike Ridley,1998-99,35.0,14,21,37,37,6,15,21,32.0,,791,272,434,706,1434.0,82,6.29,74,413,2481,10.4
19418,Mike Ridley,1999-00,36.0,15,52,75,75,20,32,52,79.0,,866,292,466,758,1513.0,82,5.83,55,336,2444,9.8
19419,Mike Rogers,1982-83,28.0,4,105,80,80,44,61,105,229.0,,80,44,61,105,229.0,80,7.03,61,280,2352,12.0
19420,Mike Rogers,1983-84,29.0,5,105,80,80,40,65,105,242.0,,160,84,126,210,471.0,80,7.69,77,340,2441,12.6
19421,Mike Rogers,1984-85,30.0,6,103,80,80,38,65,103,213.0,,240,122,191,313,684.0,80,8.03,73,320,2489,12.9
19422,Mike Rogers,1985-86,31.0,7,76,71,71,29,47,76,200.0,,311,151,238,389,884.0,80,7.73,71,310,2444,12.7
19423,Mike Rogers,1986-87,32.0,8,61,78,78,23,38,61,186.0,,389,174,276,450,1070.0,80,7.89,74,336,2448,12.9
19424,Mike Rogers,1987-88,33.0,9,64,78,78,26,38,64,145.0,,467,200,314,514,1215.0,80,7.77,71,321,2447,12.7
19425,Mike Rogers,1988-89,34.0,10,5,17,17,2,3,5,25.0,,484,202,317,519,1240.0,80,7.94,82,370,2484,12.8
19426,Mike Rowe,1987-88,22.0,4,0,6,6,0,0,0,6.0,,6,0,0,0,6.0,80,7.77,71,321,2447,12.7
19427,Mike Rowe,1988-89,23.0,5,0,3,3,0,0,0,5.0,,9,0,0,0,11.0,80,7.94,82,370,2484,12.8
19428,Mike Rowe,1989-90,24.0,6,0,2,2,0,0,0,1.0,,11,0,0,0,12.0,80,7.34,72,344,2400,12.2
19429,Mike Rucinski,1991-92,28.0,4,0,1,1,0,0,0,0.0,,1,0,0,0,0.0,80,7.48,85,403,2430,12.3
19430,Mike Rucinski0,2000-01,25.0,4,1,9,9,0,1,1,3.0,,9,0,1,1,3.0,82,5.28,57,380,2242,9.6
19431,Mike Rucinski0,2001-02,26.0,5,1,15,15,0,1,1,8.0,157.0,24,0,2,2,11.0,82,5.27,57,359,2285,9.4
19432,Mike Rucinski0,2003-04,28.0,6,0,2,2,0,0,0,2.0,27.0,26,0,2,2,13.0,82,5.51,63,376,2272,9.9
19433,Mike Rupp,2005-06,26.0,4,8,26,26,5,3,8,34.0,303.0,26,5,3,8,34.0,82,5.31,60,363,2326,9.4
19434,Mike Rupp,2006-07,27.0,5,12,57,57,6,6,12,76.0,645.0,83,11,9,20,110.0,82,5.14,57,348,2300,9.2
19435,Mike Rupp,2008-09,29.0,6,6,40,40,4,2,6,39.0,360.0,123,15,11,26,149.0,82,6.05,85,480,2458,10.1
19436,Mike Rupp,2009-10,30.0,7,9,76,76,6,3,9,60.0,490.0,199,21,14,35,209.0,82,5.76,70,398,2426,9.7
19437,Mike Rupp,2010-11,31.0,8,9,64,64,3,6,9,69.0,516.0,263,24,20,44,278.0,82,5.44,62,351,2383,9.4
19438,Mike Rupp,2011-12,32.0,9,9,72,72,3,6,9,76.0,628.0,335,27,26,53,354.0,82,5.7,65,341,2477,9.4
19439,Mike Rupp,2012-13,33.0,10,19,81,81,13,6,19,87.0,732.0,416,40,32,72,441.0,82,5.53,56,304,2486,9.1
19440,Mike Rupp,2013-14,34.0,11,17,81,81,9,8,17,81.0,814.0,497,49,40,89,522.0,82,5.46,52,291,2492,9.0
19441,Mike Rupp,2014-15,35.0,12,5,60,60,4,1,5,31.0,399.0,557,53,41,94,553.0,82,5.32,47,271,2439,8.9
19442,Mike Rupp,2015-16,36.0,13,4,40,40,1,3,4,29.0,334.0,597,54,44,98,582.0,48,5.31,29,160,1399,9.1
19443,Mike Rupp,2016-17,37.0,14,1,13,13,0,1,1,6.0,81.0,610,54,45,99,588.0,82,5.34,48,269,2463,8.9
19444,Mike Santorelli,2011-12,26.0,4,0,7,7,0,0,0,11.0,86.0,7,0,0,0,11.0,82,5.7,65,341,2477,9.4
19445,Mike Santorelli,2012-13,27.0,5,3,25,25,2,1,3,36.0,274.0,32,2,1,3,47.0,82,5.53,56,304,2486,9.1
19446,Mike Santorelli,2013-14,28.0,6,41,82,82,20,21,41,193.0,1368.0,114,22,22,44,240.0,82,5.46,52,291,2492,9.0
19447,Mike Santorelli,2014-15,29.0,7,11,60,60,9,2,11,117.0,744.0,174,31,24,55,357.0,82,5.32,47,271,2439,8.9
19448,Mike Santorelli,2015-16,30.0,8,4,34,34,2,2,4,35.0,403.0,208,33,26,59,392.0,48,5.31,29,160,1399,9.1
19449,Mike Santorelli,2016-17,31.0,9,28,49,49,10,18,28,91.0,910.0,257,43,44,87,483.0,82,5.34,48,269,2463,8.9
19450,Mike Santorelli,2017-18,32.0,10,33,79,79,12,21,33,145.0,1137.0,336,55,65,120,628.0,82,5.32,47,251,2453,8.9
19451,Mike Santorelli,2018-19,33.0,11,18,70,70,9,9,18,81.0,706.0,406,64,74,138,709.0,82,5.34,48,255,2438,9.0
19452,Mike Siklenka,2005-06,26.0,4,0,1,1,0,0,0,1.0,4.0,1,0,0,0,1.0,82,5.31,60,363,2326,9.4
19453,Mike Siklenka,2006-07,27.0,5,0,1,1,0,0,0,0.0,2.0,2,0,0,0,1.0,82,5.14,57,348,2300,9.2
19454,Mike Sillinger,1993-94,22.0,4,1,3,3,0,1,1,6.0,,3,0,1,1,6.0,80,6.91,71,366,2385,11.6
19455,Mike Sillinger,1995-96,24.0,5,21,51,51,4,17,21,47.0,,54,4,18,22,53.0,84,7.25,87,443,2603,11.7
19456,Mike Sillinger,1996-97,25.0,6,29,62,62,8,21,29,91.0,,116,12,39,51,144.0,84,6.48,76,407,2545,10.7
19457,Mike Sillinger,1997-98,26.0,7,15,28,28,4,11,15,39.0,,144,16,50,66,183.0,48,5.97,37,209,1408,10.2
19458,Mike Sillinger,1998-99,27.0,8,38,74,74,14,24,38,159.0,,218,30,74,104,342.0,82,6.29,74,413,2481,10.4
19459,Mike Sillinger,1999-00,28.0,9,37,78,78,17,20,37,112.0,,296,47,94,141,454.0,82,5.83,55,336,2444,9.8
19460,Mike Sillinger,2000-01,29.0,10,41,75,75,21,20,41,96.0,,371,68,114,182,550.0,82,5.28,57,380,2242,9.6
19461,Mike Sillinger,2001-02,30.0,11,13,79,79,8,5,13,92.0,1021.0,450,76,119,195,642.0,82,5.27,57,359,2285,9.4
19462,Mike Sillinger,2002-03,31.0,12,52,80,80,23,29,52,146.0,1574.0,530,99,148,247,788.0,82,5.49,53,331,2294,9.8
19463,Mike Sillinger,2003-04,32.0,13,41,68,68,16,25,41,119.0,1227.0,598,115,173,288,907.0,82,5.51,63,376,2272,9.9
19464,Mike Sillinger,2004-05,33.0,14,43,80,80,20,23,43,150.0,1668.0,678,135,196,331,1057.0,82,5.24,53,338,2262,9.5
19465,Mike Sillinger,2005-06,34.0,15,43,75,75,18,25,43,128.0,1435.0,753,153,221,374,1185.0,82,5.31,60,363,2326,9.4
19466,Mike Sillinger,2006-07,35.0,16,24,76,76,13,11,24,106.0,1244.0,829,166,232,398,1291.0,82,5.14,57,348,2300,9.2
19467,Mike Sillinger,2008-09,37.0,17,63,79,79,32,31,63,211.0,1520.0,908,198,263,461,1502.0,82,6.05,85,480,2458,10.1
19468,Mike Sillinger,2009-10,38.0,18,59,82,82,26,33,59,152.0,1584.0,990,224,296,520,1654.0,82,5.76,70,398,2426,9.7
19469,Mike Sillinger,2010-11,39.0,19,26,52,52,14,12,26,94.0,968.0,1042,238,308,546,1748.0,82,5.44,62,351,2383,9.4
19470,Mike Sillinger,2011-12,40.0,20,2,7,7,2,0,2,14.0,99.0,1049,240,308,548,1762.0,82,5.7,65,341,2477,9.4
19471,Mike Siltala,1984-85,21.0,4,1,3,3,1,0,1,2.0,,3,1,0,1,2.0,80,8.03,73,320,2489,12.9
19472,Mike Siltala,1989-90,26.0,5,0,1,1,0,0,0,0.0,,4,1,0,1,2.0,80,7.34,72,344,2400,12.2
19473,Mike Siltala,1990-91,27.0,6,0,3,3,0,0,0,3.0,,7,1,0,1,5.0,80,7.43,89,437,2435,12.2
19474,Mike Sislo,2016-17,29.0,4,0,14,14,0,0,0,20.0,124.0,14,0,0,0,20.0,82,5.34,48,269,2463,8.9
19475,Mike Sislo,2017-18,30.0,5,1,10,10,0,1,1,13.0,122.0,24,0,1,1,33.0,82,5.32,47,251,2453,8.9
19476,Mike Sislo,2018-19,31.0,6,4,18,18,3,1,4,29.0,224.0,42,3,2,5,62.0,82,5.34,48,255,2438,9.0
19477,Mike Stapleton,1989-90,23.0,4,9,39,39,3,6,9,56.0,,39,3,6,9,56.0,80,7.34,72,344,2400,12.2
19478,Mike Stapleton,1990-91,24.0,5,11,53,53,2,9,11,50.0,,92,5,15,20,106.0,80,7.43,89,437,2435,12.2
19479,Mike Stapleton,1991-92,25.0,6,1,7,7,0,1,1,6.0,,99,5,16,21,112.0,80,7.48,85,403,2430,12.3
19480,Mike Stapleton,1993-94,27.0,7,1,7,7,0,1,1,6.0,,106,5,17,22,118.0,80,6.91,71,366,2385,11.6
19481,Mike Stapleton,1994-95,28.0,8,8,19,19,4,4,8,32.0,,125,9,21,30,150.0,80,6.96,77,402,2440,11.4
19482,Mike Stapleton,1995-96,29.0,9,13,78,78,4,9,13,78.0,,203,13,30,43,228.0,84,7.25,87,443,2603,11.7
19483,Mike Stapleton,1996-97,30.0,10,25,81,81,12,13,25,102.0,,284,25,43,68,330.0,84,6.48,76,407,2545,10.7
19484,Mike Stapleton,1997-98,31.0,11,17,46,46,6,11,17,59.0,,330,31,54,85,389.0,48,5.97,37,209,1408,10.2
19485,Mike Stapleton,1998-99,32.0,12,24,58,58,10,14,24,91.0,,388,41,68,109,480.0,82,6.29,74,413,2481,10.4
19486,Mike Stapleton,1999-00,33.0,13,15,55,55,4,11,15,74.0,,443,45,79,124,554.0,82,5.83,55,336,2444,9.8
19487,Mike Stapleton,2000-01,34.0,14,10,64,64,5,5,10,69.0,,507,50,84,134,623.0,82,5.28,57,380,2242,9.6
19488,Mike Stapleton,2001-02,35.0,15,18,76,76,9,9,18,106.0,1039.0,583,59,93,152,729.0,82,5.27,57,359,2285,9.4
19489,Mike Stapleton,2002-03,36.0,16,22,62,62,10,12,22,146.0,1073.0,645,69,105,174,875.0,82,5.49,53,331,2294,9.8
19490,Mike Stapleton,2003-04,37.0,17,8,52,52,2,6,8,31.0,491.0,697,71,111,182,906.0,82,5.51,63,376,2272,9.9
19491,Mike Stevens,1987-88,22.0,4,3,6,6,0,3,3,10.0,,6,0,3,3,10.0,80,7.77,71,321,2447,12.7
19492,Mike Stevens,1990-91,25.0,5,1,7,7,0,1,1,5.0,,13,0,4,4,15.0,80,7.43,89,437,2435,12.2
19493,Mike Stevens,1991-92,26.0,6,1,9,9,1,0,1,9.0,,22,1,4,5,24.0,80,7.48,85,403,2430,12.3
19494,Mike Stevens,1992-93,27.0,7,0,1,1,0,0,0,2.0,,23,1,4,5,26.0,80,7.37,76,367,2421,12.2
19495,Mike Stothers,1987-88,25.0,4,0,1,1,0,0,0,0.0,,1,0,0,0,0.0,80,7.77,71,321,2447,12.7
19496,Mike Stothers,1988-89,26.0,5,1,6,6,0,1,1,1.0,,7,0,1,1,1.0,80,7.94,82,370,2484,12.8
19497,Mike Stothers,1989-90,27.0,6,0,2,2,0,0,0,2.0,,9,0,1,1,3.0,80,7.34,72,344,2400,12.2
19498,Mike Stothers,1990-91,28.0,7,1,21,21,0,1,1,0.0,,30,0,2,2,3.0,80,7.43,89,437,2435,12.2
19499,Mike Stuart,2006-07,26.0,4,0,2,2,0,0,0,0.0,19.0,2,0,0,0,0.0,82,5.14,57,348,2300,9.2
19500,Mike Stuart,2008-09,28.0,5,0,1,1,0,0,0,1.0,13.0,3,0,0,0,1.0,82,6.05,85,480,2458,10.1
19501,Mike Stutzel,2006-07,27.0,4,0,9,9,0,0,0,3.0,52.0,9,0,0,0,3.0,82,5.14,57,348,2300,9.2
19502,Mike Sullivan,1994-95,26.0,4,19,64,64,8,11,19,72.0,,64,8,11,19,72.0,80,6.96,77,402,2440,11.4
19503,Mike Sullivan,1995-96,27.0,5,14,81,81,6,8,14,95.0,,145,14,19,33,167.0,84,7.25,87,443,2603,11.7
19504,Mike Sullivan,1996-97,28.0,6,9,45,45,4,5,9,48.0,,190,18,24,42,215.0,84,6.48,76,407,2545,10.7
19505,Mike Sullivan,1997-98,29.0,7,11,38,38,4,7,11,31.0,,228,22,31,53,246.0,48,5.97,37,209,1408,10.2
19506,Mike Sullivan,1998-99,30.0,8,21,81,81,9,12,21,106.0,,309,31,43,74,352.0,82,6.29,74,413,2481,10.4
19507,Mike Sullivan,1999-00,31.0,9,11,67,67,5,6,11,64.0,,376,36,49,85,416.0,82,5.83,55,336,2444,9.8
19508,Mike Sullivan,2000-01,32.0,10,18,77,77,5,13,18,83.0,,453,41,62,103,499.0,82,5.28,57,380,2242,9.6
19509,Mike Sullivan,2001-02,33.0,11,6,63,63,2,4,6,66.0,765.0,516,43,66,109,565.0,82,5.27,57,359,2285,9.4
19510,Mike Sullivan,2002-03,34.0,12,15,79,79,5,10,15,59.0,916.0,595,48,76,124,624.0,82,5.49,53,331,2294,9.8
19511,Mike Sullivan,2003-04,35.0,13,9,72,72,5,4,9,59.0,922.0,667,53,80,133,683.0,82,5.51,63,376,2272,9.9
19512,Mike Sullivan,2004-05,36.0,14,3,42,42,1,2,3,28.0,459.0,709,54,82,136,711.0,82,5.24,53,338,2262,9.5
19513,Mike Toal,1982-83,23.0,4,0,3,3,0,0,0,1.0,,3,0,0,0,1.0,80,7.03,61,280,2352,12.0
19514,Mike Tomlak,1992-93,28.0,4,21,70,70,7,14,21,64.0,,70,7,14,21,64.0,80,7.37,76,367,2421,12.2
19515,Mike Tomlak,1993-94,29.0,5,16,64,64,8,8,16,69.0,,134,15,22,37,133.0,80,6.91,71,366,2385,11.6
19516,Mike Tomlak,1994-95,30.0,6,0,6,6,0,0,0,10.0,,140,15,22,37,143.0,80,6.96,77,402,2440,11.4
19517,Mike Tomlak,1996-97,32.0,7,0,1,1,0,0,0,2.0,,141,15,22,37,145.0,84,6.48,76,407,2545,10.7
19518,Mike Van Ryn,2003-04,24.0,4,0,1,1,0,0,0,1.0,14.0,1,0,0,0,1.0,82,5.51,63,376,2272,9.9
19519,Mike Van Ryn,2004-05,25.0,5,10,48,48,2,8,10,52.0,786.0,49,2,8,10,53.0,82,5.24,53,338,2262,9.5
19520,Mike Van Ryn,2005-06,26.0,6,3,20,20,0,3,3,21.0,301.0,69,2,11,13,74.0,82,5.31,60,363,2326,9.4
19521,Mike Van Ryn,2006-07,27.0,7,37,79,79,13,24,37,136.0,1931.0,148,15,35,50,210.0,82,5.14,57,348,2300,9.2
19522,Mike Van Ryn,2008-09,29.0,8,37,80,80,8,29,37,154.0,1808.0,228,23,64,87,364.0,82,6.05,85,480,2458,10.1
19523,Mike Van Ryn,2009-10,30.0,9,29,78,78,4,25,29,121.0,1649.0,306,27,89,116,485.0,82,5.76,70,398,2426,9.7
19524,Mike Van Ryn,2010-11,31.0,10,2,20,20,0,2,2,16.0,356.0,326,27,91,118,501.0,82,5.44,62,351,2383,9.4
19525,Mike Van Ryn,2011-12,32.0,11,11,27,27,3,8,11,53.0,530.0,353,30,99,129,554.0,82,5.7,65,341,2477,9.4
19526,Mike Vecchione,2019-20,26.0,4,0,2,2,0,0,0,1.0,17.0,2,0,0,0,1.0,82,5.45,47,245,2478,9.0
19527,Mike Vellucci,1990-91,24.0,4,0,2,2,0,0,0,2.0,,2,0,0,0,2.0,80,7.43,89,437,2435,12.2
19528,Mike Vernace,2011-12,25.0,4,0,12,12,0,0,0,9.0,236.0,12,0,0,0,9.0,82,5.7,65,341,2477,9.4
19529,Mike Vernace,2013-14,27.0,5,1,10,10,0,1,1,6.0,87.0,22,0,1,1,15.0,82,5.46,52,291,2492,9.0
19530,Mike Walsh,1990-91,28.0,4,0,1,1,0,0,0,2.0,,1,0,0,0,2.0,80,7.43,89,437,2435,12.2
19531,Mike Walsh,1991-92,29.0,5,2,13,13,2,0,2,11.0,,14,2,0,2,13.0,80,7.48,85,403,2430,12.3
19532,Mike Watt,2000-01,24.0,4,3,14,14,1,2,3,14.0,,14,1,2,3,14.0,82,5.28,57,380,2242,9.6
19533,Mike Watt,2001-02,25.0,5,25,75,75,8,17,25,75.0,844.0,89,9,19,28,89.0,82,5.27,57,359,2285,9.4
19534,Mike Watt,2002-03,26.0,6,11,45,45,5,6,11,49.0,541.0,134,14,25,39,138.0,82,5.49,53,331,2294,9.8
19535,Mike Watt,2003-04,27.0,7,2,18,18,1,1,2,18.0,199.0,152,15,26,41,156.0,82,5.51,63,376,2272,9.9
19536,Mike Watt,2005-06,29.0,8,0,5,5,0,0,0,2.0,38.0,157,15,26,41,158.0,82,5.31,60,363,2326,9.4
19537,Mike Weaver,2004-05,26.0,4,1,16,16,0,1,1,9.0,222.0,16,0,1,1,9.0,82,5.24,53,338,2262,9.5
19538,Mike Weaver,2005-06,27.0,5,5,40,40,0,5,5,21.0,745.0,56,0,6,6,30.0,82,5.31,60,363,2326,9.4
19539,Mike Weaver,2006-07,28.0,6,0,1,1,0,0,0,0.0,8.0,57,0,6,6,30.0,82,5.14,57,348,2300,9.2
19540,Mike Weaver,2008-09,30.0,7,9,53,53,0,9,9,21.0,798.0,110,0,15,15,51.0,82,6.05,85,480,2458,10.1
19541,Mike Weaver,2009-10,31.0,8,9,39,39,3,6,9,22.0,598.0,149,3,21,24,73.0,82,5.76,70,398,2426,9.7
19542,Mike Weaver,2010-11,32.0,9,1,55,55,0,1,1,33.0,771.0,204,3,22,25,106.0,82,5.44,62,351,2383,9.4
19543,Mike Weaver,2011-12,33.0,10,7,58,58,0,7,7,36.0,1001.0,262,3,29,32,142.0,82,5.7,65,341,2477,9.4
19544,Mike Weaver,2012-13,34.0,11,10,77,77,1,9,10,33.0,1306.0,339,4,38,42,175.0,82,5.53,56,304,2486,9.1
19545,Mike Weaver,2013-14,35.0,12,13,82,82,2,11,13,53.0,1706.0,421,6,49,55,228.0,82,5.46,52,291,2492,9.0
19546,Mike Weaver,2014-15,36.0,13,16,82,82,0,16,16,51.0,1667.0,503,6,65,71,279.0,82,5.32,47,271,2439,8.9
19547,Mike Weaver,2015-16,37.0,14,9,27,27,1,8,9,21.0,544.0,530,7,73,80,300.0,48,5.31,29,160,1399,9.1
19548,Mike Weaver,2016-17,38.0,15,13,72,72,1,12,13,53.0,1331.0,602,8,85,93,353.0,82,5.34,48,269,2463,8.9
19549,Mike Weaver,2017-18,39.0,16,4,31,31,0,4,4,8.0,439.0,633,8,89,97,361.0,82,5.32,47,251,2453,8.9
19550,Mike Weber,2010-11,23.0,4,3,16,16,0,3,3,12.0,267.0,16,0,3,3,12.0,82,5.44,62,351,2383,9.4
19551,Mike Weber,2011-12,24.0,5,0,7,7,0,0,0,2.0,99.0,23,0,3,3,14.0,82,5.7,65,341,2477,9.4
19552,Mike Weber,2013-14,26.0,6,17,58,58,4,13,17,53.0,980.0,81,4,16,20,67.0,82,5.46,52,291,2492,9.0
19553,Mike Weber,2014-15,27.0,7,5,51,51,1,4,5,51.0,947.0,132,5,20,25,118.0,82,5.32,47,271,2439,8.9
19554,Mike Weber,2015-16,28.0,8,7,42,42,1,6,7,25.0,771.0,174,6,26,32,143.0,48,5.31,29,160,1399,9.1
19555,Mike Weber,2016-17,29.0,9,9,68,68,1,8,9,47.0,1212.0,242,7,34,41,190.0,82,5.34,48,269,2463,8.9
19556,Mike Weber,2017-18,30.0,10,7,64,64,1,6,7,41.0,1200.0,306,8,40,48,231.0,82,5.32,47,251,2453,8.9
19557,Mike Weber,2018-19,31.0,11,5,45,45,1,4,5,40.0,697.0,351,9,44,53,271.0,82,5.34,48,255,2438,9.0
19558,Mike Wilson,1998-99,23.0,4,12,58,58,4,8,12,52.0,,58,4,8,12,52.0,82,6.29,74,413,2481,10.4
19559,Mike Wilson,1999-00,24.0,5,11,77,77,2,9,11,57.0,,135,6,17,23,109.0,82,5.83,55,336,2444,9.8
19560,Mike Wilson,2000-01,25.0,6,8,66,66,4,4,8,52.0,,201,10,21,31,161.0,82,5.28,57,380,2242,9.6
19561,Mike Wilson,2001-02,26.0,7,3,34,34,1,2,3,48.0,578.0,235,11,23,34,209.0,82,5.27,57,359,2285,9.4
19562,Mike Wilson,2002-03,27.0,8,20,60,60,4,16,20,65.0,1087.0,295,15,39,54,274.0,82,5.49,53,331,2294,9.8
19563,Mike Wilson,2003-04,28.0,9,1,19,19,0,1,1,26.0,253.0,314,15,40,55,300.0,82,5.51,63,376,2272,9.9
19564,Mike Wilson,2004-05,29.0,10,2,21,21,1,1,2,14.0,312.0,335,16,41,57,314.0,82,5.24,53,338,2262,9.5
19565,Mike Wilson,2005-06,30.0,11,0,1,1,0,0,0,0.0,13.0,336,16,41,57,314.0,82,5.31,60,363,2326,9.4
19566,Mike York,2002-03,25.0,4,50,82,82,26,24,50,177.0,1299.0,82,26,24,50,177.0,82,5.49,53,331,2294,9.8
19567,Mike York,2003-04,26.0,5,31,79,79,14,17,31,171.0,1403.0,161,40,41,81,348.0,82,5.51,63,376,2272,9.9
19568,Mike York,2004-05,27.0,6,61,81,81,20,41,61,218.0,1607.0,242,60,82,142,566.0,82,5.24,53,338,2262,9.5
19569,Mike York,2005-06,28.0,7,51,71,71,22,29,51,177.0,1354.0,313,82,111,193,743.0,82,5.31,60,363,2326,9.4
19570,Mike York,2006-07,29.0,8,42,61,61,16,26,42,144.0,1176.0,374,98,137,235,887.0,82,5.14,57,348,2300,9.2
19571,Mike York,2008-09,31.0,9,52,75,75,13,39,52,146.0,1493.0,449,111,176,287,1033.0,82,6.05,85,480,2458,10.1
19572,Mike York,2009-10,32.0,10,21,66,66,10,11,21,87.0,825.0,515,121,187,308,1120.0,82,5.76,70,398,2426,9.7
19573,Mike York,2010-11,33.0,11,14,63,63,6,8,14,85.0,755.0,578,127,195,322,1205.0,82,5.44,62,351,2383,9.4
19574,Mike York,2011-12,34.0,12,0,1,1,0,0,0,1.0,13.0,579,127,195,322,1206.0,82,5.7,65,341,2477,9.4
19575,Mike Zigomanis,2005-06,25.0,4,3,19,19,2,1,3,19.0,185.0,19,2,1,3,19.0,82,5.31,60,363,2326,9.4
19576,Mike Zigomanis,2006-07,26.0,5,3,17,17,0,3,3,13.0,146.0,36,2,4,6,32.0,82,5.14,57,348,2300,9.2
19577,Mike Zigomanis,2008-09,28.0,6,1,23,23,1,0,1,17.0,213.0,59,3,4,7,49.0,82,6.05,85,480,2458,10.1
19578,Mike Zigomanis,2009-10,29.0,7,23,75,75,14,9,23,142.0,1116.0,134,17,13,30,191.0,82,5.76,70,398,2426,9.7
19579,Mike Zigomanis,2010-11,30.0,8,3,33,33,2,1,3,35.0,409.0,167,19,14,33,226.0,82,5.44,62,351,2383,9.4
19580,Mike Zigomanis,2011-12,31.0,9,6,22,22,2,4,6,23.0,251.0,189,21,18,39,249.0,82,5.7,65,341,2477,9.4
19581,Mike Zigomanis,2013-14,33.0,10,1,8,8,0,1,1,7.0,56.0,197,21,19,40,256.0,82,5.46,52,291,2492,9.0
19582,Mikhail Grabovski,2009-10,26.0,4,0,3,3,0,0,0,5.0,40.0,3,0,0,0,5.0,82,5.76,70,398,2426,9.7
19583,Mikhail Grabovski,2010-11,27.0,5,9,24,24,3,6,9,23.0,269.0,27,3,6,9,28.0,82,5.44,62,351,2383,9.4
19584,Mikhail Grabovski,2011-12,28.0,6,48,78,78,20,28,48,120.0,1265.0,105,23,34,57,148.0,82,5.7,65,341,2477,9.4
19585,Mikhail Grabovski,2012-13,29.0,7,35,59,59,10,25,35,126.0,991.0,164,33,59,92,274.0,82,5.53,56,304,2486,9.1
19586,Mikhail Grabovski,2013-14,30.0,8,58,81,81,29,29,58,239.0,1568.0,245,62,88,150,513.0,82,5.46,52,291,2492,9.0
19587,Mikhail Grabovski,2014-15,31.0,9,51,74,74,23,28,51,163.0,1303.0,319,85,116,201,676.0,82,5.32,47,271,2439,8.9
19588,Mikhail Grabovski,2015-16,32.0,10,16,48,48,9,7,16,80.0,747.0,367,94,123,217,756.0,48,5.31,29,160,1399,9.1
19589,Mikhail Grabovski,2016-17,33.0,11,35,58,58,13,22,35,81.0,914.0,425,107,145,252,837.0,82,5.34,48,269,2463,8.9
19590,Mikhail Grabovski,2017-18,34.0,12,19,51,51,9,10,19,81.0,728.0,476,116,155,271,918.0,82,5.32,47,251,2453,8.9
19591,Mikhail Grabovski,2018-19,35.0,13,25,58,58,9,16,25,83.0,818.0,534,125,171,296,1001.0,82,5.34,48,255,2438,9.0
19592,Mikhail Grigorenko,2015-16,21.0,4,5,25,25,1,4,5,31.0,256.0,25,1,4,5,31.0,48,5.31,29,160,1399,9.1
19593,Mikhail Grigorenko,2016-17,22.0,5,3,18,18,2,1,3,20.0,206.0,43,3,5,8,51.0,82,5.34,48,269,2463,8.9
19594,Mikhail Grigorenko,2017-18,23.0,6,6,25,25,3,3,6,35.0,379.0,68,6,8,14,86.0,82,5.32,47,251,2453,8.9
19595,Mikhail Grigorenko,2018-19,24.0,7,27,74,74,6,21,27,84.0,982.0,142,12,29,41,170.0,82,5.34,48,255,2438,9.0
19596,Mikhail Grigorenko,2019-20,25.0,8,23,75,75,10,13,23,85.0,1057.0,217,22,42,64,255.0,82,5.45,47,245,2478,9.0
19597,Mikhail Kravets,1994-95,31.0,4,0,1,1,0,0,0,2.0,,1,0,0,0,2.0,80,6.96,77,402,2440,11.4
19598,Mikhail Kravets,1995-96,32.0,5,0,1,1,0,0,0,0.0,,2,0,0,0,2.0,84,7.25,87,443,2603,11.7
19599,Mikhail Kuleshov,2006-07,26.0,4,0,3,3,0,0,0,4.0,34.0,3,0,0,0,4.0,82,5.14,57,348,2300,9.2
19600,Mikhail Sergachev,2019-20,21.0,4,0,4,4,0,0,0,2.0,49.0,4,0,0,0,2.0,82,5.45,47,245,2478,9.0
19601,Mikhail Sergachev,2020-21,22.0,5,40,79,79,9,31,40,141.0,1213.0,83,9,31,40,143.0,82,5.86,50,250,2620,9.2
19602,Mikhail Sergachev,2021-22,23.0,6,32,75,75,6,26,32,128.0,1344.0,158,15,57,72,271.0,82,5.96,47,239,2579,9.5
19603,Mikhail Sergachev,2022-23,24.0,7,34,70,70,10,24,34,118.0,1426.0,228,25,81,106,389.0,70,5.96,42,208,2192,9.5
19604,Mikhail Tatarinov,1993-94,27.0,4,23,65,65,8,15,23,145.0,,65,8,15,23,145.0,80,6.91,71,366,2385,11.6
19605,Mikhail Tatarinov,1994-95,28.0,5,38,66,66,11,27,38,191.0,,131,19,42,61,336.0,80,6.96,77,402,2440,11.4
19606,Mikhail Tatarinov,1995-96,29.0,6,8,28,28,2,6,8,46.0,,159,21,48,69,382.0,84,7.25,87,443,2603,11.7
19607,Mikhail Tatarinov,1996-97,30.0,7,0,2,2,0,0,0,4.0,,161,21,48,69,386.0,84,6.48,76,407,2545,10.7
19608,Mikhail Vorobyev,2021-22,25.0,4,2,15,15,1,1,2,10.0,140.0,15,1,1,2,10.0,82,5.96,47,239,2579,9.5
19609,Mikhail Vorobyev,2022-23,26.0,5,3,20,20,1,2,3,15.0,209.0,35,2,3,5,25.0,70,5.96,42,208,2192,9.5
19610,Mikhail Yakubov,2006-07,24.0,4,8,30,30,1,7,8,32.0,412.0,30,1,7,8,32.0,82,5.14,57,348,2300,9.2
19611,Mikhail Yakubov,2008-09,26.0,5,4,23,23,1,3,4,27.0,222.0,53,2,10,12,59.0,82,6.05,85,480,2458,10.1
19612,Mikkel Boedker,2011-12,22.0,4,28,78,78,11,17,28,116.0,1212.0,78,11,17,28,116.0,82,5.7,65,341,2477,9.4
19613,Mikkel Boedker,2012-13,23.0,5,3,14,14,1,2,3,7.0,122.0,92,12,19,31,123.0,82,5.53,56,304,2486,9.1
19614,Mikkel Boedker,2013-14,24.0,6,14,34,34,4,10,14,39.0,371.0,126,16,29,45,162.0,82,5.46,52,291,2492,9.0
19615,Mikkel Boedker,2014-15,25.0,7,24,82,82,11,13,24,86.0,1118.0,208,27,42,69,248.0,82,5.32,47,271,2439,8.9
19616,Mikkel Boedker,2015-16,26.0,8,26,48,48,7,19,26,83.0,887.0,256,34,61,95,331.0,48,5.31,29,160,1399,9.1
19617,Mikkel Boedker,2016-17,27.0,9,51,82,82,19,32,51,166.0,1428.0,338,53,93,146,497.0,82,5.34,48,269,2463,8.9
19618,Mikkel Boedker,2017-18,28.0,10,28,45,45,14,14,28,79.0,787.0,383,67,107,174,576.0,82,5.32,47,251,2453,8.9
19619,Mikkel Boedker,2018-19,29.0,11,51,80,80,17,34,51,166.0,1481.0,463,84,141,225,742.0,82,5.34,48,255,2438,9.0
19620,Mikkel Boedker,2019-20,30.0,12,26,81,81,10,16,26,122.0,1162.0,544,94,157,251,864.0,82,5.45,47,245,2478,9.0
19621,Mikkel Boedker,2020-21,31.0,13,37,74,74,15,22,37,119.0,988.0,618,109,179,288,983.0,82,5.86,50,250,2620,9.2
19622,Mikkel Boedker,2021-22,32.0,14,35,71,71,7,28,35,88.0,996.0,689,116,207,323,1071.0,82,5.96,47,239,2579,9.5
19623,Mikkel Boedker,2022-23,33.0,15,4,20,20,2,2,4,29.0,194.0,709,118,209,327,1100.0,70,5.96,42,208,2192,9.5
19624,Mikko Eloranta,2002-03,30.0,4,18,50,50,6,12,18,59.0,615.0,50,6,12,18,59.0,82,5.49,53,331,2294,9.8
19625,Mikko Eloranta,2003-04,31.0,5,23,62,62,12,11,23,89.0,647.0,112,18,23,41,148.0,82,5.51,63,376,2272,9.9
19626,Mikko Eloranta,2004-05,32.0,6,18,77,77,9,9,18,136.0,911.0,189,27,32,59,284.0,82,5.24,53,338,2262,9.5
19627,Mikko Eloranta,2005-06,33.0,7,17,75,75,5,12,17,96.0,962.0,264,32,44,76,380.0,82,5.31,60,363,2326,9.4
19628,Mikko Jokela,2005-06,25.0,4,0,1,1,0,0,0,3.0,5.0,1,0,0,0,3.0,82,5.31,60,363,2326,9.4
19629,Mikko Koivu,2008-09,25.0,4,21,64,64,6,15,21,96.0,850.0,64,6,15,21,96.0,82,6.05,85,480,2458,10.1
19630,Mikko Koivu,2009-10,26.0,5,54,82,82,20,34,54,162.0,1433.0,146,26,49,75,258.0,82,5.76,70,398,2426,9.7
19631,Mikko Koivu,2010-11,27.0,6,42,57,57,11,31,42,144.0,1191.0,203,37,80,117,402.0,82,5.44,62,351,2383,9.4
19632,Mikko Koivu,2011-12,28.0,7,67,79,79,20,47,67,236.0,1697.0,282,57,127,184,638.0,82,5.7,65,341,2477,9.4
19633,Mikko Koivu,2012-13,29.0,8,71,80,80,22,49,71,246.0,1660.0,362,79,176,255,884.0,82,5.53,56,304,2486,9.1
19634,Mikko Koivu,2013-14,30.0,9,62,71,71,17,45,62,191.0,1384.0,433,96,221,317,1075.0,82,5.46,52,291,2492,9.0
19635,Mikko Koivu,2014-15,31.0,10,44,55,55,12,32,44,129.0,1174.0,488,108,253,361,1204.0,82,5.32,47,271,2439,8.9
19636,Mikko Koivu,2015-16,32.0,11,37,48,48,11,26,37,127.0,1013.0,536,119,279,398,1331.0,48,5.31,29,160,1399,9.1
19637,Mikko Koivu,2016-17,33.0,12,54,65,65,11,43,54,147.0,1361.0,601,130,322,452,1478.0,82,5.34,48,269,2463,8.9
19638,Mikko Koivu,2017-18,34.0,13,48,80,80,14,34,48,179.0,1542.0,681,144,356,500,1657.0,82,5.32,47,251,2453,8.9
19639,Mikko Koivu,2018-19,35.0,14,56,82,82,17,39,56,141.0,1634.0,763,161,395,556,1798.0,82,5.34,48,255,2438,9.0
19640,Mikko Koivu,2019-20,36.0,15,58,80,80,18,40,58,139.0,1529.0,843,179,435,614,1937.0,82,5.45,47,245,2478,9.0
19641,Mikko Koivu,2020-21,37.0,16,45,82,82,14,31,45,170.0,1516.0,925,193,466,659,2107.0,82,5.86,50,250,2620,9.2
19642,Mikko Koivu,2021-22,38.0,17,29,48,48,8,21,29,89.0,878.0,973,201,487,688,2196.0,82,5.96,47,239,2579,9.5
19643,Mikko Koivu,2022-23,39.0,18,21,55,55,4,17,21,74.0,856.0,1028,205,504,709,2270.0,70,5.96,42,208,2192,9.5
19644,Mikko Lehtonen,2009-10,31.0,4,3,15,15,1,2,3,14.0,219.0,15,1,2,3,14.0,82,5.76,70,398,2426,9.7
19645,Mikko Lehtonen0,2011-12,24.0,4,0,1,1,0,0,0,1.0,16.0,1,0,0,0,1.0,82,5.7,65,341,2477,9.4
19646,Mikko Lehtonen0,2012-13,25.0,5,0,1,1,0,0,0,1.0,7.0,2,0,0,0,2.0,82,5.53,56,304,2486,9.1
19647,Mikko Leinonen,1984-85,29.0,4,31,53,53,11,20,31,68.0,,53,11,20,31,68.0,80,8.03,73,320,2489,12.9
19648,Mikko Leinonen,1985-86,30.0,5,51,78,78,17,34,51,134.0,,131,28,54,82,202.0,80,7.73,71,310,2444,12.7
19649,Mikko Leinonen,1986-87,31.0,6,26,28,28,3,23,26,39.0,,159,31,77,108,241.0,80,7.89,74,336,2448,12.9
19650,Mikko Leinonen,1987-88,32.0,7,1,3,3,0,1,1,5.0,,162,31,78,109,246.0,80,7.77,71,321,2447,12.7
19651,Mikko Luoma,2006-07,30.0,4,1,3,3,0,1,1,4.0,53.0,3,0,1,1,4.0,82,5.14,57,348,2300,9.2
19652,Mikko Makela,1988-89,23.0,4,36,58,58,16,20,36,68.0,,58,16,20,36,68.0,80,7.94,82,370,2484,12.8
19653,Mikko Makela,1989-90,24.0,5,57,80,80,24,33,57,142.0,,138,40,53,93,210.0,80,7.34,72,344,2400,12.2
19654,Mikko Makela,1990-91,25.0,6,76,73,73,36,40,76,142.0,,211,76,93,169,352.0,80,7.43,89,437,2435,12.2
19655,Mikko Makela,1991-92,26.0,7,45,76,76,17,28,45,123.0,,287,93,121,214,475.0,80,7.48,85,403,2430,12.3
19656,Mikko Makela,1992-93,27.0,8,26,65,65,9,17,26,82.0,,352,102,138,240,557.0,80,7.37,76,367,2421,12.2
19657,Mikko Makela,1993-94,28.0,9,22,60,60,15,7,22,62.0,,412,117,145,262,619.0,80,6.91,71,366,2385,11.6
19658,Mikko Makela,1997-98,32.0,10,3,11,11,1,2,3,10.0,,423,118,147,265,629.0,48,5.97,37,209,1408,10.2
19659,Mikko Rantanen,2018-19,22.0,4,0,9,9,0,0,0,9.0,81.0,9,0,0,0,9.0,82,5.34,48,255,2438,9.0
19660,Mikko Rantanen,2019-20,23.0,5,38,75,75,20,18,38,133.0,1354.0,84,20,18,38,142.0,82,5.45,47,245,2478,9.0
19661,Mikko Rantanen,2020-21,24.0,6,84,81,81,29,55,84,178.0,1536.0,165,49,73,122,320.0,82,5.86,50,250,2620,9.2
19662,Mikko Rantanen,2021-22,25.0,7,87,74,74,31,56,87,193.0,1542.0,239,80,129,209,513.0,82,5.96,47,239,2579,9.5
19663,Mikko Rantanen,2022-23,26.0,8,41,42,42,19,22,41,107.0,796.0,281,99,151,250,620.0,70,5.96,42,208,2192,9.5
19664,Milan Bartovic,2005-06,24.0,4,1,3,3,1,0,1,5.0,30.0,3,1,0,1,5.0,82,5.31,60,363,2326,9.4
19665,Milan Bartovic,2006-07,25.0,5,9,23,23,1,8,9,30.0,296.0,26,2,8,10,35.0,82,5.14,57,348,2300,9.2
19666,Milan Bartovic,2008-09,27.0,6,7,24,24,1,6,7,35.0,212.0,50,3,14,17,70.0,82,6.05,85,480,2458,10.1
19667,Milan Chalupa,1987-88,34.0,4,5,14,14,0,5,5,10.0,,14,0,5,5,10.0,80,7.77,71,321,2447,12.7
19668,Milan Hejduk,2001-02,25.0,4,48,82,82,14,34,48,178.0,1292.0,82,14,34,48,178.0,82,5.27,57,359,2285,9.4
19669,Milan Hejduk,2002-03,26.0,5,72,82,82,36,36,72,228.0,1638.0,164,50,70,120,406.0,82,5.49,53,331,2294,9.8
19670,Milan Hejduk,2003-04,27.0,6,79,80,80,41,38,79,213.0,1589.0,244,91,108,199,619.0,82,5.51,63,376,2272,9.9
19671,Milan Hejduk,2004-05,28.0,7,44,62,62,21,23,44,139.0,1252.0,306,112,131,243,758.0,82,5.24,53,338,2262,9.5
19672,Milan Hejduk,2005-06,29.0,8,98,82,82,50,48,98,244.0,1627.0,388,162,179,341,1002.0,82,5.31,60,363,2326,9.4
19673,Milan Hejduk,2006-07,30.0,9,75,82,82,35,40,75,237.0,1539.0,470,197,219,416,1239.0,82,5.14,57,348,2300,9.2
19674,Milan Hejduk,2008-09,32.0,10,58,74,74,24,34,58,221.0,1373.0,544,221,253,474,1460.0,82,6.05,85,480,2458,10.1
19675,Milan Hejduk,2009-10,33.0,11,70,80,80,35,35,70,257.0,1430.0,624,256,288,544,1717.0,82,5.76,70,398,2426,9.7
19676,Milan Hejduk,2010-11,34.0,12,54,77,77,29,25,54,205.0,1490.0,701,285,313,598,1922.0,82,5.44,62,351,2383,9.4
19677,Milan Hejduk,2011-12,35.0,13,59,82,82,27,32,59,211.0,1634.0,783,312,345,657,2133.0,82,5.7,65,341,2477,9.4
19678,Milan Hejduk,2012-13,36.0,14,44,56,56,23,21,44,153.0,1065.0,839,335,366,701,2286.0,82,5.53,56,304,2486,9.1
19679,Milan Hejduk,2013-14,37.0,15,56,71,71,22,34,56,170.0,1273.0,910,357,400,757,2456.0,82,5.46,52,291,2492,9.0
19680,Milan Hejduk,2014-15,38.0,16,37,81,81,14,23,37,170.0,1378.0,991,371,423,794,2626.0,82,5.32,47,271,2439,8.9
19681,Milan Hejduk,2015-16,39.0,17,11,29,29,4,7,11,41.0,381.0,1020,375,430,805,2667.0,48,5.31,29,160,1399,9.1
19682,Milan Jurcina,2008-09,25.0,4,11,51,51,6,5,11,64.0,840.0,51,6,5,11,64.0,82,6.05,85,480,2458,10.1
19683,Milan Jurcina,2009-10,26.0,5,12,70,70,4,8,12,71.0,1122.0,121,10,13,23,135.0,82,5.76,70,398,2426,9.7
19684,Milan Jurcina,2010-11,27.0,6,9,75,75,1,8,9,58.0,1248.0,196,11,21,32,193.0,82,5.44,62,351,2383,9.4
19685,Milan Jurcina,2011-12,28.0,7,14,79,79,3,11,14,95.0,1276.0,275,14,32,46,288.0,82,5.7,65,341,2477,9.4
19686,Milan Jurcina,2012-13,29.0,8,7,44,44,1,6,7,49.0,777.0,319,15,38,53,337.0,82,5.53,56,304,2486,9.1
19687,Milan Jurcina,2013-14,30.0,9,17,46,46,4,13,17,76.0,831.0,365,19,51,70,413.0,82,5.46,52,291,2492,9.0
19688,Milan Jurcina,2014-15,31.0,10,11,65,65,3,8,11,127.0,1221.0,430,22,59,81,540.0,82,5.32,47,271,2439,8.9
19689,Milan Kraft,2003-04,24.0,4,14,42,42,7,7,14,63.0,491.0,42,7,7,14,63.0,82,5.51,63,376,2272,9.9
19690,Milan Kraft,2004-05,25.0,5,16,68,68,8,8,16,103.0,849.0,110,15,15,30,166.0,82,5.24,53,338,2262,9.5
19691,Milan Kraft,2005-06,26.0,6,12,31,31,7,5,12,50.0,432.0,141,22,20,42,216.0,82,5.31,60,363,2326,9.4
19692,Milan Kraft,2006-07,27.0,7,40,66,66,19,21,40,134.0,1008.0,207,41,41,82,350.0,82,5.14,57,348,2300,9.2
19693,Milan Kytnar,2014-15,25.0,4,0,1,1,0,0,0,1.0,6.0,1,0,0,0,1.0,82,5.32,47,271,2439,8.9
19694,Milan Lucic,2010-11,22.0,4,27,77,77,8,19,27,88.0,933.0,77,8,19,27,88.0,82,5.44,62,351,2383,9.4
19695,Milan Lucic,2011-12,23.0,5,42,72,72,17,25,42,97.0,1076.0,149,25,44,69,185.0,82,5.7,65,341,2477,9.4
19696,Milan Lucic,2012-13,24.0,6,20,50,50,9,11,20,72.0,718.0,199,34,55,89,257.0,82,5.53,56,304,2486,9.1
19697,Milan Lucic,2013-14,25.0,7,62,79,79,30,32,62,173.0,1310.0,278,64,87,151,430.0,82,5.46,52,291,2492,9.0
19698,Milan Lucic,2014-15,26.0,8,61,81,81,26,35,61,149.0,1379.0,359,90,122,212,579.0,82,5.32,47,271,2439,8.9
19699,Milan Lucic,2015-16,27.0,9,27,46,46,7,20,27,79.0,778.0,405,97,142,239,658.0,48,5.31,29,160,1399,9.1
19700,Milan Lucic,2016-17,28.0,10,59,80,80,24,35,59,153.0,1390.0,485,121,177,298,811.0,82,5.34,48,269,2463,8.9
19701,Milan Lucic,2017-18,29.0,11,44,81,81,18,26,44,141.0,1325.0,566,139,203,342,952.0,82,5.32,47,251,2453,8.9
19702,Milan Lucic,2018-19,30.0,12,55,81,81,20,35,55,124.0,1396.0,647,159,238,397,1076.0,82,5.34,48,255,2438,9.0
19703,Milan Lucic,2019-20,31.0,13,50,82,82,23,27,50,175.0,1407.0,729,182,265,447,1251.0,82,5.45,47,245,2478,9.0
19704,Milan Lucic,2020-21,32.0,14,34,82,82,10,24,34,147.0,1309.0,811,192,289,481,1398.0,82,5.86,50,250,2620,9.2
19705,Milan Lucic,2021-22,33.0,15,20,79,79,6,14,20,74.0,1046.0,890,198,303,501,1472.0,82,5.96,47,239,2579,9.5
19706,Milan Lucic,2022-23,34.0,16,20,68,68,8,12,20,83.0,907.0,958,206,315,521,1555.0,70,5.96,42,208,2192,9.5
19707,Milan Michalek,2006-07,22.0,4,1,2,2,1,0,1,1.0,18.0,2,1,0,1,1.0,82,5.14,57,348,2300,9.2
19708,Milan Michalek,2008-09,24.0,5,35,81,81,17,18,35,159.0,1277.0,83,18,18,36,160.0,82,6.05,85,480,2458,10.1
19709,Milan Michalek,2009-10,25.0,6,66,78,78,26,40,66,191.0,1307.0,161,44,58,102,351.0,82,5.76,70,398,2426,9.7
19710,Milan Michalek,2010-11,26.0,7,55,79,79,24,31,55,233.0,1428.0,240,68,89,157,584.0,82,5.44,62,351,2383,9.4
19711,Milan Michalek,2011-12,27.0,8,57,77,77,23,34,57,179.0,1421.0,317,91,123,214,763.0,82,5.7,65,341,2477,9.4
19712,Milan Michalek,2012-13,28.0,9,34,66,66,22,12,34,163.0,1205.0,383,113,135,248,926.0,82,5.53,56,304,2486,9.1
19713,Milan Michalek,2013-14,29.0,10,33,66,66,18,15,33,167.0,1192.0,449,131,150,281,1093.0,82,5.46,52,291,2492,9.0
19714,Milan Michalek,2014-15,30.0,11,60,77,77,35,25,60,212.0,1506.0,526,166,175,341,1305.0,82,5.32,47,271,2439,8.9
19715,Milan Michalek,2015-16,31.0,12,14,23,23,4,10,14,58.0,418.0,549,170,185,355,1363.0,48,5.31,29,160,1399,9.1
19716,Milan Michalek,2016-17,32.0,13,39,82,82,17,22,39,169.0,1442.0,631,187,207,394,1532.0,82,5.34,48,269,2463,8.9
19717,Milan Michalek,2017-18,33.0,14,34,66,66,13,21,34,130.0,1080.0,697,200,228,428,1662.0,82,5.32,47,251,2453,8.9
19718,Milan Michalek,2018-19,34.0,15,16,45,45,7,9,16,64.0,725.0,742,207,237,444,1726.0,82,5.34,48,255,2438,9.0
19719,Milan Michalek,2019-20,35.0,16,2,5,5,1,1,2,6.0,71.0,747,208,238,446,1732.0,82,5.45,47,245,2478,9.0
19720,Milan Novy,1985-86,34.0,4,48,73,73,18,30,48,132.0,,73,18,30,48,132.0,80,7.73,71,310,2444,12.7
19721,Milan Tichy,1995-96,26.0,4,1,13,13,0,1,1,12.0,,13,0,1,1,12.0,84,7.25,87,443,2603,11.7
19722,Milan Tichy,1997-98,28.0,5,0,2,2,0,0,0,1.0,,15,0,1,1,13.0,48,5.97,37,209,1408,10.2
19723,Milan Tichy,1998-99,29.0,6,4,8,8,0,4,4,6.0,,23,0,5,5,19.0,82,6.29,74,413,2481,10.4
19724,Miles Wood,2018-19,23.0,4,0,1,1,0,0,0,2.0,13.0,1,0,0,0,2.0,82,5.34,48,255,2438,9.0
19725,Miles Wood,2019-20,24.0,5,17,60,60,8,9,17,105.0,771.0,61,8,9,17,107.0,82,5.45,47,245,2478,9.0
19726,Miles Wood,2020-21,25.0,6,32,76,76,19,13,32,170.0,947.0,137,27,22,49,277.0,82,5.86,50,250,2620,9.2
19727,Miles Wood,2021-22,26.0,7,24,63,63,10,14,24,159.0,863.0,200,37,36,73,436.0,82,5.96,47,239,2579,9.5
19728,Miles Wood,2022-23,27.0,8,23,68,68,11,12,23,141.0,900.0,268,48,48,96,577.0,70,5.96,42,208,2192,9.5
19729,Milos Holan,1996-97,25.0,4,2,8,8,1,1,2,26.0,,8,1,1,2,26.0,84,6.48,76,407,2545,10.7
19730,Milos Holan,1997-98,26.0,5,10,25,25,2,8,10,93.0,,33,3,9,12,119.0,48,5.97,37,209,1408,10.2
19731,Milos Holan,1998-99,27.0,6,4,16,16,2,2,4,47.0,,49,5,11,16,166.0,82,6.29,74,413,2481,10.4
19732,Miloslav Guren,2001-02,25.0,4,1,12,12,0,1,1,11.0,144.0,12,0,1,1,11.0,82,5.27,57,359,2285,9.4
19733,Miloslav Guren,2002-03,26.0,5,3,24,24,1,2,3,20.0,366.0,36,1,3,4,31.0,82,5.49,53,331,2294,9.8
19734,Miloslav Horava,1991-92,30.0,4,1,6,6,0,1,1,7.0,,6,0,1,1,7.0,80,7.48,85,403,2430,12.3
19735,Miloslav Horava,1992-93,31.0,5,14,45,45,4,10,14,50.0,,51,4,11,15,57.0,80,7.37,76,367,2421,12.2
19736,Miloslav Horava,1993-94,32.0,6,7,29,29,1,6,7,27.0,,80,5,17,22,84.0,80,6.91,71,366,2385,11.6
19737,Mirco Mueller,2017-18,22.0,4,4,39,39,1,3,4,31.0,661.0,39,1,3,4,31.0,82,5.32,47,251,2453,8.9
19738,Mirco Mueller,2018-19,23.0,5,0,11,11,0,0,0,8.0,117.0,50,1,3,4,39.0,82,5.34,48,255,2438,9.0
19739,Mirco Mueller,2019-20,24.0,6,2,4,4,1,1,2,3.0,38.0,54,2,4,6,42.0,82,5.45,47,245,2478,9.0
19740,Mirco Mueller,2020-21,25.0,7,4,28,28,0,4,4,19.0,467.0,82,2,8,10,61.0,82,5.86,50,250,2620,9.2
19741,Mirco Mueller,2021-22,26.0,8,11,53,53,1,10,11,39.0,958.0,135,3,18,21,100.0,82,5.96,47,239,2579,9.5
19742,Mirco Mueller,2022-23,27.0,9,7,50,50,2,5,7,29.0,882.0,185,5,23,28,129.0,70,5.96,42,208,2192,9.5
19743,Miro Heiskanen,2021-22,22.0,4,33,82,82,12,21,33,182.0,1895.0,82,12,21,33,182.0,82,5.96,47,239,2579,9.5
19744,Miro Heiskanen,2022-23,23.0,5,35,68,68,8,27,35,163.0,1616.0,150,20,48,68,345.0,70,5.96,42,208,2192,9.5
19745,Miroslav Dvorak,1985-86,34.0,4,37,80,80,4,33,37,112.0,,80,4,33,37,112.0,80,7.73,71,310,2444,12.7
19746,Miroslav Dvorak,1986-87,35.0,5,31,66,66,4,27,31,85.0,,146,8,60,68,197.0,80,7.89,74,336,2448,12.9
19747,Miroslav Dvorak,1987-88,36.0,6,17,47,47,3,14,17,52.0,,193,11,74,85,249.0,80,7.77,71,321,2447,12.7
19748,Miroslav Frycer,1984-85,25.0,4,47,59,59,24,23,47,112.0,,59,24,23,47,112.0,80,8.03,73,320,2489,12.9
19749,Miroslav Frycer,1985-86,26.0,5,55,67,67,25,30,55,133.0,,126,49,53,102,245.0,80,7.73,71,310,2444,12.7
19750,Miroslav Frycer,1986-87,27.0,6,26,47,47,10,16,26,83.0,,173,59,69,128,328.0,80,7.89,74,336,2448,12.9
19751,Miroslav Frycer,1987-88,28.0,7,55,65,65,25,30,55,183.0,,238,84,99,183,511.0,80,7.77,71,321,2447,12.7
19752,Miroslav Frycer,1988-89,29.0,8,75,73,73,32,43,75,201.0,,311,116,142,258,712.0,80,7.94,82,370,2484,12.8
19753,Miroslav Frycer,1989-90,30.0,9,15,29,29,7,8,15,52.0,,340,123,150,273,764.0,80,7.34,72,344,2400,12.2
19754,Miroslav Frycer,1990-91,31.0,10,32,38,38,12,20,32,76.0,,378,135,170,305,840.0,80,7.43,89,437,2435,12.2
19755,Miroslav Frycer,1991-92,32.0,11,25,37,37,12,13,25,73.0,,415,147,183,330,913.0,80,7.48,85,403,2430,12.3
19756,Miroslav Ihnacak,1988-89,26.0,4,6,21,21,2,4,6,25.0,,21,2,4,6,25.0,80,7.94,82,370,2484,12.8
19757,Miroslav Ihnacak,1989-90,27.0,5,11,34,34,6,5,11,65.0,,55,8,9,17,90.0,80,7.34,72,344,2400,12.2
19758,Miroslav Ihnacak,1991-92,29.0,6,0,1,1,0,0,0,1.0,,56,8,9,17,91.0,80,7.48,85,403,2430,12.3
19759,Miroslav Satan,1998-99,24.0,4,35,62,62,18,17,35,113.0,,62,18,17,35,113.0,82,6.29,74,413,2481,10.4
19760,Miroslav Satan,1999-00,25.0,5,38,76,76,25,13,38,119.0,,138,43,30,73,232.0,82,5.83,55,336,2444,9.8
19761,Miroslav Satan,2000-01,26.0,6,46,79,79,22,24,46,139.0,,217,65,54,119,371.0,82,5.28,57,380,2242,9.6
19762,Miroslav Satan,2001-02,27.0,7,66,81,81,40,26,66,208.0,1686.0,298,105,80,185,579.0,82,5.27,57,359,2285,9.4
19763,Miroslav Satan,2002-03,28.0,8,67,81,81,33,34,67,265.0,1667.0,379,138,114,252,844.0,82,5.49,53,331,2294,9.8
19764,Miroslav Satan,2003-04,29.0,9,62,82,82,29,33,62,206.0,1635.0,461,167,147,314,1050.0,82,5.51,63,376,2272,9.9
19765,Miroslav Satan,2004-05,30.0,10,73,82,82,37,36,73,267.0,1735.0,543,204,183,387,1317.0,82,5.24,53,338,2262,9.5
19766,Miroslav Satan,2005-06,31.0,11,75,79,79,26,49,75,240.0,1690.0,622,230,232,462,1557.0,82,5.31,60,363,2326,9.4
19767,Miroslav Satan,2006-07,32.0,12,57,82,82,29,28,57,206.0,1643.0,704,259,260,519,1763.0,82,5.14,57,348,2300,9.2
19768,Miroslav Satan,2008-09,34.0,13,66,82,82,35,31,66,253.0,1572.0,786,294,291,585,2016.0,82,6.05,85,480,2458,10.1
19769,Miroslav Satan,2009-10,35.0,14,59,81,81,27,32,59,216.0,1505.0,867,321,323,644,2232.0,82,5.76,70,398,2426,9.7
19770,Miroslav Satan,2010-11,36.0,15,41,80,80,16,25,41,171.0,1466.0,947,337,348,685,2403.0,82,5.44,62,351,2383,9.4
19771,Miroslav Satan,2011-12,37.0,16,36,65,65,17,19,36,120.0,1024.0,1012,354,367,721,2523.0,82,5.7,65,341,2477,9.4
19772,Miroslav Satan,2012-13,38.0,17,14,38,38,9,5,14,59.0,599.0,1050,363,372,735,2582.0,82,5.53,56,304,2486,9.1
19773,Miroslav Zalesak,2005-06,26.0,4,3,10,10,1,2,3,8.0,95.0,10,1,2,3,8.0,82,5.31,60,363,2326,9.4
19774,Miroslav Zalesak,2006-07,27.0,5,0,2,2,0,0,0,3.0,24.0,12,1,2,3,11.0,82,5.14,57,348,2300,9.2
19775,Mitch Callahan,2016-17,25.0,4,0,1,1,0,0,0,0.0,9.0,1,0,0,0,0.0,82,5.34,48,269,2463,8.9
19776,Mitch Callahan,2019-20,28.0,5,0,4,4,0,0,0,2.0,27.0,5,0,0,0,2.0,82,5.45,47,245,2478,9.0
19777,Mitch Fritz,2011-12,31.0,4,0,20,20,0,0,0,2.0,54.0,20,0,0,0,2.0,82,5.7,65,341,2477,9.4
19778,Mitch Lamoureux,1986-87,24.0,4,2,8,8,1,1,2,13.0,,8,1,1,2,13.0,80,7.89,74,336,2448,12.9
19779,Mitch Lamoureux,1987-88,25.0,5,18,62,62,10,8,18,81.0,,70,11,9,20,94.0,80,7.77,71,321,2447,12.7
19780,Mitch Lamoureux,1990-91,28.0,6,0,3,3,0,0,0,1.0,,73,11,9,20,95.0,80,7.43,89,437,2435,12.2
19781,Mitch Marner,2019-20,22.0,4,61,77,77,19,42,61,176.0,1294.0,77,19,42,61,176.0,82,5.45,47,245,2478,9.0
19782,Mitch Marner,2020-21,23.0,5,69,82,82,22,47,69,194.0,1344.0,159,41,89,130,370.0,82,5.86,50,250,2620,9.2
19783,Mitch Marner,2021-22,24.0,6,94,82,82,26,68,94,233.0,1625.0,241,67,157,224,603.0,82,5.96,47,239,2579,9.5
19784,Mitch Marner,2022-23,25.0,7,67,59,59,16,51,67,154.0,1272.0,300,83,208,291,757.0,70,5.96,42,208,2192,9.5
19785,Mitch Messier,1990-91,25.0,4,1,13,13,0,1,1,5.0,,13,0,1,1,5.0,80,7.43,89,437,2435,12.2
19786,Mitch Messier,1991-92,26.0,5,1,3,3,0,1,1,3.0,,16,0,2,2,8.0,80,7.48,85,403,2430,12.3
19787,Mitch Messier,1992-93,27.0,6,0,2,2,0,0,0,1.0,,18,0,2,2,9.0,80,7.37,76,367,2421,12.2
19788,Mitch Messier,1993-94,28.0,7,0,2,2,0,0,0,0.0,,20,0,2,2,9.0,80,6.91,71,366,2385,11.6
19789,Mitch Molloy,1992-93,26.0,4,0,2,2,0,0,0,0.0,,2,0,0,0,0.0,80,7.37,76,367,2421,12.2
19790,Mitch Reinke,2020-21,24.0,4,0,1,1,0,0,0,1.0,13.0,1,0,0,0,1.0,82,5.86,50,250,2620,9.2
19791,Mitch Wilson,1987-88,25.0,4,2,9,9,0,2,2,7.0,,9,0,2,2,7.0,80,7.77,71,321,2447,12.7
19792,Mitch Wilson,1989-90,27.0,5,3,17,17,2,1,3,7.0,,26,2,3,5,14.0,80,7.34,72,344,2400,12.2
19793,Mitchell Stephens,2022-23,25.0,4,6,38,38,3,3,6,43.0,410.0,38,3,3,6,43.0,70,5.96,42,208,2192,9.5
19794,Moe Lemay,1984-85,22.0,4,3,5,5,1,2,3,14.0,,5,1,2,3,14.0,80,8.03,73,320,2489,12.9
19795,Moe Lemay,1985-86,23.0,5,20,44,44,11,9,20,74.0,,49,12,11,23,88.0,80,7.73,71,310,2444,12.7
19796,Moe Lemay,1986-87,24.0,6,30,56,56,12,18,30,109.0,,105,24,29,53,197.0,80,7.89,74,336,2448,12.9
19797,Moe Lemay,1987-88,25.0,7,52,74,74,21,31,52,162.0,,179,45,60,105,359.0,80,7.77,71,321,2447,12.7
19798,Moe Lemay,1988-89,26.0,8,31,48,48,16,15,31,112.0,,227,61,75,136,471.0,80,7.94,82,370,2484,12.8
19799,Moe Lemay,1989-90,27.0,9,29,62,62,10,19,29,94.0,,289,71,94,165,565.0,80,7.34,72,344,2400,12.2
19800,Moe Lemay,1990-91,28.0,10,0,6,6,0,0,0,7.0,,295,71,94,165,572.0,80,7.43,89,437,2435,12.2
19801,Moe Lemay,1991-92,29.0,11,1,22,22,1,0,1,21.0,,317,72,94,166,593.0,80,7.48,85,403,2430,12.3
19802,Moe Mantha,1983-84,23.0,4,25,58,58,2,23,25,94.0,,58,2,23,25,94.0,80,7.69,77,340,2441,12.6
19803,Moe Mantha,1984-85,24.0,5,12,25,25,0,12,12,39.0,,83,2,35,37,133.0,80,8.03,73,320,2489,12.9
19804,Moe Mantha,1985-86,25.0,6,9,21,21,2,7,9,27.0,,104,4,42,46,160.0,80,7.73,71,310,2444,12.7
19805,Moe Mantha,1986-87,26.0,7,54,72,72,16,38,54,230.0,,176,20,80,100,390.0,80,7.89,74,336,2448,12.9
19806,Moe Mantha,1987-88,27.0,8,51,71,71,11,40,51,205.0,,247,31,120,151,595.0,80,7.77,71,321,2447,12.7
19807,Moe Mantha,1988-89,28.0,9,67,78,78,15,52,67,224.0,,325,46,172,218,819.0,80,7.94,82,370,2484,12.8
19808,Moe Mantha,1989-90,29.0,10,40,62,62,9,31,40,167.0,,387,55,203,258,986.0,80,7.34,72,344,2400,12.2
19809,Moe Mantha,1990-91,30.0,11,38,76,76,11,27,38,223.0,,463,66,230,296,1209.0,80,7.43,89,437,2435,12.2
19810,Moe Mantha,1991-92,31.0,12,18,46,46,4,14,18,103.0,,509,70,244,314,1312.0,80,7.48,85,403,2430,12.3
19811,Moe Mantha,1992-93,32.0,13,28,73,73,2,26,28,114.0,,582,72,270,342,1426.0,80,7.37,76,367,2421,12.2
19812,Moe Mantha,1993-94,33.0,14,24,57,57,9,15,24,102.0,,639,81,285,366,1528.0,80,6.91,71,366,2385,11.6
19813,Moe Mantha,1994-95,34.0,15,4,17,17,0,4,4,17.0,,656,81,289,370,1545.0,80,6.96,77,402,2440,11.4
19814,Moe Robinson,1982-83,25.0,4,0,1,1,0,0,0,0.0,,1,0,0,0,0.0,80,7.03,61,280,2352,12.0
19815,Morgan Ellis,2018-19,26.0,4,0,3,3,0,0,0,3.0,27.0,3,0,0,0,3.0,82,5.34,48,255,2438,9.0
19816,Morgan Frost,2022-23,23.0,4,7,20,20,2,5,7,31.0,274.0,20,2,5,7,31.0,70,5.96,42,208,2192,9.5
19817,Morgan Geekie,2022-23,24.0,4,4,2,2,3,1,4,4.0,24.0,2,3,1,4,4.0,70,5.96,42,208,2192,9.5
19818,Morgan Klimchuk,2020-21,25.0,4,0,1,1,0,0,0,0.0,7.0,1,0,0,0,0.0,82,5.86,50,250,2620,9.2
19819,Morgan Rielly,2016-17,22.0,4,27,73,73,2,25,27,96.0,1287.0,73,2,25,27,96.0,82,5.34,48,269,2463,8.9
19820,Morgan Rielly,2017-18,23.0,5,29,81,81,8,21,29,148.0,1647.0,154,10,46,56,244.0,82,5.32,47,251,2453,8.9
19821,Morgan Rielly,2018-19,24.0,6,36,82,82,9,27,36,167.0,1905.0,236,19,73,92,411.0,82,5.34,48,255,2438,9.0
19822,Morgan Rielly,2019-20,25.0,7,27,76,76,6,21,27,171.0,1685.0,312,25,94,119,582.0,82,5.45,47,245,2478,9.0
19823,Morgan Rielly,2020-21,26.0,8,52,76,76,6,46,52,182.0,1642.0,388,31,140,171,764.0,82,5.86,50,250,2620,9.2
19824,Morgan Rielly,2021-22,27.0,9,72,82,82,20,52,72,223.0,1896.0,470,51,192,243,987.0,82,5.96,47,239,2579,9.5
19825,Morgan Rielly,2022-23,28.0,10,27,47,47,3,24,27,123.0,1137.0,517,54,216,270,1110.0,70,5.96,42,208,2192,9.5
19826,Morris Lukowich,1982-83,26.0,4,74,78,78,35,39,74,201.0,,78,35,39,74,201.0,80,7.03,61,280,2352,12.0
19827,Morris Lukowich,1983-84,27.0,5,67,80,80,33,34,67,175.0,,158,68,73,141,376.0,80,7.69,77,340,2441,12.6
19828,Morris Lukowich,1984-85,28.0,6,92,77,77,43,49,92,229.0,,235,111,122,233,605.0,80,8.03,73,320,2489,12.9
19829,Morris Lukowich,1985-86,29.0,7,43,69,69,22,21,43,162.0,,304,133,143,276,767.0,80,7.73,71,310,2444,12.7
19830,Morris Lukowich,1986-87,30.0,8,55,80,80,30,25,55,155.0,,384,163,168,331,922.0,80,7.89,74,336,2448,12.9
19831,Morris Lukowich,1987-88,31.0,9,27,69,69,10,17,27,66.0,,453,173,185,358,988.0,80,7.77,71,321,2447,12.7
19832,Morris Lukowich,1988-89,32.0,10,25,69,69,12,13,25,110.0,,522,185,198,383,1098.0,80,7.94,82,370,2484,12.8
19833,Morris Lukowich,1989-90,33.0,11,35,60,60,14,21,35,105.0,,582,199,219,418,1203.0,80,7.34,72,344,2400,12.2
19834,Murray Baron,1992-93,25.0,4,4,16,16,2,2,4,18.0,,16,2,2,4,18.0,80,7.37,76,367,2421,12.2
19835,Murray Baron,1993-94,26.0,5,16,67,67,8,8,16,86.0,,83,10,10,20,104.0,80,6.91,71,366,2385,11.6
19836,Murray Baron,1994-95,27.0,6,11,67,67,3,8,11,55.0,,150,13,18,31,159.0,80,6.96,77,402,2440,11.4
19837,Murray Baron,1995-96,28.0,7,4,53,53,2,2,4,42.0,,203,15,20,35,201.0,84,7.25,87,443,2603,11.7
19838,Murray Baron,1996-97,29.0,8,14,77,77,5,9,14,73.0,,280,20,29,49,274.0,84,6.48,76,407,2545,10.7
19839,Murray Baron,1997-98,30.0,9,5,39,39,0,5,5,28.0,,319,20,34,54,302.0,48,5.97,37,209,1408,10.2
19840,Murray Baron,1998-99,31.0,10,11,82,82,2,9,11,86.0,,401,22,43,65,388.0,82,6.29,74,413,2481,10.4
19841,Murray Baron,1999-00,32.0,11,8,79,79,1,7,8,64.0,,480,23,50,73,452.0,82,5.83,55,336,2444,9.8
19842,Murray Baron,2000-01,33.0,12,6,45,45,1,5,6,23.0,,525,24,55,79,475.0,82,5.28,57,380,2242,9.6
19843,Murray Baron,2001-02,34.0,13,8,81,81,2,6,8,53.0,1477.0,606,26,61,87,528.0,82,5.27,57,359,2285,9.4
19844,Murray Baron,2002-03,35.0,14,12,81,81,2,10,12,48.0,1750.0,687,28,71,99,576.0,82,5.49,53,331,2294,9.8
19845,Murray Baron,2003-04,36.0,15,11,82,82,3,8,11,56.0,1591.0,769,31,79,110,632.0,82,5.51,63,376,2272,9.9
19846,Murray Baron,2004-05,37.0,16,7,61,61,1,6,7,38.0,1034.0,830,32,85,117,670.0,82,5.24,53,338,2262,9.5
19847,Murray Baron,2005-06,38.0,17,6,78,78,2,4,6,34.0,1327.0,908,34,89,123,704.0,82,5.31,60,363,2326,9.4
19848,Murray Baron,2006-07,39.0,18,6,80,80,1,5,6,57.0,1538.0,988,35,94,129,761.0,82,5.14,57,348,2300,9.2
19849,Murray Brumwell,1983-84,23.0,4,0,1,1,0,0,0,0.0,,1,0,0,0,0.0,80,7.69,77,340,2441,12.6
19850,Murray Brumwell,1984-85,24.0,5,3,21,21,0,3,3,12.0,,22,0,3,3,12.0,80,8.03,73,320,2489,12.9
19851,Murray Brumwell,1985-86,25.0,6,19,59,59,5,14,19,61.0,,81,5,17,22,73.0,80,7.73,71,310,2444,12.7
19852,Murray Brumwell,1986-87,26.0,7,20,42,42,7,13,20,55.0,,123,12,30,42,128.0,80,7.89,74,336,2448,12.9
19853,Murray Brumwell,1988-89,28.0,8,0,1,1,0,0,0,3.0,,124,12,30,42,131.0,80,7.94,82,370,2484,12.8
19854,Murray Brumwell,1989-90,29.0,9,0,1,1,0,0,0,2.0,,125,12,30,42,133.0,80,7.34,72,344,2400,12.2
19855,Murray Brumwell,1990-91,30.0,10,1,3,3,0,1,1,4.0,,128,12,31,43,137.0,80,7.43,89,437,2435,12.2
19856,Murray Craven,1985-86,21.0,4,11,31,31,4,7,11,21.0,,31,4,7,11,21.0,80,7.73,71,310,2444,12.7
19857,Murray Craven,1986-87,22.0,5,4,15,15,0,4,4,8.0,,46,4,11,15,29.0,80,7.89,74,336,2448,12.9
19858,Murray Craven,1987-88,23.0,6,61,80,80,26,35,61,145.0,,126,30,46,76,174.0,80,7.77,71,321,2447,12.7
19859,Murray Craven,1988-89,24.0,7,54,78,78,21,33,54,182.0,,204,51,79,130,356.0,80,7.94,82,370,2484,12.8
19860,Murray Craven,1989-90,25.0,8,49,77,77,19,30,49,100.0,,281,70,109,179,456.0,80,7.34,72,344,2400,12.2
19861,Murray Craven,1990-91,26.0,9,76,72,72,30,46,76,184.0,,353,100,155,255,640.0,80,7.43,89,437,2435,12.2
19862,Murray Craven,1991-92,27.0,10,37,51,51,9,28,37,89.0,,404,109,183,292,729.0,80,7.48,85,403,2430,12.3
19863,Murray Craven,1992-93,28.0,11,75,76,76,25,50,75,175.0,,480,134,233,367,904.0,80,7.37,76,367,2421,12.2
19864,Murray Craven,1993-94,29.0,12,66,77,77,19,47,66,170.0,,557,153,280,433,1074.0,80,6.91,71,366,2385,11.6
19865,Murray Craven,1994-95,30.0,13,60,73,73,27,33,60,152.0,,630,180,313,493,1226.0,80,6.96,77,402,2440,11.4
19866,Murray Craven,1995-96,31.0,14,77,77,77,25,52,77,151.0,,707,205,365,570,1377.0,84,7.25,87,443,2603,11.7
19867,Murray Craven,1996-97,32.0,15,55,78,78,15,40,55,115.0,,785,220,405,625,1492.0,84,6.48,76,407,2545,10.7
19868,Murray Craven,1997-98,33.0,16,7,16,16,4,3,7,29.0,,801,224,408,632,1521.0,48,5.97,37,209,1408,10.2
19869,Murray Craven,1998-99,34.0,17,47,66,66,18,29,47,86.0,,867,242,437,679,1607.0,82,6.29,74,413,2481,10.4
19870,Murray Craven,1999-00,35.0,18,35,75,75,8,27,35,122.0,,942,250,464,714,1729.0,82,5.83,55,336,2444,9.8
19871,Murray Craven,2000-01,36.0,19,29,67,67,12,17,29,107.0,,1009,262,481,743,1836.0,82,5.28,57,380,2242,9.6
19872,Murray Craven,2001-02,37.0,20,14,43,43,4,10,14,55.0,621.0,1052,266,491,757,1891.0,82,5.27,57,359,2285,9.4
19873,Murray Craven,2002-03,38.0,21,2,19,19,0,2,2,18.0,249.0,1071,266,493,759,1909.0,82,5.49,53,331,2294,9.8
19874,Murray Eaves,1983-84,23.0,4,3,12,12,1,2,3,12.0,,12,1,2,3,12.0,80,7.69,77,340,2441,12.6
19875,Murray Eaves,1984-85,24.0,5,0,2,2,0,0,0,0.0,,14,1,2,3,12.0,80,8.03,73,320,2489,12.9
19876,Murray Eaves,1985-86,25.0,6,9,26,26,2,7,9,17.0,,40,3,9,12,29.0,80,7.73,71,310,2444,12.7
19877,Murray Eaves,1986-87,26.0,7,0,2,2,0,0,0,1.0,,42,3,9,12,30.0,80,7.89,74,336,2448,12.9
19878,Murray Eaves,1987-88,27.0,8,3,3,3,0,3,3,2.0,,45,3,12,15,32.0,80,7.77,71,321,2447,12.7
19879,Murray Eaves,1988-89,28.0,9,1,4,4,1,0,1,6.0,,49,4,12,16,38.0,80,7.94,82,370,2484,12.8
19880,Murray Eaves,1990-91,30.0,10,1,7,7,0,1,1,4.0,,56,4,13,17,42.0,80,7.43,89,437,2435,12.2
19881,Murray Eaves,1992-93,32.0,11,0,1,1,0,0,0,2.0,,57,4,13,17,44.0,80,7.37,76,367,2421,12.2
19882,Myles O'Connor,1993-94,26.0,4,4,22,22,3,1,4,14.0,,22,3,1,4,14.0,80,6.91,71,366,2385,11.6
19883,Myles O'Connor,1994-95,27.0,5,2,9,9,0,2,2,13.0,,31,3,3,6,27.0,80,6.96,77,402,2440,11.4
19884,Myles O'Connor,1995-96,28.0,6,0,7,7,0,0,0,4.0,,38,3,3,6,31.0,84,7.25,87,443,2603,11.7
19885,Myles O'Connor,1996-97,29.0,7,1,5,5,0,1,1,7.0,,43,3,4,7,38.0,84,6.48,76,407,2545,10.7
19886,Nail Yakupov,2015-16,22.0,4,31,48,48,17,14,31,81.0,699.0,48,17,14,31,81.0,48,5.31,29,160,1399,9.1
19887,Nail Yakupov,2016-17,23.0,5,24,63,63,11,13,24,122.0,902.0,111,28,27,55,203.0,82,5.34,48,269,2463,8.9
19888,Nail Yakupov,2017-18,24.0,6,33,81,81,14,19,33,191.0,1251.0,192,42,46,88,394.0,82,5.32,47,251,2453,8.9
19889,Nail Yakupov,2018-19,25.0,7,23,60,60,8,15,23,127.0,853.0,252,50,61,111,521.0,82,5.34,48,255,2438,9.0
19890,Nail Yakupov,2019-20,26.0,8,9,40,40,3,6,9,35.0,426.0,292,53,67,120,556.0,82,5.45,47,245,2478,9.0
19891,Nail Yakupov,2020-21,27.0,9,16,58,58,9,7,16,94.0,629.0,350,62,74,136,650.0,82,5.86,50,250,2620,9.2
19892,Nate Guenin,2009-10,27.0,4,2,9,9,0,2,2,0.0,78.0,9,0,2,2,0.0,82,5.76,70,398,2426,9.7
19893,Nate Guenin,2010-11,28.0,5,0,2,2,0,0,0,0.0,20.0,11,0,2,2,0.0,82,5.44,62,351,2383,9.4
19894,Nate Guenin,2011-12,29.0,6,0,1,1,0,0,0,0.0,13.0,12,0,2,2,0.0,82,5.7,65,341,2477,9.4
19895,Nate Guenin,2012-13,30.0,7,0,2,2,0,0,0,1.0,27.0,14,0,2,2,1.0,82,5.53,56,304,2486,9.1
19896,Nate Guenin,2013-14,31.0,8,0,3,3,0,0,0,2.0,44.0,17,0,2,2,3.0,82,5.46,52,291,2492,9.0
19897,Nate Guenin,2014-15,32.0,9,2,15,15,2,0,2,5.0,167.0,32,2,2,4,8.0,82,5.32,47,271,2439,8.9
19898,Nate Guenin,2016-17,34.0,10,9,68,68,1,8,9,52.0,1175.0,100,3,10,13,60.0,82,5.34,48,269,2463,8.9
19899,Nate Guenin,2017-18,35.0,11,15,76,76,2,13,15,38.0,1280.0,176,5,23,28,98.0,82,5.32,47,251,2453,8.9
19900,Nate Guenin,2018-19,36.0,12,0,29,29,0,0,0,10.0,379.0,205,5,23,28,108.0,82,5.34,48,255,2438,9.0
19901,Nate Prosser,2012-13,26.0,4,1,3,3,0,1,1,4.0,59.0,3,0,1,1,4.0,82,5.53,56,304,2486,9.1
19902,Nate Prosser,2013-14,27.0,5,0,2,2,0,0,0,1.0,30.0,5,0,1,1,5.0,82,5.46,52,291,2492,9.0
19903,Nate Prosser,2014-15,28.0,6,12,51,51,1,11,12,32.0,982.0,56,1,12,13,37.0,82,5.32,47,271,2439,8.9
19904,Nate Prosser,2015-16,29.0,7,0,17,17,0,0,0,5.0,191.0,73,1,12,13,42.0,48,5.31,29,160,1399,9.1
19905,Nate Prosser,2016-17,30.0,8,8,53,53,2,6,8,30.0,770.0,126,3,18,21,72.0,82,5.34,48,269,2463,8.9
19906,Nate Prosser,2017-18,31.0,9,7,63,63,2,5,7,38.0,806.0,189,5,23,28,110.0,82,5.32,47,251,2453,8.9
19907,Nate Prosser,2018-19,32.0,10,3,54,54,0,3,3,20.0,615.0,243,5,26,31,130.0,82,5.34,48,255,2438,9.0
19908,Nate Prosser,2019-20,33.0,11,7,39,39,2,5,7,20.0,496.0,282,7,31,38,150.0,82,5.45,47,245,2478,9.0
19909,Nate Prosser,2020-21,34.0,12,9,57,57,3,6,9,27.0,767.0,339,10,37,47,177.0,82,5.86,50,250,2620,9.2
19910,Nate Prosser,2021-22,35.0,13,0,15,15,0,0,0,10.0,153.0,354,10,37,47,187.0,82,5.96,47,239,2579,9.5
19911,Nate Raduns,2011-12,27.0,4,0,1,1,0,0,0,0.0,6.0,1,0,0,0,0.0,82,5.7,65,341,2477,9.4
19912,Nate Schmidt,2016-17,25.0,4,6,29,29,2,4,6,41.0,542.0,29,2,4,6,41.0,82,5.34,48,269,2463,8.9
19913,Nate Schmidt,2017-18,26.0,5,4,39,39,1,3,4,40.0,542.0,68,3,7,10,81.0,82,5.32,47,251,2453,8.9
19914,Nate Schmidt,2018-19,27.0,6,16,72,72,2,14,16,80.0,1301.0,140,5,21,26,161.0,82,5.34,48,255,2438,9.0
19915,Nate Schmidt,2019-20,28.0,7,17,60,60,3,14,17,60.0,929.0,200,8,35,43,221.0,82,5.45,47,245,2478,9.0
19916,Nate Schmidt,2020-21,29.0,8,36,76,76,5,31,36,103.0,1690.0,276,13,66,79,324.0,82,5.86,50,250,2620,9.2
19917,Nate Schmidt,2021-22,30.0,9,30,61,61,9,21,30,112.0,1339.0,337,22,87,109,436.0,82,5.96,47,239,2579,9.5
19918,Nate Schmidt,2022-23,31.0,10,31,59,59,7,24,31,112.0,1279.0,396,29,111,140,548.0,70,5.96,42,208,2192,9.5
19919,Nate Thompson,2009-10,25.0,4,0,4,4,0,0,0,5.0,19.0,4,0,0,0,5.0,82,5.76,70,398,2426,9.7
19920,Nate Thompson,2011-12,27.0,5,4,43,43,2,2,4,56.0,520.0,47,2,2,4,61.0,82,5.7,65,341,2477,9.4
19921,Nate Thompson,2012-13,28.0,6,10,71,71,2,8,10,92.0,951.0,118,4,10,14,153.0,82,5.53,56,304,2486,9.1
19922,Nate Thompson,2013-14,29.0,7,25,79,79,10,15,25,123.0,1192.0,197,14,25,39,276.0,82,5.46,52,291,2492,9.0
19923,Nate Thompson,2014-15,30.0,8,15,68,68,9,6,15,85.0,1008.0,265,23,31,54,361.0,82,5.32,47,271,2439,8.9
19924,Nate Thompson,2015-16,31.0,9,15,45,45,7,8,15,58.0,645.0,310,30,39,69,419.0,48,5.31,29,160,1399,9.1
19925,Nate Thompson,2016-17,32.0,10,16,81,81,9,7,16,105.0,1042.0,391,39,46,85,524.0,82,5.34,48,269,2463,8.9
19926,Nate Thompson,2017-18,33.0,11,18,80,80,5,13,18,87.0,1066.0,471,44,59,103,611.0,82,5.32,47,251,2453,8.9
19927,Nate Thompson,2018-19,34.0,12,6,49,49,3,3,6,42.0,568.0,520,47,62,109,653.0,82,5.34,48,255,2438,9.0
19928,Nate Thompson,2019-20,35.0,13,2,30,30,1,1,2,19.0,312.0,550,48,63,111,672.0,82,5.45,47,245,2478,9.0
19929,Nate Thompson,2020-21,36.0,14,17,69,69,5,12,17,53.0,881.0,619,53,75,128,725.0,82,5.86,50,250,2620,9.2
19930,Nate Thompson,2021-22,37.0,15,13,78,78,5,8,13,71.0,1014.0,697,58,83,141,796.0,82,5.96,47,239,2579,9.5
19931,Nate Thompson,2022-23,38.0,16,15,70,70,4,11,15,67.0,895.0,767,62,94,156,863.0,70,5.96,42,208,2192,9.5
19932,Nathan Bastian,2021-22,24.0,4,3,7,7,3,0,3,13.0,89.0,7,3,0,3,13.0,82,5.96,47,239,2579,9.5
19933,Nathan Beaulieu,2015-16,23.0,4,2,6,6,0,2,2,8.0,92.0,6,0,2,2,8.0,48,5.31,29,160,1399,9.1
19934,Nathan Beaulieu,2016-17,24.0,5,2,17,17,0,2,2,15.0,225.0,23,0,4,4,23.0,82,5.34,48,269,2463,8.9
19935,Nathan Beaulieu,2017-18,25.0,6,9,64,64,1,8,9,62.0,1005.0,87,1,12,13,85.0,82,5.32,47,251,2453,8.9
19936,Nathan Beaulieu,2018-19,26.0,7,19,64,64,2,17,19,74.0,1117.0,151,3,29,32,159.0,82,5.34,48,255,2438,9.0
19937,Nathan Beaulieu,2019-20,27.0,8,28,74,74,4,24,28,118.0,1442.0,225,7,53,60,277.0,82,5.45,47,245,2478,9.0
19938,Nathan Beaulieu,2020-21,28.0,9,9,59,59,1,8,9,67.0,941.0,284,8,61,69,344.0,82,5.86,50,250,2620,9.2
19939,Nathan Beaulieu,2021-22,29.0,10,12,48,48,3,9,12,60.0,744.0,332,11,70,81,404.0,82,5.96,47,239,2579,9.5
19940,Nathan Beaulieu,2022-23,30.0,11,8,38,38,1,7,8,38.0,646.0,370,12,77,89,442.0,70,5.96,42,208,2192,9.5
19941,Nathan Dempsey,1999-00,25.0,4,2,14,14,1,1,2,11.0,,14,1,1,2,11.0,82,5.83,55,336,2444,9.8
19942,Nathan Dempsey,2002-03,28.0,5,2,6,6,0,2,2,3.0,82.0,20,1,3,4,14.0,82,5.49,53,331,2294,9.8
19943,Nathan Dempsey,2003-04,29.0,6,10,25,25,1,9,10,31.0,397.0,45,2,12,14,45.0,82,5.51,63,376,2272,9.9
19944,Nathan Dempsey,2004-05,30.0,7,0,3,3,0,0,0,3.0,42.0,48,2,12,14,48.0,82,5.24,53,338,2262,9.5
19945,Nathan Dempsey,2005-06,31.0,8,28,67,67,5,23,28,124.0,1401.0,115,7,35,42,172.0,82,5.31,60,363,2326,9.4
19946,Nathan Dempsey,2006-07,32.0,9,32,75,75,12,20,32,183.0,1726.0,190,19,55,74,355.0,82,5.14,57,348,2300,9.2
19947,Nathan Dempsey,2008-09,34.0,10,13,53,53,2,11,13,58.0,1015.0,243,21,66,87,413.0,82,6.05,85,480,2458,10.1
19948,Nathan Dempsey,2009-10,35.0,11,1,17,17,0,1,1,4.0,169.0,260,21,67,88,417.0,82,5.76,70,398,2426,9.7
19949,Nathan Gerbe,2011-12,24.0,4,1,10,10,0,1,1,24.0,136.0,10,0,1,1,24.0,82,5.7,65,341,2477,9.4
19950,Nathan Gerbe,2012-13,25.0,5,5,10,10,2,3,5,29.0,146.0,20,2,4,6,53.0,82,5.53,56,304,2486,9.1
19951,Nathan Gerbe,2013-14,26.0,6,31,64,64,16,15,31,171.0,853.0,84,18,19,37,224.0,82,5.46,52,291,2492,9.0
19952,Nathan Gerbe,2014-15,27.0,7,25,62,62,6,19,25,137.0,881.0,146,24,38,62,361.0,82,5.32,47,271,2439,8.9
19953,Nathan Gerbe,2015-16,28.0,8,10,42,42,5,5,10,64.0,525.0,188,29,43,72,425.0,48,5.31,29,160,1399,9.1
19954,Nathan Gerbe,2016-17,29.0,9,31,81,81,16,15,31,221.0,1329.0,269,45,58,103,646.0,82,5.34,48,269,2463,8.9
19955,Nathan Gerbe,2017-18,30.0,10,28,78,78,10,18,28,235.0,1283.0,347,55,76,131,881.0,82,5.32,47,251,2453,8.9
19956,Nathan Gerbe,2018-19,31.0,11,7,47,47,3,4,7,73.0,633.0,394,58,80,138,954.0,82,5.34,48,255,2438,9.0
19957,Nathan Gerbe,2020-21,33.0,12,0,2,2,0,0,0,1.0,17.0,396,58,80,138,955.0,82,5.86,50,250,2620,9.2
19958,Nathan Gerbe,2022-23,35.0,13,10,30,30,4,6,10,55.0,413.0,426,62,86,148,1010.0,70,5.96,42,208,2192,9.5
19959,Nathan Horton,2006-07,21.0,4,22,55,55,14,8,22,81.0,733.0,55,14,8,22,81.0,82,5.14,57,348,2300,9.2
19960,Nathan Horton,2008-09,23.0,5,47,71,71,28,19,47,162.0,1199.0,126,42,27,69,243.0,82,6.05,85,480,2458,10.1
19961,Nathan Horton,2009-10,24.0,6,62,82,82,31,31,62,217.0,1481.0,208,73,58,131,460.0,82,5.76,70,398,2426,9.7
19962,Nathan Horton,2010-11,25.0,7,62,82,82,27,35,62,212.0,1537.0,290,100,93,193,672.0,82,5.44,62,351,2383,9.4
19963,Nathan Horton,2011-12,26.0,8,45,67,67,22,23,45,131.0,1196.0,357,122,116,238,803.0,82,5.7,65,341,2477,9.4
19964,Nathan Horton,2012-13,27.0,9,57,65,65,20,37,57,159.0,1358.0,422,142,153,295,962.0,82,5.53,56,304,2486,9.1
19965,Nathan Horton,2013-14,28.0,10,53,80,80,26,27,53,188.0,1303.0,502,168,180,348,1150.0,82,5.46,52,291,2492,9.0
19966,Nathan Horton,2014-15,29.0,11,32,46,46,17,15,32,90.0,733.0,548,185,195,380,1240.0,82,5.32,47,271,2439,8.9
19967,Nathan Horton,2015-16,30.0,12,22,43,43,13,9,22,114.0,725.0,591,198,204,402,1354.0,48,5.31,29,160,1399,9.1
19968,Nathan Horton,2016-17,31.0,13,19,36,36,5,14,19,48.0,556.0,627,203,218,421,1402.0,82,5.34,48,269,2463,8.9
19969,Nathan LaFayette,1996-97,23.0,4,7,49,49,3,4,7,34.0,,49,3,4,7,34.0,84,6.48,76,407,2545,10.7
19970,Nathan LaFayette,1997-98,24.0,5,8,39,39,4,4,8,35.0,,88,7,8,15,69.0,48,5.97,37,209,1408,10.2
19971,Nathan LaFayette,1998-99,25.0,6,6,17,17,2,4,6,28.0,,105,9,12,21,97.0,82,6.29,74,413,2481,10.4
19972,Nathan LaFayette,1999-00,26.0,7,4,15,15,1,3,4,26.0,,120,10,15,25,123.0,82,5.83,55,336,2444,9.8
19973,Nathan LaFayette,2000-01,27.0,8,8,34,34,5,3,8,60.0,,154,15,18,33,183.0,82,5.28,57,380,2242,9.6
19974,Nathan LaFayette,2001-02,28.0,9,4,33,33,2,2,4,42.0,391.0,187,17,20,37,225.0,82,5.27,57,359,2285,9.4
19975,Nathan MacKinnon,2016-17,21.0,4,63,82,82,24,39,63,241.0,1422.0,82,24,39,63,241.0,82,5.34,48,269,2463,8.9
19976,Nathan MacKinnon,2017-18,22.0,5,38,64,64,14,24,38,192.0,1091.0,146,38,63,101,433.0,82,5.32,47,251,2453,8.9
19977,Nathan MacKinnon,2018-19,23.0,6,52,72,72,21,31,52,245.0,1358.0,218,59,94,153,678.0,82,5.34,48,255,2438,9.0
19978,Nathan MacKinnon,2019-20,24.0,7,53,82,82,16,37,53,251.0,1635.0,300,75,131,206,929.0,82,5.45,47,245,2478,9.0
19979,Nathan MacKinnon,2020-21,25.0,8,97,74,74,39,58,97,284.0,1473.0,374,114,189,303,1213.0,82,5.86,50,250,2620,9.2
19980,Nathan MacKinnon,2021-22,26.0,9,99,82,82,41,58,99,365.0,1812.0,456,155,247,402,1578.0,82,5.96,47,239,2579,9.5
19981,Nathan MacKinnon,2022-23,27.0,10,93,69,69,35,58,93,318.0,1464.0,525,190,305,495,1896.0,70,5.96,42,208,2192,9.5
19982,Nathan McIver,2009-10,25.0,4,0,1,1,0,0,0,0.0,11.0,1,0,0,0,0.0,82,5.76,70,398,2426,9.7
19983,Nathan McIver,2010-11,26.0,5,0,17,17,0,0,0,9.0,178.0,18,0,0,0,9.0,82,5.44,62,351,2383,9.4
19984,Nathan McIver,2011-12,27.0,6,1,18,18,0,1,1,5.0,169.0,36,0,1,1,14.0,82,5.7,65,341,2477,9.4
19985,Nathan Oystrick,2011-12,29.0,4,12,53,53,4,8,12,43.0,834.0,53,4,8,12,43.0,82,5.7,65,341,2477,9.4
19986,Nathan Oystrick,2012-13,30.0,5,0,3,3,0,0,0,1.0,32.0,56,4,8,12,44.0,82,5.53,56,304,2486,9.1
19987,Nathan Oystrick,2013-14,31.0,6,3,9,9,1,2,3,11.0,110.0,65,5,10,15,55.0,82,5.46,52,291,2492,9.0
19988,Nathan Paetsch,2008-09,25.0,4,1,1,1,0,1,1,0.0,16.0,1,0,1,1,0.0,82,6.05,85,480,2458,10.1
19989,Nathan Paetsch,2009-10,26.0,5,24,63,63,2,22,24,62.0,961.0,64,2,23,25,62.0,82,5.76,70,398,2426,9.7
19990,Nathan Paetsch,2010-11,27.0,6,9,59,59,2,7,9,49.0,804.0,123,4,30,34,111.0,82,5.44,62,351,2383,9.4
19991,Nathan Paetsch,2011-12,28.0,7,6,23,23,2,4,6,21.0,280.0,146,6,34,40,132.0,82,5.7,65,341,2477,9.4
19992,Nathan Paetsch,2012-13,29.0,8,2,21,21,1,1,2,17.0,219.0,167,7,35,42,149.0,82,5.53,56,304,2486,9.1
19993,Nathan Perrott,2004-05,28.0,4,3,22,22,1,2,3,7.0,108.0,22,1,2,3,7.0,82,5.24,53,338,2262,9.5
19994,Nathan Perrott,2005-06,29.0,5,0,1,1,0,0,0,0.0,4.0,23,1,2,3,7.0,82,5.31,60,363,2326,9.4
19995,Nathan Perrott,2006-07,30.0,6,3,40,40,1,2,3,47.0,307.0,63,2,4,6,54.0,82,5.14,57,348,2300,9.2
19996,Nathan Perrott,2008-09,32.0,7,3,26,26,2,1,3,19.0,143.0,89,4,5,9,73.0,82,6.05,85,480,2458,10.1
19997,Nathan Robinson,2006-07,25.0,4,0,5,5,0,0,0,5.0,30.0,5,0,0,0,5.0,82,5.14,57,348,2300,9.2
19998,Nathan Robinson,2008-09,27.0,5,0,2,2,0,0,0,1.0,7.0,7,0,0,0,6.0,82,6.05,85,480,2458,10.1
19999,Nathan Smith,2006-07,24.0,4,0,2,2,0,0,0,1.0,11.0,2,0,0,0,1.0,82,5.14,57,348,2300,9.2
20000,Nathan Smith,2008-09,26.0,5,0,1,1,0,0,0,2.0,11.0,3,0,0,0,3.0,82,6.05,85,480,2458,10.1
20001,Nathan Smith,2009-10,27.0,6,0,1,1,0,0,0,0.0,9.0,4,0,0,0,3.0,82,5.76,70,398,2426,9.7
20002,Nathan Smith,2010-11,28.0,7,0,13,13,0,0,0,3.0,100.0,17,0,0,0,6.0,82,5.44,62,351,2383,9.4
20003,Nathan Smith,2012-13,30.0,8,0,9,9,0,0,0,4.0,71.0,26,0,0,0,10.0,82,5.53,56,304,2486,9.1
20004,Nathan Walker,2020-21,26.0,4,1,9,9,1,0,1,6.0,85.0,9,1,0,1,6.0,82,5.86,50,250,2620,9.2
20005,Nathan Walker,2021-22,27.0,5,1,3,3,0,1,1,2.0,24.0,12,1,1,2,8.0,82,5.96,47,239,2579,9.5
20006,Nathan Walker,2022-23,28.0,6,2,5,5,1,1,2,6.0,56.0,17,2,2,4,14.0,70,5.96,42,208,2192,9.5
20007,Nazem Kadri,2012-13,22.0,4,0,1,1,0,0,0,0.0,17.0,1,0,0,0,0.0,82,5.53,56,304,2486,9.1
20008,Nazem Kadri,2013-14,23.0,5,12,29,29,3,9,12,51.0,457.0,30,3,9,12,51.0,82,5.46,52,291,2492,9.0
20009,Nazem Kadri,2014-15,24.0,6,7,21,21,5,2,7,28.0,297.0,51,8,11,19,79.0,82,5.32,47,271,2439,8.9
20010,Nazem Kadri,2015-16,25.0,7,44,48,48,18,26,44,107.0,771.0,99,26,37,63,186.0,48,5.31,29,160,1399,9.1
20011,Nazem Kadri,2016-17,26.0,8,50,78,78,20,30,50,148.0,1356.0,177,46,67,113,334.0,82,5.34,48,269,2463,8.9
20012,Nazem Kadri,2017-18,27.0,9,39,73,73,18,21,39,176.0,1285.0,250,64,88,152,510.0,82,5.32,47,251,2453,8.9
20013,Nazem Kadri,2018-19,28.0,10,45,76,76,17,28,45,260.0,1389.0,326,81,116,197,770.0,82,5.34,48,255,2438,9.0
20014,Nazem Kadri,2019-20,29.0,11,61,82,82,32,29,61,236.0,1360.0,408,113,145,258,1006.0,82,5.45,47,245,2478,9.0
20015,Nazem Kadri,2020-21,30.0,12,55,80,80,32,23,55,211.0,1341.0,488,145,168,313,1217.0,82,5.86,50,250,2620,9.2
20016,Nazem Kadri,2021-22,31.0,13,44,73,73,16,28,44,184.0,1182.0,561,161,196,357,1401.0,82,5.96,47,239,2579,9.5
20017,Nazem Kadri,2022-23,32.0,14,36,51,51,19,17,36,133.0,889.0,612,180,213,393,1534.0,70,5.96,42,208,2192,9.5
20018,Neal Broten,1983-84,24.0,4,2,3,3,2,0,2,6.0,,3,2,0,2,6.0,80,7.69,77,340,2441,12.6
20019,Neal Broten,1984-85,25.0,5,98,73,73,38,60,98,188.0,,76,40,60,100,194.0,80,8.03,73,320,2489,12.9
20020,Neal Broten,1985-86,26.0,6,77,79,79,32,45,77,163.0,,155,72,105,177,357.0,80,7.73,71,310,2444,12.7
20021,Neal Broten,1986-87,27.0,7,89,76,76,28,61,89,185.0,,231,100,166,266,542.0,80,7.89,74,336,2448,12.9
20022,Neal Broten,1987-88,28.0,8,56,80,80,19,37,56,187.0,,311,119,203,322,729.0,80,7.77,71,321,2447,12.7
20023,Neal Broten,1988-89,29.0,9,105,80,80,29,76,105,193.0,,391,148,279,427,922.0,80,7.94,82,370,2484,12.8
20024,Neal Broten,1989-90,30.0,10,53,46,46,18,35,53,112.0,,437,166,314,480,1034.0,80,7.34,72,344,2400,12.2
20025,Neal Broten,1990-91,31.0,11,39,54,54,9,30,39,121.0,,491,175,344,519,1155.0,80,7.43,89,437,2435,12.2
20026,Neal Broten,1991-92,32.0,12,56,68,68,18,38,56,160.0,,559,193,382,575,1315.0,80,7.48,85,403,2430,12.3
20027,Neal Broten,1992-93,33.0,13,85,80,80,23,62,85,212.0,,639,216,444,660,1527.0,80,7.37,76,367,2421,12.2
20028,Neal Broten,1993-94,34.0,14,69,79,79,13,56,69,191.0,,718,229,500,729,1718.0,80,6.91,71,366,2385,11.6
20029,Neal Broten,1994-95,35.0,15,34,76,76,8,26,34,119.0,,794,237,526,763,1837.0,80,6.96,77,402,2440,11.4
20030,Neal Broten,1995-96,36.0,16,33,82,82,12,21,33,123.0,,876,249,547,796,1960.0,84,7.25,87,443,2603,11.7
20031,Neal Broten,1996-97,37.0,17,52,79,79,17,35,52,153.0,,955,266,582,848,2113.0,84,6.48,76,407,2545,10.7
20032,Neal Broten,1997-98,38.0,18,32,47,47,8,24,32,72.0,,1002,274,606,880,2185.0,48,5.97,37,209,1408,10.2
20033,Neal Broten,1998-99,39.0,19,23,55,55,7,16,23,73.0,,1057,281,622,903,2258.0,82,6.29,74,413,2481,10.4
20034,Neal Broten,1999-00,40.0,20,20,42,42,8,12,20,55.0,,1099,289,634,923,2313.0,82,5.83,55,336,2444,9.8
20035,Neal Coulter,1988-89,26.0,4,7,16,16,3,4,7,17.0,,16,3,4,7,17.0,80,7.94,82,370,2484,12.8
20036,Neal Coulter,1989-90,27.0,5,3,9,9,2,1,3,5.0,,25,5,5,10,22.0,80,7.34,72,344,2400,12.2
20037,Neal Coulter,1990-91,28.0,6,0,1,1,0,0,0,0.0,,26,5,5,10,22.0,80,7.43,89,437,2435,12.2
20038,Neal Pionk,2020-21,25.0,4,14,28,28,1,13,14,54.0,627.0,28,1,13,14,54.0,82,5.86,50,250,2620,9.2
20039,Neal Pionk,2021-22,26.0,5,26,73,73,6,20,26,132.0,1545.0,101,7,33,40,186.0,82,5.96,47,239,2579,9.5
20040,Neal Pionk,2022-23,27.0,6,45,71,71,6,39,45,177.0,1660.0,172,13,72,85,363.0,70,5.96,42,208,2192,9.5
20041,Neil Belland,1984-85,23.0,4,9,28,28,3,6,9,33.0,,28,3,6,9,33.0,80,8.03,73,320,2489,12.9
20042,Neil Belland,1985-86,24.0,5,6,14,14,2,4,6,13.0,,42,5,10,15,46.0,80,7.73,71,310,2444,12.7
20043,Neil Belland,1986-87,25.0,6,20,44,44,7,13,20,84.0,,86,12,23,35,130.0,80,7.89,74,336,2448,12.9
20044,Neil Belland,1987-88,26.0,7,6,13,13,0,6,6,22.0,,99,12,29,41,152.0,80,7.77,71,321,2447,12.7
20045,Neil Belland,1988-89,27.0,8,3,7,7,1,2,3,10.0,,106,13,31,44,162.0,80,7.94,82,370,2484,12.8
20046,Neil Belland,1989-90,28.0,9,1,3,3,0,1,1,4.0,,109,13,32,45,166.0,80,7.34,72,344,2400,12.2
20047,Neil Brady,1992-93,24.0,4,5,19,19,1,4,5,10.0,,19,1,4,5,10.0,80,7.37,76,367,2421,12.2
20048,Neil Brady,1993-94,25.0,5,0,3,3,0,0,0,6.0,,22,1,4,5,16.0,80,6.91,71,366,2385,11.6
20049,Neil Brady,1994-95,26.0,6,1,7,7,1,0,1,3.0,,29,2,4,6,19.0,80,6.96,77,402,2440,11.4
20050,Neil Brady,1995-96,27.0,7,24,55,55,7,17,24,68.0,,84,9,21,30,87.0,84,7.25,87,443,2603,11.7
20051,Neil Brady,1996-97,28.0,8,1,5,5,0,1,1,1.0,,89,9,22,31,88.0,84,6.48,76,407,2545,10.7
20052,Neil Eisenhut,1996-97,29.0,4,4,13,13,1,3,4,13.0,,13,1,3,4,13.0,84,6.48,76,407,2545,10.7
20053,Neil Eisenhut,1997-98,30.0,5,0,3,3,0,0,0,2.0,,16,1,3,4,15.0,48,5.97,37,209,1408,10.2
20054,Neil Hawryliw,1984-85,29.0,4,0,1,1,0,0,0,0.0,,1,0,0,0,0.0,80,8.03,73,320,2489,12.9
20055,Neil Sheehy,1986-87,26.0,4,1,1,1,1,0,1,1.0,,1,1,0,1,1.0,80,7.89,74,336,2448,12.9
20056,Neil Sheehy,1987-88,27.0,5,7,31,31,3,4,7,42.0,,32,4,4,8,43.0,80,7.77,71,321,2447,12.7
20057,Neil Sheehy,1988-89,28.0,6,18,65,65,2,16,18,59.0,,97,6,20,26,102.0,80,7.94,82,370,2484,12.8
20058,Neil Sheehy,1989-90,29.0,7,10,54,54,4,6,10,45.0,,151,10,26,36,147.0,80,7.34,72,344,2400,12.2
20059,Neil Sheehy,1990-91,30.0,8,13,62,62,3,10,13,40.0,,213,13,36,49,187.0,80,7.43,89,437,2435,12.2
20060,Neil Sheehy,1991-92,31.0,9,7,72,72,3,4,7,22.0,,285,16,40,56,209.0,80,7.48,85,403,2430,12.3
20061,Neil Sheehy,1992-93,32.0,10,6,59,59,1,5,6,32.0,,344,17,45,62,241.0,80,7.37,76,367,2421,12.2
20062,Neil Sheehy,1994-95,34.0,11,3,35,35,1,2,3,19.0,,379,18,47,65,260.0,80,6.96,77,402,2440,11.4
20063,Neil Wilkinson,1992-93,25.0,4,5,36,36,0,5,5,36.0,,36,0,5,5,36.0,80,7.37,76,367,2421,12.2
20064,Neil Wilkinson,1993-94,26.0,5,11,50,50,2,9,11,55.0,,86,2,14,16,91.0,80,6.91,71,366,2385,11.6
20065,Neil Wilkinson,1994-95,27.0,6,19,60,60,4,15,19,95.0,,146,6,29,35,186.0,80,6.96,77,402,2440,11.4
20066,Neil Wilkinson,1995-96,28.0,7,8,59,59,1,7,8,51.0,,205,7,36,43,237.0,84,7.25,87,443,2603,11.7
20067,Neil Wilkinson,1996-97,29.0,8,12,72,72,3,9,12,72.0,,277,10,45,55,309.0,84,6.48,76,407,2545,10.7
20068,Neil Wilkinson,1997-98,30.0,9,5,40,40,1,4,5,25.0,,317,11,49,60,334.0,48,5.97,37,209,1408,10.2
20069,Neil Wilkinson,1998-99,31.0,10,17,62,62,3,14,17,59.0,,379,14,63,77,393.0,82,6.29,74,413,2481,10.4
20070,Neil Wilkinson,1999-00,32.0,11,0,23,23,0,0,0,16.0,,402,14,63,77,409.0,82,5.83,55,336,2444,9.8
20071,Neil Wilkinson,2000-01,33.0,12,6,34,34,2,4,6,19.0,,436,16,67,83,428.0,82,5.28,57,380,2242,9.6
20072,Neil Wilkinson,2001-02,34.0,13,0,24,24,0,0,0,11.0,239.0,460,16,67,83,439.0,82,5.27,57,359,2285,9.4
20073,Nelson Emerson,1993-94,26.0,4,3,4,4,0,3,3,3.0,,4,0,3,3,3.0,80,6.91,71,366,2385,11.6
20074,Nelson Emerson,1994-95,27.0,5,59,79,79,23,36,59,143.0,,83,23,39,62,146.0,80,6.96,77,402,2440,11.4
20075,Nelson Emerson,1995-96,28.0,6,73,82,82,22,51,73,196.0,,165,45,90,135,342.0,84,7.25,87,443,2603,11.7
20076,Nelson Emerson,1996-97,29.0,7,74,83,83,33,41,74,282.0,,248,78,131,209,624.0,84,6.48,76,407,2545,10.7
20077,Nelson Emerson,1997-98,30.0,8,37,48,48,14,23,37,122.0,,296,92,154,246,746.0,48,5.97,37,209,1408,10.2
20078,Nelson Emerson,1998-99,31.0,9,58,81,81,29,29,58,247.0,,377,121,183,304,993.0,82,6.29,74,413,2481,10.4
20079,Nelson Emerson,1999-00,32.0,10,38,66,66,9,29,38,194.0,,443,130,212,342,1187.0,82,5.83,55,336,2444,9.8
20080,Nelson Emerson,2000-01,33.0,11,45,81,81,21,24,45,203.0,,524,151,236,387,1390.0,82,5.28,57,380,2242,9.6
20081,Nelson Emerson,2001-02,34.0,12,37,65,65,13,24,37,188.0,1088.0,589,164,260,424,1578.0,82,5.27,57,359,2285,9.4
20082,Nelson Emerson,2002-03,35.0,13,35,63,63,15,20,35,196.0,1185.0,652,179,280,459,1774.0,82,5.49,53,331,2294,9.8
20083,Nelson Emerson,2003-04,36.0,14,22,78,78,11,11,22,157.0,1080.0,730,190,291,481,1931.0,82,5.51,63,376,2272,9.9
20084,Nelson Emerson,2004-05,37.0,15,7,41,41,5,2,7,40.0,377.0,771,195,293,488,1971.0,82,5.24,53,338,2262,9.5
20085,Nelson Nogier,2019-20,23.0,4,0,10,10,0,0,0,8.0,117.0,10,0,0,0,8.0,82,5.45,47,245,2478,9.0
20086,Nelson Nogier,2021-22,25.0,5,0,1,1,0,0,0,1.0,10.0,11,0,0,0,9.0,82,5.96,47,239,2579,9.5
20087,Nevin Markwart,1986-87,22.0,4,30,70,70,14,16,30,66.0,,70,14,16,30,66.0,80,7.89,74,336,2448,12.9
20088,Nevin Markwart,1987-88,23.0,5,4,26,26,0,4,4,5.0,,96,14,20,34,71.0,80,7.77,71,321,2447,12.7
20089,Nevin Markwart,1988-89,24.0,6,22,65,65,7,15,22,44.0,,161,21,35,56,115.0,80,7.94,82,370,2484,12.8
20090,Nevin Markwart,1989-90,25.0,7,19,64,64,10,9,19,65.0,,225,31,44,75,180.0,80,7.34,72,344,2400,12.2
20091,Nevin Markwart,1990-91,26.0,8,13,25,25,1,12,13,24.0,,250,32,56,88,204.0,80,7.43,89,437,2435,12.2
20092,Nevin Markwart,1992-93,28.0,9,3,8,8,1,2,3,6.0,,258,33,58,91,210.0,80,7.37,76,367,2421,12.2
20093,Nevin Markwart,1993-94,29.0,10,6,23,23,3,3,6,13.0,,281,36,61,97,223.0,80,6.91,71,366,2385,11.6
20094,Nevin Markwart,1994-95,30.0,11,12,28,28,5,7,12,16.0,,309,41,68,109,239.0,80,6.96,77,402,2440,11.4
20095,Nic Dowd,2018-19,28.0,4,0,5,5,0,0,0,3.0,53.0,5,0,0,0,3.0,82,5.34,48,255,2438,9.0
20096,Nic Dowd,2019-20,29.0,5,22,70,70,6,16,22,78.0,872.0,75,6,16,22,81.0,82,5.45,47,245,2478,9.0
20097,Nic Dowd,2020-21,30.0,6,4,56,56,3,1,4,51.0,590.0,131,9,17,26,132.0,82,5.86,50,250,2620,9.2
20098,Nic Dowd,2021-22,31.0,7,22,64,64,8,14,22,47.0,659.0,195,17,31,48,179.0,82,5.96,47,239,2579,9.5
20099,Nic Dowd,2022-23,32.0,8,15,56,56,7,8,15,52.0,607.0,251,24,39,63,231.0,70,5.96,42,208,2192,9.5
20100,Nic Petan,2018-19,23.0,4,6,26,26,2,4,6,25.0,305.0,26,2,4,6,25.0,82,5.34,48,255,2438,9.0
20101,Nic Petan,2019-20,24.0,5,13,54,54,1,12,13,57.0,589.0,80,3,16,19,82.0,82,5.45,47,245,2478,9.0
20102,Nic Petan,2020-21,25.0,6,2,15,15,2,0,2,16.0,126.0,95,5,16,21,98.0,82,5.86,50,250,2620,9.2
20103,Nic Petan,2021-22,26.0,7,3,18,18,1,2,3,15.0,137.0,113,6,18,24,113.0,82,5.96,47,239,2579,9.5
20104,Nic Petan,2022-23,27.0,8,3,16,16,0,3,3,19.0,178.0,129,6,21,27,132.0,70,5.96,42,208,2192,9.5
20105,Nicholas Baptiste,2019-20,24.0,4,4,14,14,3,1,4,16.0,129.0,14,3,1,4,16.0,82,5.45,47,245,2478,9.0
20106,Nicholas Baptiste,2020-21,25.0,5,6,33,33,4,2,6,45.0,329.0,47,7,3,10,61.0,82,5.86,50,250,2620,9.2
20107,Nicholas Caamano,2022-23,24.0,4,2,12,12,1,1,2,13.0,120.0,12,1,1,2,13.0,70,5.96,42,208,2192,9.5
20108,Nicholas Merkley,2020-21,23.0,4,0,1,1,0,0,0,0.0,14.0,1,0,0,0,0.0,82,5.86,50,250,2620,9.2
20109,Nicholas Merkley,2022-23,25.0,5,2,4,4,1,1,2,8.0,45.0,5,1,1,2,8.0,70,5.96,42,208,2192,9.5
20110,Nicholas Petrecki,2015-16,26.0,4,0,1,1,0,0,0,0.0,12.0,1,0,0,0,0.0,48,5.31,29,160,1399,9.1
20111,Nick Bjugstad,2015-16,23.0,4,1,11,11,1,0,1,17.0,167.0,11,1,0,1,17.0,48,5.31,29,160,1399,9.1
20112,Nick Bjugstad,2016-17,24.0,5,38,76,76,16,22,38,185.0,1233.0,87,17,22,39,202.0,82,5.34,48,269,2463,8.9
20113,Nick Bjugstad,2017-18,25.0,6,43,72,72,24,19,43,207.0,1194.0,159,41,41,82,409.0,82,5.32,47,251,2453,8.9
20114,Nick Bjugstad,2018-19,26.0,7,34,67,67,15,19,34,171.0,1039.0,226,56,60,116,580.0,82,5.34,48,255,2438,9.0
20115,Nick Bjugstad,2019-20,27.0,8,14,54,54,7,7,14,91.0,710.0,280,63,67,130,671.0,82,5.45,47,245,2478,9.0
20116,Nick Bjugstad,2020-21,28.0,9,49,82,82,19,30,49,230.0,1240.0,362,82,97,179,901.0,82,5.86,50,250,2620,9.2
20117,Nick Bjugstad,2021-22,29.0,10,26,64,64,14,12,26,154.0,968.0,426,96,109,205,1055.0,82,5.96,47,239,2579,9.5
20118,Nick Bjugstad,2022-23,30.0,11,2,13,13,1,1,2,18.0,159.0,439,97,110,207,1073.0,70,5.96,42,208,2192,9.5
20119,Nick Bonino,2012-13,24.0,4,2,9,9,1,1,2,14.0,128.0,9,1,1,2,14.0,82,5.53,56,304,2486,9.1
20120,Nick Bonino,2013-14,25.0,5,0,26,26,0,0,0,23.0,255.0,35,1,1,2,37.0,82,5.46,52,291,2492,9.0
20121,Nick Bonino,2014-15,26.0,6,18,50,50,5,13,18,63.0,624.0,85,6,14,20,100.0,82,5.32,47,271,2439,8.9
20122,Nick Bonino,2015-16,27.0,7,13,27,27,5,8,13,37.0,429.0,112,11,22,33,137.0,48,5.31,29,160,1399,9.1
20123,Nick Bonino,2016-17,28.0,8,49,77,77,22,27,49,159.0,1250.0,189,33,49,82,296.0,82,5.34,48,269,2463,8.9
20124,Nick Bonino,2017-18,29.0,9,39,75,75,15,24,39,149.0,1269.0,264,48,73,121,445.0,82,5.32,47,251,2453,8.9
20125,Nick Bonino,2018-19,30.0,10,29,63,63,9,20,29,97.0,998.0,327,57,93,150,542.0,82,5.34,48,255,2438,9.0
20126,Nick Bonino,2019-20,31.0,11,37,80,80,18,19,37,142.0,1332.0,407,75,112,187,684.0,82,5.45,47,245,2478,9.0
20127,Nick Bonino,2020-21,32.0,12,25,71,71,12,13,25,83.0,1110.0,478,87,125,212,767.0,82,5.86,50,250,2620,9.2
20128,Nick Bonino,2021-22,33.0,13,35,81,81,17,18,35,118.0,1321.0,559,104,143,247,885.0,82,5.96,47,239,2579,9.5
20129,Nick Bonino,2022-23,34.0,14,35,67,67,18,17,35,104.0,1107.0,626,122,160,282,989.0,70,5.96,42,208,2192,9.5
20130,Nick Boynton,2002-03,24.0,4,0,5,5,0,0,0,6.0,107.0,5,0,0,0,6.0,82,5.49,53,331,2294,9.8
20131,Nick Boynton,2003-04,25.0,5,0,1,1,0,0,0,1.0,14.0,6,0,0,0,7.0,82,5.51,63,376,2272,9.9
20132,Nick Boynton,2004-05,26.0,6,18,80,80,4,14,18,136.0,1481.0,86,4,14,18,143.0,82,5.24,53,338,2262,9.5
20133,Nick Boynton,2005-06,27.0,7,24,78,78,7,17,24,160.0,1769.0,164,11,31,42,303.0,82,5.31,60,363,2326,9.4
20134,Nick Boynton,2006-07,28.0,8,30,81,81,6,24,30,178.0,1826.0,245,17,55,72,481.0,82,5.14,57,348,2300,9.2
20135,Nick Boynton,2008-09,30.0,9,12,54,54,5,7,12,89.0,1115.0,299,22,62,84,570.0,82,6.05,85,480,2458,10.1
20136,Nick Boynton,2009-10,31.0,10,11,59,59,2,9,11,53.0,991.0,358,24,71,95,623.0,82,5.76,70,398,2426,9.7
20137,Nick Boynton,2010-11,32.0,11,12,79,79,3,9,12,94.0,1344.0,437,27,80,107,717.0,82,5.44,62,351,2383,9.4
20138,Nick Boynton,2011-12,33.0,12,21,68,68,5,16,21,104.0,1129.0,505,32,96,128,821.0,82,5.7,65,341,2477,9.4
20139,Nick Boynton,2012-13,34.0,13,8,49,49,1,7,8,50.0,815.0,554,33,103,136,871.0,82,5.53,56,304,2486,9.1
20140,Nick Boynton,2013-14,35.0,14,8,51,51,1,7,8,43.0,747.0,605,34,110,144,914.0,82,5.46,52,291,2492,9.0
20141,Nick Cousins,2017-18,24.0,4,0,11,11,0,0,0,6.0,97.0,11,0,0,0,6.0,82,5.32,47,251,2453,8.9
20142,Nick Cousins,2018-19,25.0,5,11,36,36,6,5,11,41.0,386.0,47,6,5,11,47.0,82,5.34,48,255,2438,9.0
20143,Nick Cousins,2019-20,26.0,6,16,60,60,6,10,16,99.0,720.0,107,12,15,27,146.0,82,5.45,47,245,2478,9.0
20144,Nick Cousins,2020-21,27.0,7,19,71,71,12,7,19,119.0,913.0,178,24,22,46,265.0,82,5.86,50,250,2620,9.2
20145,Nick Cousins,2021-22,28.0,8,27,81,81,7,20,27,144.0,1097.0,259,31,42,73,409.0,82,5.96,47,239,2579,9.5
20146,Nick Cousins,2022-23,29.0,9,25,65,65,10,15,25,115.0,878.0,324,41,57,98,524.0,70,5.96,42,208,2192,9.5
20147,Nick Drazenovic,2013-14,27.0,4,0,3,3,0,0,0,2.0,27.0,3,0,0,0,2.0,82,5.46,52,291,2492,9.0
20148,Nick Drazenovic,2015-16,29.0,5,0,8,8,0,0,0,5.0,79.0,11,0,0,0,7.0,48,5.31,29,160,1399,9.1
20149,Nick Drazenovic,2016-17,30.0,6,0,1,1,0,0,0,3.0,10.0,12,0,0,0,10.0,82,5.34,48,269,2463,8.9
20150,Nick Foligno,2010-11,23.0,4,9,45,45,6,3,9,44.0,412.0,45,6,3,9,44.0,82,5.44,62,351,2383,9.4
20151,Nick Foligno,2011-12,24.0,5,32,81,81,17,15,32,145.0,1108.0,126,23,18,41,189.0,82,5.7,65,341,2477,9.4
20152,Nick Foligno,2012-13,25.0,6,26,61,61,9,17,26,83.0,873.0,187,32,35,67,272.0,82,5.53,56,304,2486,9.1
20153,Nick Foligno,2013-14,26.0,7,34,82,82,14,20,34,149.0,1277.0,269,46,55,101,421.0,82,5.46,52,291,2492,9.0
20154,Nick Foligno,2014-15,27.0,8,47,82,82,15,32,47,153.0,1201.0,351,61,87,148,574.0,82,5.32,47,271,2439,8.9
20155,Nick Foligno,2015-16,28.0,9,19,45,45,6,13,19,69.0,744.0,396,67,100,167,643.0,48,5.31,29,160,1399,9.1
20156,Nick Foligno,2016-17,29.0,10,39,70,70,18,21,39,111.0,1124.0,466,85,121,206,754.0,82,5.34,48,269,2463,8.9
20157,Nick Foligno,2017-18,30.0,11,73,79,79,31,42,73,182.0,1488.0,545,116,163,279,936.0,82,5.32,47,251,2453,8.9
20158,Nick Foligno,2018-19,31.0,12,37,72,72,12,25,37,149.0,1216.0,617,128,188,316,1085.0,82,5.34,48,255,2438,9.0
20159,Nick Foligno,2019-20,32.0,13,51,79,79,26,25,51,185.0,1456.0,696,154,213,367,1270.0,82,5.45,47,245,2478,9.0
20160,Nick Foligno,2020-21,33.0,14,33,72,72,15,18,33,137.0,1321.0,768,169,231,400,1407.0,82,5.86,50,250,2620,9.2
20161,Nick Foligno,2021-22,34.0,15,35,73,73,17,18,35,141.0,1292.0,841,186,249,435,1548.0,82,5.96,47,239,2579,9.5
20162,Nick Foligno,2022-23,35.0,16,31,67,67,10,21,31,131.0,1251.0,908,196,270,466,1679.0,70,5.96,42,208,2192,9.5
20163,Nick Holden,2013-14,26.0,4,0,5,5,0,0,0,6.0,86.0,5,0,0,0,6.0,82,5.46,52,291,2492,9.0
20164,Nick Holden,2015-16,28.0,5,0,2,2,0,0,0,2.0,17.0,7,0,0,0,8.0,48,5.31,29,160,1399,9.1
20165,Nick Holden,2016-17,29.0,6,25,54,54,10,15,25,66.0,1009.0,61,10,15,25,74.0,82,5.34,48,269,2463,8.9
20166,Nick Holden,2017-18,30.0,7,14,78,78,5,9,14,94.0,1545.0,139,15,24,39,168.0,82,5.32,47,251,2453,8.9
20167,Nick Holden,2018-19,31.0,8,22,82,82,6,16,22,98.0,1794.0,221,21,40,61,266.0,82,5.34,48,255,2438,9.0
20168,Nick Holden,2019-20,32.0,9,34,80,80,11,23,34,84.0,1649.0,301,32,63,95,350.0,82,5.45,47,245,2478,9.0
20169,Nick Holden,2020-21,33.0,10,17,73,73,4,13,17,80.0,1387.0,374,36,76,112,430.0,82,5.86,50,250,2620,9.2
20170,Nick Holden,2021-22,34.0,11,15,61,61,3,12,15,77.0,1116.0,435,39,88,127,507.0,82,5.96,47,239,2579,9.5
20171,Nick Holden,2022-23,35.0,12,14,61,61,6,8,14,101.0,1150.0,496,45,96,141,608.0,70,5.96,42,208,2192,9.5
20172,Nick Jensen,2019-20,29.0,4,13,49,49,4,9,13,59.0,870.0,49,4,9,13,59.0,82,5.45,47,245,2478,9.0
20173,Nick Jensen,2020-21,30.0,5,15,81,81,0,15,15,107.0,1317.0,130,4,24,28,166.0,82,5.86,50,250,2620,9.2
20174,Nick Jensen,2021-22,31.0,6,20,80,80,2,18,20,94.0,1588.0,210,6,42,48,260.0,82,5.96,47,239,2579,9.5
20175,Nick Jensen,2022-23,32.0,7,8,68,68,0,8,8,61.0,1212.0,278,6,50,56,321.0,70,5.96,42,208,2192,9.5
20176,Nick Johnson,2012-13,27.0,4,2,6,6,1,1,2,7.0,61.0,6,1,1,2,7.0,82,5.53,56,304,2486,9.1
20177,Nick Johnson,2013-14,28.0,5,3,4,4,1,2,3,10.0,67.0,10,2,3,5,17.0,82,5.46,52,291,2492,9.0
20178,Nick Johnson,2014-15,29.0,6,26,77,77,8,18,26,146.0,1113.0,87,10,21,31,163.0,82,5.32,47,271,2439,8.9
20179,Nick Johnson,2015-16,30.0,7,6,17,17,4,2,6,23.0,169.0,104,14,23,37,186.0,48,5.31,29,160,1399,9.1
20180,Nick Johnson,2016-17,31.0,8,0,9,9,0,0,0,10.0,87.0,113,14,23,37,196.0,82,5.34,48,269,2463,8.9
20181,Nick Kypreos,1992-93,26.0,4,9,31,31,5,4,9,27.0,,31,5,4,9,27.0,80,7.37,76,367,2421,12.2
20182,Nick Kypreos,1993-94,27.0,5,18,79,79,9,9,18,60.0,,110,14,13,27,87.0,80,6.91,71,366,2385,11.6
20183,Nick Kypreos,1994-95,28.0,6,10,65,65,4,6,10,28.0,,175,18,19,37,115.0,80,6.96,77,402,2440,11.4
20184,Nick Kypreos,1995-96,29.0,7,27,75,75,17,10,27,81.0,,250,35,29,64,196.0,84,7.25,87,443,2603,11.7
20185,Nick Kypreos,1996-97,30.0,8,8,56,56,3,5,8,34.0,,306,38,34,72,230.0,84,6.48,76,407,2545,10.7
20186,Nick Kypreos,1997-98,31.0,9,4,40,40,1,3,4,16.0,,346,39,37,76,246.0,48,5.97,37,209,1408,10.2
20187,Nick Kypreos,1998-99,32.0,10,9,61,61,4,5,9,49.0,,407,43,42,85,295.0,82,6.29,74,413,2481,10.4
20188,Nick Kypreos,1999-00,33.0,11,5,35,35,3,2,5,18.0,,442,46,44,90,313.0,82,5.83,55,336,2444,9.8
20189,Nick Lappin,2019-20,27.0,4,7,43,43,4,3,7,57.0,504.0,43,4,3,7,57.0,82,5.45,47,245,2478,9.0
20190,Nick Lappin,2020-21,28.0,5,1,6,6,1,0,1,7.0,59.0,49,5,3,8,64.0,82,5.86,50,250,2620,9.2
20191,Nick Lappin,2021-22,29.0,6,0,11,11,0,0,0,11.0,151.0,60,5,3,8,75.0,82,5.96,47,239,2579,9.5
20192,Nick Leddy,2013-14,22.0,4,7,46,46,4,3,7,37.0,658.0,46,4,3,7,37.0,82,5.46,52,291,2492,9.0
20193,Nick Leddy,2014-15,23.0,5,37,82,82,3,34,37,94.0,1811.0,128,7,37,44,131.0,82,5.32,47,271,2439,8.9
20194,Nick Leddy,2015-16,24.0,6,18,48,48,6,12,18,65.0,836.0,176,13,49,62,196.0,48,5.31,29,160,1399,9.1
20195,Nick Leddy,2016-17,25.0,7,31,82,82,7,24,31,123.0,1342.0,258,20,73,93,319.0,82,5.34,48,269,2463,8.9
20196,Nick Leddy,2017-18,26.0,8,37,78,78,10,27,37,120.0,1588.0,336,30,100,130,439.0,82,5.32,47,251,2453,8.9
20197,Nick Leddy,2018-19,27.0,9,40,81,81,5,35,40,121.0,1832.0,417,35,135,170,560.0,82,5.34,48,255,2438,9.0
20198,Nick Leddy,2019-20,28.0,10,46,81,81,11,35,46,137.0,1840.0,498,46,170,216,697.0,82,5.45,47,245,2478,9.0
20199,Nick Leddy,2020-21,29.0,11,42,80,80,10,32,42,153.0,1794.0,578,56,202,258,850.0,82,5.86,50,250,2620,9.2
20200,Nick Leddy,2021-22,30.0,12,26,82,82,4,22,26,116.0,1767.0,660,60,224,284,966.0,82,5.96,47,239,2579,9.5
20201,Nick Leddy,2022-23,31.0,13,21,60,60,3,18,21,72.0,1267.0,720,63,242,305,1038.0,70,5.96,42,208,2192,9.5
20202,Nick Palmieri,2012-13,23.0,4,1,6,6,0,1,1,10.0,71.0,6,0,1,1,10.0,82,5.53,56,304,2486,9.1
20203,Nick Palmieri,2013-14,24.0,5,17,43,43,9,8,17,66.0,616.0,49,9,9,18,76.0,82,5.46,52,291,2492,9.0
20204,Nick Palmieri,2014-15,25.0,6,7,38,38,4,3,7,55.0,402.0,87,13,12,25,131.0,82,5.32,47,271,2439,8.9
20205,Nick Paul,2018-19,23.0,4,5,24,24,2,3,5,28.0,293.0,24,2,3,5,28.0,82,5.34,48,255,2438,9.0
20206,Nick Paul,2019-20,24.0,5,0,1,1,0,0,0,4.0,16.0,25,2,3,5,32.0,82,5.45,47,245,2478,9.0
20207,Nick Paul,2020-21,25.0,6,1,11,11,1,0,1,11.0,87.0,36,3,3,6,43.0,82,5.86,50,250,2620,9.2
20208,Nick Paul,2021-22,26.0,7,2,20,20,1,1,2,30.0,169.0,56,4,4,8,73.0,82,5.96,47,239,2579,9.5
20209,Nick Paul,2022-23,27.0,8,20,56,56,9,11,20,103.0,809.0,112,13,15,28,176.0,70,5.96,42,208,2192,9.5
20210,Nick Ritchie,2018-19,23.0,4,4,33,33,2,2,4,55.0,388.0,33,2,2,4,55.0,82,5.34,48,255,2438,9.0
20211,Nick Ritchie,2019-20,24.0,5,28,77,77,14,14,28,149.0,1000.0,110,16,16,32,204.0,82,5.45,47,245,2478,9.0
20212,Nick Ritchie,2020-21,25.0,6,27,76,76,10,17,27,122.0,1002.0,186,26,33,59,326.0,82,5.86,50,250,2620,9.2
20213,Nick Ritchie,2021-22,26.0,7,31,60,60,9,22,31,96.0,900.0,246,35,55,90,422.0,82,5.96,47,239,2579,9.5
20214,Nick Ritchie,2022-23,27.0,8,21,48,48,9,12,21,78.0,680.0,294,44,67,111,500.0,70,5.96,42,208,2192,9.5
20215,Nick Schmaltz,2019-20,23.0,4,28,61,61,6,22,28,66.0,809.0,61,6,22,28,66.0,82,5.45,47,245,2478,9.0
20216,Nick Schmaltz,2020-21,24.0,5,52,78,78,21,31,52,118.0,1422.0,139,27,53,80,184.0,82,5.86,50,250,2620,9.2
20217,Nick Schmaltz,2021-22,25.0,6,25,40,40,7,18,25,62.0,713.0,179,34,71,105,246.0,82,5.96,47,239,2579,9.5
20218,Nick Schmaltz,2022-23,26.0,7,45,70,70,11,34,45,95.0,1087.0,249,45,105,150,341.0,70,5.96,42,208,2192,9.5
20219,Nick Schultz,2004-05,22.0,4,10,52,52,4,6,10,47.0,839.0,52,4,6,10,47.0,82,5.24,53,338,2262,9.5
20220,Nick Schultz,2005-06,23.0,5,10,75,75,3,7,10,70.0,1385.0,127,7,13,20,117.0,82,5.31,60,363,2326,9.4
20221,Nick Schultz,2006-07,24.0,6,16,79,79,6,10,16,72.0,1604.0,206,13,23,36,189.0,82,5.14,57,348,2300,9.2
20222,Nick Schultz,2008-09,26.0,7,14,79,79,2,12,14,45.0,1419.0,285,15,35,50,234.0,82,6.05,85,480,2458,10.1
20223,Nick Schultz,2009-10,27.0,8,12,82,82,2,10,12,69.0,1657.0,367,17,45,62,303.0,82,5.76,70,398,2426,9.7
20224,Nick Schultz,2010-11,28.0,9,15,81,81,2,13,15,52.0,1634.0,448,19,58,77,355.0,82,5.44,62,351,2383,9.4
20225,Nick Schultz,2011-12,29.0,10,11,79,79,2,9,11,48.0,1624.0,527,21,67,88,403.0,82,5.7,65,341,2477,9.4
20226,Nick Schultz,2012-13,30.0,11,20,80,80,1,19,20,83.0,1677.0,607,22,86,108,486.0,82,5.53,56,304,2486,9.1
20227,Nick Schultz,2013-14,31.0,12,17,74,74,3,14,17,46.0,1496.0,681,25,100,125,532.0,82,5.46,52,291,2492,9.0
20228,Nick Schultz,2014-15,32.0,13,7,82,82,1,6,7,51.0,1616.0,763,26,106,132,583.0,82,5.32,47,271,2439,8.9
20229,Nick Schultz,2015-16,33.0,14,9,48,48,1,8,9,33.0,894.0,811,27,114,141,616.0,48,5.31,29,160,1399,9.1
20230,Nick Schultz,2016-17,34.0,15,5,69,69,0,5,5,35.0,1126.0,880,27,119,146,651.0,82,5.34,48,269,2463,8.9
20231,Nick Schultz,2017-18,35.0,16,15,80,80,2,13,15,69.0,1524.0,960,29,132,161,720.0,82,5.32,47,251,2453,8.9
20232,Nick Schultz,2018-19,36.0,17,10,81,81,1,9,10,70.0,1454.0,1041,30,141,171,790.0,82,5.34,48,255,2438,9.0
20233,Nick Schultz,2019-20,37.0,18,4,28,28,0,4,4,25.0,427.0,1069,30,145,175,815.0,82,5.45,47,245,2478,9.0
20234,Nick Seeler,2020-21,27.0,4,4,22,22,0,4,4,17.0,320.0,22,0,4,4,17.0,82,5.86,50,250,2620,9.2
20235,Nick Seeler,2021-22,28.0,5,7,71,71,2,5,7,67.0,876.0,93,2,9,11,84.0,82,5.96,47,239,2579,9.5
20236,Nick Seeler,2022-23,29.0,6,1,12,12,0,1,1,5.0,143.0,105,2,10,12,89.0,70,5.96,42,208,2192,9.5
20237,Nick Shore,2017-18,25.0,4,7,34,34,1,6,7,33.0,377.0,34,1,6,7,33.0,82,5.32,47,251,2453,8.9
20238,Nick Shore,2018-19,26.0,5,10,68,68,3,7,10,90.0,844.0,102,4,13,17,123.0,82,5.34,48,255,2438,9.0
20239,Nick Shore,2019-20,27.0,6,17,70,70,6,11,17,79.0,895.0,172,10,24,34,202.0,82,5.45,47,245,2478,9.0
20240,Nick Shore,2020-21,28.0,7,19,64,64,5,14,19,74.0,907.0,236,15,38,53,276.0,82,5.86,50,250,2620,9.2
20241,Nick Shore,2022-23,30.0,8,6,63,63,3,3,6,45.0,578.0,299,18,41,59,321.0,70,5.96,42,208,2192,9.5
20242,Nick Smith,2004-05,25.0,4,0,15,15,0,0,0,2.0,62.0,15,0,0,0,2.0,82,5.24,53,338,2262,9.5
20243,Nick Sorensen,2019-20,25.0,4,1,5,5,0,1,1,7.0,54.0,5,0,1,1,7.0,82,5.45,47,245,2478,9.0
20244,Nick Spaling,2012-13,24.0,4,3,28,28,0,3,3,26.0,310.0,28,0,3,3,26.0,82,5.53,56,304,2486,9.1
20245,Nick Spaling,2013-14,25.0,5,14,74,74,8,6,14,75.0,1031.0,102,8,9,17,101.0,82,5.46,52,291,2492,9.0
20246,Nick Spaling,2014-15,26.0,6,22,77,77,10,12,22,107.0,1210.0,179,18,21,39,208.0,82,5.32,47,271,2439,8.9
20247,Nick Spaling,2015-16,27.0,7,13,47,47,9,4,13,57.0,745.0,226,27,25,52,265.0,48,5.31,29,160,1399,9.1
20248,Nick Spaling,2016-17,28.0,8,32,71,71,13,19,32,85.0,1137.0,297,40,44,84,350.0,82,5.34,48,269,2463,8.9
20249,Nick Spaling,2017-18,29.0,9,27,82,82,9,18,27,90.0,1250.0,379,49,62,111,440.0,82,5.32,47,251,2453,8.9
20250,Nick Spaling,2018-19,30.0,10,13,58,58,3,10,13,53.0,828.0,437,52,72,124,493.0,82,5.34,48,255,2438,9.0
20251,Nick Stajduhar,1998-99,24.0,4,0,2,2,0,0,0,1.0,,2,0,0,0,1.0,82,6.29,74,413,2481,10.4
20252,Nick Suzuki,2022-23,23.0,4,41,71,71,13,28,41,138.0,1135.0,71,13,28,41,138.0,70,5.96,42,208,2192,9.5
20253,Nick Tarnasky,2008-09,24.0,4,1,12,12,0,1,1,9.0,56.0,12,0,1,1,9.0,82,6.05,85,480,2458,10.1
20254,Nick Tarnasky,2009-10,25.0,5,9,77,77,5,4,9,41.0,500.0,89,5,5,10,50.0,82,5.76,70,398,2426,9.7
20255,Nick Tarnasky,2010-11,26.0,6,10,80,80,6,4,10,91.0,660.0,169,11,9,20,141.0,82,5.44,62,351,2383,9.4
20256,Nick Tarnasky,2011-12,27.0,7,7,45,45,1,6,7,38.0,330.0,214,12,15,27,179.0,82,5.7,65,341,2477,9.4
20257,Nick Tarnasky,2012-13,28.0,8,3,31,31,1,2,3,19.0,211.0,245,13,17,30,198.0,82,5.53,56,304,2486,9.1
20258,Nick Vachon,1999-00,27.0,4,0,1,1,0,0,0,0.0,,1,0,0,0,0.0,82,5.83,55,336,2444,9.8
20259,Nicklas Backstrom,2010-11,23.0,4,69,82,82,14,55,69,153.0,1557.0,82,14,55,69,153.0,82,5.44,62,351,2383,9.4
20260,Nicklas Backstrom,2011-12,24.0,5,88,82,82,22,66,88,174.0,1635.0,164,36,121,157,327.0,82,5.7,65,341,2477,9.4
20261,Nicklas Backstrom,2012-13,25.0,6,101,82,82,33,68,101,222.0,1677.0,246,69,189,258,549.0,82,5.53,56,304,2486,9.1
20262,Nicklas Backstrom,2013-14,26.0,7,65,77,77,18,47,65,202.0,1586.0,323,87,236,323,751.0,82,5.46,52,291,2492,9.0
20263,Nicklas Backstrom,2014-15,27.0,8,44,42,42,14,30,44,95.0,805.0,365,101,266,367,846.0,82,5.32,47,271,2439,8.9
20264,Nicklas Backstrom,2015-16,28.0,9,48,48,48,8,40,48,82.0,955.0,413,109,306,415,928.0,48,5.31,29,160,1399,9.1
20265,Nicklas Backstrom,2016-17,29.0,10,79,82,82,18,61,79,196.0,1624.0,495,127,367,494,1124.0,82,5.34,48,269,2463,8.9
20266,Nicklas Backstrom,2017-18,30.0,11,78,82,82,18,60,78,153.0,1683.0,577,145,427,572,1277.0,82,5.32,47,251,2453,8.9
20267,Nicklas Backstrom,2018-19,31.0,12,70,75,75,20,50,70,129.0,1439.0,652,165,477,642,1406.0,82,5.34,48,255,2438,9.0
20268,Nicklas Backstrom,2019-20,32.0,13,86,82,82,23,63,86,162.0,1497.0,734,188,540,728,1568.0,82,5.45,47,245,2478,9.0
20269,Nicklas Backstrom,2020-21,33.0,14,71,81,81,21,50,71,165.0,1593.0,815,209,590,799,1733.0,82,5.86,50,250,2620,9.2
20270,Nicklas Backstrom,2021-22,34.0,15,74,80,80,22,52,74,169.0,1596.0,895,231,642,873,1902.0,82,5.96,47,239,2579,9.5
20271,Nicklas Backstrom,2022-23,35.0,16,54,61,61,12,42,54,132.0,1160.0,956,243,684,927,2034.0,70,5.96,42,208,2192,9.5
20272,Nicklas Grossmann,2009-10,25.0,4,0,8,8,0,0,0,8.0,103.0,8,0,0,0,8.0,82,5.76,70,398,2426,9.7
20273,Nicklas Grossmann,2010-11,26.0,5,7,62,62,0,7,7,34.0,964.0,70,0,7,7,42.0,82,5.44,62,351,2383,9.4
20274,Nicklas Grossmann,2011-12,27.0,6,12,81,81,2,10,12,60.0,1429.0,151,2,17,19,102.0,82,5.7,65,341,2477,9.4
20275,Nicklas Grossmann,2012-13,28.0,7,7,71,71,0,7,7,58.0,1362.0,222,2,24,26,160.0,82,5.53,56,304,2486,9.1
20276,Nicklas Grossmann,2013-14,29.0,8,10,59,59,1,9,10,38.0,1074.0,281,3,33,36,198.0,82,5.46,52,291,2492,9.0
20277,Nicklas Grossmann,2014-15,30.0,9,11,74,74,0,11,11,56.0,1392.0,355,3,44,47,254.0,82,5.32,47,271,2439,8.9
20278,Nicklas Grossmann,2015-16,31.0,10,4,30,30,1,3,4,21.0,550.0,385,4,47,51,275.0,48,5.31,29,160,1399,9.1
20279,Nicklas Grossmann,2016-17,32.0,11,14,78,78,1,13,14,71.0,1491.0,463,5,60,65,346.0,82,5.34,48,269,2463,8.9
20280,Nicklas Grossmann,2017-18,33.0,12,14,68,68,5,9,14,43.0,1201.0,531,10,69,79,389.0,82,5.32,47,251,2453,8.9
20281,Nicklas Grossmann,2018-19,34.0,13,7,58,58,3,4,7,42.0,1031.0,589,13,73,86,431.0,82,5.34,48,255,2438,9.0
20282,Nicklas Grossmann,2019-20,35.0,14,0,3,3,0,0,0,3.0,39.0,592,13,73,86,434.0,82,5.45,47,245,2478,9.0
20283,Nicklas Jensen,2015-16,22.0,4,0,2,2,0,0,0,0.0,28.0,2,0,0,0,0.0,48,5.31,29,160,1399,9.1
20284,Nicklas Jensen,2016-17,23.0,5,6,17,17,3,3,6,30.0,266.0,19,3,3,6,30.0,82,5.34,48,269,2463,8.9
20285,Nicklas Jensen,2017-18,24.0,6,0,5,5,0,0,0,7.0,48.0,24,3,3,6,37.0,82,5.32,47,251,2453,8.9
20286,Nicklas Jensen,2019-20,26.0,7,0,7,7,0,0,0,8.0,65.0,31,3,3,6,45.0,82,5.45,47,245,2478,9.0
20287,Nicklas Lidstrom,1994-95,24.0,4,60,80,80,11,49,60,168.0,,80,11,49,60,168.0,80,6.96,77,402,2440,11.4
20288,Nicklas Lidstrom,1995-96,25.0,5,41,84,84,7,34,41,156.0,,164,18,83,101,324.0,84,7.25,87,443,2603,11.7
20289,Nicklas Lidstrom,1996-97,26.0,6,56,84,84,10,46,56,200.0,,248,28,129,157,524.0,84,6.48,76,407,2545,10.7
20290,Nicklas Lidstrom,1997-98,27.0,7,26,43,43,10,16,26,90.0,,291,38,145,183,614.0,48,5.97,37,209,1408,10.2
20291,Nicklas Lidstrom,1998-99,28.0,8,67,81,81,17,50,67,211.0,,372,55,195,250,825.0,82,6.29,74,413,2481,10.4
20292,Nicklas Lidstrom,1999-00,29.0,9,57,79,79,15,42,57,214.0,,451,70,237,307,1039.0,82,5.83,55,336,2444,9.8
20293,Nicklas Lidstrom,2000-01,30.0,10,59,80,80,17,42,59,205.0,,531,87,279,366,1244.0,82,5.28,57,380,2242,9.6
20294,Nicklas Lidstrom,2001-02,31.0,11,57,81,81,14,43,57,205.0,2148.0,612,101,322,423,1449.0,82,5.27,57,359,2285,9.4
20295,Nicklas Lidstrom,2002-03,32.0,12,73,81,81,20,53,73,218.0,2328.0,693,121,375,496,1667.0,82,5.49,53,331,2294,9.8
20296,Nicklas Lidstrom,2003-04,33.0,13,71,82,82,15,56,71,272.0,2333.0,775,136,431,567,1939.0,82,5.51,63,376,2272,9.9
20297,Nicklas Lidstrom,2004-05,34.0,14,59,78,78,9,50,59,215.0,2247.0,853,145,481,626,2154.0,82,5.24,53,338,2262,9.5
20298,Nicklas Lidstrom,2005-06,35.0,15,62,82,82,18,44,62,175.0,2406.0,935,163,525,688,2329.0,82,5.31,60,363,2326,9.4
20299,Nicklas Lidstrom,2006-07,36.0,16,38,81,81,10,28,38,194.0,2240.0,1016,173,553,726,2523.0,82,5.14,57,348,2300,9.2
20300,Nicklas Lidstrom,2008-09,38.0,17,80,80,80,16,64,80,243.0,2249.0,1096,189,617,806,2766.0,82,6.05,85,480,2458,10.1
20301,Nicklas Lidstrom,2009-10,39.0,18,62,80,80,13,49,62,224.0,2199.0,1176,202,666,868,2990.0,82,5.76,70,398,2426,9.7
20302,Nicklas Lidstrom,2010-11,40.0,19,70,76,76,10,60,70,188.0,2031.0,1252,212,726,938,3178.0,82,5.44,62,351,2383,9.4
20303,Nicklas Lidstrom,2011-12,41.0,20,59,78,78,16,43,59,180.0,1936.0,1330,228,769,997,3358.0,82,5.7,65,341,2477,9.4
20304,Nicklas Lidstrom,2012-13,42.0,21,49,82,82,9,40,49,194.0,2085.0,1412,237,809,1046,3552.0,82,5.53,56,304,2486,9.1
20305,Nicklas Lidstrom,2013-14,43.0,22,62,82,82,16,46,62,175.0,1924.0,1494,253,855,1108,3727.0,82,5.46,52,291,2492,9.0
20306,Nicklas Lidstrom,2014-15,44.0,23,34,70,70,11,23,34,148.0,1664.0,1564,264,878,1142,3875.0,82,5.32,47,271,2439,8.9
20307,Niclas Bergfors,2010-11,23.0,4,0,1,1,0,0,0,3.0,11.0,1,0,0,0,3.0,82,5.44,62,351,2383,9.4
20308,Niclas Bergfors,2011-12,24.0,5,1,8,8,1,0,1,6.0,46.0,9,1,0,1,9.0,82,5.7,65,341,2477,9.4
20309,Niclas Bergfors,2012-13,25.0,6,44,81,81,21,23,44,217.0,1249.0,90,22,23,45,226.0,82,5.53,56,304,2486,9.1
20310,Niclas Bergfors,2013-14,26.0,7,36,72,72,12,24,36,152.0,1062.0,162,34,47,81,378.0,82,5.46,52,291,2492,9.0
20311,Niclas Bergfors,2014-15,27.0,8,2,11,11,1,1,2,11.0,89.0,173,35,48,83,389.0,82,5.32,47,271,2439,8.9
20312,Niclas Havelid,2002-03,29.0,4,9,50,50,2,7,9,70.0,958.0,50,2,7,9,70.0,82,5.49,53,331,2294,9.8
20313,Niclas Havelid,2003-04,30.0,5,14,47,47,4,10,14,69.0,1027.0,97,6,17,23,139.0,82,5.51,63,376,2272,9.9
20314,Niclas Havelid,2004-05,31.0,6,3,52,52,1,2,3,45.0,885.0,149,7,19,26,184.0,82,5.24,53,338,2262,9.5
20315,Niclas Havelid,2005-06,32.0,7,33,82,82,11,22,33,169.0,1844.0,231,18,41,59,353.0,82,5.31,60,363,2326,9.4
20316,Niclas Havelid,2006-07,33.0,8,26,79,79,6,20,26,122.0,1789.0,310,24,61,85,475.0,82,5.14,57,348,2300,9.2
20317,Niclas Havelid,2008-09,35.0,9,32,82,82,4,28,32,84.0,2002.0,392,28,89,117,559.0,82,6.05,85,480,2458,10.1
20318,Niclas Havelid,2009-10,36.0,10,21,77,77,3,18,21,82.0,1946.0,469,31,107,138,641.0,82,5.76,70,398,2426,9.7
20319,Niclas Havelid,2010-11,37.0,11,14,81,81,1,13,14,54.0,1661.0,550,32,120,152,695.0,82,5.44,62,351,2383,9.4
20320,Niclas Havelid,2011-12,38.0,12,19,78,78,2,17,19,56.0,1613.0,628,34,137,171,751.0,82,5.7,65,341,2477,9.4
20321,Niclas Wallin,2003-04,28.0,4,5,37,37,2,3,5,19.0,553.0,37,2,3,5,19.0,82,5.51,63,376,2272,9.9
20322,Niclas Wallin,2004-05,29.0,5,3,52,52,1,2,3,33.0,634.0,89,3,5,8,52.0,82,5.24,53,338,2262,9.5
20323,Niclas Wallin,2005-06,30.0,6,10,77,77,2,8,10,69.0,1248.0,166,5,13,18,121.0,82,5.31,60,363,2326,9.4
20324,Niclas Wallin,2006-07,31.0,7,10,57,57,3,7,10,74.0,1064.0,223,8,20,28,195.0,82,5.14,57,348,2300,9.2
20325,Niclas Wallin,2008-09,33.0,8,8,50,50,4,4,8,44.0,841.0,273,12,24,36,239.0,82,6.05,85,480,2458,10.1
20326,Niclas Wallin,2009-10,34.0,9,10,67,67,2,8,10,76.0,1242.0,340,14,32,46,315.0,82,5.76,70,398,2426,9.7
20327,Niclas Wallin,2010-11,35.0,10,8,66,66,2,6,8,60.0,1197.0,406,16,38,54,375.0,82,5.44,62,351,2383,9.4
20328,Niclas Wallin,2011-12,36.0,11,10,64,64,2,8,10,53.0,1041.0,470,18,46,64,428.0,82,5.7,65,341,2477,9.4
20329,Niclas Wallin,2012-13,37.0,12,7,70,70,0,7,7,72.0,1213.0,540,18,53,71,500.0,82,5.53,56,304,2486,9.1
20330,Niclas Wallin,2013-14,38.0,13,8,74,74,3,5,8,86.0,1172.0,614,21,58,79,586.0,82,5.46,52,291,2492,9.0
20331,Nico Hischier,2020-21,22.0,4,52,82,82,20,32,52,180.0,1337.0,82,20,32,52,180.0,82,5.86,50,250,2620,9.2
20332,Nico Hischier,2021-22,23.0,5,47,69,69,17,30,47,160.0,1249.0,151,37,62,99,340.0,82,5.96,47,239,2579,9.5
20333,Nico Hischier,2022-23,24.0,6,36,58,58,14,22,36,123.0,1048.0,209,51,84,135,463.0,70,5.96,42,208,2192,9.5
20334,Nico Sturm,2021-22,26.0,4,0,2,2,0,0,0,7.0,26.0,2,0,0,0,7.0,82,5.96,47,239,2579,9.5
20335,Nico Sturm,2022-23,27.0,5,2,6,6,0,2,2,2.0,71.0,8,0,2,2,9.0,70,5.96,42,208,2192,9.5
20336,Nicolas Aube-Kubel,2021-22,25.0,4,0,9,9,0,0,0,2.0,50.0,9,0,0,0,2.0,82,5.96,47,239,2579,9.5
20337,Nicolas Aube-Kubel,2022-23,26.0,5,15,36,36,7,8,15,48.0,406.0,45,7,8,15,50.0,70,5.96,42,208,2192,9.5
20338,Nicolas Beaudin,2022-23,23.0,4,0,1,1,0,0,0,2.0,17.0,1,0,0,0,2.0,70,5.96,42,208,2192,9.5
20339,Nicolas Blanchard,2015-16,28.0,4,0,9,9,0,0,0,6.0,78.0,9,0,0,0,6.0,48,5.31,29,160,1399,9.1
20340,Nicolas Deschamps,2016-17,27.0,4,0,3,3,0,0,0,2.0,20.0,3,0,0,0,2.0,82,5.34,48,269,2463,8.9
20341,Nicolas Deslauriers,2016-17,25.0,4,1,17,17,1,0,1,30.0,223.0,17,1,0,1,30.0,82,5.34,48,269,2463,8.9
20342,Nicolas Deslauriers,2017-18,26.0,5,15,82,82,5,10,15,76.0,973.0,99,6,10,16,106.0,82,5.32,47,251,2453,8.9
20343,Nicolas Deslauriers,2018-19,27.0,6,12,70,70,6,6,12,72.0,723.0,169,12,16,28,178.0,82,5.34,48,255,2438,9.0
20344,Nicolas Deslauriers,2019-20,28.0,7,2,42,42,0,2,2,26.0,311.0,211,12,18,30,204.0,82,5.45,47,245,2478,9.0
20345,Nicolas Deslauriers,2020-21,29.0,8,14,58,58,10,4,14,77.0,673.0,269,22,22,44,281.0,82,5.86,50,250,2620,9.2
20346,Nicolas Deslauriers,2021-22,30.0,9,5,48,48,2,3,5,48.0,482.0,317,24,25,49,329.0,82,5.96,47,239,2579,9.5
20347,Nicolas Deslauriers,2022-23,31.0,10,13,59,59,7,6,13,64.0,577.0,376,31,31,62,393.0,70,5.96,42,208,2192,9.5
20348,Nicolas Hague,2022-23,24.0,4,11,38,38,1,10,11,54.0,611.0,38,1,10,11,54.0,70,5.96,42,208,2192,9.5
20349,Nicolas Kerdiles,2019-20,26.0,4,0,1,1,0,0,0,0.0,11.0,1,0,0,0,0.0,82,5.45,47,245,2478,9.0
20350,Nicolas Kerdiles,2020-21,27.0,5,0,2,2,0,0,0,0.0,8.0,3,0,0,0,0.0,82,5.86,50,250,2620,9.2
20351,Nicolas Roy,2020-21,23.0,4,0,1,1,0,0,0,1.0,11.0,1,0,0,0,1.0,82,5.86,50,250,2620,9.2
20352,Nicolas Roy,2021-22,24.0,5,0,6,6,0,0,0,1.0,42.0,7,0,0,0,2.0,82,5.96,47,239,2579,9.5
20353,Nicolas Roy,2022-23,25.0,6,10,28,28,5,5,10,42.0,320.0,35,5,5,10,44.0,70,5.96,42,208,2192,9.5
20354,Nigel Dawes,2009-10,24.0,4,1,8,8,1,0,1,7.0,54.0,8,1,0,1,7.0,82,5.76,70,398,2426,9.7
20355,Nigel Dawes,2010-11,25.0,5,29,61,61,14,15,29,121.0,792.0,69,15,15,30,128.0,82,5.44,62,351,2383,9.4
20356,Nigel Dawes,2011-12,26.0,6,21,64,64,10,11,21,115.0,848.0,133,25,26,51,243.0,82,5.7,65,341,2477,9.4
20357,Nigel Dawes,2012-13,27.0,7,32,66,66,14,18,32,96.0,960.0,199,39,44,83,339.0,82,5.53,56,304,2486,9.1
20358,Nigel Dawes,2013-14,28.0,8,1,13,13,0,1,1,12.0,128.0,212,39,45,84,351.0,82,5.46,52,291,2492,9.0
20359,Nik Antropov,2002-03,22.0,4,30,66,66,12,18,30,89.0,845.0,66,12,18,30,89.0,82,5.49,53,331,2294,9.8
20360,Nik Antropov,2003-04,23.0,5,17,52,52,6,11,17,71.0,522.0,118,18,29,47,160.0,82,5.51,63,376,2272,9.9
20361,Nik Antropov,2004-05,24.0,6,2,11,11,1,1,2,12.0,98.0,129,19,30,49,172.0,82,5.24,53,338,2262,9.5
20362,Nik Antropov,2005-06,25.0,7,45,72,72,16,29,45,102.0,1080.0,201,35,59,94,274.0,82,5.31,60,363,2326,9.4
20363,Nik Antropov,2006-07,26.0,8,31,62,62,13,18,31,89.0,948.0,263,48,77,125,363.0,82,5.14,57,348,2300,9.2
20364,Nik Antropov,2008-09,28.0,9,31,57,57,12,19,31,113.0,887.0,320,60,96,156,476.0,82,6.05,85,480,2458,10.1
20365,Nik Antropov,2009-10,29.0,10,33,54,54,18,15,33,125.0,896.0,374,78,111,189,601.0,82,5.76,70,398,2426,9.7
20366,Nik Antropov,2010-11,30.0,11,56,72,72,26,30,56,165.0,1448.0,446,104,141,245,766.0,82,5.44,62,351,2383,9.4
20367,Nik Antropov,2011-12,31.0,12,59,81,81,28,31,59,224.0,1392.0,527,132,172,304,990.0,82,5.7,65,341,2477,9.4
20368,Nik Antropov,2012-13,32.0,13,67,76,76,24,43,67,126.0,1385.0,603,156,215,371,1116.0,82,5.53,56,304,2486,9.1
20369,Nik Antropov,2013-14,33.0,14,41,76,76,16,25,41,105.0,1189.0,679,172,240,412,1221.0,82,5.46,52,291,2492,9.0
20370,Nik Antropov,2014-15,34.0,15,35,69,69,15,20,35,95.0,1140.0,748,187,260,447,1316.0,82,5.32,47,271,2439,8.9
20371,Nik Antropov,2015-16,35.0,16,18,40,40,6,12,18,56.0,638.0,788,193,272,465,1372.0,48,5.31,29,160,1399,9.1
20372,Nikita Alexeev,2004-05,23.0,4,8,44,44,4,4,8,47.0,503.0,44,4,4,8,47.0,82,5.24,53,338,2262,9.5
20373,Nikita Alexeev,2005-06,24.0,5,6,37,37,4,2,6,52.0,426.0,81,8,6,14,99.0,82,5.31,60,363,2326,9.4
20374,Nikita Alexeev,2009-10,28.0,6,23,78,78,12,11,23,117.0,1075.0,159,20,17,37,216.0,82,5.76,70,398,2426,9.7
20375,Nikita Filatov,2011-12,21.0,4,4,8,8,4,0,4,10.0,65.0,8,4,0,4,10.0,82,5.7,65,341,2477,9.4
20376,Nikita Filatov,2012-13,22.0,5,2,13,13,2,0,2,11.0,105.0,21,6,0,6,21.0,82,5.53,56,304,2486,9.1
20377,Nikita Filatov,2013-14,23.0,6,7,23,23,0,7,7,31.0,283.0,44,6,7,13,52.0,82,5.46,52,291,2492,9.0
20378,Nikita Filatov,2014-15,24.0,7,1,9,9,0,1,1,6.0,88.0,53,6,8,14,58.0,82,5.32,47,271,2439,8.9
20379,Nikita Gusev,2022-23,30.0,4,44,66,66,13,31,44,158.0,970.0,66,13,31,44,158.0,70,5.96,42,208,2192,9.5
20380,Nikita Kucherov,2016-17,23.0,4,18,52,52,9,9,18,102.0,682.0,52,9,9,18,102.0,82,5.34,48,269,2463,8.9
20381,Nikita Kucherov,2017-18,24.0,5,65,82,82,29,36,65,191.0,1226.0,134,38,45,83,293.0,82,5.32,47,251,2453,8.9
20382,Nikita Kucherov,2018-19,25.0,6,66,77,77,30,36,66,209.0,1402.0,211,68,81,149,502.0,82,5.34,48,255,2438,9.0
20383,Nikita Kucherov,2019-20,26.0,7,85,74,74,40,45,85,246.0,1438.0,285,108,126,234,748.0,82,5.45,47,245,2478,9.0
20384,Nikita Kucherov,2020-21,27.0,8,100,80,80,39,61,100,279.0,1586.0,365,147,187,334,1027.0,82,5.86,50,250,2620,9.2
20385,Nikita Kucherov,2021-22,28.0,9,128,82,82,41,87,128,246.0,1637.0,447,188,274,462,1273.0,82,5.96,47,239,2579,9.5
20386,Nikita Kucherov,2022-23,29.0,10,85,68,68,33,52,85,210.0,1283.0,515,221,326,547,1483.0,70,5.96,42,208,2192,9.5
20387,Nikita Nesterov,2017-18,24.0,4,7,27,27,2,5,7,44.0,433.0,27,2,5,7,44.0,82,5.32,47,251,2453,8.9
20388,Nikita Nesterov,2018-19,25.0,5,9,57,57,3,6,9,57.0,849.0,84,5,11,16,101.0,82,5.34,48,255,2438,9.0
20389,Nikita Nesterov,2019-20,26.0,6,17,48,48,4,13,17,63.0,782.0,132,9,24,33,164.0,82,5.45,47,245,2478,9.0
20390,Nikita Nikitin,2013-14,27.0,4,9,41,41,1,8,9,46.0,672.0,41,1,8,9,46.0,82,5.46,52,291,2492,9.0
20391,Nikita Nikitin,2014-15,28.0,5,32,61,61,7,25,32,103.0,1415.0,102,8,33,41,149.0,82,5.32,47,271,2439,8.9
20392,Nikita Nikitin,2015-16,29.0,6,9,38,38,3,6,9,60.0,806.0,140,11,39,50,209.0,48,5.31,29,160,1399,9.1
20393,Nikita Nikitin,2016-17,30.0,7,15,66,66,2,13,15,95.0,1130.0,206,13,52,65,304.0,82,5.34,48,269,2463,8.9
20394,Nikita Nikitin,2017-18,31.0,8,10,42,42,4,6,10,80.0,825.0,248,17,58,75,384.0,82,5.32,47,251,2453,8.9
20395,Nikita Nikitin,2018-19,32.0,9,1,11,11,0,1,1,12.0,163.0,259,17,59,76,396.0,82,5.34,48,255,2438,9.0
20396,Nikita Scherbak,2019-20,24.0,4,1,3,3,1,0,1,3.0,34.0,3,1,0,1,3.0,82,5.45,47,245,2478,9.0
20397,Nikita Scherbak,2020-21,25.0,5,6,26,26,4,2,6,39.0,348.0,29,5,2,7,42.0,82,5.86,50,250,2620,9.2
20398,Nikita Scherbak,2021-22,26.0,6,1,8,8,1,0,1,12.0,81.0,37,6,2,8,54.0,82,5.96,47,239,2579,9.5
20399,Nikita Soshnikov,2018-19,25.0,4,5,11,11,2,3,5,33.0,172.0,11,2,3,5,33.0,82,5.34,48,255,2438,9.0
20400,Nikita Soshnikov,2019-20,26.0,5,9,56,56,5,4,9,70.0,608.0,67,7,7,14,103.0,82,5.45,47,245,2478,9.0
20401,Nikita Soshnikov,2020-21,27.0,6,2,15,15,1,1,2,17.0,165.0,82,8,8,16,120.0,82,5.86,50,250,2620,9.2
20402,Nikita Soshnikov,2021-22,28.0,7,0,5,5,0,0,0,1.0,36.0,87,8,8,16,121.0,82,5.96,47,239,2579,9.5
20403,Nikita Tryamkin,2018-19,24.0,4,2,13,13,1,1,2,11.0,228.0,13,1,1,2,11.0,82,5.34,48,255,2438,9.0
20404,Nikita Tryamkin,2019-20,25.0,5,9,66,66,2,7,9,65.0,1105.0,79,3,8,11,76.0,82,5.45,47,245,2478,9.0
20405,Nikita Zadorov,2016-17,21.0,4,1,7,7,1,0,1,4.0,120.0,7,1,0,1,4.0,82,5.34,48,269,2463,8.9
20406,Nikita Zadorov,2017-18,22.0,5,15,60,60,3,12,15,52.0,1062.0,67,4,12,16,56.0,82,5.32,47,251,2453,8.9
20407,Nikita Zadorov,2018-19,23.0,6,2,22,22,0,2,2,18.0,373.0,89,4,14,18,74.0,82,5.34,48,255,2438,9.0
20408,Nikita Zadorov,2019-20,24.0,7,10,56,56,0,10,10,61.0,1066.0,145,4,24,28,135.0,82,5.45,47,245,2478,9.0
20409,Nikita Zadorov,2020-21,25.0,8,20,77,77,7,13,20,94.0,1499.0,222,11,37,48,229.0,82,5.86,50,250,2620,9.2
20410,Nikita Zadorov,2021-22,26.0,9,14,70,70,7,7,14,100.0,1204.0,292,18,44,62,329.0,82,5.96,47,239,2579,9.5
20411,Nikita Zadorov,2022-23,27.0,10,13,64,64,4,9,13,65.0,1137.0,356,22,53,75,394.0,70,5.96,42,208,2192,9.5
20412,Nikita Zaitsev,2019-20,28.0,4,36,82,82,4,32,36,106.0,1806.0,82,4,32,36,106.0,82,5.45,47,245,2478,9.0
20413,Nikita Zaitsev,2020-21,29.0,5,13,60,60,5,8,13,54.0,1333.0,142,9,40,49,160.0,82,5.86,50,250,2620,9.2
20414,Nikita Zaitsev,2021-22,30.0,6,14,81,81,3,11,14,71.0,1658.0,223,12,51,63,231.0,82,5.96,47,239,2579,9.5
20415,Nikita Zaitsev,2022-23,31.0,7,12,58,58,1,11,12,64.0,1285.0,281,13,62,75,295.0,70,5.96,42,208,2192,9.5
20416,Niklas Andersson,1995-96,24.0,4,1,3,3,0,1,1,4.0,,3,0,1,1,4.0,84,7.25,87,443,2603,11.7
20417,Niklas Andersson,1998-99,27.0,5,26,47,47,14,12,26,89.0,,50,14,13,27,93.0,82,6.29,74,413,2481,10.4
20418,Niklas Andersson,1999-00,28.0,6,43,74,74,12,31,43,122.0,,124,26,44,70,215.0,82,5.83,55,336,2444,9.8
20419,Niklas Andersson,2000-01,29.0,7,0,5,5,0,0,0,6.0,,129,26,44,70,221.0,82,5.28,57,380,2242,9.6
20420,Niklas Andersson,2002-03,31.0,8,11,24,24,3,8,11,31.0,316.0,153,29,52,81,252.0,82,5.49,53,331,2294,9.8
20421,Niklas Andersson,2003-04,32.0,9,1,11,11,0,1,1,8.0,123.0,164,29,53,82,260.0,82,5.51,63,376,2272,9.9
20422,Niklas Hagman,2004-05,25.0,4,28,78,78,10,18,28,134.0,1079.0,78,10,18,28,134.0,82,5.24,53,338,2262,9.5
20423,Niklas Hagman,2005-06,26.0,5,23,80,80,8,15,23,132.0,1081.0,158,18,33,51,266.0,82,5.31,60,363,2326,9.4
20424,Niklas Hagman,2006-07,27.0,6,23,75,75,10,13,23,122.0,1109.0,233,28,46,74,388.0,82,5.14,57,348,2300,9.2
20425,Niklas Hagman,2008-09,29.0,7,21,84,84,8,13,21,126.0,1029.0,317,36,59,95,514.0,82,6.05,85,480,2458,10.1
20426,Niklas Hagman,2009-10,30.0,8,29,82,82,17,12,29,152.0,1183.0,399,53,71,124,666.0,82,5.76,70,398,2426,9.7
20427,Niklas Hagman,2010-11,31.0,9,41,82,82,27,14,41,178.0,1279.0,481,80,85,165,844.0,82,5.44,62,351,2383,9.4
20428,Niklas Hagman,2011-12,32.0,10,42,65,65,22,20,42,168.0,1110.0,546,102,105,207,1012.0,82,5.7,65,341,2477,9.4
20429,Niklas Hagman,2012-13,33.0,11,44,82,82,25,19,44,216.0,1322.0,628,127,124,251,1228.0,82,5.53,56,304,2486,9.1
20430,Niklas Hagman,2013-14,34.0,12,27,71,71,11,16,27,140.0,968.0,699,138,140,278,1368.0,82,5.46,52,291,2492,9.0
20431,Niklas Hagman,2014-15,35.0,13,23,71,71,9,14,23,125.0,1035.0,770,147,154,301,1493.0,82,5.32,47,271,2439,8.9
20432,Niklas Hjalmarsson,2010-11,23.0,4,1,13,13,0,1,1,5.0,177.0,13,0,1,1,5.0,82,5.44,62,351,2383,9.4
20433,Niklas Hjalmarsson,2011-12,24.0,5,3,21,21,1,2,3,15.0,315.0,34,1,3,4,20.0,82,5.7,65,341,2477,9.4
20434,Niklas Hjalmarsson,2012-13,25.0,6,17,77,77,2,15,17,62.0,1514.0,111,3,18,21,82.0,82,5.53,56,304,2486,9.1
20435,Niklas Hjalmarsson,2013-14,26.0,7,10,80,80,3,7,10,64.0,1478.0,191,6,25,31,146.0,82,5.46,52,291,2492,9.0
20436,Niklas Hjalmarsson,2014-15,27.0,8,15,69,69,1,14,15,65.0,1392.0,260,7,39,46,211.0,82,5.32,47,271,2439,8.9
20437,Niklas Hjalmarsson,2015-16,28.0,9,10,46,46,2,8,10,43.0,962.0,306,9,47,56,254.0,48,5.31,29,160,1399,9.1
20438,Niklas Hjalmarsson,2016-17,29.0,10,26,81,81,4,22,26,98.0,1724.0,387,13,69,82,352.0,82,5.34,48,269,2463,8.9
20439,Niklas Hjalmarsson,2017-18,30.0,11,19,82,82,3,16,19,97.0,1795.0,469,16,85,101,449.0,82,5.32,47,251,2453,8.9
20440,Niklas Hjalmarsson,2018-19,31.0,12,24,81,81,2,22,24,77.0,1813.0,550,18,107,125,526.0,82,5.34,48,255,2438,9.0
20441,Niklas Hjalmarsson,2019-20,32.0,13,18,73,73,5,13,18,61.0,1569.0,623,23,120,143,587.0,82,5.45,47,245,2478,9.0
20442,Niklas Hjalmarsson,2020-21,33.0,14,9,48,48,1,8,9,32.0,994.0,671,24,128,152,619.0,82,5.86,50,250,2620,9.2
20443,Niklas Hjalmarsson,2021-22,34.0,15,10,82,82,0,10,10,57.0,1615.0,753,24,138,162,676.0,82,5.96,47,239,2579,9.5
20444,Niklas Hjalmarsson,2022-23,35.0,16,5,27,27,1,4,5,18.0,507.0,780,25,142,167,694.0,70,5.96,42,208,2192,9.5
20445,Niklas Kronwall,2006-07,26.0,4,5,20,20,1,4,5,18.0,277.0,20,1,4,5,18.0,82,5.14,57,348,2300,9.2
20446,Niklas Kronwall,2008-09,28.0,5,9,27,27,1,8,9,28.0,554.0,47,2,12,14,46.0,82,6.05,85,480,2458,10.1
20447,Niklas Kronwall,2009-10,29.0,6,22,68,68,1,21,22,104.0,1404.0,115,3,33,36,150.0,82,5.76,70,398,2426,9.7
20448,Niklas Kronwall,2010-11,30.0,7,35,65,65,7,28,35,108.0,1372.0,180,10,61,71,258.0,82,5.44,62,351,2383,9.4
20449,Niklas Kronwall,2011-12,31.0,8,51,80,80,6,45,51,121.0,1832.0,260,16,106,122,379.0,82,5.7,65,341,2477,9.4
20450,Niklas Kronwall,2012-13,32.0,9,22,48,48,7,15,22,68.0,1052.0,308,23,121,144,447.0,82,5.53,56,304,2486,9.1
20451,Niklas Kronwall,2013-14,33.0,10,37,77,77,11,26,37,131.0,1761.0,385,34,147,181,578.0,82,5.46,52,291,2492,9.0
20452,Niklas Kronwall,2014-15,34.0,11,36,82,82,15,21,36,141.0,1875.0,467,49,168,217,719.0,82,5.32,47,271,2439,8.9
20453,Niklas Kronwall,2015-16,35.0,12,29,48,48,5,24,29,67.0,1169.0,515,54,192,246,786.0,48,5.31,29,160,1399,9.1
20454,Niklas Kronwall,2016-17,36.0,13,49,79,79,8,41,49,110.0,1921.0,594,62,233,295,896.0,82,5.34,48,269,2463,8.9
20455,Niklas Kronwall,2017-18,37.0,14,44,80,80,9,35,44,101.0,1907.0,674,71,268,339,997.0,82,5.32,47,251,2453,8.9
20456,Niklas Kronwall,2018-19,38.0,15,26,64,64,3,23,26,61.0,1409.0,738,74,291,365,1058.0,82,5.34,48,255,2438,9.0
20457,Niklas Kronwall,2019-20,39.0,16,13,57,57,2,11,13,67.0,1109.0,795,76,302,378,1125.0,82,5.45,47,245,2478,9.0
20458,Niklas Kronwall,2020-21,40.0,17,27,79,79,4,23,27,76.0,1463.0,874,80,325,405,1201.0,82,5.86,50,250,2620,9.2
20459,Niklas Kronwall,2021-22,41.0,18,27,79,79,3,24,27,71.0,1576.0,953,83,349,432,1272.0,82,5.96,47,239,2579,9.5
20460,Niklas Nordgren,2008-09,29.0,4,6,58,58,4,2,6,38.0,411.0,58,4,2,6,38.0,82,6.05,85,480,2458,10.1
20461,Niklas Sundblad,1998-99,26.0,4,0,2,2,0,0,0,3.0,,2,0,0,0,3.0,82,6.29,74,413,2481,10.4
20462,Niklas Sundstrom,1998-99,23.0,4,21,82,82,9,12,21,90.0,,82,9,12,21,90.0,82,6.29,74,413,2481,10.4
20463,Niklas Sundstrom,1999-00,24.0,5,52,82,82,24,28,52,132.0,,164,33,40,73,222.0,82,5.83,55,336,2444,9.8
20464,Niklas Sundstrom,2000-01,25.0,6,47,70,70,19,28,47,115.0,,234,52,68,120,337.0,82,5.28,57,380,2242,9.6
20465,Niklas Sundstrom,2001-02,26.0,7,43,81,81,13,30,43,89.0,1554.0,315,65,98,163,426.0,82,5.27,57,359,2285,9.4
20466,Niklas Sundstrom,2002-03,27.0,8,37,79,79,12,25,37,90.0,1198.0,394,77,123,200,516.0,82,5.49,53,331,2294,9.8
20467,Niklas Sundstrom,2003-04,28.0,9,49,82,82,10,39,49,100.0,1372.0,476,87,162,249,616.0,82,5.51,63,376,2272,9.9
20468,Niklas Sundstrom,2004-05,29.0,10,39,73,73,9,30,39,74.0,1164.0,549,96,192,288,690.0,82,5.24,53,338,2262,9.5
20469,Niklas Sundstrom,2005-06,30.0,11,26,80,80,7,19,26,71.0,1141.0,629,103,211,314,761.0,82,5.31,60,363,2326,9.4
20470,Niklas Sundstrom,2006-07,31.0,12,20,66,66,8,12,20,67.0,943.0,695,111,223,334,828.0,82,5.14,57,348,2300,9.2
20471,Niklas Sundstrom,2008-09,33.0,13,15,55,55,6,9,15,54.0,772.0,750,117,232,349,882.0,82,6.05,85,480,2458,10.1
20472,Niko Dimitrakos,2005-06,26.0,4,13,21,21,6,7,13,34.0,299.0,21,6,7,13,34.0,82,5.31,60,363,2326,9.4
20473,Niko Dimitrakos,2006-07,27.0,5,24,68,68,9,15,24,116.0,906.0,89,15,22,37,150.0,82,5.14,57,348,2300,9.2
20474,Niko Dimitrakos,2008-09,29.0,6,25,64,64,9,16,25,93.0,742.0,153,24,38,62,243.0,82,6.05,85,480,2458,10.1
20475,Niko Dimitrakos,2009-10,30.0,7,0,5,5,0,0,0,4.0,43.0,158,24,38,62,247.0,82,5.76,70,398,2426,9.7
20476,Niko Kapanen,2004-05,26.0,4,1,9,9,0,1,1,3.0,88.0,9,0,1,1,3.0,82,5.24,53,338,2262,9.5
20477,Niko Kapanen,2005-06,27.0,5,34,82,82,5,29,34,80.0,1201.0,91,5,30,35,83.0,82,5.31,60,363,2326,9.4
20478,Niko Kapanen,2006-07,28.0,6,6,67,67,1,5,6,57.0,771.0,158,6,35,41,140.0,82,5.14,57,348,2300,9.2
20479,Niko Kapanen,2008-09,30.0,7,35,81,81,14,21,35,97.0,1152.0,239,20,56,76,237.0,82,6.05,85,480,2458,10.1
20480,Niko Kapanen,2009-10,31.0,8,22,79,79,6,16,22,79.0,979.0,318,26,72,98,316.0,82,5.76,70,398,2426,9.7
20481,Niko Kapanen,2010-11,32.0,9,28,79,79,10,18,28,85.0,1091.0,397,36,90,126,401.0,82,5.44,62,351,2383,9.4
20482,Niko Mikkola,2022-23,26.0,4,1,5,5,0,1,1,10.0,72.0,5,0,1,1,10.0,70,5.96,42,208,2192,9.5
20483,Nikolai Borschevsky,1995-96,31.0,4,74,78,78,34,40,74,204.0,,78,34,40,74,204.0,84,7.25,87,443,2603,11.7
20484,Nikolai Borschevsky,1996-97,32.0,5,34,45,45,14,20,34,105.0,,123,48,60,108,309.0,84,6.48,76,407,2545,10.7
20485,Nikolai Borschevsky,1997-98,33.0,6,10,27,27,0,10,10,40.0,,150,48,70,118,349.0,48,5.97,37,209,1408,10.2
20486,Nikolai Borschevsky,1998-99,34.0,7,4,12,12,1,3,4,22.0,,162,49,73,122,371.0,82,6.29,74,413,2481,10.4
20487,Nikolai Knyzhov,2022-23,24.0,4,0,3,3,0,0,0,0.0,32.0,3,0,0,0,0.0,70,5.96,42,208,2192,9.5
20488,Nikolai Kulemin,2011-12,25.0,4,31,73,73,15,16,31,129.0,1008.0,73,15,16,31,129.0,82,5.7,65,341,2477,9.4
20489,Nikolai Kulemin,2012-13,26.0,5,36,78,78,16,20,36,145.0,1277.0,151,31,36,67,274.0,82,5.53,56,304,2486,9.1
20490,Nikolai Kulemin,2013-14,27.0,6,57,82,82,30,27,57,173.0,1421.0,233,61,63,124,447.0,82,5.46,52,291,2492,9.0
20491,Nikolai Kulemin,2014-15,28.0,7,28,70,70,7,21,28,107.0,1066.0,303,68,84,152,554.0,82,5.32,47,271,2439,8.9
20492,Nikolai Kulemin,2015-16,29.0,8,23,48,48,7,16,23,72.0,803.0,351,75,100,175,626.0,48,5.31,29,160,1399,9.1
20493,Nikolai Kulemin,2016-17,30.0,9,20,70,70,9,11,20,81.0,1136.0,421,84,111,195,707.0,82,5.34,48,269,2463,8.9
20494,Nikolai Kulemin,2017-18,31.0,10,31,82,82,15,16,31,115.0,1219.0,503,99,127,226,822.0,82,5.32,47,251,2453,8.9
20495,Nikolai Kulemin,2018-19,32.0,11,22,81,81,9,13,22,92.0,1139.0,584,108,140,248,914.0,82,5.34,48,255,2438,9.0
20496,Nikolai Kulemin,2019-20,33.0,12,23,72,72,12,11,23,74.0,995.0,656,120,151,271,988.0,82,5.45,47,245,2478,9.0
20497,Nikolai Kulemin,2020-21,34.0,13,3,13,13,1,2,3,7.0,155.0,669,121,153,274,995.0,82,5.86,50,250,2620,9.2
20498,Nikolai Prokhorkin,2022-23,29.0,4,14,43,43,4,10,14,63.0,520.0,43,4,10,14,63.0,70,5.96,42,208,2192,9.5
20499,Nikolai Tsulygin,1999-00,24.0,4,1,22,22,0,1,1,10.0,,22,0,1,1,10.0,82,5.83,55,336,2444,9.8
20500,Nikolai Zherdev,2006-07,22.0,4,34,57,57,13,21,34,137.0,922.0,57,13,21,34,137.0,82,5.14,57,348,2300,9.2
20501,Nikolai Zherdev,2008-09,24.0,5,54,73,73,27,27,54,194.0,1284.0,130,40,48,88,331.0,82,6.05,85,480,2458,10.1
20502,Nikolai Zherdev,2009-10,25.0,6,32,71,71,10,22,32,164.0,1152.0,201,50,70,120,495.0,82,5.76,70,398,2426,9.7
20503,Nikolai Zherdev,2010-11,26.0,7,61,82,82,26,35,61,254.0,1589.0,283,76,105,181,749.0,82,5.44,62,351,2383,9.4
20504,Nikolai Zherdev,2011-12,27.0,8,58,82,82,23,35,58,219.0,1380.0,365,99,140,239,968.0,82,5.7,65,341,2477,9.4
20505,Nikolai Zherdev,2013-14,29.0,9,22,56,56,16,6,22,135.0,720.0,421,115,146,261,1103.0,82,5.46,52,291,2492,9.0
20506,Nikolaj Ehlers,2018-19,22.0,4,38,72,72,15,23,38,167.0,1159.0,72,15,23,38,167.0,82,5.34,48,255,2438,9.0
20507,Nikolaj Ehlers,2019-20,23.0,5,64,82,82,25,39,64,204.0,1434.0,154,40,62,102,371.0,82,5.45,47,245,2478,9.0
20508,Nikolaj Ehlers,2020-21,24.0,6,60,82,82,29,31,60,231.0,1319.0,236,69,93,162,602.0,82,5.86,50,250,2620,9.2
20509,Nikolaj Ehlers,2021-22,25.0,7,37,62,62,21,16,37,158.0,977.0,298,90,109,199,760.0,82,5.96,47,239,2579,9.5
20510,Nikolaj Ehlers,2022-23,26.0,8,58,71,71,25,33,58,203.0,1173.0,369,115,142,257,963.0,70,5.96,42,208,2192,9.5
20511,Nikolay Goldobin,2018-19,23.0,4,2,9,9,1,1,2,7.0,101.0,9,1,1,2,7.0,82,5.34,48,255,2438,9.0
20512,Nikolay Goldobin,2019-20,24.0,5,3,14,14,3,0,3,14.0,159.0,23,4,1,5,21.0,82,5.45,47,245,2478,9.0
20513,Nikolay Goldobin,2020-21,25.0,6,14,38,38,8,6,14,50.0,469.0,61,12,7,19,71.0,82,5.86,50,250,2620,9.2
20514,Nikolay Goldobin,2021-22,26.0,7,27,63,63,7,20,27,105.0,944.0,124,19,27,46,176.0,82,5.96,47,239,2579,9.5
20515,Nikolay Goldobin,2022-23,27.0,8,0,1,1,0,0,0,0.0,9.0,125,19,27,46,176.0,70,5.96,42,208,2192,9.5
20516,Nikos Tselios,2004-05,26.0,4,0,2,2,0,0,0,3.0,26.0,2,0,0,0,3.0,82,5.24,53,338,2262,9.5
20517,Nils Ekman,2002-03,26.0,4,4,28,28,2,2,4,42.0,313.0,28,2,2,4,42.0,82,5.49,53,331,2294,9.8
20518,Nils Ekman,2003-04,27.0,5,20,43,43,9,11,20,72.0,678.0,71,11,13,24,114.0,82,5.51,63,376,2272,9.9
20519,Nils Ekman,2006-07,30.0,6,55,82,82,22,33,55,147.0,1222.0,153,33,46,79,261.0,82,5.14,57,348,2300,9.2
20520,Nils Ekman,2008-09,32.0,7,57,77,77,21,36,57,176.0,1171.0,230,54,82,136,437.0,82,6.05,85,480,2458,10.1
20521,Nils Ekman,2009-10,33.0,8,15,34,34,6,9,15,69.0,469.0,264,60,91,151,506.0,82,5.76,70,398,2426,9.7
20522,Nino Niederreiter,2013-14,21.0,4,2,9,9,1,1,2,12.0,122.0,9,1,1,2,12.0,82,5.46,52,291,2492,9.0
20523,Nino Niederreiter,2014-15,22.0,5,1,55,55,1,0,1,74.0,556.0,64,2,1,3,86.0,82,5.32,47,271,2439,8.9
20524,Nino Niederreiter,2016-17,24.0,6,36,81,81,14,22,36,143.0,1142.0,145,16,23,39,229.0,82,5.34,48,269,2463,8.9
20525,Nino Niederreiter,2017-18,25.0,7,37,80,80,24,13,37,149.0,1164.0,225,40,36,76,378.0,82,5.32,47,251,2453,8.9
20526,Nino Niederreiter,2018-19,26.0,8,43,82,82,20,23,43,159.0,1275.0,307,60,59,119,537.0,82,5.34,48,255,2438,9.0
20527,Nino Niederreiter,2019-20,27.0,9,57,82,82,25,32,57,186.0,1236.0,389,85,91,176,723.0,82,5.45,47,245,2478,9.0
20528,Nino Niederreiter,2020-21,28.0,10,32,63,63,18,14,32,133.0,945.0,452,103,105,208,856.0,82,5.86,50,250,2620,9.2
20529,Nino Niederreiter,2021-22,29.0,11,53,82,82,23,30,53,184.0,1330.0,534,126,135,261,1040.0,82,5.96,47,239,2579,9.5
20530,Nino Niederreiter,2022-23,30.0,12,29,67,67,11,18,29,115.0,993.0,601,137,153,290,1155.0,70,5.96,42,208,2192,9.5
20531,Noah Clarke,2006-07,27.0,4,1,2,2,0,1,1,3.0,19.0,2,0,1,1,3.0,82,5.14,57,348,2300,9.2
20532,Noah Clarke,2008-09,29.0,5,0,5,5,0,0,0,3.0,37.0,7,0,1,1,6.0,82,6.05,85,480,2458,10.1
20533,Noah Clarke,2009-10,30.0,6,2,13,13,2,0,2,11.0,112.0,20,2,1,3,17.0,82,5.76,70,398,2426,9.7
20534,Noah Clarke,2010-11,31.0,7,1,1,1,1,0,1,3.0,11.0,21,3,1,4,20.0,82,5.44,62,351,2383,9.4
20535,Noah Dobson,2022-23,23.0,4,7,34,34,1,6,7,37.0,451.0,34,1,6,7,37.0,70,5.96,42,208,2192,9.5
20536,Noah Gregor,2022-23,24.0,4,5,28,28,3,2,5,33.0,282.0,28,3,2,5,33.0,70,5.96,42,208,2192,9.5
20537,Noah Hanifin,2018-19,22.0,4,22,79,79,4,18,22,122.0,1414.0,79,4,18,22,122.0,82,5.34,48,255,2438,9.0
20538,Noah Hanifin,2019-20,23.0,5,29,81,81,4,25,29,108.0,1452.0,160,8,43,51,230.0,82,5.45,47,245,2478,9.0
20539,Noah Hanifin,2020-21,24.0,6,32,79,79,10,22,32,165.0,1490.0,239,18,65,83,395.0,82,5.86,50,250,2620,9.2
20540,Noah Hanifin,2021-22,25.0,7,33,80,80,5,28,33,116.0,1662.0,319,23,93,116,511.0,82,5.96,47,239,2579,9.5
20541,Noah Hanifin,2022-23,26.0,8,22,70,70,5,17,22,132.0,1482.0,389,28,110,138,643.0,70,5.96,42,208,2192,9.5
20542,Noah Juulsen,2020-21,23.0,4,3,23,23,1,2,3,33.0,447.0,23,1,2,3,33.0,82,5.86,50,250,2620,9.2
20543,Noah Juulsen,2021-22,24.0,5,5,21,21,1,4,5,22.0,359.0,44,2,6,8,55.0,82,5.96,47,239,2579,9.5
20544,Noah Welch,2008-09,26.0,4,4,5,5,1,3,4,5.0,87.0,5,1,3,4,5.0,82,6.05,85,480,2458,10.1
20545,Noah Welch,2009-10,27.0,5,3,24,24,2,1,3,18.0,335.0,29,3,4,7,23.0,82,5.76,70,398,2426,9.7
20546,Noah Welch,2010-11,28.0,6,0,4,4,0,0,0,0.0,32.0,33,3,4,7,23.0,82,5.44,62,351,2383,9.4
20547,Noah Welch,2011-12,29.0,7,2,40,40,1,1,2,22.0,438.0,73,4,5,9,45.0,82,5.7,65,341,2477,9.4
20548,Noah Welch,2013-14,31.0,8,0,2,2,0,0,0,1.0,35.0,75,4,5,9,46.0,82,5.46,52,291,2492,9.0
20549,Noel Acciari,2018-19,27.0,4,1,19,19,0,1,1,18.0,188.0,19,0,1,1,18.0,82,5.34,48,255,2438,9.0
20550,Noel Acciari,2019-20,28.0,5,5,29,29,2,3,5,24.0,301.0,48,2,4,6,42.0,82,5.45,47,245,2478,9.0
20551,Noel Acciari,2020-21,29.0,6,11,60,60,10,1,11,66.0,775.0,108,12,5,17,108.0,82,5.86,50,250,2620,9.2
20552,Noel Acciari,2021-22,30.0,7,14,72,72,6,8,14,99.0,935.0,180,18,13,31,207.0,82,5.96,47,239,2579,9.5
20553,Noel Acciari,2022-23,31.0,8,27,66,66,20,7,27,108.0,1054.0,246,38,20,58,315.0,70,5.96,42,208,2192,9.5
20554,Nolan Baumgartner,1998-99,22.0,4,0,1,1,0,0,0,0.0,,1,0,0,0,0.0,82,6.29,74,413,2481,10.4
20555,Nolan Baumgartner,2000-01,24.0,5,1,4,4,0,1,1,4.0,,5,0,1,1,4.0,82,5.28,57,380,2242,9.6
20556,Nolan Baumgartner,2001-02,25.0,6,0,5,5,0,0,0,1.0,43.0,10,0,1,1,5.0,82,5.27,57,359,2285,9.4
20557,Nolan Baumgartner,2002-03,26.0,7,1,8,8,0,1,1,6.0,84.0,18,0,2,2,11.0,82,5.49,53,331,2294,9.8
20558,Nolan Baumgartner,2003-04,27.0,8,0,8,8,0,0,0,7.0,101.0,26,0,2,2,18.0,82,5.51,63,376,2272,9.9
20559,Nolan Baumgartner,2005-06,29.0,9,3,8,8,1,2,3,7.0,93.0,34,1,4,5,25.0,82,5.31,60,363,2326,9.4
20560,Nolan Baumgartner,2006-07,30.0,10,3,14,14,0,3,3,15.0,203.0,48,1,7,8,40.0,82,5.14,57,348,2300,9.2
20561,Nolan Baumgartner,2008-09,32.0,11,34,70,70,5,29,34,73.0,1154.0,118,6,36,42,113.0,82,6.05,85,480,2458,10.1
20562,Nolan Baumgartner,2009-10,33.0,12,3,13,13,0,3,3,8.0,176.0,131,6,39,45,121.0,82,5.76,70,398,2426,9.7
20563,Nolan Baumgartner,2012-13,36.0,13,2,12,12,1,1,2,12.0,170.0,143,7,40,47,133.0,82,5.53,56,304,2486,9.1
20564,Nolan Patrick,2020-21,22.0,4,30,73,73,13,17,30,127.0,1002.0,73,13,17,30,127.0,82,5.86,50,250,2620,9.2
20565,Nolan Patrick,2021-22,23.0,5,31,72,72,13,18,31,115.0,1086.0,145,26,35,61,242.0,82,5.96,47,239,2579,9.5
20566,Nolan Pratt,1999-00,24.0,4,2,9,9,0,2,2,4.0,,9,0,2,2,4.0,82,5.83,55,336,2444,9.8
20567,Nolan Pratt,2000-01,25.0,5,2,23,23,0,2,2,11.0,,32,0,4,4,15.0,82,5.28,57,380,2242,9.6
20568,Nolan Pratt,2001-02,26.0,6,15,61,61,1,14,15,46.0,1022.0,93,1,18,19,61.0,82,5.27,57,359,2285,9.4
20569,Nolan Pratt,2002-03,27.0,7,4,64,64,3,1,4,47.0,1227.0,157,4,19,23,108.0,82,5.49,53,331,2294,9.8
20570,Nolan Pratt,2003-04,28.0,8,3,46,46,1,2,3,26.0,452.0,203,5,21,26,134.0,82,5.51,63,376,2272,9.9
20571,Nolan Pratt,2004-05,29.0,9,3,46,46,0,3,3,38.0,847.0,249,5,24,29,172.0,82,5.24,53,338,2262,9.5
20572,Nolan Pratt,2005-06,30.0,10,8,67,67,1,7,8,38.0,1177.0,316,6,31,37,210.0,82,5.31,60,363,2326,9.4
20573,Nolan Pratt,2006-07,31.0,11,4,58,58,1,3,4,35.0,952.0,374,7,34,41,245.0,82,5.14,57,348,2300,9.2
20574,Nolan Pratt,2008-09,33.0,12,9,82,82,0,9,9,26.0,1475.0,456,7,43,50,271.0,82,6.05,85,480,2458,10.1
20575,Nolan Pratt,2009-10,34.0,13,8,81,81,1,7,8,30.0,1279.0,537,8,50,58,301.0,82,5.76,70,398,2426,9.7
20576,Nolan Pratt,2010-11,35.0,14,7,55,55,1,6,7,21.0,744.0,592,9,56,65,322.0,82,5.44,62,351,2383,9.4
20577,Nolan Yonkman,2004-05,23.0,4,1,11,11,1,0,1,7.0,140.0,11,1,0,1,7.0,82,5.24,53,338,2262,9.5
20578,Nolan Yonkman,2006-07,25.0,5,0,1,1,0,0,0,0.0,5.0,12,1,0,1,7.0,82,5.14,57,348,2300,9.2
20579,Nolan Yonkman,2008-09,27.0,6,7,38,38,0,7,7,14.0,313.0,50,1,7,8,21.0,82,6.05,85,480,2458,10.1
20580,Nolan Yonkman,2013-14,32.0,7,1,16,16,0,1,1,8.0,194.0,66,1,8,9,29.0,82,5.46,52,291,2492,9.0
20581,Nolan Yonkman,2014-15,33.0,8,0,1,1,0,0,0,0.0,6.0,67,1,8,9,29.0,82,5.32,47,271,2439,8.9
20582,Nolan Yonkman,2015-16,34.0,9,0,7,7,0,0,0,4.0,68.0,74,1,8,9,33.0,48,5.31,29,160,1399,9.1
20583,Nolan Yonkman,2016-17,35.0,10,1,2,2,0,1,1,3.0,30.0,76,1,9,10,36.0,82,5.34,48,269,2463,8.9
20584,Norm Aubin,1984-85,24.0,4,26,43,43,14,12,26,62.0,,43,14,12,26,62.0,80,8.03,73,320,2489,12.9
20585,Norm Aubin,1985-86,25.0,5,5,26,26,4,1,5,18.0,,69,18,13,31,80.0,80,7.73,71,310,2444,12.7
20586,Norm Dupont,1982-83,25.0,4,4,35,35,1,3,4,18.0,,35,1,3,4,18.0,80,7.03,61,280,2352,12.0
20587,Norm Dupont,1983-84,26.0,5,53,80,80,27,26,53,215.0,,115,28,29,57,233.0,80,7.69,77,340,2441,12.6
20588,Norm Dupont,1984-85,27.0,6,38,62,62,13,25,38,148.0,,177,41,54,95,381.0,80,8.03,73,320,2489,12.9
20589,Norm Dupont,1985-86,28.0,7,23,39,39,7,16,23,71.0,,216,48,70,118,452.0,80,7.73,71,310,2444,12.7
20590,Norm Dupont,1986-87,29.0,8,22,40,40,7,15,22,85.0,,256,55,85,140,537.0,80,7.89,74,336,2448,12.9
20591,Norm Maciver,1989-90,25.0,4,1,4,4,0,1,1,2.0,,4,0,1,1,2.0,80,7.34,72,344,2400,12.2
20592,Norm Maciver,1990-91,26.0,5,24,37,37,9,15,24,65.0,,41,9,16,25,67.0,80,7.43,89,437,2435,12.2
20593,Norm Maciver,1991-92,27.0,6,33,63,63,1,32,33,87.0,,104,10,48,58,154.0,80,7.48,85,403,2430,12.3
20594,Norm Maciver,1992-93,28.0,7,0,1,1,0,0,0,0.0,,105,10,48,58,154.0,80,7.37,76,367,2421,12.2
20595,Norm Maciver,1993-94,29.0,8,7,21,21,2,5,7,25.0,,126,12,53,65,179.0,80,6.91,71,366,2385,11.6
20596,Norm Maciver,1994-95,30.0,9,40,57,57,6,34,40,69.0,,183,18,87,105,248.0,80,6.96,77,402,2440,11.4
20597,Norm Maciver,1995-96,31.0,10,63,80,80,17,46,63,184.0,,263,35,133,168,432.0,84,7.25,87,443,2603,11.7
20598,Norm Maciver,1996-97,32.0,11,23,53,53,3,20,23,88.0,,316,38,153,191,520.0,84,6.48,76,407,2545,10.7
20599,Norm Maciver,1997-98,33.0,12,20,41,41,4,16,20,50.0,,357,42,169,211,570.0,48,5.97,37,209,1408,10.2
20600,Norm Maciver,1998-99,34.0,13,53,71,71,7,46,53,79.0,,428,49,215,264,649.0,82,6.29,74,413,2481,10.4
20601,Norm Maciver,1999-00,35.0,14,13,32,32,4,9,13,40.0,,460,53,224,277,689.0,82,5.83,55,336,2444,9.8
20602,Norm Maciver,2000-01,36.0,15,8,41,41,2,6,8,37.0,,501,55,230,285,726.0,82,5.28,57,380,2242,9.6
20603,Norm Milley,2004-05,24.0,4,1,5,5,0,1,1,10.0,66.0,5,0,1,1,10.0,82,5.24,53,338,2262,9.5
20604,Norm Milley,2005-06,25.0,5,2,8,8,0,2,2,8.0,85.0,13,0,3,3,18.0,82,5.31,60,363,2326,9.4
20605,Norm Milley,2006-07,26.0,6,0,2,2,0,0,0,2.0,17.0,15,0,3,3,20.0,82,5.14,57,348,2300,9.2
20606,Norm Milley,2008-09,28.0,7,3,14,14,2,1,3,12.0,100.0,29,2,4,6,32.0,82,6.05,85,480,2458,10.1
20607,Norm Schmidt,1986-87,24.0,4,18,34,34,6,12,18,56.0,,34,6,12,18,56.0,80,7.89,74,336,2448,12.9
20608,Norm Schmidt,1988-89,26.0,5,29,66,66,15,14,29,141.0,,100,21,26,47,197.0,80,7.94,82,370,2484,12.8
20609,Norm Schmidt,1989-90,27.0,6,6,20,20,1,5,6,32.0,,120,22,31,53,229.0,80,7.34,72,344,2400,12.2
20610,Norm Schmidt,1990-91,28.0,7,3,5,5,1,2,3,13.0,,125,23,33,56,242.0,80,7.43,89,437,2435,12.2
20611,Normand Baron,1986-87,29.0,4,0,4,4,0,0,0,2.0,,4,0,0,0,2.0,80,7.89,74,336,2448,12.9
20612,Normand Baron,1988-89,31.0,5,2,23,23,2,0,2,13.0,,27,2,0,2,15.0,80,7.94,82,370,2484,12.8
20613,Normand Lacombe,1987-88,23.0,4,6,30,30,2,4,6,30.0,,30,2,4,6,30.0,80,7.77,71,321,2447,12.7
20614,Normand Lacombe,1988-89,24.0,5,13,25,25,6,7,13,38.0,,55,8,11,19,68.0,80,7.94,82,370,2484,12.8
20615,Normand Lacombe,1989-90,25.0,6,11,40,40,4,7,11,48.0,,95,12,18,30,116.0,80,7.34,72,344,2400,12.2
20616,Normand Lacombe,1990-91,26.0,7,17,53,53,8,9,17,44.0,,148,20,27,47,160.0,80,7.43,89,437,2435,12.2
20617,Normand Lacombe,1991-92,27.0,8,28,64,64,17,11,28,71.0,,212,37,38,75,231.0,80,7.48,85,403,2430,12.3
20618,Normand Lacombe,1992-93,28.0,9,9,33,33,5,4,9,36.0,,245,42,42,84,267.0,80,7.37,76,367,2421,12.2
20619,Normand Lacombe,1993-94,29.0,10,31,74,74,11,20,31,91.0,,319,53,62,115,358.0,80,6.91,71,366,2385,11.6
20620,Normand Leveille,1984-85,22.0,4,33,66,66,14,19,33,148.0,,66,14,19,33,148.0,80,8.03,73,320,2489,12.9
20621,Normand Leveille,1985-86,23.0,5,9,9,9,3,6,9,32.0,,75,17,25,42,180.0,80,7.73,71,310,2444,12.7
20622,Normand Rochefort,1983-84,23.0,4,10,56,56,3,7,10,77.0,,56,3,7,10,77.0,80,7.69,77,340,2441,12.6
20623,Normand Rochefort,1984-85,24.0,5,18,72,72,4,14,18,105.0,,128,7,21,28,182.0,80,8.03,73,320,2489,12.9
20624,Normand Rochefort,1985-86,25.0,6,23,62,62,6,17,23,104.0,,190,13,38,51,286.0,80,7.73,71,310,2444,12.7
20625,Normand Rochefort,1986-87,26.0,7,24,75,75,2,22,24,83.0,,265,15,60,75,369.0,80,7.89,74,336,2448,12.9
20626,Normand Rochefort,1987-88,27.0,8,24,73,73,3,21,24,111.0,,338,18,81,99,480.0,80,7.77,71,321,2447,12.7
20627,Normand Rochefort,1988-89,28.0,9,9,26,26,5,4,9,51.0,,364,23,85,108,531.0,80,7.94,82,370,2484,12.8
20628,Normand Rochefort,1989-90,29.0,10,15,70,70,6,9,15,92.0,,434,29,94,123,623.0,80,7.34,72,344,2400,12.2
20629,Normand Rochefort,1990-91,30.0,11,13,46,46,3,10,13,70.0,,480,32,104,136,693.0,80,7.43,89,437,2435,12.2
20630,Normand Rochefort,1991-92,31.0,12,6,11,11,1,5,6,14.0,,491,33,109,142,707.0,80,7.48,85,403,2430,12.3
20631,Normand Rochefort,1992-93,32.0,13,4,31,31,3,1,4,30.0,,522,36,110,146,737.0,80,7.37,76,367,2421,12.2
20632,Normand Rochefort,1993-94,33.0,14,10,44,44,3,7,10,34.0,,566,39,117,156,771.0,80,6.91,71,366,2385,11.6
20633,Normand Rochefort,1994-95,34.0,15,2,26,26,0,2,2,18.0,,592,39,119,158,789.0,80,6.96,77,402,2440,11.4
20634,Normand Rochefort,1996-97,36.0,16,0,6,6,0,0,0,4.0,,598,39,119,158,793.0,84,6.48,76,407,2545,10.7
20635,Ole-Kristian Tollefsen,2008-09,24.0,4,0,5,5,0,0,0,3.0,82.0,5,0,0,0,3.0,82,6.05,85,480,2458,10.1
20636,Ole-Kristian Tollefsen,2009-10,25.0,5,5,70,70,2,3,5,39.0,996.0,75,2,3,5,42.0,82,5.76,70,398,2426,9.7
20637,Ole-Kristian Tollefsen,2010-11,26.0,6,4,51,51,2,2,4,21.0,628.0,126,4,5,9,63.0,82,5.44,62,351,2383,9.4
20638,Ole-Kristian Tollefsen,2011-12,27.0,7,1,19,19,0,1,1,12.0,196.0,145,4,6,10,75.0,82,5.7,65,341,2477,9.4
20639,Ole-Kristian Tollefsen,2012-13,28.0,8,2,18,18,0,2,2,12.0,177.0,163,4,8,12,87.0,82,5.53,56,304,2486,9.1
20640,Oleg Kvasha,2001-02,23.0,4,25,68,68,12,13,25,138.0,870.0,68,12,13,25,138.0,82,5.27,57,359,2285,9.4
20641,Oleg Kvasha,2002-03,24.0,5,25,78,78,5,20,25,110.0,890.0,146,17,33,50,248.0,82,5.49,53,331,2294,9.8
20642,Oleg Kvasha,2003-04,25.0,6,20,62,62,11,9,20,118.0,926.0,208,28,42,70,366.0,82,5.51,63,376,2272,9.9
20643,Oleg Kvasha,2004-05,26.0,7,38,71,71,13,25,38,119.0,1008.0,279,41,67,108,485.0,82,5.24,53,338,2262,9.5
20644,Oleg Kvasha,2005-06,27.0,8,26,69,69,12,14,26,121.0,901.0,348,53,81,134,606.0,82,5.31,60,363,2326,9.4
20645,Oleg Kvasha,2006-07,28.0,9,51,81,81,15,36,51,147.0,1447.0,429,68,117,185,753.0,82,5.14,57,348,2300,9.2
20646,Oleg Kvasha,2008-09,30.0,10,32,64,64,13,19,32,136.0,910.0,493,81,136,217,889.0,82,6.05,85,480,2458,10.1
20647,Oleg Mikulchik,1996-97,32.0,4,1,4,4,0,1,1,3.0,,4,0,1,1,3.0,84,6.48,76,407,2545,10.7
20648,Oleg Mikulchik,1997-98,33.0,5,2,25,25,0,2,2,5.0,,29,0,3,3,8.0,48,5.97,37,209,1408,10.2
20649,Oleg Mikulchik,1998-99,34.0,6,0,8,8,0,0,0,0.0,,37,0,3,3,8.0,82,6.29,74,413,2481,10.4
20650,Oleg Petrov,1995-96,24.0,4,3,9,9,2,1,3,20.0,,9,2,1,3,20.0,84,7.25,87,443,2603,11.7
20651,Oleg Petrov,1996-97,25.0,5,27,55,55,12,15,27,107.0,,64,14,16,30,127.0,84,6.48,76,407,2545,10.7
20652,Oleg Petrov,1997-98,26.0,6,5,12,12,2,3,5,26.0,,76,16,19,35,153.0,48,5.97,37,209,1408,10.2
20653,Oleg Petrov,1998-99,27.0,7,11,36,36,4,7,11,44.0,,112,20,26,46,197.0,82,6.29,74,413,2481,10.4
20654,Oleg Petrov,2002-03,31.0,8,26,44,44,2,24,26,96.0,697.0,156,22,50,72,293.0,82,5.49,53,331,2294,9.8
20655,Oleg Petrov,2003-04,32.0,9,47,81,81,17,30,47,158.0,1503.0,237,39,80,119,451.0,82,5.51,63,376,2272,9.9
20656,Oleg Petrov,2004-05,33.0,10,41,75,75,24,17,41,152.0,1421.0,312,63,97,160,603.0,82,5.24,53,338,2262,9.5
20657,Oleg Petrov,2005-06,34.0,11,27,70,70,9,18,27,124.0,1006.0,382,72,115,187,727.0,82,5.31,60,363,2326,9.4
20658,Oleg Saprykin,2002-03,21.0,4,1,4,4,0,1,1,2.0,50.0,4,0,1,1,2.0,82,5.49,53,331,2294,9.8
20659,Oleg Saprykin,2003-04,22.0,5,23,59,59,9,14,23,95.0,718.0,63,9,15,24,97.0,82,5.51,63,376,2272,9.9
20660,Oleg Saprykin,2004-05,23.0,6,0,3,3,0,0,0,9.0,40.0,66,9,15,24,106.0,82,5.24,53,338,2262,9.5
20661,Oleg Saprykin,2005-06,24.0,7,23,52,52,8,15,23,116.0,618.0,118,17,30,47,222.0,82,5.31,60,363,2326,9.4
20662,Oleg Saprykin,2006-07,25.0,8,29,69,69,12,17,29,151.0,952.0,187,29,47,76,373.0,82,5.14,57,348,2300,9.2
20663,Oleg Saprykin,2008-09,27.0,9,25,67,67,11,14,25,126.0,918.0,254,40,61,101,499.0,82,6.05,85,480,2458,10.1
20664,Oleg Saprykin,2009-10,28.0,10,36,71,71,15,21,36,150.0,885.0,325,55,82,137,649.0,82,5.76,70,398,2426,9.7
20665,Oleg Tverdovsky,1997-98,21.0,4,12,36,36,3,9,12,26.0,,36,3,9,12,26.0,48,5.97,37,209,1408,10.2
20666,Oleg Tverdovsky,1998-99,22.0,5,30,82,82,7,23,30,119.0,,118,10,32,42,145.0,82,6.29,74,413,2481,10.4
20667,Oleg Tverdovsky,1999-00,23.0,6,55,82,82,10,45,55,144.0,,200,20,77,97,289.0,82,5.83,55,336,2444,9.8
20668,Oleg Tverdovsky,2000-01,24.0,7,19,46,46,7,12,19,83.0,,246,27,89,116,372.0,82,5.28,57,380,2242,9.6
20669,Oleg Tverdovsky,2001-02,25.0,8,25,82,82,7,18,25,117.0,1706.0,328,34,107,141,489.0,82,5.27,57,359,2285,9.4
20670,Oleg Tverdovsky,2002-03,26.0,9,51,82,82,15,36,51,153.0,1867.0,410,49,143,192,642.0,82,5.49,53,331,2294,9.8
20671,Oleg Tverdovsky,2003-04,27.0,10,53,82,82,14,39,53,188.0,2002.0,492,63,182,245,830.0,82,5.51,63,376,2272,9.9
20672,Oleg Tverdovsky,2004-05,28.0,11,32,73,73,6,26,32,147.0,1667.0,565,69,208,277,977.0,82,5.24,53,338,2262,9.5
20673,Oleg Tverdovsky,2005-06,29.0,12,13,50,50,5,8,13,76.0,840.0,615,74,216,290,1053.0,82,5.31,60,363,2326,9.4
20674,Oleg Tverdovsky,2008-09,32.0,13,23,72,72,3,20,23,91.0,1195.0,687,77,236,313,1144.0,82,6.05,85,480,2458,10.1
20675,Oleg Tverdovsky,2009-10,33.0,14,4,26,26,0,4,4,26.0,308.0,713,77,240,317,1170.0,82,5.76,70,398,2426,9.7
20676,Oliver Bjorkstrand,2018-19,23.0,4,8,12,12,4,4,8,25.0,192.0,12,4,4,8,25.0,82,5.34,48,255,2438,9.0
20677,Oliver Bjorkstrand,2019-20,24.0,5,13,26,26,6,7,13,55.0,366.0,38,10,11,21,80.0,82,5.45,47,245,2478,9.0
20678,Oliver Bjorkstrand,2020-21,25.0,6,40,82,82,11,29,40,163.0,1172.0,120,21,40,61,243.0,82,5.86,50,250,2620,9.2
20679,Oliver Bjorkstrand,2021-22,26.0,7,36,77,77,23,13,36,161.0,950.0,197,44,53,97,404.0,82,5.96,47,239,2579,9.5
20680,Oliver Bjorkstrand,2022-23,27.0,8,36,49,49,21,15,36,162.0,879.0,246,65,68,133,566.0,70,5.96,42,208,2192,9.5
20681,Oliver Ekman-Larsson,2013-14,22.0,4,11,48,48,1,10,11,50.0,722.0,48,1,10,11,50.0,82,5.46,52,291,2492,9.0
20682,Oliver Ekman-Larsson,2014-15,23.0,5,32,82,82,13,19,32,147.0,1813.0,130,14,29,43,197.0,82,5.32,47,271,2439,8.9
20683,Oliver Ekman-Larsson,2015-16,24.0,6,24,48,48,3,21,24,101.0,1205.0,178,17,50,67,298.0,48,5.31,29,160,1399,9.1
20684,Oliver Ekman-Larsson,2016-17,25.0,7,44,80,80,15,29,44,199.0,2072.0,258,32,79,111,497.0,82,5.34,48,269,2463,8.9
20685,Oliver Ekman-Larsson,2017-18,26.0,8,43,82,82,23,20,43,264.0,2067.0,340,55,99,154,761.0,82,5.32,47,251,2453,8.9
20686,Oliver Ekman-Larsson,2018-19,27.0,9,55,75,75,21,34,55,228.0,1858.0,415,76,133,209,989.0,82,5.34,48,255,2438,9.0
20687,Oliver Ekman-Larsson,2019-20,28.0,10,39,79,79,12,27,39,145.0,1945.0,494,88,160,248,1134.0,82,5.45,47,245,2478,9.0
20688,Oliver Ekman-Larsson,2020-21,29.0,11,42,82,82,14,28,42,202.0,1942.0,576,102,188,290,1336.0,82,5.86,50,250,2620,9.2
20689,Oliver Ekman-Larsson,2021-22,30.0,12,44,81,81,14,30,44,176.0,1915.0,657,116,218,334,1512.0,82,5.96,47,239,2579,9.5
20690,Oliver Ekman-Larsson,2022-23,31.0,13,30,66,66,9,21,30,135.0,1519.0,723,125,239,364,1647.0,70,5.96,42,208,2192,9.5
20691,Oliver Kylington,2018-19,21.0,4,0,1,1,0,0,0,1.0,17.0,1,0,0,0,1.0,82,5.34,48,255,2438,9.0
20692,Oliver Kylington,2021-22,24.0,5,8,38,38,3,5,8,21.0,472.0,39,3,5,8,22.0,82,5.96,47,239,2579,9.5
20693,Oliver Kylington,2022-23,25.0,6,7,48,48,2,5,7,37.0,658.0,87,5,10,15,59.0,70,5.96,42,208,2192,9.5
20694,Oliver Lauridsen,2015-16,26.0,4,3,15,15,2,1,3,14.0,227.0,15,2,1,3,14.0,48,5.31,29,160,1399,9.1
20695,Oliver Lauridsen,2017-18,28.0,5,0,1,1,0,0,0,2.0,10.0,16,2,1,3,16.0,82,5.32,47,251,2453,8.9
20696,Oliver Wahlstrom,2022-23,22.0,4,0,9,9,0,0,0,9.0,93.0,9,0,0,0,9.0,70,5.96,42,208,2192,9.5
20697,Olivier Magnan,2013-14,27.0,4,0,18,18,0,0,0,8.0,283.0,18,0,0,0,8.0,82,5.46,52,291,2492,9.0
20698,Olli Jokinen,2000-01,22.0,4,0,8,8,0,0,0,12.0,,8,0,0,0,12.0,82,5.28,57,380,2242,9.6
20699,Olli Jokinen,2001-02,23.0,5,21,66,66,9,12,21,87.0,970.0,74,9,12,21,99.0,82,5.27,57,359,2285,9.4
20700,Olli Jokinen,2002-03,24.0,6,21,82,82,11,10,21,138.0,1332.0,156,20,22,42,237.0,82,5.49,53,331,2294,9.8
20701,Olli Jokinen,2003-04,25.0,7,16,78,78,6,10,16,121.0,1044.0,234,26,32,58,358.0,82,5.51,63,376,2272,9.9
20702,Olli Jokinen,2004-05,26.0,8,29,80,80,9,20,29,153.0,1447.0,314,35,52,87,511.0,82,5.24,53,338,2262,9.5
20703,Olli Jokinen,2005-06,27.0,9,65,81,81,36,29,65,240.0,1784.0,395,71,81,152,751.0,82,5.31,60,363,2326,9.4
20704,Olli Jokinen,2006-07,28.0,10,58,82,82,26,32,58,280.0,1852.0,477,97,113,210,1031.0,82,5.14,57,348,2300,9.2
20705,Olli Jokinen,2008-09,30.0,11,89,82,82,38,51,89,351.0,1680.0,559,135,164,299,1382.0,82,6.05,85,480,2458,10.1
20706,Olli Jokinen,2009-10,31.0,12,91,82,82,39,52,91,351.0,1684.0,641,174,216,390,1733.0,82,5.76,70,398,2426,9.7
20707,Olli Jokinen,2010-11,32.0,13,71,82,82,34,37,71,341.0,1632.0,723,208,253,461,2074.0,82,5.44,62,351,2383,9.4
20708,Olli Jokinen,2011-12,33.0,14,57,76,76,29,28,57,236.0,1435.0,799,237,281,518,2310.0,82,5.7,65,341,2477,9.4
20709,Olli Jokinen,2012-13,34.0,15,50,82,82,15,35,50,236.0,1465.0,881,252,316,568,2546.0,82,5.53,56,304,2486,9.1
20710,Olli Jokinen,2013-14,35.0,16,54,79,79,17,37,54,208.0,1404.0,960,269,353,622,2754.0,82,5.46,52,291,2492,9.0
20711,Olli Jokinen,2014-15,36.0,17,61,82,82,23,38,61,223.0,1555.0,1042,292,391,683,2977.0,82,5.32,47,271,2439,8.9
20712,Olli Jokinen,2015-16,37.0,18,14,45,45,7,7,14,85.0,771.0,1087,299,398,697,3062.0,48,5.31,29,160,1399,9.1
20713,Olli Jokinen,2016-17,38.0,19,43,82,82,18,25,43,171.0,1396.0,1169,317,423,740,3233.0,82,5.34,48,269,2463,8.9
20714,Olli Jokinen,2017-18,39.0,20,10,62,62,4,6,10,110.0,822.0,1231,321,429,750,3343.0,82,5.32,47,251,2453,8.9
20715,Olli Maatta,2016-17,22.0,4,29,78,78,9,20,29,119.0,1443.0,78,9,20,29,119.0,82,5.34,48,269,2463,8.9
20716,Olli Maatta,2017-18,23.0,5,9,20,20,1,8,9,27.0,414.0,98,10,28,38,146.0,82,5.32,47,251,2453,8.9
20717,Olli Maatta,2018-19,24.0,6,19,67,67,6,13,19,95.0,1337.0,165,16,41,57,241.0,82,5.34,48,255,2438,9.0
20718,Olli Maatta,2019-20,25.0,7,7,55,55,1,6,7,66.0,994.0,220,17,47,64,307.0,82,5.45,47,245,2478,9.0
20719,Olli Maatta,2020-21,26.0,8,29,82,82,7,22,29,164.0,1538.0,302,24,69,93,471.0,82,5.86,50,250,2620,9.2
20720,Olli Maatta,2021-22,27.0,9,14,60,60,1,13,14,74.0,1115.0,362,25,82,107,545.0,82,5.96,47,239,2579,9.5
20721,Olli Maatta,2022-23,28.0,10,17,65,65,4,13,17,80.0,1197.0,427,29,95,124,625.0,70,5.96,42,208,2192,9.5
20722,Olli Malmivaara,2010-11,28.0,4,0,2,2,0,0,0,0.0,18.0,2,0,0,0,0.0,82,5.44,62,351,2383,9.4
20723,Ondrej Kase,2019-20,24.0,4,15,53,53,5,10,15,77.0,625.0,53,5,10,15,77.0,82,5.45,47,245,2478,9.0
20724,Ondrej Kase,2020-21,25.0,5,38,66,66,20,18,38,146.0,919.0,119,25,28,53,223.0,82,5.86,50,250,2620,9.2
20725,Ondrej Kase,2021-22,26.0,6,20,30,30,11,9,20,94.0,470.0,149,36,37,73,317.0,82,5.96,47,239,2579,9.5
20726,Ondrej Kase,2022-23,27.0,7,24,55,55,7,17,24,144.0,910.0,204,43,54,97,461.0,70,5.96,42,208,2192,9.5
20727,Ondrej Palat,2015-16,24.0,4,4,14,14,2,2,4,16.0,164.0,14,2,2,4,16.0,48,5.31,29,160,1399,9.1
20728,Ondrej Palat,2016-17,25.0,5,59,81,81,23,36,59,165.0,1461.0,95,25,38,63,181.0,82,5.34,48,269,2463,8.9
20729,Ondrej Palat,2017-18,26.0,6,63,75,75,16,47,63,139.0,1307.0,170,41,85,126,320.0,82,5.32,47,251,2453,8.9
20730,Ondrej Palat,2018-19,27.0,7,40,62,62,16,24,40,117.0,1111.0,232,57,109,166,437.0,82,5.34,48,255,2438,9.0
20731,Ondrej Palat,2019-20,28.0,8,52,75,75,17,35,52,162.0,1434.0,307,74,144,218,599.0,82,5.45,47,245,2478,9.0
20732,Ondrej Palat,2020-21,29.0,9,35,56,56,11,24,35,109.0,952.0,363,85,168,253,708.0,82,5.86,50,250,2620,9.2
20733,Ondrej Palat,2021-22,30.0,10,34,64,64,8,26,34,100.0,953.0,427,93,194,287,808.0,82,5.96,47,239,2579,9.5
20734,Ondrej Palat,2022-23,31.0,11,41,69,69,17,24,41,128.0,1117.0,496,110,218,328,936.0,70,5.96,42,208,2192,9.5
20735,Oscar Fantenberg,2020-21,29.0,4,9,27,27,2,7,9,33.0,385.0,27,2,7,9,33.0,82,5.86,50,250,2620,9.2
20736,Oscar Fantenberg,2021-22,30.0,5,4,61,61,2,2,4,70.0,976.0,88,4,9,13,103.0,82,5.96,47,239,2579,9.5
20737,Oscar Fantenberg,2022-23,31.0,6,6,36,36,1,5,6,45.0,573.0,124,5,14,19,148.0,70,5.96,42,208,2192,9.5
20738,Oscar Klefbom,2016-17,23.0,4,3,17,17,1,2,3,14.0,269.0,17,1,2,3,14.0,82,5.34,48,269,2463,8.9
20739,Oscar Klefbom,2017-18,24.0,5,20,60,60,2,18,20,98.0,1320.0,77,3,20,23,112.0,82,5.32,47,251,2453,8.9
20740,Oscar Klefbom,2018-19,25.0,6,12,30,30,4,8,12,48.0,657.0,107,7,28,35,160.0,82,5.34,48,255,2438,9.0
20741,Oscar Klefbom,2019-20,26.0,7,38,82,82,12,26,38,201.0,1834.0,189,19,54,73,361.0,82,5.45,47,245,2478,9.0
20742,Oscar Klefbom,2020-21,27.0,8,21,66,66,5,16,21,203.0,1508.0,255,24,70,94,564.0,82,5.86,50,250,2620,9.2
20743,Oscar Klefbom,2021-22,28.0,9,28,61,61,5,23,28,167.0,1463.0,316,29,93,122,731.0,82,5.96,47,239,2579,9.5
20744,Oscar Klefbom,2022-23,29.0,10,34,62,62,5,29,34,159.0,1576.0,378,34,122,156,890.0,70,5.96,42,208,2192,9.5
20745,Oscar Lindberg,2017-18,26.0,4,0,1,1,0,0,0,2.0,8.0,1,0,0,0,2.0,82,5.32,47,251,2453,8.9
20746,Oscar Lindberg,2018-19,27.0,5,28,68,68,13,15,28,114.0,828.0,69,13,15,28,116.0,82,5.34,48,255,2438,9.0
20747,Oscar Lindberg,2019-20,28.0,6,20,65,65,8,12,20,86.0,704.0,134,21,27,48,202.0,82,5.45,47,245,2478,9.0
20748,Oscar Lindberg,2020-21,29.0,7,11,63,63,9,2,11,81.0,742.0,197,30,29,59,283.0,82,5.86,50,250,2620,9.2
20749,Oscar Lindberg,2021-22,30.0,8,20,55,55,9,11,20,91.0,686.0,252,39,40,79,374.0,82,5.96,47,239,2579,9.5
20750,Oscar Moller,2011-12,23.0,4,15,40,40,7,8,15,81.0,535.0,40,7,8,15,81.0,82,5.7,65,341,2477,9.4
20751,Oscar Moller,2012-13,24.0,5,7,34,34,4,3,7,42.0,292.0,74,11,11,22,123.0,82,5.53,56,304,2486,9.1
20752,Oscar Moller,2013-14,25.0,6,4,13,13,1,3,4,27.0,190.0,87,12,14,26,150.0,82,5.46,52,291,2492,9.0
20753,Oskar Lindblom,2020-21,24.0,4,6,23,23,2,4,6,36.0,335.0,23,2,4,6,36.0,82,5.86,50,250,2620,9.2
20754,Oskar Lindblom,2021-22,25.0,5,33,81,81,17,16,33,162.0,1113.0,104,19,20,39,198.0,82,5.96,47,239,2579,9.5
20755,Oskar Lindblom,2022-23,26.0,6,18,30,30,11,7,18,72.0,528.0,134,30,27,57,270.0,70,5.96,42,208,2192,9.5
20756,Oskar Osala,2011-12,24.0,4,0,2,2,0,0,0,1.0,17.0,2,0,0,0,1.0,82,5.7,65,341,2477,9.4
20757,Oskar Osala,2012-13,25.0,5,0,1,1,0,0,0,1.0,7.0,3,0,0,0,2.0,82,5.53,56,304,2486,9.1
20758,Oskar Sundqvist,2018-19,24.0,4,4,18,18,1,3,4,13.0,186.0,18,1,3,4,13.0,82,5.34,48,255,2438,9.0
20759,Oskar Sundqvist,2019-20,25.0,5,0,10,10,0,0,0,9.0,92.0,28,1,3,4,22.0,82,5.45,47,245,2478,9.0
20760,Oskar Sundqvist,2020-21,26.0,6,5,42,42,1,4,5,41.0,440.0,70,2,7,9,63.0,82,5.86,50,250,2620,9.2
20761,Oskar Sundqvist,2021-22,27.0,7,31,74,74,14,17,31,113.0,1023.0,144,16,24,40,176.0,82,5.96,47,239,2579,9.5
20762,Oskar Sundqvist,2022-23,28.0,8,23,57,57,12,11,23,97.0,820.0,201,28,35,63,273.0,70,5.96,42,208,2192,9.5
20763,Oskars Bartulis,2012-13,26.0,4,9,53,53,1,8,9,26.0,741.0,53,1,8,9,26.0,82,5.53,56,304,2486,9.1
20764,Oskars Bartulis,2013-14,27.0,5,0,13,13,0,0,0,7.0,169.0,66,1,8,9,33.0,82,5.46,52,291,2492,9.0
20765,Ossi Vaananen,2003-04,23.0,4,16,81,81,4,12,16,69.0,1552.0,81,4,12,16,69.0,82,5.51,63,376,2272,9.9
20766,Ossi Vaananen,2004-05,24.0,5,14,76,76,2,12,14,41.0,1536.0,157,6,24,30,110.0,82,5.24,53,338,2262,9.5
20767,Ossi Vaananen,2005-06,25.0,6,9,67,67,2,7,9,49.0,1290.0,224,8,31,39,159.0,82,5.31,60,363,2326,9.4
20768,Ossi Vaananen,2006-07,26.0,7,6,79,79,2,4,6,45.0,1520.0,303,10,35,45,204.0,82,5.14,57,348,2300,9.2
20769,Ossi Vaananen,2008-09,28.0,8,4,53,53,0,4,4,34.0,719.0,356,10,39,49,238.0,82,6.05,85,480,2458,10.1
20770,Ossi Vaananen,2009-10,29.0,9,8,74,74,2,6,8,32.0,1060.0,430,12,45,57,270.0,82,5.76,70,398,2426,9.7
20771,Ossi Vaananen,2011-12,31.0,10,11,49,49,1,10,11,20.0,878.0,479,13,55,68,290.0,82,5.7,65,341,2477,9.4
20772,Otto Koivula,2022-23,24.0,4,0,12,12,0,0,0,4.0,95.0,12,0,0,0,4.0,70,5.96,42,208,2192,9.5
20773,Otto Leskinen,2022-23,25.0,4,0,5,5,0,0,0,2.0,51.0,5,0,0,0,2.0,70,5.96,42,208,2192,9.5
20774,Owen Fussey,2006-07,23.0,4,1,4,4,0,1,1,6.0,33.0,4,0,1,1,6.0,82,5.14,57,348,2300,9.2
20775,Owen Nolan,1993-94,21.0,4,13,59,59,3,10,13,54.0,,59,3,10,13,54.0,80,6.91,71,366,2385,11.6
20776,Owen Nolan,1994-95,22.0,5,73,75,75,42,31,73,190.0,,134,45,41,86,244.0,80,6.96,77,402,2440,11.4
20777,Owen Nolan,1995-96,23.0,6,77,73,73,36,41,77,241.0,,207,81,82,163,485.0,84,7.25,87,443,2603,11.7
20778,Owen Nolan,1996-97,24.0,7,4,6,6,2,2,4,15.0,,213,83,84,167,500.0,84,6.48,76,407,2545,10.7
20779,Owen Nolan,1997-98,25.0,8,49,46,46,30,19,49,137.0,,259,113,103,216,637.0,48,5.97,37,209,1408,10.2
20780,Owen Nolan,1998-99,26.0,9,69,81,81,33,36,69,207.0,,340,146,139,285,844.0,82,6.29,74,413,2481,10.4
20781,Owen Nolan,1999-00,27.0,10,63,72,72,31,32,63,225.0,,412,177,171,348,1069.0,82,5.83,55,336,2444,9.8
20782,Owen Nolan,2000-01,28.0,11,41,75,75,14,27,41,192.0,,487,191,198,389,1261.0,82,5.28,57,380,2242,9.6
20783,Owen Nolan,2001-02,29.0,12,45,78,78,19,26,45,207.0,1494.0,565,210,224,434,1468.0,82,5.27,57,359,2285,9.4
20784,Owen Nolan,2002-03,30.0,13,84,78,78,44,40,84,261.0,1647.0,643,254,264,518,1729.0,82,5.49,53,331,2294,9.8
20785,Owen Nolan,2003-04,31.0,14,49,57,57,24,25,49,191.0,1244.0,700,278,289,567,1920.0,82,5.51,63,376,2272,9.9
20786,Owen Nolan,2004-05,32.0,15,66,75,75,23,43,66,217.0,1454.0,775,301,332,633,2137.0,82,5.24,53,338,2262,9.5
20787,Owen Nolan,2005-06,33.0,16,54,75,75,29,25,54,221.0,1345.0,850,330,357,687,2358.0,82,5.31,60,363,2326,9.4
20788,Owen Nolan,2006-07,34.0,17,48,65,65,19,29,48,154.0,1166.0,915,349,386,735,2512.0,82,5.14,57,348,2300,9.2
20789,Owen Nolan,2009-10,37.0,18,40,76,76,16,24,40,154.0,1172.0,991,365,410,775,2666.0,82,5.76,70,398,2426,9.7
20790,Owen Nolan,2010-11,38.0,19,32,77,77,16,16,32,163.0,1275.0,1068,381,426,807,2829.0,82,5.44,62,351,2383,9.4
20791,Owen Nolan,2011-12,39.0,20,45,59,59,25,20,45,148.0,967.0,1127,406,446,852,2977.0,82,5.7,65,341,2477,9.4
20792,Owen Nolan,2012-13,40.0,21,33,73,73,16,17,33,151.0,1212.0,1200,422,463,885,3128.0,82,5.53,56,304,2486,9.1
20793,Owen Tippett,2020-21,21.0,4,1,7,7,1,0,1,17.0,78.0,7,1,0,1,17.0,82,5.86,50,250,2620,9.2
20794,P.A. Parenteau,2009-10,26.0,4,1,5,5,0,1,1,7.0,55.0,5,0,1,1,7.0,82,5.76,70,398,2426,9.7
20795,P.A. Parenteau,2012-13,29.0,5,8,22,22,3,5,8,38.0,301.0,27,3,6,9,45.0,82,5.53,56,304,2486,9.1
20796,P.A. Parenteau,2013-14,30.0,6,53,81,81,20,33,53,161.0,1476.0,108,23,39,62,206.0,82,5.46,52,291,2492,9.0
20797,P.A. Parenteau,2014-15,31.0,7,67,80,80,18,49,67,167.0,1492.0,188,41,88,129,373.0,82,5.32,47,271,2439,8.9
20798,P.A. Parenteau,2015-16,32.0,8,43,48,48,18,25,43,105.0,919.0,236,59,113,172,478.0,48,5.31,29,160,1399,9.1
20799,P.A. Parenteau,2016-17,33.0,9,33,55,55,14,19,33,110.0,932.0,291,73,132,205,588.0,82,5.34,48,269,2463,8.9
20800,P.A. Parenteau,2017-18,34.0,10,22,56,56,8,14,22,97.0,839.0,347,81,146,227,685.0,82,5.32,47,251,2453,8.9
20801,P.A. Parenteau,2018-19,35.0,11,41,77,77,20,21,41,168.0,1252.0,424,101,167,268,853.0,82,5.34,48,255,2438,9.0
20802,P.A. Parenteau,2019-20,36.0,12,28,67,67,13,15,28,123.0,985.0,491,114,182,296,976.0,82,5.45,47,245,2478,9.0
20803,P.C. Drouin,1999-00,25.0,4,0,3,3,0,0,0,1.0,,3,0,0,0,1.0,82,5.83,55,336,2444,9.8
20804,P.J. Axelsson,2000-01,25.0,4,27,82,82,8,19,27,144.0,,82,8,19,27,144.0,82,5.28,57,380,2242,9.6
20805,P.J. Axelsson,2001-02,26.0,5,17,77,77,7,10,17,146.0,1281.0,159,15,29,44,290.0,82,5.27,57,359,2285,9.4
20806,P.J. Axelsson,2002-03,27.0,6,26,81,81,10,16,26,186.0,1354.0,240,25,45,70,476.0,82,5.49,53,331,2294,9.8
20807,P.J. Axelsson,2003-04,28.0,7,23,81,81,8,15,23,146.0,1013.0,321,33,60,93,622.0,82,5.51,63,376,2272,9.9
20808,P.J. Axelsson,2004-05,29.0,8,24,78,78,7,17,24,127.0,1146.0,399,40,77,117,749.0,82,5.24,53,338,2262,9.5
20809,P.J. Axelsson,2005-06,30.0,9,36,66,66,17,19,36,122.0,1097.0,465,57,96,153,871.0,82,5.31,60,363,2326,9.4
20810,P.J. Axelsson,2006-07,31.0,10,20,68,68,6,14,20,107.0,1109.0,533,63,110,173,978.0,82,5.14,57,348,2300,9.2
20811,P.J. Axelsson,2008-09,33.0,11,28,59,59,10,18,28,113.0,1039.0,592,73,128,201,1091.0,82,6.05,85,480,2458,10.1
20812,P.J. Axelsson,2009-10,34.0,12,27,55,55,11,16,27,81.0,1076.0,647,84,144,228,1172.0,82,5.76,70,398,2426,9.7
20813,P.J. Axelsson,2010-11,35.0,13,29,75,75,13,16,29,100.0,1320.0,722,97,160,257,1272.0,82,5.44,62,351,2383,9.4
20814,P.J. Axelsson,2011-12,36.0,14,30,75,75,6,24,30,87.0,1217.0,797,103,184,287,1359.0,82,5.7,65,341,2477,9.4
20815,P.J. Stock,2000-01,25.0,4,5,38,38,2,3,5,9.0,,38,2,3,5,9.0,82,5.28,57,380,2242,9.6
20816,P.J. Stock,2001-02,26.0,5,0,5,5,0,0,0,0.0,14.0,43,2,3,5,9.0,82,5.27,57,359,2285,9.4
20817,P.J. Stock,2002-03,27.0,6,1,11,11,0,1,1,2.0,68.0,54,2,4,6,11.0,82,5.49,53,331,2294,9.8
20818,P.J. Stock,2003-04,28.0,7,7,51,51,2,5,7,27.0,352.0,105,4,9,13,38.0,82,5.51,63,376,2272,9.9
20819,P.J. Stock,2004-05,29.0,8,3,58,58,0,3,3,12.0,299.0,163,4,12,16,50.0,82,5.24,53,338,2262,9.5
20820,P.J. Stock,2005-06,30.0,9,10,71,71,1,9,10,38.0,443.0,234,5,21,26,88.0,82,5.31,60,363,2326,9.4
20821,P.J. Stock,2006-07,31.0,10,0,1,1,0,0,0,1.0,6.0,235,5,21,26,89.0,82,5.14,57,348,2300,9.2
20822,P.K. Subban,2012-13,23.0,4,2,2,2,0,2,2,4.0,40.0,2,0,2,2,4.0,82,5.53,56,304,2486,9.1
20823,P.K. Subban,2013-14,24.0,5,38,77,77,14,24,38,197.0,1715.0,79,14,26,40,201.0,82,5.46,52,291,2492,9.0
20824,P.K. Subban,2014-15,25.0,6,36,81,81,7,29,36,205.0,1968.0,160,21,55,76,406.0,82,5.32,47,271,2439,8.9
20825,P.K. Subban,2015-16,26.0,7,38,42,42,11,27,38,126.0,976.0,202,32,82,114,532.0,48,5.31,29,160,1399,9.1
20826,P.K. Subban,2016-17,27.0,8,53,82,82,10,43,53,204.0,2019.0,284,42,125,167,736.0,82,5.34,48,269,2463,8.9
20827,P.K. Subban,2017-18,28.0,9,60,82,82,15,45,60,170.0,2149.0,366,57,170,227,906.0,82,5.32,47,251,2453,8.9
20828,P.K. Subban,2018-19,29.0,10,51,68,68,6,45,51,176.0,1793.0,434,63,215,278,1082.0,82,5.34,48,255,2438,9.0
20829,P.K. Subban,2019-20,30.0,11,40,66,66,10,30,40,142.0,1611.0,500,73,245,318,1224.0,82,5.45,47,245,2478,9.0
20830,P.K. Subban,2020-21,31.0,12,59,82,82,16,43,59,207.0,1977.0,582,89,288,377,1431.0,82,5.86,50,250,2620,9.2
20831,P.K. Subban,2021-22,32.0,13,31,63,63,9,22,31,168.0,1428.0,645,98,310,408,1599.0,82,5.96,47,239,2579,9.5
20832,P.K. Subban,2022-23,33.0,14,18,68,68,7,11,18,151.0,1504.0,713,105,321,426,1750.0,70,5.96,42,208,2192,9.5
20833,Par Lindholm,2021-22,30.0,4,13,65,65,1,12,13,65.0,738.0,65,1,12,13,65.0,82,5.96,47,239,2579,9.5
20834,Par Lindholm,2022-23,31.0,5,6,40,40,3,3,6,35.0,450.0,105,4,15,19,100.0,70,5.96,42,208,2192,9.5
20835,Pascal Dupuis,2003-04,24.0,4,1,4,4,1,0,1,8.0,62.0,4,1,0,1,8.0,82,5.51,63,376,2272,9.9
20836,Pascal Dupuis,2004-05,25.0,5,27,76,76,15,12,27,154.0,1150.0,80,16,12,28,162.0,82,5.24,53,338,2262,9.5
20837,Pascal Dupuis,2005-06,26.0,6,48,80,80,20,28,48,183.0,1400.0,160,36,40,76,345.0,82,5.31,60,363,2326,9.4
20838,Pascal Dupuis,2006-07,27.0,7,26,59,59,11,15,26,127.0,932.0,219,47,55,102,472.0,82,5.14,57,348,2300,9.2
20839,Pascal Dupuis,2008-09,29.0,8,26,67,67,10,16,26,151.0,1105.0,286,57,71,128,623.0,82,6.05,85,480,2458,10.1
20840,Pascal Dupuis,2009-10,30.0,9,19,71,71,14,5,19,156.0,1103.0,357,71,76,147,779.0,82,5.76,70,398,2426,9.7
20841,Pascal Dupuis,2010-11,31.0,10,27,78,78,12,15,27,143.0,1185.0,435,83,91,174,922.0,82,5.44,62,351,2383,9.4
20842,Pascal Dupuis,2011-12,32.0,11,28,71,71,12,16,28,145.0,1010.0,506,95,107,202,1067.0,82,5.7,65,341,2477,9.4
20843,Pascal Dupuis,2012-13,33.0,12,38,81,81,18,20,38,157.0,1149.0,587,113,127,240,1224.0,82,5.53,56,304,2486,9.1
20844,Pascal Dupuis,2013-14,34.0,13,37,81,81,17,20,37,171.0,1366.0,668,130,147,277,1395.0,82,5.46,52,291,2492,9.0
20845,Pascal Dupuis,2014-15,35.0,14,59,82,82,25,34,59,214.0,1388.0,750,155,181,336,1609.0,82,5.32,47,271,2439,8.9
20846,Pascal Dupuis,2015-16,36.0,15,38,48,48,20,18,38,140.0,840.0,798,175,199,374,1749.0,48,5.31,29,160,1399,9.1
20847,Pascal Dupuis,2016-17,37.0,16,20,39,39,7,13,20,97.0,690.0,837,182,212,394,1846.0,82,5.34,48,269,2463,8.9
20848,Pascal Dupuis,2017-18,38.0,17,11,16,16,6,5,11,44.0,266.0,853,188,217,405,1890.0,82,5.32,47,251,2453,8.9
20849,Pascal Dupuis,2018-19,39.0,18,4,18,18,2,2,4,28.0,272.0,871,190,219,409,1918.0,82,5.34,48,255,2438,9.0
20850,Pascal Pelletier,2010-11,27.0,4,0,6,6,0,0,0,8.0,66.0,6,0,0,0,8.0,82,5.44,62,351,2383,9.4
20851,Pascal Pelletier,2011-12,28.0,5,0,7,7,0,0,0,7.0,64.0,13,0,0,0,15.0,82,5.7,65,341,2477,9.4
20852,Pascal Pelletier,2016-17,33.0,6,0,3,3,0,0,0,1.0,27.0,16,0,0,0,16.0,82,5.34,48,269,2463,8.9
20853,Pascal Rheaume,1999-00,26.0,4,1,2,2,1,0,1,5.0,,2,1,0,1,5.0,82,5.83,55,336,2444,9.8
20854,Pascal Rheaume,2000-01,27.0,5,15,48,48,6,9,15,45.0,,50,7,9,16,50.0,82,5.28,57,380,2242,9.6
20855,Pascal Rheaume,2001-02,28.0,6,27,60,60,9,18,27,85.0,799.0,110,16,27,43,135.0,82,5.27,57,359,2285,9.4
20856,Pascal Rheaume,2002-03,29.0,7,2,7,7,1,1,2,5.0,71.0,117,17,28,45,140.0,82,5.49,53,331,2294,9.8
20857,Pascal Rheaume,2003-04,30.0,8,2,8,8,2,0,2,16.0,95.0,125,19,28,47,156.0,82,5.51,63,376,2272,9.9
20858,Pascal Rheaume,2004-05,31.0,9,22,61,61,11,11,22,80.0,785.0,186,30,39,69,236.0,82,5.24,53,338,2262,9.5
20859,Pascal Rheaume,2005-06,32.0,10,18,77,77,8,10,18,93.0,936.0,263,38,49,87,329.0,82,5.31,60,363,2326,9.4
20860,Pascal Rheaume,2006-07,33.0,11,4,42,42,1,3,4,38.0,429.0,305,39,52,91,367.0,82,5.14,57,348,2300,9.2
20861,Pascal Rheaume,2008-09,35.0,12,0,13,13,0,0,0,11.0,117.0,318,39,52,91,378.0,82,6.05,85,480,2458,10.1
20862,Pascal Trepanier,2000-01,27.0,4,1,15,15,0,1,1,9.0,,15,0,1,1,9.0,82,5.28,57,380,2242,9.6
20863,Pascal Trepanier,2001-02,28.0,5,6,45,45,2,4,6,49.0,572.0,60,2,5,7,58.0,82,5.27,57,359,2285,9.4
20864,Pascal Trepanier,2002-03,29.0,6,4,37,37,0,4,4,33.0,418.0,97,2,9,11,91.0,82,5.49,53,331,2294,9.8
20865,Pascal Trepanier,2003-04,30.0,7,10,57,57,6,4,10,86.0,957.0,154,8,13,21,177.0,82,5.51,63,376,2272,9.9
20866,Pascal Trepanier,2004-05,31.0,8,13,74,74,4,9,13,87.0,1082.0,228,12,22,34,264.0,82,5.24,53,338,2262,9.5
20867,Pascal Trepanier,2005-06,32.0,9,0,1,1,0,0,0,1.0,10.0,229,12,22,34,265.0,82,5.31,60,363,2326,9.4
20868,Pat Conacher,1982-83,23.0,4,5,17,17,0,5,5,15.0,,17,0,5,5,15.0,80,7.03,61,280,2352,12.0
20869,Pat Conacher,1985-86,26.0,5,1,5,5,0,1,1,5.0,,22,0,6,6,20.0,80,7.73,71,310,2444,12.7
20870,Pat Conacher,1986-87,27.0,6,10,45,45,2,8,10,17.0,,67,2,14,16,37.0,80,7.89,74,336,2448,12.9
20871,Pat Conacher,1988-89,29.0,7,2,2,2,0,2,2,3.0,,69,2,16,18,40.0,80,7.94,82,370,2484,12.8
20872,Pat Conacher,1990-91,31.0,8,7,24,24,2,5,7,22.0,,93,4,21,25,62.0,80,7.43,89,437,2435,12.2
20873,Pat Conacher,1991-92,32.0,9,12,55,55,7,5,12,59.0,,148,11,26,37,121.0,80,7.48,85,403,2430,12.3
20874,Pat Conacher,1992-93,33.0,10,6,19,19,3,3,6,18.0,,167,14,29,43,139.0,80,7.37,76,367,2421,12.2
20875,Pat Conacher,1993-94,34.0,11,16,49,49,5,11,16,45.0,,216,19,40,59,184.0,80,6.91,71,366,2385,11.6
20876,Pat Conacher,1994-95,35.0,12,10,44,44,7,3,10,38.0,,260,26,43,69,222.0,80,6.96,77,402,2440,11.4
20877,Pat Conacher,1995-96,36.0,13,17,81,81,9,8,17,65.0,,341,35,51,86,287.0,84,7.25,87,443,2603,11.7
20878,Pat Conacher,1996-97,37.0,14,28,77,77,15,13,28,98.0,,418,50,64,114,385.0,84,6.48,76,407,2545,10.7
20879,Pat Conacher,1997-98,38.0,15,16,48,48,7,9,16,64.0,,466,57,73,130,449.0,48,5.97,37,209,1408,10.2
20880,Pat Conacher,1998-99,39.0,16,9,55,55,6,3,9,45.0,,521,63,76,139,494.0,82,6.29,74,413,2481,10.4
20881,Pat Daley,1982-83,23.0,4,1,5,5,1,0,1,6.0,,5,1,0,1,6.0,80,7.03,61,280,2352,12.0
20882,Pat Daley,1983-84,24.0,5,0,7,7,0,0,0,4.0,,12,1,0,1,10.0,80,7.69,77,340,2441,12.6
20883,Pat Elynuik,1990-91,23.0,4,4,13,13,1,3,4,12.0,,13,1,3,4,12.0,80,7.43,89,437,2435,12.2
20884,Pat Elynuik,1991-92,24.0,5,51,56,56,26,25,51,100.0,,69,27,28,55,112.0,80,7.48,85,403,2430,12.3
20885,Pat Elynuik,1992-93,25.0,6,74,80,80,32,42,74,132.0,,149,59,70,129,244.0,80,7.37,76,367,2421,12.2
20886,Pat Elynuik,1993-94,26.0,7,65,80,80,31,34,65,150.0,,229,90,104,194,394.0,80,6.91,71,366,2385,11.6
20887,Pat Elynuik,1994-95,27.0,8,50,60,60,25,25,50,127.0,,289,115,129,244,521.0,80,6.96,77,402,2440,11.4
20888,Pat Elynuik,1995-96,28.0,9,57,80,80,22,35,57,121.0,,369,137,164,301,642.0,84,7.25,87,443,2603,11.7
20889,Pat Elynuik,1996-97,29.0,10,28,67,67,13,15,28,111.0,,436,150,179,329,753.0,84,6.48,76,407,2545,10.7
20890,Pat Elynuik,1997-98,30.0,11,10,41,41,3,7,10,58.0,,477,153,186,339,811.0,48,5.97,37,209,1408,10.2
20891,Pat Elynuik,1998-99,31.0,12,3,29,29,1,2,3,27.0,,506,154,188,342,838.0,82,6.29,74,413,2481,10.4
20892,Pat Falloon,1994-95,22.0,4,59,79,79,25,34,59,181.0,,79,25,34,59,181.0,80,6.96,77,402,2440,11.4
20893,Pat Falloon,1995-96,23.0,5,28,41,41,14,14,28,131.0,,120,39,48,87,312.0,84,7.25,87,443,2603,11.7
20894,Pat Falloon,1996-97,24.0,6,53,83,83,22,31,53,193.0,,203,61,79,140,505.0,84,6.48,76,407,2545,10.7
20895,Pat Falloon,1997-98,25.0,7,19,46,46,12,7,19,91.0,,249,73,86,159,596.0,48,5.97,37,209,1408,10.2
20896,Pat Falloon,1998-99,26.0,8,51,71,71,25,26,51,170.0,,320,98,112,210,766.0,82,6.29,74,413,2481,10.4
20897,Pat Falloon,1999-00,27.0,9,23,52,52,11,12,23,124.0,,372,109,124,233,890.0,82,5.83,55,336,2444,9.8
20898,Pat Falloon,2000-01,28.0,10,18,58,58,8,10,18,136.0,,430,117,134,251,1026.0,82,5.28,57,380,2242,9.6
20899,Pat Falloon,2001-02,29.0,11,40,82,82,17,23,40,152.0,1205.0,512,134,157,291,1178.0,82,5.27,57,359,2285,9.4
20900,Pat Falloon,2002-03,30.0,12,31,63,63,9,22,31,92.0,776.0,575,143,179,322,1270.0,82,5.49,53,331,2294,9.8
20901,Pat Flatley,1986-87,23.0,4,9,16,16,2,7,9,17.0,,16,2,7,9,17.0,80,7.89,74,336,2448,12.9
20902,Pat Flatley,1987-88,24.0,5,51,78,78,20,31,51,134.0,,94,22,38,60,151.0,80,7.77,71,321,2447,12.7
20903,Pat Flatley,1988-89,25.0,6,52,73,73,18,34,52,120.0,,167,40,72,112,271.0,80,7.94,82,370,2484,12.8
20904,Pat Flatley,1989-90,26.0,7,51,63,63,16,35,51,113.0,,230,56,107,163,384.0,80,7.34,72,344,2400,12.2
20905,Pat Flatley,1990-91,27.0,8,24,40,40,9,15,24,83.0,,270,65,122,187,467.0,80,7.43,89,437,2435,12.2
20906,Pat Flatley,1991-92,28.0,9,25,41,41,10,15,25,72.0,,311,75,137,212,539.0,80,7.48,85,403,2430,12.3
20907,Pat Flatley,1992-93,29.0,10,49,62,62,17,32,49,136.0,,373,92,169,261,675.0,80,7.37,76,367,2421,12.2
20908,Pat Flatley,1993-94,30.0,11,45,56,56,20,25,45,137.0,,429,112,194,306,812.0,80,6.91,71,366,2385,11.6
20909,Pat Flatley,1994-95,31.0,12,36,38,38,8,28,36,76.0,,467,120,222,342,888.0,80,6.96,77,402,2440,11.4
20910,Pat Flatley,1995-96,32.0,13,60,80,80,13,47,60,139.0,,547,133,269,402,1027.0,84,7.25,87,443,2603,11.7
20911,Pat Flatley,1996-97,33.0,14,42,64,64,12,30,42,112.0,,611,145,299,444,1139.0,84,6.48,76,407,2545,10.7
20912,Pat Flatley,1997-98,34.0,15,27,45,45,7,20,27,81.0,,656,152,319,471,1220.0,48,5.97,37,209,1408,10.2
20913,Pat Flatley,1998-99,35.0,16,17,56,56,8,9,17,89.0,,712,160,328,488,1309.0,82,6.29,74,413,2481,10.4
20914,Pat Flatley,1999-00,36.0,17,22,68,68,10,12,22,96.0,,780,170,340,510,1405.0,82,5.83,55,336,2444,9.8
20915,Pat Graham,1984-85,23.0,4,14,42,42,6,8,14,51.0,,42,6,8,14,51.0,80,8.03,73,320,2489,12.9
20916,Pat Graham,1985-86,24.0,5,6,20,20,1,5,6,25.0,,62,7,13,20,76.0,80,7.73,71,310,2444,12.7
20917,Pat Graham,1986-87,25.0,6,8,41,41,4,4,8,46.0,,103,11,17,28,122.0,80,7.89,74,336,2448,12.9
20918,Pat Kavanagh,2005-06,26.0,4,1,3,3,1,0,1,4.0,31.0,3,1,0,1,4.0,82,5.31,60,363,2326,9.4
20919,Pat Kavanagh,2006-07,27.0,5,1,3,3,1,0,1,1.0,24.0,6,2,0,2,5.0,82,5.14,57,348,2300,9.2
20920,Pat Kavanagh,2008-09,29.0,6,0,8,8,0,0,0,1.0,42.0,14,2,0,2,6.0,82,6.05,85,480,2458,10.1
20921,Pat LaFontaine,1986-87,21.0,4,19,15,15,13,6,19,35.0,,15,13,6,19,35.0,80,7.89,74,336,2448,12.9
20922,Pat LaFontaine,1987-88,22.0,5,54,67,67,19,35,54,172.0,,82,32,41,73,207.0,80,7.77,71,321,2447,12.7
20923,Pat LaFontaine,1988-89,23.0,6,53,65,65,30,23,53,172.0,,147,62,64,126,379.0,80,7.94,82,370,2484,12.8
20924,Pat LaFontaine,1989-90,24.0,7,70,80,80,38,32,70,219.0,,227,100,96,196,598.0,80,7.34,72,344,2400,12.2
20925,Pat LaFontaine,1990-91,25.0,8,92,75,75,47,45,92,242.0,,302,147,141,288,840.0,80,7.43,89,437,2435,12.2
20926,Pat LaFontaine,1991-92,26.0,9,88,79,79,45,43,88,288.0,,381,192,184,376,1128.0,80,7.48,85,403,2430,12.3
20927,Pat LaFontaine,1992-93,27.0,10,105,74,74,54,51,105,286.0,,455,246,235,481,1414.0,80,7.37,76,367,2421,12.2
20928,Pat LaFontaine,1993-94,28.0,11,85,75,75,41,44,85,225.0,,530,287,279,566,1639.0,80,6.91,71,366,2385,11.6
20929,Pat LaFontaine,1994-95,29.0,12,93,57,57,46,47,93,203.0,,587,333,326,659,1842.0,80,6.96,77,402,2440,11.4
20930,Pat LaFontaine,1995-96,30.0,13,148,84,84,53,95,148,306.0,,671,386,421,807,2148.0,84,7.25,87,443,2603,11.7
20931,Pat LaFontaine,1996-97,31.0,14,18,16,16,5,13,18,40.0,,687,391,434,825,2188.0,84,6.48,76,407,2545,10.7
20932,Pat LaFontaine,1997-98,32.0,15,27,22,22,12,15,27,54.0,,709,403,449,852,2242.0,48,5.97,37,209,1408,10.2
20933,Pat LaFontaine,1998-99,33.0,16,91,76,76,40,51,91,224.0,,785,443,500,943,2466.0,82,6.29,74,413,2481,10.4
20934,Pat LaFontaine,1999-00,34.0,17,8,13,13,2,6,8,38.0,,798,445,506,951,2504.0,82,5.83,55,336,2444,9.8
20935,Pat LaFontaine,2000-01,35.0,18,62,67,67,23,39,62,160.0,,865,468,545,1013,2664.0,82,5.28,57,380,2242,9.6
20936,Pat MacLeod,1993-94,24.0,4,1,1,1,0,1,1,1.0,,1,0,1,1,1.0,80,6.91,71,366,2385,11.6
20937,Pat MacLeod,1994-95,25.0,5,16,37,37,5,11,16,77.0,,38,5,12,17,78.0,80,6.96,77,402,2440,11.4
20938,Pat MacLeod,1995-96,26.0,6,1,13,13,0,1,1,20.0,,51,5,13,18,98.0,84,7.25,87,443,2603,11.7
20939,Pat MacLeod,1998-99,29.0,7,0,2,2,0,0,0,2.0,,53,5,13,18,100.0,82,6.29,74,413,2481,10.4
20940,Pat Maroon,2014-15,26.0,4,0,2,2,0,0,0,1.0,25.0,2,0,0,0,1.0,82,5.32,47,271,2439,8.9
20941,Pat Maroon,2015-16,27.0,5,3,13,13,2,1,3,21.0,127.0,15,2,1,3,22.0,48,5.31,29,160,1399,9.1
20942,Pat Maroon,2016-17,28.0,6,29,62,62,11,18,29,93.0,763.0,77,13,19,32,115.0,82,5.34,48,269,2463,8.9
20943,Pat Maroon,2017-18,29.0,7,34,71,71,9,25,34,120.0,1014.0,148,22,44,66,235.0,82,5.32,47,251,2453,8.9
20944,Pat Maroon,2018-19,30.0,8,27,72,72,12,15,27,104.0,888.0,220,34,59,93,339.0,82,5.34,48,255,2438,9.0
20945,Pat Maroon,2019-20,31.0,9,42,81,81,27,15,42,178.0,1356.0,301,61,74,135,517.0,82,5.45,47,245,2478,9.0
20946,Pat Maroon,2020-21,32.0,10,43,74,74,17,26,43,141.0,1224.0,375,78,100,178,658.0,82,5.86,50,250,2620,9.2
20947,Pat Maroon,2021-22,33.0,11,28,74,74,10,18,28,118.0,1049.0,449,88,118,206,776.0,82,5.96,47,239,2579,9.5
20948,Pat Maroon,2022-23,34.0,12,23,64,64,9,14,23,80.0,794.0,513,97,132,229,856.0,70,5.96,42,208,2192,9.5
20949,Pat Mayer,1990-91,29.0,4,0,1,1,0,0,0,0.0,,1,0,0,0,0.0,80,7.43,89,437,2435,12.2
20950,Pat Micheletti,1990-91,27.0,4,2,12,12,2,0,2,18.0,,12,2,0,2,18.0,80,7.43,89,437,2435,12.2
20951,Pat Murray,1993-94,24.0,4,3,16,16,2,1,3,16.0,,16,2,1,3,16.0,80,6.91,71,366,2385,11.6
20952,Pat Murray,1994-95,25.0,5,1,9,9,1,0,1,8.0,,25,3,1,4,24.0,80,6.96,77,402,2440,11.4
20953,Pat Neaton,1996-97,25.0,4,2,9,9,1,1,2,11.0,,9,1,1,2,11.0,84,6.48,76,407,2545,10.7
20954,Pat Peake,1996-97,23.0,4,29,49,49,11,18,29,91.0,,49,11,18,29,91.0,84,6.48,76,407,2545,10.7
20955,Pat Peake,1997-98,24.0,5,4,18,18,0,4,4,30.0,,67,11,22,33,121.0,48,5.97,37,209,1408,10.2
20956,Pat Peake,1998-99,25.0,6,36,62,62,17,19,36,129.0,,129,28,41,69,250.0,82,6.29,74,413,2481,10.4
20957,Pat Peake,1999-00,26.0,7,0,4,4,0,0,0,9.0,,133,28,41,69,259.0,82,5.83,55,336,2444,9.8
20958,Pat Peake,2000-01,27.0,8,0,1,1,0,0,0,0.0,,134,28,41,69,259.0,82,5.28,57,380,2242,9.6
20959,Pat Verbeek,1985-86,21.0,4,5,6,6,3,2,5,12.0,,6,3,2,5,12.0,80,7.73,71,310,2444,12.7
20960,Pat Verbeek,1986-87,22.0,5,47,79,79,20,27,47,167.0,,85,23,29,52,179.0,80,7.89,74,336,2448,12.9
20961,Pat Verbeek,1987-88,23.0,6,33,78,78,15,18,33,148.0,,163,38,47,85,327.0,80,7.77,71,321,2447,12.7
20962,Pat Verbeek,1988-89,24.0,7,52,76,76,25,27,52,159.0,,239,63,74,137,486.0,80,7.94,82,370,2484,12.8
20963,Pat Verbeek,1989-90,25.0,8,59,74,74,35,24,59,144.0,,313,98,98,196,630.0,80,7.34,72,344,2400,12.2
20964,Pat Verbeek,1990-91,26.0,9,77,73,73,46,31,77,179.0,,386,144,129,273,809.0,80,7.43,89,437,2435,12.2
20965,Pat Verbeek,1991-92,27.0,10,47,77,77,26,21,47,175.0,,463,170,150,320,984.0,80,7.48,85,403,2430,12.3
20966,Pat Verbeek,1992-93,28.0,11,89,80,80,44,45,89,219.0,,543,214,195,409,1203.0,80,7.37,76,367,2421,12.2
20967,Pat Verbeek,1993-94,29.0,12,82,80,80,43,39,82,247.0,,623,257,234,491,1450.0,80,6.91,71,366,2385,11.6
20968,Pat Verbeek,1994-95,30.0,13,57,76,76,22,35,57,163.0,,699,279,269,548,1613.0,80,6.96,77,402,2440,11.4
20969,Pat Verbeek,1995-96,31.0,14,82,84,84,39,43,82,235.0,,783,318,312,630,1848.0,84,7.25,87,443,2603,11.7
20970,Pat Verbeek,1996-97,32.0,15,75,84,84,37,38,75,226.0,,867,355,350,705,2074.0,84,6.48,76,407,2545,10.7
20971,Pat Verbeek,1997-98,33.0,16,33,48,48,17,16,33,131.0,,915,372,366,738,2205.0,48,5.97,37,209,1408,10.2
20972,Pat Verbeek,1998-99,34.0,17,82,69,69,41,41,82,252.0,,984,413,407,820,2457.0,82,6.29,74,413,2481,10.4
20973,Pat Verbeek,1999-00,35.0,18,53,81,81,17,36,53,172.0,,1065,430,443,873,2629.0,82,5.83,55,336,2444,9.8
20974,Pat Verbeek,2000-01,36.0,19,57,82,82,31,26,57,190.0,,1147,461,469,930,2819.0,82,5.28,57,380,2242,9.6
20975,Pat Verbeek,2001-02,37.0,20,34,78,78,17,17,34,134.0,1136.0,1225,478,486,964,2953.0,82,5.27,57,359,2285,9.4
20976,Pat Verbeek,2002-03,38.0,21,48,68,68,22,26,48,138.0,1092.0,1293,500,512,1012,3091.0,82,5.49,53,331,2294,9.8
20977,Pat Verbeek,2003-04,39.0,22,30,67,67,15,15,30,113.0,905.0,1360,515,527,1042,3204.0,82,5.51,63,376,2272,9.9
20978,Pat Verbeek,2004-05,40.0,23,20,64,64,7,13,20,81.0,745.0,1424,522,540,1062,3285.0,82,5.24,53,338,2262,9.5
20979,Patric Hornqvist,2011-12,25.0,4,7,28,28,2,5,7,54.0,319.0,28,2,5,7,54.0,82,5.7,65,341,2477,9.4
20980,Patric Hornqvist,2012-13,26.0,5,51,80,80,30,21,51,275.0,1255.0,108,32,26,58,329.0,82,5.53,56,304,2486,9.1
20981,Patric Hornqvist,2013-14,27.0,6,48,79,79,21,27,48,265.0,1242.0,187,53,53,106,594.0,82,5.46,52,291,2492,9.0
20982,Patric Hornqvist,2014-15,28.0,7,43,76,76,27,16,43,230.0,1165.0,263,80,69,149,824.0,82,5.32,47,271,2439,8.9
20983,Patric Hornqvist,2015-16,29.0,8,14,24,24,4,10,14,87.0,389.0,287,84,79,163,911.0,48,5.31,29,160,1399,9.1
20984,Patric Hornqvist,2016-17,30.0,9,53,76,76,22,31,53,248.0,1281.0,363,106,110,216,1159.0,82,5.34,48,269,2463,8.9
20985,Patric Hornqvist,2017-18,31.0,10,51,64,64,25,26,51,220.0,1130.0,427,131,136,267,1379.0,82,5.32,47,251,2453,8.9
20986,Patric Hornqvist,2018-19,32.0,11,51,82,82,22,29,51,257.0,1382.0,509,153,165,318,1636.0,82,5.34,48,255,2438,9.0
20987,Patric Hornqvist,2019-20,33.0,12,44,70,70,21,23,44,223.0,1117.0,579,174,188,362,1859.0,82,5.45,47,245,2478,9.0
20988,Patric Hornqvist,2020-21,34.0,13,49,70,70,29,20,49,247.0,1213.0,649,203,208,411,2106.0,82,5.86,50,250,2620,9.2
20989,Patric Hornqvist,2021-22,35.0,14,37,69,69,18,19,37,197.0,1068.0,718,221,227,448,2303.0,82,5.96,47,239,2579,9.5
20990,Patric Hornqvist,2022-23,36.0,15,32,52,52,17,15,32,168.0,828.0,770,238,242,480,2471.0,70,5.96,42,208,2192,9.5
20991,Patric Kjellberg,1995-96,26.0,4,0,7,7,0,0,0,7.0,,7,0,0,0,7.0,84,7.25,87,443,2603,11.7
20992,Patric Kjellberg,2001-02,32.0,5,31,71,71,11,20,31,103.0,1256.0,78,11,20,31,110.0,82,5.27,57,359,2285,9.4
20993,Patric Kjellberg,2002-03,33.0,6,46,82,82,23,23,46,129.0,1492.0,160,34,43,77,239.0,82,5.49,53,331,2294,9.8
20994,Patric Kjellberg,2003-04,34.0,7,45,81,81,14,31,45,139.0,1430.0,241,48,74,122,378.0,82,5.51,63,376,2272,9.9
20995,Patric Kjellberg,2004-05,35.0,8,19,77,77,8,11,19,88.0,1314.0,318,56,85,141,466.0,82,5.24,53,338,2262,9.5
20996,Patric Kjellberg,2005-06,36.0,9,19,76,76,8,11,19,95.0,1188.0,394,64,96,160,561.0,82,5.31,60,363,2326,9.4
20997,Patrice Bergeron,2006-07,21.0,4,39,71,71,16,23,39,133.0,1161.0,71,16,23,39,133.0,82,5.14,57,348,2300,9.2
20998,Patrice Bergeron,2008-09,23.0,5,73,81,81,31,42,73,310.0,1668.0,152,47,65,112,443.0,82,6.05,85,480,2458,10.1
20999,Patrice Bergeron,2009-10,24.0,6,70,77,77,22,48,70,224.0,1603.0,229,69,113,182,667.0,82,5.76,70,398,2426,9.7
21000,Patrice Bergeron,2010-11,25.0,7,7,10,10,3,4,7,24.0,182.0,239,72,117,189,691.0,82,5.44,62,351,2383,9.4
21001,Patrice Bergeron,2011-12,26.0,8,39,64,64,8,31,39,155.0,1151.0,303,80,148,228,846.0,82,5.7,65,341,2477,9.4
21002,Patrice Bergeron,2012-13,27.0,9,52,73,73,19,33,52,184.0,1380.0,376,99,181,280,1030.0,82,5.53,56,304,2486,9.1
21003,Patrice Bergeron,2013-14,28.0,10,57,80,80,22,35,57,211.0,1431.0,456,121,216,337,1241.0,82,5.46,52,291,2492,9.0
21004,Patrice Bergeron,2014-15,29.0,11,64,81,81,22,42,64,191.0,1505.0,537,143,258,401,1432.0,82,5.32,47,271,2439,8.9
21005,Patrice Bergeron,2015-16,30.0,12,32,42,42,10,22,32,125.0,810.0,579,153,280,433,1557.0,48,5.31,29,160,1399,9.1
21006,Patrice Bergeron,2016-17,31.0,13,62,80,80,30,32,62,243.0,1439.0,659,183,312,495,1800.0,82,5.34,48,269,2463,8.9
21007,Patrice Bergeron,2017-18,32.0,14,55,81,81,23,32,55,234.0,1469.0,740,206,344,550,2034.0,82,5.32,47,251,2453,8.9
21008,Patrice Bergeron,2018-19,33.0,15,68,80,80,32,36,68,282.0,1587.0,820,238,380,618,2316.0,82,5.34,48,255,2438,9.0
21009,Patrice Bergeron,2019-20,34.0,16,53,79,79,21,32,53,302.0,1534.0,899,259,412,671,2618.0,82,5.45,47,245,2478,9.0
21010,Patrice Bergeron,2020-21,35.0,17,63,64,64,30,33,63,224.0,1244.0,963,289,445,734,2842.0,82,5.86,50,250,2620,9.2
21011,Patrice Bergeron,2021-22,36.0,18,79,65,65,32,47,79,205.0,1200.0,1028,321,492,813,3047.0,82,5.96,47,239,2579,9.5
21012,Patrice Bergeron,2022-23,37.0,19,56,61,61,31,25,56,203.0,1143.0,1089,352,517,869,3250.0,70,5.96,42,208,2192,9.5
21013,Patrice Brisebois,1993-94,23.0,4,2,10,10,0,2,2,11.0,,10,0,2,2,11.0,80,6.91,71,366,2385,11.6
21014,Patrice Brisebois,1994-95,24.0,5,10,26,26,2,8,10,37.0,,36,2,10,12,48.0,80,6.96,77,402,2440,11.4
21015,Patrice Brisebois,1995-96,25.0,6,31,70,70,10,21,31,123.0,,106,12,31,43,171.0,84,7.25,87,443,2603,11.7
21016,Patrice Brisebois,1996-97,26.0,7,23,53,53,2,21,23,71.0,,159,14,52,66,242.0,84,6.48,76,407,2545,10.7
21017,Patrice Brisebois,1997-98,27.0,8,12,35,35,4,8,12,67.0,,194,18,60,78,309.0,48,5.97,37,209,1408,10.2
21018,Patrice Brisebois,1998-99,28.0,9,36,69,69,9,27,36,127.0,,263,27,87,114,436.0,82,6.29,74,413,2481,10.4
21019,Patrice Brisebois,1999-00,29.0,10,15,49,49,2,13,15,72.0,,312,29,100,129,508.0,82,5.83,55,336,2444,9.8
21020,Patrice Brisebois,2000-01,30.0,11,37,79,79,10,27,37,125.0,,391,39,127,166,633.0,82,5.28,57,380,2242,9.6
21021,Patrice Brisebois,2001-02,31.0,12,12,54,54,3,9,12,90.0,1211.0,445,42,136,178,723.0,82,5.27,57,359,2285,9.4
21022,Patrice Brisebois,2002-03,32.0,13,35,54,54,10,25,35,88.0,1254.0,499,52,161,213,811.0,82,5.49,53,331,2294,9.8
21023,Patrice Brisebois,2003-04,33.0,14,36,77,77,15,21,36,178.0,1903.0,576,67,182,249,989.0,82,5.51,63,376,2272,9.9
21024,Patrice Brisebois,2004-05,34.0,15,33,71,71,4,29,33,95.0,1696.0,647,71,211,282,1084.0,82,5.24,53,338,2262,9.5
21025,Patrice Brisebois,2005-06,35.0,16,29,73,73,4,25,29,105.0,1707.0,720,75,236,311,1189.0,82,5.31,60,363,2326,9.4
21026,Patrice Brisebois,2006-07,36.0,17,31,71,71,4,27,31,96.0,1515.0,791,79,263,342,1285.0,82,5.14,57,348,2300,9.2
21027,Patrice Brisebois,2008-09,38.0,18,38,80,80,10,28,38,107.0,1785.0,871,89,291,380,1392.0,82,6.05,85,480,2458,10.1
21028,Patrice Brisebois,2009-10,39.0,19,11,33,33,1,10,11,36.0,640.0,904,90,301,391,1428.0,82,5.76,70,398,2426,9.7
21029,Patrice Brisebois,2010-11,40.0,20,11,43,43,3,8,11,42.0,724.0,947,93,309,402,1470.0,82,5.44,62,351,2383,9.4
21030,Patrice Brisebois,2011-12,41.0,21,18,62,62,5,13,18,68.0,986.0,1009,98,322,420,1538.0,82,5.7,65,341,2477,9.4
21031,Patrice Cormier,2013-14,23.0,4,2,21,21,1,1,2,27.0,203.0,21,1,1,2,27.0,82,5.46,52,291,2492,9.0
21032,Patrice Cormier,2014-15,24.0,5,0,9,9,0,0,0,8.0,57.0,30,1,1,2,35.0,82,5.32,47,271,2439,8.9
21033,Patrice Cormier,2015-16,25.0,6,0,10,10,0,0,0,4.0,39.0,40,1,1,2,39.0,48,5.31,29,160,1399,9.1
21034,Patrice Cormier,2016-17,26.0,7,3,9,9,0,3,3,4.0,63.0,49,1,4,5,43.0,82,5.34,48,269,2463,8.9
21035,Patrice Cormier,2017-18,27.0,8,0,1,1,0,0,0,0.0,5.0,50,1,4,5,43.0,82,5.32,47,251,2453,8.9
21036,Patrice Cormier,2018-19,28.0,9,0,2,2,0,0,0,1.0,9.0,52,1,4,5,44.0,82,5.34,48,255,2438,9.0
21037,Patrice Lefebvre,2001-02,34.0,4,0,3,3,0,0,0,2.0,34.0,3,0,0,0,2.0,82,5.27,57,359,2285,9.4
21038,Patrice Tardif,1997-98,27.0,4,13,27,27,3,10,13,46.0,,27,3,10,13,46.0,48,5.97,37,209,1408,10.2
21039,Patrice Tardif,1998-99,28.0,5,5,38,38,4,1,5,50.0,,65,7,11,18,96.0,82,6.29,74,413,2481,10.4
21040,Patrick Boileau,1999-00,24.0,4,0,1,1,0,0,0,0.0,,1,0,0,0,0.0,82,5.83,55,336,2444,9.8
21041,Patrick Boileau,2001-02,26.0,5,1,4,4,0,1,1,7.0,64.0,5,0,1,1,7.0,82,5.27,57,359,2285,9.4
21042,Patrick Boileau,2004-05,29.0,6,0,2,2,0,0,0,0.0,24.0,7,0,1,1,7.0,82,5.24,53,338,2262,9.5
21043,Patrick Boileau,2005-06,30.0,7,8,25,25,2,6,8,18.0,349.0,32,2,7,9,25.0,82,5.31,60,363,2326,9.4
21044,Patrick Boileau,2006-07,31.0,8,7,16,16,3,4,7,41.0,318.0,48,5,11,16,66.0,82,5.14,57,348,2300,9.2
21045,Patrick Bordeleau,2015-16,29.0,4,5,46,46,2,3,5,24.0,286.0,46,2,3,5,24.0,48,5.31,29,160,1399,9.1
21046,Patrick Bordeleau,2016-17,30.0,5,11,82,82,6,5,11,37.0,565.0,128,8,8,16,61.0,82,5.34,48,269,2463,8.9
21047,Patrick Bordeleau,2017-18,31.0,6,0,1,1,0,0,0,0.0,7.0,129,8,8,16,61.0,82,5.32,47,251,2453,8.9
21048,Patrick Brown,2017-18,25.0,4,0,7,7,0,0,0,4.0,62.0,7,0,0,0,4.0,82,5.32,47,251,2453,8.9
21049,Patrick Brown,2018-19,26.0,5,2,7,7,1,1,2,8.0,88.0,14,1,1,2,12.0,82,5.34,48,255,2438,9.0
21050,Patrick Brown,2019-20,27.0,6,0,14,14,0,0,0,12.0,136.0,28,1,1,2,24.0,82,5.45,47,245,2478,9.0
21051,Patrick Brown,2022-23,30.0,7,1,1,1,1,0,1,2.0,10.0,29,2,1,3,26.0,70,5.96,42,208,2192,9.5
21052,Patrick Cannone,2019-20,33.0,4,0,3,3,0,0,0,2.0,24.0,3,0,0,0,2.0,82,5.45,47,245,2478,9.0
21053,Patrick Cote,1998-99,24.0,4,0,2,2,0,0,0,0.0,,2,0,0,0,0.0,82,6.29,74,413,2481,10.4
21054,Patrick Cote,1999-00,25.0,5,0,3,3,0,0,0,1.0,,5,0,0,0,1.0,82,5.83,55,336,2444,9.8
21055,Patrick Cote,2000-01,26.0,6,0,3,3,0,0,0,3.0,,8,0,0,0,4.0,82,5.28,57,380,2242,9.6
21056,Patrick Cote,2001-02,27.0,7,3,70,70,1,2,3,21.0,296.0,78,1,2,3,25.0,82,5.27,57,359,2285,9.4
21057,Patrick Cote,2002-03,28.0,8,0,21,21,0,0,0,8.0,110.0,99,1,2,3,33.0,82,5.49,53,331,2294,9.8
21058,Patrick Cote,2003-04,29.0,9,0,6,6,0,0,0,0.0,19.0,105,1,2,3,33.0,82,5.51,63,376,2272,9.9
21059,Patrick Coulombe,2009-10,24.0,4,1,7,7,0,1,1,11.0,95.0,7,0,1,1,11.0,82,5.76,70,398,2426,9.7
21060,Patrick Davis,2011-12,25.0,4,0,1,1,0,0,0,0.0,5.0,1,0,0,0,0.0,82,5.7,65,341,2477,9.4
21061,Patrick Davis,2012-13,26.0,5,1,8,8,1,0,1,8.0,101.0,9,1,0,1,8.0,82,5.53,56,304,2486,9.1
21062,Patrick Dwyer,2011-12,28.0,4,1,13,13,1,0,1,9.0,111.0,13,1,0,1,9.0,82,5.7,65,341,2477,9.4
21063,Patrick Dwyer,2012-13,29.0,5,12,58,58,7,5,12,80.0,725.0,71,8,5,13,89.0,82,5.53,56,304,2486,9.1
21064,Patrick Dwyer,2013-14,30.0,6,18,80,80,8,10,18,104.0,1006.0,151,16,15,31,193.0,82,5.46,52,291,2492,9.0
21065,Patrick Dwyer,2014-15,31.0,7,12,73,73,5,7,12,120.0,1122.0,224,21,22,43,313.0,82,5.32,47,271,2439,8.9
21066,Patrick Dwyer,2015-16,32.0,8,16,46,46,8,8,16,93.0,710.0,270,29,30,59,406.0,48,5.31,29,160,1399,9.1
21067,Patrick Dwyer,2016-17,33.0,9,22,75,75,8,14,22,134.0,1099.0,345,37,44,81,540.0,82,5.34,48,269,2463,8.9
21068,Patrick Dwyer,2017-18,34.0,10,12,71,71,5,7,12,77.0,907.0,416,42,51,93,617.0,82,5.32,47,251,2453,8.9
21069,Patrick Eaves,2008-09,24.0,4,29,58,58,20,9,29,100.0,724.0,58,20,9,29,100.0,82,6.05,85,480,2458,10.1
21070,Patrick Eaves,2009-10,25.0,5,32,73,73,14,18,32,130.0,892.0,131,34,27,61,230.0,82,5.76,70,398,2426,9.7
21071,Patrick Eaves,2010-11,26.0,6,15,37,37,5,10,15,81.0,473.0,168,39,37,76,311.0,82,5.44,62,351,2383,9.4
21072,Patrick Eaves,2011-12,27.0,7,14,74,74,6,8,14,115.0,833.0,242,45,45,90,426.0,82,5.7,65,341,2477,9.4
21073,Patrick Eaves,2012-13,28.0,8,22,65,65,12,10,22,120.0,874.0,307,57,55,112,546.0,82,5.53,56,304,2486,9.1
21074,Patrick Eaves,2013-14,29.0,9,20,63,63,13,7,20,108.0,800.0,370,70,62,132,654.0,82,5.46,52,291,2492,9.0
21075,Patrick Eaves,2014-15,30.0,10,1,10,10,0,1,1,24.0,110.0,380,70,63,133,678.0,82,5.32,47,271,2439,8.9
21076,Patrick Eaves,2015-16,31.0,11,8,34,34,2,6,8,42.0,360.0,414,72,69,141,720.0,48,5.31,29,160,1399,9.1
21077,Patrick Eaves,2016-17,32.0,12,5,30,30,2,3,5,53.0,338.0,444,74,72,146,773.0,82,5.34,48,269,2463,8.9
21078,Patrick Eaves,2017-18,33.0,13,27,47,47,14,13,27,91.0,645.0,491,88,85,173,864.0,82,5.32,47,251,2453,8.9
21079,Patrick Eaves,2018-19,34.0,14,17,54,54,11,6,17,86.0,700.0,545,99,91,190,950.0,82,5.34,48,255,2438,9.0
21080,Patrick Eaves,2019-20,35.0,15,51,79,79,32,19,51,209.0,1296.0,624,131,110,241,1159.0,82,5.45,47,245,2478,9.0
21081,Patrick Eaves,2020-21,36.0,16,1,2,2,1,0,1,3.0,33.0,626,132,110,242,1162.0,82,5.86,50,250,2620,9.2
21082,Patrick Eaves,2021-22,37.0,17,0,7,7,0,0,0,6.0,97.0,633,132,110,242,1168.0,82,5.96,47,239,2579,9.5
21083,Patrick Fischer,2009-10,34.0,4,10,27,27,4,6,10,32.0,293.0,27,4,6,10,32.0,82,5.76,70,398,2426,9.7
21084,Patrick Holland,2016-17,25.0,4,0,5,5,0,0,0,2.0,38.0,5,0,0,0,2.0,82,5.34,48,269,2463,8.9
21085,Patrick Kaleta,2009-10,23.0,4,2,7,7,0,2,2,6.0,48.0,7,0,2,2,6.0,82,5.76,70,398,2426,9.7
21086,Patrick Kaleta,2010-11,24.0,5,5,40,40,3,2,5,26.0,253.0,47,3,4,7,32.0,82,5.44,62,351,2383,9.4
21087,Patrick Kaleta,2011-12,25.0,6,9,51,51,4,5,9,35.0,455.0,98,7,9,16,67.0,82,5.7,65,341,2477,9.4
21088,Patrick Kaleta,2012-13,26.0,7,15,55,55,10,5,15,64.0,558.0,153,17,14,31,131.0,82,5.53,56,304,2486,9.1
21089,Patrick Kaleta,2013-14,27.0,8,9,51,51,4,5,9,65.0,520.0,204,21,19,40,196.0,82,5.46,52,291,2492,9.0
21090,Patrick Kaleta,2014-15,28.0,9,10,63,63,5,5,10,69.0,829.0,267,26,24,50,265.0,82,5.32,47,271,2439,8.9
21091,Patrick Kaleta,2015-16,29.0,10,1,34,34,1,0,1,34.0,367.0,301,27,24,51,299.0,48,5.31,29,160,1399,9.1
21092,Patrick Kaleta,2016-17,30.0,11,0,5,5,0,0,0,0.0,42.0,306,27,24,51,299.0,82,5.34,48,269,2463,8.9
21093,Patrick Kaleta,2017-18,31.0,12,3,42,42,0,3,3,25.0,372.0,348,27,27,54,324.0,82,5.32,47,251,2453,8.9
21094,Patrick Kane,2010-11,22.0,4,72,82,82,21,51,72,191.0,1506.0,82,21,51,72,191.0,82,5.44,62,351,2383,9.4
21095,Patrick Kane,2011-12,23.0,5,70,80,80,25,45,70,254.0,1493.0,162,46,96,142,445.0,82,5.7,65,341,2477,9.4
21096,Patrick Kane,2012-13,24.0,6,88,82,82,30,58,88,261.0,1574.0,244,76,154,230,706.0,82,5.53,56,304,2486,9.1
21097,Patrick Kane,2013-14,25.0,7,73,73,73,27,46,73,216.0,1408.0,317,103,200,303,922.0,82,5.46,52,291,2492,9.0
21098,Patrick Kane,2014-15,26.0,8,66,82,82,23,43,66,253.0,1656.0,399,126,243,369,1175.0,82,5.32,47,271,2439,8.9
21099,Patrick Kane,2015-16,27.0,9,55,47,47,23,32,55,138.0,943.0,446,149,275,424,1313.0,48,5.31,29,160,1399,9.1
21100,Patrick Kane,2016-17,28.0,10,69,69,69,29,40,69,227.0,1353.0,515,178,315,493,1540.0,82,5.34,48,269,2463,8.9
21101,Patrick Kane,2017-18,29.0,11,64,61,61,27,37,64,186.0,1211.0,576,205,352,557,1726.0,82,5.32,47,251,2453,8.9
21102,Patrick Kane,2018-19,30.0,12,106,82,82,46,60,106,287.0,1674.0,658,251,412,663,2013.0,82,5.34,48,255,2438,9.0
21103,Patrick Kane,2019-20,31.0,13,89,82,82,34,55,89,292.0,1754.0,740,285,467,752,2305.0,82,5.45,47,245,2478,9.0
21104,Patrick Kane,2020-21,32.0,14,76,82,82,27,49,76,285.0,1655.0,822,312,516,828,2590.0,82,5.86,50,250,2620,9.2
21105,Patrick Kane,2021-22,33.0,15,110,81,81,44,66,110,341.0,1822.0,903,356,582,938,2931.0,82,5.96,47,239,2579,9.5
21106,Patrick Kane,2022-23,34.0,16,84,70,70,33,51,84,275.0,1494.0,973,389,633,1022,3206.0,70,5.96,42,208,2192,9.5
21107,Patrick Leahy,2006-07,27.0,4,0,6,6,0,0,0,2.0,33.0,6,0,0,0,2.0,82,5.14,57,348,2300,9.2
21108,Patrick Leahy,2008-09,29.0,5,8,43,43,4,4,8,46.0,391.0,49,4,4,8,48.0,82,6.05,85,480,2458,10.1
21109,Patrick Leahy,2009-10,30.0,6,0,1,1,0,0,0,0.0,6.0,50,4,4,8,48.0,82,5.76,70,398,2426,9.7
21110,Patrick Lebeau,1993-94,23.0,4,2,2,2,1,1,2,3.0,,2,1,1,2,3.0,80,6.91,71,366,2385,11.6
21111,Patrick Lebeau,1995-96,25.0,5,0,1,1,0,0,0,0.0,,3,1,1,2,3.0,84,7.25,87,443,2603,11.7
21112,Patrick Lebeau,1996-97,26.0,6,2,4,4,1,1,2,4.0,,7,2,2,4,7.0,84,6.48,76,407,2545,10.7
21113,Patrick Lebeau,2001-02,31.0,7,1,8,8,1,0,1,4.0,76.0,15,3,2,5,11.0,82,5.27,57,359,2285,9.4
21114,Patrick Marleau,2000-01,21.0,4,32,74,74,13,19,32,90.0,,74,13,19,32,90.0,82,5.28,57,380,2242,9.6
21115,Patrick Marleau,2001-02,22.0,5,45,81,81,21,24,45,134.0,1230.0,155,34,43,77,224.0,82,5.27,57,359,2285,9.4
21116,Patrick Marleau,2002-03,23.0,6,40,81,81,17,23,40,161.0,1149.0,236,51,66,117,385.0,82,5.49,53,331,2294,9.8
21117,Patrick Marleau,2003-04,24.0,7,52,81,81,25,27,52,146.0,1319.0,317,76,93,169,531.0,82,5.51,63,376,2272,9.9
21118,Patrick Marleau,2004-05,25.0,8,44,79,79,21,23,44,121.0,1111.0,396,97,116,213,652.0,82,5.24,53,338,2262,9.5
21119,Patrick Marleau,2005-06,26.0,9,57,82,82,28,29,57,172.0,1519.0,478,125,145,270,824.0,82,5.31,60,363,2326,9.4
21120,Patrick Marleau,2006-07,27.0,10,57,80,80,28,29,57,220.0,1456.0,558,153,174,327,1044.0,82,5.14,57,348,2300,9.2
21121,Patrick Marleau,2008-09,29.0,11,86,82,82,34,52,86,260.0,1634.0,640,187,226,413,1304.0,82,6.05,85,480,2458,10.1
21122,Patrick Marleau,2009-10,30.0,12,78,77,77,32,46,78,180.0,1429.0,717,219,272,491,1484.0,82,5.76,70,398,2426,9.7
21123,Patrick Marleau,2010-11,31.0,13,48,78,78,19,29,48,185.0,1422.0,795,238,301,539,1669.0,82,5.44,62,351,2383,9.4
21124,Patrick Marleau,2011-12,32.0,14,71,76,76,38,33,71,251.0,1623.0,871,276,334,610,1920.0,82,5.7,65,341,2477,9.4
21125,Patrick Marleau,2012-13,33.0,15,83,82,82,44,39,83,274.0,1739.0,953,320,373,693,2194.0,82,5.53,56,304,2486,9.1
21126,Patrick Marleau,2013-14,34.0,16,73,82,82,37,36,73,279.0,1705.0,1035,357,409,766,2473.0,82,5.46,52,291,2492,9.0
21127,Patrick Marleau,2014-15,35.0,17,64,82,82,30,34,64,251.0,1679.0,1117,387,443,830,2724.0,82,5.32,47,271,2439,8.9
21128,Patrick Marleau,2015-16,36.0,18,31,48,48,17,14,31,150.0,917.0,1165,404,457,861,2874.0,48,5.31,29,160,1399,9.1
21129,Patrick Marleau,2016-17,37.0,19,70,82,82,33,37,70,285.0,1683.0,1247,437,494,931,3159.0,82,5.34,48,269,2463,8.9
21130,Patrick Marleau,2017-18,38.0,20,57,82,82,19,38,57,233.0,1606.0,1329,456,532,988,3392.0,82,5.32,47,251,2453,8.9
21131,Patrick Marleau,2018-19,39.0,21,48,82,82,25,23,48,216.0,1560.0,1411,481,555,1036,3608.0,82,5.34,48,255,2438,9.0
21132,Patrick Marleau,2019-20,40.0,22,46,82,82,27,19,46,190.0,1407.0,1493,508,574,1082,3798.0,82,5.45,47,245,2478,9.0
21133,Patrick Marleau,2020-21,41.0,23,47,82,82,27,20,47,203.0,1393.0,1575,535,594,1129,4001.0,82,5.86,50,250,2620,9.2
21134,Patrick Marleau,2021-22,42.0,24,37,82,82,16,21,37,161.0,1340.0,1657,551,615,1166,4162.0,82,5.96,47,239,2579,9.5
21135,Patrick Marleau,2022-23,43.0,25,22,66,66,11,11,22,117.0,1028.0,1723,562,626,1188,4279.0,70,5.96,42,208,2192,9.5
21136,Patrick O'Sullivan,2009-10,24.0,4,19,44,44,5,14,19,92.0,619.0,44,5,14,19,92.0,82,5.76,70,398,2426,9.7
21137,Patrick O'Sullivan,2010-11,25.0,5,53,82,82,22,31,53,220.0,1534.0,126,27,45,72,312.0,82,5.44,62,351,2383,9.4
21138,Patrick O'Sullivan,2011-12,26.0,6,43,81,81,16,27,43,259.0,1551.0,207,43,72,115,571.0,82,5.7,65,341,2477,9.4
21139,Patrick O'Sullivan,2012-13,27.0,7,34,73,73,11,23,34,191.0,1279.0,280,54,95,149,762.0,82,5.53,56,304,2486,9.1
21140,Patrick O'Sullivan,2013-14,28.0,8,8,31,31,2,6,8,50.0,378.0,311,56,101,157,812.0,82,5.46,52,291,2492,9.0
21141,Patrick O'Sullivan,2014-15,29.0,9,4,23,23,2,2,4,34.0,254.0,334,58,103,161,846.0,82,5.32,47,271,2439,8.9
21142,Patrick Poulin,1994-95,21.0,4,0,1,1,0,0,0,0.0,,1,0,0,0,0.0,80,6.96,77,402,2440,11.4
21143,Patrick Poulin,1995-96,22.0,5,51,81,81,20,31,51,160.0,,82,20,31,51,160.0,84,7.25,87,443,2603,11.7
21144,Patrick Poulin,1996-97,23.0,6,28,67,67,14,14,28,96.0,,149,34,45,79,256.0,84,6.48,76,407,2545,10.7
21145,Patrick Poulin,1997-98,24.0,7,30,45,45,15,15,30,77.0,,194,49,60,109,333.0,48,5.97,37,209,1408,10.2
21146,Patrick Poulin,1998-99,25.0,8,16,46,46,7,9,16,51.0,,240,56,69,125,384.0,82,6.29,74,413,2481,10.4
21147,Patrick Poulin,1999-00,26.0,9,26,73,73,12,14,26,124.0,,313,68,83,151,508.0,82,5.83,55,336,2444,9.8
21148,Patrick Poulin,2000-01,27.0,10,19,78,78,6,13,19,88.0,,391,74,96,170,596.0,82,5.28,57,380,2242,9.6
21149,Patrick Poulin,2001-02,28.0,11,25,81,81,8,17,25,87.0,1094.0,472,82,113,195,683.0,82,5.27,57,359,2285,9.4
21150,Patrick Poulin,2002-03,29.0,12,15,82,82,10,5,15,82.0,1030.0,554,92,118,210,765.0,82,5.49,53,331,2294,9.8
21151,Patrick Poulin,2003-04,30.0,13,20,52,52,9,11,20,65.0,690.0,606,101,129,230,830.0,82,5.51,63,376,2272,9.9
21152,Patrick Poulin,2004-05,31.0,14,5,28,28,0,5,5,15.0,258.0,634,101,134,235,845.0,82,5.24,53,338,2262,9.5
21153,Patrick Rissmiller,2006-07,28.0,4,0,4,4,0,0,0,2.0,28.0,4,0,0,0,2.0,82,5.14,57,348,2300,9.2
21154,Patrick Rissmiller,2008-09,30.0,5,6,18,18,3,3,6,26.0,169.0,22,3,3,6,28.0,82,6.05,85,480,2458,10.1
21155,Patrick Rissmiller,2009-10,31.0,6,22,79,79,7,15,22,100.0,961.0,101,10,18,28,128.0,82,5.76,70,398,2426,9.7
21156,Patrick Rissmiller,2010-11,32.0,7,17,79,79,8,9,17,119.0,1040.0,180,18,27,45,247.0,82,5.44,62,351,2383,9.4
21157,Patrick Rissmiller,2011-12,33.0,8,0,2,2,0,0,0,2.0,18.0,182,18,27,45,249.0,82,5.7,65,341,2477,9.4
21158,Patrick Rissmiller,2013-14,35.0,9,1,10,10,0,1,1,14.0,104.0,192,18,28,46,263.0,82,5.46,52,291,2492,9.0
21159,Patrick Russell,2021-22,29.0,4,0,6,6,0,0,0,6.0,53.0,6,0,0,0,6.0,82,5.96,47,239,2579,9.5
21160,Patrick Russell,2022-23,30.0,5,5,45,45,0,5,5,58.0,511.0,51,0,5,5,64.0,70,5.96,42,208,2192,9.5
21161,Patrick Sharp,2005-06,24.0,4,0,3,3,0,0,0,3.0,18.0,3,0,0,0,3.0,82,5.31,60,363,2326,9.4
21162,Patrick Sharp,2006-07,25.0,5,7,41,41,5,2,7,44.0,407.0,44,5,2,7,47.0,82,5.14,57,348,2300,9.2
21163,Patrick Sharp,2008-09,27.0,6,31,72,72,14,17,31,144.0,986.0,116,19,19,38,191.0,82,6.05,85,480,2458,10.1
21164,Patrick Sharp,2009-10,28.0,7,35,80,80,20,15,35,160.0,1366.0,196,39,34,73,351.0,82,5.76,70,398,2426,9.7
21165,Patrick Sharp,2010-11,29.0,8,62,80,80,36,26,62,209.0,1502.0,276,75,60,135,560.0,82,5.44,62,351,2383,9.4
21166,Patrick Sharp,2011-12,30.0,9,44,61,61,26,18,44,184.0,1095.0,337,101,78,179,744.0,82,5.7,65,341,2477,9.4
21167,Patrick Sharp,2012-13,31.0,10,66,82,82,25,41,66,266.0,1486.0,419,126,119,245,1010.0,82,5.53,56,304,2486,9.1
21168,Patrick Sharp,2013-14,32.0,11,71,74,74,34,37,71,268.0,1437.0,493,160,156,316,1278.0,82,5.46,52,291,2492,9.0
21169,Patrick Sharp,2014-15,33.0,12,69,74,74,33,36,69,282.0,1473.0,567,193,192,385,1560.0,82,5.32,47,271,2439,8.9
21170,Patrick Sharp,2015-16,34.0,13,20,28,28,6,14,20,88.0,527.0,595,199,206,405,1648.0,48,5.31,29,160,1399,9.1
21171,Patrick Sharp,2016-17,35.0,14,78,82,82,34,44,78,313.0,1549.0,677,233,250,483,1961.0,82,5.34,48,269,2463,8.9
21172,Patrick Sharp,2017-18,36.0,15,43,68,68,16,27,43,230.0,1143.0,745,249,277,526,2191.0,82,5.32,47,251,2453,8.9
21173,Patrick Sharp,2018-19,37.0,16,55,76,76,20,35,55,226.0,1339.0,821,269,312,581,2417.0,82,5.34,48,255,2438,9.0
21174,Patrick Sharp,2019-20,38.0,17,18,48,48,8,10,18,146.0,765.0,869,277,322,599,2563.0,82,5.45,47,245,2478,9.0
21175,Patrick Sharp,2020-21,39.0,18,21,70,70,10,11,21,143.0,902.0,939,287,333,620,2706.0,82,5.86,50,250,2620,9.2
21176,Patrick Sieloff,2018-19,24.0,4,1,1,1,1,0,1,1.0,18.0,1,1,0,1,1.0,82,5.34,48,255,2438,9.0
21177,Patrick Sieloff,2020-21,26.0,5,1,1,1,1,0,1,3.0,11.0,2,2,0,2,4.0,82,5.86,50,250,2620,9.2
21178,Patrick Thoresen,2009-10,26.0,4,16,68,68,4,12,16,73.0,777.0,68,4,12,16,73.0,82,5.76,70,398,2426,9.7
21179,Patrick Thoresen,2010-11,27.0,5,8,38,38,2,6,8,39.0,447.0,106,6,18,24,112.0,82,5.44,62,351,2383,9.4
21180,Patrick Traverse,1998-99,24.0,4,0,5,5,0,0,0,2.0,,5,0,0,0,2.0,82,6.29,74,413,2481,10.4
21181,Patrick Traverse,2001-02,27.0,5,10,46,46,1,9,10,35.0,687.0,51,1,9,10,37.0,82,5.27,57,359,2285,9.4
21182,Patrick Traverse,2002-03,28.0,6,23,66,66,6,17,23,73.0,1235.0,117,7,26,33,110.0,82,5.49,53,331,2294,9.8
21183,Patrick Traverse,2003-04,29.0,7,14,71,71,5,9,14,62.0,1286.0,188,12,35,47,172.0,82,5.51,63,376,2272,9.9
21184,Patrick Traverse,2004-05,30.0,8,5,25,25,2,3,5,24.0,456.0,213,14,38,52,196.0,82,5.24,53,338,2262,9.5
21185,Patrick Traverse,2005-06,31.0,9,13,65,65,0,13,13,63.0,1313.0,278,14,51,65,259.0,82,5.31,60,363,2326,9.4
21186,Patrick Traverse,2008-09,34.0,10,0,1,1,0,0,0,1.0,11.0,279,14,51,65,260.0,82,6.05,85,480,2458,10.1
21187,Patrick Wey,2016-17,25.0,4,3,9,9,0,3,3,5.0,131.0,9,0,3,3,5.0,82,5.34,48,269,2463,8.9
21188,Patrick Wiercioch,2013-14,23.0,4,2,8,8,0,2,2,3.0,111.0,8,0,2,2,3.0,82,5.46,52,291,2492,9.0
21189,Patrick Wiercioch,2015-16,25.0,5,19,42,42,5,14,19,81.0,659.0,50,5,16,21,84.0,48,5.31,29,160,1399,9.1
21190,Patrick Wiercioch,2016-17,26.0,6,23,53,53,4,19,23,97.0,868.0,103,9,35,44,181.0,82,5.34,48,269,2463,8.9
21191,Patrick Wiercioch,2017-18,27.0,7,13,56,56,3,10,13,79.0,1011.0,159,12,45,57,260.0,82,5.32,47,251,2453,8.9
21192,Patrick Wiercioch,2018-19,28.0,8,5,52,52,0,5,5,56.0,902.0,211,12,50,62,316.0,82,5.34,48,255,2438,9.0
21193,Patrick Wiercioch,2019-20,29.0,9,12,57,57,4,8,12,63.0,950.0,268,16,58,74,379.0,82,5.45,47,245,2478,9.0
21194,Patrik Augusta,1996-97,27.0,4,0,2,2,0,0,0,3.0,,2,0,0,0,3.0,84,6.48,76,407,2545,10.7
21195,Patrik Augusta,2001-02,32.0,5,0,2,2,0,0,0,4.0,27.0,4,0,0,0,7.0,82,5.27,57,359,2285,9.4
21196,Patrik Berglund,2011-12,23.0,4,47,76,76,21,26,47,143.0,1119.0,76,21,26,47,143.0,82,5.7,65,341,2477,9.4
21197,Patrik Berglund,2012-13,24.0,5,26,71,71,13,13,26,129.0,959.0,147,34,39,73,272.0,82,5.53,56,304,2486,9.1
21198,Patrik Berglund,2013-14,25.0,6,52,81,81,22,30,52,175.0,1392.0,228,56,69,125,447.0,82,5.46,52,291,2492,9.0
21199,Patrik Berglund,2014-15,26.0,7,38,82,82,19,19,38,188.0,1473.0,310,75,88,163,635.0,82,5.32,47,271,2439,8.9
21200,Patrik Berglund,2015-16,27.0,8,25,48,48,17,8,25,74.0,808.0,358,92,96,188,709.0,48,5.31,29,160,1399,9.1
21201,Patrik Berglund,2016-17,28.0,9,32,78,78,14,18,32,144.0,1261.0,436,106,114,220,853.0,82,5.34,48,269,2463,8.9
21202,Patrik Berglund,2017-18,29.0,10,27,77,77,12,15,27,145.0,1122.0,513,118,129,247,998.0,82,5.32,47,251,2453,8.9
21203,Patrik Berglund,2018-19,30.0,11,15,42,42,10,5,15,80.0,651.0,555,128,134,262,1078.0,82,5.34,48,255,2438,9.0
21204,Patrik Berglund,2019-20,31.0,12,34,82,82,23,11,34,153.0,1311.0,637,151,145,296,1231.0,82,5.45,47,245,2478,9.0
21205,Patrik Berglund,2020-21,32.0,13,26,57,57,17,9,26,112.0,921.0,694,168,154,322,1343.0,82,5.86,50,250,2620,9.2
21206,Patrik Berglund,2021-22,33.0,14,4,23,23,2,2,4,25.0,300.0,717,170,156,326,1368.0,82,5.96,47,239,2579,9.5
21207,Patrik Carnback,1995-96,27.0,4,0,6,6,0,0,0,4.0,,6,0,0,0,4.0,84,7.25,87,443,2603,11.7
21208,Patrik Carnback,1996-97,28.0,5,23,73,73,12,11,23,81.0,,79,12,11,23,85.0,84,6.48,76,407,2545,10.7
21209,Patrik Carnback,1997-98,29.0,6,21,41,41,6,15,21,58.0,,120,18,26,44,143.0,48,5.97,37,209,1408,10.2
21210,Patrik Carnback,1998-99,30.0,7,18,34,34,6,12,18,54.0,,154,24,38,62,197.0,82,6.29,74,413,2481,10.4
21211,Patrik Elias,1998-99,22.0,4,0,1,1,0,0,0,2.0,,1,0,0,0,2.0,82,6.29,74,413,2481,10.4
21212,Patrik Elias,1999-00,23.0,5,5,17,17,2,3,5,23.0,,18,2,3,5,25.0,82,5.83,55,336,2444,9.8
21213,Patrik Elias,2000-01,24.0,6,37,74,74,18,19,37,147.0,,92,20,22,42,172.0,82,5.28,57,380,2242,9.6
21214,Patrik Elias,2001-02,25.0,7,50,74,74,17,33,50,157.0,1172.0,166,37,55,92,329.0,82,5.27,57,359,2285,9.4
21215,Patrik Elias,2002-03,26.0,8,72,72,72,35,37,72,183.0,1257.0,238,72,92,164,512.0,82,5.49,53,331,2294,9.8
21216,Patrik Elias,2003-04,27.0,9,96,82,82,40,56,96,220.0,1535.0,320,112,148,260,732.0,82,5.51,63,376,2272,9.9
21217,Patrik Elias,2004-05,28.0,10,61,75,75,29,32,61,199.0,1421.0,395,141,180,321,931.0,82,5.24,53,338,2262,9.5
21218,Patrik Elias,2005-06,29.0,11,57,81,81,28,29,57,255.0,1465.0,476,169,209,378,1186.0,82,5.31,60,363,2326,9.4
21219,Patrik Elias,2006-07,30.0,12,81,82,82,38,43,81,300.0,1539.0,558,207,252,459,1486.0,82,5.14,57,348,2300,9.2
21220,Patrik Elias,2008-09,32.0,13,45,38,38,16,29,45,142.0,706.0,596,223,281,504,1628.0,82,6.05,85,480,2458,10.1
21221,Patrik Elias,2009-10,33.0,14,69,75,75,21,48,69,267.0,1396.0,671,244,329,573,1895.0,82,5.76,70,398,2426,9.7
21222,Patrik Elias,2010-11,34.0,15,55,74,74,20,35,55,263.0,1367.0,745,264,364,628,2158.0,82,5.44,62,351,2383,9.4
21223,Patrik Elias,2011-12,35.0,16,78,77,77,31,47,78,247.0,1430.0,822,295,411,706,2405.0,82,5.7,65,341,2477,9.4
21224,Patrik Elias,2012-13,36.0,17,48,58,58,19,29,48,145.0,1022.0,880,314,440,754,2550.0,82,5.53,56,304,2486,9.1
21225,Patrik Elias,2013-14,37.0,18,62,81,81,21,41,62,204.0,1510.0,961,335,481,816,2754.0,82,5.46,52,291,2492,9.0
21226,Patrik Elias,2014-15,38.0,19,78,81,81,26,52,78,164.0,1608.0,1042,361,533,894,2918.0,82,5.32,47,271,2439,8.9
21227,Patrik Elias,2015-16,39.0,20,36,48,48,14,22,36,118.0,899.0,1090,375,555,930,3036.0,48,5.31,29,160,1399,9.1
21228,Patrik Elias,2016-17,40.0,21,53,65,65,18,35,53,116.0,1162.0,1155,393,590,983,3152.0,82,5.34,48,269,2463,8.9
21229,Patrik Elias,2017-18,41.0,22,34,69,69,13,21,34,114.0,1217.0,1224,406,611,1017,3266.0,82,5.32,47,251,2453,8.9
21230,Patrik Elias,2018-19,42.0,23,8,16,16,2,6,8,21.0,247.0,1240,408,617,1025,3287.0,82,5.34,48,255,2438,9.0
21231,Patrik Juhlin,1997-98,27.0,4,7,42,42,4,3,7,44.0,,42,4,3,7,44.0,48,5.97,37,209,1408,10.2
21232,Patrik Juhlin,1998-99,28.0,5,6,14,14,3,3,6,14.0,,56,7,6,13,58.0,82,6.29,74,413,2481,10.4
21233,Patrik Laine,2019-20,21.0,4,64,73,73,36,28,64,204.0,1308.0,73,36,28,64,204.0,82,5.45,47,245,2478,9.0
21234,Patrik Laine,2020-21,22.0,5,70,82,82,44,26,70,241.0,1351.0,155,80,54,134,445.0,82,5.86,50,250,2620,9.2
21235,Patrik Laine,2021-22,23.0,6,50,82,82,30,20,50,245.0,1413.0,237,110,74,184,690.0,82,5.96,47,239,2579,9.5
21236,Patrik Laine,2022-23,24.0,7,63,68,68,28,35,63,226.0,1320.0,305,138,109,247,916.0,70,5.96,42,208,2192,9.5
21237,Patrik Nemeth,2016-17,24.0,4,0,8,8,0,0,0,3.0,110.0,8,0,0,0,3.0,82,5.34,48,269,2463,8.9
21238,Patrik Nemeth,2017-18,25.0,5,3,22,22,0,3,3,16.0,357.0,30,0,3,3,19.0,82,5.32,47,251,2453,8.9
21239,Patrik Nemeth,2018-19,26.0,6,8,38,38,0,8,8,36.0,594.0,68,0,11,11,55.0,82,5.34,48,255,2438,9.0
21240,Patrik Nemeth,2019-20,27.0,7,3,40,40,0,3,3,46.0,631.0,108,0,14,14,101.0,82,5.45,47,245,2478,9.0
21241,Patrik Nemeth,2020-21,28.0,8,15,68,68,3,12,15,73.0,1350.0,176,3,26,29,174.0,82,5.86,50,250,2620,9.2
21242,Patrik Nemeth,2021-22,29.0,9,10,74,74,1,9,10,57.0,1220.0,250,4,35,39,231.0,82,5.96,47,239,2579,9.5
21243,Patrik Nemeth,2022-23,30.0,10,9,64,64,1,8,9,89.0,1410.0,314,5,43,48,320.0,70,5.96,42,208,2192,9.5
21244,Patrik Stefan,2002-03,22.0,4,25,72,72,5,20,25,117.0,1067.0,72,5,20,25,117.0,82,5.49,53,331,2294,9.8
21245,Patrik Stefan,2003-04,23.0,5,31,66,66,10,21,31,93.0,932.0,138,15,41,56,210.0,82,5.51,63,376,2272,9.9
21246,Patrik Stefan,2004-05,24.0,6,23,59,59,7,16,23,67.0,942.0,197,22,57,79,277.0,82,5.24,53,338,2262,9.5
21247,Patrik Stefan,2005-06,25.0,7,34,71,71,13,21,34,96.0,1195.0,268,35,78,113,373.0,82,5.31,60,363,2326,9.4
21248,Patrik Stefan,2006-07,26.0,8,40,82,82,14,26,40,110.0,1351.0,350,49,104,153,483.0,82,5.14,57,348,2300,9.2
21249,Patrik Stefan,2008-09,28.0,9,24,64,64,10,14,24,81.0,885.0,414,59,118,177,564.0,82,6.05,85,480,2458,10.1
21250,Patrik Stefan,2009-10,29.0,10,11,41,41,5,6,11,41.0,501.0,455,64,124,188,605.0,82,5.76,70,398,2426,9.7
21251,Patrik Sundstrom,1985-86,24.0,4,46,74,74,23,23,46,156.0,,74,23,23,46,156.0,80,7.73,71,310,2444,12.7
21252,Patrik Sundstrom,1986-87,25.0,5,91,78,78,38,53,91,215.0,,152,61,76,137,371.0,80,7.89,74,336,2448,12.9
21253,Patrik Sundstrom,1987-88,26.0,6,68,71,71,25,43,68,186.0,,223,86,119,205,557.0,80,7.77,71,321,2447,12.7
21254,Patrik Sundstrom,1988-89,27.0,7,66,79,79,18,48,66,154.0,,302,104,167,271,711.0,80,7.94,82,370,2484,12.8
21255,Patrik Sundstrom,1989-90,28.0,8,71,72,72,29,42,71,141.0,,374,133,209,342,852.0,80,7.34,72,344,2400,12.2
21256,Patrik Sundstrom,1990-91,29.0,9,51,78,78,15,36,51,126.0,,452,148,245,393,978.0,80,7.43,89,437,2435,12.2
21257,Patrik Sundstrom,1991-92,30.0,10,69,65,65,28,41,69,156.0,,517,176,286,462,1134.0,80,7.48,85,403,2430,12.3
21258,Patrik Sundstrom,1992-93,31.0,11,76,74,74,27,49,76,142.0,,591,203,335,538,1276.0,80,7.37,76,367,2421,12.2
21259,Patrik Sundstrom,1993-94,32.0,12,46,71,71,15,31,46,96.0,,662,218,366,584,1372.0,80,6.91,71,366,2385,11.6
21260,Patrik Sundstrom,1994-95,33.0,13,4,17,17,1,3,4,16.0,,679,219,369,588,1388.0,80,6.96,77,402,2440,11.4
21261,Paul Baxter,1982-83,27.0,4,20,61,61,7,13,20,90.0,,61,7,13,20,90.0,80,7.03,61,280,2352,12.0
21262,Paul Baxter,1983-84,28.0,5,19,51,51,5,14,19,62.0,,112,12,27,39,152.0,80,7.69,77,340,2441,12.6
21263,Paul Baxter,1984-85,29.0,6,43,76,76,9,34,43,177.0,,188,21,61,82,329.0,80,8.03,73,320,2489,12.9
21264,Paul Baxter,1985-86,30.0,7,32,75,75,11,21,32,157.0,,263,32,82,114,486.0,80,7.73,71,310,2444,12.7
21265,Paul Baxter,1986-87,31.0,8,27,74,74,7,20,27,87.0,,337,39,102,141,573.0,80,7.89,74,336,2448,12.9
21266,Paul Baxter,1987-88,32.0,9,19,70,70,5,14,19,83.0,,407,44,116,160,656.0,80,7.77,71,321,2447,12.7
21267,Paul Baxter,1988-89,33.0,10,7,47,47,4,3,7,41.0,,454,48,119,167,697.0,80,7.94,82,370,2484,12.8
21268,Paul Baxter,1989-90,34.0,11,2,18,18,0,2,2,13.0,,472,48,121,169,710.0,80,7.34,72,344,2400,12.2
21269,Paul Beraldo,1990-91,23.0,4,0,3,3,0,0,0,1.0,,3,0,0,0,1.0,80,7.43,89,437,2435,12.2
21270,Paul Beraldo,1991-92,24.0,5,0,7,7,0,0,0,1.0,,10,0,0,0,2.0,80,7.48,85,403,2430,12.3
21271,Paul Bissonnette,2011-12,26.0,4,1,15,15,0,1,1,4.0,53.0,15,0,1,1,4.0,82,5.7,65,341,2477,9.4
21272,Paul Bissonnette,2012-13,27.0,5,5,41,41,3,2,5,25.0,240.0,56,3,3,6,29.0,82,5.53,56,304,2486,9.1
21273,Paul Bissonnette,2013-14,28.0,6,1,48,48,1,0,1,18.0,252.0,104,4,3,7,47.0,82,5.46,52,291,2492,9.0
21274,Paul Bissonnette,2014-15,29.0,7,1,31,31,1,0,1,15.0,188.0,135,5,3,8,62.0,82,5.32,47,271,2439,8.9
21275,Paul Bissonnette,2015-16,30.0,8,6,28,28,0,6,6,13.0,152.0,163,5,9,14,75.0,48,5.31,29,160,1399,9.1
21276,Paul Bissonnette,2016-17,31.0,9,8,39,39,2,6,8,25.0,185.0,202,7,15,22,100.0,82,5.34,48,269,2463,8.9
21277,Paul Boutilier,1984-85,21.0,4,0,1,1,0,0,0,0.0,,1,0,0,0,0.0,80,8.03,73,320,2489,12.9
21278,Paul Boutilier,1985-86,22.0,5,9,29,29,4,5,9,52.0,,30,4,5,9,52.0,80,7.73,71,310,2444,12.7
21279,Paul Boutilier,1986-87,23.0,6,11,28,28,0,11,11,31.0,,58,4,16,20,83.0,80,7.89,74,336,2448,12.9
21280,Paul Boutilier,1987-88,24.0,7,35,78,78,12,23,35,138.0,,136,16,39,55,221.0,80,7.77,71,321,2447,12.7
21281,Paul Boutilier,1988-89,25.0,8,34,77,77,4,30,34,124.0,,213,20,69,89,345.0,80,7.94,82,370,2484,12.8
21282,Paul Boutilier,1989-90,26.0,9,20,62,62,7,13,20,89.0,,275,27,82,109,434.0,80,7.34,72,344,2400,12.2
21283,Paul Boutilier,1990-91,27.0,10,1,10,10,0,1,1,9.0,,285,27,83,110,443.0,80,7.43,89,437,2435,12.2
21284,Paul Boutilier,1991-92,28.0,11,0,3,3,0,0,0,4.0,,288,27,83,110,447.0,80,7.48,85,403,2430,12.3
21285,Paul Broten,1992-93,27.0,4,8,32,32,5,3,8,43.0,,32,5,3,8,43.0,80,7.37,76,367,2421,12.2
21286,Paul Broten,1993-94,28.0,5,10,28,28,4,6,10,34.0,,60,9,9,18,77.0,80,6.91,71,366,2385,11.6
21287,Paul Broten,1994-95,29.0,6,28,74,74,13,15,28,96.0,,134,22,24,46,173.0,80,6.96,77,402,2440,11.4
21288,Paul Broten,1995-96,30.0,7,14,60,60,5,9,14,57.0,,194,27,33,60,230.0,84,7.25,87,443,2603,11.7
21289,Paul Broten,1996-97,31.0,8,24,64,64,12,12,24,76.0,,258,39,45,84,306.0,84,6.48,76,407,2545,10.7
21290,Paul Broten,1997-98,32.0,9,16,47,47,7,9,16,67.0,,305,46,54,100,373.0,48,5.97,37,209,1408,10.2
21291,Paul Broten,1998-99,33.0,10,1,17,17,0,1,1,11.0,,322,46,55,101,384.0,82,6.29,74,413,2481,10.4
21292,Paul Brousseau,1998-99,25.0,4,2,8,8,1,1,2,10.0,,8,1,1,2,10.0,82,6.29,74,413,2481,10.4
21293,Paul Brousseau,1999-00,26.0,5,0,6,6,0,0,0,3.0,,14,1,1,2,13.0,82,5.83,55,336,2444,9.8
21294,Paul Brousseau,2000-01,27.0,6,2,11,11,0,2,2,6.0,,25,1,3,4,19.0,82,5.28,57,380,2242,9.6
21295,Paul Brousseau,2003-04,30.0,7,0,1,1,0,0,0,0.0,2.0,26,1,3,4,19.0,82,5.51,63,376,2272,9.9
21296,Paul Brydges,1989-90,24.0,4,4,15,15,2,2,4,8.0,,15,2,2,4,8.0,80,7.34,72,344,2400,12.2
21297,Paul Byron,2013-14,24.0,4,2,8,8,1,1,2,5.0,88.0,8,1,1,2,5.0,82,5.46,52,291,2492,9.0
21298,Paul Byron,2014-15,25.0,5,5,22,22,3,2,5,13.0,225.0,30,4,3,7,18.0,82,5.32,47,271,2439,8.9
21299,Paul Byron,2015-16,26.0,6,1,4,4,0,1,1,1.0,42.0,34,4,4,8,19.0,48,5.31,29,160,1399,9.1
21300,Paul Byron,2016-17,27.0,7,21,47,47,7,14,21,46.0,679.0,81,11,18,29,65.0,82,5.34,48,269,2463,8.9
21301,Paul Byron,2017-18,28.0,8,19,57,57,6,13,19,62.0,825.0,138,17,31,48,127.0,82,5.32,47,251,2453,8.9
21302,Paul Byron,2018-19,29.0,9,18,62,62,11,7,18,50.0,853.0,200,28,38,66,177.0,82,5.34,48,255,2438,9.0
21303,Paul Byron,2019-20,30.0,10,43,81,81,22,21,43,96.0,1220.0,281,50,59,109,273.0,82,5.45,47,245,2478,9.0
21304,Paul Byron,2020-21,31.0,11,35,82,82,20,15,35,115.0,1322.0,363,70,74,144,388.0,82,5.86,50,250,2620,9.2
21305,Paul Byron,2021-22,32.0,12,31,56,56,15,16,31,94.0,816.0,419,85,90,175,482.0,82,5.96,47,239,2579,9.5
21306,Paul Byron,2022-23,33.0,13,10,29,29,4,6,10,29.0,415.0,448,89,96,185,511.0,70,5.96,42,208,2192,9.5
21307,Paul Carey,2016-17,28.0,4,0,12,12,0,0,0,6.0,77.0,12,0,0,0,6.0,82,5.34,48,269,2463,8.9
21308,Paul Carey,2017-18,29.0,5,1,10,10,0,1,1,5.0,79.0,22,0,1,1,11.0,82,5.32,47,251,2453,8.9
21309,Paul Carey,2018-19,30.0,6,1,4,4,1,0,1,5.0,40.0,26,1,1,2,16.0,82,5.34,48,255,2438,9.0
21310,Paul Carey,2019-20,31.0,7,0,6,6,0,0,0,8.0,63.0,32,1,1,2,24.0,82,5.45,47,245,2478,9.0
21311,Paul Carey,2020-21,32.0,8,14,60,60,7,7,14,51.0,616.0,92,8,8,16,75.0,82,5.86,50,250,2620,9.2
21312,Paul Carey,2021-22,33.0,9,0,7,7,0,0,0,4.0,75.0,99,8,8,16,79.0,82,5.96,47,239,2579,9.5
21313,Paul Carey,2022-23,34.0,10,0,1,1,0,0,0,0.0,6.0,100,8,8,16,79.0,70,5.96,42,208,2192,9.5
21314,Paul Cavallini,1989-90,24.0,4,2,6,6,0,2,2,6.0,,6,0,2,2,6.0,80,7.34,72,344,2400,12.2
21315,Paul Cavallini,1990-91,25.0,5,16,72,72,6,10,16,71.0,,78,6,12,18,77.0,80,7.43,89,437,2435,12.2
21316,Paul Cavallini,1991-92,26.0,6,24,65,65,4,20,24,93.0,,143,10,32,42,170.0,80,7.48,85,403,2430,12.3
21317,Paul Cavallini,1992-93,27.0,7,47,80,80,8,39,47,135.0,,223,18,71,89,305.0,80,7.37,76,367,2421,12.2
21318,Paul Cavallini,1993-94,28.0,8,35,67,67,10,25,35,116.0,,290,28,96,124,421.0,80,6.91,71,366,2385,11.6
21319,Paul Cavallini,1994-95,29.0,9,35,66,66,10,25,35,164.0,,356,38,121,159,585.0,80,6.96,77,402,2440,11.4
21320,Paul Cavallini,1995-96,30.0,10,18,82,82,6,12,18,99.0,,438,44,133,177,684.0,84,7.25,87,443,2603,11.7
21321,Paul Cavallini,1996-97,31.0,11,44,74,74,11,33,44,145.0,,512,55,166,221,829.0,84,6.48,76,407,2545,10.7
21322,Paul Cavallini,1997-98,32.0,12,12,44,44,1,11,12,69.0,,556,56,177,233,898.0,48,5.97,37,209,1408,10.2
21323,Paul Cavallini,1998-99,33.0,13,0,8,8,0,0,0,5.0,,564,56,177,233,903.0,82,6.29,74,413,2481,10.4
21324,Paul Coffey,1983-84,22.0,4,32,74,74,9,23,32,113.0,,74,9,23,32,113.0,80,7.69,77,340,2441,12.6
21325,Paul Coffey,1984-85,23.0,5,89,80,80,29,60,89,234.0,,154,38,83,121,347.0,80,8.03,73,320,2489,12.9
21326,Paul Coffey,1985-86,24.0,6,96,80,80,29,67,96,260.0,,234,67,150,217,607.0,80,7.73,71,310,2444,12.7
21327,Paul Coffey,1986-87,25.0,7,126,80,80,40,86,126,259.0,,314,107,236,343,866.0,80,7.89,74,336,2448,12.9
21328,Paul Coffey,1987-88,26.0,8,121,80,80,37,84,121,285.0,,394,144,320,464,1151.0,80,7.77,71,321,2447,12.7
21329,Paul Coffey,1988-89,27.0,9,138,79,79,48,90,138,308.0,,473,192,410,602,1459.0,80,7.94,82,370,2484,12.8
21330,Paul Coffey,1989-90,28.0,10,67,59,59,17,50,67,165.0,,532,209,460,669,1624.0,80,7.34,72,344,2400,12.2
21331,Paul Coffey,1990-91,29.0,11,67,46,46,15,52,67,193.0,,578,224,512,736,1817.0,80,7.43,89,437,2435,12.2
21332,Paul Coffey,1991-92,30.0,12,113,75,75,30,83,113,342.0,,653,254,595,849,2159.0,80,7.48,85,403,2430,12.3
21333,Paul Coffey,1992-93,31.0,13,103,80,80,29,74,103,324.0,,733,283,669,952,2483.0,80,7.37,76,367,2421,12.2
21334,Paul Coffey,1993-94,32.0,14,93,76,76,24,69,93,240.0,,809,307,738,1045,2723.0,80,6.91,71,366,2385,11.6
21335,Paul Coffey,1994-95,33.0,15,69,64,64,11,58,69,232.0,,873,318,796,1114,2955.0,80,6.96,77,402,2440,11.4
21336,Paul Coffey,1995-96,34.0,16,87,80,80,12,75,87,254.0,,953,330,871,1201,3209.0,84,7.25,87,443,2603,11.7
21337,Paul Coffey,1996-97,35.0,17,77,80,80,14,63,77,278.0,,1033,344,934,1278,3487.0,84,6.48,76,407,2545,10.7
21338,Paul Coffey,1997-98,36.0,18,58,45,45,14,44,58,181.0,,1078,358,978,1336,3668.0,48,5.97,37,209,1408,10.2
21339,Paul Coffey,1998-99,37.0,19,74,76,76,14,60,74,234.0,,1154,372,1038,1410,3902.0,82,6.29,74,413,2481,10.4
21340,Paul Coffey,1999-00,38.0,20,34,57,57,9,25,34,110.0,,1211,381,1063,1444,4012.0,82,5.83,55,336,2444,9.8
21341,Paul Coffey,2000-01,39.0,21,29,57,57,2,27,29,107.0,,1268,383,1090,1473,4119.0,82,5.28,57,380,2242,9.6
21342,Paul Coffey,2001-02,40.0,22,14,54,54,2,12,14,87.0,1020.0,1322,385,1102,1487,4206.0,82,5.27,57,359,2285,9.4
21343,Paul Coffey,2002-03,41.0,23,40,69,69,11,29,40,155.0,1558.0,1391,396,1131,1527,4361.0,82,5.49,53,331,2294,9.8
21344,Paul Coffey,2003-04,42.0,24,4,18,18,0,4,4,28.0,341.0,1409,396,1135,1531,4389.0,82,5.51,63,376,2272,9.9
21345,Paul Comrie,2002-03,25.0,4,3,15,15,1,2,3,11.0,155.0,15,1,2,3,11.0,82,5.49,53,331,2294,9.8
21346,Paul Cyr,1985-86,22.0,4,27,37,37,15,12,27,66.0,,37,15,12,27,66.0,80,7.73,71,310,2444,12.7
21347,Paul Cyr,1986-87,23.0,5,43,71,71,16,27,43,142.0,,108,31,39,70,208.0,80,7.89,74,336,2448,12.9
21348,Paul Cyr,1987-88,24.0,6,46,71,71,22,24,46,170.0,,179,53,63,116,378.0,80,7.77,71,321,2447,12.7
21349,Paul Cyr,1988-89,25.0,7,51,71,71,20,31,51,151.0,,250,73,94,167,529.0,80,7.94,82,370,2484,12.8
21350,Paul Cyr,1989-90,26.0,8,27,73,73,11,16,27,131.0,,323,84,110,194,660.0,80,7.34,72,344,2400,12.2
21351,Paul Cyr,1990-91,27.0,9,19,60,60,5,14,19,92.0,,383,89,124,213,752.0,80,7.43,89,437,2435,12.2
21352,Paul Cyr,1991-92,28.0,10,0,1,1,0,0,0,0.0,,384,89,124,213,752.0,80,7.48,85,403,2430,12.3
21353,Paul Cyr,1993-94,30.0,11,25,70,70,12,13,25,128.0,,454,101,137,238,880.0,80,6.91,71,366,2385,11.6
21354,Paul Cyr,1994-95,31.0,12,3,17,17,0,3,3,20.0,,471,101,140,241,900.0,80,6.96,77,402,2440,11.4
21355,Paul DiPietro,1994-95,24.0,4,10,33,33,4,6,10,27.0,,33,4,6,10,27.0,80,6.96,77,402,2440,11.4
21356,Paul DiPietro,1995-96,25.0,5,17,29,29,4,13,17,43.0,,62,8,19,27,70.0,84,7.25,87,443,2603,11.7
21357,Paul DiPietro,1996-97,26.0,6,33,70,70,13,20,33,115.0,,132,21,39,60,185.0,84,6.48,76,407,2545,10.7
21358,Paul DiPietro,1997-98,27.0,7,11,34,34,5,6,11,60.0,,166,26,45,71,245.0,48,5.97,37,209,1408,10.2
21359,Paul DiPietro,1998-99,28.0,8,8,20,20,4,4,8,23.0,,186,30,49,79,268.0,82,6.29,74,413,2481,10.4
21360,Paul DiPietro,1999-00,29.0,9,1,6,6,1,0,1,10.0,,192,31,49,80,278.0,82,5.83,55,336,2444,9.8
21361,Paul Fenton,1987-88,28.0,4,12,33,33,7,5,12,53.0,,33,7,5,12,53.0,80,7.77,71,321,2447,12.7
21362,Paul Fenton,1988-89,29.0,5,0,1,1,0,0,0,3.0,,34,7,5,12,56.0,80,7.94,82,370,2484,12.8
21363,Paul Fenton,1989-90,30.0,6,0,8,8,0,0,0,11.0,,42,7,5,12,67.0,80,7.34,72,344,2400,12.2
21364,Paul Fenton,1990-91,31.0,7,43,71,71,20,23,43,166.0,,113,27,28,55,233.0,80,7.43,89,437,2435,12.2
21365,Paul Fenton,1991-92,32.0,8,28,80,80,16,12,28,135.0,,193,43,40,83,368.0,80,7.48,85,403,2430,12.3
21366,Paul Fenton,1992-93,33.0,9,50,80,80,32,18,50,152.0,,273,75,58,133,520.0,80,7.37,76,367,2421,12.2
21367,Paul Fenton,1993-94,34.0,10,35,78,78,14,21,35,133.0,,351,89,79,168,653.0,80,6.91,71,366,2385,11.6
21368,Paul Fenton,1994-95,35.0,11,15,60,60,11,4,15,96.0,,411,100,83,183,749.0,80,6.96,77,402,2440,11.4
21369,Paul Gagne,1983-84,21.0,4,41,61,61,25,16,41,99.0,,61,25,16,41,99.0,80,7.69,77,340,2441,12.6
21370,Paul Gagne,1984-85,22.0,5,22,59,59,10,12,22,104.0,,120,35,28,63,203.0,80,8.03,73,320,2489,12.9
21371,Paul Gagne,1985-86,23.0,6,29,53,53,14,15,29,76.0,,173,49,43,92,279.0,80,7.73,71,310,2444,12.7
21372,Paul Gagne,1986-87,24.0,7,32,66,66,14,18,32,109.0,,239,63,61,124,388.0,80,7.89,74,336,2448,12.9
21373,Paul Gagne,1987-88,25.0,8,43,79,79,24,19,43,155.0,,318,87,80,167,543.0,80,7.77,71,321,2447,12.7
21374,Paul Gagne,1988-89,26.0,9,38,47,47,19,19,38,91.0,,365,106,99,205,634.0,80,7.94,82,370,2484,12.8
21375,Paul Gagne,1991-92,29.0,10,5,16,16,3,2,5,14.0,,381,109,101,210,648.0,80,7.48,85,403,2430,12.3
21376,Paul Gagne,1992-93,30.0,11,1,9,9,1,0,1,10.0,,390,110,101,211,658.0,80,7.37,76,367,2421,12.2
21377,Paul Gaustad,2005-06,23.0,4,0,1,1,0,0,0,0.0,6.0,1,0,0,0,0.0,82,5.31,60,363,2326,9.4
21378,Paul Gaustad,2008-09,26.0,5,24,78,78,9,15,24,113.0,946.0,79,9,15,24,113.0,82,6.05,85,480,2458,10.1
21379,Paul Gaustad,2009-10,27.0,6,22,54,54,9,13,22,75.0,719.0,133,18,28,46,188.0,82,5.76,70,398,2426,9.7
21380,Paul Gaustad,2010-11,28.0,7,36,82,82,10,26,36,136.0,1407.0,215,28,54,82,324.0,82,5.44,62,351,2383,9.4
21381,Paul Gaustad,2011-12,29.0,8,29,62,62,12,17,29,122.0,999.0,277,40,71,111,446.0,82,5.7,65,341,2477,9.4
21382,Paul Gaustad,2012-13,30.0,9,22,65,65,12,10,22,111.0,1023.0,342,52,81,133,557.0,82,5.53,56,304,2486,9.1
21383,Paul Gaustad,2013-14,31.0,10,31,81,81,12,19,31,117.0,1226.0,423,64,100,164,674.0,82,5.46,52,291,2492,9.0
21384,Paul Gaustad,2014-15,32.0,11,21,70,70,7,14,21,75.0,1034.0,493,71,114,185,749.0,82,5.32,47,271,2439,8.9
21385,Paul Gaustad,2015-16,33.0,12,5,23,23,2,3,5,35.0,350.0,516,73,117,190,784.0,48,5.31,29,160,1399,9.1
21386,Paul Gaustad,2016-17,34.0,13,21,75,75,10,11,21,74.0,1036.0,591,83,128,211,858.0,82,5.34,48,269,2463,8.9
21387,Paul Gaustad,2017-18,35.0,14,14,73,73,4,10,14,54.0,908.0,664,87,138,225,912.0,82,5.32,47,251,2453,8.9
21388,Paul Gaustad,2018-19,36.0,15,6,63,63,2,4,6,46.0,708.0,727,89,142,231,958.0,82,5.34,48,255,2438,9.0
21389,Paul Gillis,1985-86,22.0,4,2,7,7,0,2,2,1.0,,7,0,2,2,1.0,80,7.73,71,310,2444,12.7
21390,Paul Gillis,1986-87,23.0,5,17,57,57,8,9,17,60.0,,64,8,11,19,61.0,80,7.89,74,336,2448,12.9
21391,Paul Gillis,1987-88,24.0,6,42,77,77,14,28,42,104.0,,141,22,39,61,165.0,80,7.77,71,321,2447,12.7
21392,Paul Gillis,1988-89,25.0,7,43,80,80,19,24,43,136.0,,221,41,63,104,301.0,80,7.94,82,370,2484,12.8
21393,Paul Gillis,1989-90,26.0,8,39,76,76,13,26,39,118.0,,297,54,89,143,419.0,80,7.34,72,344,2400,12.2
21394,Paul Gillis,1990-91,27.0,9,17,80,80,7,10,17,82.0,,377,61,99,160,501.0,80,7.43,89,437,2435,12.2
21395,Paul Gillis,1991-92,28.0,10,40,79,79,15,25,40,97.0,,456,76,124,200,598.0,80,7.48,85,403,2430,12.3
21396,Paul Gillis,1992-93,29.0,11,22,71,71,8,14,22,68.0,,527,84,138,222,666.0,80,7.37,76,367,2421,12.2
21397,Paul Gillis,1993-94,30.0,12,16,62,62,3,13,16,66.0,,589,87,151,238,732.0,80,6.91,71,366,2385,11.6
21398,Paul Gillis,1994-95,31.0,13,2,14,14,0,2,2,7.0,,603,87,153,240,739.0,80,6.96,77,402,2440,11.4
21399,Paul Gillis,1995-96,32.0,14,2,21,21,1,1,2,8.0,,624,88,154,242,747.0,84,7.25,87,443,2603,11.7
21400,Paul Guay,1986-87,23.0,4,8,14,14,2,6,8,20.0,,14,2,6,8,20.0,80,7.89,74,336,2448,12.9
21401,Paul Guay,1987-88,24.0,5,1,2,2,0,1,1,2.0,,16,2,7,9,22.0,80,7.77,71,321,2447,12.7
21402,Paul Guay,1988-89,25.0,6,6,23,23,3,3,6,18.0,,39,5,10,15,40.0,80,7.94,82,370,2484,12.8
21403,Paul Guay,1989-90,26.0,7,7,35,35,2,5,7,18.0,,74,7,15,22,58.0,80,7.34,72,344,2400,12.2
21404,Paul Guay,1990-91,27.0,8,8,33,33,4,4,8,42.0,,107,11,19,30,100.0,80,7.43,89,437,2435,12.2
21405,Paul Guay,1991-92,28.0,9,2,7,7,0,2,2,3.0,,114,11,21,32,103.0,80,7.48,85,403,2430,12.3
21406,Paul Guay,1993-94,30.0,10,2,3,3,0,2,2,5.0,,117,11,23,34,108.0,80,6.91,71,366,2385,11.6
21407,Paul Healey,1999-00,24.0,4,0,2,2,0,0,0,0.0,,2,0,0,0,0.0,82,5.83,55,336,2444,9.8
21408,Paul Healey,2000-01,25.0,5,0,4,4,0,0,0,0.0,,6,0,0,0,0.0,82,5.28,57,380,2242,9.6
21409,Paul Healey,2004-05,29.0,6,10,21,21,3,7,10,29.0,232.0,27,3,7,10,29.0,82,5.24,53,338,2262,9.5
21410,Paul Healey,2005-06,30.0,7,10,44,44,3,7,10,43.0,528.0,71,6,14,20,72.0,82,5.31,60,363,2326,9.4
21411,Paul Healey,2006-07,31.0,8,0,4,4,0,0,0,0.0,19.0,75,6,14,20,72.0,82,5.14,57,348,2300,9.2
21412,Paul Healey,2008-09,33.0,9,0,2,2,0,0,0,0.0,11.0,77,6,14,20,72.0,82,6.05,85,480,2458,10.1
21413,Paul Higgins,1984-85,23.0,4,0,3,3,0,0,0,0.0,,3,0,0,0,0.0,80,8.03,73,320,2489,12.9
21414,Paul Higgins,1985-86,24.0,5,0,23,23,0,0,0,2.0,,26,0,0,0,2.0,80,7.73,71,310,2444,12.7
21415,Paul Houck,1988-89,25.0,4,1,3,3,1,0,1,3.0,,3,1,0,1,3.0,80,7.94,82,370,2484,12.8
21416,Paul Houck,1989-90,26.0,5,2,12,12,0,2,2,10.0,,15,1,2,3,13.0,80,7.34,72,344,2400,12.2
21417,Paul Houck,1990-91,27.0,6,0,1,1,0,0,0,1.0,,16,1,2,3,14.0,80,7.43,89,437,2435,12.2
21418,Paul Jerrard,1991-92,26.0,4,0,5,5,0,0,0,8.0,,5,0,0,0,8.0,80,7.48,85,403,2430,12.3
21419,Paul Kariya,1997-98,23.0,4,39,47,47,18,21,39,134.0,,47,18,21,39,134.0,48,5.97,37,209,1408,10.2
21420,Paul Kariya,1998-99,24.0,5,108,82,82,50,58,108,349.0,,129,68,79,147,483.0,82,6.29,74,413,2481,10.4
21421,Paul Kariya,1999-00,25.0,6,99,69,69,44,55,99,340.0,,198,112,134,246,823.0,82,5.83,55,336,2444,9.8
21422,Paul Kariya,2000-01,26.0,7,31,22,22,17,14,31,103.0,,220,129,148,277,926.0,82,5.28,57,380,2242,9.6
21423,Paul Kariya,2001-02,27.0,8,101,82,82,39,62,101,429.0,2094.0,302,168,210,378,1355.0,82,5.27,57,359,2285,9.4
21424,Paul Kariya,2002-03,28.0,9,86,74,74,42,44,86,324.0,1803.0,376,210,254,464,1679.0,82,5.49,53,331,2294,9.8
21425,Paul Kariya,2003-04,29.0,10,67,66,66,33,34,67,230.0,1520.0,442,243,288,531,1909.0,82,5.51,63,376,2272,9.9
21426,Paul Kariya,2004-05,30.0,11,57,82,82,32,25,57,289.0,1822.0,524,275,313,588,2198.0,82,5.24,53,338,2262,9.5
21427,Paul Kariya,2005-06,31.0,12,81,82,82,25,56,81,257.0,1664.0,606,300,369,669,2455.0,82,5.31,60,363,2326,9.4
21428,Paul Kariya,2006-07,32.0,13,36,51,51,11,25,36,110.0,950.0,657,311,394,705,2565.0,82,5.14,57,348,2300,9.2
21429,Paul Kariya,2008-09,34.0,14,85,82,82,31,54,85,245.0,1565.0,739,342,448,790,2810.0,82,6.05,85,480,2458,10.1
21430,Paul Kariya,2009-10,35.0,15,76,82,82,24,52,76,224.0,1671.0,821,366,500,866,3034.0,82,5.76,70,398,2426,9.7
21431,Paul Kariya,2010-11,36.0,16,65,82,82,16,49,65,223.0,1536.0,903,382,549,931,3257.0,82,5.44,62,351,2383,9.4
21432,Paul Kariya,2011-12,37.0,17,15,11,11,2,13,15,31.0,199.0,914,384,562,946,3288.0,82,5.7,65,341,2477,9.4
21433,Paul Kariya,2012-13,38.0,18,43,75,75,18,25,43,221.0,1287.0,989,402,587,989,3509.0,82,5.53,56,304,2486,9.1
21434,Paul Kruse,1993-94,23.0,4,0,1,1,0,0,0,0.0,,1,0,0,0,0.0,80,6.91,71,366,2385,11.6
21435,Paul Kruse,1994-95,24.0,5,4,16,16,3,1,4,12.0,,17,3,1,4,12.0,80,6.96,77,402,2440,11.4
21436,Paul Kruse,1995-96,25.0,6,5,27,27,2,3,5,17.0,,44,5,4,9,29.0,84,7.25,87,443,2603,11.7
21437,Paul Kruse,1996-97,26.0,7,11,68,68,3,8,11,52.0,,112,8,12,20,81.0,84,6.48,76,407,2545,10.7
21438,Paul Kruse,1997-98,27.0,8,16,45,45,11,5,16,52.0,,157,19,17,36,133.0,48,5.97,37,209,1408,10.2
21439,Paul Kruse,1998-99,28.0,9,15,75,75,3,12,15,83.0,,232,22,29,51,216.0,82,6.29,74,413,2481,10.4
21440,Paul Kruse,1999-00,29.0,10,8,62,62,6,2,8,49.0,,294,28,31,59,265.0,82,5.83,55,336,2444,9.8
21441,Paul Kruse,2000-01,30.0,11,9,74,74,7,2,9,52.0,,368,35,33,68,317.0,82,5.28,57,380,2242,9.6
21442,Paul Kruse,2001-02,31.0,12,3,43,43,3,0,3,33.0,275.0,411,38,33,71,350.0,82,5.27,57,359,2285,9.4
21443,Paul Kruse,2002-03,32.0,13,0,11,11,0,0,0,7.0,69.0,422,38,33,71,357.0,82,5.49,53,331,2294,9.8
21444,Paul Kruse,2003-04,33.0,14,0,1,1,0,0,0,0.0,4.0,423,38,33,71,357.0,82,5.51,63,376,2272,9.9
21445,Paul Ladue,2019-20,27.0,4,8,22,22,0,8,8,27.0,339.0,22,0,8,8,27.0,82,5.45,47,245,2478,9.0
21446,Paul Ladue,2020-21,28.0,5,4,12,12,3,1,4,13.0,168.0,34,3,9,12,40.0,82,5.86,50,250,2620,9.2
21447,Paul Ladue,2021-22,29.0,6,5,33,33,2,3,5,33.0,436.0,67,5,12,17,73.0,82,5.96,47,239,2579,9.5
21448,Paul Ladue,2022-23,30.0,7,1,2,2,0,1,1,2.0,26.0,69,5,13,18,75.0,70,5.96,42,208,2192,9.5
21449,Paul Laus,1996-97,26.0,4,2,39,39,2,0,2,15.0,,39,2,0,2,15.0,84,6.48,76,407,2545,10.7
21450,Paul Laus,1997-98,27.0,5,7,37,37,0,7,7,18.0,,76,2,7,9,33.0,48,5.97,37,209,1408,10.2
21451,Paul Laus,1998-99,28.0,6,9,78,78,3,6,9,45.0,,154,5,13,18,78.0,82,6.29,74,413,2481,10.4
21452,Paul Laus,1999-00,29.0,7,12,77,77,0,12,12,63.0,,231,5,25,30,141.0,82,5.83,55,336,2444,9.8
21453,Paul Laus,2000-01,30.0,8,11,77,77,0,11,11,64.0,,308,5,36,41,205.0,82,5.28,57,380,2242,9.6
21454,Paul Laus,2001-02,31.0,9,10,75,75,1,9,10,54.0,836.0,383,6,45,51,259.0,82,5.27,57,359,2285,9.4
21455,Paul Laus,2002-03,32.0,10,11,77,77,3,8,11,44.0,586.0,460,9,53,62,303.0,82,5.49,53,331,2294,9.8
21456,Paul Laus,2003-04,33.0,11,3,25,25,1,2,3,18.0,359.0,485,10,55,65,321.0,82,5.51,63,376,2272,9.9
21457,Paul Laus,2004-05,34.0,12,7,45,45,4,3,7,39.0,638.0,530,14,58,72,360.0,82,5.24,53,338,2262,9.5
21458,Paul Lawless,1985-86,21.0,4,15,47,47,6,9,15,85.0,,47,6,9,15,85.0,80,7.73,71,310,2444,12.7
21459,Paul Lawless,1986-87,22.0,5,3,6,6,0,3,3,7.0,,53,6,12,18,92.0,80,7.89,74,336,2448,12.9
21460,Paul Lawless,1988-89,24.0,6,38,64,64,17,21,38,140.0,,117,23,33,56,232.0,80,7.94,82,370,2484,12.8
21461,Paul Lawless,1989-90,25.0,7,54,60,60,22,32,54,161.0,,177,45,65,110,393.0,80,7.34,72,344,2400,12.2
21462,Paul Lawless,1990-91,26.0,8,15,49,49,4,11,15,96.0,,226,49,76,125,489.0,80,7.43,89,437,2435,12.2
21463,Paul Lawless,1991-92,27.0,9,0,7,7,0,0,0,11.0,,233,49,76,125,500.0,80,7.48,85,403,2430,12.3
21464,Paul Lawless,1992-93,28.0,10,1,6,6,0,1,1,6.0,,239,49,77,126,506.0,80,7.37,76,367,2421,12.2
21465,Paul MacDermid,1984-85,21.0,4,1,3,3,1,0,1,4.0,,3,1,0,1,4.0,80,8.03,73,320,2489,12.9
21466,Paul MacDermid,1985-86,22.0,5,0,7,7,0,0,0,7.0,,10,1,0,1,11.0,80,7.73,71,310,2444,12.7
21467,Paul MacDermid,1986-87,23.0,6,1,3,3,0,1,1,2.0,,13,1,1,2,13.0,80,7.89,74,336,2448,12.9
21468,Paul MacDermid,1987-88,24.0,7,11,31,31,4,7,11,27.0,,44,5,8,13,40.0,80,7.77,71,321,2447,12.7
21469,Paul MacDermid,1988-89,25.0,8,23,74,74,13,10,23,88.0,,118,18,18,36,128.0,80,7.94,82,370,2484,12.8
21470,Paul MacDermid,1989-90,26.0,9,18,72,72,7,11,18,73.0,,190,25,29,54,201.0,80,7.34,72,344,2400,12.2
21471,Paul MacDermid,1990-91,27.0,10,35,80,80,20,15,35,96.0,,270,45,44,89,297.0,80,7.43,89,437,2435,12.2
21472,Paul MacDermid,1991-92,28.0,11,44,74,74,17,27,44,113.0,,344,62,71,133,410.0,80,7.48,85,403,2430,12.3
21473,Paul MacDermid,1992-93,29.0,12,35,73,73,13,22,35,85.0,,417,75,93,168,495.0,80,7.37,76,367,2421,12.2
21474,Paul MacDermid,1993-94,30.0,13,36,69,69,15,21,36,94.0,,486,90,114,204,589.0,80,6.91,71,366,2385,11.6
21475,Paul MacDermid,1994-95,31.0,14,28,74,74,12,16,28,92.0,,560,102,130,232,681.0,80,6.96,77,402,2440,11.4
21476,Paul MacDermid,1995-96,32.0,15,17,72,72,9,8,17,45.0,,632,111,138,249,726.0,84,7.25,87,443,2603,11.7
21477,Paul MacDermid,1996-97,33.0,16,5,44,44,2,3,5,16.0,,676,113,141,254,742.0,84,6.48,76,407,2545,10.7
21478,Paul MacDermid,1997-98,34.0,17,4,14,14,3,1,4,13.0,,690,116,142,258,755.0,48,5.97,37,209,1408,10.2
21479,Paul MacKinnon,1982-83,24.0,4,12,63,63,1,11,12,68.0,,63,1,11,12,68.0,80,7.03,61,280,2352,12.0
21480,Paul MacKinnon,1983-84,25.0,5,0,14,14,0,0,0,7.0,,77,1,11,12,75.0,80,7.69,77,340,2441,12.6
21481,Paul MacKinnon,1984-85,26.0,6,11,39,39,2,9,11,28.0,,116,3,20,23,103.0,80,8.03,73,320,2489,12.9
21482,Paul MacKinnon,1985-86,27.0,7,4,19,19,2,2,4,10.0,,135,5,22,27,113.0,80,7.73,71,310,2444,12.7
21483,Paul MacKinnon,1986-87,28.0,8,1,12,12,0,1,1,3.0,,147,5,23,28,116.0,80,7.89,74,336,2448,12.9
21484,Paul MacLean,1983-84,25.0,4,0,1,1,0,0,0,1.0,,1,0,0,0,1.0,80,7.69,77,340,2441,12.6
21485,Paul MacLean,1984-85,26.0,5,61,74,74,36,25,61,164.0,,75,36,25,61,165.0,80,8.03,73,320,2489,12.9
21486,Paul MacLean,1985-86,27.0,6,76,80,80,32,44,76,164.0,,155,68,69,137,329.0,80,7.73,71,310,2444,12.7
21487,Paul MacLean,1986-87,28.0,7,71,76,76,40,31,71,158.0,,231,108,100,208,487.0,80,7.89,74,336,2448,12.9
21488,Paul MacLean,1987-88,29.0,8,101,79,79,41,60,101,185.0,,310,149,160,309,672.0,80,7.77,71,321,2447,12.7
21489,Paul MacLean,1988-89,30.0,9,56,69,69,27,29,56,169.0,,379,176,189,365,841.0,80,7.94,82,370,2484,12.8
21490,Paul MacLean,1989-90,31.0,10,74,72,72,32,42,74,155.0,,451,208,231,439,996.0,80,7.34,72,344,2400,12.2
21491,Paul MacLean,1990-91,32.0,11,79,77,77,40,39,79,176.0,,528,248,270,518,1172.0,80,7.43,89,437,2435,12.2
21492,Paul MacLean,1991-92,33.0,12,71,76,76,36,35,71,148.0,,604,284,305,589,1320.0,80,7.48,85,403,2430,12.3
21493,Paul MacLean,1992-93,34.0,13,67,78,78,34,33,67,141.0,,682,318,338,656,1461.0,80,7.37,76,367,2421,12.2
21494,Paul MacLean,1993-94,35.0,14,17,37,37,6,11,17,53.0,,719,324,349,673,1514.0,80,6.91,71,366,2385,11.6
21495,Paul Manning,2005-06,26.0,4,0,8,8,0,0,0,4.0,104.0,8,0,0,0,4.0,82,5.31,60,363,2326,9.4
21496,Paul Mara,2001-02,22.0,4,2,1,1,1,1,2,1.0,20.0,1,1,1,2,1.0,82,5.27,57,359,2285,9.4
21497,Paul Mara,2002-03,23.0,5,18,54,54,7,11,18,78.0,1200.0,55,8,12,20,79.0,82,5.49,53,331,2294,9.8
21498,Paul Mara,2003-04,24.0,6,20,62,62,6,14,20,78.0,1373.0,117,14,26,40,157.0,82,5.51,63,376,2272,9.9
21499,Paul Mara,2004-05,25.0,7,24,75,75,7,17,24,112.0,1618.0,192,21,43,64,269.0,82,5.24,53,338,2262,9.5
21500,Paul Mara,2005-06,26.0,8,25,73,73,10,15,25,95.0,1541.0,265,31,58,89,364.0,82,5.31,60,363,2326,9.4
21501,Paul Mara,2006-07,27.0,9,42,81,81,6,36,42,140.0,1913.0,346,37,94,131,504.0,82,5.14,57,348,2300,9.2
21502,Paul Mara,2008-09,29.0,10,47,78,78,15,32,47,157.0,1676.0,424,52,126,178,661.0,82,6.05,85,480,2458,10.1
21503,Paul Mara,2009-10,30.0,11,23,78,78,5,18,23,100.0,1726.0,502,57,144,201,761.0,82,5.76,70,398,2426,9.7
21504,Paul Mara,2010-11,31.0,12,17,61,61,1,16,17,80.0,1091.0,563,58,160,218,841.0,82,5.44,62,351,2383,9.4
21505,Paul Mara,2011-12,32.0,13,21,76,76,5,16,21,102.0,1441.0,639,63,176,239,943.0,82,5.7,65,341,2477,9.4
21506,Paul Mara,2012-13,33.0,14,8,42,42,0,8,8,30.0,787.0,681,63,184,247,973.0,82,5.53,56,304,2486,9.1
21507,Paul Mara,2013-14,34.0,15,6,53,53,1,5,6,50.0,969.0,734,64,189,253,1023.0,82,5.46,52,291,2492,9.0
21508,Paul Marshall,1982-83,22.0,4,21,46,46,9,12,21,68.0,,46,9,12,21,68.0,80,7.03,61,280,2352,12.0
21509,Paul Marshall,1983-84,23.0,5,5,26,26,3,2,5,16.0,,72,12,14,26,84.0,80,7.69,77,340,2441,12.6
21510,Paul Marshall,1984-85,24.0,6,4,10,10,2,2,4,14.0,,82,14,16,30,98.0,80,8.03,73,320,2489,12.9
21511,Paul Marshall,1985-86,25.0,7,3,13,13,1,2,3,10.0,,95,15,18,33,108.0,80,7.73,71,310,2444,12.7
21512,Paul Martin,2006-07,25.0,4,24,70,70,6,18,24,82.0,1409.0,70,6,18,24,82.0,82,5.14,57,348,2300,9.2
21513,Paul Martin,2008-09,27.0,5,37,80,80,5,32,37,97.0,1889.0,150,11,50,61,179.0,82,6.05,85,480,2458,10.1
21514,Paul Martin,2009-10,28.0,6,26,82,82,3,23,26,84.0,2068.0,232,14,73,87,263.0,82,5.76,70,398,2426,9.7
21515,Paul Martin,2010-11,29.0,7,32,73,73,5,27,32,93.0,1743.0,305,19,100,119,356.0,82,5.44,62,351,2383,9.4
21516,Paul Martin,2011-12,30.0,8,33,73,73,5,28,33,107.0,1779.0,378,24,128,152,463.0,82,5.7,65,341,2477,9.4
21517,Paul Martin,2012-13,31.0,9,11,22,22,2,9,11,21.0,495.0,400,26,137,163,484.0,82,5.53,56,304,2486,9.1
21518,Paul Martin,2013-14,32.0,10,24,77,77,3,21,24,104.0,1799.0,477,29,158,187,588.0,82,5.46,52,291,2492,9.0
21519,Paul Martin,2014-15,33.0,11,27,73,73,2,25,27,93.0,1679.0,550,31,183,214,681.0,82,5.32,47,271,2439,8.9
21520,Paul Martin,2015-16,34.0,12,23,34,34,6,17,23,38.0,861.0,584,37,200,237,719.0,48,5.31,29,160,1399,9.1
21521,Paul Martin,2016-17,35.0,13,15,39,39,3,12,15,54.0,958.0,623,40,212,252,773.0,82,5.34,48,269,2463,8.9
21522,Paul Martin,2017-18,36.0,14,20,74,74,3,17,20,61.0,1687.0,697,43,229,272,834.0,82,5.32,47,251,2453,8.9
21523,Paul Martin,2018-19,37.0,15,20,78,78,3,17,20,49.0,1617.0,775,46,246,292,883.0,82,5.34,48,255,2438,9.0
21524,Paul Martin,2019-20,38.0,16,26,81,81,4,22,26,57.0,1557.0,856,50,268,318,940.0,82,5.45,47,245,2478,9.0
21525,Paul Martin,2020-21,39.0,17,2,14,14,0,2,2,6.0,207.0,870,50,270,320,946.0,82,5.86,50,250,2620,9.2
21526,Paul Miller,1984-85,25.0,4,3,3,3,0,3,3,0.0,,3,0,3,3,0.0,80,8.03,73,320,2489,12.9
21527,Paul Pooley,1987-88,27.0,4,2,12,12,0,2,2,1.0,,12,0,2,2,1.0,80,7.77,71,321,2447,12.7
21528,Paul Pooley,1988-89,28.0,5,1,3,3,0,1,1,2.0,,15,0,3,3,3.0,80,7.94,82,370,2484,12.8
21529,Paul Postma,2013-14,24.0,4,0,1,1,0,0,0,1.0,10.0,1,0,0,0,1.0,82,5.46,52,291,2492,9.0
21530,Paul Postma,2014-15,25.0,5,0,3,3,0,0,0,3.0,26.0,4,0,0,0,4.0,82,5.32,47,271,2439,8.9
21531,Paul Postma,2015-16,26.0,6,9,34,34,4,5,9,32.0,511.0,38,4,5,9,36.0,48,5.31,29,160,1399,9.1
21532,Paul Postma,2016-17,27.0,7,3,20,20,1,2,3,19.0,323.0,58,5,7,12,55.0,82,5.34,48,269,2463,8.9
21533,Paul Postma,2017-18,28.0,8,6,42,42,2,4,6,40.0,593.0,100,7,11,18,95.0,82,5.32,47,251,2453,8.9
21534,Paul Postma,2018-19,29.0,9,2,26,26,2,0,2,24.0,298.0,126,9,11,20,119.0,82,5.34,48,255,2438,9.0
21535,Paul Postma,2019-20,30.0,10,14,65,65,1,13,14,50.0,706.0,191,10,24,34,169.0,82,5.45,47,245,2478,9.0
21536,Paul Postma,2020-21,31.0,11,1,14,14,0,1,1,14.0,143.0,205,10,25,35,183.0,82,5.86,50,250,2620,9.2
21537,Paul Ranger,2008-09,24.0,4,18,76,76,1,17,18,73.0,1301.0,76,1,17,18,73.0,82,6.05,85,480,2458,10.1
21538,Paul Ranger,2009-10,25.0,5,28,72,72,4,24,28,90.0,1463.0,148,5,41,46,163.0,82,5.76,70,398,2426,9.7
21539,Paul Ranger,2010-11,26.0,6,31,72,72,10,21,31,105.0,1816.0,220,15,62,77,268.0,82,5.44,62,351,2383,9.4
21540,Paul Ranger,2011-12,27.0,7,13,42,42,2,11,13,69.0,1029.0,262,17,73,90,337.0,82,5.7,65,341,2477,9.4
21541,Paul Ranger,2012-13,28.0,8,2,8,8,1,1,2,11.0,163.0,270,18,74,92,348.0,82,5.53,56,304,2486,9.1
21542,Paul Ranger,2016-17,32.0,9,14,53,53,6,8,14,59.0,923.0,323,24,82,106,407.0,82,5.34,48,269,2463,8.9
21543,Paul Ranheim,1991-92,26.0,4,0,5,5,0,0,0,4.0,,5,0,0,0,4.0,80,7.48,85,403,2430,12.3
21544,Paul Ranheim,1992-93,27.0,5,54,80,80,26,28,54,197.0,,85,26,28,54,201.0,80,7.37,76,367,2421,12.2
21545,Paul Ranheim,1993-94,28.0,6,30,39,39,14,16,30,108.0,,124,40,44,84,309.0,80,6.91,71,366,2385,11.6
21546,Paul Ranheim,1994-95,29.0,7,43,80,80,23,20,43,159.0,,204,63,64,127,468.0,80,6.96,77,402,2440,11.4
21547,Paul Ranheim,1995-96,30.0,8,43,83,83,21,22,43,179.0,,287,84,86,170,647.0,84,7.25,87,443,2603,11.7
21548,Paul Ranheim,1996-97,31.0,9,27,82,82,10,17,27,131.0,,369,94,103,197,778.0,84,6.48,76,407,2545,10.7
21549,Paul Ranheim,1997-98,32.0,10,20,47,47,6,14,20,73.0,,416,100,117,217,851.0,48,5.97,37,209,1408,10.2
21550,Paul Ranheim,1998-99,33.0,11,30,73,73,10,20,30,126.0,,489,110,137,247,977.0,82,6.29,74,413,2481,10.4
21551,Paul Ranheim,1999-00,34.0,12,21,67,67,10,11,21,96.0,,556,120,148,268,1073.0,82,5.83,55,336,2444,9.8
21552,Paul Ranheim,2000-01,35.0,13,14,73,73,5,9,14,77.0,,629,125,157,282,1150.0,82,5.28,57,380,2242,9.6
21553,Paul Ranheim,2001-02,36.0,14,19,78,78,9,10,19,67.0,705.0,707,134,167,301,1217.0,82,5.27,57,359,2285,9.4
21554,Paul Ranheim,2002-03,37.0,15,22,79,79,9,13,22,98.0,894.0,786,143,180,323,1315.0,82,5.49,53,331,2294,9.8
21555,Paul Ranheim,2003-04,38.0,16,17,80,80,10,7,17,123.0,1036.0,866,153,187,340,1438.0,82,5.51,63,376,2272,9.9
21556,Paul Ranheim,2004-05,39.0,17,9,79,79,5,4,9,75.0,731.0,945,158,191,349,1513.0,82,5.24,53,338,2262,9.5
21557,Paul Ranheim,2005-06,40.0,18,11,68,68,3,8,11,71.0,813.0,1013,161,199,360,1584.0,82,5.31,60,363,2326,9.4
21558,Paul Reinhart,1982-83,23.0,4,47,79,79,9,38,47,130.0,,79,9,38,47,130.0,80,7.03,61,280,2352,12.0
21559,Paul Reinhart,1983-84,24.0,5,67,74,74,18,49,67,122.0,,153,27,87,114,252.0,80,7.69,77,340,2441,12.6
21560,Paul Reinhart,1984-85,25.0,6,61,62,62,13,48,61,116.0,,215,40,135,175,368.0,80,8.03,73,320,2489,12.9
21561,Paul Reinhart,1985-86,26.0,7,75,78,78,17,58,75,153.0,,293,57,193,250,521.0,80,7.73,71,310,2444,12.7
21562,Paul Reinhart,1986-87,27.0,8,21,27,27,6,15,21,92.0,,320,63,208,271,613.0,80,7.89,74,336,2448,12.9
21563,Paul Reinhart,1987-88,28.0,9,69,75,75,23,46,69,173.0,,395,86,254,340,786.0,80,7.77,71,321,2447,12.7
21564,Paul Reinhart,1988-89,29.0,10,33,32,32,8,25,33,58.0,,427,94,279,373,844.0,80,7.94,82,370,2484,12.8
21565,Paul Reinhart,1989-90,30.0,11,68,76,76,15,53,68,119.0,,503,109,332,441,963.0,80,7.34,72,344,2400,12.2
21566,Paul Reinhart,1990-91,31.0,12,4,14,14,0,4,4,22.0,,517,109,336,445,985.0,80,7.43,89,437,2435,12.2
21567,Paul Reinhart,1991-92,32.0,13,57,64,64,7,50,57,133.0,,581,116,386,502,1118.0,80,7.48,85,403,2430,12.3
21568,Paul Reinhart,1992-93,33.0,14,57,67,67,17,40,57,139.0,,648,133,426,559,1257.0,80,7.37,76,367,2421,12.2
21569,Paul Stanton,1993-94,26.0,4,23,75,75,5,18,23,72.0,,75,5,18,23,72.0,80,6.91,71,366,2385,11.6
21570,Paul Stanton,1994-95,27.0,5,10,54,54,2,8,10,70.0,,129,7,26,33,142.0,80,6.96,77,402,2440,11.4
21571,Paul Stanton,1995-96,28.0,6,16,77,77,4,12,16,106.0,,206,11,38,49,248.0,84,7.25,87,443,2603,11.7
21572,Paul Stanton,1996-97,29.0,7,10,71,71,3,7,10,136.0,,277,14,45,59,384.0,84,6.48,76,407,2545,10.7
21573,Paul Stanton,1997-98,30.0,8,4,18,18,0,4,4,28.0,,295,14,49,63,412.0,48,5.97,37,209,1408,10.2
21574,Paul Stastny,2009-10,24.0,4,78,82,82,28,50,78,185.0,1490.0,82,28,50,78,185.0,82,5.76,70,398,2426,9.7
21575,Paul Stastny,2010-11,25.0,5,71,66,66,24,47,71,138.0,1391.0,148,52,97,149,323.0,82,5.44,62,351,2383,9.4
21576,Paul Stastny,2011-12,26.0,6,36,45,45,11,25,36,118.0,956.0,193,63,122,185,441.0,82,5.7,65,341,2477,9.4
21577,Paul Stastny,2012-13,27.0,7,79,81,81,20,59,79,199.0,1733.0,274,83,181,264,640.0,82,5.53,56,304,2486,9.1
21578,Paul Stastny,2013-14,28.0,8,57,74,74,22,35,57,181.0,1460.0,348,105,216,321,821.0,82,5.46,52,291,2492,9.0
21579,Paul Stastny,2014-15,29.0,9,53,79,79,21,32,53,190.0,1488.0,427,126,248,374,1011.0,82,5.32,47,271,2439,8.9
21580,Paul Stastny,2015-16,30.0,10,24,40,40,9,15,24,87.0,774.0,467,135,263,398,1098.0,48,5.31,29,160,1399,9.1
21581,Paul Stastny,2016-17,31.0,11,60,71,71,25,35,60,150.0,1306.0,538,160,298,458,1248.0,82,5.34,48,269,2463,8.9
21582,Paul Stastny,2017-18,32.0,12,46,74,74,16,30,46,143.0,1304.0,612,176,328,504,1391.0,82,5.32,47,251,2453,8.9
21583,Paul Stastny,2018-19,33.0,13,49,64,64,10,39,49,103.0,1226.0,676,186,367,553,1494.0,82,5.34,48,255,2438,9.0
21584,Paul Stastny,2019-20,34.0,14,40,66,66,18,22,40,112.0,1263.0,742,204,389,593,1606.0,82,5.45,47,245,2478,9.0
21585,Paul Stastny,2020-21,35.0,15,53,82,82,16,37,53,159.0,1501.0,824,220,426,646,1765.0,82,5.86,50,250,2620,9.2
21586,Paul Stastny,2021-22,36.0,16,42,50,50,13,29,42,103.0,905.0,874,233,455,688,1868.0,82,5.96,47,239,2579,9.5
21587,Paul Stastny,2022-23,37.0,17,38,71,71,17,21,38,136.0,1216.0,945,250,476,726,2004.0,70,5.96,42,208,2192,9.5
21588,Paul Stewart,1982-83,28.0,4,2,21,21,2,0,2,9.0,,21,2,0,2,9.0,80,7.03,61,280,2352,12.0
21589,Paul Szczechura,2011-12,26.0,4,9,31,31,4,5,9,51.0,420.0,31,4,5,9,51.0,82,5.7,65,341,2477,9.4
21590,Paul Szczechura,2012-13,27.0,5,7,52,52,5,2,7,83.0,681.0,83,9,7,16,134.0,82,5.53,56,304,2486,9.1
21591,Paul Szczechura,2014-15,29.0,6,4,9,9,1,3,4,11.0,103.0,92,10,10,20,145.0,82,5.32,47,271,2439,8.9
21592,Paul Thompson,2018-19,30.0,4,0,3,3,0,0,0,3.0,38.0,3,0,0,0,3.0,82,5.34,48,255,2438,9.0
21593,Paul Thompson,2019-20,31.0,5,3,21,21,0,3,3,19.0,166.0,24,0,3,3,22.0,82,5.45,47,245,2478,9.0
21594,Paul Ysebaert,1991-92,25.0,4,4,5,5,0,4,4,4.0,,5,0,4,4,4.0,80,7.48,85,403,2430,12.3
21595,Paul Ysebaert,1992-93,26.0,5,3,5,5,1,2,3,6.0,,10,1,6,7,10.0,80,7.37,76,367,2421,12.2
21596,Paul Ysebaert,1993-94,27.0,6,40,62,62,19,21,40,128.0,,72,20,27,47,138.0,80,6.91,71,366,2385,11.6
21597,Paul Ysebaert,1994-95,28.0,7,75,79,79,35,40,75,211.0,,151,55,67,122,349.0,80,6.96,77,402,2440,11.4
21598,Paul Ysebaert,1995-96,29.0,8,62,80,80,34,28,62,186.0,,231,89,95,184,535.0,84,7.25,87,443,2603,11.7
21599,Paul Ysebaert,1996-97,30.0,9,35,71,71,14,21,35,151.0,,302,103,116,219,686.0,84,6.48,76,407,2545,10.7
21600,Paul Ysebaert,1997-98,31.0,10,28,44,44,12,16,28,93.0,,346,115,132,247,779.0,48,5.97,37,209,1408,10.2
21601,Paul Ysebaert,1998-99,32.0,11,31,55,55,16,15,31,135.0,,401,131,147,278,914.0,82,6.29,74,413,2481,10.4
21602,Paul Ysebaert,1999-00,33.0,12,17,39,39,5,12,17,91.0,,440,136,159,295,1005.0,82,5.83,55,336,2444,9.8
21603,Paul Ysebaert,2000-01,34.0,13,40,82,82,13,27,40,145.0,,522,149,186,335,1150.0,82,5.28,57,380,2242,9.6
21604,Paul Ysebaert,2001-02,35.0,14,1,10,10,0,1,1,10.0,98.0,532,149,187,336,1160.0,82,5.27,57,359,2285,9.4
21605,Pavel Brendl,2004-05,23.0,4,1,8,8,1,0,1,6.0,72.0,8,1,0,1,6.0,82,5.24,53,338,2262,9.5
21606,Pavel Brendl,2005-06,24.0,5,13,50,50,5,8,13,94.0,554.0,58,6,8,14,100.0,82,5.31,60,363,2326,9.4
21607,Pavel Brendl,2006-07,25.0,6,8,18,18,5,3,8,27.0,266.0,76,11,11,22,127.0,82,5.14,57,348,2300,9.2
21608,Pavel Brendl,2008-09,27.0,7,0,2,2,0,0,0,3.0,18.0,78,11,11,22,130.0,82,6.05,85,480,2458,10.1
21609,Pavel Buchnevich,2019-20,24.0,4,20,41,41,8,12,20,55.0,544.0,41,8,12,20,55.0,82,5.45,47,245,2478,9.0
21610,Pavel Buchnevich,2020-21,25.0,5,43,74,74,14,29,43,136.0,1111.0,115,22,41,63,191.0,82,5.86,50,250,2620,9.2
21611,Pavel Buchnevich,2021-22,26.0,6,38,64,64,21,17,38,119.0,971.0,179,43,58,101,310.0,82,5.96,47,239,2579,9.5
21612,Pavel Buchnevich,2022-23,27.0,7,46,68,68,16,30,46,148.0,1151.0,247,59,88,147,458.0,70,5.96,42,208,2192,9.5
21613,Pavel Bure,1994-95,23.0,4,60,65,65,34,26,60,268.0,,65,34,26,60,268.0,80,6.96,77,402,2440,11.4
21614,Pavel Bure,1995-96,24.0,5,110,83,83,60,50,110,407.0,,148,94,76,170,675.0,84,7.25,87,443,2603,11.7
21615,Pavel Bure,1996-97,25.0,6,107,76,76,60,47,107,374.0,,224,154,123,277,1049.0,84,6.48,76,407,2545,10.7
21616,Pavel Bure,1997-98,26.0,7,43,44,44,20,23,43,198.0,,268,174,146,320,1247.0,48,5.97,37,209,1408,10.2
21617,Pavel Bure,1998-99,27.0,8,13,15,15,6,7,13,78.0,,283,180,153,333,1325.0,82,6.29,74,413,2481,10.4
21618,Pavel Bure,1999-00,28.0,9,55,63,63,23,32,55,265.0,,346,203,185,388,1590.0,82,5.83,55,336,2444,9.8
21619,Pavel Bure,2000-01,29.0,10,90,82,82,51,39,90,329.0,,428,254,224,478,1919.0,82,5.28,57,380,2242,9.6
21620,Pavel Bure,2001-02,30.0,11,16,11,11,13,3,16,44.0,239.0,439,267,227,494,1963.0,82,5.27,57,359,2285,9.4
21621,Pavel Bure,2002-03,31.0,12,94,74,74,58,36,94,360.0,1804.0,513,325,263,588,2323.0,82,5.49,53,331,2294,9.8
21622,Pavel Bure,2003-04,32.0,13,92,82,82,59,33,92,384.0,2203.0,595,384,296,680,2707.0,82,5.51,63,376,2272,9.9
21623,Pavel Bure,2004-05,33.0,14,69,68,68,34,35,69,287.0,1701.0,663,418,331,749,2994.0,82,5.24,53,338,2262,9.5
21624,Pavel Bure,2005-06,34.0,15,30,39,39,19,11,30,136.0,739.0,702,437,342,779,3130.0,82,5.31,60,363,2326,9.4
21625,Pavel Datsyuk,2004-05,26.0,4,35,70,70,11,24,35,79.0,955.0,70,11,24,35,79.0,82,5.24,53,338,2262,9.5
21626,Pavel Datsyuk,2005-06,27.0,5,51,64,64,12,39,51,82.0,989.0,134,23,63,86,161.0,82,5.31,60,363,2326,9.4
21627,Pavel Datsyuk,2006-07,28.0,6,68,75,75,30,38,68,136.0,1370.0,209,53,101,154,297.0,82,5.14,57,348,2300,9.2
21628,Pavel Datsyuk,2008-09,30.0,7,87,75,75,28,59,87,145.0,1342.0,284,81,160,241,442.0,82,6.05,85,480,2458,10.1
21629,Pavel Datsyuk,2009-10,31.0,8,87,79,79,27,60,87,207.0,1577.0,363,108,220,328,649.0,82,5.76,70,398,2426,9.7
21630,Pavel Datsyuk,2010-11,32.0,9,97,82,82,31,66,97,264.0,1753.0,445,139,286,425,913.0,82,5.44,62,351,2383,9.4
21631,Pavel Datsyuk,2011-12,33.0,10,97,81,81,32,65,97,248.0,1556.0,526,171,351,522,1161.0,82,5.7,65,341,2477,9.4
21632,Pavel Datsyuk,2012-13,34.0,11,70,80,80,27,43,70,203.0,1628.0,606,198,394,592,1364.0,82,5.53,56,304,2486,9.1
21633,Pavel Datsyuk,2013-14,35.0,12,59,56,56,23,36,59,137.0,1082.0,662,221,430,651,1501.0,82,5.46,52,291,2492,9.0
21634,Pavel Datsyuk,2014-15,36.0,13,67,70,70,19,48,67,164.0,1370.0,732,240,478,718,1665.0,82,5.32,47,271,2439,8.9
21635,Pavel Datsyuk,2015-16,37.0,14,49,47,47,15,34,49,107.0,949.0,779,255,512,767,1772.0,48,5.31,29,160,1399,9.1
21636,Pavel Datsyuk,2016-17,38.0,15,37,45,45,17,20,37,126.0,912.0,824,272,532,804,1898.0,82,5.34,48,269,2463,8.9
21637,Pavel Datsyuk,2017-18,39.0,16,65,63,63,26,39,65,165.0,1200.0,887,298,571,869,2063.0,82,5.32,47,251,2453,8.9
21638,Pavel Datsyuk,2018-19,40.0,17,49,66,66,16,33,49,181.0,1297.0,953,314,604,918,2244.0,82,5.34,48,255,2438,9.0
21639,Pavel Kolarik,2003-04,31.0,4,0,10,10,0,0,0,1.0,88.0,10,0,0,0,1.0,82,5.51,63,376,2272,9.9
21640,Pavel Kolarik,2004-05,32.0,5,0,13,13,0,0,0,6.0,88.0,23,0,0,0,7.0,82,5.24,53,338,2262,9.5
21641,Pavel Kubina,2000-01,23.0,4,3,10,10,1,2,3,8.0,,10,1,2,3,8.0,82,5.28,57,380,2242,9.6
21642,Pavel Kubina,2001-02,24.0,5,21,68,68,9,12,21,119.0,1549.0,78,10,14,24,127.0,82,5.27,57,359,2285,9.4
21643,Pavel Kubina,2002-03,25.0,6,26,69,69,8,18,26,128.0,1555.0,147,18,32,50,255.0,82,5.49,53,331,2294,9.8
21644,Pavel Kubina,2003-04,26.0,7,30,70,70,11,19,30,128.0,1687.0,217,29,51,80,383.0,82,5.51,63,376,2272,9.9
21645,Pavel Kubina,2004-05,27.0,8,34,82,82,11,23,34,189.0,1940.0,299,40,74,114,572.0,82,5.24,53,338,2262,9.5
21646,Pavel Kubina,2005-06,28.0,9,22,75,75,3,19,22,139.0,1606.0,374,43,93,136,711.0,82,5.31,60,363,2326,9.4
21647,Pavel Kubina,2006-07,29.0,10,35,81,81,17,18,35,153.0,1713.0,455,60,111,171,864.0,82,5.14,57,348,2300,9.2
21648,Pavel Kubina,2008-09,31.0,11,38,76,76,5,33,38,155.0,1704.0,531,65,144,209,1019.0,82,6.05,85,480,2458,10.1
21649,Pavel Kubina,2009-10,32.0,12,21,61,61,7,14,21,97.0,1300.0,592,72,158,230,1116.0,82,5.76,70,398,2426,9.7
21650,Pavel Kubina,2010-11,33.0,13,40,72,72,11,29,40,136.0,1722.0,664,83,187,270,1252.0,82,5.44,62,351,2383,9.4
21651,Pavel Kubina,2011-12,34.0,14,40,82,82,14,26,40,184.0,1808.0,746,97,213,310,1436.0,82,5.7,65,341,2477,9.4
21652,Pavel Kubina,2012-13,35.0,15,38,76,76,6,32,38,159.0,1720.0,822,103,245,348,1595.0,82,5.53,56,304,2486,9.1
21653,Pavel Kubina,2013-14,36.0,16,23,79,79,4,19,23,78.0,1519.0,901,107,264,371,1673.0,82,5.46,52,291,2492,9.0
21654,Pavel Kubina,2014-15,37.0,17,15,69,69,3,12,15,75.0,1330.0,970,110,276,386,1748.0,82,5.32,47,271,2439,8.9
21655,Pavel Patera,2002-03,31.0,4,5,12,12,1,4,5,18.0,169.0,12,1,4,5,18.0,82,5.49,53,331,2294,9.8
21656,Pavel Patera,2003-04,32.0,5,4,20,20,1,3,4,14.0,289.0,32,2,7,9,32.0,82,5.51,63,376,2272,9.9
21657,Pavel Rosa,2001-02,24.0,4,16,29,29,4,12,16,61.0,393.0,29,4,12,16,61.0,82,5.27,57,359,2285,9.4
21658,Pavel Rosa,2002-03,25.0,5,0,3,3,0,0,0,1.0,34.0,32,4,12,16,62.0,82,5.49,53,331,2294,9.8
21659,Pavel Rosa,2005-06,28.0,6,0,2,2,0,0,0,4.0,28.0,34,4,12,16,66.0,82,5.31,60,363,2326,9.4
21660,Pavel Rosa,2006-07,29.0,7,2,2,2,1,1,2,4.0,25.0,36,5,13,18,70.0,82,5.14,57,348,2300,9.2
21661,Pavel Skrbek,2001-02,23.0,4,0,4,4,0,0,0,1.0,57.0,4,0,0,0,1.0,82,5.27,57,359,2285,9.4
21662,Pavel Skrbek,2003-04,25.0,5,0,5,5,0,0,0,2.0,59.0,9,0,0,0,3.0,82,5.51,63,376,2272,9.9
21663,Pavel Skrbek,2004-05,26.0,6,0,3,3,0,0,0,0.0,31.0,12,0,0,0,3.0,82,5.24,53,338,2262,9.5
21664,Pavel Torgaev,1998-99,33.0,4,16,41,41,6,10,16,50.0,,41,6,10,16,50.0,82,6.29,74,413,2481,10.4
21665,Pavel Torgaev,2002-03,37.0,5,4,14,14,0,4,4,18.0,173.0,55,6,14,20,68.0,82,5.49,53,331,2294,9.8
21666,Pavel Trnka,2000-01,24.0,4,7,48,48,3,4,7,46.0,,48,3,4,7,46.0,82,5.28,57,380,2242,9.6
21667,Pavel Trnka,2001-02,25.0,5,4,63,63,0,4,4,50.0,1014.0,111,3,8,11,96.0,82,5.27,57,359,2285,9.4
21668,Pavel Trnka,2002-03,26.0,6,17,57,57,2,15,17,54.0,1103.0,168,5,23,28,150.0,82,5.49,53,331,2294,9.8
21669,Pavel Trnka,2003-04,27.0,7,8,59,59,1,7,8,59.0,1187.0,227,6,30,36,209.0,82,5.51,63,376,2272,9.9
21670,Pavel Trnka,2004-05,28.0,8,13,71,71,2,11,13,78.0,1211.0,298,8,41,49,287.0,82,5.24,53,338,2262,9.5
21671,Pavel Trnka,2005-06,29.0,9,12,46,46,3,9,12,58.0,767.0,344,11,50,61,345.0,82,5.31,60,363,2326,9.4
21672,Pavel Trnka,2006-07,30.0,10,16,67,67,3,13,16,66.0,1146.0,411,14,63,77,411.0,82,5.14,57,348,2300,9.2
21673,Pavel Vorobiev,2006-07,24.0,4,4,18,18,1,3,4,20.0,230.0,18,1,3,4,20.0,82,5.14,57,348,2300,9.2
21674,Pavel Vorobiev,2008-09,26.0,5,21,39,39,9,12,21,87.0,558.0,57,10,15,25,107.0,82,6.05,85,480,2458,10.1
21675,Pavel Zacha,2018-19,21.0,4,2,1,1,0,2,2,3.0,17.0,1,0,2,2,3.0,82,5.34,48,255,2438,9.0
21676,Pavel Zacha,2019-20,22.0,5,24,70,70,8,16,24,83.0,1002.0,71,8,18,26,86.0,82,5.45,47,245,2478,9.0
21677,Pavel Zacha,2020-21,23.0,6,25,69,69,8,17,25,112.0,992.0,140,16,35,51,198.0,82,5.86,50,250,2620,9.2
21678,Pavel Zacha,2021-22,24.0,7,25,61,61,13,12,25,99.0,981.0,201,29,47,76,297.0,82,5.96,47,239,2579,9.5
21679,Pavel Zacha,2022-23,25.0,8,32,65,65,8,24,32,97.0,1057.0,266,37,71,108,394.0,70,5.96,42,208,2192,9.5
21680,Pavol Demitra,1996-97,22.0,4,2,12,12,1,1,2,10.0,,12,1,1,2,10.0,84,6.48,76,407,2545,10.7
21681,Pavol Demitra,1997-98,23.0,5,7,16,16,4,3,7,21.0,,28,5,4,9,31.0,48,5.97,37,209,1408,10.2
21682,Pavol Demitra,1998-99,24.0,6,17,31,31,7,10,17,66.0,,59,12,14,26,97.0,82,6.29,74,413,2481,10.4
21683,Pavol Demitra,1999-00,25.0,7,3,8,8,3,0,3,15.0,,67,15,14,29,112.0,82,5.83,55,336,2444,9.8
21684,Pavol Demitra,2000-01,26.0,8,52,61,61,22,30,52,147.0,,128,37,44,81,259.0,82,5.28,57,380,2242,9.6
21685,Pavol Demitra,2001-02,27.0,9,89,82,82,37,52,89,259.0,1654.0,210,74,96,170,518.0,82,5.27,57,359,2285,9.4
21686,Pavol Demitra,2002-03,28.0,10,75,71,71,28,47,75,241.0,1365.0,281,102,143,245,759.0,82,5.49,53,331,2294,9.8
21687,Pavol Demitra,2003-04,29.0,11,45,44,44,20,25,45,124.0,794.0,325,122,168,290,883.0,82,5.51,63,376,2272,9.9
21688,Pavol Demitra,2004-05,30.0,12,78,82,82,35,43,78,212.0,1573.0,407,157,211,368,1095.0,82,5.24,53,338,2262,9.5
21689,Pavol Demitra,2005-06,31.0,13,93,78,78,36,57,93,205.0,1544.0,485,193,268,461,1300.0,82,5.31,60,363,2326,9.4
21690,Pavol Demitra,2006-07,32.0,14,58,68,68,23,35,58,179.0,1395.0,553,216,303,519,1479.0,82,5.14,57,348,2300,9.2
21691,Pavol Demitra,2008-09,34.0,15,62,58,58,25,37,62,184.0,1222.0,611,241,340,581,1663.0,82,6.05,85,480,2458,10.1
21692,Pavol Demitra,2009-10,35.0,16,64,71,71,25,39,64,175.0,1466.0,682,266,379,645,1838.0,82,5.76,70,398,2426,9.7
21693,Pavol Demitra,2010-11,36.0,17,54,68,68,15,39,54,126.0,1340.0,750,281,418,699,1964.0,82,5.44,62,351,2383,9.4
21694,Pavol Demitra,2011-12,37.0,18,53,69,69,20,33,53,143.0,1206.0,819,301,451,752,2107.0,82,5.7,65,341,2477,9.4
21695,Pavol Demitra,2012-13,38.0,19,16,28,28,3,13,16,53.0,454.0,847,304,464,768,2160.0,82,5.53,56,304,2486,9.1
21696,Paxton Schulte,1996-97,24.0,4,0,1,1,0,0,0,0.0,,1,0,0,0,0.0,84,6.48,76,407,2545,10.7
21697,Paxton Schulte,1999-00,27.0,5,0,1,1,0,0,0,1.0,,2,0,0,0,1.0,82,5.83,55,336,2444,9.8
21698,Pekka Rautakallio,1982-83,29.0,4,30,79,79,5,25,30,104.0,,79,5,25,30,104.0,80,7.03,61,280,2352,12.0
21699,Pekka Rautakallio,1983-84,30.0,5,56,76,76,11,45,56,129.0,,155,16,70,86,233.0,80,7.69,77,340,2441,12.6
21700,Pekka Rautakallio,1984-85,31.0,6,68,80,80,17,51,68,176.0,,235,33,121,154,409.0,80,8.03,73,320,2489,12.9
21701,Pelle Eklund,1988-89,25.0,4,66,70,70,15,51,66,141.0,,70,15,51,66,141.0,80,7.94,82,370,2484,12.8
21702,Pelle Eklund,1989-90,26.0,5,55,72,72,14,41,55,127.0,,142,29,92,121,268.0,80,7.34,72,344,2400,12.2
21703,Pelle Eklund,1990-91,27.0,6,42,71,71,10,32,42,101.0,,213,39,124,163,369.0,80,7.43,89,437,2435,12.2
21704,Pelle Eklund,1991-92,28.0,7,69,79,79,18,51,69,121.0,,292,57,175,232,490.0,80,7.48,85,403,2430,12.3
21705,Pelle Eklund,1992-93,29.0,8,62,70,70,23,39,62,126.0,,362,80,214,294,616.0,80,7.37,76,367,2421,12.2
21706,Pelle Eklund,1993-94,30.0,9,69,73,73,19,50,69,131.0,,435,99,264,363,747.0,80,6.91,71,366,2385,11.6
21707,Pelle Eklund,1994-95,31.0,10,23,51,51,7,16,23,74.0,,486,106,280,386,821.0,80,6.96,77,402,2440,11.4
21708,Pelle Eklund,1995-96,32.0,11,49,55,55,11,38,49,82.0,,541,117,318,435,903.0,84,7.25,87,443,2603,11.7
21709,Pelle Eklund,1996-97,33.0,12,20,53,53,3,17,20,53.0,,594,120,335,455,956.0,84,6.48,76,407,2545,10.7
21710,Per Djoos,1993-94,25.0,4,12,26,26,0,12,12,23.0,,26,0,12,12,23.0,80,6.91,71,366,2385,11.6
21711,Per Djoos,1994-95,26.0,5,19,50,50,1,18,19,39.0,,76,1,30,31,62.0,80,6.96,77,402,2440,11.4
21712,Per Djoos,1995-96,27.0,6,2,6,6,1,1,2,4.0,,82,2,31,33,66.0,84,7.25,87,443,2603,11.7
21713,Per Gustafsson,1999-00,29.0,4,29,58,58,7,22,29,105.0,,58,7,22,29,105.0,82,5.83,55,336,2444,9.8
21714,Per Gustafsson,2000-01,30.0,5,6,31,31,1,5,6,36.0,,89,8,27,35,141.0,82,5.28,57,380,2242,9.6
21715,Per Ledin,2011-12,33.0,4,0,3,3,0,0,0,2.0,30.0,3,0,0,0,2.0,82,5.7,65,341,2477,9.4
21716,Per Svartvadet,2002-03,27.0,4,7,38,38,3,4,7,36.0,509.0,38,3,4,7,36.0,82,5.49,53,331,2294,9.8
21717,Per Svartvadet,2003-04,28.0,5,21,69,69,10,11,21,98.0,1015.0,107,13,15,28,134.0,82,5.51,63,376,2272,9.9
21718,Per Svartvadet,2004-05,29.0,6,15,78,78,3,12,15,80.0,1043.0,185,16,27,43,214.0,82,5.24,53,338,2262,9.5
21719,Per Svartvadet,2005-06,30.0,7,8,62,62,1,7,8,47.0,730.0,247,17,34,51,261.0,82,5.31,60,363,2326,9.4
21720,Perry Anderson,1984-85,23.0,4,3,5,5,1,2,3,9.0,,5,1,2,3,9.0,80,8.03,73,320,2489,12.9
21721,Perry Anderson,1985-86,24.0,5,7,18,18,5,2,7,26.0,,23,6,4,10,35.0,80,7.73,71,310,2444,12.7
21722,Perry Anderson,1986-87,25.0,6,12,50,50,7,5,12,49.0,,73,13,9,22,84.0,80,7.89,74,336,2448,12.9
21723,Perry Anderson,1987-88,26.0,7,18,71,71,9,9,18,84.0,,144,22,18,40,168.0,80,7.77,71,321,2447,12.7
21724,Perry Anderson,1988-89,27.0,8,19,51,51,7,12,19,61.0,,195,29,30,59,229.0,80,7.94,82,370,2484,12.8
21725,Perry Anderson,1989-90,28.0,9,19,57,57,10,9,19,46.0,,252,39,39,78,275.0,80,7.34,72,344,2400,12.2
21726,Perry Anderson,1990-91,29.0,10,10,60,60,4,6,10,40.0,,312,43,45,88,315.0,80,7.43,89,437,2435,12.2
21727,Perry Anderson,1991-92,30.0,11,9,39,39,3,6,9,36.0,,351,46,51,97,351.0,80,7.48,85,403,2430,12.3
21728,Perry Anderson,1993-94,32.0,12,0,1,1,0,0,0,1.0,,352,46,51,97,352.0,80,6.91,71,366,2385,11.6
21729,Perry Anderson,1994-95,33.0,13,12,48,48,4,8,12,57.0,,400,50,59,109,409.0,80,6.96,77,402,2440,11.4
21730,Perry Berezan,1987-88,23.0,4,5,9,9,3,2,5,13.0,,9,3,2,5,13.0,80,7.77,71,321,2447,12.7
21731,Perry Berezan,1988-89,24.0,5,33,55,55,12,21,33,117.0,,64,15,23,38,130.0,80,7.94,82,370,2484,12.8
21732,Perry Berezan,1989-90,25.0,6,8,24,24,5,3,8,31.0,,88,20,26,46,161.0,80,7.34,72,344,2400,12.2
21733,Perry Berezan,1990-91,26.0,7,19,29,29,7,12,19,69.0,,117,27,38,65,230.0,80,7.43,89,437,2435,12.2
21734,Perry Berezan,1991-92,27.0,8,13,51,51,5,8,13,65.0,,168,32,46,78,295.0,80,7.48,85,403,2430,12.3
21735,Perry Berezan,1992-93,28.0,9,15,64,64,3,12,15,75.0,,232,35,58,93,370.0,80,7.37,76,367,2421,12.2
21736,Perry Berezan,1993-94,29.0,10,17,52,52,11,6,17,73.0,,284,46,64,110,443.0,80,6.91,71,366,2385,11.6
21737,Perry Berezan,1994-95,30.0,11,19,66,66,12,7,19,112.0,,350,58,71,129,555.0,80,6.96,77,402,2440,11.4
21738,Perry Berezan,1995-96,31.0,12,7,28,28,3,4,7,37.0,,378,61,75,136,592.0,84,7.25,87,443,2603,11.7
21739,Perry Ganchar,1986-87,23.0,4,0,1,1,0,0,0,0.0,,1,0,0,0,0.0,80,7.89,74,336,2448,12.9
21740,Perry Ganchar,1987-88,24.0,5,2,7,7,0,2,2,4.0,,8,0,2,2,4.0,80,7.77,71,321,2447,12.7
21741,Perry Ganchar,1990-91,27.0,6,8,31,31,3,5,8,35.0,,39,3,7,10,39.0,80,7.43,89,437,2435,12.2
21742,Perry Ganchar,1991-92,28.0,7,0,3,3,0,0,0,3.0,,42,3,7,10,42.0,80,7.48,85,403,2430,12.3
21743,Perry Pelensky,1986-87,24.0,4,0,4,4,0,0,0,4.0,,4,0,0,0,4.0,80,7.89,74,336,2448,12.9
21744,Perry Turnbull,1982-83,23.0,4,35,80,80,16,19,35,139.0,,80,16,19,35,139.0,80,7.03,61,280,2352,12.0
21745,Perry Turnbull,1983-84,24.0,5,56,75,75,34,22,56,209.0,,155,50,41,91,348.0,80,7.69,77,340,2441,12.6
21746,Perry Turnbull,1984-85,25.0,6,59,79,79,33,26,59,215.0,,234,83,67,150,563.0,80,8.03,73,320,2489,12.9
21747,Perry Turnbull,1985-86,26.0,7,47,79,79,32,15,47,206.0,,313,115,82,197,769.0,80,7.73,71,310,2444,12.7
21748,Perry Turnbull,1986-87,27.0,8,35,72,72,20,15,35,153.0,,385,135,97,232,922.0,80,7.89,74,336,2448,12.9
21749,Perry Turnbull,1987-88,28.0,9,43,66,66,22,21,43,138.0,,451,157,118,275,1060.0,80,7.77,71,321,2447,12.7
21750,Perry Turnbull,1988-89,29.0,10,51,80,80,20,31,51,167.0,,531,177,149,326,1227.0,80,7.94,82,370,2484,12.8
21751,Perry Turnbull,1989-90,30.0,11,6,26,26,1,5,6,29.0,,557,178,154,332,1256.0,80,7.34,72,344,2400,12.2
21752,Perry Turnbull,1990-91,31.0,12,19,51,51,10,9,19,62.0,,608,188,163,351,1318.0,80,7.43,89,437,2435,12.2
21753,Perttu Lindgren,2012-13,25.0,4,0,1,1,0,0,0,0.0,9.0,1,0,0,0,0.0,82,5.53,56,304,2486,9.1
21754,Peter Ahola,1994-95,26.0,4,19,71,71,7,12,19,74.0,,71,7,12,19,74.0,80,6.96,77,402,2440,11.4
21755,Peter Ahola,1995-96,27.0,5,8,50,50,3,5,8,40.0,,121,10,17,27,114.0,84,7.25,87,443,2603,11.7
21756,Peter Ahola,1996-97,28.0,6,0,2,2,0,0,0,1.0,,123,10,17,27,115.0,84,6.48,76,407,2545,10.7
21757,Peter Allen,1998-99,28.0,4,0,8,8,0,0,0,2.0,,8,0,0,0,2.0,82,6.29,74,413,2481,10.4
21758,Peter Ambroziak,1997-98,26.0,4,1,12,12,0,1,1,3.0,,12,0,1,1,3.0,48,5.97,37,209,1408,10.2
21759,Peter Andersson,1986-87,24.0,4,10,42,42,3,7,10,49.0,,42,3,7,10,49.0,80,7.89,74,336,2448,12.9
21760,Peter Andersson,1987-88,25.0,5,10,57,57,0,10,10,61.0,,99,3,17,20,110.0,80,7.77,71,321,2447,12.7
21761,Peter Andersson,1988-89,26.0,6,31,73,73,7,24,31,100.0,,172,10,41,51,210.0,80,7.94,82,370,2484,12.8
21762,Peter Andersson0,1995-96,30.0,4,15,31,31,4,11,15,68.0,,31,4,11,15,68.0,84,7.25,87,443,2603,11.7
21763,Peter Andersson0,1996-97,31.0,5,4,16,16,2,2,4,21.0,,47,6,13,19,89.0,84,6.48,76,407,2545,10.7
21764,Peter Bakovic,1990-91,26.0,4,2,10,10,2,0,2,7.0,,10,2,0,2,7.0,80,7.43,89,437,2435,12.2
21765,Peter Bartos,2003-04,30.0,4,6,13,13,4,2,6,18.0,180.0,13,4,2,6,18.0,82,5.51,63,376,2272,9.9
21766,Peter Bondra,1993-94,25.0,4,28,54,54,12,16,28,95.0,,54,12,16,28,95.0,80,6.91,71,366,2385,11.6
21767,Peter Bondra,1994-95,26.0,5,56,71,71,28,28,56,158.0,,125,40,44,84,253.0,80,6.96,77,402,2440,11.4
21768,Peter Bondra,1995-96,27.0,6,85,83,83,37,48,85,239.0,,208,77,92,169,492.0,84,7.25,87,443,2603,11.7
21769,Peter Bondra,1996-97,28.0,7,43,69,69,24,19,43,200.0,,277,101,111,212,692.0,84,6.48,76,407,2545,10.7
21770,Peter Bondra,1997-98,29.0,8,43,47,47,34,9,43,177.0,,324,135,120,255,869.0,48,5.97,37,209,1408,10.2
21771,Peter Bondra,1998-99,30.0,9,80,67,67,52,28,80,322.0,,391,187,148,335,1191.0,82,6.29,74,413,2481,10.4
21772,Peter Bondra,1999-00,31.0,10,77,77,77,46,31,77,314.0,,468,233,179,412,1505.0,82,5.83,55,336,2444,9.8
21773,Peter Bondra,2000-01,32.0,11,78,76,76,52,26,78,284.0,,544,285,205,490,1789.0,82,5.28,57,380,2242,9.6
21774,Peter Bondra,2001-02,33.0,12,55,66,66,31,24,55,284.0,1359.0,610,316,229,545,2073.0,82,5.27,57,359,2285,9.4
21775,Peter Bondra,2002-03,34.0,13,38,62,62,21,17,38,187.0,1166.0,672,337,246,583,2260.0,82,5.49,53,331,2294,9.8
21776,Peter Bondra,2003-04,35.0,14,81,82,82,45,36,81,305.0,1705.0,754,382,282,664,2565.0,82,5.51,63,376,2272,9.9
21777,Peter Bondra,2004-05,36.0,15,70,77,77,39,31,70,333.0,1672.0,831,421,313,734,2898.0,82,5.24,53,338,2262,9.5
21778,Peter Bondra,2005-06,37.0,16,56,76,76,30,26,56,256.0,1436.0,907,451,339,790,3154.0,82,5.31,60,363,2326,9.4
21779,Peter Bondra,2006-07,38.0,17,49,77,77,26,23,49,188.0,1433.0,984,477,362,839,3342.0,82,5.14,57,348,2300,9.2
21780,Peter Bondra,2008-09,40.0,18,39,60,60,21,18,39,143.0,956.0,1044,498,380,878,3485.0,82,6.05,85,480,2458,10.1
21781,Peter Bondra,2009-10,41.0,19,14,37,37,5,9,14,46.0,445.0,1081,503,389,892,3531.0,82,5.76,70,398,2426,9.7
21782,Peter Cehlarik,2019-20,24.0,4,2,11,11,0,2,2,8.0,153.0,11,0,2,2,8.0,82,5.45,47,245,2478,9.0
21783,Peter Cehlarik,2020-21,25.0,5,2,6,6,1,1,2,3.0,84.0,17,1,3,4,11.0,82,5.86,50,250,2620,9.2
21784,Peter Cehlarik,2021-22,26.0,6,6,20,20,4,2,6,30.0,252.0,37,5,5,10,41.0,82,5.96,47,239,2579,9.5
21785,Peter Cehlarik,2022-23,27.0,7,1,3,3,0,1,1,0.0,34.0,40,5,6,11,41.0,70,5.96,42,208,2192,9.5
21786,Peter Ciavaglia,1994-95,25.0,4,0,2,2,0,0,0,1.0,,2,0,0,0,1.0,80,6.96,77,402,2440,11.4
21787,Peter Ciavaglia,1995-96,26.0,5,0,3,3,0,0,0,2.0,,5,0,0,0,3.0,84,7.25,87,443,2603,11.7
21788,Peter Dineen,1989-90,29.0,4,2,11,11,0,2,2,5.0,,11,0,2,2,5.0,80,7.34,72,344,2400,12.2
21789,Peter Dineen,1992-93,32.0,5,0,2,2,0,0,0,0.0,,13,0,2,2,5.0,80,7.37,76,367,2421,12.2
21790,Peter Douris,1988-89,22.0,4,0,11,11,0,0,0,0.0,,11,0,0,0,0.0,80,7.94,82,370,2484,12.8
21791,Peter Douris,1989-90,23.0,5,0,6,6,0,0,0,3.0,,17,0,0,0,3.0,80,7.34,72,344,2400,12.2
21792,Peter Douris,1990-91,24.0,6,2,4,4,0,2,2,2.0,,21,0,2,2,5.0,80,7.43,89,437,2435,12.2
21793,Peter Douris,1992-93,26.0,7,11,36,36,5,6,11,63.0,,57,5,8,13,68.0,80,7.37,76,367,2421,12.2
21794,Peter Douris,1993-94,27.0,8,7,39,39,5,2,7,46.0,,96,10,10,20,114.0,80,6.91,71,366,2385,11.6
21795,Peter Douris,1994-95,28.0,9,23,54,54,10,13,23,107.0,,150,20,23,43,221.0,80,6.96,77,402,2440,11.4
21796,Peter Douris,1995-96,29.0,10,8,19,19,4,4,8,33.0,,169,24,27,51,254.0,84,7.25,87,443,2603,11.7
21797,Peter Douris,1996-97,30.0,11,34,74,74,12,22,34,142.0,,243,36,49,85,396.0,84,6.48,76,407,2545,10.7
21798,Peter Douris,1997-98,31.0,12,21,46,46,10,11,21,69.0,,289,46,60,106,465.0,48,5.97,37,209,1408,10.2
21799,Peter Douris,1998-99,32.0,13,15,31,31,8,7,15,45.0,,320,54,67,121,510.0,82,6.29,74,413,2481,10.4
21800,Peter Douris,2000-01,34.0,14,0,1,1,0,0,0,3.0,,321,54,67,121,513.0,82,5.28,57,380,2242,9.6
21801,Peter Driscoll,1982-83,28.0,4,6,39,39,1,5,6,23.0,,39,1,5,6,23.0,80,7.03,61,280,2352,12.0
21802,Peter Driscoll,1983-84,29.0,5,5,21,21,2,3,5,17.0,,60,3,8,11,40.0,80,7.69,77,340,2441,12.6
21803,Peter Eriksson,1992-93,27.0,4,6,20,20,3,3,6,23.0,,20,3,3,6,23.0,80,7.37,76,367,2421,12.2
21804,Peter Ferraro,1998-99,26.0,4,1,5,5,0,1,1,6.0,,5,0,1,1,6.0,82,6.29,74,413,2481,10.4
21805,Peter Ferraro,1999-00,27.0,5,0,2,2,0,0,0,3.0,,7,0,1,1,9.0,82,5.83,55,336,2444,9.8
21806,Peter Ferraro,2000-01,28.0,6,7,30,30,3,4,7,37.0,,37,3,5,8,46.0,82,5.28,57,380,2242,9.6
21807,Peter Ferraro,2001-02,29.0,7,14,46,46,6,8,14,61.0,469.0,83,9,13,22,107.0,82,5.27,57,359,2285,9.4
21808,Peter Ferraro,2002-03,30.0,8,1,5,5,0,1,1,3.0,41.0,88,9,14,23,110.0,82,5.49,53,331,2294,9.8
21809,Peter Ferraro,2004-05,32.0,9,1,4,4,0,1,1,3.0,52.0,92,9,15,24,113.0,82,5.24,53,338,2262,9.5
21810,Peter Fiorentino,1994-95,26.0,4,0,1,1,0,0,0,2.0,,1,0,0,0,2.0,80,6.96,77,402,2440,11.4
21811,Peter Forsberg,1997-98,24.0,4,50,47,47,15,35,50,86.0,,47,15,35,50,86.0,48,5.97,37,209,1408,10.2
21812,Peter Forsberg,1998-99,25.0,5,116,82,82,30,86,116,217.0,,129,45,121,166,303.0,82,6.29,74,413,2481,10.4
21813,Peter Forsberg,1999-00,26.0,6,86,65,65,28,58,86,188.0,,194,73,179,252,491.0,82,5.83,55,336,2444,9.8
21814,Peter Forsberg,2000-01,27.0,7,91,72,72,25,66,91,202.0,,266,98,245,343,693.0,82,5.28,57,380,2242,9.6
21815,Peter Forsberg,2001-02,28.0,8,97,78,78,30,67,97,217.0,1832.0,344,128,312,440,910.0,82,5.27,57,359,2285,9.4
21816,Peter Forsberg,2002-03,29.0,9,51,49,49,14,37,51,105.0,1025.0,393,142,349,491,1015.0,82,5.49,53,331,2294,9.8
21817,Peter Forsberg,2003-04,30.0,10,89,73,73,27,62,89,178.0,1518.0,466,169,411,580,1193.0,82,5.51,63,376,2272,9.9
21818,Peter Forsberg,2005-06,32.0,11,106,75,75,29,77,106,166.0,1450.0,541,198,488,686,1359.0,82,5.31,60,363,2326,9.4
21819,Peter Forsberg,2006-07,33.0,12,55,39,39,18,37,55,85.0,749.0,580,216,525,741,1444.0,82,5.14,57,348,2300,9.2
21820,Peter Forsberg,2008-09,35.0,13,75,60,60,19,56,75,132.0,1127.0,640,235,581,816,1576.0,82,6.05,85,480,2458,10.1
21821,Peter Forsberg,2009-10,36.0,14,55,57,57,13,42,55,99.0,1043.0,697,248,623,871,1675.0,82,5.76,70,398,2426,9.7
21822,Peter Forsberg,2010-11,37.0,15,14,9,9,1,13,14,15.0,173.0,706,249,636,885,1690.0,82,5.44,62,351,2383,9.4
21823,Peter Forsberg,2013-14,40.0,16,0,2,2,0,0,0,3.0,35.0,708,249,636,885,1693.0,82,5.46,52,291,2492,9.0
21824,Peter Gustavsson,1984-85,26.0,4,0,2,2,0,0,0,2.0,,2,0,0,0,2.0,80,8.03,73,320,2489,12.9
21825,Peter Harrold,2009-10,26.0,4,2,12,12,0,2,2,11.0,182.0,12,0,2,2,11.0,82,5.76,70,398,2426,9.7
21826,Peter Harrold,2010-11,27.0,5,5,25,25,2,3,5,16.0,410.0,37,2,5,7,27.0,82,5.44,62,351,2383,9.4
21827,Peter Harrold,2011-12,28.0,6,12,69,69,4,8,12,95.0,909.0,106,6,13,19,122.0,82,5.7,65,341,2477,9.4
21828,Peter Harrold,2012-13,29.0,7,3,39,39,1,2,3,23.0,361.0,145,7,15,22,145.0,82,5.53,56,304,2486,9.1
21829,Peter Harrold,2013-14,30.0,8,4,19,19,1,3,4,12.0,233.0,164,8,18,26,157.0,82,5.46,52,291,2492,9.0
21830,Peter Harrold,2014-15,31.0,9,2,11,11,0,2,2,11.0,161.0,175,8,20,28,168.0,82,5.32,47,271,2439,8.9
21831,Peter Harrold,2015-16,32.0,10,5,23,23,2,3,5,36.0,406.0,198,10,23,33,204.0,48,5.31,29,160,1399,9.1
21832,Peter Harrold,2016-17,33.0,11,4,33,33,0,4,4,32.0,616.0,231,10,27,37,236.0,82,5.34,48,269,2463,8.9
21833,Peter Harrold,2017-18,34.0,12,5,43,43,3,2,5,31.0,655.0,274,13,29,42,267.0,82,5.32,47,251,2453,8.9
21834,Peter Hayek,1984-85,27.0,4,0,1,1,0,0,0,0.0,,1,0,0,0,0.0,80,8.03,73,320,2489,12.9
21835,Peter Helander,1985-86,34.0,4,1,7,7,0,1,1,2.0,,7,0,1,1,2.0,80,7.73,71,310,2444,12.7
21836,Peter Holland,2014-15,24.0,4,1,4,4,1,0,1,1.0,31.0,4,1,0,1,1.0,82,5.32,47,271,2439,8.9
21837,Peter Holland,2015-16,25.0,5,5,21,21,3,2,5,26.0,243.0,25,4,2,6,27.0,48,5.31,29,160,1399,9.1
21838,Peter Holland,2016-17,26.0,6,11,43,43,6,5,11,43.0,488.0,68,10,7,17,70.0,82,5.34,48,269,2463,8.9
21839,Peter Holland,2017-18,27.0,7,25,62,62,11,14,25,93.0,900.0,130,21,21,42,163.0,82,5.32,47,251,2453,8.9
21840,Peter Holland,2018-19,28.0,8,27,65,65,9,18,27,138.0,953.0,195,30,39,69,301.0,82,5.34,48,255,2438,9.0
21841,Peter Holland,2019-20,29.0,9,12,48,48,5,7,12,79.0,612.0,243,35,46,81,380.0,82,5.45,47,245,2478,9.0
21842,Peter Holland,2020-21,30.0,10,4,23,23,1,3,4,30.0,285.0,266,36,49,85,410.0,82,5.86,50,250,2620,9.2
21843,Peter Ihnacak,1985-86,28.0,4,66,80,80,28,38,66,160.0,,80,28,38,66,160.0,80,7.73,71,310,2444,12.7
21844,Peter Ihnacak,1986-87,29.0,5,23,47,47,10,13,23,76.0,,127,38,51,89,236.0,80,7.89,74,336,2448,12.9
21845,Peter Ihnacak,1987-88,30.0,6,44,70,70,22,22,44,118.0,,197,60,73,133,354.0,80,7.77,71,321,2447,12.7
21846,Peter Ihnacak,1988-89,31.0,7,45,63,63,18,27,45,96.0,,260,78,100,178,450.0,80,7.94,82,370,2484,12.8
21847,Peter Ihnacak,1989-90,32.0,8,39,58,58,12,27,39,98.0,,318,90,127,217,548.0,80,7.34,72,344,2400,12.2
21848,Peter Ihnacak,1990-91,33.0,9,30,68,68,10,20,30,75.0,,386,100,147,247,623.0,80,7.43,89,437,2435,12.2
21849,Peter Ihnacak,1991-92,34.0,10,18,26,26,2,16,18,30.0,,412,102,163,265,653.0,80,7.48,85,403,2430,12.3
21850,Peter Ihnacak,1992-93,35.0,11,2,5,5,0,2,2,5.0,,417,102,165,267,658.0,80,7.37,76,367,2421,12.2
21851,Peter Lappin,1992-93,27.0,4,0,6,6,0,0,0,8.0,,6,0,0,0,8.0,80,7.37,76,367,2421,12.2
21852,Peter Lappin,1994-95,29.0,5,0,1,1,0,0,0,2.0,,7,0,0,0,10.0,80,6.96,77,402,2440,11.4
21853,Peter Laviolette,1991-92,27.0,4,0,12,12,0,0,0,2.0,,12,0,0,0,2.0,80,7.48,85,403,2430,12.3
21854,Peter LeBlanc,2016-17,28.0,4,0,1,1,0,0,0,0.0,9.0,1,0,0,0,0.0,82,5.34,48,269,2463,8.9
21855,Peter LeBoutillier,1999-00,25.0,4,1,23,23,1,0,1,5.0,,23,1,0,1,5.0,82,5.83,55,336,2444,9.8
21856,Peter LeBoutillier,2000-01,26.0,5,2,12,12,1,1,2,6.0,,35,2,1,3,11.0,82,5.28,57,380,2242,9.6
21857,Peter Loob,1987-88,30.0,4,3,8,8,1,2,3,10.0,,8,1,2,3,10.0,80,7.77,71,321,2447,12.7
21858,Peter Marsh,1982-83,26.0,4,38,57,57,18,20,38,187.0,,57,18,20,38,187.0,80,7.03,61,280,2352,12.0
21859,Peter Marsh,1983-84,27.0,5,23,53,53,10,13,23,111.0,,110,28,33,61,298.0,80,7.69,77,340,2441,12.6
21860,Peter Marsh,1984-85,28.0,6,28,57,57,10,18,28,122.0,,167,38,51,89,420.0,80,8.03,73,320,2489,12.9
21861,Peter Marsh,1985-86,29.0,7,20,68,68,6,14,20,121.0,,235,44,65,109,541.0,80,7.73,71,310,2444,12.7
21862,Peter Marsh,1986-87,30.0,8,10,43,43,4,6,10,86.0,,278,48,71,119,627.0,80,7.89,74,336,2448,12.9
21863,Peter Mueller,2010-11,22.0,4,54,81,81,22,32,54,201.0,1398.0,81,22,32,54,201.0,82,5.44,62,351,2383,9.4
21864,Peter Mueller,2011-12,23.0,5,36,72,72,13,23,36,138.0,1158.0,153,35,55,90,339.0,82,5.7,65,341,2477,9.4
21865,Peter Mueller,2012-13,24.0,6,37,69,69,13,24,37,124.0,965.0,222,48,79,127,463.0,82,5.53,56,304,2486,9.1
21866,Peter Mueller,2014-15,26.0,7,16,32,32,7,9,16,82.0,469.0,254,55,88,143,545.0,82,5.32,47,271,2439,8.9
21867,Peter Mueller,2015-16,27.0,8,17,43,43,8,9,17,131.0,699.0,297,63,97,160,676.0,48,5.31,29,160,1399,9.1
21868,Peter Nordstrom,2001-02,27.0,4,0,2,2,0,0,0,0.0,16.0,2,0,0,0,0.0,82,5.27,57,359,2285,9.4
21869,Peter Olvecky,2011-12,26.0,4,7,31,31,2,5,7,19.0,277.0,31,2,5,7,19.0,82,5.7,65,341,2477,9.4
21870,Peter Olvecky,2012-13,27.0,5,0,1,1,0,0,0,0.0,8.0,32,2,5,7,19.0,82,5.53,56,304,2486,9.1
21871,Peter Popovic,1996-97,28.0,4,14,47,47,2,12,14,58.0,,47,2,12,14,58.0,84,6.48,76,407,2545,10.7
21872,Peter Popovic,1997-98,29.0,5,5,33,33,0,5,5,23.0,,80,2,17,19,81.0,48,5.97,37,209,1408,10.2
21873,Peter Popovic,1998-99,30.0,6,14,76,76,2,12,14,59.0,,156,4,29,33,140.0,82,6.29,74,413,2481,10.4
21874,Peter Popovic,1999-00,31.0,7,14,78,78,1,13,14,82.0,,234,5,42,47,222.0,82,5.83,55,336,2444,9.8
21875,Peter Popovic,2000-01,32.0,8,8,69,69,2,6,8,40.0,,303,7,48,55,262.0,82,5.28,57,380,2242,9.6
21876,Peter Popovic,2001-02,33.0,9,5,68,68,1,4,5,64.0,1406.0,371,8,52,60,326.0,82,5.27,57,359,2285,9.4
21877,Peter Popovic,2002-03,34.0,10,6,54,54,1,5,6,23.0,875.0,425,9,57,66,349.0,82,5.49,53,331,2294,9.8
21878,Peter Popovic,2003-04,35.0,11,7,60,60,1,6,7,34.0,1121.0,485,10,63,73,383.0,82,5.51,63,376,2272,9.9
21879,Peter Ratchuk,2001-02,24.0,4,2,24,24,1,1,2,34.0,334.0,24,1,1,2,34.0,82,5.27,57,359,2285,9.4
21880,Peter Ratchuk,2003-04,26.0,5,0,8,8,0,0,0,11.0,105.0,32,1,1,2,45.0,82,5.51,63,376,2272,9.9
21881,Peter Regin,2011-12,25.0,4,2,11,11,1,1,2,7.0,116.0,11,1,1,2,7.0,82,5.7,65,341,2477,9.4
21882,Peter Regin,2012-13,26.0,5,29,75,75,13,16,29,135.0,967.0,86,14,17,31,142.0,82,5.53,56,304,2486,9.1
21883,Peter Regin,2013-14,27.0,6,17,55,55,3,14,17,87.0,736.0,141,17,31,48,229.0,82,5.46,52,291,2492,9.0
21884,Peter Regin,2014-15,28.0,7,4,10,10,2,2,4,15.0,141.0,151,19,33,52,244.0,82,5.32,47,271,2439,8.9
21885,Peter Regin,2015-16,29.0,8,3,27,27,0,3,3,37.0,311.0,178,19,36,55,281.0,48,5.31,29,160,1399,9.1
21886,Peter Regin,2016-17,30.0,9,11,61,61,4,7,11,69.0,698.0,239,23,43,66,350.0,82,5.34,48,269,2463,8.9
21887,Peter Regin,2017-18,31.0,10,1,4,4,0,1,1,3.0,33.0,243,23,44,67,353.0,82,5.32,47,251,2453,8.9
21888,Peter Sarno,2006-07,27.0,4,1,6,6,1,0,1,5.0,62.0,6,1,0,1,5.0,82,5.14,57,348,2300,9.2
21889,Peter Sarno,2008-09,29.0,5,0,1,1,0,0,0,0.0,11.0,7,1,0,1,5.0,82,6.05,85,480,2458,10.1
21890,Peter Schaefer,2001-02,24.0,4,8,25,25,4,4,8,24.0,334.0,25,4,4,8,24.0,82,5.27,57,359,2285,9.4
21891,Peter Schaefer,2002-03,25.0,5,31,71,71,16,15,31,101.0,1098.0,96,20,19,39,125.0,82,5.49,53,331,2294,9.8
21892,Peter Schaefer,2003-04,26.0,6,36,82,82,16,20,36,163.0,1337.0,178,36,39,75,288.0,82,5.51,63,376,2272,9.9
21893,Peter Schaefer,2005-06,28.0,7,23,75,75,6,17,23,93.0,1124.0,253,42,56,98,381.0,82,5.31,60,363,2326,9.4
21894,Peter Schaefer,2006-07,29.0,8,39,81,81,15,24,39,112.0,1264.0,334,57,80,137,493.0,82,5.14,57,348,2300,9.2
21895,Peter Schaefer,2008-09,31.0,9,50,82,82,20,30,50,137.0,1297.0,416,77,110,187,630.0,82,6.05,85,480,2458,10.1
21896,Peter Schaefer,2009-10,32.0,10,46,77,77,12,34,46,132.0,1288.0,493,89,144,233,762.0,82,5.76,70,398,2426,9.7
21897,Peter Schaefer,2010-11,33.0,11,26,63,63,9,17,26,91.0,943.0,556,98,161,259,853.0,82,5.44,62,351,2383,9.4
21898,Peter Schaefer,2013-14,36.0,12,2,16,16,1,1,2,10.0,155.0,572,99,162,261,863.0,82,5.46,52,291,2492,9.0
21899,Peter Sejna,2005-06,26.0,4,1,1,1,1,0,1,3.0,15.0,1,1,0,1,3.0,82,5.31,60,363,2326,9.4
21900,Peter Sejna,2006-07,27.0,5,4,20,20,2,2,4,36.0,299.0,21,3,2,5,39.0,82,5.14,57,348,2300,9.2
21901,Peter Sejna,2008-09,29.0,6,2,6,6,1,1,2,9.0,70.0,27,4,3,7,48.0,82,6.05,85,480,2458,10.1
21902,Peter Sejna,2009-10,30.0,7,4,22,22,3,1,4,34.0,220.0,49,7,4,11,82.0,82,5.76,70,398,2426,9.7
21903,Peter Smrek,2003-04,24.0,4,5,20,20,2,3,5,14.0,313.0,20,2,3,5,14.0,82,5.51,63,376,2272,9.9
21904,Peter Smrek,2004-05,25.0,5,1,8,8,0,1,1,2.0,116.0,28,2,4,6,16.0,82,5.24,53,338,2262,9.5
21905,Peter Stastny,1983-84,27.0,4,109,77,77,39,70,109,232.0,,77,39,70,109,232.0,80,7.69,77,340,2441,12.6
21906,Peter Stastny,1984-85,28.0,5,139,80,80,46,93,139,227.0,,157,85,163,248,459.0,80,8.03,73,320,2489,12.9
21907,Peter Stastny,1985-86,29.0,6,124,75,75,47,77,124,201.0,,232,132,240,372,660.0,80,7.73,71,310,2444,12.7
21908,Peter Stastny,1986-87,30.0,7,119,80,80,46,73,119,189.0,,312,178,313,491,849.0,80,7.89,74,336,2448,12.9
21909,Peter Stastny,1987-88,31.0,8,100,75,75,32,68,100,208.0,,387,210,381,591,1057.0,80,7.77,71,321,2447,12.7
21910,Peter Stastny,1988-89,32.0,9,122,76,76,41,81,122,207.0,,463,251,462,713,1264.0,80,7.94,82,370,2484,12.8
21911,Peter Stastny,1989-90,33.0,10,77,64,64,24,53,77,156.0,,527,275,515,790,1420.0,80,7.34,72,344,2400,12.2
21912,Peter Stastny,1990-91,34.0,11,111,76,76,46,65,111,199.0,,603,321,580,901,1619.0,80,7.43,89,437,2435,12.2
21913,Peter Stastny,1991-92,35.0,12,85,72,72,35,50,85,195.0,,675,356,630,986,1814.0,80,7.48,85,403,2430,12.3
21914,Peter Stastny,1992-93,36.0,13,73,74,74,29,44,73,156.0,,749,385,674,1059,1970.0,80,7.37,76,367,2421,12.2
21915,Peter Stastny,1993-94,37.0,14,60,77,77,18,42,60,117.0,,826,403,716,1119,2087.0,80,6.91,71,366,2385,11.6
21916,Peter Stastny,1994-95,38.0,15,62,66,66,24,38,62,142.0,,892,427,754,1181,2229.0,80,6.96,77,402,2440,11.4
21917,Peter Stastny,1995-96,39.0,16,40,62,62,17,23,40,106.0,,954,444,777,1221,2335.0,84,7.25,87,443,2603,11.7
21918,Peter Stastny,1996-97,40.0,17,16,17,17,5,11,16,30.0,,971,449,788,1237,2365.0,84,6.48,76,407,2545,10.7
21919,Peter Stastny,1997-98,41.0,18,2,6,6,1,1,2,9.0,,977,450,789,1239,2374.0,48,5.97,37,209,1408,10.2
21920,Peter Sturgeon,1982-83,28.0,4,0,2,2,0,0,0,1.0,,2,0,0,0,1.0,80,7.03,61,280,2352,12.0
21921,Peter Sturgeon,1983-84,29.0,5,1,4,4,0,1,1,4.0,,6,0,1,1,5.0,80,7.69,77,340,2441,12.6
21922,Peter Sullivan,1982-83,31.0,4,59,79,79,24,35,59,166.0,,79,24,35,59,166.0,80,7.03,61,280,2352,12.0
21923,Peter Sullivan,1983-84,32.0,5,23,47,47,4,19,23,42.0,,126,28,54,82,208.0,80,7.69,77,340,2441,12.6
21924,Peter Sundstrom,1986-87,25.0,4,44,77,77,22,22,44,148.0,,77,22,22,44,148.0,80,7.89,74,336,2448,12.9
21925,Peter Sundstrom,1987-88,26.0,5,43,76,76,18,25,43,161.0,,153,40,47,87,309.0,80,7.77,71,321,2447,12.7
21926,Peter Sundstrom,1988-89,27.0,6,23,53,53,8,15,23,63.0,,206,48,62,110,372.0,80,7.94,82,370,2484,12.8
21927,Peter Sundstrom,1990-91,29.0,7,25,76,76,8,17,25,89.0,,282,56,79,135,461.0,80,7.43,89,437,2435,12.2
21928,Peter Sundstrom,1991-92,30.0,8,6,35,35,4,2,6,39.0,,317,60,81,141,500.0,80,7.48,85,403,2430,12.3
21929,Peter Sundstrom,1992-93,31.0,9,3,21,21,1,2,3,16.0,,338,61,83,144,516.0,80,7.37,76,367,2421,12.2
21930,Peter Taglianetti,1987-88,24.0,4,0,1,1,0,0,0,2.0,,1,0,0,0,2.0,80,7.77,71,321,2447,12.7
21931,Peter Taglianetti,1988-89,25.0,5,0,18,18,0,0,0,8.0,,19,0,0,0,10.0,80,7.94,82,370,2484,12.8
21932,Peter Taglianetti,1989-90,26.0,6,0,3,3,0,0,0,2.0,,22,0,0,0,12.0,80,7.34,72,344,2400,12.2
21933,Peter Taglianetti,1990-91,27.0,7,23,70,70,6,17,23,92.0,,92,6,17,23,104.0,80,7.43,89,437,2435,12.2
21934,Peter Taglianetti,1991-92,28.0,8,15,66,66,1,14,15,72.0,,158,7,31,38,176.0,80,7.48,85,403,2430,12.3
21935,Peter Taglianetti,1992-93,29.0,9,9,49,49,3,6,9,57.0,,207,10,37,47,233.0,80,7.37,76,367,2421,12.2
21936,Peter Taglianetti,1993-94,30.0,10,12,55,55,3,9,12,40.0,,262,13,46,59,273.0,80,6.91,71,366,2385,11.6
21937,Peter Taglianetti,1994-95,31.0,11,4,44,44,1,3,4,23.0,,306,14,49,63,296.0,80,6.96,77,402,2440,11.4
21938,Peter Taglianetti,1995-96,32.0,12,14,72,72,2,12,14,78.0,,378,16,61,77,374.0,84,7.25,87,443,2603,11.7
21939,Peter Taglianetti,1996-97,33.0,13,14,60,60,2,12,14,57.0,,438,18,73,91,431.0,84,6.48,76,407,2545,10.7
21940,Peter Taglianetti,1997-98,34.0,14,1,13,13,0,1,1,5.0,,451,18,74,92,436.0,48,5.97,37,209,1408,10.2
21941,Peter Vandermeer,2010-11,35.0,4,0,2,2,0,0,0,0.0,15.0,2,0,0,0,0.0,82,5.44,62,351,2383,9.4
21942,Peter Wallin,1983-84,26.0,4,6,12,12,1,5,6,14.0,,12,1,5,6,14.0,80,7.69,77,340,2441,12.6
21943,Peter Wallin,1984-85,27.0,5,11,40,40,2,9,11,49.0,,52,3,14,17,63.0,80,8.03,73,320,2489,12.9
21944,Peter White,1996-97,27.0,4,8,26,26,3,5,8,17.0,,26,3,5,8,17.0,84,6.48,76,407,2545,10.7
21945,Peter White,1997-98,28.0,5,6,9,9,2,4,6,13.0,,35,5,9,14,30.0,48,5.97,37,209,1408,10.2
21946,Peter White,1998-99,29.0,6,8,27,27,5,3,8,34.0,,62,10,12,22,64.0,82,6.29,74,413,2481,10.4
21947,Peter White,2001-02,32.0,7,0,3,3,0,0,0,0.0,6.0,65,10,12,22,64.0,82,5.27,57,359,2285,9.4
21948,Peter White,2002-03,33.0,8,6,21,21,1,5,6,24.0,274.0,86,11,17,28,88.0,82,5.49,53,331,2294,9.8
21949,Peter White,2003-04,34.0,9,25,77,77,9,16,25,68.0,995.0,163,20,33,53,156.0,82,5.51,63,376,2272,9.9
21950,Peter White,2004-05,35.0,10,6,48,48,3,3,6,21.0,505.0,211,23,36,59,177.0,82,5.24,53,338,2262,9.5
21951,Peter White,2005-06,36.0,11,1,6,6,0,1,1,2.0,54.0,217,23,37,60,179.0,82,5.31,60,363,2326,9.4
21952,Peter White,2006-07,37.0,12,0,3,3,0,0,0,2.0,19.0,220,23,37,60,181.0,82,5.14,57,348,2300,9.2
21953,Peter Worrell,2000-01,23.0,4,0,19,19,0,0,0,15.0,,19,0,0,0,15.0,82,5.28,57,380,2242,9.6
21954,Peter Worrell,2001-02,24.0,5,9,62,62,4,5,9,50.0,388.0,81,4,5,9,65.0,82,5.27,57,359,2285,9.4
21955,Peter Worrell,2002-03,25.0,6,9,48,48,3,6,9,45.0,404.0,129,7,11,18,110.0,82,5.49,53,331,2294,9.8
21956,Peter Worrell,2003-04,26.0,7,10,71,71,3,7,10,86.0,672.0,200,10,18,28,196.0,82,5.51,63,376,2272,9.9
21957,Peter Worrell,2004-05,27.0,8,9,79,79,4,5,9,65.0,691.0,279,14,23,37,261.0,82,5.24,53,338,2262,9.5
21958,Peter Worrell,2005-06,28.0,9,5,63,63,2,3,5,52.0,583.0,342,16,26,42,313.0,82,5.31,60,363,2326,9.4
21959,Peter Worrell,2006-07,29.0,10,4,49,49,3,1,4,32.0,290.0,391,19,27,46,345.0,82,5.14,57,348,2300,9.2
21960,Peter Zezel,1987-88,22.0,4,60,65,65,15,45,60,93.0,,65,15,45,60,93.0,80,7.77,71,321,2447,12.7
21961,Peter Zezel,1988-89,23.0,5,54,79,79,17,37,54,146.0,,144,32,82,114,239.0,80,7.94,82,370,2484,12.8
21962,Peter Zezel,1989-90,24.0,6,72,71,71,33,39,72,181.0,,215,65,121,186,420.0,80,7.34,72,344,2400,12.2
21963,Peter Zezel,1990-91,25.0,7,57,69,69,22,35,57,133.0,,284,87,156,243,553.0,80,7.43,89,437,2435,12.2
21964,Peter Zezel,1991-92,26.0,8,70,78,78,21,49,70,149.0,,362,108,205,313,702.0,80,7.48,85,403,2430,12.3
21965,Peter Zezel,1992-93,27.0,9,72,73,73,25,47,72,158.0,,435,133,252,385,860.0,80,7.37,76,367,2421,12.2
21966,Peter Zezel,1993-94,28.0,10,40,52,52,21,19,40,90.0,,487,154,271,425,950.0,80,6.91,71,366,2385,11.6
21967,Peter Zezel,1994-95,29.0,11,49,64,64,16,33,49,125.0,,551,170,304,474,1075.0,80,6.96,77,402,2440,11.4
21968,Peter Zezel,1995-96,30.0,12,35,70,70,12,23,35,102.0,,621,182,327,509,1177.0,84,7.25,87,443,2603,11.7
21969,Peter Zezel,1996-97,31.0,13,16,41,41,8,8,16,47.0,,662,190,335,525,1224.0,84,6.48,76,407,2545,10.7
21970,Peter Zezel,1997-98,32.0,14,11,30,30,6,5,11,47.0,,692,196,340,536,1271.0,48,5.97,37,209,1408,10.2
21971,Peter Zezel,1998-99,33.0,15,21,57,57,8,13,21,87.0,,749,204,353,557,1358.0,82,6.29,74,413,2481,10.4
21972,Peter Zezel,1999-00,34.0,16,16,53,53,4,12,16,62.0,,802,208,365,573,1420.0,82,5.83,55,336,2444,9.8
21973,Peter Zezel,2000-01,35.0,17,20,30,30,5,15,20,40.0,,832,213,380,593,1460.0,82,5.28,57,380,2242,9.6
21974,Peter Zezel,2001-02,36.0,18,14,41,41,6,8,14,45.0,538.0,873,219,388,607,1505.0,82,5.27,57,359,2285,9.4
21975,Petr Buzek,2000-01,23.0,4,0,2,2,0,0,0,0.0,,2,0,0,0,0.0,82,5.28,57,380,2242,9.6
21976,Petr Buzek,2001-02,24.0,5,0,2,2,0,0,0,0.0,28.0,4,0,0,0,0.0,82,5.27,57,359,2285,9.4
21977,Petr Buzek,2002-03,25.0,6,19,63,63,5,14,19,90.0,1159.0,67,5,14,19,90.0,82,5.49,53,331,2294,9.8
21978,Petr Buzek,2003-04,26.0,7,0,5,5,0,0,0,11.0,87.0,72,5,14,19,101.0,82,5.51,63,376,2272,9.9
21979,Petr Buzek,2004-05,27.0,8,4,41,41,1,3,4,36.0,694.0,113,6,17,23,137.0,82,5.24,53,338,2262,9.5
21980,Petr Buzek,2005-06,28.0,9,8,44,44,3,5,8,48.0,632.0,157,9,22,31,185.0,82,5.31,60,363,2326,9.4
21981,Petr Cajanek,2005-06,30.0,4,38,51,51,9,29,38,90.0,812.0,51,9,29,38,90.0,82,5.31,60,363,2326,9.4
21982,Petr Cajanek,2006-07,31.0,5,26,70,70,12,14,26,126.0,1246.0,121,21,43,64,216.0,82,5.14,57,348,2300,9.2
21983,Petr Cajanek,2008-09,33.0,6,41,71,71,10,31,41,150.0,1340.0,192,31,74,105,366.0,82,6.05,85,480,2458,10.1
21984,Petr Cajanek,2009-10,34.0,7,48,77,77,15,33,48,167.0,1251.0,269,46,107,153,533.0,82,5.76,70,398,2426,9.7
21985,Petr Hubacek,2003-04,24.0,4,1,6,6,1,0,1,5.0,68.0,6,1,0,1,5.0,82,5.51,63,376,2272,9.9
21986,Petr Kalus,2009-10,22.0,4,5,9,9,4,1,5,8.0,101.0,9,4,1,5,8.0,82,5.76,70,398,2426,9.7
21987,Petr Kalus,2012-13,25.0,5,0,2,2,0,0,0,0.0,15.0,11,4,1,5,8.0,82,5.53,56,304,2486,9.1
21988,Petr Kanko,2008-09,24.0,4,1,10,10,1,0,1,7.0,47.0,10,1,0,1,7.0,82,6.05,85,480,2458,10.1
21989,Petr Klima,1988-89,24.0,4,56,74,74,32,24,56,178.0,,74,32,24,56,178.0,80,7.94,82,370,2484,12.8
21990,Petr Klima,1989-90,25.0,5,53,77,77,30,23,53,210.0,,151,62,47,109,388.0,80,7.34,72,344,2400,12.2
21991,Petr Klima,1990-91,26.0,6,62,78,78,37,25,62,174.0,,229,99,72,171,562.0,80,7.43,89,437,2435,12.2
21992,Petr Klima,1991-92,27.0,7,41,51,51,25,16,41,145.0,,280,124,88,212,707.0,80,7.48,85,403,2430,12.3
21993,Petr Klima,1992-93,28.0,8,63,76,76,30,33,63,186.0,,356,154,121,275,893.0,80,7.37,76,367,2421,12.2
21994,Petr Klima,1993-94,29.0,9,68,70,70,40,28,68,204.0,,426,194,149,343,1097.0,80,6.91,71,366,2385,11.6
21995,Petr Klima,1994-95,30.0,10,34,57,57,21,13,34,107.0,,483,215,162,377,1204.0,80,6.96,77,402,2440,11.4
21996,Petr Klima,1995-96,31.0,11,48,68,68,32,16,48,175.0,,551,247,178,425,1379.0,84,7.25,87,443,2603,11.7
21997,Petr Klima,1996-97,32.0,12,55,75,75,28,27,55,167.0,,626,275,205,480,1546.0,84,6.48,76,407,2545,10.7
21998,Petr Klima,1997-98,33.0,13,26,47,47,13,13,26,75.0,,673,288,218,506,1621.0,48,5.97,37,209,1408,10.2
21999,Petr Klima,1998-99,34.0,14,52,67,67,22,30,52,164.0,,740,310,248,558,1785.0,82,6.29,74,413,2481,10.4
22000,Petr Klima,1999-00,35.0,15,14,33,33,2,12,14,55.0,,773,312,260,572,1840.0,82,5.83,55,336,2444,9.8
22001,Petr Klima,2001-02,37.0,16,1,13,13,1,0,1,12.0,78.0,786,313,260,573,1852.0,82,5.27,57,359,2285,9.4
22002,Petr Mika,2002-03,23.0,4,0,3,3,0,0,0,1.0,14.0,3,0,0,0,1.0,82,5.49,53,331,2294,9.8
22003,Petr Nedved,1993-94,22.0,4,16,61,61,10,6,16,97.0,,61,10,6,16,97.0,80,6.91,71,366,2385,11.6
22004,Petr Nedved,1994-95,23.0,5,37,77,77,15,22,37,99.0,,138,25,28,53,196.0,80,6.96,77,402,2440,11.4
22005,Petr Nedved,1995-96,24.0,6,71,84,84,38,33,71,149.0,,222,63,61,124,345.0,84,7.25,87,443,2603,11.7
22006,Petr Nedved,1996-97,25.0,7,20,19,19,6,14,20,63.0,,241,69,75,144,408.0,84,6.48,76,407,2545,10.7
22007,Petr Nedved,1997-98,26.0,8,23,46,46,11,12,23,123.0,,287,80,87,167,531.0,48,5.97,37,209,1408,10.2
22008,Petr Nedved,1998-99,27.0,9,99,80,80,45,54,99,204.0,,367,125,141,266,735.0,82,6.29,74,413,2481,10.4
22009,Petr Nedved,1999-00,28.0,10,71,74,74,33,38,71,189.0,,441,158,179,337,924.0,82,5.83,55,336,2444,9.8
22010,Petr Nedved,2001-02,30.0,11,47,56,56,20,27,47,153.0,1149.0,497,178,206,384,1077.0,82,5.27,57,359,2285,9.4
22011,Petr Nedved,2002-03,31.0,12,68,76,76,24,44,68,201.0,1513.0,573,202,250,452,1278.0,82,5.49,53,331,2294,9.8
22012,Petr Nedved,2003-04,32.0,13,78,79,79,32,46,78,230.0,1602.0,652,234,296,530,1508.0,82,5.51,63,376,2272,9.9
22013,Petr Nedved,2004-05,33.0,14,46,78,78,21,25,46,175.0,1510.0,730,255,321,576,1683.0,82,5.24,53,338,2262,9.5
22014,Petr Nedved,2005-06,34.0,15,58,78,78,27,31,58,205.0,1587.0,808,282,352,634,1888.0,82,5.31,60,363,2326,9.4
22015,Petr Nedved,2006-07,35.0,16,46,81,81,19,27,46,190.0,1517.0,889,301,379,680,2078.0,82,5.14,57,348,2300,9.2
22016,Petr Nedved,2008-09,37.0,17,25,53,53,7,18,25,90.0,891.0,942,308,397,705,2168.0,82,6.05,85,480,2458,10.1
22017,Petr Nedved,2009-10,38.0,18,12,40,40,2,10,12,39.0,592.0,982,310,407,717,2207.0,82,5.76,70,398,2426,9.7
22018,Petr Prajsler,1990-91,25.0,4,0,7,7,0,0,0,2.0,,7,0,0,0,2.0,80,7.43,89,437,2435,12.2
22019,Petr Prajsler,1991-92,26.0,5,3,2,2,0,3,3,1.0,,9,0,3,3,3.0,80,7.48,85,403,2430,12.3
22020,Petr Prajsler,1992-93,27.0,6,10,34,34,3,7,10,49.0,,43,3,10,13,52.0,80,7.37,76,367,2421,12.2
22021,Petr Prajsler,1994-95,29.0,7,0,3,3,0,0,0,3.0,,46,3,10,13,55.0,80,6.96,77,402,2440,11.4
22022,Petr Prucha,2008-09,26.0,4,47,68,68,30,17,47,130.0,931.0,68,30,17,47,130.0,82,6.05,85,480,2458,10.1
22023,Petr Prucha,2009-10,27.0,5,40,79,79,22,18,40,136.0,1027.0,147,52,35,87,266.0,82,5.76,70,398,2426,9.7
22024,Petr Prucha,2010-11,28.0,6,17,62,62,7,10,17,89.0,722.0,209,59,45,104,355.0,82,5.44,62,351,2383,9.4
22025,Petr Prucha,2011-12,29.0,7,19,47,47,6,13,19,67.0,690.0,256,65,58,123,422.0,82,5.7,65,341,2477,9.4
22026,Petr Prucha,2012-13,30.0,8,22,79,79,13,9,22,128.0,1109.0,335,78,67,145,550.0,82,5.53,56,304,2486,9.1
22027,Petr Prucha,2013-14,31.0,9,1,11,11,0,1,1,10.0,126.0,346,78,68,146,560.0,82,5.46,52,291,2492,9.0
22028,Petr Schastlivy,2002-03,23.0,4,7,13,13,2,5,7,22.0,160.0,13,2,5,7,22.0,82,5.49,53,331,2294,9.8
22029,Petr Schastlivy,2003-04,24.0,5,5,17,17,3,2,5,32.0,193.0,30,5,7,12,54.0,82,5.51,63,376,2272,9.9
22030,Petr Schastlivy,2004-05,25.0,6,1,1,1,0,1,1,0.0,3.0,31,5,8,13,54.0,82,5.24,53,338,2262,9.5
22031,Petr Schastlivy,2005-06,26.0,7,19,33,33,9,10,19,68.0,440.0,64,14,18,32,122.0,82,5.31,60,363,2326,9.4
22032,Petr Schastlivy,2006-07,27.0,8,8,65,65,4,4,8,85.0,660.0,129,18,22,40,207.0,82,5.14,57,348,2300,9.2
22033,Petr Straka,2017-18,25.0,4,2,3,3,0,2,2,2.0,28.0,3,0,2,2,2.0,82,5.32,47,251,2453,8.9
22034,Petr Svoboda,1987-88,21.0,4,31,73,73,4,27,31,81.0,,73,4,27,31,81.0,80,7.77,71,321,2447,12.7
22035,Petr Svoboda,1988-89,22.0,5,19,73,73,1,18,19,60.0,,146,5,45,50,141.0,80,7.94,82,370,2484,12.8
22036,Petr Svoboda,1989-90,23.0,6,22,70,70,5,17,22,79.0,,216,10,62,72,220.0,80,7.34,72,344,2400,12.2
22037,Petr Svoboda,1990-91,24.0,7,29,69,69,7,22,29,138.0,,285,17,84,101,358.0,80,7.43,89,437,2435,12.2
22038,Petr Svoboda,1991-92,25.0,8,45,71,71,8,37,45,131.0,,356,25,121,146,489.0,80,7.48,85,403,2430,12.3
22039,Petr Svoboda,1992-93,26.0,9,36,60,60,5,31,36,90.0,,416,30,152,182,579.0,80,7.37,76,367,2421,12.2
22040,Petr Svoboda,1993-94,27.0,10,26,60,60,4,22,26,67.0,,476,34,174,208,646.0,80,6.91,71,366,2385,11.6
22041,Petr Svoboda,1994-95,28.0,11,28,71,71,6,22,28,111.0,,547,40,196,236,757.0,80,6.96,77,402,2440,11.4
22042,Petr Svoboda,1995-96,29.0,12,26,40,40,2,24,26,61.0,,587,42,220,262,818.0,84,7.25,87,443,2603,11.7
22043,Petr Svoboda,1996-97,30.0,13,16,60,60,2,14,16,80.0,,647,44,234,278,898.0,84,6.48,76,407,2545,10.7
22044,Petr Svoboda,1997-98,31.0,14,8,37,37,0,8,8,39.0,,684,44,242,286,937.0,48,5.97,37,209,1408,10.2
22045,Petr Svoboda,1998-99,32.0,15,29,73,73,1,28,29,91.0,,757,45,270,315,1028.0,82,6.29,74,413,2481,10.4
22046,Petr Svoboda,1999-00,33.0,16,14,67,67,2,12,14,36.0,,824,47,282,329,1064.0,82,5.83,55,336,2444,9.8
22047,Petr Svoboda,2000-01,34.0,17,18,56,56,3,15,18,44.0,,880,50,297,347,1108.0,82,5.28,57,380,2242,9.6
22048,Petr Svoboda,2001-02,35.0,18,23,59,59,5,18,23,83.0,1375.0,939,55,315,370,1191.0,82,5.27,57,359,2285,9.4
22049,Petr Svoboda,2002-03,36.0,19,25,70,70,2,23,25,93.0,1610.0,1009,57,338,395,1284.0,82,5.49,53,331,2294,9.8
22050,Petr Svoboda,2003-04,37.0,20,4,19,19,1,3,4,16.0,357.0,1028,58,341,399,1300.0,82,5.51,63,376,2272,9.9
22051,Petr Svoboda0,2003-04,23.0,4,3,18,18,1,2,3,17.0,269.0,18,1,2,3,17.0,82,5.51,63,376,2272,9.9
22052,Petr Sykora,1998-99,22.0,4,42,63,63,18,24,42,128.0,,63,18,24,42,128.0,82,6.29,74,413,2481,10.4
22053,Petr Sykora,1999-00,23.0,5,3,19,19,1,2,3,26.0,,82,19,26,45,154.0,82,5.83,55,336,2444,9.8
22054,Petr Sykora,2000-01,24.0,6,36,58,58,16,20,36,130.0,,140,35,46,81,284.0,82,5.28,57,380,2242,9.6
22055,Petr Sykora,2001-02,25.0,7,72,80,80,29,43,72,222.0,1299.0,220,64,89,153,506.0,82,5.27,57,359,2285,9.4
22056,Petr Sykora,2002-03,26.0,8,68,79,79,25,43,68,222.0,1351.0,299,89,132,221,728.0,82,5.49,53,331,2294,9.8
22057,Petr Sykora,2003-04,27.0,9,81,73,73,35,46,81,249.0,1295.0,372,124,178,302,977.0,82,5.51,63,376,2272,9.9
22058,Petr Sykora,2004-05,28.0,10,48,73,73,21,27,48,194.0,1303.0,445,145,205,350,1171.0,82,5.24,53,338,2262,9.5
22059,Petr Sykora,2005-06,29.0,11,59,82,82,34,25,59,299.0,1515.0,527,179,230,409,1470.0,82,5.31,60,363,2326,9.4
22060,Petr Sykora,2006-07,30.0,12,52,81,81,23,29,52,277.0,1455.0,608,202,259,461,1747.0,82,5.14,57,348,2300,9.2
22061,Petr Sykora,2008-09,32.0,13,51,74,74,23,28,51,230.0,1191.0,682,225,287,512,1977.0,82,6.05,85,480,2458,10.1
22062,Petr Sykora,2009-10,33.0,14,53,82,82,22,31,53,206.0,1366.0,764,247,318,565,2183.0,82,5.76,70,398,2426,9.7
22063,Petr Sykora,2010-11,34.0,15,63,81,81,28,35,63,201.0,1365.0,845,275,353,628,2384.0,82,5.44,62,351,2383,9.4
22064,Petr Sykora,2011-12,35.0,16,46,76,76,25,21,46,180.0,1238.0,921,300,374,674,2564.0,82,5.7,65,341,2477,9.4
22065,Petr Sykora,2012-13,36.0,17,3,14,14,2,1,3,13.0,168.0,935,302,375,677,2577.0,82,5.53,56,304,2486,9.1
22066,Petr Sykora,2014-15,38.0,18,44,82,82,21,23,44,170.0,1304.0,1017,323,398,721,2747.0,82,5.32,47,271,2439,8.9
22067,Petr Sykora0,2001-02,23.0,4,0,2,2,0,0,0,2.0,17.0,2,0,0,0,2.0,82,5.27,57,359,2285,9.4
22068,Petr Sykora0,2008-09,30.0,5,4,10,10,2,2,4,9.0,107.0,12,2,2,4,11.0,82,6.05,85,480,2458,10.1
22069,Petr Taticek,2008-09,25.0,4,0,3,3,0,0,0,3.0,18.0,3,0,0,0,3.0,82,6.05,85,480,2458,10.1
22070,Petr Tenkrat,2003-04,26.0,4,14,46,46,5,9,14,79.0,589.0,46,5,9,14,79.0,82,5.51,63,376,2272,9.9
22071,Petr Tenkrat,2004-05,27.0,5,24,67,67,8,16,24,95.0,802.0,113,13,25,38,174.0,82,5.24,53,338,2262,9.5
22072,Petr Tenkrat,2009-10,32.0,6,14,64,64,9,5,14,82.0,801.0,177,22,30,52,256.0,82,5.76,70,398,2426,9.7
22073,Petr Vrana,2011-12,26.0,4,1,16,16,1,0,1,6.0,110.0,16,1,0,1,6.0,82,5.7,65,341,2477,9.4
22074,Petri Kontiola,2010-11,26.0,4,5,12,12,0,5,5,13.0,175.0,12,0,5,5,13.0,82,5.44,62,351,2383,9.4
22075,Petri Skriko,1987-88,25.0,4,35,72,72,21,14,35,156.0,,72,21,14,35,156.0,80,7.77,71,321,2447,12.7
22076,Petri Skriko,1988-89,26.0,5,78,80,80,38,40,78,191.0,,152,59,54,113,347.0,80,7.94,82,370,2484,12.8
22077,Petri Skriko,1989-90,27.0,6,74,76,76,33,41,74,224.0,,228,92,95,187,571.0,80,7.34,72,344,2400,12.2
22078,Petri Skriko,1990-91,28.0,7,64,73,73,30,34,64,172.0,,301,122,129,251,743.0,80,7.43,89,437,2435,12.2
22079,Petri Skriko,1991-92,29.0,8,66,74,74,30,36,66,204.0,,375,152,165,317,947.0,80,7.48,85,403,2430,12.3
22080,Petri Skriko,1992-93,30.0,9,48,77,77,15,33,48,172.0,,452,167,198,365,1119.0,80,7.37,76,367,2421,12.2
22081,Petri Skriko,1993-94,31.0,10,27,48,48,9,18,27,120.0,,500,176,216,392,1239.0,80,6.91,71,366,2385,11.6
22082,Petri Skriko,1994-95,32.0,11,6,24,24,3,3,6,47.0,,524,179,219,398,1286.0,80,6.96,77,402,2440,11.4
22083,Petri Skriko,1995-96,33.0,12,7,17,17,4,3,7,35.0,,541,183,222,405,1321.0,84,7.25,87,443,2603,11.7
22084,Petri Varis,2000-01,31.0,4,0,1,1,0,0,0,0.0,,1,0,0,0,0.0,82,5.28,57,380,2242,9.6
22085,Petter Granberg,2016-17,24.0,4,0,1,1,0,0,0,0.0,12.0,1,0,0,0,0.0,82,5.34,48,269,2463,8.9
22086,Petter Granberg,2017-18,25.0,5,0,7,7,0,0,0,1.0,80.0,8,0,0,0,1.0,82,5.32,47,251,2453,8.9
22087,Petter Granberg,2018-19,26.0,6,2,27,27,0,2,2,12.0,370.0,35,0,2,2,13.0,82,5.34,48,255,2438,9.0
22088,Petter Granberg,2019-20,27.0,7,0,10,10,0,0,0,4.0,96.0,45,0,2,2,17.0,82,5.45,47,245,2478,9.0
22089,Petteri Lehto,1987-88,26.0,4,0,6,6,0,0,0,5.0,,6,0,0,0,5.0,80,7.77,71,321,2447,12.7
22090,Petteri Lindbohm,2017-18,24.0,4,3,23,23,2,1,3,32.0,358.0,23,2,1,3,32.0,82,5.32,47,251,2453,8.9
22091,Petteri Lindbohm,2018-19,25.0,5,0,10,10,0,0,0,9.0,138.0,33,2,1,3,41.0,82,5.34,48,255,2438,9.0
22092,Petteri Lindbohm,2019-20,26.0,6,0,7,7,0,0,0,10.0,91.0,40,2,1,3,51.0,82,5.45,47,245,2478,9.0
22093,Petteri Nokelainen,2008-09,23.0,4,2,15,15,1,1,2,13.0,117.0,15,1,1,2,13.0,82,6.05,85,480,2458,10.1
22094,Petteri Nokelainen,2010-11,25.0,5,10,57,57,7,3,10,40.0,472.0,72,8,4,12,53.0,82,5.44,62,351,2383,9.4
22095,Petteri Nokelainen,2011-12,26.0,6,9,50,50,4,5,9,56.0,563.0,122,12,9,21,109.0,82,5.7,65,341,2477,9.4
22096,Petteri Nokelainen,2012-13,27.0,7,13,67,67,5,8,13,88.0,823.0,189,17,17,34,197.0,82,5.53,56,304,2486,9.1
22097,Petteri Nokelainen,2014-15,29.0,8,7,56,56,3,4,7,37.0,493.0,245,20,21,41,234.0,82,5.32,47,271,2439,8.9
22098,Petteri Nummelin,2003-04,31.0,4,16,61,61,4,12,16,99.0,1051.0,61,4,12,16,99.0,82,5.51,63,376,2272,9.9
22099,Petteri Nummelin,2009-10,37.0,5,20,51,51,3,17,20,69.0,1035.0,112,7,29,36,168.0,82,5.76,70,398,2426,9.7
22100,Petteri Nummelin,2010-11,38.0,6,9,27,27,2,7,9,31.0,414.0,139,9,36,45,199.0,82,5.44,62,351,2383,9.4
22101,Petteri Wirtanen,2010-11,24.0,4,1,3,3,1,0,1,1.0,13.0,3,1,0,1,1.0,82,5.44,62,351,2383,9.4
22102,Phil Bourque,1986-87,24.0,4,1,5,5,0,1,1,6.0,,5,0,1,1,6.0,80,7.89,74,336,2448,12.9
22103,Phil Bourque,1988-89,26.0,5,0,4,4,0,0,0,0.0,,9,0,1,1,6.0,80,7.94,82,370,2484,12.8
22104,Phil Bourque,1989-90,27.0,6,5,22,22,2,3,5,23.0,,31,2,4,6,29.0,80,7.34,72,344,2400,12.2
22105,Phil Bourque,1990-91,28.0,7,16,21,21,4,12,16,56.0,,52,6,16,22,85.0,80,7.43,89,437,2435,12.2
22106,Phil Bourque,1991-92,29.0,8,43,80,80,17,26,43,153.0,,132,23,42,65,238.0,80,7.48,85,403,2430,12.3
22107,Phil Bourque,1992-93,30.0,9,39,76,76,22,17,39,110.0,,208,45,59,104,348.0,80,7.37,76,367,2421,12.2
22108,Phil Bourque,1993-94,31.0,10,34,78,78,20,14,34,122.0,,286,65,73,138,470.0,80,6.91,71,366,2385,11.6
22109,Phil Bourque,1994-95,32.0,11,26,58,58,10,16,26,51.0,,344,75,89,164,521.0,80,6.96,77,402,2440,11.4
22110,Phil Bourque,1995-96,33.0,12,20,55,55,6,14,20,71.0,,399,81,103,184,592.0,84,7.25,87,443,2603,11.7
22111,Phil Bourque,1996-97,34.0,13,6,27,27,2,4,6,21.0,,426,83,107,190,613.0,84,6.48,76,407,2545,10.7
22112,Phil Bourque,1997-98,35.0,14,7,38,38,4,3,7,34.0,,464,87,110,197,647.0,48,5.97,37,209,1408,10.2
22113,Phil Bourque,1998-99,36.0,15,2,13,13,1,1,2,12.0,,477,88,111,199,659.0,82,6.29,74,413,2481,10.4
22114,Phil Crowe,1996-97,26.0,4,2,31,31,0,2,2,5.0,,31,0,2,2,5.0,84,6.48,76,407,2545,10.7
22115,Phil Crowe,1998-99,28.0,5,2,16,16,1,1,2,6.0,,47,1,3,4,11.0,82,6.29,74,413,2481,10.4
22116,Phil Crowe,1999-00,29.0,6,1,26,26,0,1,1,8.0,,73,1,4,5,19.0,82,5.83,55,336,2444,9.8
22117,Phil Crowe,2000-01,30.0,7,3,9,9,3,0,3,6.0,,82,4,4,8,25.0,82,5.28,57,380,2242,9.6
22118,Phil Crowe,2001-02,31.0,8,1,8,8,0,1,1,2.0,33.0,90,4,5,9,27.0,82,5.27,57,359,2285,9.4
22119,Phil Crowe,2002-03,32.0,9,0,4,4,0,0,0,1.0,16.0,94,4,5,9,28.0,82,5.49,53,331,2294,9.8
22120,Phil Housley,1985-86,21.0,4,66,77,77,19,47,66,183.0,,77,19,47,66,183.0,80,7.73,71,310,2444,12.7
22121,Phil Housley,1986-87,22.0,5,77,75,75,31,46,77,235.0,,152,50,93,143,418.0,80,7.89,74,336,2448,12.9
22122,Phil Housley,1987-88,23.0,6,69,73,73,16,53,69,189.0,,225,66,146,212,607.0,80,7.77,71,321,2447,12.7
22123,Phil Housley,1988-89,24.0,7,62,79,79,15,47,62,180.0,,304,81,193,274,787.0,80,7.94,82,370,2484,12.8
22124,Phil Housley,1989-90,25.0,8,67,78,78,21,46,67,200.0,,382,102,239,341,987.0,80,7.34,72,344,2400,12.2
22125,Phil Housley,1990-91,26.0,9,66,74,74,29,37,66,231.0,,456,131,276,407,1218.0,80,7.43,89,437,2435,12.2
22126,Phil Housley,1991-92,27.0,10,70,72,72,26,44,70,178.0,,528,157,320,477,1396.0,80,7.48,85,403,2430,12.3
22127,Phil Housley,1992-93,28.0,11,81,80,80,21,60,81,201.0,,608,178,380,558,1597.0,80,7.37,76,367,2421,12.2
22128,Phil Housley,1993-94,29.0,12,76,78,78,23,53,76,206.0,,686,201,433,634,1803.0,80,6.91,71,366,2385,11.6
22129,Phil Housley,1994-95,30.0,13,86,74,74,23,63,86,234.0,,760,224,496,720,2037.0,80,6.96,77,402,2440,11.4
22130,Phil Housley,1995-96,31.0,14,97,80,80,18,79,97,249.0,,840,242,575,817,2286.0,84,7.25,87,443,2603,11.7
22131,Phil Housley,1996-97,32.0,15,22,26,26,7,15,22,60.0,,866,249,590,839,2346.0,84,6.48,76,407,2545,10.7
22132,Phil Housley,1997-98,33.0,16,43,43,43,8,35,43,135.0,,909,257,625,882,2481.0,48,5.97,37,209,1408,10.2
22133,Phil Housley,1998-99,34.0,17,68,81,81,17,51,68,205.0,,990,274,676,950,2686.0,82,6.29,74,413,2481,10.4
22134,Phil Housley,1999-00,35.0,18,40,77,77,11,29,40,167.0,,1067,285,705,990,2853.0,82,5.83,55,336,2444,9.8
22135,Phil Housley,2000-01,36.0,19,31,64,64,6,25,31,116.0,,1131,291,730,1021,2969.0,82,5.28,57,380,2242,9.6
22136,Phil Housley,2001-02,37.0,20,54,79,79,11,43,54,193.0,1648.0,1210,302,773,1075,3162.0,82,5.27,57,359,2285,9.4
22137,Phil Housley,2002-03,38.0,21,55,78,78,11,44,55,176.0,1832.0,1288,313,817,1130,3338.0,82,5.49,53,331,2294,9.8
22138,Phil Housley,2003-04,39.0,22,34,69,69,4,30,34,115.0,1253.0,1357,317,847,1164,3453.0,82,5.51,63,376,2272,9.9
22139,Phil Housley,2004-05,40.0,23,39,80,80,15,24,39,218.0,1741.0,1437,332,871,1203,3671.0,82,5.24,53,338,2262,9.5
22140,Phil Housley,2005-06,41.0,24,29,58,58,6,23,29,137.0,1121.0,1495,338,894,1232,3808.0,82,5.31,60,363,2326,9.4
22141,Phil Kessel,2009-10,22.0,4,29,70,70,11,18,29,170.0,984.0,70,11,18,29,170.0,82,5.76,70,398,2426,9.7
22142,Phil Kessel,2010-11,23.0,5,37,82,82,19,18,37,213.0,1249.0,152,30,36,66,383.0,82,5.44,62,351,2383,9.4
22143,Phil Kessel,2011-12,24.0,6,60,70,70,36,24,60,232.0,1159.0,222,66,60,126,615.0,82,5.7,65,341,2477,9.4
22144,Phil Kessel,2012-13,25.0,7,55,70,70,30,25,55,297.0,1368.0,292,96,85,181,912.0,82,5.53,56,304,2486,9.1
22145,Phil Kessel,2013-14,26.0,8,64,82,82,32,32,64,325.0,1611.0,374,128,117,245,1237.0,82,5.46,52,291,2492,9.0
22146,Phil Kessel,2014-15,27.0,9,82,82,82,37,45,82,295.0,1645.0,456,165,162,327,1532.0,82,5.32,47,271,2439,8.9
22147,Phil Kessel,2015-16,28.0,10,52,48,48,20,32,52,161.0,951.0,504,185,194,379,1693.0,48,5.31,29,160,1399,9.1
22148,Phil Kessel,2016-17,29.0,11,80,82,82,37,43,80,305.0,1695.0,586,222,237,459,1998.0,82,5.34,48,269,2463,8.9
22149,Phil Kessel,2017-18,30.0,12,61,82,82,25,36,61,280.0,1541.0,668,247,273,520,2278.0,82,5.32,47,251,2453,8.9
22150,Phil Kessel,2018-19,31.0,13,59,82,82,26,33,59,274.0,1507.0,750,273,306,579,2552.0,82,5.34,48,255,2438,9.0
22151,Phil Kessel,2019-20,32.0,14,70,82,82,23,47,70,229.0,1471.0,832,296,353,649,2781.0,82,5.45,47,245,2478,9.0
22152,Phil Kessel,2020-21,33.0,15,92,82,82,34,58,92,261.0,1532.0,914,330,411,741,3042.0,82,5.86,50,250,2620,9.2
22153,Phil Kessel,2021-22,34.0,16,82,82,82,27,55,82,215.0,1474.0,996,357,466,823,3257.0,82,5.96,47,239,2579,9.5
22154,Phil Kessel,2022-23,35.0,17,38,70,70,14,24,38,153.0,1200.0,1066,371,490,861,3410.0,70,5.96,42,208,2192,9.5
22155,Phil Oreskovic,2011-12,25.0,4,2,10,10,1,1,2,12.0,162.0,10,1,1,2,12.0,82,5.7,65,341,2477,9.4
22156,Phil Sykes,1985-86,26.0,4,2,7,7,2,0,2,5.0,,7,2,0,2,5.0,80,7.73,71,310,2444,12.7
22157,Phil Sykes,1986-87,27.0,5,0,3,3,0,0,0,2.0,,10,2,0,2,7.0,80,7.89,74,336,2448,12.9
22158,Phil Sykes,1987-88,28.0,6,32,79,79,17,15,32,97.0,,89,19,15,34,104.0,80,7.77,71,321,2447,12.7
22159,Phil Sykes,1988-89,29.0,7,44,76,76,20,24,44,132.0,,165,39,39,78,236.0,80,7.94,82,370,2484,12.8
22160,Phil Sykes,1989-90,30.0,8,21,58,58,6,15,21,62.0,,223,45,54,99,298.0,80,7.34,72,344,2400,12.2
22161,Phil Sykes,1990-91,31.0,9,21,40,40,9,12,21,61.0,,263,54,66,120,359.0,80,7.43,89,437,2435,12.2
22162,Phil Sykes,1991-92,32.0,10,1,23,23,0,1,1,5.0,,286,54,67,121,364.0,80,7.48,85,403,2430,12.3
22163,Phil Sykes,1992-93,33.0,11,15,48,48,9,6,15,50.0,,334,63,73,136,414.0,80,7.37,76,367,2421,12.2
22164,Phil Sykes,1993-94,34.0,12,22,70,70,12,10,22,65.0,,404,75,83,158,479.0,80,6.91,71,366,2385,11.6
22165,Phil Sykes,1994-95,35.0,13,6,52,52,4,2,6,34.0,,456,79,85,164,513.0,80,6.96,77,402,2440,11.4
22166,Phil Varone,2016-17,26.0,4,2,9,9,1,1,2,15.0,103.0,9,1,1,2,15.0,82,5.34,48,269,2463,8.9
22167,Phil Varone,2017-18,27.0,5,5,28,28,3,2,5,28.0,376.0,37,4,3,7,43.0,82,5.32,47,251,2453,8.9
22168,Phil Varone,2018-19,28.0,6,3,6,6,1,2,3,2.0,51.0,43,5,5,10,45.0,82,5.34,48,255,2438,9.0
22169,Phil Varone,2019-20,29.0,7,0,7,7,0,0,0,1.0,56.0,50,5,5,10,46.0,82,5.45,47,245,2478,9.0
22170,Phil Varone,2021-22,31.0,8,7,47,47,3,4,7,34.0,372.0,97,8,9,17,80.0,82,5.96,47,239,2579,9.5
22171,Phil Von Stefenelli,1998-99,29.0,4,4,27,27,0,4,4,20.0,,27,0,4,4,20.0,82,6.29,74,413,2481,10.4
22172,Phil Von Stefenelli,1999-00,30.0,5,1,6,6,0,1,1,2.0,,33,0,5,5,22.0,82,5.83,55,336,2444,9.8
22173,Philip Holm,2020-21,29.0,4,0,1,1,0,0,0,0.0,15.0,1,0,0,0,0.0,82,5.86,50,250,2620,9.2
22174,Philip Larsen,2012-13,23.0,4,1,2,2,0,1,1,1.0,25.0,2,0,1,1,1.0,82,5.53,56,304,2486,9.1
22175,Philip Larsen,2013-14,24.0,5,2,6,6,0,2,2,11.0,81.0,8,0,3,3,12.0,82,5.46,52,291,2492,9.0
22176,Philip Larsen,2014-15,25.0,6,11,55,55,3,8,11,69.0,988.0,63,3,11,14,81.0,82,5.32,47,271,2439,8.9
22177,Philip Larsen,2015-16,26.0,7,5,32,32,2,3,5,30.0,476.0,95,5,14,19,111.0,48,5.31,29,160,1399,9.1
22178,Philip Larsen,2016-17,27.0,8,12,30,30,3,9,12,47.0,515.0,125,8,23,31,158.0,82,5.34,48,269,2463,8.9
22179,Philip Larsen,2019-20,30.0,9,6,26,26,1,5,6,32.0,428.0,151,9,28,37,190.0,82,5.45,47,245,2478,9.0
22180,Philip McRae,2013-14,23.0,4,3,15,15,1,2,3,13.0,136.0,15,1,2,3,13.0,82,5.46,52,291,2492,9.0
22181,Philip Samuelsson,2016-17,25.0,4,0,5,5,0,0,0,5.0,78.0,5,0,0,0,5.0,82,5.34,48,269,2463,8.9
22182,Philip Samuelsson,2017-18,26.0,5,0,4,4,0,0,0,4.0,68.0,9,0,0,0,9.0,82,5.32,47,251,2453,8.9
22183,Philip Samuelsson,2018-19,27.0,6,0,4,4,0,0,0,5.0,64.0,13,0,0,0,14.0,82,5.34,48,255,2438,9.0
22184,Philippe Audet,2001-02,24.0,4,0,4,4,0,0,0,3.0,17.0,4,0,0,0,3.0,82,5.27,57,359,2285,9.4
22185,Philippe Boucher,1995-96,22.0,4,4,18,18,0,4,4,28.0,,18,0,4,4,28.0,84,7.25,87,443,2603,11.7
22186,Philippe Boucher,1996-97,23.0,5,14,38,38,6,8,14,67.0,,56,6,12,18,95.0,84,6.48,76,407,2545,10.7
22187,Philippe Boucher,1997-98,24.0,6,6,15,15,2,4,6,30.0,,71,8,16,24,125.0,48,5.97,37,209,1408,10.2
22188,Philippe Boucher,1998-99,25.0,7,23,53,53,7,16,23,145.0,,124,15,32,47,270.0,82,6.29,74,413,2481,10.4
22189,Philippe Boucher,1999-00,26.0,8,25,60,60,7,18,25,159.0,,184,22,50,72,429.0,82,5.83,55,336,2444,9.8
22190,Philippe Boucher,2000-01,27.0,9,16,45,45,6,10,16,80.0,,229,28,60,88,509.0,82,5.28,57,380,2242,9.6
22191,Philippe Boucher,2001-02,28.0,10,8,45,45,2,6,8,87.0,803.0,274,30,66,96,596.0,82,5.27,57,359,2285,9.4
22192,Philippe Boucher,2002-03,29.0,11,0,1,1,0,0,0,3.0,17.0,275,30,66,96,599.0,82,5.49,53,331,2294,9.8
22193,Philippe Boucher,2003-04,30.0,12,6,22,22,2,4,6,40.0,405.0,297,32,70,102,639.0,82,5.51,63,376,2272,9.9
22194,Philippe Boucher,2004-05,31.0,13,30,80,80,7,23,30,198.0,1727.0,377,39,93,132,837.0,82,5.24,53,338,2262,9.5
22195,Philippe Boucher,2005-06,32.0,14,27,80,80,7,20,27,137.0,1639.0,457,46,113,159,974.0,82,5.31,60,363,2326,9.4
22196,Philippe Boucher,2006-07,33.0,15,24,70,70,8,16,24,134.0,1568.0,527,54,129,183,1108.0,82,5.14,57,348,2300,9.2
22197,Philippe Boucher,2008-09,35.0,16,43,66,66,16,27,43,174.0,1545.0,593,70,156,226,1282.0,82,6.05,85,480,2458,10.1
22198,Philippe Boucher,2009-10,36.0,17,51,76,76,19,32,51,222.0,1740.0,669,89,188,277,1504.0,82,5.76,70,398,2426,9.7
22199,Philippe Boucher,2010-11,37.0,18,14,38,38,2,12,14,72.0,817.0,707,91,200,291,1576.0,82,5.44,62,351,2383,9.4
22200,Philippe Boucher,2011-12,38.0,19,9,41,41,3,6,9,66.0,824.0,748,94,206,300,1642.0,82,5.7,65,341,2477,9.4
22201,Philippe Bozon,1994-95,28.0,4,4,9,9,1,3,4,19.0,,9,1,3,4,19.0,80,6.96,77,402,2440,11.4
22202,Philippe Bozon,1995-96,29.0,5,12,54,54,6,6,12,90.0,,63,7,9,16,109.0,84,7.25,87,443,2603,11.7
22203,Philippe Bozon,1996-97,30.0,6,25,80,80,9,16,25,118.0,,143,16,25,41,227.0,84,6.48,76,407,2545,10.7
22204,Philippe Bozon,1997-98,31.0,7,0,1,1,0,0,0,0.0,,144,16,25,41,227.0,48,5.97,37,209,1408,10.2
22205,Philippe Cornet,2014-15,24.0,4,1,2,2,0,1,1,0.0,21.0,2,0,1,1,0.0,82,5.32,47,271,2439,8.9
22206,Philippe Dupuis,2011-12,26.0,4,0,8,8,0,0,0,11.0,76.0,8,0,0,0,11.0,82,5.7,65,341,2477,9.4
22207,Philippe Dupuis,2012-13,27.0,5,1,4,4,0,1,1,4.0,33.0,12,0,1,1,15.0,82,5.53,56,304,2486,9.1
22208,Philippe Dupuis,2013-14,28.0,6,17,74,74,6,11,17,101.0,674.0,86,6,12,18,116.0,82,5.46,52,291,2492,9.0
22209,Philippe Dupuis,2014-15,29.0,7,0,30,30,0,0,0,30.0,315.0,116,6,12,18,146.0,82,5.32,47,271,2439,8.9
22210,Philippe Myers,2021-22,25.0,4,2,21,21,1,1,2,25.0,323.0,21,1,1,2,25.0,82,5.96,47,239,2579,9.5
22211,Philippe Myers,2022-23,26.0,5,16,50,50,4,12,16,78.0,855.0,71,5,13,18,103.0,70,5.96,42,208,2192,9.5
22212,Phillip Danault,2017-18,24.0,4,0,2,2,0,0,0,2.0,19.0,2,0,0,0,2.0,82,5.32,47,251,2453,8.9
22213,Phillip Danault,2018-19,25.0,5,10,51,51,4,6,10,72.0,651.0,53,4,6,10,74.0,82,5.34,48,255,2438,9.0
22214,Phillip Danault,2019-20,26.0,6,40,82,82,13,27,40,133.0,1278.0,135,17,33,50,207.0,82,5.45,47,245,2478,9.0
22215,Phillip Danault,2020-21,27.0,7,25,52,52,8,17,25,94.0,863.0,187,25,50,75,301.0,82,5.86,50,250,2620,9.2
22216,Phillip Danault,2021-22,28.0,8,53,81,81,12,41,53,132.0,1440.0,268,37,91,128,433.0,82,5.96,47,239,2579,9.5
22217,Phillip Danault,2022-23,29.0,9,47,71,71,13,34,47,131.0,1338.0,339,50,125,175,564.0,70,5.96,42,208,2192,9.5
22218,Phillip Di Giuseppe,2018-19,25.0,4,17,41,41,7,10,17,68.0,585.0,41,7,10,17,68.0,82,5.34,48,255,2438,9.0
22219,Phillip Di Giuseppe,2019-20,26.0,5,7,36,36,1,6,7,68.0,443.0,77,8,16,24,136.0,82,5.45,47,245,2478,9.0
22220,Phillip Di Giuseppe,2020-21,27.0,6,13,49,49,5,8,13,64.0,515.0,126,13,24,37,200.0,82,5.86,50,250,2620,9.2
22221,Phillip Di Giuseppe,2021-22,28.0,7,4,24,24,1,3,4,31.0,243.0,150,14,27,41,231.0,82,5.96,47,239,2579,9.5
22222,Phillip Di Giuseppe,2022-23,29.0,8,4,20,20,1,3,4,35.0,226.0,170,15,30,45,266.0,70,5.96,42,208,2192,9.5
22223,Pierre Aubry,1983-84,23.0,4,0,1,1,0,0,0,0.0,,1,0,0,0,0.0,80,7.69,77,340,2441,12.6
22224,Pierre Aubry,1984-85,24.0,5,23,62,62,10,13,23,62.0,,63,10,13,23,62.0,80,8.03,73,320,2489,12.9
22225,Pierre Aubry,1985-86,25.0,6,16,76,76,7,9,16,63.0,,139,17,22,39,125.0,80,7.73,71,310,2444,12.7
22226,Pierre Aubry,1986-87,26.0,7,7,37,37,5,2,7,22.0,,176,22,24,46,147.0,80,7.89,74,336,2448,12.9
22227,Pierre Aubry,1987-88,27.0,8,4,25,25,2,2,4,21.0,,201,24,26,50,168.0,80,7.77,71,321,2447,12.7
22228,Pierre Dagenais,2003-04,25.0,4,5,9,9,3,2,5,20.0,111.0,9,3,2,5,20.0,82,5.51,63,376,2272,9.9
22229,Pierre Dagenais,2004-05,26.0,5,14,42,42,10,4,14,77.0,462.0,51,13,6,19,97.0,82,5.24,53,338,2262,9.5
22230,Pierre Dagenais,2005-06,27.0,6,0,9,9,0,0,0,5.0,54.0,60,13,6,19,102.0,82,5.31,60,363,2326,9.4
22231,Pierre Dagenais,2006-07,28.0,7,27,50,50,17,10,27,149.0,694.0,110,30,16,46,251.0,82,5.14,57,348,2300,9.2
22232,Pierre Dagenais,2008-09,30.0,8,12,32,32,5,7,12,74.0,317.0,142,35,23,58,325.0,82,6.05,85,480,2458,10.1
22233,Pierre Engvall,2022-23,26.0,4,15,48,48,8,7,15,72.0,573.0,48,8,7,15,72.0,70,5.96,42,208,2192,9.5
22234,Pierre Giroux,1985-86,30.0,4,1,6,6,1,0,1,1.0,,6,1,0,1,1.0,80,7.73,71,310,2444,12.7
22235,Pierre Hedin,2006-07,28.0,4,1,3,3,0,1,1,4.0,58.0,3,0,1,1,4.0,82,5.14,57,348,2300,9.2
22236,Pierre Lacroix,1982-83,23.0,4,30,76,76,9,21,30,86.0,,76,9,21,30,86.0,80,7.03,61,280,2352,12.0
22237,Pierre Lacroix,1983-84,24.0,5,39,61,61,5,34,39,96.0,,137,14,55,69,182.0,80,7.69,77,340,2441,12.6
22238,Pierre Lacroix,1984-85,25.0,6,27,68,68,4,23,27,73.0,,205,18,78,96,255.0,80,8.03,73,320,2489,12.9
22239,Pierre Lacroix,1985-86,26.0,7,36,69,69,6,30,36,97.0,,274,24,108,132,352.0,80,7.73,71,310,2444,12.7
22240,Pierre Rioux,1985-86,23.0,4,3,14,14,1,2,3,9.0,,14,1,2,3,9.0,80,7.73,71,310,2444,12.7
22241,Pierre Sevigny,1996-97,25.0,4,9,43,43,4,5,9,19.0,,43,4,5,9,19.0,84,6.48,76,407,2545,10.7
22242,Pierre Sevigny,1997-98,26.0,5,0,19,19,0,0,0,6.0,,62,4,5,9,25.0,48,5.97,37,209,1408,10.2
22243,Pierre Sevigny,1999-00,28.0,6,0,13,13,0,0,0,1.0,,75,4,5,9,26.0,82,5.83,55,336,2444,9.8
22244,Pierre Sevigny,2000-01,29.0,7,0,3,3,0,0,0,1.0,,78,4,5,9,27.0,82,5.28,57,380,2242,9.6
22245,Pierre Turgeon,1990-91,21.0,4,42,76,76,14,28,42,101.0,,76,14,28,42,101.0,80,7.43,89,437,2435,12.2
22246,Pierre Turgeon,1991-92,22.0,5,88,80,80,34,54,88,182.0,,156,48,82,130,283.0,80,7.48,85,403,2430,12.3
22247,Pierre Turgeon,1992-93,23.0,6,106,80,80,40,66,106,193.0,,236,88,148,236,476.0,80,7.37,76,367,2421,12.2
22248,Pierre Turgeon,1993-94,24.0,7,79,78,78,32,47,79,174.0,,314,120,195,315,650.0,80,6.91,71,366,2385,11.6
22249,Pierre Turgeon,1994-95,25.0,8,95,77,77,40,55,95,207.0,,391,160,250,410,857.0,80,6.96,77,402,2440,11.4
22250,Pierre Turgeon,1995-96,26.0,9,132,83,83,58,74,132,301.0,,474,218,324,542,1158.0,84,7.25,87,443,2603,11.7
22251,Pierre Turgeon,1996-97,27.0,10,94,69,69,38,56,94,254.0,,543,256,380,636,1412.0,84,6.48,76,407,2545,10.7
22252,Pierre Turgeon,1997-98,28.0,11,47,49,49,24,23,47,160.0,,592,280,403,683,1572.0,48,5.97,37,209,1408,10.2
22253,Pierre Turgeon,1998-99,29.0,12,96,80,80,38,58,96,297.0,,672,318,461,779,1869.0,82,6.29,74,413,2481,10.4
22254,Pierre Turgeon,1999-00,30.0,13,85,78,78,26,59,85,216.0,,750,344,520,864,2085.0,82,5.83,55,336,2444,9.8
22255,Pierre Turgeon,2000-01,31.0,14,68,60,60,22,46,68,140.0,,810,366,566,932,2225.0,82,5.28,57,380,2242,9.6
22256,Pierre Turgeon,2001-02,32.0,15,65,67,67,31,34,65,193.0,1281.0,877,397,600,997,2418.0,82,5.27,57,359,2285,9.4
22257,Pierre Turgeon,2002-03,33.0,16,66,52,52,26,40,66,139.0,999.0,929,423,640,1063,2557.0,82,5.49,53,331,2294,9.8
22258,Pierre Turgeon,2003-04,34.0,17,82,79,79,30,52,82,171.0,1488.0,1008,453,692,1145,2728.0,82,5.51,63,376,2272,9.9
22259,Pierre Turgeon,2004-05,35.0,18,47,66,66,15,32,47,121.0,1090.0,1074,468,724,1192,2849.0,82,5.24,53,338,2262,9.5
22260,Pierre Turgeon,2005-06,36.0,19,42,65,65,12,30,42,76.0,951.0,1139,480,754,1234,2925.0,82,5.31,60,363,2326,9.4
22261,Pierre Turgeon,2006-07,37.0,20,40,76,76,15,25,40,104.0,1081.0,1215,495,779,1274,3029.0,82,5.14,57,348,2300,9.2
22262,Pierre Turgeon,2008-09,39.0,21,46,62,62,16,30,46,94.0,793.0,1277,511,809,1320,3123.0,82,6.05,85,480,2458,10.1
22263,Pierre Turgeon,2009-10,40.0,22,7,17,17,4,3,7,31.0,173.0,1294,515,812,1327,3154.0,82,5.76,70,398,2426,9.7
22264,Pierre-Cedric Labrie,2014-15,28.0,4,2,14,14,0,2,2,5.0,83.0,14,0,2,2,5.0,82,5.32,47,271,2439,8.9
22265,Pierre-Cedric Labrie,2015-16,29.0,5,3,19,19,2,1,3,16.0,163.0,33,2,3,5,21.0,48,5.31,29,160,1399,9.1
22266,Pierre-Cedric Labrie,2016-17,30.0,6,0,13,13,0,0,0,2.0,89.0,46,2,3,5,23.0,82,5.34,48,269,2463,8.9
22267,Pierre-Edouard Bellemare,2017-18,32.0,4,12,81,81,6,6,12,113.0,1039.0,81,6,6,12,113.0,82,5.32,47,251,2453,8.9
22268,Pierre-Edouard Bellemare,2018-19,33.0,5,14,74,74,7,7,14,102.0,1004.0,155,13,13,26,215.0,82,5.34,48,255,2438,9.0
22269,Pierre-Edouard Bellemare,2019-20,34.0,6,8,82,82,4,4,8,90.0,1064.0,237,17,17,34,305.0,82,5.45,47,245,2478,9.0
22270,Pierre-Edouard Bellemare,2020-21,35.0,7,16,72,72,6,10,16,92.0,888.0,309,23,27,50,397.0,82,5.86,50,250,2620,9.2
22271,Pierre-Edouard Bellemare,2021-22,36.0,8,15,76,76,6,9,15,108.0,945.0,385,29,36,65,505.0,82,5.96,47,239,2579,9.5
22272,Pierre-Edouard Bellemare,2022-23,37.0,9,22,69,69,9,13,22,85.0,926.0,454,38,49,87,590.0,70,5.96,42,208,2192,9.5
22273,Pierre-Luc Dubois,2020-21,22.0,4,48,82,82,20,28,48,165.0,1364.0,82,20,28,48,165.0,82,5.86,50,250,2620,9.2
22274,Pierre-Luc Dubois,2021-22,23.0,5,61,82,82,27,34,61,174.0,1453.0,164,47,62,109,339.0,82,5.96,47,239,2579,9.5
22275,Pierre-Luc Dubois,2022-23,24.0,6,49,70,70,18,31,49,158.0,1255.0,234,65,93,158,497.0,70,5.96,42,208,2192,9.5
22276,Pierre-Luc Letourneau-Leblond,2011-12,26.0,4,1,8,8,0,1,1,3.0,39.0,8,0,1,1,3.0,82,5.7,65,341,2477,9.4
22277,Pierre-Luc Letourneau-Leblond,2012-13,27.0,5,2,27,27,0,2,2,9.0,149.0,35,0,3,3,12.0,82,5.53,56,304,2486,9.1
22278,Pierre-Luc Letourneau-Leblond,2013-14,28.0,6,0,2,2,0,0,0,0.0,7.0,37,0,3,3,12.0,82,5.46,52,291,2492,9.0
22279,Pierre-Luc Letourneau-Leblond,2014-15,29.0,7,0,3,3,0,0,0,3.0,15.0,40,0,3,3,15.0,82,5.32,47,271,2439,8.9
22280,Pierre-Luc Letourneau-Leblond,2016-17,31.0,8,0,1,1,0,0,0,1.0,5.0,41,0,3,3,16.0,82,5.34,48,269,2463,8.9
22281,Pierre-Marc Bouchard,2005-06,21.0,4,20,50,50,7,13,20,53.0,664.0,50,7,13,20,53.0,82,5.31,60,363,2326,9.4
22282,Pierre-Marc Bouchard,2006-07,22.0,5,22,61,61,4,18,22,60.0,854.0,111,11,31,42,113.0,82,5.14,57,348,2300,9.2
22283,Pierre-Marc Bouchard,2008-09,24.0,6,59,80,80,17,42,59,118.0,1220.0,191,28,73,101,231.0,82,6.05,85,480,2458,10.1
22284,Pierre-Marc Bouchard,2009-10,25.0,7,57,82,82,20,37,57,173.0,1311.0,273,48,110,158,404.0,82,5.76,70,398,2426,9.7
22285,Pierre-Marc Bouchard,2010-11,26.0,8,63,81,81,13,50,63,129.0,1364.0,354,61,160,221,533.0,82,5.44,62,351,2383,9.4
22286,Pierre-Marc Bouchard,2011-12,27.0,9,46,71,71,16,30,46,142.0,1205.0,425,77,190,267,675.0,82,5.7,65,341,2477,9.4
22287,Pierre-Marc Bouchard,2012-13,28.0,10,0,1,1,0,0,0,0.0,11.0,426,77,190,267,675.0,82,5.53,56,304,2486,9.1
22288,Pierre-Marc Bouchard,2013-14,29.0,11,38,59,59,12,26,38,98.0,927.0,485,89,216,305,773.0,82,5.46,52,291,2492,9.0
22289,Pierre-Marc Bouchard,2014-15,30.0,12,22,37,37,9,13,22,84.0,604.0,522,98,229,327,857.0,82,5.32,47,271,2439,8.9
22290,Pierre-Marc Bouchard,2015-16,31.0,13,20,43,43,8,12,20,71.0,600.0,565,106,241,347,928.0,48,5.31,29,160,1399,9.1
22291,Pierre-Marc Bouchard,2016-17,32.0,14,9,28,28,4,5,9,51.0,391.0,593,110,246,356,979.0,82,5.34,48,269,2463,8.9
22292,Pontus Aberg,2019-20,26.0,4,2,15,15,1,1,2,12.0,185.0,15,1,1,2,12.0,82,5.45,47,245,2478,9.0
22293,Pontus Aberg,2020-21,27.0,5,16,53,53,4,12,16,70.0,645.0,68,5,13,18,82.0,82,5.86,50,250,2620,9.2
22294,Pontus Aberg,2021-22,28.0,6,25,59,59,12,13,25,101.0,861.0,127,17,26,43,183.0,82,5.96,47,239,2579,9.5
22295,Pontus Aberg,2022-23,29.0,7,1,5,5,0,1,1,4.0,44.0,132,17,27,44,187.0,70,5.96,42,208,2192,9.5
22296,Prestin Ryan,2008-09,28.0,4,0,1,1,0,0,0,0.0,8.0,1,0,0,0,0.0,82,6.05,85,480,2458,10.1
22297,Quinn Hughes,2021-22,22.0,4,3,5,5,0,3,3,6.0,90.0,5,0,3,3,6.0,82,5.96,47,239,2579,9.5
22298,Quinn Hughes,2022-23,23.0,5,53,68,68,8,45,53,126.0,1488.0,73,8,48,56,132.0,70,5.96,42,208,2192,9.5
22299,Quintin Laing,2006-07,27.0,4,1,3,3,0,1,1,3.0,36.0,3,0,1,1,3.0,82,5.14,57,348,2300,9.2
22300,Quintin Laing,2010-11,31.0,5,6,39,39,1,5,6,48.0,451.0,42,1,6,7,51.0,82,5.44,62,351,2383,9.4
22301,Quintin Laing,2011-12,32.0,6,0,1,1,0,0,0,2.0,10.0,43,1,6,7,53.0,82,5.7,65,341,2477,9.4
22302,Quintin Laing,2012-13,33.0,7,4,36,36,2,2,4,38.0,347.0,79,3,8,11,91.0,82,5.53,56,304,2486,9.1
22303,Quinton Howden,2015-16,24.0,4,0,18,18,0,0,0,22.0,188.0,18,0,0,0,22.0,48,5.31,29,160,1399,9.1
22304,Quinton Howden,2016-17,25.0,5,6,16,16,4,2,6,23.0,220.0,34,4,2,6,45.0,82,5.34,48,269,2463,8.9
22305,Quinton Howden,2018-19,27.0,6,11,58,58,6,5,11,54.0,602.0,92,10,7,17,99.0,82,5.34,48,255,2438,9.0
22306,Quinton Howden,2019-20,28.0,7,0,5,5,0,0,0,5.0,43.0,97,10,7,17,104.0,82,5.45,47,245,2478,9.0
22307,R.J. Umberger,2008-09,26.0,4,38,73,73,20,18,38,138.0,966.0,73,20,18,38,138.0,82,6.05,85,480,2458,10.1
22308,R.J. Umberger,2009-10,27.0,5,28,81,81,16,12,28,134.0,1178.0,154,36,30,66,272.0,82,5.76,70,398,2426,9.7
22309,R.J. Umberger,2010-11,28.0,6,50,74,74,13,37,50,173.0,1322.0,228,49,67,116,445.0,82,5.44,62,351,2383,9.4
22310,R.J. Umberger,2011-12,29.0,7,46,82,82,26,20,46,234.0,1539.0,310,75,87,162,679.0,82,5.7,65,341,2477,9.4
22311,R.J. Umberger,2012-13,30.0,8,55,82,82,23,32,55,221.0,1572.0,392,98,119,217,900.0,82,5.53,56,304,2486,9.1
22312,R.J. Umberger,2013-14,31.0,9,57,82,82,25,32,57,220.0,1576.0,474,123,151,274,1120.0,82,5.46,52,291,2492,9.0
22313,R.J. Umberger,2014-15,32.0,10,40,77,77,20,20,40,200.0,1401.0,551,143,171,314,1320.0,82,5.32,47,271,2439,8.9
22314,R.J. Umberger,2015-16,33.0,11,18,48,48,8,10,18,96.0,887.0,599,151,181,332,1416.0,48,5.31,29,160,1399,9.1
22315,R.J. Umberger,2016-17,34.0,12,34,74,74,18,16,34,136.0,1197.0,673,169,197,366,1552.0,82,5.34,48,269,2463,8.9
22316,R.J. Umberger,2017-18,35.0,13,15,67,67,9,6,15,96.0,926.0,740,178,203,381,1648.0,82,5.32,47,251,2453,8.9
22317,R.J. Umberger,2018-19,36.0,14,11,39,39,2,9,11,48.0,396.0,779,180,212,392,1696.0,82,5.34,48,255,2438,9.0
22318,Radek Bonk,1997-98,22.0,4,11,42,42,3,8,11,40.0,,42,3,8,11,40.0,48,5.97,37,209,1408,10.2
22319,Radek Bonk,1998-99,23.0,5,35,76,76,16,19,35,161.0,,118,19,27,46,201.0,82,6.29,74,413,2481,10.4
22320,Radek Bonk,1999-00,24.0,6,18,53,53,5,13,18,82.0,,171,24,40,64,283.0,82,5.83,55,336,2444,9.8
22321,Radek Bonk,2000-01,25.0,7,16,65,65,7,9,16,93.0,,236,31,49,80,376.0,82,5.28,57,380,2242,9.6
22322,Radek Bonk,2001-02,26.0,8,32,81,81,16,16,32,110.0,1112.0,317,47,65,112,486.0,82,5.27,57,359,2285,9.4
22323,Radek Bonk,2002-03,27.0,9,60,80,80,23,37,60,167.0,1458.0,397,70,102,172,653.0,82,5.49,53,331,2294,9.8
22324,Radek Bonk,2003-04,28.0,10,59,74,74,23,36,59,139.0,1352.0,471,93,138,231,792.0,82,5.51,63,376,2272,9.9
22325,Radek Bonk,2004-05,29.0,11,70,82,82,25,45,70,170.0,1472.0,553,118,183,301,962.0,82,5.24,53,338,2262,9.5
22326,Radek Bonk,2005-06,30.0,12,54,70,70,22,32,54,146.0,1228.0,623,140,215,355,1108.0,82,5.31,60,363,2326,9.4
22327,Radek Bonk,2006-07,31.0,13,44,66,66,12,32,44,98.0,1164.0,689,152,247,399,1206.0,82,5.14,57,348,2300,9.2
22328,Radek Bonk,2008-09,33.0,14,21,61,61,6,15,21,76.0,925.0,750,158,262,420,1282.0,82,6.05,85,480,2458,10.1
22329,Radek Bonk,2009-10,34.0,15,23,74,74,13,10,23,111.0,1174.0,824,171,272,443,1393.0,82,5.76,70,398,2426,9.7
22330,Radek Bonk,2010-11,35.0,16,29,79,79,14,15,29,138.0,1258.0,903,185,287,472,1531.0,82,5.44,62,351,2383,9.4
22331,Radek Bonk,2011-12,36.0,17,25,66,66,9,16,25,102.0,1019.0,969,194,303,497,1633.0,82,5.7,65,341,2477,9.4
22332,Radek Dvorak,1998-99,21.0,4,27,77,77,13,14,27,126.0,,77,13,14,27,126.0,82,6.29,74,413,2481,10.4
22333,Radek Dvorak,1999-00,22.0,5,39,78,78,18,21,39,139.0,,155,31,35,66,265.0,82,5.83,55,336,2444,9.8
22334,Radek Dvorak,2000-01,23.0,6,36,64,64,12,24,36,112.0,,219,43,59,102,377.0,82,5.28,57,380,2242,9.6
22335,Radek Dvorak,2001-02,24.0,7,43,82,82,19,24,43,182.0,1330.0,301,62,83,145,559.0,82,5.27,57,359,2285,9.4
22336,Radek Dvorak,2002-03,25.0,8,50,81,81,18,32,50,157.0,1386.0,382,80,115,195,716.0,82,5.49,53,331,2294,9.8
22337,Radek Dvorak,2003-04,26.0,9,67,82,82,31,36,67,230.0,1564.0,464,111,151,262,946.0,82,5.51,63,376,2272,9.9
22338,Radek Dvorak,2004-05,27.0,10,37,65,65,17,20,37,210.0,1283.0,529,128,171,299,1156.0,82,5.24,53,338,2262,9.5
22339,Radek Dvorak,2005-06,28.0,11,35,75,75,10,25,35,166.0,1183.0,604,138,196,334,1322.0,82,5.31,60,363,2326,9.4
22340,Radek Dvorak,2006-07,29.0,12,50,78,78,15,35,50,188.0,1320.0,682,153,231,384,1510.0,82,5.14,57,348,2300,9.2
22341,Radek Dvorak,2008-09,31.0,13,28,64,64,8,20,28,131.0,1060.0,746,161,251,412,1641.0,82,6.05,85,480,2458,10.1
22342,Radek Dvorak,2009-10,32.0,14,37,82,82,10,27,37,139.0,1282.0,828,171,278,449,1780.0,82,5.76,70,398,2426,9.7
22343,Radek Dvorak,2010-11,33.0,15,17,67,67,8,9,17,146.0,1013.0,895,179,287,466,1926.0,82,5.44,62,351,2383,9.4
22344,Radek Dvorak,2011-12,34.0,16,36,81,81,15,21,36,136.0,1331.0,976,194,308,502,2062.0,82,5.7,65,341,2477,9.4
22345,Radek Dvorak,2012-13,35.0,17,32,76,76,14,18,32,140.0,1325.0,1052,208,326,534,2202.0,82,5.53,56,304,2486,9.1
22346,Radek Dvorak,2013-14,36.0,18,22,66,66,7,15,22,109.0,1061.0,1118,215,341,556,2311.0,82,5.46,52,291,2492,9.0
22347,Radek Dvorak,2014-15,37.0,19,21,73,73,4,17,21,83.0,1042.0,1191,219,358,577,2394.0,82,5.32,47,271,2439,8.9
22348,Radek Dvorak,2015-16,38.0,20,4,9,9,4,0,4,17.0,118.0,1200,223,358,581,2411.0,48,5.31,29,160,1399,9.1
22349,Radek Dvorak,2016-17,39.0,21,9,60,60,4,5,9,52.0,638.0,1260,227,363,590,2463.0,82,5.34,48,269,2463,8.9
22350,Radek Faksa,2018-19,25.0,4,12,45,45,5,7,12,67.0,556.0,45,5,7,12,67.0,82,5.34,48,255,2438,9.0
22351,Radek Faksa,2019-20,26.0,5,33,80,80,12,21,33,132.0,1294.0,125,17,28,45,199.0,82,5.45,47,245,2478,9.0
22352,Radek Faksa,2020-21,27.0,6,33,79,79,17,16,33,118.0,1206.0,204,34,44,78,317.0,82,5.86,50,250,2620,9.2
22353,Radek Faksa,2021-22,28.0,7,30,81,81,15,15,30,114.0,1331.0,285,49,59,108,431.0,82,5.96,47,239,2579,9.5
22354,Radek Faksa,2022-23,29.0,8,20,66,66,11,9,20,109.0,1049.0,351,60,68,128,540.0,70,5.96,42,208,2192,9.5
22355,Radek Hamr,1995-96,21.0,4,0,4,4,0,0,0,2.0,,4,0,0,0,2.0,84,7.25,87,443,2603,11.7
22356,Radek Hamr,1996-97,22.0,5,0,7,7,0,0,0,5.0,,11,0,0,0,7.0,84,6.48,76,407,2545,10.7
22357,Radek Martinek,2004-05,28.0,4,5,23,23,1,4,5,25.0,486.0,23,1,4,5,25.0,82,5.24,53,338,2262,9.5
22358,Radek Martinek,2005-06,29.0,5,13,66,66,2,11,13,67.0,1138.0,89,3,15,18,92.0,82,5.31,60,363,2326,9.4
22359,Radek Martinek,2006-07,30.0,6,7,47,47,4,3,7,48.0,613.0,136,7,18,25,140.0,82,5.14,57,348,2300,9.2
22360,Radek Martinek,2008-09,32.0,7,17,74,74,1,16,17,79.0,1351.0,210,8,34,42,219.0,82,6.05,85,480,2458,10.1
22361,Radek Martinek,2009-10,33.0,8,17,43,43,2,15,17,44.0,856.0,253,10,49,59,263.0,82,5.76,70,398,2426,9.7
22362,Radek Martinek,2010-11,34.0,9,15,69,69,0,15,15,98.0,1578.0,322,10,64,74,361.0,82,5.44,62,351,2383,9.4
22363,Radek Martinek,2011-12,35.0,10,10,51,51,6,4,10,54.0,1099.0,373,16,68,84,415.0,82,5.7,65,341,2477,9.4
22364,Radek Martinek,2012-13,36.0,11,3,16,16,2,1,3,24.0,365.0,389,18,69,87,439.0,82,5.53,56,304,2486,9.1
22365,Radek Martinek,2013-14,37.0,12,16,64,64,3,13,16,97.0,1334.0,453,21,82,103,536.0,82,5.46,52,291,2492,9.0
22366,Radek Martinek,2014-15,38.0,13,1,7,7,1,0,1,10.0,136.0,460,22,82,104,546.0,82,5.32,47,271,2439,8.9
22367,Radek Martinek,2015-16,39.0,14,3,13,13,3,0,3,12.0,210.0,473,25,82,107,558.0,48,5.31,29,160,1399,9.1
22368,Radek Martinek,2016-17,40.0,15,3,13,13,0,3,3,12.0,201.0,486,25,85,110,570.0,82,5.34,48,269,2463,8.9
22369,Radek Smolenak,2011-12,25.0,4,1,6,6,0,1,1,14.0,50.0,6,0,1,1,14.0,82,5.7,65,341,2477,9.4
22370,Radek Smolenak,2012-13,26.0,5,0,1,1,0,0,0,1.0,5.0,7,0,1,1,15.0,82,5.53,56,304,2486,9.1
22371,Radim Bicanek,1997-98,23.0,4,0,6,6,0,0,0,6.0,,6,0,0,0,6.0,48,5.97,37,209,1408,10.2
22372,Radim Bicanek,1999-00,25.0,5,1,21,21,0,1,1,27.0,,27,0,1,1,33.0,82,5.83,55,336,2444,9.8
22373,Radim Bicanek,2000-01,26.0,6,0,1,1,0,0,0,0.0,,28,0,1,1,33.0,82,5.28,57,380,2242,9.6
22374,Radim Bicanek,2001-02,27.0,7,0,14,14,0,0,0,13.0,188.0,42,0,1,1,46.0,82,5.27,57,359,2285,9.4
22375,Radim Bicanek,2002-03,28.0,8,3,11,11,0,3,3,8.0,203.0,53,0,4,4,54.0,82,5.49,53,331,2294,9.8
22376,Radim Bicanek,2003-04,29.0,9,2,9,9,0,2,2,11.0,154.0,62,0,6,6,65.0,82,5.51,63,376,2272,9.9
22377,Radim Bicanek,2004-05,30.0,10,6,60,60,1,5,6,43.0,812.0,122,1,11,12,108.0,82,5.24,53,338,2262,9.5
22378,Radim Simek,2021-22,29.0,4,9,41,41,1,8,9,41.0,624.0,41,1,8,9,41.0,82,5.96,47,239,2579,9.5
22379,Radim Simek,2022-23,30.0,5,9,48,48,2,7,9,40.0,825.0,89,3,15,18,81.0,70,5.96,42,208,2192,9.5
22380,Radim Vrbata,2004-05,23.0,4,30,52,52,18,12,30,112.0,756.0,52,18,12,30,112.0,82,5.24,53,338,2262,9.5
22381,Radim Vrbata,2005-06,24.0,5,35,76,76,16,19,35,215.0,1108.0,128,34,31,65,327.0,82,5.31,60,363,2326,9.4
22382,Radim Vrbata,2006-07,25.0,6,25,80,80,12,13,25,195.0,1096.0,208,46,44,90,522.0,82,5.14,57,348,2300,9.2
22383,Radim Vrbata,2008-09,27.0,7,39,61,61,15,24,39,185.0,909.0,269,61,68,129,707.0,82,6.05,85,480,2458,10.1
22384,Radim Vrbata,2009-10,28.0,8,41,77,77,14,27,41,215.0,1300.0,346,75,95,170,922.0,82,5.76,70,398,2426,9.7
22385,Radim Vrbata,2010-11,29.0,9,56,76,76,27,29,56,246.0,1383.0,422,102,124,226,1168.0,82,5.44,62,351,2383,9.4
22386,Radim Vrbata,2011-12,30.0,10,6,18,18,3,3,6,41.0,256.0,440,105,127,232,1209.0,82,5.7,65,341,2477,9.4
22387,Radim Vrbata,2012-13,31.0,11,43,82,82,24,19,43,266.0,1330.0,522,129,146,275,1475.0,82,5.53,56,304,2486,9.1
22388,Radim Vrbata,2013-14,32.0,12,48,79,79,19,29,48,240.0,1293.0,601,148,175,323,1715.0,82,5.46,52,291,2492,9.0
22389,Radim Vrbata,2014-15,33.0,13,62,77,77,35,27,62,232.0,1435.0,678,183,202,385,1947.0,82,5.32,47,271,2439,8.9
22390,Radim Vrbata,2015-16,34.0,14,28,34,34,12,16,28,106.0,623.0,712,195,218,413,2053.0,48,5.31,29,160,1399,9.1
22391,Radim Vrbata,2016-17,35.0,15,51,80,80,20,31,51,263.0,1437.0,792,215,249,464,2316.0,82,5.34,48,269,2463,8.9
22392,Radim Vrbata,2017-18,36.0,16,63,79,79,31,32,63,267.0,1312.0,871,246,281,527,2583.0,82,5.32,47,251,2453,8.9
22393,Radim Vrbata,2018-19,37.0,17,27,63,63,13,14,27,199.0,1011.0,934,259,295,554,2782.0,82,5.34,48,255,2438,9.0
22394,Radim Vrbata,2019-20,38.0,18,55,81,81,20,35,55,233.0,1369.0,1015,279,330,609,3015.0,82,5.45,47,245,2478,9.0
22395,Radim Vrbata,2020-21,39.0,19,14,42,42,5,9,14,88.0,542.0,1057,284,339,623,3103.0,82,5.86,50,250,2620,9.2
22396,Radko Gudas,2015-16,25.0,4,5,22,22,2,3,5,31.0,374.0,22,2,3,5,31.0,48,5.31,29,160,1399,9.1
22397,Radko Gudas,2016-17,26.0,5,22,73,73,3,19,22,114.0,1396.0,95,5,22,27,145.0,82,5.34,48,269,2463,8.9
22398,Radko Gudas,2017-18,27.0,6,5,31,31,2,3,5,63.0,527.0,126,7,25,32,208.0,82,5.32,47,251,2453,8.9
22399,Radko Gudas,2018-19,28.0,7,14,76,76,5,9,14,150.0,1508.0,202,12,34,46,358.0,82,5.34,48,255,2438,9.0
22400,Radko Gudas,2019-20,29.0,8,23,67,67,6,17,23,113.0,1293.0,269,18,51,69,471.0,82,5.45,47,245,2478,9.0
22401,Radko Gudas,2020-21,30.0,9,16,70,70,2,14,16,142.0,1197.0,339,20,65,85,613.0,82,5.86,50,250,2620,9.2
22402,Radko Gudas,2021-22,31.0,10,20,77,77,4,16,20,136.0,1376.0,416,24,81,105,749.0,82,5.96,47,239,2579,9.5
22403,Radko Gudas,2022-23,32.0,11,15,63,63,2,13,15,90.0,1054.0,479,26,94,120,839.0,70,5.96,42,208,2192,9.5
22404,Radoslav Hecl,2005-06,31.0,4,0,14,14,0,0,0,3.0,140.0,14,0,0,0,3.0,82,5.31,60,363,2326,9.4
22405,Radoslav Suchy,2002-03,26.0,4,6,60,60,0,6,6,36.0,909.0,60,0,6,6,36.0,82,5.49,53,331,2294,9.8
22406,Radoslav Suchy,2003-04,27.0,5,10,72,72,0,10,10,33.0,1235.0,132,0,16,16,69.0,82,5.51,63,376,2272,9.9
22407,Radoslav Suchy,2004-05,28.0,6,17,81,81,4,13,17,49.0,1465.0,213,4,29,33,118.0,82,5.24,53,338,2262,9.5
22408,Radoslav Suchy,2005-06,29.0,7,9,77,77,1,8,9,48.0,1265.0,290,5,37,42,166.0,82,5.31,60,363,2326,9.4
22409,Radoslav Suchy,2006-07,30.0,8,21,82,82,7,14,21,82.0,1613.0,372,12,51,63,248.0,82,5.14,57,348,2300,9.2
22410,Radoslav Suchy,2008-09,32.0,9,8,79,79,1,7,8,33.0,1574.0,451,13,58,71,281.0,82,6.05,85,480,2458,10.1
22411,Radovan Somik,2005-06,28.0,4,18,60,60,8,10,18,95.0,949.0,60,8,10,18,95.0,82,5.31,60,363,2326,9.4
22412,Radovan Somik,2006-07,29.0,5,14,53,53,4,10,14,41.0,584.0,113,12,20,32,136.0,82,5.14,57,348,2300,9.2
22413,Raffi Torres,2004-05,23.0,4,1,14,14,0,1,1,9.0,106.0,14,0,1,1,9.0,82,5.24,53,338,2262,9.5
22414,Raffi Torres,2005-06,24.0,5,5,17,17,0,5,5,12.0,130.0,31,0,6,6,21.0,82,5.31,60,363,2326,9.4
22415,Raffi Torres,2006-07,25.0,6,34,80,80,20,14,34,136.0,1011.0,111,20,20,40,157.0,82,5.14,57,348,2300,9.2
22416,Raffi Torres,2008-09,27.0,7,41,82,82,27,14,41,164.0,1099.0,193,47,34,81,321.0,82,6.05,85,480,2458,10.1
22417,Raffi Torres,2009-10,28.0,8,34,82,82,15,19,34,154.0,1175.0,275,62,53,115,475.0,82,5.76,70,398,2426,9.7
22418,Raffi Torres,2010-11,29.0,9,11,32,32,5,6,11,87.0,544.0,307,67,59,126,562.0,82,5.44,62,351,2383,9.4
22419,Raffi Torres,2011-12,30.0,10,20,51,51,12,8,20,74.0,617.0,358,79,67,146,636.0,82,5.7,65,341,2477,9.4
22420,Raffi Torres,2012-13,31.0,11,36,74,74,19,17,36,120.0,1001.0,432,98,84,182,756.0,82,5.53,56,304,2486,9.1
22421,Raffi Torres,2013-14,32.0,12,29,80,80,14,15,29,115.0,999.0,512,112,99,211,871.0,82,5.46,52,291,2492,9.0
22422,Raffi Torres,2014-15,33.0,13,26,79,79,15,11,26,99.0,898.0,591,127,110,237,970.0,82,5.32,47,271,2439,8.9
22423,Raffi Torres,2015-16,34.0,14,18,39,39,7,11,18,60.0,518.0,630,134,121,255,1030.0,48,5.31,29,160,1399,9.1
22424,Raffi Torres,2016-17,35.0,15,5,5,5,3,2,5,9.0,52.0,635,137,123,260,1039.0,82,5.34,48,269,2463,8.9
22425,Raimo Helminen,1988-89,24.0,4,40,66,66,10,30,40,125.0,,66,10,30,40,125.0,80,7.94,82,370,2484,12.8
22426,Raimo Helminen,1989-90,25.0,5,7,27,27,2,5,7,30.0,,93,12,35,47,155.0,80,7.34,72,344,2400,12.2
22427,Raimo Helminen,1991-92,27.0,6,12,24,24,1,11,12,22.0,,117,13,46,59,177.0,80,7.48,85,403,2430,12.3
22428,Raimo Summanen,1986-87,24.0,4,5,2,2,1,4,5,3.0,,2,1,4,5,3.0,80,7.89,74,336,2448,12.9
22429,Raimo Summanen,1987-88,25.0,5,4,9,9,0,4,4,5.0,,11,1,8,9,8.0,80,7.77,71,321,2447,12.7
22430,Raimo Summanen,1988-89,26.0,6,37,73,73,19,18,37,83.0,,84,20,26,46,91.0,80,7.94,82,370,2484,12.8
22431,Raimo Summanen,1989-90,27.0,7,25,58,58,14,11,25,73.0,,142,34,37,71,164.0,80,7.34,72,344,2400,12.2
22432,Raimo Summanen,1990-91,28.0,8,5,9,9,2,3,5,11.0,,151,36,40,76,175.0,80,7.43,89,437,2435,12.2
22433,Raitis Ivanans,2008-09,30.0,4,0,4,4,0,0,0,0.0,12.0,4,0,0,0,0.0,82,6.05,85,480,2458,10.1
22434,Raitis Ivanans,2009-10,31.0,5,8,66,66,4,4,8,37.0,461.0,70,4,4,8,37.0,82,5.76,70,398,2426,9.7
22435,Raitis Ivanans,2010-11,32.0,6,8,73,73,6,2,8,48.0,548.0,143,10,6,16,85.0,82,5.44,62,351,2383,9.4
22436,Raitis Ivanans,2011-12,33.0,7,2,76,76,2,0,2,25.0,484.0,219,12,6,18,110.0,82,5.7,65,341,2477,9.4
22437,Raitis Ivanans,2012-13,34.0,8,0,61,61,0,0,0,18.0,299.0,280,12,6,18,128.0,82,5.53,56,304,2486,9.1
22438,Raitis Ivanans,2013-14,35.0,9,0,1,1,0,0,0,0.0,8.0,281,12,6,18,128.0,82,5.46,52,291,2492,9.0
22439,Raitis Ivanans,2014-15,36.0,10,0,1,1,0,0,0,0.0,11.0,282,12,6,18,128.0,82,5.32,47,271,2439,8.9
22440,Ralph Barahona,1993-94,28.0,4,3,3,3,2,1,3,5.0,,3,2,1,3,5.0,80,6.91,71,366,2385,11.6
22441,Ralph Barahona,1994-95,29.0,5,1,3,3,0,1,1,0.0,,6,2,2,4,5.0,80,6.96,77,402,2440,11.4
22442,Ralph Intranuovo,1997-98,24.0,4,1,1,1,0,1,1,1.0,,1,0,1,1,1.0,48,5.97,37,209,1408,10.2
22443,Ralph Intranuovo,1998-99,25.0,5,3,13,13,1,2,3,19.0,,14,1,3,4,20.0,82,6.29,74,413,2481,10.4
22444,Ralph Intranuovo,1999-00,26.0,6,2,8,8,1,1,2,6.0,,22,2,4,6,26.0,82,5.83,55,336,2444,9.8
22445,Raman Hrabarenka,2017-18,25.0,4,0,1,1,0,0,0,0.0,12.0,1,0,0,0,0.0,82,5.32,47,251,2453,8.9
22446,Ramzi Abid,2005-06,25.0,4,18,33,33,10,8,18,59.0,428.0,33,10,8,18,59.0,82,5.31,60,363,2326,9.4
22447,Ramzi Abid,2006-07,26.0,5,5,16,16,3,2,5,35.0,207.0,49,13,10,23,94.0,82,5.14,57,348,2300,9.2
22448,Ramzi Abid,2008-09,28.0,6,2,6,6,0,2,2,6.0,49.0,55,13,12,25,100.0,82,6.05,85,480,2458,10.1
22449,Ramzi Abid,2009-10,29.0,7,5,13,13,1,4,5,12.0,141.0,68,14,16,30,112.0,82,5.76,70,398,2426,9.7
22450,Randy Boyd,1984-85,23.0,4,2,23,23,0,2,2,26.0,,23,0,2,2,26.0,80,8.03,73,320,2489,12.9
22451,Randy Boyd,1985-86,24.0,5,18,56,56,4,14,18,101.0,,79,4,16,20,127.0,80,7.73,71,310,2444,12.7
22452,Randy Boyd,1986-87,25.0,6,5,28,28,0,5,5,33.0,,107,4,21,25,160.0,80,7.89,74,336,2448,12.9
22453,Randy Boyd,1987-88,26.0,7,0,3,3,0,0,0,3.0,,110,4,21,25,163.0,80,7.77,71,321,2447,12.7
22454,Randy Boyd,1988-89,27.0,8,14,55,55,2,12,14,52.0,,165,6,33,39,215.0,80,7.94,82,370,2484,12.8
22455,Randy Boyd,1989-90,28.0,9,24,30,30,7,17,24,69.0,,195,13,50,63,284.0,80,7.34,72,344,2400,12.2
22456,Randy Boyd,1990-91,29.0,10,23,60,60,7,16,23,85.0,,255,20,66,86,369.0,80,7.43,89,437,2435,12.2
22457,Randy Boyd,1991-92,30.0,11,1,2,2,0,1,1,6.0,,257,20,67,87,375.0,80,7.48,85,403,2430,12.3
22458,Randy Bucyk,1988-89,26.0,4,6,17,17,4,2,6,21.0,,17,4,2,6,21.0,80,7.94,82,370,2484,12.8
22459,Randy Bucyk,1990-91,28.0,5,0,2,2,0,0,0,2.0,,19,4,2,6,23.0,80,7.43,89,437,2435,12.2
22460,Randy Burridge,1988-89,23.0,4,42,52,52,17,25,42,90.0,,52,17,25,42,90.0,80,7.94,82,370,2484,12.8
22461,Randy Burridge,1989-90,24.0,5,5,23,23,1,4,5,28.0,,75,18,29,47,118.0,80,7.34,72,344,2400,12.2
22462,Randy Burridge,1990-91,25.0,6,55,79,79,27,28,55,159.0,,154,45,57,102,277.0,80,7.43,89,437,2435,12.2
22463,Randy Burridge,1991-92,26.0,7,61,80,80,31,30,61,189.0,,234,76,87,163,466.0,80,7.48,85,403,2430,12.3
22464,Randy Burridge,1992-93,27.0,8,32,63,63,17,15,32,118.0,,297,93,102,195,584.0,80,7.37,76,367,2421,12.2
22465,Randy Burridge,1993-94,28.0,9,28,62,62,15,13,28,108.0,,359,108,115,223,692.0,80,6.91,71,366,2385,11.6
22466,Randy Burridge,1994-95,29.0,10,67,66,66,23,44,67,131.0,,425,131,159,290,823.0,80,6.96,77,402,2440,11.4
22467,Randy Burridge,1995-96,30.0,11,0,4,4,0,0,0,7.0,,429,131,159,290,830.0,84,7.25,87,443,2603,11.7
22468,Randy Burridge,1996-97,31.0,12,42,78,78,25,17,42,150.0,,507,156,176,332,980.0,84,6.48,76,407,2545,10.7
22469,Randy Burridge,1997-98,32.0,13,19,40,40,4,15,19,52.0,,547,160,191,351,1032.0,48,5.97,37,209,1408,10.2
22470,Randy Burridge,1998-99,33.0,14,58,74,74,25,33,58,154.0,,621,185,224,409,1186.0,82,6.29,74,413,2481,10.4
22471,Randy Burridge,1999-00,34.0,15,31,55,55,10,21,31,85.0,,676,195,245,440,1271.0,82,5.83,55,336,2444,9.8
22472,Randy Burridge,2000-01,35.0,16,10,30,30,4,6,10,40.0,,706,199,251,450,1311.0,82,5.28,57,380,2242,9.6
22473,Randy Cunneyworth,1983-84,22.0,4,0,1,1,0,0,0,1.0,,1,0,0,0,1.0,80,7.69,77,340,2441,12.6
22474,Randy Cunneyworth,1984-85,23.0,5,6,20,20,2,4,6,33.0,,21,2,4,6,34.0,80,8.03,73,320,2489,12.9
22475,Randy Cunneyworth,1988-89,27.0,6,45,75,75,15,30,45,134.0,,96,17,34,51,168.0,80,7.94,82,370,2484,12.8
22476,Randy Cunneyworth,1989-90,28.0,7,53,79,79,26,27,53,171.0,,175,43,61,104,339.0,80,7.34,72,344,2400,12.2
22477,Randy Cunneyworth,1990-91,29.0,8,74,71,71,35,39,74,229.0,,246,78,100,178,568.0,80,7.43,89,437,2435,12.2
22478,Randy Cunneyworth,1991-92,30.0,9,44,70,70,25,19,44,163.0,,316,103,119,222,731.0,80,7.48,85,403,2430,12.3
22479,Randy Cunneyworth,1992-93,31.0,10,29,71,71,14,15,29,121.0,,387,117,134,251,852.0,80,7.37,76,367,2421,12.2
22480,Randy Cunneyworth,1993-94,32.0,11,14,32,32,9,5,14,56.0,,419,126,139,265,908.0,80,6.91,71,366,2385,11.6
22481,Randy Cunneyworth,1994-95,33.0,12,17,39,39,7,10,17,63.0,,458,133,149,282,971.0,80,6.96,77,402,2440,11.4
22482,Randy Cunneyworth,1995-96,34.0,13,9,39,39,5,4,9,47.0,,497,138,153,291,1018.0,84,7.25,87,443,2603,11.7
22483,Randy Cunneyworth,1996-97,35.0,14,24,79,79,13,11,24,154.0,,576,151,164,315,1172.0,84,6.48,76,407,2545,10.7
22484,Randy Cunneyworth,1997-98,36.0,15,10,48,48,5,5,10,71.0,,624,156,169,325,1243.0,48,5.97,37,209,1408,10.2
22485,Randy Cunneyworth,1998-99,37.0,16,36,81,81,17,19,36,142.0,,705,173,188,361,1385.0,82,6.29,74,413,2481,10.4
22486,Randy Cunneyworth,1999-00,38.0,17,36,76,76,12,24,36,115.0,,781,185,212,397,1500.0,82,5.83,55,336,2444,9.8
22487,Randy Cunneyworth,2000-01,39.0,18,13,71,71,2,11,13,81.0,,852,187,223,410,1581.0,82,5.28,57,380,2242,9.6
22488,Randy Cunneyworth,2001-02,40.0,19,4,14,14,2,2,4,12.0,126.0,866,189,225,414,1593.0,82,5.27,57,359,2285,9.4
22489,Randy Gilhen,1985-86,22.0,4,1,2,2,0,1,1,4.0,,2,0,1,1,4.0,80,7.73,71,310,2444,12.7
22490,Randy Gilhen,1989-90,26.0,5,0,2,2,0,0,0,3.0,,4,0,1,1,7.0,80,7.34,72,344,2400,12.2
22491,Randy Gilhen,1990-91,27.0,6,5,13,13,3,2,5,21.0,,17,3,3,6,28.0,80,7.43,89,437,2435,12.2
22492,Randy Gilhen,1991-92,28.0,7,8,64,64,5,3,8,76.0,,81,8,6,14,104.0,80,7.48,85,403,2430,12.3
22493,Randy Gilhen,1992-93,29.0,8,16,61,61,5,11,16,67.0,,142,13,17,30,171.0,80,7.37,76,367,2421,12.2
22494,Randy Gilhen,1993-94,30.0,9,25,72,72,15,10,25,112.0,,214,28,27,55,283.0,80,6.91,71,366,2385,11.6
22495,Randy Gilhen,1994-95,31.0,10,23,73,73,10,13,23,99.0,,287,38,40,78,382.0,80,6.96,77,402,2440,11.4
22496,Randy Gilhen,1995-96,32.0,11,7,44,44,3,4,7,45.0,,331,41,44,85,427.0,84,7.25,87,443,2603,11.7
22497,Randy Gilhen,1996-97,33.0,12,14,60,60,7,7,14,95.0,,391,48,51,99,522.0,84,6.48,76,407,2545,10.7
22498,Randy Gilhen,1997-98,34.0,13,11,44,44,5,6,11,47.0,,435,53,57,110,569.0,48,5.97,37,209,1408,10.2
22499,Randy Gilhen,1998-99,35.0,14,5,22,22,2,3,5,26.0,,457,55,60,115,595.0,82,6.29,74,413,2481,10.4
22500,Randy Gregg,1985-86,29.0,4,28,80,80,6,22,28,94.0,,80,6,22,28,94.0,80,7.73,71,310,2444,12.7
22501,Randy Gregg,1986-87,30.0,5,40,80,80,13,27,40,90.0,,160,19,49,68,184.0,80,7.89,74,336,2448,12.9
22502,Randy Gregg,1987-88,31.0,6,23,57,57,3,20,23,60.0,,217,22,69,91,244.0,80,7.77,71,321,2447,12.7
22503,Randy Gregg,1988-89,32.0,7,28,64,64,2,26,28,56.0,,281,24,95,119,300.0,80,7.94,82,370,2484,12.8
22504,Randy Gregg,1989-90,33.0,8,24,52,52,8,16,24,59.0,,333,32,111,143,359.0,80,7.34,72,344,2400,12.2
22505,Randy Gregg,1990-91,34.0,9,3,15,15,1,2,3,20.0,,348,33,113,146,379.0,80,7.43,89,437,2435,12.2
22506,Randy Gregg,1991-92,35.0,10,18,57,57,3,15,18,42.0,,405,36,128,164,421.0,80,7.48,85,403,2430,12.3
22507,Randy Gregg,1992-93,36.0,11,24,48,48,4,20,24,41.0,,453,40,148,188,462.0,80,7.37,76,367,2421,12.2
22508,Randy Gregg,1994-95,38.0,12,5,21,21,1,4,5,19.0,,474,41,152,193,481.0,80,6.96,77,402,2440,11.4
22509,Randy Heath,1987-88,23.0,4,5,12,12,2,3,5,18.0,,12,2,3,5,18.0,80,7.77,71,321,2447,12.7
22510,Randy Heath,1988-89,24.0,5,1,1,1,0,1,1,1.0,,13,2,4,6,19.0,80,7.94,82,370,2484,12.8
22511,Randy Hillier,1984-85,24.0,4,8,25,25,0,8,8,17.0,,25,0,8,8,17.0,80,8.03,73,320,2489,12.9
22512,Randy Hillier,1985-86,25.0,5,10,70,70,0,10,10,45.0,,95,0,18,18,62.0,80,7.73,71,310,2444,12.7
22513,Randy Hillier,1986-87,26.0,6,15,69,69,3,12,15,63.0,,164,3,30,33,125.0,80,7.89,74,336,2448,12.9
22514,Randy Hillier,1987-88,27.0,7,21,45,45,2,19,21,58.0,,209,5,49,54,183.0,80,7.77,71,321,2447,12.7
22515,Randy Hillier,1988-89,28.0,8,3,28,28,0,3,3,22.0,,237,5,52,57,205.0,80,7.94,82,370,2484,12.8
22516,Randy Hillier,1989-90,29.0,9,12,55,55,4,8,12,51.0,,292,9,60,69,256.0,80,7.34,72,344,2400,12.2
22517,Randy Hillier,1990-91,30.0,10,13,55,55,1,12,13,44.0,,347,10,72,82,300.0,80,7.43,89,437,2435,12.2
22518,Randy Hillier,1991-92,31.0,11,24,68,68,1,23,24,37.0,,415,11,95,106,337.0,80,7.48,85,403,2430,12.3
22519,Randy Hillier,1992-93,32.0,12,15,61,61,3,12,15,45.0,,476,14,107,121,382.0,80,7.37,76,367,2421,12.2
22520,Randy Hillier,1993-94,33.0,13,4,31,31,2,2,4,14.0,,507,16,109,125,396.0,80,6.91,71,366,2385,11.6
22521,Randy Hillier,1994-95,34.0,14,1,36,36,0,1,1,23.0,,543,16,110,126,419.0,80,6.96,77,402,2440,11.4
22522,Randy Johnston,1982-83,24.0,4,0,4,4,0,0,0,2.0,,4,0,0,0,2.0,80,7.03,61,280,2352,12.0
22523,Randy Jones,2006-07,25.0,4,0,5,5,0,0,0,5.0,60.0,5,0,0,0,5.0,82,5.14,57,348,2300,9.2
22524,Randy Jones,2008-09,27.0,5,8,28,28,0,8,8,21.0,419.0,33,0,8,8,26.0,82,6.05,85,480,2458,10.1
22525,Randy Jones,2009-10,28.0,6,22,66,66,4,18,22,67.0,1062.0,99,4,26,30,93.0,82,5.76,70,398,2426,9.7
22526,Randy Jones,2010-11,29.0,7,31,71,71,5,26,31,103.0,1377.0,170,9,52,61,196.0,82,5.44,62,351,2383,9.4
22527,Randy Jones,2011-12,30.0,8,8,47,47,4,4,8,45.0,898.0,217,13,56,69,241.0,82,5.7,65,341,2477,9.4
22528,Randy Jones,2012-13,31.0,9,21,48,48,5,16,21,54.0,872.0,265,18,72,90,295.0,82,5.53,56,304,2486,9.1
22529,Randy Jones,2013-14,32.0,10,13,61,61,1,12,13,52.0,1041.0,326,19,84,103,347.0,82,5.46,52,291,2492,9.0
22530,Randy Jones,2014-15,33.0,11,2,39,39,1,1,2,24.0,578.0,365,20,85,105,371.0,82,5.32,47,271,2439,8.9
22531,Randy Ladouceur,1985-86,25.0,4,4,27,27,0,4,4,19.0,,27,0,4,4,19.0,80,7.73,71,310,2444,12.7
22532,Randy Ladouceur,1986-87,26.0,5,20,71,71,3,17,20,89.0,,98,3,21,24,108.0,80,7.89,74,336,2448,12.9
22533,Randy Ladouceur,1987-88,27.0,6,30,80,80,3,27,30,83.0,,178,6,48,54,191.0,80,7.77,71,321,2447,12.7
22534,Randy Ladouceur,1988-89,28.0,7,18,78,78,5,13,18,92.0,,256,11,61,72,283.0,80,7.94,82,370,2484,12.8
22535,Randy Ladouceur,1989-90,29.0,8,14,70,70,5,9,14,54.0,,326,16,70,86,337.0,80,7.34,72,344,2400,12.2
22536,Randy Ladouceur,1990-91,30.0,9,8,67,67,1,7,8,37.0,,393,17,77,94,374.0,80,7.43,89,437,2435,12.2
22537,Randy Ladouceur,1991-92,31.0,10,7,75,75,2,5,7,56.0,,468,19,82,101,430.0,80,7.48,85,403,2430,12.3
22538,Randy Ladouceur,1992-93,32.0,11,15,71,71,3,12,15,45.0,,539,22,94,116,475.0,80,7.37,76,367,2421,12.2
22539,Randy Ladouceur,1993-94,33.0,12,4,67,67,1,3,4,44.0,,606,23,97,120,519.0,80,6.91,71,366,2385,11.6
22540,Randy Ladouceur,1994-95,34.0,13,10,74,74,1,9,10,59.0,,680,24,106,130,578.0,80,6.96,77,402,2440,11.4
22541,Randy Ladouceur,1995-96,35.0,14,6,62,62,2,4,6,37.0,,742,26,110,136,615.0,84,7.25,87,443,2603,11.7
22542,Randy Ladouceur,1996-97,36.0,15,10,81,81,1,9,10,66.0,,823,27,119,146,681.0,84,6.48,76,407,2545,10.7
22543,Randy Ladouceur,1997-98,37.0,16,6,44,44,2,4,6,42.0,,867,29,123,152,723.0,48,5.97,37,209,1408,10.2
22544,Randy Ladouceur,1998-99,38.0,17,4,63,63,1,3,4,48.0,,930,30,126,156,771.0,82,6.29,74,413,2481,10.4
22545,Randy MacGregor,1984-85,31.0,4,2,2,2,1,1,2,1.0,,2,1,1,2,1.0,80,8.03,73,320,2489,12.9
22546,Randy McKay,1991-92,25.0,4,0,3,3,0,0,0,2.0,,3,0,0,0,2.0,80,7.48,85,403,2430,12.3
22547,Randy McKay,1992-93,26.0,5,9,33,33,3,6,9,33.0,,36,3,6,9,35.0,80,7.37,76,367,2421,12.2
22548,Randy McKay,1993-94,27.0,6,8,47,47,1,7,8,22.0,,83,4,13,17,57.0,80,6.91,71,366,2385,11.6
22549,Randy McKay,1994-95,28.0,7,33,80,80,17,16,33,111.0,,163,21,29,50,168.0,80,6.96,77,402,2440,11.4
22550,Randy McKay,1995-96,29.0,8,22,73,73,11,11,22,94.0,,236,32,40,72,262.0,84,7.25,87,443,2603,11.7
22551,Randy McKay,1996-97,30.0,9,27,78,78,12,15,27,77.0,,314,44,55,99,339.0,84,6.48,76,407,2545,10.7
22552,Randy McKay,1997-98,31.0,10,12,33,33,5,7,12,44.0,,347,49,62,111,383.0,48,5.97,37,209,1408,10.2
22553,Randy McKay,1998-99,32.0,11,21,76,76,11,10,21,97.0,,423,60,72,132,480.0,82,6.29,74,413,2481,10.4
22554,Randy McKay,1999-00,33.0,12,27,77,77,9,18,27,92.0,,500,69,90,159,572.0,82,5.83,55,336,2444,9.8
22555,Randy McKay,2000-01,34.0,13,48,74,74,24,24,48,141.0,,574,93,114,207,713.0,82,5.28,57,380,2242,9.6
22556,Randy McKay,2001-02,35.0,14,37,70,70,17,20,37,136.0,1127.0,644,110,134,244,849.0,82,5.27,57,359,2285,9.4
22557,Randy McKay,2002-03,36.0,15,39,67,67,16,23,39,116.0,1048.0,711,126,157,283,965.0,82,5.49,53,331,2294,9.8
22558,Randy McKay,2003-04,37.0,16,43,77,77,23,20,43,120.0,1076.0,788,149,177,326,1085.0,82,5.51,63,376,2272,9.9
22559,Randy McKay,2004-05,38.0,17,18,69,69,7,11,18,73.0,898.0,857,156,188,344,1158.0,82,5.24,53,338,2262,9.5
22560,Randy McKay,2005-06,39.0,18,19,75,75,6,13,19,52.0,829.0,932,162,201,363,1210.0,82,5.31,60,363,2326,9.4
22561,Randy Moller,1985-86,22.0,4,14,75,75,2,12,14,75.0,,75,2,12,14,75.0,80,7.73,71,310,2444,12.7
22562,Randy Moller,1986-87,23.0,5,18,74,74,4,14,18,78.0,,149,6,26,32,153.0,80,7.89,74,336,2448,12.9
22563,Randy Moller,1987-88,24.0,6,29,79,79,7,22,29,126.0,,228,13,48,61,279.0,80,7.77,71,321,2447,12.7
22564,Randy Moller,1988-89,25.0,7,23,69,69,5,18,23,105.0,,297,18,66,84,384.0,80,7.94,82,370,2484,12.8
22565,Randy Moller,1989-90,26.0,8,14,71,71,5,9,14,106.0,,368,23,75,98,490.0,80,7.34,72,344,2400,12.2
22566,Randy Moller,1990-91,27.0,9,25,66,66,3,22,25,116.0,,434,26,97,123,606.0,80,7.43,89,437,2435,12.2
22567,Randy Moller,1991-92,28.0,10,29,74,74,7,22,29,117.0,,508,33,119,152,723.0,80,7.48,85,403,2430,12.3
22568,Randy Moller,1992-93,29.0,11,13,60,60,1,12,13,47.0,,568,34,131,165,770.0,80,7.37,76,367,2421,12.2
22569,Randy Moller,1993-94,30.0,12,23,61,61,4,19,23,75.0,,629,38,150,188,845.0,80,6.91,71,366,2385,11.6
22570,Randy Moller,1994-95,31.0,13,12,56,56,3,9,12,63.0,,685,41,159,200,908.0,80,6.96,77,402,2440,11.4
22571,Randy Moller,1995-96,32.0,14,9,35,35,2,7,9,25.0,,720,43,166,209,933.0,84,7.25,87,443,2603,11.7
22572,Randy Moller,1996-97,33.0,15,13,78,78,2,11,13,77.0,,798,45,177,222,1010.0,84,6.48,76,407,2545,10.7
22573,Randy Moller,1997-98,34.0,16,3,17,17,0,3,3,12.0,,815,45,180,225,1022.0,48,5.97,37,209,1408,10.2
22574,Randy Robitaille,1999-00,24.0,4,0,1,1,0,0,0,0.0,,1,0,0,0,0.0,82,5.83,55,336,2444,9.8
22575,Randy Robitaille,2000-01,25.0,5,0,4,4,0,0,0,5.0,,5,0,0,0,5.0,82,5.28,57,380,2242,9.6
22576,Randy Robitaille,2001-02,26.0,6,2,4,4,0,2,2,5.0,41.0,9,0,2,2,10.0,82,5.27,57,359,2285,9.4
22577,Randy Robitaille,2002-03,27.0,7,25,69,69,11,14,25,113.0,888.0,78,11,16,27,123.0,82,5.49,53,331,2294,9.8
22578,Randy Robitaille,2003-04,28.0,8,26,62,62,9,17,26,121.0,879.0,140,20,33,53,244.0,82,5.51,63,376,2272,9.9
22579,Randy Robitaille,2004-05,29.0,9,37,58,58,14,23,37,121.0,957.0,198,34,56,90,365.0,82,5.24,53,338,2262,9.5
22580,Randy Robitaille,2005-06,30.0,10,20,51,51,6,14,20,69.0,697.0,249,40,70,110,434.0,82,5.31,60,363,2326,9.4
22581,Randy Robitaille,2006-07,31.0,11,37,69,69,11,26,37,121.0,1094.0,318,51,96,147,555.0,82,5.14,57,348,2300,9.2
22582,Randy Robitaille,2008-09,33.0,12,40,67,67,12,28,40,112.0,987.0,385,63,124,187,667.0,82,6.05,85,480,2458,10.1
22583,Randy Robitaille,2009-10,34.0,13,40,78,78,11,29,40,120.0,1103.0,463,74,153,227,787.0,82,5.76,70,398,2426,9.7
22584,Randy Robitaille,2010-11,35.0,14,29,68,68,10,19,29,99.0,922.0,531,84,172,256,886.0,82,5.44,62,351,2383,9.4
22585,Randy Skarda,1992-93,24.0,4,5,25,25,0,5,5,8.0,,25,0,5,5,8.0,80,7.37,76,367,2421,12.2
22586,Randy Skarda,1994-95,26.0,5,0,1,1,0,0,0,0.0,,26,0,5,5,8.0,80,6.96,77,402,2440,11.4
22587,Randy Smith,1988-89,23.0,4,0,1,1,0,0,0,0.0,,1,0,0,0,0.0,80,7.94,82,370,2484,12.8
22588,Randy Smith,1989-90,24.0,5,0,2,2,0,0,0,0.0,,3,0,0,0,0.0,80,7.34,72,344,2400,12.2
22589,Randy Turnbull,1984-85,22.0,4,0,1,1,0,0,0,0.0,,1,0,0,0,0.0,80,8.03,73,320,2489,12.9
22590,Randy Velischek,1985-86,23.0,4,0,3,3,0,0,0,4.0,,3,0,0,0,4.0,80,7.73,71,310,2444,12.7
22591,Randy Velischek,1986-87,24.0,5,4,33,33,2,2,4,15.0,,36,2,2,4,19.0,80,7.89,74,336,2448,12.9
22592,Randy Velischek,1987-88,25.0,6,13,52,52,4,9,13,31.0,,88,6,11,17,50.0,80,7.77,71,321,2447,12.7
22593,Randy Velischek,1988-89,26.0,7,9,47,47,2,7,9,24.0,,135,8,18,26,74.0,80,7.94,82,370,2484,12.8
22594,Randy Velischek,1989-90,27.0,8,18,64,64,2,16,18,39.0,,199,10,34,44,113.0,80,7.34,72,344,2400,12.2
22595,Randy Velischek,1990-91,28.0,9,12,51,51,3,9,12,39.0,,250,13,43,56,152.0,80,7.43,89,437,2435,12.2
22596,Randy Velischek,1991-92,29.0,10,18,80,80,4,14,18,77.0,,330,17,57,74,229.0,80,7.48,85,403,2430,12.3
22597,Randy Velischek,1992-93,30.0,11,6,62,62,0,6,6,34.0,,392,17,63,80,263.0,80,7.37,76,367,2421,12.2
22598,Randy Velischek,1993-94,31.0,12,12,79,79,2,10,12,47.0,,471,19,73,92,310.0,80,6.91,71,366,2385,11.6
22599,Randy Velischek,1994-95,32.0,13,5,38,38,2,3,5,23.0,,509,21,76,97,333.0,80,6.96,77,402,2440,11.4
22600,Randy Wood,1989-90,26.0,4,1,6,6,1,0,1,4.0,,6,1,0,1,4.0,80,7.34,72,344,2400,12.2
22601,Randy Wood,1990-91,27.0,5,38,75,75,22,16,38,106.0,,81,23,16,39,110.0,80,7.43,89,437,2435,12.2
22602,Randy Wood,1991-92,28.0,6,28,77,77,15,13,28,115.0,,158,38,29,67,225.0,80,7.48,85,403,2430,12.3
22603,Randy Wood,1992-93,29.0,7,48,74,74,24,24,48,185.0,,232,62,53,115,410.0,80,7.37,76,367,2421,12.2
22604,Randy Wood,1993-94,30.0,8,42,76,76,24,18,42,186.0,,308,86,71,157,596.0,80,6.91,71,366,2385,11.6
22605,Randy Wood,1994-95,31.0,9,40,78,78,22,18,40,215.0,,386,108,89,197,811.0,80,6.96,77,402,2440,11.4
22606,Randy Wood,1995-96,32.0,10,43,82,82,18,25,43,176.0,,468,126,114,240,987.0,84,7.25,87,443,2603,11.7
22607,Randy Wood,1996-97,33.0,11,38,84,84,22,16,38,161.0,,552,148,130,278,1148.0,84,6.48,76,407,2545,10.7
22608,Randy Wood,1997-98,34.0,12,24,48,48,13,11,24,125.0,,600,161,141,302,1273.0,48,5.97,37,209,1408,10.2
22609,Randy Wood,1998-99,35.0,13,21,76,76,8,13,21,159.0,,676,169,154,323,1432.0,82,6.29,74,413,2481,10.4
22610,Randy Wood,1999-00,36.0,14,11,65,65,6,5,11,96.0,,741,175,159,334,1528.0,82,5.83,55,336,2444,9.8
22611,Raphael Diaz,2014-15,29.0,4,16,59,59,3,13,16,61.0,1062.0,59,3,13,16,61.0,82,5.32,47,271,2439,8.9
22612,Raphael Diaz,2015-16,30.0,5,14,23,23,1,13,14,34.0,473.0,82,4,26,30,95.0,48,5.31,29,160,1399,9.1
22613,Raphael Diaz,2016-17,31.0,6,15,63,63,2,13,15,68.0,1133.0,145,6,39,45,163.0,82,5.34,48,269,2463,8.9
22614,Raphael Diaz,2017-18,32.0,7,4,56,56,2,2,4,52.0,673.0,201,8,41,49,215.0,82,5.32,47,251,2453,8.9
22615,Rasmus Andersson,2019-20,23.0,4,0,1,1,0,0,0,0.0,19.0,1,0,0,0,0.0,82,5.45,47,245,2478,9.0
22616,Rasmus Andersson,2020-21,24.0,5,0,10,10,0,0,0,8.0,154.0,11,0,0,0,8.0,82,5.86,50,250,2620,9.2
22617,Rasmus Andersson,2021-22,25.0,6,19,79,79,2,17,19,115.0,1267.0,90,2,17,19,123.0,82,5.96,47,239,2579,9.5
22618,Rasmus Andersson,2022-23,26.0,7,22,70,70,5,17,22,124.0,1396.0,160,7,34,41,247.0,70,5.96,42,208,2192,9.5
22619,Rasmus Asplund,2022-23,25.0,4,3,29,29,1,2,3,36.0,314.0,29,1,2,3,36.0,70,5.96,42,208,2192,9.5
22620,Rasmus Dahlin,2021-22,21.0,4,44,82,82,9,35,44,177.0,1735.0,82,9,35,44,177.0,82,5.96,47,239,2579,9.5
22621,Rasmus Dahlin,2022-23,22.0,5,40,59,59,4,36,40,90.0,1138.0,141,13,71,84,267.0,70,5.96,42,208,2192,9.5
22622,Rasmus Rissanen,2017-18,26.0,4,0,6,6,0,0,0,3.0,90.0,6,0,0,0,3.0,82,5.32,47,251,2453,8.9
22623,Rasmus Ristolainen,2016-17,22.0,4,4,34,34,2,2,4,52.0,650.0,34,2,2,4,52.0,82,5.34,48,269,2463,8.9
22624,Rasmus Ristolainen,2017-18,23.0,5,20,78,78,8,12,20,121.0,1608.0,112,10,14,24,173.0,82,5.32,47,251,2453,8.9
22625,Rasmus Ristolainen,2018-19,24.0,6,41,82,82,9,32,41,202.0,2073.0,194,19,46,65,375.0,82,5.34,48,255,2438,9.0
22626,Rasmus Ristolainen,2019-20,25.0,7,45,79,79,6,39,45,186.0,2091.0,273,25,85,110,561.0,82,5.45,47,245,2478,9.0
22627,Rasmus Ristolainen,2020-21,26.0,8,41,73,73,6,35,41,182.0,1934.0,346,31,120,151,743.0,82,5.86,50,250,2620,9.2
22628,Rasmus Ristolainen,2021-22,27.0,9,43,78,78,5,38,43,182.0,1922.0,424,36,158,194,925.0,82,5.96,47,239,2579,9.5
22629,Rasmus Ristolainen,2022-23,28.0,10,33,69,69,6,27,33,128.0,1573.0,493,42,185,227,1053.0,70,5.96,42,208,2192,9.5
22630,Rasmus Sandin,2022-23,22.0,4,8,28,28,1,7,8,22.0,401.0,28,1,7,8,22.0,70,5.96,42,208,2192,9.5
22631,Ravil Gusmanov,1998-99,26.0,4,0,4,4,0,0,0,6.0,,4,0,0,0,6.0,82,6.29,74,413,2481,10.4
22632,Ray Allison,1982-83,23.0,4,28,64,64,16,12,28,79.0,,64,16,12,28,79.0,80,7.03,61,280,2352,12.0
22633,Ray Allison,1983-84,24.0,5,1,6,6,1,0,1,6.0,,70,17,12,29,85.0,80,7.69,77,340,2441,12.6
22634,Ray Allison,1984-85,25.0,6,54,51,51,17,37,54,131.0,,121,34,49,83,216.0,80,8.03,73,320,2489,12.9
22635,Ray Allison,1985-86,26.0,7,51,67,67,21,30,51,148.0,,188,55,79,134,364.0,80,7.73,71,310,2444,12.7
22636,Ray Allison,1986-87,27.0,8,21,37,37,8,13,21,74.0,,225,63,92,155,438.0,80,7.89,74,336,2448,12.9
22637,Ray Allison,1987-88,28.0,9,2,11,11,1,1,2,16.0,,236,64,93,157,454.0,80,7.77,71,321,2447,12.7
22638,Ray Allison,1989-90,30.0,10,0,2,2,0,0,0,1.0,,238,64,93,157,455.0,80,7.34,72,344,2400,12.2
22639,Ray Bourque,1982-83,22.0,4,65,80,80,17,48,65,185.0,,80,17,48,65,185.0,80,7.03,61,280,2352,12.0
22640,Ray Bourque,1983-84,23.0,5,56,67,67,27,29,56,207.0,,147,44,77,121,392.0,80,7.69,77,340,2441,12.6
22641,Ray Bourque,1984-85,24.0,6,66,65,65,17,49,66,211.0,,212,61,126,187,603.0,80,8.03,73,320,2489,12.9
22642,Ray Bourque,1985-86,25.0,7,73,65,65,22,51,73,205.0,,277,83,177,260,808.0,80,7.73,71,310,2444,12.7
22643,Ray Bourque,1986-87,26.0,8,96,78,78,31,65,96,343.0,,355,114,242,356,1151.0,80,7.89,74,336,2448,12.9
22644,Ray Bourque,1987-88,27.0,9,86,73,73,20,66,86,333.0,,428,134,308,442,1484.0,80,7.77,71,321,2447,12.7
22645,Ray Bourque,1988-89,28.0,10,77,74,74,19,58,77,289.0,,502,153,366,519,1773.0,80,7.94,82,370,2484,12.8
22646,Ray Bourque,1989-90,29.0,11,95,78,78,23,72,95,334.0,,580,176,438,614,2107.0,80,7.34,72,344,2400,12.2
22647,Ray Bourque,1990-91,30.0,12,81,78,78,17,64,81,344.0,,658,193,502,695,2451.0,80,7.43,89,437,2435,12.2
22648,Ray Bourque,1991-92,31.0,13,61,60,60,18,43,61,243.0,,718,211,545,756,2694.0,80,7.48,85,403,2430,12.3
22649,Ray Bourque,1992-93,32.0,14,84,76,76,19,65,84,310.0,,794,230,610,840,3004.0,80,7.37,76,367,2421,12.2
22650,Ray Bourque,1993-94,33.0,15,94,76,76,21,73,94,323.0,,870,251,683,934,3327.0,80,6.91,71,366,2385,11.6
22651,Ray Bourque,1994-95,34.0,16,81,80,80,21,60,81,334.0,,950,272,743,1015,3661.0,80,6.96,77,402,2440,11.4
22652,Ray Bourque,1995-96,35.0,17,82,78,78,19,63,82,330.0,,1028,291,806,1097,3991.0,84,7.25,87,443,2603,11.7
22653,Ray Bourque,1996-97,36.0,18,91,72,72,20,71,91,386.0,,1100,311,877,1188,4377.0,84,6.48,76,407,2545,10.7
22654,Ray Bourque,1997-98,37.0,19,43,46,46,12,31,43,210.0,,1146,323,908,1231,4587.0,48,5.97,37,209,1408,10.2
22655,Ray Bourque,1998-99,38.0,20,82,82,82,20,62,82,390.0,,1228,343,970,1313,4977.0,82,6.29,74,413,2481,10.4
22656,Ray Bourque,1999-00,39.0,21,50,62,62,19,31,50,230.0,,1290,362,1001,1363,5207.0,82,5.83,55,336,2444,9.8
22657,Ray Bourque,2000-01,40.0,22,48,82,82,13,35,48,264.0,,1372,375,1036,1411,5471.0,82,5.28,57,380,2242,9.6
22658,Ray Bourque,2001-02,41.0,23,57,81,81,10,47,57,262.0,2391.0,1453,385,1083,1468,5733.0,82,5.27,57,359,2285,9.4
22659,Ray Bourque,2002-03,42.0,24,52,79,79,18,34,52,260.0,2148.0,1532,403,1117,1520,5993.0,82,5.49,53,331,2294,9.8
22660,Ray Bourque,2003-04,43.0,25,59,80,80,7,52,59,216.0,2088.0,1612,410,1169,1579,6209.0,82,5.51,63,376,2272,9.9
22661,Ray Cote,1986-87,25.0,4,0,13,13,0,0,0,12.0,,13,0,0,0,12.0,80,7.89,74,336,2448,12.9
22662,Ray Cote,1987-88,26.0,5,0,2,2,0,0,0,1.0,,15,0,0,0,13.0,80,7.77,71,321,2447,12.7
22663,Ray Ferraro,1987-88,23.0,4,28,44,44,11,17,28,59.0,,44,11,17,28,59.0,80,7.77,71,321,2447,12.7
22664,Ray Ferraro,1988-89,24.0,5,77,76,76,30,47,77,131.0,,120,41,64,105,190.0,80,7.94,82,370,2484,12.8
22665,Ray Ferraro,1989-90,25.0,6,59,80,80,27,32,59,96.0,,200,68,96,164,286.0,80,7.34,72,344,2400,12.2
22666,Ray Ferraro,1990-91,26.0,7,50,68,68,21,29,50,105.0,,268,89,125,214,391.0,80,7.43,89,437,2435,12.2
22667,Ray Ferraro,1991-92,27.0,8,76,80,80,41,35,76,169.0,,348,130,160,290,560.0,80,7.48,85,403,2430,12.3
22668,Ray Ferraro,1992-93,28.0,9,54,79,79,25,29,54,138.0,,427,155,189,344,698.0,80,7.37,76,367,2421,12.2
22669,Ray Ferraro,1993-94,29.0,10,42,76,76,21,21,42,109.0,,503,176,210,386,807.0,80,6.91,71,366,2385,11.6
22670,Ray Ferraro,1994-95,30.0,11,80,80,80,40,40,80,154.0,,583,216,250,466,961.0,80,6.96,77,402,2440,11.4
22671,Ray Ferraro,1995-96,31.0,12,27,46,46,14,13,27,72.0,,629,230,263,493,1033.0,84,7.25,87,443,2603,11.7
22672,Ray Ferraro,1996-97,32.0,13,53,82,82,21,32,53,136.0,,711,251,295,546,1169.0,84,6.48,76,407,2545,10.7
22673,Ray Ferraro,1997-98,33.0,14,43,47,47,22,21,43,94.0,,758,273,316,589,1263.0,48,5.97,37,209,1408,10.2
22674,Ray Ferraro,1998-99,34.0,15,60,76,76,29,31,60,178.0,,834,302,347,649,1441.0,82,6.29,74,413,2481,10.4
22675,Ray Ferraro,1999-00,35.0,16,46,81,81,25,21,46,152.0,,915,327,368,695,1593.0,82,5.83,55,336,2444,9.8
22676,Ray Ferraro,2000-01,36.0,17,15,40,40,6,9,15,45.0,,955,333,377,710,1638.0,82,5.28,57,380,2242,9.6
22677,Ray Ferraro,2001-02,37.0,18,31,65,65,13,18,31,84.0,947.0,1020,346,395,741,1722.0,82,5.27,57,359,2285,9.4
22678,Ray Ferraro,2002-03,38.0,19,44,81,81,19,25,44,170.0,1309.0,1101,365,420,785,1892.0,82,5.49,53,331,2294,9.8
22679,Ray Ferraro,2003-04,39.0,20,76,81,81,29,47,76,172.0,1483.0,1182,394,467,861,2064.0,82,5.51,63,376,2272,9.9
22680,Ray Ferraro,2004-05,40.0,21,37,76,76,14,23,37,99.0,1187.0,1258,408,490,898,2163.0,82,5.24,53,338,2262,9.5
22681,Ray Giroux,2002-03,26.0,4,9,14,14,0,9,9,24.0,205.0,14,0,9,9,24.0,82,5.49,53,331,2294,9.8
22682,Ray Giroux,2004-05,28.0,5,0,2,2,0,0,0,2.0,25.0,16,0,9,9,26.0,82,5.24,53,338,2262,9.5
22683,Ray Giroux,2005-06,29.0,6,1,11,11,0,1,1,20.0,201.0,27,0,10,10,46.0,82,5.31,60,363,2326,9.4
22684,Ray Giroux,2006-07,30.0,7,3,11,11,0,3,3,17.0,230.0,38,0,13,13,63.0,82,5.14,57,348,2300,9.2
22685,Ray Macias,2011-12,25.0,4,1,6,6,0,1,1,4.0,108.0,6,0,1,1,4.0,82,5.7,65,341,2477,9.4
22686,Ray Macias,2013-14,27.0,5,0,2,2,0,0,0,0.0,30.0,8,0,1,1,4.0,82,5.46,52,291,2492,9.0
22687,Ray Markham,1982-83,25.0,4,2,14,14,1,1,2,6.0,,14,1,1,2,6.0,80,7.03,61,280,2352,12.0
22688,Ray Neufeld,1982-83,23.0,4,1,8,8,1,0,1,4.0,,8,1,0,1,4.0,80,7.03,61,280,2352,12.0
22689,Ray Neufeld,1983-84,24.0,5,15,52,52,5,10,15,55.0,,60,6,10,16,59.0,80,7.69,77,340,2441,12.6
22690,Ray Neufeld,1984-85,25.0,6,7,19,19,4,3,7,33.0,,79,10,13,23,92.0,80,8.03,73,320,2489,12.9
22691,Ray Neufeld,1985-86,26.0,7,57,80,80,26,31,57,166.0,,159,36,44,80,258.0,80,7.73,71,310,2444,12.7
22692,Ray Neufeld,1986-87,27.0,8,69,80,80,27,42,69,163.0,,239,63,86,149,421.0,80,7.89,74,336,2448,12.9
22693,Ray Neufeld,1987-88,28.0,9,62,76,76,27,35,62,177.0,,315,90,121,211,598.0,80,7.77,71,321,2447,12.7
22694,Ray Neufeld,1988-89,29.0,10,63,76,76,25,38,63,168.0,,391,115,159,274,766.0,80,7.94,82,370,2484,12.8
22695,Ray Neufeld,1989-90,30.0,11,36,80,80,18,18,36,134.0,,471,133,177,310,900.0,80,7.34,72,344,2400,12.2
22696,Ray Neufeld,1990-91,31.0,12,36,78,78,18,18,36,115.0,,549,151,195,346,1015.0,80,7.43,89,437,2435,12.2
22697,Ray Neufeld,1991-92,32.0,13,11,45,45,6,5,11,63.0,,594,157,200,357,1078.0,80,7.48,85,403,2430,12.3
22698,Ray Neufeld,1992-93,33.0,14,0,1,1,0,0,0,1.0,,595,157,200,357,1079.0,80,7.37,76,367,2421,12.2
22699,Ray Podloski,1991-92,26.0,4,1,8,8,0,1,1,3.0,,8,0,1,1,3.0,80,7.48,85,403,2430,12.3
22700,Ray Schultz,2000-01,24.0,4,1,13,13,0,1,1,4.0,,13,0,1,1,4.0,82,5.28,57,380,2242,9.6
22701,Ray Schultz,2001-02,25.0,5,0,4,4,0,0,0,2.0,61.0,17,0,1,1,6.0,82,5.27,57,359,2285,9.4
22702,Ray Schultz,2002-03,26.0,6,1,9,9,0,1,1,2.0,129.0,26,0,2,2,8.0,82,5.49,53,331,2294,9.8
22703,Ray Schultz,2003-04,27.0,7,2,13,13,0,2,2,3.0,141.0,39,0,4,4,11.0,82,5.51,63,376,2272,9.9
22704,Ray Schultz,2004-05,28.0,8,0,2,2,0,0,0,0.0,7.0,41,0,4,4,11.0,82,5.24,53,338,2262,9.5
22705,Ray Schultz,2005-06,29.0,9,0,4,4,0,0,0,1.0,22.0,45,0,4,4,12.0,82,5.31,60,363,2326,9.4
22706,Ray Sheppard,1990-91,24.0,4,65,74,74,38,27,65,173.0,,74,38,27,65,173.0,80,7.43,89,437,2435,12.2
22707,Ray Sheppard,1991-92,25.0,5,43,67,67,22,21,43,147.0,,141,60,48,108,320.0,80,7.48,85,403,2430,12.3
22708,Ray Sheppard,1992-93,26.0,6,6,18,18,4,2,6,31.0,,159,64,50,114,351.0,80,7.37,76,367,2421,12.2
22709,Ray Sheppard,1993-94,27.0,7,47,59,59,24,23,47,129.0,,218,88,73,161,480.0,80,6.91,71,366,2385,11.6
22710,Ray Sheppard,1994-95,28.0,8,62,74,74,36,26,62,178.0,,292,124,99,223,658.0,80,6.96,77,402,2440,11.4
22711,Ray Sheppard,1995-96,29.0,9,66,70,70,32,34,66,183.0,,362,156,133,289,841.0,84,7.25,87,443,2603,11.7
22712,Ray Sheppard,1996-97,30.0,10,93,82,82,52,41,93,260.0,,444,208,174,382,1101.0,84,6.48,76,407,2545,10.7
22713,Ray Sheppard,1997-98,31.0,11,40,43,43,30,10,40,125.0,,487,238,184,422,1226.0,48,5.97,37,209,1408,10.2
22714,Ray Sheppard,1998-99,32.0,12,60,70,70,37,23,60,231.0,,557,275,207,482,1457.0,82,6.29,74,413,2481,10.4
22715,Ray Sheppard,1999-00,33.0,13,60,68,68,29,31,60,226.0,,625,304,238,542,1683.0,82,5.83,55,336,2444,9.8
22716,Ray Sheppard,2000-01,34.0,14,37,71,71,18,19,37,169.0,,696,322,257,579,1852.0,82,5.28,57,380,2242,9.6
22717,Ray Sheppard,2001-02,35.0,15,58,74,74,25,33,58,188.0,1347.0,770,347,290,637,2040.0,82,5.27,57,359,2285,9.4
22718,Ray Sheppard,2002-03,36.0,16,20,47,47,10,10,20,74.0,640.0,817,357,300,657,2114.0,82,5.49,53,331,2294,9.8
22719,Ray Staszak,1988-89,26.0,4,1,4,4,0,1,1,9.0,,4,0,1,1,9.0,80,7.94,82,370,2484,12.8
22720,Ray Whitney,1994-95,22.0,4,3,2,2,0,3,3,4.0,,2,0,3,3,4.0,80,6.96,77,402,2440,11.4
22721,Ray Whitney,1995-96,23.0,5,10,26,26,4,6,10,24.0,,28,4,9,13,28.0,84,7.25,87,443,2603,11.7
22722,Ray Whitney,1996-97,24.0,6,40,61,61,14,26,40,82.0,,89,18,35,53,110.0,84,6.48,76,407,2545,10.7
22723,Ray Whitney,1997-98,25.0,7,25,39,39,13,12,25,67.0,,128,31,47,78,177.0,48,5.97,37,209,1408,10.2
22724,Ray Whitney,1998-99,26.0,8,41,60,60,17,24,41,106.0,,188,48,71,119,283.0,82,6.29,74,413,2481,10.4
22725,Ray Whitney,1999-00,27.0,9,2,12,12,0,2,2,24.0,,200,48,73,121,307.0,82,5.83,55,336,2444,9.8
22726,Ray Whitney,2000-01,28.0,10,65,77,77,33,32,65,175.0,,277,81,105,186,482.0,82,5.28,57,380,2242,9.6
22727,Ray Whitney,2001-02,29.0,11,64,81,81,26,38,64,193.0,1485.0,358,107,143,250,675.0,82,5.27,57,359,2285,9.4
22728,Ray Whitney,2002-03,30.0,12,71,81,81,29,42,71,198.0,1514.0,439,136,185,321,873.0,82,5.49,53,331,2294,9.8
22729,Ray Whitney,2003-04,31.0,13,34,46,46,10,24,34,120.0,821.0,485,146,209,355,993.0,82,5.51,63,376,2272,9.9
22730,Ray Whitney,2004-05,32.0,14,61,67,67,21,40,61,210.0,1355.0,552,167,249,416,1203.0,82,5.24,53,338,2262,9.5
22731,Ray Whitney,2005-06,33.0,15,76,81,81,24,52,76,235.0,1701.0,633,191,301,492,1438.0,82,5.31,60,363,2326,9.4
22732,Ray Whitney,2006-07,34.0,16,43,67,67,14,29,43,119.0,1099.0,700,205,330,535,1557.0,82,5.14,57,348,2300,9.2
22733,Ray Whitney,2008-09,36.0,17,55,63,63,17,38,55,147.0,1083.0,763,222,368,590,1704.0,82,6.05,85,480,2458,10.1
22734,Ray Whitney,2009-10,37.0,18,83,81,81,32,51,83,215.0,1515.0,844,254,419,673,1919.0,82,5.76,70,398,2426,9.7
22735,Ray Whitney,2010-11,38.0,19,61,66,66,25,36,61,204.0,1250.0,910,279,455,734,2123.0,82,5.44,62,351,2383,9.4
22736,Ray Whitney,2011-12,39.0,20,77,82,82,24,53,77,219.0,1510.0,992,303,508,811,2342.0,82,5.7,65,341,2477,9.4
22737,Ray Whitney,2012-13,40.0,21,58,80,80,21,37,58,171.0,1532.0,1072,324,545,869,2513.0,82,5.53,56,304,2486,9.1
22738,Ray Whitney,2013-14,41.0,22,57,75,75,17,40,57,156.0,1272.0,1147,341,585,926,2669.0,82,5.46,52,291,2492,9.0
22739,Ray Whitney,2014-15,42.0,23,77,82,82,24,53,77,185.0,1529.0,1229,365,638,1003,2854.0,82,5.32,47,271,2439,8.9
22740,Ray Whitney,2015-16,43.0,24,29,32,32,11,18,29,62.0,621.0,1261,376,656,1032,2916.0,48,5.31,29,160,1399,9.1
22741,Ray Whitney,2016-17,44.0,25,32,69,69,9,23,32,124.0,963.0,1330,385,679,1064,3040.0,82,5.34,48,269,2463,8.9
22742,Raymond Sawada,2011-12,26.0,4,1,5,5,1,0,1,2.0,43.0,5,1,0,1,2.0,82,5.7,65,341,2477,9.4
22743,Raymond Sawada,2012-13,27.0,5,0,5,5,0,0,0,2.0,41.0,10,1,0,1,4.0,82,5.53,56,304,2486,9.1
22744,Raymond Sawada,2013-14,28.0,6,0,1,1,0,0,0,1.0,6.0,11,1,0,1,5.0,82,5.46,52,291,2492,9.0
22745,Real Cloutier,1982-83,26.0,4,89,67,67,42,47,89,254.0,,67,42,47,89,254.0,80,7.03,61,280,2352,12.0
22746,Real Cloutier,1983-84,27.0,5,31,34,34,15,16,31,89.0,,101,57,63,120,343.0,80,7.69,77,340,2441,12.6
22747,Real Cloutier,1984-85,28.0,6,97,67,67,37,60,97,214.0,,168,94,123,217,557.0,80,8.03,73,320,2489,12.9
22748,Real Cloutier,1985-86,29.0,7,67,68,68,28,39,67,185.0,,236,122,162,284,742.0,80,7.73,71,310,2444,12.7
22749,Real Cloutier,1986-87,30.0,8,60,77,77,24,36,60,169.0,,313,146,198,344,911.0,80,7.89,74,336,2448,12.9
22750,Real Cloutier,1987-88,31.0,9,0,5,5,0,0,0,7.0,,318,146,198,344,918.0,80,7.77,71,321,2447,12.7
22751,Reed Low,2003-04,27.0,4,6,56,56,1,5,6,31.0,352.0,56,1,5,6,31.0,82,5.51,63,376,2272,9.9
22752,Reed Low,2004-05,28.0,5,5,58,58,0,5,5,25.0,311.0,114,1,10,11,56.0,82,5.24,53,338,2262,9.5
22753,Reed Low,2005-06,29.0,6,6,79,79,2,4,6,48.0,499.0,193,3,14,17,104.0,82,5.31,60,363,2326,9.4
22754,Reed Low,2006-07,30.0,7,2,57,57,0,2,2,28.0,325.0,250,3,16,19,132.0,82,5.14,57,348,2300,9.2
22755,Reed Low,2009-10,33.0,8,0,6,6,0,0,0,0.0,21.0,256,3,16,19,132.0,82,5.76,70,398,2426,9.7
22756,Reg Thomas,1982-83,29.0,4,16,39,39,9,7,16,89.0,,39,9,7,16,89.0,80,7.03,61,280,2352,12.0
22757,Reggie Savage,1993-94,23.0,4,0,1,1,0,0,0,2.0,,1,0,0,0,2.0,80,6.91,71,366,2385,11.6
22758,Reggie Savage,1995-96,25.0,5,5,16,16,2,3,5,20.0,,17,2,3,5,22.0,84,7.25,87,443,2603,11.7
22759,Reggie Savage,1996-97,26.0,6,7,17,17,3,4,7,25.0,,34,5,7,12,47.0,84,6.48,76,407,2545,10.7
22760,Reid Bailey,1983-84,27.0,4,4,17,17,1,3,4,16.0,,17,1,3,4,16.0,80,7.69,77,340,2441,12.6
22761,Reid Bailey,1984-85,28.0,5,0,10,10,0,0,0,7.0,,27,1,3,4,23.0,80,8.03,73,320,2489,12.9
22762,Reid Bailey,1985-86,29.0,6,0,1,1,0,0,0,0.0,,28,1,3,4,23.0,80,7.73,71,310,2444,12.7
22763,Reid Bailey,1986-87,30.0,7,0,12,12,0,0,0,8.0,,40,1,3,4,31.0,80,7.89,74,336,2448,12.9
22764,Reid Boucher,2016-17,23.0,4,7,23,23,2,5,7,27.0,261.0,23,2,5,7,27.0,82,5.34,48,269,2463,8.9
22765,Reid Boucher,2017-18,24.0,5,1,11,11,1,0,1,20.0,123.0,34,3,5,8,47.0,82,5.32,47,251,2453,8.9
22766,Reid Boucher,2018-19,25.0,6,19,39,39,8,11,19,74.0,557.0,73,11,16,27,121.0,82,5.34,48,255,2438,9.0
22767,Reid Boucher,2019-20,26.0,7,10,39,39,6,4,10,70.0,465.0,112,17,20,37,191.0,82,5.45,47,245,2478,9.0
22768,Reid Boucher,2020-21,27.0,8,5,20,20,3,2,5,37.0,228.0,132,20,22,42,228.0,82,5.86,50,250,2620,9.2
22769,Reid Boucher,2021-22,28.0,9,0,1,1,0,0,0,0.0,5.0,133,20,22,42,228.0,82,5.96,47,239,2579,9.5
22770,Reid Simpson,1994-95,25.0,4,0,1,1,0,0,0,0.0,,1,0,0,0,0.0,80,6.96,77,402,2440,11.4
22771,Reid Simpson,1995-96,26.0,5,0,1,1,0,0,0,0.0,,2,0,0,0,0.0,84,7.25,87,443,2603,11.7
22772,Reid Simpson,1997-98,28.0,6,0,9,9,0,0,0,5.0,,11,0,0,0,5.0,48,5.97,37,209,1408,10.2
22773,Reid Simpson,1998-99,29.0,7,6,23,23,1,5,6,8.0,,34,1,5,6,13.0,82,6.29,74,413,2481,10.4
22774,Reid Simpson,1999-00,30.0,8,4,27,27,0,4,4,17.0,,61,1,9,10,30.0,82,5.83,55,336,2444,9.8
22775,Reid Simpson,2000-01,31.0,9,5,44,44,3,2,5,24.0,,105,4,11,15,54.0,82,5.28,57,380,2242,9.6
22776,Reid Simpson,2001-02,32.0,10,9,53,53,5,4,9,23.0,314.0,158,9,15,24,77.0,82,5.27,57,359,2285,9.4
22777,Reid Simpson,2002-03,33.0,11,1,26,26,1,0,1,13.0,118.0,184,10,15,25,90.0,82,5.49,53,331,2294,9.8
22778,Reid Simpson,2003-04,34.0,12,3,38,38,2,1,3,23.0,264.0,222,12,16,28,113.0,82,5.51,63,376,2272,9.9
22779,Reid Simpson,2004-05,35.0,13,7,51,51,6,1,7,22.0,259.0,273,18,17,35,135.0,82,5.24,53,338,2262,9.5
22780,Reid Simpson,2005-06,36.0,14,1,26,26,0,1,1,11.0,132.0,299,18,18,36,146.0,82,5.31,60,363,2326,9.4
22781,Reid Simpson,2006-07,37.0,15,0,2,2,0,0,0,2.0,10.0,301,18,18,36,148.0,82,5.14,57,348,2300,9.2
22782,Reijo Ruotsalainen,1984-85,24.0,4,56,78,78,18,38,56,247.0,,78,18,38,56,247.0,80,8.03,73,320,2489,12.9
22783,Reijo Ruotsalainen,1985-86,25.0,5,69,77,77,16,53,69,230.0,,155,34,91,125,477.0,80,7.73,71,310,2444,12.7
22784,Reijo Ruotsalainen,1986-87,26.0,6,59,74,74,20,39,59,288.0,,229,54,130,184,765.0,80,7.89,74,336,2448,12.9
22785,Reijo Ruotsalainen,1987-88,27.0,7,73,80,80,28,45,73,256.0,,309,82,175,257,1021.0,80,7.77,71,321,2447,12.7
22786,Reijo Ruotsalainen,1988-89,28.0,8,59,80,80,17,42,59,229.0,,389,99,217,316,1250.0,80,7.94,82,370,2484,12.8
22787,Reijo Ruotsalainen,1989-90,29.0,9,13,16,16,5,8,13,52.0,,405,104,225,329,1302.0,80,7.34,72,344,2400,12.2
22788,Reijo Ruotsalainen,1992-93,32.0,10,15,41,41,3,12,15,80.0,,446,107,237,344,1382.0,80,7.37,76,367,2421,12.2
22789,Reilly Smith,2014-15,23.0,4,0,3,3,0,0,0,2.0,25.0,3,0,0,0,2.0,82,5.32,47,271,2439,8.9
22790,Reilly Smith,2015-16,24.0,5,9,37,37,3,6,9,34.0,404.0,40,3,6,9,36.0,48,5.31,29,160,1399,9.1
22791,Reilly Smith,2016-17,25.0,6,51,82,82,20,31,51,146.0,1206.0,122,23,37,60,182.0,82,5.34,48,269,2463,8.9
22792,Reilly Smith,2017-18,26.0,7,40,81,81,13,27,40,143.0,1247.0,203,36,64,100,325.0,82,5.32,47,251,2453,8.9
22793,Reilly Smith,2018-19,27.0,8,50,82,82,25,25,50,173.0,1526.0,285,61,89,150,498.0,82,5.34,48,255,2438,9.0
22794,Reilly Smith,2019-20,28.0,9,37,80,80,15,22,37,160.0,1468.0,365,76,111,187,658.0,82,5.45,47,245,2478,9.0
22795,Reilly Smith,2020-21,29.0,10,60,67,67,22,38,60,162.0,1201.0,432,98,149,247,820.0,82,5.86,50,250,2620,9.2
22796,Reilly Smith,2021-22,30.0,11,53,74,74,19,34,53,178.0,1352.0,506,117,183,300,998.0,82,5.96,47,239,2579,9.5
22797,Reilly Smith,2022-23,31.0,12,54,71,71,27,27,54,169.0,1272.0,577,144,210,354,1167.0,70,5.96,42,208,2192,9.5
22798,Rejean Cloutier,1982-83,22.0,4,1,3,3,0,1,1,1.0,,3,0,1,1,1.0,80,7.03,61,280,2352,12.0
22799,Rejean Cloutier,1984-85,24.0,5,1,2,2,0,1,1,0.0,,5,0,2,2,1.0,80,8.03,73,320,2489,12.9
22800,Rem Murray,1999-00,27.0,4,31,82,82,11,20,31,85.0,,82,11,20,31,85.0,82,5.83,55,336,2444,9.8
22801,Rem Murray,2000-01,28.0,5,18,61,61,9,9,18,59.0,,143,20,29,49,144.0,82,5.28,57,380,2242,9.6
22802,Rem Murray,2001-02,29.0,6,39,78,78,21,18,39,116.0,1235.0,221,41,47,88,260.0,82,5.27,57,359,2285,9.4
22803,Rem Murray,2002-03,30.0,7,14,44,44,9,5,14,65.0,628.0,265,50,52,102,325.0,82,5.49,53,331,2294,9.8
22804,Rem Murray,2003-04,31.0,8,36,82,82,15,21,36,122.0,1259.0,347,65,73,138,447.0,82,5.51,63,376,2272,9.9
22805,Rem Murray,2004-05,32.0,9,27,80,80,8,19,27,98.0,1172.0,427,73,92,165,545.0,82,5.24,53,338,2262,9.5
22806,Rem Murray,2005-06,33.0,10,31,85,85,12,19,31,143.0,1416.0,512,85,111,196,688.0,82,5.31,60,363,2326,9.4
22807,Rem Murray,2006-07,34.0,11,17,39,39,8,9,17,58.0,648.0,551,93,120,213,746.0,82,5.14,57,348,2300,9.2
22808,Rem Murray,2008-09,36.0,12,2,9,9,1,1,2,6.0,70.0,560,94,121,215,752.0,82,6.05,85,480,2458,10.1
22809,Rem Pitlick,2021-22,24.0,4,0,1,1,0,0,0,0.0,10.0,1,0,0,0,0.0,82,5.96,47,239,2579,9.5
22810,Remi Elie,2019-20,24.0,4,7,18,18,1,6,7,15.0,281.0,18,1,6,7,15.0,82,5.45,47,245,2478,9.0
22811,Remi Elie,2020-21,25.0,5,14,72,72,6,8,14,70.0,738.0,90,7,14,21,85.0,82,5.86,50,250,2620,9.2
22812,Remi Elie,2021-22,26.0,6,1,16,16,0,1,1,9.0,166.0,106,7,15,22,94.0,82,5.96,47,239,2579,9.5
22813,Remi Royer,2001-02,23.0,4,0,18,18,0,0,0,24.0,245.0,18,0,0,0,24.0,82,5.27,57,359,2285,9.4
22814,Rene Bourque,2008-09,27.0,4,34,77,77,16,18,34,180.0,1181.0,77,16,18,34,180.0,82,6.05,85,480,2458,10.1
22815,Rene Bourque,2009-10,28.0,5,17,44,44,7,10,17,82.0,705.0,121,23,28,51,262.0,82,5.76,70,398,2426,9.7
22816,Rene Bourque,2010-11,29.0,6,24,62,62,10,14,24,103.0,947.0,183,33,42,75,365.0,82,5.44,62,351,2383,9.4
22817,Rene Bourque,2011-12,30.0,7,40,58,58,21,19,40,149.0,933.0,241,54,61,115,514.0,82,5.7,65,341,2477,9.4
22818,Rene Bourque,2012-13,31.0,8,58,73,73,27,31,58,215.0,1337.0,314,81,92,173,729.0,82,5.53,56,304,2486,9.1
22819,Rene Bourque,2013-14,32.0,9,50,80,80,27,23,50,218.0,1420.0,394,108,115,223,947.0,82,5.46,52,291,2492,9.0
22820,Rene Bourque,2014-15,33.0,10,24,76,76,18,6,24,158.0,1355.0,470,126,121,247,1105.0,82,5.32,47,271,2439,8.9
22821,Rene Bourque,2015-16,34.0,11,13,27,27,7,6,13,63.0,441.0,497,133,127,260,1168.0,48,5.31,29,160,1399,9.1
22822,Rene Bourque,2016-17,35.0,12,16,63,63,9,7,16,118.0,894.0,560,142,134,276,1286.0,82,5.34,48,269,2463,8.9
22823,Rene Bourque,2017-18,36.0,13,14,51,51,6,8,14,85.0,644.0,611,148,142,290,1371.0,82,5.32,47,251,2453,8.9
22824,Rene Bourque,2018-19,37.0,14,8,49,49,3,5,8,77.0,512.0,660,151,147,298,1448.0,82,5.34,48,255,2438,9.0
22825,Rene Bourque,2019-20,38.0,15,18,65,65,12,6,18,111.0,906.0,725,163,153,316,1559.0,82,5.45,47,245,2478,9.0
22826,Rene Chapdelaine,1993-94,27.0,4,1,3,3,0,1,1,1.0,,3,0,1,1,1.0,80,6.91,71,366,2385,11.6
22827,Rene Chapdelaine,1994-95,28.0,5,1,16,16,0,1,1,6.0,,19,0,2,2,7.0,80,6.96,77,402,2440,11.4
22828,Rene Chapdelaine,1995-96,29.0,6,0,13,13,0,0,0,5.0,,32,0,2,2,12.0,84,7.25,87,443,2603,11.7
22829,Rene Corbet,1996-97,23.0,4,2,9,9,1,1,2,14.0,,9,1,1,2,14.0,84,6.48,76,407,2545,10.7
22830,Rene Corbet,1997-98,24.0,5,3,8,8,0,3,3,4.0,,17,1,4,5,18.0,48,5.97,37,209,1408,10.2
22831,Rene Corbet,1998-99,25.0,6,9,33,33,3,6,9,35.0,,50,4,10,14,53.0,82,6.29,74,413,2481,10.4
22832,Rene Corbet,1999-00,26.0,7,27,76,76,12,15,27,128.0,,126,16,25,41,181.0,82,5.83,55,336,2444,9.8
22833,Rene Corbet,2000-01,27.0,8,28,68,68,16,12,28,117.0,,194,32,37,69,298.0,82,5.28,57,380,2242,9.6
22834,Rene Corbet,2001-02,28.0,9,31,73,73,13,18,31,127.0,979.0,267,45,55,100,425.0,82,5.27,57,359,2285,9.4
22835,Rene Corbet,2002-03,29.0,10,15,52,52,5,10,15,109.0,605.0,319,50,65,115,534.0,82,5.49,53,331,2294,9.8
22836,Rene Corbet,2003-04,30.0,11,17,43,43,8,9,17,85.0,493.0,362,58,74,132,619.0,82,5.51,63,376,2272,9.9
22837,Reto Von Arx,2003-04,27.0,4,4,19,19,3,1,4,12.0,217.0,19,3,1,4,12.0,82,5.51,63,376,2272,9.9
22838,Rhett Gardner,2022-23,26.0,4,0,8,8,0,0,0,8.0,81.0,8,0,0,0,8.0,70,5.96,42,208,2192,9.5
22839,Rhett Rakhshani,2013-14,25.0,4,0,2,2,0,0,0,2.0,23.0,2,0,0,0,2.0,82,5.46,52,291,2492,9.0
22840,Rhett Rakhshani,2014-15,26.0,5,0,5,5,0,0,0,3.0,61.0,7,0,0,0,5.0,82,5.32,47,271,2439,8.9
22841,Rhett Warrener,1998-99,23.0,4,3,28,28,0,3,3,19.0,,28,0,3,3,19.0,82,6.29,74,413,2481,10.4
22842,Rhett Warrener,1999-00,24.0,5,13,62,62,4,9,13,58.0,,90,4,12,16,77.0,82,5.83,55,336,2444,9.8
22843,Rhett Warrener,2000-01,25.0,6,4,79,79,0,4,4,66.0,,169,4,16,20,143.0,82,5.28,57,380,2242,9.6
22844,Rhett Warrener,2001-02,26.0,7,8,61,61,1,7,8,44.0,1150.0,230,5,23,28,187.0,82,5.27,57,359,2285,9.4
22845,Rhett Warrener,2002-03,27.0,8,3,61,61,0,3,3,68.0,1211.0,291,5,26,31,255.0,82,5.49,53,331,2294,9.8
22846,Rhett Warrener,2003-04,28.0,9,19,77,77,3,16,19,103.0,1570.0,368,8,42,50,358.0,82,5.51,63,376,2272,9.9
22847,Rhett Warrener,2004-05,29.0,10,10,65,65,5,5,10,66.0,1277.0,433,13,47,60,424.0,82,5.24,53,338,2262,9.5
22848,Rhett Warrener,2005-06,30.0,11,9,50,50,0,9,9,47.0,912.0,483,13,56,69,471.0,82,5.31,60,363,2326,9.4
22849,Rhett Warrener,2006-07,31.0,12,17,77,77,3,14,17,82.0,1530.0,560,16,70,86,553.0,82,5.14,57,348,2300,9.2
22850,Rhett Warrener,2008-09,33.0,13,6,61,61,3,3,6,40.0,1171.0,621,19,73,92,593.0,82,6.05,85,480,2458,10.1
22851,Rhett Warrener,2009-10,34.0,14,10,62,62,4,6,10,31.0,1062.0,683,23,79,102,624.0,82,5.76,70,398,2426,9.7
22852,Rhett Warrener,2010-11,35.0,15,4,31,31,1,3,4,15.0,416.0,714,24,82,106,639.0,82,5.44,62,351,2383,9.4
22853,Ric Jackman,2002-03,24.0,4,3,22,22,1,2,3,16.0,178.0,22,1,2,3,16.0,82,5.49,53,331,2294,9.8
22854,Ric Jackman,2003-04,25.0,5,0,16,16,0,0,0,10.0,142.0,38,1,2,3,26.0,82,5.51,63,376,2272,9.9
22855,Ric Jackman,2004-05,26.0,6,0,2,2,0,0,0,4.0,27.0,40,1,2,3,30.0,82,5.24,53,338,2262,9.5
22856,Ric Jackman,2005-06,27.0,7,2,42,42,0,2,2,35.0,587.0,82,1,4,5,65.0,82,5.31,60,363,2326,9.4
22857,Ric Jackman,2006-07,28.0,8,30,54,54,9,21,30,91.0,1128.0,136,10,25,35,156.0,82,5.14,57,348,2300,9.2
22858,Ric Jackman,2008-09,30.0,9,30,64,64,7,23,30,120.0,1110.0,200,17,48,65,276.0,82,6.05,85,480,2458,10.1
22859,Ric Jackman,2009-10,31.0,10,12,31,31,2,10,12,36.0,425.0,231,19,58,77,312.0,82,5.76,70,398,2426,9.7
22860,Ric Nattress,1985-86,23.0,4,4,40,40,1,3,4,44.0,,40,1,3,4,44.0,80,7.73,71,310,2444,12.7
22861,Ric Nattress,1986-87,24.0,5,12,34,34,0,12,12,31.0,,74,1,15,16,75.0,80,7.89,74,336,2448,12.9
22862,Ric Nattress,1987-88,25.0,6,1,5,5,0,1,1,3.0,,79,1,16,17,78.0,80,7.77,71,321,2447,12.7
22863,Ric Nattress,1988-89,26.0,7,24,78,78,4,20,24,124.0,,157,5,36,41,202.0,80,7.94,82,370,2484,12.8
22864,Ric Nattress,1989-90,27.0,8,28,73,73,6,22,28,135.0,,230,11,58,69,337.0,80,7.34,72,344,2400,12.2
22865,Ric Nattress,1990-91,28.0,9,15,63,63,2,13,15,48.0,,293,13,71,84,385.0,80,7.43,89,437,2435,12.2
22866,Ric Nattress,1991-92,29.0,10,9,38,38,1,8,9,28.0,,331,14,79,93,413.0,80,7.48,85,403,2430,12.3
22867,Ric Nattress,1992-93,30.0,11,15,49,49,1,14,15,65.0,,380,15,93,108,478.0,80,7.37,76,367,2421,12.2
22868,Ric Nattress,1993-94,31.0,12,18,58,58,5,13,18,81.0,,438,20,106,126,559.0,80,6.91,71,366,2385,11.6
22869,Ric Nattress,1994-95,32.0,13,21,54,54,2,19,21,66.0,,492,22,125,147,625.0,80,6.96,77,402,2440,11.4
22870,Ric Nattress,1995-96,33.0,14,17,44,44,7,10,17,57.0,,536,29,135,164,682.0,84,7.25,87,443,2603,11.7
22871,Ricard Persson,1998-99,29.0,4,3,12,12,2,1,3,41.0,,12,2,1,3,41.0,82,6.29,74,413,2481,10.4
22872,Ricard Persson,1999-00,30.0,5,12,54,54,4,8,12,70.0,,66,6,9,15,111.0,82,5.83,55,336,2444,9.8
22873,Ricard Persson,2000-01,31.0,6,0,1,1,0,0,0,0.0,,67,6,9,15,111.0,82,5.28,57,380,2242,9.6
22874,Ricard Persson,2001-02,32.0,7,13,54,54,1,12,13,52.0,1078.0,121,7,21,28,163.0,82,5.27,57,359,2285,9.4
22875,Ricard Persson,2002-03,33.0,8,8,41,41,0,8,8,30.0,508.0,162,7,29,36,193.0,82,5.49,53,331,2294,9.8
22876,Ricard Persson,2003-04,34.0,9,9,33,33,1,8,9,43.0,564.0,195,8,37,45,236.0,82,5.51,63,376,2272,9.9
22877,Ricard Persson,2004-05,35.0,10,9,34,34,2,7,9,35.0,495.0,229,10,44,54,271.0,82,5.24,53,338,2262,9.5
22878,Rich Brennan,1999-00,27.0,4,0,2,2,0,0,0,0.0,,2,0,0,0,0.0,82,5.83,55,336,2444,9.8
22879,Rich Brennan,2000-01,28.0,5,3,11,11,1,2,3,24.0,,13,1,2,3,24.0,82,5.28,57,380,2242,9.6
22880,Rich Brennan,2001-02,29.0,6,4,24,24,1,3,4,36.0,313.0,37,2,5,7,60.0,82,5.27,57,359,2285,9.4
22881,Rich Brennan,2003-04,31.0,7,0,2,2,0,0,0,1.0,29.0,39,2,5,7,61.0,82,5.51,63,376,2272,9.9
22882,Rich Brennan,2004-05,32.0,8,0,4,4,0,0,0,0.0,58.0,43,2,5,7,61.0,82,5.24,53,338,2262,9.5
22883,Rich Brennan,2005-06,33.0,9,1,7,7,0,1,1,12.0,95.0,50,2,6,8,73.0,82,5.31,60,363,2326,9.4
22884,Rich Chernomaz,1984-85,21.0,4,0,2,2,0,0,0,2.0,,2,0,0,0,2.0,80,8.03,73,320,2489,12.9
22885,Rich Chernomaz,1986-87,23.0,5,3,7,7,2,1,3,7.0,,9,2,1,3,9.0,80,7.89,74,336,2448,12.9
22886,Rich Chernomaz,1987-88,24.0,6,2,3,3,0,2,2,2.0,,12,2,3,5,11.0,80,7.77,71,321,2447,12.7
22887,Rich Chernomaz,1989-90,26.0,7,10,25,25,6,4,10,44.0,,37,8,7,15,55.0,80,7.34,72,344,2400,12.2
22888,Rich Chernomaz,1990-91,27.0,8,1,2,2,1,0,1,5.0,,39,9,7,16,60.0,80,7.43,89,437,2435,12.2
22889,Rich Chernomaz,1991-92,28.0,9,0,1,1,0,0,0,2.0,,40,9,7,16,62.0,80,7.48,85,403,2430,12.3
22890,Rich Chernomaz,1994-95,31.0,10,0,11,11,0,0,0,21.0,,51,9,7,16,83.0,80,6.96,77,402,2440,11.4
22891,Rich Clune,2012-13,25.0,4,2,14,14,0,2,2,7.0,102.0,14,0,2,2,7.0,82,5.53,56,304,2486,9.1
22892,Rich Clune,2015-16,28.0,5,9,47,47,4,5,9,46.0,442.0,61,4,7,11,53.0,48,5.31,29,160,1399,9.1
22893,Rich Clune,2016-17,29.0,6,7,58,58,3,4,7,29.0,491.0,119,7,11,18,82.0,82,5.34,48,269,2463,8.9
22894,Rich Clune,2017-18,30.0,7,0,1,1,0,0,0,0.0,6.0,120,7,11,18,82.0,82,5.32,47,251,2453,8.9
22895,Rich Clune,2018-19,31.0,8,4,19,19,0,4,4,10.0,154.0,139,7,15,22,92.0,82,5.34,48,255,2438,9.0
22896,Rich Costello,1986-87,23.0,4,3,10,10,2,1,3,7.0,,10,2,1,3,7.0,80,7.89,74,336,2448,12.9
22897,Rich Costello,1988-89,25.0,5,1,2,2,0,1,1,2.0,,12,2,2,4,9.0,80,7.94,82,370,2484,12.8
22898,Rich Peverley,2009-10,27.0,4,1,13,13,0,1,1,9.0,98.0,13,0,1,1,9.0,82,5.76,70,398,2426,9.7
22899,Rich Peverley,2010-11,28.0,5,10,33,33,5,5,10,43.0,341.0,46,5,6,11,52.0,82,5.44,62,351,2383,9.4
22900,Rich Peverley,2011-12,29.0,6,44,66,66,15,29,44,117.0,1062.0,112,20,35,55,169.0,82,5.7,65,341,2477,9.4
22901,Rich Peverley,2012-13,30.0,7,55,82,82,22,33,55,166.0,1530.0,194,42,68,110,335.0,82,5.53,56,304,2486,9.1
22902,Rich Peverley,2013-14,31.0,8,41,82,82,18,23,41,201.0,1497.0,276,60,91,151,536.0,82,5.46,52,291,2492,9.0
22903,Rich Peverley,2014-15,32.0,9,42,57,57,11,31,42,112.0,963.0,333,71,122,193,648.0,82,5.32,47,271,2439,8.9
22904,Rich Peverley,2015-16,33.0,10,18,47,47,6,12,18,95.0,717.0,380,77,134,211,743.0,48,5.31,29,160,1399,9.1
22905,Rich Peverley,2016-17,34.0,11,30,62,62,7,23,30,122.0,954.0,442,84,157,241,865.0,82,5.34,48,269,2463,8.9
22906,Rich Pilon,1991-92,23.0,4,14,62,62,0,14,14,47.0,,62,0,14,14,47.0,80,7.48,85,403,2430,12.3
22907,Rich Pilon,1992-93,24.0,5,2,14,14,0,2,2,5.0,,76,0,16,16,52.0,80,7.37,76,367,2421,12.2
22908,Rich Pilon,1993-94,25.0,6,5,60,60,1,4,5,33.0,,136,1,20,21,85.0,80,6.91,71,366,2385,11.6
22909,Rich Pilon,1994-95,26.0,7,7,65,65,1,6,7,27.0,,201,2,26,28,112.0,80,6.96,77,402,2440,11.4
22910,Rich Pilon,1995-96,27.0,8,4,44,44,1,3,4,20.0,,245,3,29,32,132.0,84,7.25,87,443,2603,11.7
22911,Rich Pilon,1996-97,28.0,9,5,28,28,1,4,5,20.0,,273,4,33,37,152.0,84,6.48,76,407,2545,10.7
22912,Rich Pilon,1997-98,29.0,10,2,20,20,1,1,2,11.0,,293,5,34,39,163.0,48,5.97,37,209,1408,10.2
22913,Rich Pilon,1998-99,30.0,11,3,27,27,0,3,3,7.0,,320,5,37,42,170.0,82,6.29,74,413,2481,10.4
22914,Rich Pilon,1999-00,31.0,12,5,52,52,1,4,5,17.0,,372,6,41,47,187.0,82,5.83,55,336,2444,9.8
22915,Rich Pilon,2000-01,32.0,13,7,76,76,0,7,7,37.0,,448,6,48,54,224.0,82,5.28,57,380,2242,9.6
22916,Rich Pilon,2001-02,33.0,14,4,52,52,0,4,4,27.0,862.0,500,6,52,58,251.0,82,5.27,57,359,2285,9.4
22917,Rich Pilon,2002-03,34.0,15,6,54,54,0,6,6,16.0,889.0,554,6,58,64,267.0,82,5.49,53,331,2294,9.8
22918,Rich Pilon,2003-04,35.0,16,11,69,69,2,9,11,24.0,1164.0,623,8,67,75,291.0,82,5.51,63,376,2272,9.9
22919,Rich Pilon,2004-05,36.0,17,2,8,8,0,2,2,3.0,102.0,631,8,69,77,294.0,82,5.24,53,338,2262,9.5
22920,Rich Preston,1982-83,30.0,4,61,80,80,31,30,61,205.0,,80,31,30,61,205.0,80,7.03,61,280,2352,12.0
22921,Rich Preston,1983-84,31.0,5,21,47,47,7,14,21,100.0,,127,38,44,82,305.0,80,7.69,77,340,2441,12.6
22922,Rich Preston,1984-85,32.0,6,43,75,75,15,28,43,122.0,,202,53,72,125,427.0,80,8.03,73,320,2489,12.9
22923,Rich Preston,1985-86,33.0,7,53,79,79,25,28,53,161.0,,281,78,100,178,588.0,80,7.73,71,310,2444,12.7
22924,Rich Preston,1986-87,34.0,8,28,75,75,10,18,28,109.0,,356,88,118,206,697.0,80,7.89,74,336,2448,12.9
22925,Rich Preston,1987-88,35.0,9,27,75,75,12,15,27,106.0,,431,100,133,233,803.0,80,7.77,71,321,2447,12.7
22926,Rich Preston,1988-89,36.0,10,41,76,76,19,22,41,118.0,,507,119,155,274,921.0,80,7.94,82,370,2484,12.8
22927,Rich Preston,1989-90,37.0,11,17,73,73,8,9,17,55.0,,580,127,164,291,976.0,80,7.34,72,344,2400,12.2
22928,Rich Sutter,1985-86,22.0,4,0,4,4,0,0,0,3.0,,4,0,0,0,3.0,80,7.73,71,310,2444,12.7
22929,Rich Sutter,1986-87,23.0,5,28,75,75,16,12,28,134.0,,79,16,12,28,137.0,80,7.89,74,336,2448,12.9
22930,Rich Sutter,1987-88,24.0,6,16,56,56,6,10,16,62.0,,135,22,22,44,199.0,80,7.77,71,321,2447,12.7
22931,Rich Sutter,1988-89,25.0,7,39,78,78,14,25,39,123.0,,213,36,47,83,322.0,80,7.94,82,370,2484,12.8
22932,Rich Sutter,1989-90,26.0,8,42,74,74,20,22,42,166.0,,287,56,69,125,488.0,80,7.34,72,344,2400,12.2
22933,Rich Sutter,1990-91,27.0,9,30,80,80,15,15,30,132.0,,367,71,84,155,620.0,80,7.43,89,437,2435,12.2
22934,Rich Sutter,1991-92,28.0,10,32,75,75,17,15,32,125.0,,442,88,99,187,745.0,80,7.48,85,403,2430,12.3
22935,Rich Sutter,1992-93,29.0,11,20,74,74,11,9,20,122.0,,516,99,108,207,867.0,80,7.37,76,367,2421,12.2
22936,Rich Sutter,1993-94,30.0,12,27,77,77,16,11,27,130.0,,593,115,119,234,997.0,80,6.91,71,366,2385,11.6
22937,Rich Sutter,1994-95,31.0,13,25,77,77,9,16,25,113.0,,670,124,135,259,1110.0,80,6.96,77,402,2440,11.4
22938,Rich Sutter,1995-96,32.0,14,27,84,84,13,14,27,148.0,,754,137,149,286,1258.0,84,7.25,87,443,2603,11.7
22939,Rich Sutter,1996-97,33.0,15,26,83,83,12,14,26,122.0,,837,149,163,312,1380.0,84,6.48,76,407,2545,10.7
22940,Rich Sutter,1997-98,34.0,16,3,37,37,0,3,3,39.0,,874,149,166,315,1419.0,48,5.97,37,209,1408,10.2
22941,Richard David,1982-83,24.0,4,0,10,10,0,0,0,10.0,,10,0,0,0,10.0,80,7.03,61,280,2352,12.0
22942,Richard David,1984-85,26.0,5,2,5,5,1,1,2,6.0,,15,1,1,2,16.0,80,8.03,73,320,2489,12.9
22943,Richard David,1985-86,27.0,6,6,16,16,3,3,6,13.0,,31,4,4,8,29.0,80,7.73,71,310,2444,12.7
22944,Richard Hajdu,1988-89,23.0,4,0,3,3,0,0,0,2.0,,3,0,0,0,2.0,80,7.94,82,370,2484,12.8
22945,Richard Hajdu,1989-90,24.0,5,0,2,2,0,0,0,1.0,,5,0,0,0,3.0,80,7.34,72,344,2400,12.2
22946,Richard Kromm,1986-87,22.0,4,23,53,53,11,12,23,66.0,,53,11,12,23,66.0,80,7.89,74,336,2448,12.9
22947,Richard Kromm,1987-88,23.0,5,52,73,73,20,32,52,140.0,,126,31,44,75,206.0,80,7.77,71,321,2447,12.7
22948,Richard Kromm,1988-89,24.0,6,43,77,77,19,24,43,120.0,,203,50,68,118,326.0,80,7.94,82,370,2484,12.8
22949,Richard Kromm,1989-90,25.0,7,29,70,70,12,17,29,109.0,,273,62,85,147,435.0,80,7.34,72,344,2400,12.2
22950,Richard Kromm,1990-91,26.0,8,15,71,71,5,10,15,84.0,,344,67,95,162,519.0,80,7.43,89,437,2435,12.2
22951,Richard Kromm,1991-92,27.0,9,7,20,20,1,6,7,12.0,,364,68,101,169,531.0,80,7.48,85,403,2430,12.3
22952,Richard Kromm,1993-94,29.0,10,1,6,6,1,0,1,6.0,,370,69,101,170,537.0,80,6.91,71,366,2385,11.6
22953,Richard Kromm,1994-95,30.0,11,0,1,1,0,0,0,0.0,,371,69,101,170,537.0,80,6.96,77,402,2440,11.4
22954,Richard Kromm,1995-96,31.0,12,3,1,1,1,2,3,2.0,,372,70,103,173,539.0,84,7.25,87,443,2603,11.7
22955,Richard Lintner,2002-03,25.0,4,6,33,33,1,5,6,58.0,490.0,33,1,5,6,58.0,82,5.49,53,331,2294,9.8
22956,Richard Lintner,2003-04,26.0,5,8,50,50,3,5,8,81.0,654.0,83,4,10,14,139.0,82,5.51,63,376,2272,9.9
22957,Richard Lintner,2005-06,28.0,6,6,29,29,4,2,6,45.0,504.0,112,8,12,20,184.0,82,5.31,60,363,2326,9.4
22958,Richard Matvichuk,1995-96,22.0,4,5,53,53,2,3,5,51.0,,53,2,3,5,51.0,84,7.25,87,443,2603,11.7
22959,Richard Matvichuk,1996-97,23.0,5,3,25,25,0,3,3,18.0,,78,2,6,8,69.0,84,6.48,76,407,2545,10.7
22960,Richard Matvichuk,1997-98,24.0,6,2,14,14,0,2,2,21.0,,92,2,8,10,90.0,48,5.97,37,209,1408,10.2
22961,Richard Matvichuk,1998-99,25.0,7,22,73,73,6,16,22,81.0,,165,8,24,32,171.0,82,6.29,74,413,2481,10.4
22962,Richard Matvichuk,1999-00,26.0,8,12,57,57,5,7,12,83.0,,222,13,31,44,254.0,82,5.83,55,336,2444,9.8
22963,Richard Matvichuk,2000-01,27.0,9,18,74,74,3,15,18,71.0,,296,16,46,62,325.0,82,5.28,57,380,2242,9.6
22964,Richard Matvichuk,2001-02,28.0,10,12,64,64,3,9,12,54.0,1364.0,360,19,55,74,379.0,82,5.27,57,359,2285,9.4
22965,Richard Matvichuk,2002-03,29.0,11,25,70,70,4,21,25,73.0,1712.0,430,23,76,99,452.0,82,5.49,53,331,2294,9.8
22966,Richard Matvichuk,2003-04,30.0,12,20,78,78,4,16,20,85.0,1786.0,508,27,92,119,537.0,82,5.51,63,376,2272,9.9
22967,Richard Matvichuk,2004-05,31.0,13,21,82,82,9,12,21,109.0,1951.0,590,36,104,140,646.0,82,5.24,53,338,2262,9.5
22968,Richard Matvichuk,2005-06,32.0,14,6,68,68,1,5,6,59.0,1318.0,658,37,109,146,705.0,82,5.31,60,363,2326,9.4
22969,Richard Matvichuk,2006-07,33.0,15,21,75,75,1,20,21,85.0,1638.0,733,38,129,167,790.0,82,5.14,57,348,2300,9.2
22970,Richard Matvichuk,2008-09,35.0,16,11,62,62,1,10,11,43.0,1130.0,795,39,139,178,833.0,82,6.05,85,480,2458,10.1
22971,Richard Matvichuk,2009-10,36.0,17,0,1,1,0,0,0,0.0,13.0,796,39,139,178,833.0,82,5.76,70,398,2426,9.7
22972,Richard Panik,2015-16,24.0,4,9,25,25,5,4,9,34.0,283.0,25,5,4,9,34.0,48,5.31,29,160,1399,9.1
22973,Richard Panik,2016-17,25.0,5,13,50,50,3,10,13,56.0,635.0,75,8,14,22,90.0,82,5.34,48,269,2463,8.9
22974,Richard Panik,2017-18,26.0,6,17,76,76,11,6,17,87.0,885.0,151,19,20,39,177.0,82,5.32,47,251,2453,8.9
22975,Richard Panik,2018-19,27.0,7,8,30,30,6,2,8,39.0,325.0,181,25,22,47,216.0,82,5.34,48,255,2438,9.0
22976,Richard Panik,2019-20,28.0,8,44,82,82,22,22,44,155.0,1208.0,263,47,44,91,371.0,82,5.45,47,245,2478,9.0
22977,Richard Panik,2020-21,29.0,9,35,72,72,14,21,35,136.0,1094.0,335,61,65,126,507.0,82,5.86,50,250,2620,9.2
22978,Richard Panik,2021-22,30.0,10,33,75,75,14,19,33,140.0,1246.0,410,75,84,159,647.0,82,5.96,47,239,2579,9.5
22979,Richard Panik,2022-23,31.0,11,22,59,59,9,13,22,67.0,669.0,469,84,97,181,714.0,70,5.96,42,208,2192,9.5
22980,Richard Park,1997-98,21.0,4,1,1,1,0,1,1,4.0,,1,0,1,1,4.0,48,5.97,37,209,1408,10.2
22981,Richard Park,1998-99,22.0,5,10,56,56,4,6,10,62.0,,57,4,7,11,66.0,82,6.29,74,413,2481,10.4
22982,Richard Park,1999-00,23.0,6,2,12,12,1,1,2,10.0,,69,5,8,13,76.0,82,5.83,55,336,2444,9.8
22983,Richard Park,2000-01,24.0,7,2,15,15,0,2,2,14.0,,84,5,10,15,90.0,82,5.28,57,380,2242,9.6
22984,Richard Park,2001-02,25.0,8,0,7,7,0,0,0,5.0,65.0,91,5,10,15,95.0,82,5.27,57,359,2285,9.4
22985,Richard Park,2004-05,28.0,9,25,63,63,10,15,25,115.0,1037.0,154,15,25,40,210.0,82,5.24,53,338,2262,9.5
22986,Richard Park,2005-06,29.0,10,24,81,81,14,10,24,149.0,1345.0,235,29,35,64,359.0,82,5.31,60,363,2326,9.4
22987,Richard Park,2006-07,30.0,11,25,73,73,13,12,25,142.0,1204.0,308,42,47,89,501.0,82,5.14,57,348,2300,9.2
22988,Richard Park,2008-09,32.0,12,18,60,60,8,10,18,97.0,660.0,368,50,57,107,598.0,82,6.05,85,480,2458,10.1
22989,Richard Park,2009-10,33.0,13,26,82,82,10,16,26,93.0,955.0,450,60,73,133,691.0,82,5.76,70,398,2426,9.7
22990,Richard Park,2010-11,34.0,14,32,82,82,12,20,32,132.0,1249.0,532,72,93,165,823.0,82,5.44,62,351,2383,9.4
22991,Richard Park,2011-12,35.0,15,31,71,71,14,17,31,138.0,1219.0,603,86,110,196,961.0,82,5.7,65,341,2477,9.4
22992,Richard Park,2012-13,36.0,16,31,81,81,9,22,31,146.0,1276.0,684,95,132,227,1107.0,82,5.53,56,304,2486,9.1
22993,Richard Park,2014-15,38.0,17,14,54,54,7,7,14,44.0,589.0,738,102,139,241,1151.0,82,5.32,47,271,2439,8.9
22994,Richard Petiot,2008-09,26.0,4,0,2,2,0,0,0,1.0,10.0,2,0,0,0,1.0,82,6.05,85,480,2458,10.1
22995,Richard Petiot,2011-12,29.0,5,3,11,11,0,3,3,10.0,227.0,13,0,3,3,11.0,82,5.7,65,341,2477,9.4
22996,Richard Petiot,2013-14,31.0,6,0,2,2,0,0,0,1.0,26.0,15,0,3,3,12.0,82,5.46,52,291,2492,9.0
22997,Richard Scott,2004-05,26.0,4,0,5,5,0,0,0,1.0,12.0,5,0,0,0,1.0,82,5.24,53,338,2262,9.5
22998,Richard Scott,2006-07,28.0,5,0,5,5,0,0,0,1.0,30.0,10,0,0,0,2.0,82,5.14,57,348,2300,9.2
22999,Richard Smehlik,1995-96,26.0,4,31,80,80,4,27,31,82.0,,80,4,27,31,82.0,84,7.25,87,443,2603,11.7
23000,Richard Smehlik,1996-97,27.0,5,41,84,84,14,27,41,106.0,,164,18,54,72,188.0,84,6.48,76,407,2545,10.7
23001,Richard Smehlik,1997-98,28.0,6,11,39,39,4,7,11,49.0,,203,22,61,83,237.0,48,5.97,37,209,1408,10.2
23002,Richard Smehlik,1999-00,30.0,7,30,62,62,11,19,30,100.0,,265,33,80,113,337.0,82,5.83,55,336,2444,9.8
23003,Richard Smehlik,2000-01,31.0,8,20,72,72,3,17,20,90.0,,337,36,97,133,427.0,82,5.28,57,380,2242,9.6
23004,Richard Smehlik,2001-02,32.0,9,14,72,72,3,11,14,61.0,1572.0,409,39,108,147,488.0,82,5.27,57,359,2285,9.4
23005,Richard Smehlik,2002-03,33.0,10,11,64,64,2,9,11,67.0,1349.0,473,41,117,158,555.0,82,5.49,53,331,2294,9.8
23006,Richard Smehlik,2003-04,34.0,11,15,56,56,3,12,15,40.0,1087.0,529,44,129,173,595.0,82,5.51,63,376,2272,9.9
23007,Richard Smehlik,2004-05,35.0,12,9,60,60,3,6,9,52.0,1222.0,589,47,135,182,647.0,82,5.24,53,338,2262,9.5
23008,Richard Smehlik,2005-06,36.0,13,13,55,55,2,11,13,49.0,1055.0,644,49,146,195,696.0,82,5.31,60,363,2326,9.4
23009,Richard Zednik,1998-99,23.0,4,0,1,1,0,0,0,0.0,,1,0,0,0,0.0,82,6.29,74,413,2481,10.4
23010,Richard Zednik,1999-00,24.0,5,3,11,11,2,1,3,21.0,,12,2,1,3,21.0,82,5.83,55,336,2444,9.8
23011,Richard Zednik,2000-01,25.0,6,26,65,65,17,9,26,148.0,,77,19,10,29,169.0,82,5.28,57,380,2242,9.6
23012,Richard Zednik,2001-02,26.0,7,17,49,49,9,8,17,115.0,742.0,126,28,18,46,284.0,82,5.27,57,359,2285,9.4
23013,Richard Zednik,2002-03,27.0,8,35,69,69,19,16,35,179.0,1074.0,195,47,34,81,463.0,82,5.49,53,331,2294,9.8
23014,Richard Zednik,2003-04,28.0,9,44,74,74,19,25,44,178.0,1185.0,269,66,59,125,641.0,82,5.51,63,376,2272,9.9
23015,Richard Zednik,2004-05,29.0,10,44,82,82,22,22,44,249.0,1448.0,351,88,81,169,890.0,82,5.24,53,338,2262,9.5
23016,Richard Zednik,2005-06,30.0,11,50,80,80,31,19,50,250.0,1474.0,431,119,100,219,1140.0,82,5.31,60,363,2326,9.4
23017,Richard Zednik,2006-07,31.0,12,50,81,81,26,24,50,218.0,1418.0,512,145,124,269,1358.0,82,5.14,57,348,2300,9.2
23018,Richard Zednik,2008-09,33.0,13,30,67,67,16,14,30,161.0,1057.0,579,161,138,299,1519.0,82,6.05,85,480,2458,10.1
23019,Richard Zednik,2009-10,34.0,14,21,42,42,7,14,21,83.0,631.0,621,168,152,320,1602.0,82,5.76,70,398,2426,9.7
23020,Richard Zednik,2010-11,35.0,15,26,54,54,15,11,26,140.0,950.0,675,183,163,346,1742.0,82,5.44,62,351,2383,9.4
23021,Richard Zednik,2011-12,36.0,16,33,70,70,17,16,33,153.0,1091.0,745,200,179,379,1895.0,82,5.7,65,341,2477,9.4
23022,Richard Zemlak,1989-90,26.0,4,2,21,21,0,2,2,2.0,,21,0,2,2,2.0,80,7.34,72,344,2400,12.2
23023,Richard Zemlak,1990-91,27.0,5,5,54,54,1,4,5,19.0,,75,1,6,7,21.0,80,7.43,89,437,2435,12.2
23024,Richard Zemlak,1991-92,28.0,6,0,34,34,0,0,0,3.0,,109,1,6,7,24.0,80,7.48,85,403,2430,12.3
23025,Richard Zemlak,1992-93,29.0,7,6,19,19,1,5,6,11.0,,128,2,11,13,35.0,80,7.37,76,367,2421,12.2
23026,Richard Zemlak,1994-95,31.0,8,1,5,5,0,1,1,4.0,,133,2,12,14,39.0,80,6.96,77,402,2440,11.4
23027,Richie Regehr,2008-09,26.0,4,2,14,14,0,2,2,12.0,159.0,14,0,2,2,12.0,82,6.05,85,480,2458,10.1
23028,Richie Regehr,2009-10,27.0,5,2,6,6,1,1,2,4.0,52.0,20,1,3,4,16.0,82,5.76,70,398,2426,9.7
23029,Rick Bennett,1992-93,25.0,4,1,6,6,1,0,1,6.0,,6,1,0,1,6.0,80,7.37,76,367,2421,12.2
23030,Rick Bennett,1993-94,26.0,5,0,6,6,0,0,0,3.0,,12,1,0,1,9.0,80,6.91,71,366,2385,11.6
23031,Rick Bennett,1994-95,27.0,6,1,3,3,0,1,1,2.0,,15,1,1,2,11.0,80,6.96,77,402,2440,11.4
23032,Rick Berry,2003-04,25.0,4,4,19,19,0,4,4,10.0,231.0,19,0,4,4,10.0,82,5.51,63,376,2272,9.9
23033,Rick Berry,2004-05,26.0,5,2,70,70,0,2,2,49.0,796.0,89,0,6,6,59.0,82,5.24,53,338,2262,9.5
23034,Rick Berry,2005-06,27.0,6,3,43,43,2,1,3,40.0,557.0,132,2,7,9,99.0,82,5.31,60,363,2326,9.4
23035,Rick Berry,2006-07,28.0,7,6,65,65,0,6,6,43.0,792.0,197,2,13,15,142.0,82,5.14,57,348,2300,9.2
23036,Rick Boh,1990-91,26.0,4,3,8,8,2,1,3,8.0,,8,2,1,3,8.0,80,7.43,89,437,2435,12.2
23037,Rick Hayward,1993-94,27.0,4,0,4,4,0,0,0,0.0,,4,0,0,0,0.0,80,6.91,71,366,2385,11.6
23038,Rick Hodgson,1982-83,26.0,4,0,6,6,0,0,0,1.0,,6,0,0,0,1.0,80,7.03,61,280,2352,12.0
23039,Rick Lanz,1983-84,22.0,4,29,76,76,7,22,29,134.0,,76,7,22,29,134.0,80,7.69,77,340,2441,12.6
23040,Rick Lanz,1984-85,23.0,5,14,39,39,3,11,14,94.0,,115,10,33,43,228.0,80,8.03,73,320,2489,12.9
23041,Rick Lanz,1985-86,24.0,6,48,74,74,10,38,48,179.0,,189,20,71,91,407.0,80,7.73,71,310,2444,12.7
23042,Rick Lanz,1986-87,25.0,7,57,79,79,18,39,57,230.0,,268,38,110,148,637.0,80,7.89,74,336,2448,12.9
23043,Rick Lanz,1987-88,26.0,8,19,57,57,2,17,19,131.0,,325,40,127,167,768.0,80,7.77,71,321,2447,12.7
23044,Rick Lanz,1988-89,27.0,9,53,75,75,15,38,53,190.0,,400,55,165,220,958.0,80,7.94,82,370,2484,12.8
23045,Rick Lanz,1989-90,28.0,10,28,61,61,3,25,28,130.0,,461,58,190,248,1088.0,80,7.34,72,344,2400,12.2
23046,Rick Lanz,1990-91,29.0,11,28,75,75,6,22,28,145.0,,536,64,212,276,1233.0,80,7.43,89,437,2435,12.2
23047,Rick Lanz,1991-92,30.0,12,10,32,32,1,9,10,56.0,,568,65,221,286,1289.0,80,7.48,85,403,2430,12.3
23048,Rick Lanz,1994-95,33.0,13,0,1,1,0,0,0,0.0,,569,65,221,286,1289.0,80,6.96,77,402,2440,11.4
23049,Rick Lessard,1991-92,24.0,4,1,6,6,0,1,1,0.0,,6,0,1,1,0.0,80,7.48,85,403,2430,12.3
23050,Rick Lessard,1993-94,26.0,5,1,1,1,0,1,1,0.0,,7,0,2,2,0.0,80,6.91,71,366,2385,11.6
23051,Rick Lessard,1994-95,27.0,6,2,8,8,0,2,2,4.0,,15,0,4,4,4.0,80,6.96,77,402,2440,11.4
23052,Rick Meagher,1982-83,29.0,4,0,2,2,0,0,0,0.0,,2,0,0,0,0.0,80,7.03,61,280,2352,12.0
23053,Rick Meagher,1983-84,30.0,5,17,27,27,7,10,17,73.0,,29,7,10,17,73.0,80,7.69,77,340,2441,12.6
23054,Rick Meagher,1984-85,31.0,6,43,65,65,24,19,43,171.0,,94,31,29,60,244.0,80,8.03,73,320,2489,12.9
23055,Rick Meagher,1985-86,32.0,7,29,61,61,15,14,29,138.0,,155,46,43,89,382.0,80,7.73,71,310,2444,12.7
23056,Rick Meagher,1986-87,33.0,8,28,52,52,14,14,28,126.0,,207,60,57,117,508.0,80,7.89,74,336,2448,12.9
23057,Rick Meagher,1987-88,34.0,9,31,71,71,11,20,31,140.0,,278,71,77,148,648.0,80,7.77,71,321,2447,12.7
23058,Rick Meagher,1988-89,35.0,10,30,79,79,11,19,30,109.0,,357,82,96,178,757.0,80,7.94,82,370,2484,12.8
23059,Rick Meagher,1989-90,36.0,11,39,80,80,18,21,39,170.0,,437,100,117,217,927.0,80,7.34,72,344,2400,12.2
23060,Rick Meagher,1990-91,37.0,12,34,76,76,18,16,34,113.0,,513,118,133,251,1040.0,80,7.43,89,437,2435,12.2
23061,Rick Meagher,1991-92,38.0,13,29,78,78,15,14,29,109.0,,591,133,147,280,1149.0,80,7.48,85,403,2430,12.3
23062,Rick Meagher,1992-93,39.0,14,25,76,76,8,17,25,99.0,,667,141,164,305,1248.0,80,7.37,76,367,2421,12.2
23063,Rick Meagher,1993-94,40.0,15,4,24,24,3,1,4,21.0,,691,144,165,309,1269.0,80,6.91,71,366,2385,11.6
23064,Rick Mrozik,2005-06,31.0,4,0,2,2,0,0,0,2.0,20.0,2,0,0,0,2.0,82,5.31,60,363,2326,9.4
23065,Rick Nash,2005-06,21.0,4,39,74,74,17,22,39,154.0,1032.0,74,17,22,39,154.0,82,5.31,60,363,2326,9.4
23066,Rick Nash,2006-07,22.0,5,57,80,80,41,16,57,269.0,1410.0,154,58,38,96,423.0,82,5.14,57,348,2300,9.2
23067,Rick Nash,2008-09,24.0,6,54,54,54,31,23,54,170.0,986.0,208,89,61,150,593.0,82,6.05,85,480,2458,10.1
23068,Rick Nash,2009-10,25.0,7,57,75,75,27,30,57,228.0,1440.0,283,116,91,207,821.0,82,5.76,70,398,2426,9.7
23069,Rick Nash,2010-11,26.0,8,69,80,80,38,31,69,329.0,1639.0,363,154,122,276,1150.0,82,5.44,62,351,2383,9.4
23070,Rick Nash,2011-12,27.0,9,79,78,78,40,39,79,263.0,1650.0,441,194,161,355,1413.0,82,5.7,65,341,2477,9.4
23071,Rick Nash,2012-13,28.0,10,67,76,76,33,34,67,254.0,1591.0,517,227,195,422,1667.0,82,5.53,56,304,2486,9.1
23072,Rick Nash,2013-14,29.0,11,66,75,75,32,34,66,305.0,1420.0,592,259,229,488,1972.0,82,5.46,52,291,2492,9.0
23073,Rick Nash,2014-15,30.0,12,59,82,82,30,29,59,306.0,1565.0,674,289,258,547,2278.0,82,5.32,47,271,2439,8.9
23074,Rick Nash,2015-16,31.0,13,42,44,44,21,21,42,176.0,879.0,718,310,279,589,2454.0,48,5.31,29,160,1399,9.1
23075,Rick Nash,2016-17,32.0,14,39,65,65,26,13,39,258.0,1106.0,783,336,292,628,2712.0,82,5.34,48,269,2463,8.9
23076,Rick Nash,2017-18,33.0,15,69,79,79,42,27,69,304.0,1379.0,862,378,319,697,3016.0,82,5.32,47,251,2453,8.9
23077,Rick Nash,2018-19,34.0,16,36,60,60,15,21,36,183.0,1016.0,922,393,340,733,3199.0,82,5.34,48,255,2438,9.0
23078,Rick Nash,2019-20,35.0,17,38,67,67,23,15,38,195.0,1103.0,989,416,355,771,3394.0,82,5.45,47,245,2478,9.0
23079,Rick Nash,2020-21,36.0,18,34,71,71,21,13,34,230.0,1211.0,1060,437,368,805,3624.0,82,5.86,50,250,2620,9.2
23080,Rick Paterson,1982-83,24.0,4,2,11,11,0,2,2,11.0,,11,0,2,2,11.0,80,7.03,61,280,2352,12.0
23081,Rick Paterson,1983-84,25.0,5,10,49,49,8,2,10,38.0,,60,8,4,12,49.0,80,7.69,77,340,2441,12.6
23082,Rick Paterson,1984-85,26.0,6,11,48,48,4,7,11,45.0,,108,12,11,23,94.0,80,8.03,73,320,2489,12.9
23083,Rick Paterson,1985-86,27.0,7,23,79,79,14,9,23,80.0,,187,26,20,46,174.0,80,7.73,71,310,2444,12.7
23084,Rick Paterson,1986-87,28.0,8,13,72,72,7,6,13,64.0,,259,33,26,59,238.0,80,7.89,74,336,2448,12.9
23085,Rick Paterson,1987-88,29.0,9,19,79,79,7,12,19,54.0,,338,40,38,78,292.0,80,7.77,71,321,2447,12.7
23086,Rick Paterson,1988-89,30.0,10,12,70,70,9,3,12,36.0,,408,49,41,90,328.0,80,7.94,82,370,2484,12.8
23087,Rick Paterson,1989-90,31.0,11,3,22,22,1,2,3,4.0,,430,50,43,93,332.0,80,7.34,72,344,2400,12.2
23088,Rick Rypien,2008-09,24.0,4,1,5,5,1,0,1,6.0,32.0,5,1,0,1,6.0,82,6.05,85,480,2458,10.1
23089,Rick Rypien,2009-10,25.0,5,0,2,2,0,0,0,0.0,10.0,7,1,0,1,6.0,82,5.76,70,398,2426,9.7
23090,Rick Rypien,2010-11,26.0,6,3,22,22,1,2,3,8.0,178.0,29,2,2,4,14.0,82,5.44,62,351,2383,9.4
23091,Rick Rypien,2011-12,27.0,7,3,12,12,3,0,3,16.0,112.0,41,5,2,7,30.0,82,5.7,65,341,2477,9.4
23092,Rick Rypien,2012-13,28.0,8,8,69,69,4,4,8,61.0,499.0,110,9,6,15,91.0,82,5.53,56,304,2486,9.1
23093,Rick Rypien,2013-14,29.0,9,1,9,9,0,1,1,6.0,46.0,119,9,7,16,97.0,82,5.46,52,291,2492,9.0
23094,Rick Tocchet,1987-88,23.0,4,39,75,75,14,25,39,114.0,,75,14,25,39,114.0,80,7.77,71,321,2447,12.7
23095,Rick Tocchet,1988-89,24.0,5,35,69,69,14,21,35,109.0,,144,28,46,74,223.0,80,7.94,82,370,2484,12.8
23096,Rick Tocchet,1989-90,25.0,6,49,69,69,21,28,49,147.0,,213,49,74,123,370.0,80,7.34,72,344,2400,12.2
23097,Rick Tocchet,1990-91,26.0,7,64,65,65,31,33,64,182.0,,278,80,107,187,552.0,80,7.43,89,437,2435,12.2
23098,Rick Tocchet,1991-92,27.0,8,81,66,66,45,36,81,220.0,,344,125,143,268,772.0,80,7.48,85,403,2430,12.3
23099,Rick Tocchet,1992-93,28.0,9,96,75,75,37,59,96,269.0,,419,162,202,364,1041.0,80,7.37,76,367,2421,12.2
23100,Rick Tocchet,1993-94,29.0,10,71,70,70,40,31,71,217.0,,489,202,233,435,1258.0,80,6.91,71,366,2385,11.6
23101,Rick Tocchet,1994-95,30.0,11,59,61,61,27,32,59,166.0,,550,229,265,494,1424.0,80,6.96,77,402,2440,11.4
23102,Rick Tocchet,1995-96,31.0,12,109,80,80,48,61,109,240.0,,630,277,326,603,1664.0,84,7.25,87,443,2603,11.7
23103,Rick Tocchet,1996-97,32.0,13,40,51,51,14,26,40,150.0,,681,291,352,643,1814.0,84,6.48,76,407,2545,10.7
23104,Rick Tocchet,1997-98,33.0,14,35,36,36,18,17,35,95.0,,717,309,369,678,1909.0,48,5.97,37,209,1408,10.2
23105,Rick Tocchet,1998-99,34.0,15,60,71,71,29,31,60,185.0,,788,338,400,738,2094.0,82,6.29,74,413,2481,10.4
23106,Rick Tocchet,1999-00,35.0,16,40,53,53,21,19,40,157.0,,841,359,419,778,2251.0,82,5.83,55,336,2444,9.8
23107,Rick Tocchet,2000-01,36.0,17,45,68,68,26,19,45,161.0,,909,385,438,823,2412.0,82,5.28,57,380,2242,9.6
23108,Rick Tocchet,2001-02,37.0,18,56,81,81,26,30,56,178.0,1504.0,990,411,468,879,2590.0,82,5.27,57,359,2285,9.4
23109,Rick Tocchet,2002-03,38.0,19,35,80,80,15,20,35,130.0,1255.0,1070,426,488,914,2720.0,82,5.49,53,331,2294,9.8
23110,Rick Tocchet,2003-04,39.0,20,36,60,60,14,22,36,76.0,920.0,1130,440,510,950,2796.0,82,5.51,63,376,2272,9.9
23111,Rick Tocchet,2004-05,40.0,21,2,14,14,0,2,2,10.0,129.0,1144,440,512,952,2806.0,82,5.24,53,338,2262,9.5
23112,Rick Vaive,1982-83,23.0,4,37,69,69,22,15,37,144.0,,69,22,15,37,144.0,80,7.03,61,280,2352,12.0
23113,Rick Vaive,1983-84,24.0,5,62,75,75,33,29,62,195.0,,144,55,44,99,339.0,80,7.69,77,340,2441,12.6
23114,Rick Vaive,1984-85,25.0,6,89,77,77,54,35,89,267.0,,221,109,79,188,606.0,80,8.03,73,320,2489,12.9
23115,Rick Vaive,1985-86,26.0,7,79,78,78,51,28,79,296.0,,299,160,107,267,902.0,80,7.73,71,310,2444,12.7
23116,Rick Vaive,1986-87,27.0,8,93,76,76,52,41,93,261.0,,375,212,148,360,1163.0,80,7.89,74,336,2448,12.9
23117,Rick Vaive,1987-88,28.0,9,68,72,72,35,33,68,259.0,,447,247,181,428,1422.0,80,7.77,71,321,2447,12.7
23118,Rick Vaive,1988-89,29.0,10,64,61,61,33,31,64,226.0,,508,280,212,492,1648.0,80,7.94,82,370,2484,12.8
23119,Rick Vaive,1989-90,30.0,11,66,73,73,32,34,66,213.0,,581,312,246,558,1861.0,80,7.34,72,344,2400,12.2
23120,Rick Vaive,1990-91,31.0,12,69,76,76,43,26,69,229.0,,657,355,272,627,2090.0,80,7.43,89,437,2435,12.2
23121,Rick Vaive,1991-92,32.0,13,57,58,58,31,26,57,138.0,,715,386,298,684,2228.0,80,7.48,85,403,2430,12.3
23122,Rick Vaive,1992-93,33.0,14,48,70,70,29,19,48,195.0,,785,415,317,732,2423.0,80,7.37,76,367,2421,12.2
23123,Rick Vaive,1993-94,34.0,15,52,71,71,25,27,52,155.0,,856,440,344,784,2578.0,80,6.91,71,366,2385,11.6
23124,Rick Vaive,1994-95,35.0,16,4,20,20,1,3,4,25.0,,876,441,347,788,2603.0,80,6.96,77,402,2440,11.4
23125,Rick Zombo,1987-88,24.0,4,0,1,1,0,0,0,0.0,,1,0,0,0,0.0,80,7.77,71,321,2447,12.7
23126,Rick Zombo,1988-89,25.0,5,1,14,14,0,1,1,8.0,,15,0,1,1,8.0,80,7.94,82,370,2484,12.8
23127,Rick Zombo,1989-90,26.0,6,5,44,44,1,4,5,28.0,,59,1,5,6,36.0,80,7.34,72,344,2400,12.2
23128,Rick Zombo,1990-91,27.0,7,17,62,62,3,14,17,48.0,,121,4,19,23,84.0,80,7.43,89,437,2435,12.2
23129,Rick Zombo,1991-92,28.0,8,21,75,75,1,20,21,64.0,,196,5,39,44,148.0,80,7.48,85,403,2430,12.3
23130,Rick Zombo,1992-93,29.0,9,25,77,77,5,20,25,62.0,,273,10,59,69,210.0,80,7.37,76,367,2421,12.2
23131,Rick Zombo,1993-94,30.0,10,23,77,77,4,19,23,68.0,,350,14,78,92,278.0,80,6.91,71,366,2385,11.6
23132,Rick Zombo,1994-95,31.0,11,18,67,67,3,15,18,48.0,,417,17,93,110,326.0,80,6.96,77,402,2440,11.4
23133,Rick Zombo,1995-96,32.0,12,15,71,71,0,15,15,43.0,,488,17,108,125,369.0,84,7.25,87,443,2603,11.7
23134,Rick Zombo,1996-97,33.0,13,10,74,74,2,8,10,53.0,,562,19,116,135,422.0,84,6.48,76,407,2545,10.7
23135,Rick Zombo,1997-98,34.0,14,5,23,23,1,4,5,18.0,,585,20,120,140,440.0,48,5.97,37,209,1408,10.2
23136,Rick Zombo,1998-99,35.0,15,14,67,67,4,10,14,68.0,,652,24,130,154,508.0,82,6.29,74,413,2481,10.4
23137,Rickard Rakell,2015-16,22.0,4,0,4,4,0,0,0,3.0,36.0,4,0,0,0,3.0,48,5.31,29,160,1399,9.1
23138,Rickard Rakell,2016-17,23.0,5,4,18,18,0,4,4,22.0,211.0,22,0,4,4,25.0,82,5.34,48,269,2463,8.9
23139,Rickard Rakell,2017-18,24.0,6,31,71,71,9,22,31,105.0,893.0,93,9,26,35,130.0,82,5.32,47,251,2453,8.9
23140,Rickard Rakell,2018-19,25.0,7,43,72,72,20,23,43,169.0,1157.0,165,29,49,78,299.0,82,5.34,48,255,2438,9.0
23141,Rickard Rakell,2019-20,26.0,8,51,71,71,33,18,51,177.0,1234.0,236,62,67,129,476.0,82,5.45,47,245,2478,9.0
23142,Rickard Rakell,2020-21,27.0,9,69,77,77,34,35,69,230.0,1495.0,313,96,102,198,706.0,82,5.86,50,250,2620,9.2
23143,Rickard Rakell,2021-22,28.0,10,43,69,69,18,25,43,194.0,1275.0,382,114,127,241,900.0,82,5.96,47,239,2579,9.5
23144,Rickard Rakell,2022-23,29.0,11,42,65,65,15,27,42,186.0,1180.0,447,129,154,283,1086.0,70,5.96,42,208,2192,9.5
23145,Rickard Wallin,2005-06,25.0,4,1,4,4,1,0,1,1.0,31.0,4,1,0,1,1.0,82,5.31,60,363,2326,9.4
23146,Rickard Wallin,2006-07,26.0,5,9,15,15,5,4,9,16.0,215.0,19,6,4,10,17.0,82,5.14,57,348,2300,9.2
23147,Rickard Wallin,2012-13,32.0,6,9,60,60,2,7,9,72.0,759.0,79,8,11,19,89.0,82,5.53,56,304,2486,9.1
23148,Rico Fata,2001-02,21.0,4,1,20,20,0,1,1,13.0,152.0,20,0,1,1,13.0,82,5.27,57,359,2285,9.4
23149,Rico Fata,2002-03,22.0,5,0,2,2,0,0,0,0.0,20.0,22,0,1,1,13.0,82,5.49,53,331,2294,9.8
23150,Rico Fata,2003-04,23.0,6,0,5,5,0,0,0,6.0,47.0,27,0,1,1,19.0,82,5.51,63,376,2272,9.9
23151,Rico Fata,2004-05,24.0,7,0,10,10,0,0,0,8.0,85.0,37,0,1,1,27.0,82,5.24,53,338,2262,9.5
23152,Rico Fata,2005-06,25.0,8,19,63,63,7,12,19,79.0,742.0,100,7,13,20,106.0,82,5.31,60,363,2326,9.4
23153,Rico Fata,2006-07,26.0,9,34,73,73,16,18,34,163.0,1312.0,173,23,31,54,269.0,82,5.14,57,348,2300,9.2
23154,Rico Fata,2008-09,28.0,10,7,47,47,3,4,7,50.0,478.0,220,26,35,61,319.0,82,6.05,85,480,2458,10.1
23155,Rico Fata,2009-10,29.0,11,2,10,10,1,1,2,15.0,104.0,230,27,36,63,334.0,82,5.76,70,398,2426,9.7
23156,Rik Wilson,1984-85,22.0,4,21,48,48,3,18,21,95.0,,48,3,18,21,95.0,80,8.03,73,320,2489,12.9
23157,Rik Wilson,1985-86,23.0,5,14,56,56,3,11,14,77.0,,104,6,29,35,172.0,80,7.73,71,310,2444,12.7
23158,Rik Wilson,1986-87,24.0,6,18,48,48,7,11,18,72.0,,152,13,40,53,244.0,80,7.89,74,336,2448,12.9
23159,Rik Wilson,1987-88,25.0,7,24,51,51,8,16,24,85.0,,203,21,56,77,329.0,80,7.77,71,321,2447,12.7
23160,Rik Wilson,1988-89,26.0,8,4,34,34,0,4,4,48.0,,237,21,60,81,377.0,80,7.94,82,370,2484,12.8
23161,Rik Wilson,1990-91,28.0,9,9,14,14,4,5,9,27.0,,251,25,65,90,404.0,80,7.43,89,437,2435,12.2
23162,Riku Hahl,2004-05,24.0,4,5,22,22,2,3,5,17.0,208.0,22,2,3,5,17.0,82,5.24,53,338,2262,9.5
23163,Riku Hahl,2005-06,25.0,5,7,42,42,3,4,7,61.0,464.0,64,5,7,12,78.0,82,5.31,60,363,2326,9.4
23164,Riku Hahl,2006-07,26.0,6,1,28,28,0,1,1,40.0,344.0,92,5,8,13,118.0,82,5.14,57,348,2300,9.2
23165,Riley Armstrong,2011-12,27.0,4,0,2,2,0,0,0,1.0,15.0,2,0,0,0,1.0,82,5.7,65,341,2477,9.4
23166,Riley Barber,2019-20,25.0,4,0,3,3,0,0,0,2.0,26.0,3,0,0,0,2.0,82,5.45,47,245,2478,9.0
23167,Riley Barber,2022-23,28.0,5,0,9,9,0,0,0,6.0,74.0,12,0,0,0,8.0,70,5.96,42,208,2192,9.5
23168,Riley Cote,2009-10,27.0,4,0,8,8,0,0,0,3.0,36.0,8,0,0,0,3.0,82,5.76,70,398,2426,9.7
23169,Riley Cote,2010-11,28.0,5,4,70,70,1,3,4,17.0,299.0,78,1,3,4,20.0,82,5.44,62,351,2383,9.4
23170,Riley Cote,2011-12,29.0,6,3,63,63,0,3,3,24.0,262.0,141,1,6,7,44.0,82,5.7,65,341,2477,9.4
23171,Riley Cote,2012-13,30.0,7,0,15,15,0,0,0,7.0,45.0,156,1,6,7,51.0,82,5.53,56,304,2486,9.1
23172,Riley Nash,2014-15,25.0,4,1,5,5,0,1,1,2.0,53.0,5,0,1,1,2.0,82,5.32,47,271,2439,8.9
23173,Riley Nash,2015-16,26.0,5,9,32,32,4,5,9,36.0,410.0,37,4,6,10,38.0,48,5.31,29,160,1399,9.1
23174,Riley Nash,2016-17,27.0,6,24,73,73,10,14,24,86.0,925.0,110,14,20,34,124.0,82,5.34,48,269,2463,8.9
23175,Riley Nash,2017-18,28.0,7,25,68,68,8,17,25,94.0,1109.0,178,22,37,59,218.0,82,5.32,47,251,2453,8.9
23176,Riley Nash,2018-19,29.0,8,22,64,64,9,13,22,76.0,829.0,242,31,50,81,294.0,82,5.34,48,255,2438,9.0
23177,Riley Nash,2019-20,30.0,9,17,81,81,7,10,17,125.0,1118.0,323,38,60,98,419.0,82,5.45,47,245,2478,9.0
23178,Riley Nash,2020-21,31.0,10,41,76,76,15,26,41,113.0,1171.0,399,53,86,139,532.0,82,5.86,50,250,2620,9.2
23179,Riley Nash,2021-22,32.0,11,12,78,78,3,9,12,79.0,846.0,477,56,95,151,611.0,82,5.96,47,239,2579,9.5
23180,Riley Nash,2022-23,33.0,12,14,64,64,5,9,14,64.0,758.0,541,61,104,165,675.0,70,5.96,42,208,2192,9.5
23181,Riley Sheahan,2014-15,23.0,4,0,1,1,0,0,0,3.0,6.0,1,0,0,0,3.0,82,5.32,47,271,2439,8.9
23182,Riley Sheahan,2015-16,24.0,5,0,1,1,0,0,0,1.0,7.0,2,0,0,0,4.0,48,5.31,29,160,1399,9.1
23183,Riley Sheahan,2016-17,25.0,6,24,42,42,9,15,24,59.0,607.0,44,9,15,24,63.0,82,5.34,48,269,2463,8.9
23184,Riley Sheahan,2017-18,26.0,7,36,79,79,13,23,36,123.0,1236.0,123,22,38,60,186.0,82,5.32,47,251,2453,8.9
23185,Riley Sheahan,2018-19,27.0,8,25,81,81,14,11,25,128.0,1234.0,204,36,49,85,314.0,82,5.34,48,255,2438,9.0
23186,Riley Sheahan,2019-20,28.0,9,13,80,80,2,11,13,109.0,1118.0,284,38,60,98,423.0,82,5.45,47,245,2478,9.0
23187,Riley Sheahan,2020-21,29.0,10,32,81,81,11,21,32,109.0,1188.0,365,49,81,130,532.0,82,5.86,50,250,2620,9.2
23188,Riley Sheahan,2021-22,30.0,11,19,82,82,9,10,19,110.0,1104.0,447,58,91,149,642.0,82,5.96,47,239,2579,9.5
23189,Riley Sheahan,2022-23,31.0,12,15,66,66,8,7,15,70.0,844.0,513,66,98,164,712.0,70,5.96,42,208,2192,9.5
23190,Riley Stillman,2021-22,23.0,4,0,1,1,0,0,0,1.0,11.0,1,0,0,0,1.0,82,5.96,47,239,2579,9.5
23191,Riley Stillman,2022-23,24.0,5,5,34,34,0,5,5,39.0,650.0,35,0,5,5,40.0,70,5.96,42,208,2192,9.5
23192,Rinat Valiev,2018-19,23.0,4,0,10,10,0,0,0,7.0,123.0,10,0,0,0,7.0,82,5.34,48,255,2438,9.0
23193,Rinat Valiev,2020-21,25.0,5,0,2,2,0,0,0,2.0,24.0,12,0,0,0,9.0,82,5.86,50,250,2620,9.2
23194,Risto Jalo,1988-89,26.0,4,3,3,3,0,3,3,3.0,,3,0,3,3,3.0,80,7.94,82,370,2484,12.8
23195,Risto Siltanen,1982-83,24.0,4,35,64,64,6,29,35,116.0,,64,6,29,35,116.0,80,7.03,61,280,2352,12.0
23196,Risto Siltanen,1983-84,25.0,5,53,79,79,17,36,53,209.0,,143,23,65,88,325.0,80,7.69,77,340,2441,12.6
23197,Risto Siltanen,1984-85,26.0,6,63,63,63,15,48,63,143.0,,206,38,113,151,468.0,80,8.03,73,320,2489,12.9
23198,Risto Siltanen,1985-86,27.0,7,30,74,74,5,25,30,155.0,,280,43,138,181,623.0,80,7.73,71,310,2444,12.7
23199,Risto Siltanen,1986-87,28.0,8,53,75,75,15,38,53,163.0,,355,58,176,234,786.0,80,7.89,74,336,2448,12.9
23200,Risto Siltanen,1987-88,29.0,9,45,76,76,12,33,45,175.0,,431,70,209,279,961.0,80,7.77,71,321,2447,12.7
23201,Risto Siltanen,1988-89,30.0,10,37,65,65,10,27,37,179.0,,496,80,236,316,1140.0,80,7.94,82,370,2484,12.8
23202,Risto Siltanen,1989-90,31.0,11,39,66,66,10,29,39,129.0,,562,90,265,355,1269.0,80,7.34,72,344,2400,12.2
23203,Rob Blake,1992-93,23.0,4,0,4,4,0,0,0,3.0,,4,0,0,0,3.0,80,7.37,76,367,2421,12.2
23204,Rob Blake,1993-94,24.0,5,46,75,75,12,34,46,150.0,,79,12,34,46,153.0,80,6.91,71,366,2385,11.6
23205,Rob Blake,1994-95,25.0,6,20,57,57,7,13,20,131.0,,136,19,47,66,284.0,80,6.96,77,402,2440,11.4
23206,Rob Blake,1995-96,26.0,7,59,76,76,16,43,59,243.0,,212,35,90,125,527.0,84,7.25,87,443,2603,11.7
23207,Rob Blake,1996-97,27.0,8,68,84,84,20,48,68,304.0,,296,55,138,193,831.0,84,6.48,76,407,2545,10.7
23208,Rob Blake,1997-98,28.0,9,11,24,24,4,7,11,76.0,,320,59,145,204,907.0,48,5.97,37,209,1408,10.2
23209,Rob Blake,1998-99,29.0,10,3,6,6,1,2,3,13.0,,326,60,147,207,920.0,82,6.29,74,413,2481,10.4
23210,Rob Blake,1999-00,30.0,11,31,62,62,8,23,31,169.0,,388,68,170,238,1089.0,82,5.83,55,336,2444,9.8
23211,Rob Blake,2000-01,31.0,12,50,81,81,23,27,50,261.0,,469,91,197,288,1350.0,82,5.28,57,380,2242,9.6
23212,Rob Blake,2001-02,32.0,13,35,62,62,12,23,35,216.0,1542.0,531,103,220,323,1566.0,82,5.27,57,359,2285,9.4
23213,Rob Blake,2002-03,33.0,14,57,77,77,18,39,57,327.0,2194.0,608,121,259,380,1893.0,82,5.49,53,331,2294,9.8
23214,Rob Blake,2003-04,34.0,15,59,67,67,19,40,59,267.0,1860.0,675,140,299,439,2160.0,82,5.51,63,376,2272,9.9
23215,Rob Blake,2004-05,35.0,16,56,75,75,16,40,56,229.0,2068.0,750,156,339,495,2389.0,82,5.24,53,338,2262,9.5
23216,Rob Blake,2005-06,36.0,17,45,79,79,17,28,45,269.0,2082.0,829,173,367,540,2658.0,82,5.31,60,363,2326,9.4
23217,Rob Blake,2006-07,37.0,18,46,74,74,13,33,46,242.0,1805.0,903,186,400,586,2900.0,82,5.14,57,348,2300,9.2
23218,Rob Blake,2008-09,39.0,19,51,81,81,14,37,51,264.0,1974.0,984,200,437,637,3164.0,82,6.05,85,480,2458,10.1
23219,Rob Blake,2009-10,40.0,20,34,72,72,14,20,34,208.0,1757.0,1056,214,457,671,3372.0,82,5.76,70,398,2426,9.7
23220,Rob Blake,2010-11,41.0,21,31,71,71,9,22,31,144.0,1614.0,1127,223,479,702,3516.0,82,5.44,62,351,2383,9.4
23221,Rob Blake,2011-12,42.0,22,45,73,73,10,35,45,198.0,1553.0,1200,233,514,747,3714.0,82,5.7,65,341,2477,9.4
23222,Rob Blake,2012-13,43.0,23,30,70,70,7,23,30,182.0,1495.0,1270,240,537,777,3896.0,82,5.53,56,304,2486,9.1
23223,Rob Brown,1990-91,22.0,4,44,51,51,24,20,44,80.0,,51,24,20,44,80.0,80,7.43,89,437,2435,12.2
23224,Rob Brown,1991-92,23.0,5,115,68,68,49,66,115,169.0,,119,73,86,159,249.0,80,7.48,85,403,2430,12.3
23225,Rob Brown,1992-93,24.0,6,80,80,80,33,47,80,157.0,,199,106,133,239,406.0,80,7.37,76,367,2421,12.2
23226,Rob Brown,1993-94,25.0,7,58,69,69,24,34,58,126.0,,268,130,167,297,532.0,80,6.91,71,366,2385,11.6
23227,Rob Brown,1994-95,26.0,8,47,67,67,21,26,47,106.0,,335,151,193,344,638.0,80,6.96,77,402,2440,11.4
23228,Rob Brown,1995-96,27.0,9,7,15,15,1,6,7,16.0,,350,152,199,351,654.0,84,7.25,87,443,2603,11.7
23229,Rob Brown,1996-97,28.0,10,0,1,1,0,0,0,1.0,,351,152,199,351,655.0,84,6.48,76,407,2545,10.7
23230,Rob Brown,1997-98,29.0,11,0,2,2,0,0,0,1.0,,353,152,199,351,656.0,48,5.97,37,209,1408,10.2
23231,Rob Brown,2000-01,32.0,12,40,82,82,15,25,40,172.0,,435,167,224,391,828.0,82,5.28,57,380,2242,9.6
23232,Rob Brown,2001-02,33.0,13,24,58,58,13,11,24,78.0,730.0,493,180,235,415,906.0,82,5.27,57,359,2285,9.4
23233,Rob Brown,2002-03,34.0,14,23,50,50,10,13,23,73.0,531.0,543,190,248,438,979.0,82,5.49,53,331,2294,9.8
23234,Rob Cimetta,1991-92,21.0,4,2,7,7,2,0,2,4.0,,7,2,0,2,4.0,80,7.48,85,403,2430,12.3
23235,Rob Cimetta,1992-93,22.0,5,17,47,47,8,9,17,28.0,,54,10,9,19,32.0,80,7.37,76,367,2421,12.2
23236,Rob Cimetta,1993-94,23.0,6,6,25,25,2,4,6,18.0,,79,12,13,25,50.0,80,6.91,71,366,2385,11.6
23237,Rob Cimetta,1994-95,24.0,7,7,24,24,4,3,7,31.0,,103,16,16,32,81.0,80,6.96,77,402,2440,11.4
23238,Rob Collins,2008-09,30.0,4,2,8,8,1,1,2,8.0,52.0,8,1,1,2,8.0,82,6.05,85,480,2458,10.1
23239,Rob Conn,1994-95,26.0,4,0,2,2,0,0,0,3.0,,2,0,0,0,3.0,80,6.96,77,402,2440,11.4
23240,Rob Conn,1998-99,30.0,5,7,28,28,2,5,7,36.0,,30,2,5,7,39.0,82,6.29,74,413,2481,10.4
23241,Rob Cowie,1997-98,30.0,4,9,32,32,2,7,9,39.0,,32,2,7,9,39.0,48,5.97,37,209,1408,10.2
23242,Rob Cowie,1998-99,31.0,5,10,46,46,5,5,10,86.0,,78,7,12,19,125.0,82,6.29,74,413,2481,10.4
23243,Rob Davison,2005-06,25.0,4,3,15,15,1,2,3,15.0,268.0,15,1,2,3,15.0,82,5.31,60,363,2326,9.4
23244,Rob Davison,2006-07,26.0,5,3,55,55,0,3,3,33.0,790.0,70,1,5,6,48.0,82,5.14,57,348,2300,9.2
23245,Rob Davison,2008-09,28.0,6,6,69,69,1,5,6,36.0,955.0,139,2,10,12,84.0,82,6.05,85,480,2458,10.1
23246,Rob Davison,2009-10,29.0,7,2,22,22,0,2,2,14.0,205.0,161,2,12,14,98.0,82,5.76,70,398,2426,9.7
23247,Rob Davison,2010-11,30.0,8,2,34,34,1,1,2,32.0,471.0,195,3,13,16,130.0,82,5.44,62,351,2383,9.4
23248,Rob Davison,2011-12,31.0,9,2,23,23,0,2,2,15.0,232.0,218,3,15,18,145.0,82,5.7,65,341,2477,9.4
23249,Rob Davison,2012-13,32.0,10,0,1,1,0,0,0,0.0,4.0,219,3,15,18,145.0,82,5.53,56,304,2486,9.1
23250,Rob DiMaio,1991-92,23.0,4,1,16,16,1,0,1,16.0,,16,1,0,1,16.0,80,7.48,85,403,2430,12.3
23251,Rob DiMaio,1992-93,24.0,5,0,7,7,0,0,0,2.0,,23,1,0,1,18.0,80,7.37,76,367,2421,12.2
23252,Rob DiMaio,1993-94,25.0,6,0,1,1,0,0,0,0.0,,24,1,0,1,18.0,80,6.91,71,366,2385,11.6
23253,Rob DiMaio,1994-95,26.0,7,7,50,50,5,2,7,43.0,,74,6,2,8,61.0,80,6.96,77,402,2440,11.4
23254,Rob DiMaio,1995-96,27.0,8,24,54,54,9,15,24,75.0,,128,15,17,32,136.0,84,7.25,87,443,2603,11.7
23255,Rob DiMaio,1996-97,28.0,9,23,53,53,11,12,23,81.0,,181,26,29,55,217.0,84,6.48,76,407,2545,10.7
23256,Rob DiMaio,1997-98,29.0,10,4,36,36,3,1,4,34.0,,217,29,30,59,251.0,48,5.97,37,209,1408,10.2
23257,Rob DiMaio,1998-99,30.0,11,21,59,59,6,15,21,49.0,,276,35,45,80,300.0,82,6.29,74,413,2481,10.4
23258,Rob DiMaio,1999-00,31.0,12,28,72,72,13,15,28,152.0,,348,48,60,108,452.0,82,5.83,55,336,2444,9.8
23259,Rob DiMaio,2000-01,32.0,13,27,79,79,10,17,27,112.0,,427,58,77,135,564.0,82,5.28,57,380,2242,9.6
23260,Rob DiMaio,2001-02,33.0,14,21,71,71,7,14,21,121.0,1185.0,498,65,91,156,685.0,82,5.27,57,359,2285,9.4
23261,Rob DiMaio,2002-03,34.0,15,25,62,62,6,19,25,111.0,1025.0,560,71,110,181,796.0,82,5.49,53,331,2294,9.8
23262,Rob DiMaio,2003-04,35.0,16,24,74,74,6,18,24,99.0,1108.0,634,77,128,205,895.0,82,5.51,63,376,2272,9.9
23263,Rob DiMaio,2004-05,36.0,17,12,61,61,6,6,12,63.0,663.0,695,83,134,217,958.0,82,5.24,53,338,2262,9.5
23264,Rob DiMaio,2005-06,37.0,18,19,69,69,10,9,19,81.0,895.0,764,93,143,236,1039.0,82,5.31,60,363,2326,9.4
23265,Rob DiMaio,2006-07,38.0,19,24,69,69,9,15,24,76.0,895.0,833,102,158,260,1115.0,82,5.14,57,348,2300,9.2
23266,Rob DiMaio,2008-09,40.0,20,17,61,61,4,13,17,72.0,713.0,894,106,171,277,1187.0,82,6.05,85,480,2458,10.1
23267,Rob Garner,1985-86,27.0,4,0,1,1,0,0,0,1.0,,1,0,0,0,1.0,80,7.73,71,310,2444,12.7
23268,Rob Gaudreau,1995-96,26.0,4,43,59,59,23,20,43,191.0,,59,23,20,43,191.0,84,7.25,87,443,2603,11.7
23269,Rob Gaudreau,1996-97,27.0,5,35,84,84,15,20,35,151.0,,143,38,40,78,342.0,84,6.48,76,407,2545,10.7
23270,Rob Gaudreau,1997-98,28.0,6,14,36,36,5,9,14,65.0,,179,43,49,92,407.0,48,5.97,37,209,1408,10.2
23271,Rob Gaudreau,1998-99,29.0,7,13,52,52,8,5,13,76.0,,231,51,54,105,483.0,82,6.29,74,413,2481,10.4
23272,Rob Globke,2008-09,26.0,4,1,18,18,1,0,1,18.0,131.0,18,1,0,1,18.0,82,6.05,85,480,2458,10.1
23273,Rob Globke,2009-10,27.0,5,1,19,19,0,1,1,15.0,115.0,37,1,1,2,33.0,82,5.76,70,398,2426,9.7
23274,Rob Globke,2010-11,28.0,6,0,9,9,0,0,0,4.0,70.0,46,1,1,2,37.0,82,5.44,62,351,2383,9.4
23275,Rob Klinkhammer,2013-14,27.0,4,0,1,1,0,0,0,1.0,12.0,1,0,0,0,1.0,82,5.46,52,291,2492,9.0
23276,Rob Klinkhammer,2014-15,28.0,5,2,15,15,0,2,2,26.0,172.0,16,0,2,2,27.0,82,5.32,47,271,2439,8.9
23277,Rob Klinkhammer,2015-16,29.0,6,11,22,22,5,6,11,34.0,269.0,38,5,8,13,61.0,48,5.31,29,160,1399,9.1
23278,Rob Klinkhammer,2016-17,30.0,7,20,72,72,11,9,20,103.0,818.0,110,16,17,33,164.0,82,5.34,48,269,2463,8.9
23279,Rob Klinkhammer,2017-18,31.0,8,9,69,69,5,4,9,64.0,774.0,179,21,21,42,228.0,82,5.32,47,251,2453,8.9
23280,Rob Klinkhammer,2018-19,32.0,9,1,14,14,1,0,1,10.0,132.0,193,22,21,43,238.0,82,5.34,48,255,2438,9.0
23281,Rob McClanahan,1982-83,25.0,4,7,13,13,2,5,7,13.0,,13,2,5,7,13.0,80,7.03,61,280,2352,12.0
23282,Rob McClanahan,1983-84,26.0,5,15,53,53,3,12,15,67.0,,66,5,17,22,80.0,80,7.69,77,340,2441,12.6
23283,Rob McClanahan,1984-85,27.0,6,17,39,39,5,12,17,45.0,,105,10,29,39,125.0,80,8.03,73,320,2489,12.9
23284,Rob McClanahan,1985-86,28.0,7,48,78,78,22,26,48,118.0,,183,32,55,87,243.0,80,7.73,71,310,2444,12.7
23285,Rob McClanahan,1986-87,29.0,8,14,41,41,6,8,14,52.0,,224,38,63,101,295.0,80,7.89,74,336,2448,12.9
23286,Rob Murphy,1990-91,21.0,4,0,5,5,0,0,0,4.0,,5,0,0,0,4.0,80,7.43,89,437,2435,12.2
23287,Rob Murphy,1991-92,22.0,5,1,8,8,0,1,1,10.0,,13,0,1,1,14.0,80,7.48,85,403,2430,12.3
23288,Rob Murphy,1992-93,23.0,6,2,12,12,1,1,2,6.0,,25,1,2,3,20.0,80,7.37,76,367,2421,12.2
23289,Rob Murphy,1993-94,24.0,7,6,42,42,5,1,6,19.0,,67,6,3,9,39.0,80,6.91,71,366,2385,11.6
23290,Rob Murphy,1994-95,25.0,8,1,6,6,0,1,1,2.0,,73,6,4,10,41.0,80,6.96,77,402,2440,11.4
23291,Rob Murphy,1995-96,26.0,9,10,44,44,3,7,10,55.0,,117,9,11,20,96.0,84,7.25,87,443,2603,11.7
23292,Rob Murphy,1996-97,27.0,10,1,8,8,0,1,1,4.0,,125,9,12,21,100.0,84,6.48,76,407,2545,10.7
23293,Rob Murray,1992-93,25.0,4,9,41,41,2,7,9,29.0,,41,2,7,9,29.0,80,7.37,76,367,2421,12.2
23294,Rob Murray,1993-94,26.0,5,3,17,17,0,3,3,8.0,,58,2,10,12,37.0,80,6.91,71,366,2385,11.6
23295,Rob Murray,1994-95,27.0,6,1,9,9,0,1,1,2.0,,67,2,11,13,39.0,80,6.96,77,402,2440,11.4
23296,Rob Murray,1995-96,28.0,7,1,10,10,1,0,1,4.0,,77,3,11,14,43.0,84,7.25,87,443,2603,11.7
23297,Rob Murray,1996-97,29.0,8,0,6,6,0,0,0,1.0,,83,3,11,14,44.0,84,6.48,76,407,2545,10.7
23298,Rob Murray,1997-98,30.0,9,2,10,10,0,2,2,5.0,,93,3,13,16,49.0,48,5.97,37,209,1408,10.2
23299,Rob Murray,1998-99,31.0,10,0,1,1,0,0,0,1.0,,94,3,13,16,50.0,82,6.29,74,413,2481,10.4
23300,Rob Murray,2001-02,34.0,11,3,13,13,1,2,3,11.0,108.0,107,4,15,19,61.0,82,5.27,57,359,2285,9.4
23301,Rob Niedermayer,1996-97,22.0,4,26,65,65,9,17,26,67.0,,65,9,17,26,67.0,84,6.48,76,407,2545,10.7
23302,Rob Niedermayer,1997-98,23.0,5,10,48,48,4,6,10,58.0,,113,13,23,36,125.0,48,5.97,37,209,1408,10.2
23303,Rob Niedermayer,1998-99,24.0,6,61,82,82,26,35,61,155.0,,195,39,58,97,280.0,82,6.29,74,413,2481,10.4
23304,Rob Niedermayer,1999-00,25.0,7,38,60,60,14,24,38,136.0,,255,53,82,135,416.0,82,5.83,55,336,2444,9.8
23305,Rob Niedermayer,2000-01,26.0,8,15,33,33,8,7,15,64.0,,288,61,89,150,480.0,82,5.28,57,380,2242,9.6
23306,Rob Niedermayer,2001-02,27.0,9,51,82,82,18,33,51,142.0,1745.0,370,79,122,201,622.0,82,5.27,57,359,2285,9.4
23307,Rob Niedermayer,2002-03,28.0,10,33,81,81,10,23,33,135.0,1545.0,451,89,145,234,757.0,82,5.49,53,331,2294,9.8
23308,Rob Niedermayer,2003-04,29.0,11,32,67,67,12,20,32,115.0,1373.0,518,101,165,266,872.0,82,5.51,63,376,2272,9.9
23309,Rob Niedermayer,2004-05,30.0,12,20,57,57,6,14,20,87.0,1027.0,575,107,179,286,959.0,82,5.24,53,338,2262,9.5
23310,Rob Niedermayer,2005-06,31.0,13,22,66,66,10,12,22,125.0,1128.0,641,117,191,308,1084.0,82,5.31,60,363,2326,9.4
23311,Rob Niedermayer,2006-07,32.0,14,28,55,55,12,16,28,111.0,1071.0,696,129,207,336,1195.0,82,5.14,57,348,2300,9.2
23312,Rob Niedermayer,2008-09,34.0,15,39,76,76,15,24,39,140.0,1358.0,772,144,231,375,1335.0,82,6.05,85,480,2458,10.1
23313,Rob Niedermayer,2009-10,35.0,16,16,82,82,5,11,16,106.0,1365.0,854,149,242,391,1441.0,82,5.76,70,398,2426,9.7
23314,Rob Niedermayer,2010-11,36.0,17,16,78,78,8,8,16,111.0,1382.0,932,157,250,407,1552.0,82,5.44,62,351,2383,9.4
23315,Rob Niedermayer,2011-12,37.0,18,21,79,79,14,7,21,88.0,1230.0,1011,171,257,428,1640.0,82,5.7,65,341,2477,9.4
23316,Rob Niedermayer,2012-13,38.0,19,22,71,71,10,12,22,93.0,1194.0,1082,181,269,450,1733.0,82,5.53,56,304,2486,9.1
23317,Rob Niedermayer,2013-14,39.0,20,19,71,71,5,14,19,80.0,906.0,1153,186,283,469,1813.0,82,5.46,52,291,2492,9.0
23318,Rob O'Gara,2019-20,26.0,4,0,3,3,0,0,0,2.0,48.0,3,0,0,0,2.0,82,5.45,47,245,2478,9.0
23319,Rob O'Gara,2020-21,27.0,5,3,30,30,0,3,3,21.0,465.0,33,0,3,3,23.0,82,5.86,50,250,2620,9.2
23320,Rob Pearson,1994-95,23.0,4,24,47,47,14,10,24,79.0,,47,14,10,24,79.0,80,6.96,77,402,2440,11.4
23321,Rob Pearson,1995-96,24.0,5,37,78,78,23,14,37,164.0,,125,37,24,61,243.0,84,7.25,87,443,2603,11.7
23322,Rob Pearson,1996-97,25.0,6,30,67,67,12,18,30,119.0,,192,49,42,91,362.0,84,6.48,76,407,2545,10.7
23323,Rob Pearson,1997-98,26.0,7,6,32,32,0,6,6,34.0,,224,49,48,97,396.0,48,5.97,37,209,1408,10.2
23324,Rob Pearson,1998-99,27.0,8,10,27,27,6,4,10,51.0,,251,55,52,107,447.0,82,6.29,74,413,2481,10.4
23325,Rob Pearson,1999-00,28.0,9,3,18,18,1,2,3,14.0,,269,56,54,110,461.0,82,5.83,55,336,2444,9.8
23326,Rob Ramage,1982-83,24.0,4,28,75,75,8,20,28,218.0,,75,8,20,28,218.0,80,7.03,61,280,2352,12.0
23327,Rob Ramage,1983-84,25.0,5,62,79,79,20,42,62,289.0,,154,28,62,90,507.0,80,7.69,77,340,2441,12.6
23328,Rob Ramage,1984-85,26.0,6,42,80,80,13,29,42,270.0,,234,41,91,132,777.0,80,8.03,73,320,2489,12.9
23329,Rob Ramage,1985-86,27.0,7,51,78,78,16,35,51,278.0,,312,57,126,183,1055.0,80,7.73,71,310,2444,12.7
23330,Rob Ramage,1986-87,28.0,8,60,80,80,15,45,60,267.0,,392,72,171,243,1322.0,80,7.89,74,336,2448,12.9
23331,Rob Ramage,1987-88,29.0,9,38,80,80,7,31,38,284.0,,472,79,202,281,1606.0,80,7.77,71,321,2447,12.7
23332,Rob Ramage,1988-89,30.0,10,66,77,77,10,56,66,228.0,,549,89,258,347,1834.0,80,7.94,82,370,2484,12.8
23333,Rob Ramage,1989-90,31.0,11,39,59,59,11,28,39,161.0,,608,100,286,386,1995.0,80,7.34,72,344,2400,12.2
23334,Rob Ramage,1990-91,32.0,12,49,79,79,9,40,49,215.0,,687,109,326,435,2210.0,80,7.43,89,437,2435,12.2
23335,Rob Ramage,1991-92,33.0,13,16,68,68,3,13,16,91.0,,755,112,339,451,2301.0,80,7.48,85,403,2430,12.3
23336,Rob Ramage,1992-93,34.0,14,49,80,80,8,41,49,196.0,,835,120,380,500,2497.0,80,7.37,76,367,2421,12.2
23337,Rob Ramage,1993-94,35.0,15,35,80,80,10,25,35,169.0,,915,130,405,535,2666.0,80,6.91,71,366,2385,11.6
23338,Rob Ramage,1994-95,36.0,16,9,34,34,4,5,9,63.0,,949,134,410,544,2729.0,80,6.96,77,402,2440,11.4
23339,Rob Ramage,1995-96,37.0,17,18,74,74,5,13,18,131.0,,1023,139,423,562,2860.0,84,7.25,87,443,2603,11.7
23340,Rob Ramage,1996-97,38.0,18,2,21,21,0,2,2,23.0,,1044,139,425,564,2883.0,84,6.48,76,407,2545,10.7
23341,Rob Ray,1992-93,24.0,4,3,27,27,2,1,3,20.0,,27,2,1,3,20.0,80,7.37,76,367,2421,12.2
23342,Rob Ray,1993-94,25.0,5,16,66,66,8,8,16,54.0,,93,10,9,19,74.0,80,6.91,71,366,2385,11.6
23343,Rob Ray,1994-95,26.0,6,8,63,63,5,3,8,29.0,,156,15,12,27,103.0,80,6.96,77,402,2440,11.4
23344,Rob Ray,1995-96,27.0,7,5,68,68,3,2,5,28.0,,224,18,14,32,131.0,84,7.25,87,443,2603,11.7
23345,Rob Ray,1996-97,28.0,8,7,82,82,3,4,7,34.0,,306,21,18,39,165.0,84,6.48,76,407,2545,10.7
23346,Rob Ray,1997-98,29.0,9,3,47,47,0,3,3,7.0,,353,21,21,42,172.0,48,5.97,37,209,1408,10.2
23347,Rob Ray,1998-99,30.0,10,9,71,71,3,6,9,21.0,,424,24,27,51,193.0,82,6.29,74,413,2481,10.4
23348,Rob Ray,1999-00,31.0,11,10,82,82,7,3,10,45.0,,506,31,30,61,238.0,82,5.83,55,336,2444,9.8
23349,Rob Ray,2000-01,32.0,12,6,63,63,2,4,6,19.0,,569,33,34,67,257.0,82,5.28,57,380,2242,9.6
23350,Rob Ray,2001-02,33.0,13,4,76,76,0,4,4,23.0,394.0,645,33,38,71,280.0,82,5.27,57,359,2285,9.4
23351,Rob Ray,2002-03,34.0,14,4,69,69,1,3,4,17.0,290.0,714,34,41,75,297.0,82,5.49,53,331,2294,9.8
23352,Rob Ray,2003-04,35.0,15,10,63,63,4,6,10,33.0,355.0,777,38,47,85,330.0,82,5.51,63,376,2272,9.9
23353,Rob Ray,2004-05,36.0,16,5,71,71,2,3,5,23.0,364.0,848,40,50,90,353.0,82,5.24,53,338,2262,9.5
23354,Rob Ray,2005-06,37.0,17,0,46,46,0,0,0,14.0,205.0,894,40,50,90,367.0,82,5.31,60,363,2326,9.4
23355,Rob Ray,2006-07,38.0,18,1,6,6,1,0,1,3.0,28.0,900,41,50,91,370.0,82,5.14,57,348,2300,9.2
23356,Rob Robinson,1994-95,27.0,4,1,22,22,0,1,1,9.0,,22,0,1,1,9.0,80,6.96,77,402,2440,11.4
23357,Rob Schremp,2009-10,23.0,4,0,1,1,0,0,0,2.0,14.0,1,0,0,0,2.0,82,5.76,70,398,2426,9.7
23358,Rob Schremp,2010-11,24.0,5,0,2,2,0,0,0,3.0,14.0,3,0,0,0,5.0,82,5.44,62,351,2383,9.4
23359,Rob Schremp,2011-12,25.0,6,3,4,4,0,3,3,3.0,54.0,7,0,3,3,8.0,82,5.7,65,341,2477,9.4
23360,Rob Schremp,2012-13,26.0,7,25,44,44,7,18,25,74.0,612.0,51,7,21,28,82.0,82,5.53,56,304,2486,9.1
23361,Rob Schremp,2013-14,27.0,8,26,63,63,13,13,26,83.0,885.0,114,20,34,54,165.0,82,5.46,52,291,2492,9.0
23362,Rob Scuderi,2006-07,28.0,4,3,13,13,1,2,3,4.0,261.0,13,1,2,3,4.0,82,5.14,57,348,2300,9.2
23363,Rob Scuderi,2008-09,30.0,5,4,57,57,0,4,4,28.0,1154.0,70,1,6,7,32.0,82,6.05,85,480,2458,10.1
23364,Rob Scuderi,2009-10,31.0,6,11,78,78,1,10,11,31.0,1467.0,148,2,16,18,63.0,82,5.76,70,398,2426,9.7
23365,Rob Scuderi,2010-11,32.0,7,5,71,71,0,5,5,28.0,1331.0,219,2,21,23,91.0,82,5.44,62,351,2383,9.4
23366,Rob Scuderi,2011-12,33.0,8,16,81,81,1,15,16,51.0,1552.0,300,3,36,39,142.0,82,5.7,65,341,2477,9.4
23367,Rob Scuderi,2012-13,34.0,9,11,73,73,0,11,11,38.0,1407.0,373,3,47,50,180.0,82,5.53,56,304,2486,9.1
23368,Rob Scuderi,2013-14,35.0,10,15,82,82,2,13,15,46.0,1664.0,455,5,60,65,226.0,82,5.46,52,291,2492,9.0
23369,Rob Scuderi,2014-15,36.0,11,9,82,82,1,8,9,63.0,1690.0,537,6,68,74,289.0,82,5.32,47,271,2439,8.9
23370,Rob Scuderi,2015-16,37.0,12,12,48,48,1,11,12,33.0,1046.0,585,7,79,86,322.0,48,5.31,29,160,1399,9.1
23371,Rob Scuderi,2016-17,38.0,13,4,53,53,0,4,4,28.0,1003.0,638,7,83,90,350.0,82,5.34,48,269,2463,8.9
23372,Rob Scuderi,2017-18,39.0,14,10,82,82,1,9,10,52.0,1570.0,720,8,92,100,402.0,82,5.32,47,251,2453,8.9
23373,Rob Scuderi,2018-19,40.0,15,10,63,63,0,10,10,35.0,996.0,783,8,102,110,437.0,82,5.34,48,255,2438,9.0
23374,Rob Shearer,2003-04,27.0,4,0,2,2,0,0,0,0.0,14.0,2,0,0,0,0.0,82,5.51,63,376,2272,9.9
23375,Rob Skrlac,2006-07,30.0,4,1,8,8,1,0,1,3.0,18.0,8,1,0,1,3.0,82,5.14,57,348,2300,9.2
23376,Rob Valicevic,2001-02,31.0,4,6,19,19,4,2,6,23.0,209.0,19,4,2,6,23.0,82,5.27,57,359,2285,9.4
23377,Rob Valicevic,2002-03,32.0,5,25,80,80,14,11,25,113.0,1161.0,99,18,13,31,136.0,82,5.49,53,331,2294,9.8
23378,Rob Valicevic,2003-04,33.0,6,14,60,60,8,6,14,62.0,846.0,159,26,19,45,198.0,82,5.51,63,376,2272,9.9
23379,Rob Valicevic,2004-05,34.0,7,2,17,17,1,1,2,9.0,163.0,176,27,20,47,207.0,82,5.24,53,338,2262,9.5
23380,Rob Valicevic,2005-06,35.0,8,1,10,10,1,0,1,7.0,86.0,186,28,20,48,214.0,82,5.31,60,363,2326,9.4
23381,Rob Valicevic,2006-07,36.0,9,0,7,7,0,0,0,4.0,55.0,193,28,20,48,218.0,82,5.14,57,348,2300,9.2
23382,Rob Whistle,1988-89,27.0,4,6,32,32,4,2,6,30.0,,32,4,2,6,30.0,80,7.94,82,370,2484,12.8
23383,Rob Whistle,1990-91,29.0,5,6,19,19,3,3,6,17.0,,51,7,5,12,47.0,80,7.43,89,437,2435,12.2
23384,Rob Zamuner,1994-95,25.0,4,3,9,9,1,2,3,11.0,,9,1,2,3,11.0,80,6.96,77,402,2440,11.4
23385,Rob Zamuner,1995-96,26.0,5,43,84,84,15,28,43,183.0,,93,16,30,46,194.0,84,7.25,87,443,2603,11.7
23386,Rob Zamuner,1996-97,27.0,6,12,59,59,6,6,12,109.0,,152,22,36,58,303.0,84,6.48,76,407,2545,10.7
23387,Rob Zamuner,1997-98,28.0,7,15,43,43,9,6,15,74.0,,195,31,42,73,377.0,48,5.97,37,209,1408,10.2
23388,Rob Zamuner,1998-99,29.0,8,35,72,72,15,20,35,152.0,,267,46,62,108,529.0,82,6.29,74,413,2481,10.4
23389,Rob Zamuner,1999-00,30.0,9,50,82,82,17,33,50,216.0,,349,63,95,158,745.0,82,5.83,55,336,2444,9.8
23390,Rob Zamuner,2000-01,31.0,10,26,77,77,14,12,26,126.0,,426,77,107,184,871.0,82,5.28,57,380,2242,9.6
23391,Rob Zamuner,2001-02,32.0,11,19,58,58,8,11,19,89.0,953.0,484,85,118,203,960.0,82,5.27,57,359,2285,9.4
23392,Rob Zamuner,2002-03,33.0,12,21,57,57,9,12,21,103.0,851.0,541,94,130,224,1063.0,82,5.49,53,331,2294,9.8
23393,Rob Zamuner,2003-04,34.0,13,37,79,79,19,18,37,123.0,1167.0,620,113,148,261,1186.0,82,5.51,63,376,2272,9.9
23394,Rob Zamuner,2004-05,35.0,14,25,66,66,12,13,25,98.0,872.0,686,125,161,286,1284.0,82,5.24,53,338,2262,9.5
23395,Rob Zamuner,2005-06,36.0,15,16,55,55,10,6,16,94.0,667.0,741,135,167,302,1378.0,82,5.31,60,363,2326,9.4
23396,Rob Zamuner,2006-07,37.0,16,9,57,57,4,5,9,49.0,554.0,798,139,172,311,1427.0,82,5.14,57,348,2300,9.2
23397,Rob Zettler,1991-92,23.0,4,0,2,2,0,0,0,0.0,,2,0,0,0,0.0,80,7.48,85,403,2430,12.3
23398,Rob Zettler,1992-93,24.0,5,8,31,31,0,8,8,21.0,,33,0,8,8,21.0,80,7.37,76,367,2421,12.2
23399,Rob Zettler,1993-94,25.0,6,5,47,47,1,4,5,30.0,,80,1,12,13,51.0,80,6.91,71,366,2385,11.6
23400,Rob Zettler,1994-95,26.0,7,9,74,74,1,8,9,72.0,,154,2,20,22,123.0,80,6.96,77,402,2440,11.4
23401,Rob Zettler,1995-96,27.0,8,7,80,80,0,7,7,60.0,,234,2,27,29,183.0,84,7.25,87,443,2603,11.7
23402,Rob Zettler,1996-97,28.0,9,7,75,75,0,7,7,55.0,,309,2,34,36,238.0,84,6.48,76,407,2545,10.7
23403,Rob Zettler,1997-98,29.0,10,1,32,32,0,1,1,17.0,,341,2,35,37,255.0,48,5.97,37,209,1408,10.2
23404,Rob Zettler,1998-99,30.0,11,1,29,29,0,1,1,11.0,,370,2,36,38,266.0,82,6.29,74,413,2481,10.4
23405,Rob Zettler,1999-00,31.0,12,14,48,48,2,12,14,31.0,,418,4,48,52,297.0,82,5.83,55,336,2444,9.8
23406,Rob Zettler,2000-01,32.0,13,7,59,59,0,7,7,28.0,,477,4,55,59,325.0,82,5.28,57,380,2242,9.6
23407,Rob Zettler,2001-02,33.0,14,0,2,2,0,0,0,0.0,33.0,479,4,55,59,325.0,82,5.27,57,359,2285,9.4
23408,Rob Zettler,2002-03,34.0,15,2,12,12,0,2,2,15.0,184.0,491,4,57,61,340.0,82,5.49,53,331,2294,9.8
23409,Rob Zettler,2003-04,35.0,16,4,29,29,0,4,4,17.0,352.0,520,4,61,65,357.0,82,5.51,63,376,2272,9.9
23410,Rob Zettler,2004-05,36.0,17,5,49,49,1,4,5,28.0,706.0,569,5,65,70,385.0,82,5.24,53,338,2262,9.5
23411,Robb Gordon,2001-02,26.0,4,0,4,4,0,0,0,1.0,35.0,4,0,0,0,1.0,82,5.27,57,359,2285,9.4
23412,Robbie Earl,2010-11,25.0,4,1,9,9,0,1,1,9.0,83.0,9,0,1,1,9.0,82,5.44,62,351,2383,9.4
23413,Robbie Earl,2012-13,27.0,5,6,32,32,6,0,6,29.0,286.0,41,6,1,7,38.0,82,5.53,56,304,2486,9.1
23414,Robbie Earl,2013-14,28.0,6,0,6,6,0,0,0,6.0,53.0,47,6,1,7,44.0,82,5.46,52,291,2492,9.0
23415,Robbie Laird,1982-83,28.0,4,0,1,1,0,0,0,0.0,,1,0,0,0,0.0,80,7.03,61,280,2352,12.0
23416,Robbie Russo,2019-20,26.0,4,0,19,19,0,0,0,18.0,305.0,19,0,0,0,18.0,82,5.45,47,245,2478,9.0
23417,Robby Fabbri,2018-19,23.0,4,37,72,72,18,19,37,114.0,959.0,72,18,19,37,114.0,82,5.34,48,255,2438,9.0
23418,Robby Fabbri,2019-20,24.0,5,29,51,51,11,18,29,91.0,796.0,123,29,37,66,205.0,82,5.45,47,245,2478,9.0
23419,Robby Fabbri,2021-22,26.0,6,6,32,32,2,4,6,43.0,405.0,155,31,41,72,248.0,82,5.96,47,239,2579,9.5
23420,Robby Fabbri,2022-23,27.0,7,32,61,61,15,17,32,111.0,985.0,216,46,58,104,359.0,70,5.96,42,208,2192,9.5
23421,Robert Bortuzzo,2014-15,25.0,4,0,6,6,0,0,0,3.0,65.0,6,0,0,0,3.0,82,5.32,47,271,2439,8.9
23422,Robert Bortuzzo,2015-16,26.0,5,4,15,15,2,2,4,10.0,199.0,21,2,2,4,13.0,48,5.31,29,160,1399,9.1
23423,Robert Bortuzzo,2016-17,27.0,6,10,54,54,0,10,10,50.0,836.0,75,2,12,14,63.0,82,5.34,48,269,2463,8.9
23424,Robert Bortuzzo,2017-18,28.0,7,8,51,51,3,5,8,56.0,771.0,126,5,17,22,119.0,82,5.32,47,251,2453,8.9
23425,Robert Bortuzzo,2018-19,29.0,8,3,40,40,2,1,3,47.0,531.0,166,7,18,25,166.0,82,5.34,48,255,2438,9.0
23426,Robert Bortuzzo,2019-20,30.0,9,4,38,38,1,3,4,45.0,535.0,204,8,21,29,211.0,82,5.45,47,245,2478,9.0
23427,Robert Bortuzzo,2020-21,31.0,10,13,72,72,4,9,13,76.0,1066.0,276,12,30,42,287.0,82,5.86,50,250,2620,9.2
23428,Robert Bortuzzo,2021-22,32.0,11,10,59,59,2,8,10,75.0,913.0,335,14,38,52,362.0,82,5.96,47,239,2579,9.5
23429,Robert Bortuzzo,2022-23,33.0,12,6,42,42,2,4,6,36.0,551.0,377,16,42,58,398.0,70,5.96,42,208,2192,9.5
23430,Robert Burakovsky,1996-97,30.0,4,5,23,23,2,3,5,40.0,,23,2,3,5,40.0,84,6.48,76,407,2545,10.7
23431,Robert Dirk,1990-91,24.0,4,1,7,7,0,1,1,2.0,,7,0,1,1,2.0,80,7.43,89,437,2435,12.2
23432,Robert Dirk,1991-92,25.0,5,1,9,9,0,1,1,7.0,,16,0,2,2,9.0,80,7.48,85,403,2430,12.3
23433,Robert Dirk,1992-93,26.0,6,2,37,37,1,1,2,14.0,,53,1,3,4,23.0,80,7.37,76,367,2421,12.2
23434,Robert Dirk,1993-94,27.0,7,5,52,52,2,3,5,29.0,,105,3,6,9,52.0,80,6.91,71,366,2385,11.6
23435,Robert Dirk,1994-95,28.0,8,9,72,72,2,7,9,44.0,,177,5,13,18,96.0,80,6.96,77,402,2440,11.4
23436,Robert Dirk,1995-96,29.0,9,12,69,69,4,8,12,41.0,,246,9,21,30,137.0,84,7.25,87,443,2603,11.7
23437,Robert Dirk,1996-97,30.0,10,5,71,71,2,3,5,42.0,,317,11,24,35,179.0,84,6.48,76,407,2545,10.7
23438,Robert Dirk,1997-98,31.0,11,4,38,38,1,3,4,15.0,,355,12,27,39,194.0,48,5.97,37,209,1408,10.2
23439,Robert Dirk,1998-99,32.0,12,3,47,47,1,2,3,20.0,,402,13,29,42,214.0,82,6.29,74,413,2481,10.4
23440,Robert Dome,2000-01,22.0,4,7,30,30,5,2,7,29.0,,30,5,2,7,29.0,82,5.28,57,380,2242,9.6
23441,Robert Dome,2002-03,24.0,5,7,22,22,2,5,7,27.0,217.0,52,7,7,14,56.0,82,5.49,53,331,2294,9.8
23442,Robert Dome,2005-06,27.0,6,0,1,1,0,0,0,1.0,8.0,53,7,7,14,57.0,82,5.31,60,363,2326,9.4
23443,Robert Hagg,2019-20,24.0,4,0,1,1,0,0,0,5.0,21.0,1,0,0,0,5.0,82,5.45,47,245,2478,9.0
23444,Robert Hagg,2020-21,25.0,5,9,70,70,3,6,9,89.0,1270.0,71,3,6,9,94.0,82,5.86,50,250,2620,9.2
23445,Robert Hagg,2021-22,26.0,6,20,82,82,5,15,20,86.0,1390.0,153,8,21,29,180.0,82,5.96,47,239,2579,9.5
23446,Robert Hagg,2022-23,27.0,7,13,49,49,3,10,13,38.0,764.0,202,11,31,42,218.0,70,5.96,42,208,2192,9.5
23447,Robert Kron,1993-94,26.0,4,32,76,76,12,20,32,124.0,,76,12,20,32,124.0,80,6.91,71,366,2385,11.6
23448,Robert Kron,1994-95,27.0,5,4,36,36,2,2,4,49.0,,112,14,22,36,173.0,80,6.96,77,402,2440,11.4
23449,Robert Kron,1995-96,28.0,6,27,45,45,14,13,27,97.0,,157,28,35,63,270.0,84,7.25,87,443,2603,11.7
23450,Robert Kron,1996-97,29.0,7,50,77,77,24,26,50,194.0,,234,52,61,113,464.0,84,6.48,76,407,2545,10.7
23451,Robert Kron,1997-98,30.0,8,18,37,37,10,8,18,88.0,,271,62,69,131,552.0,48,5.97,37,209,1408,10.2
23452,Robert Kron,1998-99,31.0,9,50,77,77,22,28,50,203.0,,348,84,97,181,755.0,82,6.29,74,413,2481,10.4
23453,Robert Kron,1999-00,32.0,10,22,68,68,10,12,22,182.0,,416,94,109,203,937.0,82,5.83,55,336,2444,9.8
23454,Robert Kron,2000-01,33.0,11,36,81,81,16,20,36,175.0,,497,110,129,239,1112.0,82,5.28,57,380,2242,9.6
23455,Robert Kron,2001-02,34.0,12,25,75,75,9,16,25,134.0,1218.0,572,119,145,264,1246.0,82,5.27,57,359,2285,9.4
23456,Robert Kron,2002-03,35.0,13,40,81,81,13,27,40,134.0,1233.0,653,132,172,304,1380.0,82,5.49,53,331,2294,9.8
23457,Robert Kron,2003-04,36.0,14,19,59,59,8,11,19,134.0,1011.0,712,140,183,323,1514.0,82,5.51,63,376,2272,9.9
23458,Robert Kron,2004-05,37.0,15,15,59,59,4,11,15,92.0,943.0,771,144,194,338,1606.0,82,5.24,53,338,2262,9.5
23459,Robert Lang,1995-96,25.0,4,5,11,11,0,5,5,3.0,,11,0,5,5,3.0,84,7.25,87,443,2603,11.7
23460,Robert Lang,1996-97,26.0,5,19,32,32,9,10,19,41.0,,43,9,15,24,44.0,84,6.48,76,407,2545,10.7
23461,Robert Lang,1997-98,27.0,6,12,36,36,4,8,12,38.0,,79,13,23,36,82.0,48,5.97,37,209,1408,10.2
23462,Robert Lang,1998-99,28.0,7,22,68,68,6,16,22,71.0,,147,19,39,58,153.0,82,6.29,74,413,2481,10.4
23463,Robert Lang,2000-01,30.0,8,22,54,54,9,13,22,66.0,,201,28,52,80,219.0,82,5.28,57,380,2242,9.6
23464,Robert Lang,2001-02,31.0,9,44,72,72,21,23,44,137.0,1181.0,273,49,75,124,356.0,82,5.27,57,359,2285,9.4
23465,Robert Lang,2002-03,32.0,10,65,78,78,23,42,65,142.0,1510.0,351,72,117,189,498.0,82,5.49,53,331,2294,9.8
23466,Robert Lang,2003-04,33.0,11,80,82,82,32,48,80,177.0,1673.0,433,104,165,269,675.0,82,5.51,63,376,2272,9.9
23467,Robert Lang,2004-05,34.0,12,50,62,62,18,32,50,175.0,1422.0,495,122,197,319,850.0,82,5.24,53,338,2262,9.5
23468,Robert Lang,2005-06,35.0,13,69,82,82,22,47,69,146.0,1540.0,577,144,244,388,996.0,82,5.31,60,363,2326,9.4
23469,Robert Lang,2006-07,36.0,14,79,69,69,30,49,79,163.0,1469.0,646,174,293,467,1159.0,82,5.14,57,348,2300,9.2
23470,Robert Lang,2008-09,38.0,15,62,72,72,20,42,62,171.0,1170.0,718,194,335,529,1330.0,82,6.05,85,480,2458,10.1
23471,Robert Lang,2009-10,39.0,16,52,81,81,19,33,52,166.0,1362.0,799,213,368,581,1496.0,82,5.76,70,398,2426,9.7
23472,Robert Lang,2010-11,40.0,17,54,76,76,21,33,54,172.0,1400.0,875,234,401,635,1668.0,82,5.44,62,351,2383,9.4
23473,Robert Lang,2011-12,41.0,18,39,50,50,18,21,39,101.0,844.0,925,252,422,674,1769.0,82,5.7,65,341,2477,9.4
23474,Robert Lang,2012-13,42.0,19,29,64,64,9,20,29,84.0,965.0,989,261,442,703,1853.0,82,5.53,56,304,2486,9.1
23475,Robert Logan,1989-90,25.0,4,10,22,22,7,3,10,22.0,,22,7,3,10,22.0,80,7.34,72,344,2400,12.2
23476,Robert Logan,1990-91,26.0,5,5,16,16,3,2,5,15.0,,38,10,5,15,37.0,80,7.43,89,437,2435,12.2
23477,Robert Logan,1991-92,27.0,6,0,4,4,0,0,0,0.0,,42,10,5,15,37.0,80,7.48,85,403,2430,12.3
23478,Robert Nilsson,2008-09,24.0,4,20,53,53,6,14,20,70.0,629.0,53,6,14,20,70.0,82,6.05,85,480,2458,10.1
23479,Robert Nilsson,2009-10,25.0,5,1,4,4,1,0,1,8.0,69.0,57,7,14,21,78.0,82,5.76,70,398,2426,9.7
23480,Robert Nilsson,2010-11,26.0,6,41,71,71,10,31,41,102.0,989.0,128,17,45,62,180.0,82,5.44,62,351,2383,9.4
23481,Robert Nilsson,2011-12,27.0,7,29,64,64,9,20,29,77.0,972.0,192,26,65,91,257.0,82,5.7,65,341,2477,9.4
23482,Robert Nilsson,2012-13,28.0,8,27,60,60,11,16,27,104.0,885.0,252,37,81,118,361.0,82,5.53,56,304,2486,9.1
23483,Robert Nordmark,1990-91,28.0,4,21,67,67,3,18,21,78.0,,67,3,18,21,78.0,80,7.43,89,437,2435,12.2
23484,Robert Nordmark,1991-92,29.0,5,41,80,80,6,35,41,156.0,,147,9,53,62,234.0,80,7.48,85,403,2430,12.3
23485,Robert Nordmark,1992-93,30.0,6,13,44,44,2,11,13,86.0,,191,11,64,75,320.0,80,7.37,76,367,2421,12.2
23486,Robert Nordmark,1993-94,31.0,7,8,45,45,2,6,8,65.0,,236,13,70,83,385.0,80,6.91,71,366,2385,11.6
23487,Robert Petrovicky,1995-96,22.0,4,9,42,42,3,6,9,41.0,,42,3,6,9,41.0,84,7.25,87,443,2603,11.7
23488,Robert Petrovicky,1996-97,23.0,5,11,33,33,6,5,11,33.0,,75,9,11,20,74.0,84,6.48,76,407,2545,10.7
23489,Robert Petrovicky,1997-98,24.0,6,0,2,2,0,0,0,1.0,,77,9,11,20,75.0,48,5.97,37,209,1408,10.2
23490,Robert Petrovicky,1998-99,25.0,7,2,5,5,1,1,2,3.0,,82,10,12,22,78.0,82,6.29,74,413,2481,10.4
23491,Robert Petrovicky,1999-00,26.0,8,19,44,44,7,12,19,54.0,,126,17,24,41,132.0,82,5.83,55,336,2444,9.8
23492,Robert Petrovicky,2001-02,28.0,9,7,28,28,3,4,7,32.0,295.0,154,20,28,48,164.0,82,5.27,57,359,2285,9.4
23493,Robert Petrovicky,2002-03,29.0,10,17,43,43,7,10,17,50.0,434.0,197,27,38,65,214.0,82,5.49,53,331,2294,9.8
23494,Robert Petrovicky,2003-04,30.0,11,0,11,11,0,0,0,3.0,38.0,208,27,38,65,217.0,82,5.51,63,376,2272,9.9
23495,Robert Reichel,1993-94,22.0,4,41,66,66,19,22,41,131.0,,66,19,22,41,131.0,80,6.91,71,366,2385,11.6
23496,Robert Reichel,1994-95,23.0,5,54,77,77,20,34,54,181.0,,143,39,56,95,312.0,80,6.96,77,402,2440,11.4
23497,Robert Reichel,1995-96,24.0,6,88,80,80,40,48,88,238.0,,223,79,104,183,550.0,84,7.25,87,443,2603,11.7
23498,Robert Reichel,1996-97,25.0,7,93,84,84,40,53,93,249.0,,307,119,157,276,799.0,84,6.48,76,407,2545,10.7
23499,Robert Reichel,1997-98,26.0,8,35,48,48,18,17,35,160.0,,355,137,174,311,959.0,48,5.97,37,209,1408,10.2
23500,Robert Reichel,1999-00,28.0,9,62,82,82,21,41,62,214.0,,437,158,215,373,1173.0,82,5.83,55,336,2444,9.8
23501,Robert Reichel,2000-01,29.0,10,65,82,82,25,40,65,201.0,,519,183,255,438,1374.0,82,5.28,57,380,2242,9.6
23502,Robert Reichel,2001-02,30.0,11,69,83,83,26,43,69,236.0,1633.0,602,209,298,507,1610.0,82,5.27,57,359,2285,9.4
23503,Robert Reichel,2004-05,33.0,12,51,78,78,20,31,51,152.0,1184.0,680,229,329,558,1762.0,82,5.24,53,338,2262,9.5
23504,Robert Reichel,2005-06,34.0,13,42,81,81,12,30,42,111.0,1178.0,761,241,359,600,1873.0,82,5.31,60,363,2326,9.4
23505,Robert Reichel,2006-07,35.0,14,30,69,69,11,19,30,100.0,1070.0,830,252,378,630,1973.0,82,5.14,57,348,2300,9.2
23506,Robert Schnabel,2004-05,26.0,4,0,1,1,0,0,0,0.0,7.0,1,0,0,0,0.0,82,5.24,53,338,2262,9.5
23507,Robert Schnabel,2005-06,27.0,5,0,1,1,0,0,0,0.0,4.0,2,0,0,0,0.0,82,5.31,60,363,2326,9.4
23508,Robert Schnabel,2006-07,28.0,6,3,20,20,0,3,3,10.0,292.0,22,0,3,3,10.0,82,5.14,57,348,2300,9.2
23509,Robert Svehla,1997-98,29.0,4,2,5,5,1,1,2,6.0,,5,1,1,2,6.0,48,5.97,37,209,1408,10.2
23510,Robert Svehla,1998-99,30.0,5,57,81,81,8,49,57,146.0,,86,9,50,59,152.0,82,6.29,74,413,2481,10.4
23511,Robert Svehla,1999-00,31.0,6,45,82,82,13,32,45,159.0,,168,22,82,104,311.0,82,5.83,55,336,2444,9.8
23512,Robert Svehla,2000-01,32.0,7,43,79,79,9,34,43,144.0,,247,31,116,147,455.0,82,5.28,57,380,2242,9.6
23513,Robert Svehla,2001-02,33.0,8,37,80,80,8,29,37,157.0,1980.0,327,39,145,184,612.0,82,5.27,57,359,2285,9.4
23514,Robert Svehla,2002-03,34.0,9,49,82,82,9,40,49,143.0,2013.0,409,48,185,233,755.0,82,5.49,53,331,2294,9.8
23515,Robert Svehla,2003-04,35.0,10,28,82,82,6,22,28,121.0,2097.0,491,54,207,261,876.0,82,5.51,63,376,2272,9.9
23516,Robert Svehla,2004-05,36.0,11,29,82,82,7,22,29,119.0,2106.0,573,61,229,290,995.0,82,5.24,53,338,2262,9.5
23517,Robert Svehla,2005-06,37.0,12,45,82,82,7,38,45,110.0,1947.0,655,68,267,335,1105.0,82,5.31,60,363,2326,9.4
23518,Robert Thomas,2021-22,22.0,4,33,70,70,9,24,33,80.0,915.0,70,9,24,33,80.0,82,5.96,47,239,2579,9.5
23519,Robert Thomas,2022-23,23.0,5,42,66,66,10,32,42,87.0,961.0,136,19,56,75,167.0,70,5.96,42,208,2192,9.5
23520,Robin Bartel,1988-89,27.0,4,0,1,1,0,0,0,0.0,,1,0,0,0,0.0,80,7.94,82,370,2484,12.8
23521,Robin Bartel,1989-90,28.0,5,1,40,40,0,1,1,16.0,,41,0,1,1,16.0,80,7.34,72,344,2400,12.2
23522,Robin Bawa,1992-93,26.0,4,1,5,5,1,0,1,1.0,,5,1,0,1,1.0,80,7.37,76,367,2421,12.2
23523,Robin Bawa,1994-95,28.0,5,0,2,2,0,0,0,1.0,,7,1,0,1,2.0,80,6.96,77,402,2440,11.4
23524,Robin Bawa,1995-96,29.0,6,5,42,42,5,0,5,25.0,,49,6,0,6,27.0,84,7.25,87,443,2603,11.7
23525,Robin Bawa,1996-97,30.0,7,1,12,12,0,1,1,1.0,,61,6,1,7,28.0,84,6.48,76,407,2545,10.7
23526,Robyn Regehr,2002-03,22.0,4,12,57,57,5,7,12,64.0,1049.0,57,5,7,12,64.0,82,5.49,53,331,2294,9.8
23527,Robyn Regehr,2003-04,23.0,5,4,71,71,1,3,4,62.0,1400.0,128,6,10,16,126.0,82,5.51,63,376,2272,9.9
23528,Robyn Regehr,2004-05,24.0,6,8,77,77,2,6,8,82.0,1609.0,205,8,16,24,208.0,82,5.24,53,338,2262,9.5
23529,Robyn Regehr,2005-06,25.0,7,12,76,76,0,12,12,109.0,1729.0,281,8,28,36,317.0,82,5.31,60,363,2326,9.4
23530,Robyn Regehr,2006-07,26.0,8,18,82,82,4,14,18,106.0,1832.0,363,12,42,54,423.0,82,5.14,57,348,2300,9.2
23531,Robyn Regehr,2008-09,28.0,9,26,68,68,6,20,26,89.0,1573.0,431,18,62,80,512.0,82,6.05,85,480,2458,10.1
23532,Robyn Regehr,2009-10,29.0,10,21,78,78,2,19,21,66.0,1709.0,509,20,81,101,578.0,82,5.76,70,398,2426,9.7
23533,Robyn Regehr,2010-11,30.0,11,20,82,82,5,15,20,93.0,1750.0,591,25,96,121,671.0,82,5.44,62,351,2383,9.4
23534,Robyn Regehr,2011-12,31.0,12,8,75,75,0,8,8,79.0,1586.0,666,25,104,129,750.0,82,5.7,65,341,2477,9.4
23535,Robyn Regehr,2012-13,32.0,13,17,81,81,2,15,17,78.0,1753.0,747,27,119,146,828.0,82,5.53,56,304,2486,9.1
23536,Robyn Regehr,2013-14,33.0,14,17,79,79,2,15,17,72.0,1697.0,826,29,134,163,900.0,82,5.46,52,291,2492,9.0
23537,Robyn Regehr,2014-15,34.0,15,5,76,76,1,4,5,49.0,1416.0,902,30,138,168,949.0,82,5.32,47,271,2439,8.9
23538,Robyn Regehr,2015-16,35.0,16,4,41,41,0,4,4,27.0,796.0,943,30,142,172,976.0,48,5.31,29,160,1399,9.1
23539,Robyn Regehr,2016-17,36.0,17,14,79,79,3,11,14,73.0,1498.0,1022,33,153,186,1049.0,82,5.34,48,269,2463,8.9
23540,Robyn Regehr,2017-18,37.0,18,13,67,67,3,10,13,63.0,1362.0,1089,36,163,199,1112.0,82,5.32,47,251,2453,8.9
23541,Rocco Grimaldi,2017-18,24.0,4,1,7,7,1,0,1,18.0,88.0,7,1,0,1,18.0,82,5.32,47,251,2453,8.9
23542,Rocco Grimaldi,2018-19,25.0,5,5,20,20,3,2,5,29.0,237.0,27,4,2,6,47.0,82,5.34,48,255,2438,9.0
23543,Rocco Grimaldi,2019-20,26.0,6,1,4,4,0,1,1,11.0,44.0,31,4,3,7,58.0,82,5.45,47,245,2478,9.0
23544,Rocco Grimaldi,2020-21,27.0,7,3,6,6,1,2,3,7.0,58.0,37,5,5,10,65.0,82,5.86,50,250,2620,9.2
23545,Rocco Grimaldi,2021-22,28.0,8,13,53,53,5,8,13,81.0,530.0,90,10,13,23,146.0,82,5.96,47,239,2579,9.5
23546,Rocco Grimaldi,2022-23,29.0,9,31,66,66,10,21,31,122.0,835.0,156,20,34,54,268.0,70,5.96,42,208,2192,9.5
23547,Rocky Dundas,1992-93,26.0,4,0,5,5,0,0,0,1.0,,5,0,0,0,1.0,80,7.37,76,367,2421,12.2
23548,Rocky Thompson,2000-01,23.0,4,0,12,12,0,0,0,3.0,,12,0,0,0,3.0,82,5.28,57,380,2242,9.6
23549,Rocky Thompson,2001-02,24.0,5,0,3,3,0,0,0,0.0,6.0,15,0,0,0,3.0,82,5.27,57,359,2285,9.4
23550,Rocky Thompson,2003-04,26.0,6,0,4,4,0,0,0,0.0,6.0,19,0,0,0,3.0,82,5.51,63,376,2272,9.9
23551,Rocky Thompson,2004-05,27.0,7,0,6,6,0,0,0,1.0,24.0,25,0,0,0,4.0,82,5.24,53,338,2262,9.5
23552,Rocky Trottier,1986-87,22.0,4,2,5,5,1,1,2,2.0,,5,1,1,2,2.0,80,7.89,74,336,2448,12.9
23553,Rocky Trottier,1987-88,23.0,5,8,33,33,5,3,8,30.0,,38,6,4,10,32.0,80,7.77,71,321,2447,12.7
23554,Rod Brind'Amour,1992-93,22.0,4,61,79,79,26,35,61,160.0,,79,26,35,61,160.0,80,7.37,76,367,2421,12.2
23555,Rod Brind'Amour,1993-94,23.0,5,49,78,78,17,32,49,169.0,,157,43,67,110,329.0,80,6.91,71,366,2385,11.6
23556,Rod Brind'Amour,1994-95,24.0,6,77,80,80,33,44,77,202.0,,237,76,111,187,531.0,80,6.96,77,402,2440,11.4
23557,Rod Brind'Amour,1995-96,25.0,7,86,81,81,37,49,86,206.0,,318,113,160,273,737.0,84,7.25,87,443,2603,11.7
23558,Rod Brind'Amour,1996-97,26.0,8,97,84,84,35,62,97,230.0,,402,148,222,370,967.0,84,6.48,76,407,2545,10.7
23559,Rod Brind'Amour,1997-98,27.0,9,39,48,48,12,27,39,86.0,,450,160,249,409,1053.0,48,5.97,37,209,1408,10.2
23560,Rod Brind'Amour,1998-99,28.0,10,87,82,82,26,61,87,213.0,,532,186,310,496,1266.0,82,6.29,74,413,2481,10.4
23561,Rod Brind'Amour,1999-00,29.0,11,59,82,82,27,32,59,205.0,,614,213,342,555,1471.0,82,5.83,55,336,2444,9.8
23562,Rod Brind'Amour,2000-01,30.0,12,74,82,82,36,38,74,205.0,,696,249,380,629,1676.0,82,5.28,57,380,2242,9.6
23563,Rod Brind'Amour,2001-02,31.0,13,74,82,82,24,50,74,191.0,1762.0,778,273,430,703,1867.0,82,5.27,57,359,2285,9.4
23564,Rod Brind'Amour,2002-03,32.0,14,22,45,45,9,13,22,87.0,929.0,823,282,443,725,1954.0,82,5.49,53,331,2294,9.8
23565,Rod Brind'Amour,2003-04,33.0,15,56,79,79,20,36,56,163.0,1748.0,902,302,479,781,2117.0,82,5.51,63,376,2272,9.9
23566,Rod Brind'Amour,2004-05,34.0,16,55,81,81,23,32,55,162.0,1792.0,983,325,511,836,2279.0,82,5.24,53,338,2262,9.5
23567,Rod Brind'Amour,2005-06,35.0,17,37,48,48,14,23,37,110.0,1141.0,1031,339,534,873,2389.0,82,5.31,60,363,2326,9.4
23568,Rod Brind'Amour,2006-07,36.0,18,38,78,78,12,26,38,141.0,1668.0,1109,351,560,911,2530.0,82,5.14,57,348,2300,9.2
23569,Rod Brind'Amour,2008-09,38.0,19,70,78,78,31,39,70,198.0,1895.0,1187,382,599,981,2728.0,82,6.05,85,480,2458,10.1
23570,Rod Brind'Amour,2009-10,39.0,20,82,78,78,26,56,82,181.0,1819.0,1265,408,655,1063,2909.0,82,5.76,70,398,2426,9.7
23571,Rod Brind'Amour,2010-11,40.0,21,51,59,59,19,32,51,151.0,1325.0,1324,427,687,1114,3060.0,82,5.44,62,351,2383,9.4
23572,Rod Brind'Amour,2011-12,41.0,22,51,80,80,16,35,51,135.0,1518.0,1404,443,722,1165,3195.0,82,5.7,65,341,2477,9.4
23573,Rod Brind'Amour,2012-13,42.0,23,19,80,80,9,10,19,95.0,1017.0,1484,452,732,1184,3290.0,82,5.53,56,304,2486,9.1
23574,Rod Buskas,1985-86,25.0,4,4,41,41,2,2,4,27.0,,41,2,2,4,27.0,80,7.73,71,310,2444,12.7
23575,Rod Buskas,1986-87,26.0,5,6,47,47,2,4,6,39.0,,88,4,6,10,66.0,80,7.89,74,336,2448,12.9
23576,Rod Buskas,1987-88,27.0,6,9,69,69,2,7,9,53.0,,157,6,13,19,119.0,80,7.77,71,321,2447,12.7
23577,Rod Buskas,1988-89,28.0,7,9,72,72,2,7,9,49.0,,229,8,20,28,168.0,80,7.94,82,370,2484,12.8
23578,Rod Buskas,1989-90,29.0,8,18,68,68,3,15,18,91.0,,297,11,35,46,259.0,80,7.34,72,344,2400,12.2
23579,Rod Buskas,1990-91,30.0,9,12,76,76,4,8,12,53.0,,373,15,43,58,312.0,80,7.43,89,437,2435,12.2
23580,Rod Buskas,1991-92,31.0,10,6,52,52,1,5,6,15.0,,425,16,48,64,327.0,80,7.48,85,403,2430,12.3
23581,Rod Buskas,1992-93,32.0,11,3,23,23,0,3,3,12.0,,448,16,51,67,339.0,80,7.37,76,367,2421,12.2
23582,Rod Buskas,1993-94,33.0,12,11,57,57,3,8,11,60.0,,505,19,59,78,399.0,80,6.91,71,366,2385,11.6
23583,Rod Buskas,1994-95,34.0,13,4,47,47,0,4,4,23.0,,552,19,63,82,422.0,80,6.96,77,402,2440,11.4
23584,Rod Buskas,1995-96,35.0,14,0,4,4,0,0,0,3.0,,556,19,63,82,425.0,84,7.25,87,443,2603,11.7
23585,Rod Dallman,1990-91,24.0,4,1,3,3,1,0,1,2.0,,3,1,0,1,2.0,80,7.43,89,437,2435,12.2
23586,Rod Dallman,1991-92,25.0,5,0,1,1,0,0,0,1.0,,4,1,0,1,3.0,80,7.48,85,403,2430,12.3
23587,Rod Dallman,1994-95,28.0,6,0,2,2,0,0,0,2.0,,6,1,0,1,5.0,80,6.96,77,402,2440,11.4
23588,Rod Pelley,2009-10,25.0,4,0,9,9,0,0,0,8.0,99.0,9,0,0,0,8.0,82,5.76,70,398,2426,9.7
23589,Rod Pelley,2010-11,26.0,5,6,58,58,2,4,6,59.0,540.0,67,2,4,6,67.0,82,5.44,62,351,2383,9.4
23590,Rod Pelley,2012-13,28.0,6,10,63,63,2,8,10,74.0,496.0,130,4,12,16,141.0,82,5.53,56,304,2486,9.1
23591,Rod Pelley,2013-14,29.0,7,10,74,74,3,7,10,88.0,874.0,204,7,19,26,229.0,82,5.46,52,291,2492,9.0
23592,Rod Pelley,2014-15,30.0,8,3,52,52,2,1,3,44.0,403.0,256,9,20,29,273.0,82,5.32,47,271,2439,8.9
23593,Rod Willard,1985-86,25.0,4,0,1,1,0,0,0,2.0,,1,0,0,0,2.0,80,7.73,71,310,2444,12.7
23594,Roger Belanger,1987-88,22.0,4,8,44,44,3,5,8,65.0,,44,3,5,8,65.0,80,7.77,71,321,2447,12.7
23595,Roger Hagglund,1987-88,26.0,4,0,3,3,0,0,0,5.0,,3,0,0,0,5.0,80,7.77,71,321,2447,12.7
23596,Roger Johansson,1992-93,25.0,4,5,35,35,0,5,5,23.0,,35,0,5,5,23.0,80,7.37,76,367,2421,12.2
23597,Roger Johansson,1993-94,26.0,5,17,38,38,4,13,17,41.0,,73,4,18,22,64.0,80,6.91,71,366,2385,11.6
23598,Roger Johansson,1995-96,28.0,6,20,77,77,4,16,20,101.0,,150,8,34,42,165.0,84,7.25,87,443,2603,11.7
23599,Roger Johansson,1997-98,30.0,7,1,11,11,1,0,1,10.0,,161,9,34,43,175.0,48,5.97,37,209,1408,10.2
23600,Roger Kortko,1987-88,24.0,4,11,27,27,2,9,11,24.0,,27,2,9,11,24.0,80,7.77,71,321,2447,12.7
23601,Roger Kortko,1988-89,25.0,5,13,52,52,5,8,13,49.0,,79,7,17,24,73.0,80,7.94,82,370,2484,12.8
23602,Roger Melin,1983-84,27.0,4,0,1,1,0,0,0,1.0,,1,0,0,0,1.0,80,7.69,77,340,2441,12.6
23603,Roger Melin,1984-85,28.0,5,0,2,2,0,0,0,0.0,,3,0,0,0,1.0,80,8.03,73,320,2489,12.9
23604,Roland McKeown,2020-21,25.0,4,3,10,10,0,3,3,7.0,134.0,10,0,3,3,7.0,82,5.86,50,250,2620,9.2
23605,Roland Stoltz,1984-85,30.0,4,4,14,14,2,2,4,6.0,,14,2,2,4,6.0,80,8.03,73,320,2489,12.9
23606,Roman Cervenka,2015-16,30.0,4,17,39,39,9,8,17,51.0,512.0,39,9,8,17,51.0,48,5.31,29,160,1399,9.1
23607,Roman Hamrlik,1995-96,21.0,4,21,67,67,6,15,21,113.0,,67,6,15,21,113.0,84,7.25,87,443,2603,11.7
23608,Roman Hamrlik,1996-97,22.0,5,21,64,64,3,18,21,158.0,,131,9,33,42,271.0,84,6.48,76,407,2545,10.7
23609,Roman Hamrlik,1997-98,23.0,6,23,48,48,12,11,23,134.0,,179,21,44,65,405.0,48,5.97,37,209,1408,10.2
23610,Roman Hamrlik,1998-99,24.0,7,65,82,82,16,49,65,281.0,,261,37,93,130,686.0,82,6.29,74,413,2481,10.4
23611,Roman Hamrlik,1999-00,25.0,8,40,79,79,12,28,40,238.0,,340,49,121,170,924.0,82,5.83,55,336,2444,9.8
23612,Roman Hamrlik,2000-01,26.0,9,41,78,78,9,32,41,198.0,,418,58,153,211,1122.0,82,5.28,57,380,2242,9.6
23613,Roman Hamrlik,2001-02,27.0,10,32,75,75,8,24,32,172.0,1786.0,493,66,177,243,1294.0,82,5.27,57,359,2285,9.4
23614,Roman Hamrlik,2002-03,28.0,11,45,80,80,8,37,45,180.0,2023.0,573,74,214,288,1474.0,82,5.49,53,331,2294,9.8
23615,Roman Hamrlik,2003-04,29.0,12,46,76,76,16,30,46,232.0,1916.0,649,90,244,334,1706.0,82,5.51,63,376,2272,9.9
23616,Roman Hamrlik,2004-05,30.0,13,37,70,70,11,26,37,169.0,1787.0,719,101,270,371,1875.0,82,5.24,53,338,2262,9.5
23617,Roman Hamrlik,2005-06,31.0,14,41,73,73,9,32,41,151.0,1940.0,792,110,302,412,2026.0,82,5.31,60,363,2326,9.4
23618,Roman Hamrlik,2006-07,32.0,15,29,81,81,7,22,29,182.0,1991.0,873,117,324,441,2208.0,82,5.14,57,348,2300,9.2
23619,Roman Hamrlik,2008-09,34.0,16,26,51,51,7,19,26,89.0,1114.0,924,124,343,467,2297.0,82,6.05,85,480,2458,10.1
23620,Roman Hamrlik,2009-10,35.0,17,38,75,75,7,31,38,125.0,1865.0,999,131,374,505,2422.0,82,5.76,70,398,2426,9.7
23621,Roman Hamrlik,2010-11,36.0,18,26,77,77,5,21,26,129.0,1781.0,1076,136,395,531,2551.0,82,5.44,62,351,2383,9.4
23622,Roman Hamrlik,2011-12,37.0,19,33,81,81,6,27,33,143.0,1775.0,1157,142,422,564,2694.0,82,5.7,65,341,2477,9.4
23623,Roman Hamrlik,2012-13,38.0,20,26,75,75,6,20,26,100.0,1758.0,1232,148,442,590,2794.0,82,5.53,56,304,2486,9.1
23624,Roman Hamrlik,2013-14,39.0,21,34,79,79,5,29,34,129.0,1760.0,1311,153,471,624,2923.0,82,5.46,52,291,2492,9.0
23625,Roman Hamrlik,2014-15,40.0,22,13,68,68,2,11,13,58.0,1307.0,1379,155,482,637,2981.0,82,5.32,47,271,2439,8.9
23626,Roman Hamrlik,2015-16,41.0,23,1,16,16,0,1,1,7.0,184.0,1395,155,483,638,2988.0,48,5.31,29,160,1399,9.1
23627,Roman Horak,2014-15,23.0,4,11,61,61,3,8,11,53.0,622.0,61,3,8,11,53.0,82,5.32,47,271,2439,8.9
23628,Roman Horak,2015-16,24.0,5,7,20,20,2,5,7,28.0,291.0,81,5,13,18,81.0,48,5.31,29,160,1399,9.1
23629,Roman Horak,2016-17,25.0,6,1,3,3,1,0,1,2.0,28.0,84,6,13,19,83.0,82,5.34,48,269,2463,8.9
23630,Roman Josi,2014-15,24.0,4,16,52,52,5,11,16,64.0,956.0,52,5,11,16,64.0,82,5.32,47,271,2439,8.9
23631,Roman Josi,2015-16,25.0,5,18,48,48,5,13,18,96.0,1129.0,100,10,24,34,160.0,48,5.31,29,160,1399,9.1
23632,Roman Josi,2016-17,26.0,6,40,72,72,13,27,40,168.0,1902.0,172,23,51,74,328.0,82,5.34,48,269,2463,8.9
23633,Roman Josi,2017-18,27.0,7,55,81,81,15,40,55,201.0,2144.0,253,38,91,129,529.0,82,5.32,47,251,2453,8.9
23634,Roman Josi,2018-19,28.0,8,61,81,81,14,47,61,198.0,2064.0,334,52,138,190,727.0,82,5.34,48,255,2438,9.0
23635,Roman Josi,2019-20,29.0,9,49,72,72,12,37,49,217.0,1805.0,406,64,175,239,944.0,82,5.45,47,245,2478,9.0
23636,Roman Josi,2020-21,30.0,10,53,75,75,14,39,53,253.0,1835.0,481,78,214,292,1197.0,82,5.86,50,250,2620,9.2
23637,Roman Josi,2021-22,31.0,11,56,82,82,15,41,56,274.0,2064.0,563,93,255,348,1471.0,82,5.96,47,239,2579,9.5
23638,Roman Josi,2022-23,32.0,12,65,69,69,16,49,65,260.0,1779.0,632,109,304,413,1731.0,70,5.96,42,208,2192,9.5
23639,Roman Lyashenko,2002-03,23.0,4,12,58,58,6,6,12,51.0,634.0,58,6,6,12,51.0,82,5.49,53,331,2294,9.8
23640,Roman Lyashenko,2003-04,24.0,5,9,60,60,6,3,9,48.0,575.0,118,12,9,21,99.0,82,5.51,63,376,2272,9.9
23641,Roman Lyashenko,2004-05,25.0,6,2,19,19,2,0,2,16.0,148.0,137,14,9,23,115.0,82,5.24,53,338,2262,9.5
23642,Roman Lyashenko,2005-06,26.0,7,0,2,2,0,0,0,4.0,24.0,139,14,9,23,119.0,82,5.31,60,363,2326,9.4
23643,Roman Lyubimov,2019-20,28.0,4,6,47,47,4,2,6,41.0,450.0,47,4,2,6,41.0,82,5.45,47,245,2478,9.0
23644,Roman Oksiuta,1996-97,26.0,4,3,10,10,1,2,3,18.0,,10,1,2,3,18.0,84,6.48,76,407,2545,10.7
23645,Roman Oksiuta,1997-98,27.0,5,20,38,38,16,4,20,67.0,,48,17,6,23,85.0,48,5.97,37,209,1408,10.2
23646,Roman Oksiuta,1998-99,28.0,6,51,70,70,23,28,51,119.0,,118,40,34,74,204.0,82,6.29,74,413,2481,10.4
23647,Roman Oksiuta,1999-00,29.0,7,13,35,35,6,7,13,58.0,,153,46,41,87,262.0,82,5.83,55,336,2444,9.8
23648,Roman Polak,2009-10,23.0,4,0,19,19,0,0,0,13.0,259.0,19,0,0,0,13.0,82,5.76,70,398,2426,9.7
23649,Roman Polak,2010-11,24.0,5,1,6,6,0,1,1,2.0,69.0,25,0,1,1,15.0,82,5.44,62,351,2383,9.4
23650,Roman Polak,2011-12,25.0,6,15,69,69,1,14,15,73.0,1486.0,94,1,15,16,88.0,82,5.7,65,341,2477,9.4
23651,Roman Polak,2012-13,26.0,7,21,78,78,4,17,21,73.0,1558.0,172,5,32,37,161.0,82,5.53,56,304,2486,9.1
23652,Roman Polak,2013-14,27.0,8,12,55,55,3,9,12,54.0,1098.0,227,8,41,49,215.0,82,5.46,52,291,2492,9.0
23653,Roman Polak,2014-15,28.0,9,11,77,77,0,11,11,88.0,1453.0,304,8,52,60,303.0,82,5.32,47,271,2439,8.9
23654,Roman Polak,2015-16,29.0,10,6,48,48,1,5,6,39.0,884.0,352,9,57,66,342.0,48,5.31,29,160,1399,9.1
23655,Roman Polak,2016-17,30.0,11,13,72,72,4,9,13,83.0,1248.0,424,13,66,79,425.0,82,5.34,48,269,2463,8.9
23656,Roman Polak,2017-18,31.0,12,9,56,56,5,4,9,61.0,1181.0,480,18,70,88,486.0,82,5.32,47,251,2453,8.9
23657,Roman Polak,2018-19,32.0,13,16,79,79,1,15,16,91.0,1513.0,559,19,85,104,577.0,82,5.34,48,255,2438,9.0
23658,Roman Polak,2019-20,33.0,14,11,75,75,4,7,11,64.0,1344.0,634,23,92,115,641.0,82,5.45,47,245,2478,9.0
23659,Roman Polak,2020-21,34.0,15,12,54,54,2,10,12,47.0,953.0,688,25,102,127,688.0,82,5.86,50,250,2620,9.2
23660,Roman Polak,2021-22,35.0,16,9,77,77,1,8,9,77.0,1476.0,765,26,110,136,765.0,82,5.96,47,239,2579,9.5
23661,Roman Polak,2022-23,36.0,17,4,41,41,0,4,4,34.0,683.0,806,26,114,140,799.0,70,5.96,42,208,2192,9.5
23662,Roman Simicek,2003-04,32.0,4,15,57,57,5,10,15,33.0,629.0,57,5,10,15,33.0,82,5.51,63,376,2272,9.9
23663,Roman Simicek,2004-05,33.0,5,2,6,6,2,0,2,4.0,80.0,63,7,10,17,37.0,82,5.24,53,338,2262,9.5
23664,Roman Tvrdon,2006-07,26.0,4,1,9,9,0,1,1,7.0,96.0,9,0,1,1,7.0,82,5.14,57,348,2300,9.2
23665,Roman Vopat,1998-99,22.0,4,5,25,25,2,3,5,33.0,,25,2,3,5,33.0,82,6.29,74,413,2481,10.4
23666,Roman Vopat,1999-00,23.0,5,9,29,29,4,5,9,54.0,,54,6,8,14,87.0,82,5.83,55,336,2444,9.8
23667,Roman Vopat,2000-01,24.0,6,3,25,25,0,3,3,36.0,,79,6,11,17,123.0,82,5.28,57,380,2242,9.6
23668,Roman Vopat,2001-02,25.0,7,3,54,54,0,3,3,27.0,301.0,133,6,14,20,150.0,82,5.27,57,359,2285,9.4
23669,Roman Wick,2013-14,28.0,4,0,7,7,0,0,0,4.0,60.0,7,0,0,0,4.0,82,5.46,52,291,2492,9.0
23670,Ron Areshenkoff,1982-83,25.0,4,0,4,4,0,0,0,3.0,,4,0,0,0,3.0,80,7.03,61,280,2352,12.0
23671,Ron Carter,1982-83,24.0,4,0,2,2,0,0,0,0.0,,2,0,0,0,0.0,80,7.03,61,280,2352,12.0
23672,Ron Chipperfield,1982-83,28.0,4,45,79,79,22,23,45,155.0,,79,22,23,45,155.0,80,7.03,61,280,2352,12.0
23673,Ron Chipperfield,1983-84,29.0,5,1,4,4,0,1,1,0.0,,83,22,24,46,155.0,80,7.69,77,340,2441,12.6
23674,Ron Fischer,1984-85,25.0,4,7,15,15,0,7,7,16.0,,15,0,7,7,16.0,80,8.03,73,320,2489,12.9
23675,Ron Fischer,1985-86,26.0,5,0,3,3,0,0,0,1.0,,18,0,7,7,17.0,80,7.73,71,310,2444,12.7
23676,Ron Flockhart,1983-84,23.0,4,10,14,14,3,7,10,24.0,,14,3,7,10,24.0,80,7.69,77,340,2441,12.6
23677,Ron Flockhart,1984-85,24.0,5,72,72,72,33,39,72,240.0,,86,36,46,82,264.0,80,8.03,73,320,2489,12.9
23678,Ron Flockhart,1985-86,25.0,6,60,73,73,29,31,60,241.0,,159,65,77,142,505.0,80,7.73,71,310,2444,12.7
23679,Ron Flockhart,1986-87,26.0,7,48,76,76,27,21,48,214.0,,235,92,98,190,719.0,80,7.89,74,336,2448,12.9
23680,Ron Flockhart,1987-88,27.0,8,27,54,54,10,17,27,78.0,,289,102,115,217,797.0,80,7.77,71,321,2447,12.7
23681,Ron Flockhart,1988-89,28.0,9,67,79,79,22,45,67,199.0,,368,124,160,284,996.0,80,7.94,82,370,2484,12.8
23682,Ron Flockhart,1989-90,29.0,10,35,60,60,16,19,35,103.0,,428,140,179,319,1099.0,80,7.34,72,344,2400,12.2
23683,Ron Flockhart,1990-91,30.0,11,9,21,21,5,4,9,27.0,,449,145,183,328,1126.0,80,7.43,89,437,2435,12.2
23684,Ron Flockhart,1991-92,31.0,12,0,4,4,0,0,0,3.0,,453,145,183,328,1129.0,80,7.48,85,403,2430,12.3
23685,Ron Francis,1984-85,21.0,4,68,59,59,25,43,68,163.0,,59,25,43,68,163.0,80,8.03,73,320,2489,12.9
23686,Ron Francis,1985-86,22.0,5,90,79,79,31,59,90,210.0,,138,56,102,158,373.0,80,7.73,71,310,2444,12.7
23687,Ron Francis,1986-87,23.0,6,83,72,72,23,60,83,202.0,,210,79,162,241,575.0,80,7.89,74,336,2448,12.9
23688,Ron Francis,1987-88,24.0,7,81,80,80,24,57,81,199.0,,290,103,219,322,774.0,80,7.77,71,321,2447,12.7
23689,Ron Francis,1988-89,25.0,8,77,53,53,24,53,77,120.0,,343,127,272,399,894.0,80,7.94,82,370,2484,12.8
23690,Ron Francis,1989-90,26.0,9,93,75,75,30,63,93,189.0,,418,157,335,492,1083.0,80,7.34,72,344,2400,12.2
23691,Ron Francis,1990-91,27.0,10,75,80,80,25,50,75,172.0,,498,182,385,567,1255.0,80,7.43,89,437,2435,12.2
23692,Ron Francis,1991-92,28.0,11,77,69,69,29,48,77,156.0,,567,211,433,644,1411.0,80,7.48,85,403,2430,12.3
23693,Ron Francis,1992-93,29.0,12,101,80,80,32,69,101,170.0,,647,243,502,745,1581.0,80,7.37,76,367,2421,12.2
23694,Ron Francis,1993-94,30.0,13,87,81,81,23,64,87,174.0,,728,266,566,832,1755.0,80,6.91,71,366,2385,11.6
23695,Ron Francis,1994-95,31.0,14,54,70,70,21,33,54,121.0,,798,287,599,886,1876.0,80,6.96,77,402,2440,11.4
23696,Ron Francis,1995-96,32.0,15,100,84,84,24,76,100,215.0,,882,311,675,986,2091.0,84,7.25,87,443,2603,11.7
23697,Ron Francis,1996-97,33.0,16,93,82,82,27,66,93,216.0,,964,338,741,1079,2307.0,84,6.48,76,407,2545,10.7
23698,Ron Francis,1997-98,34.0,17,59,44,44,11,48,59,94.0,,1008,349,789,1138,2401.0,48,5.97,37,209,1408,10.2
23699,Ron Francis,1998-99,35.0,18,119,77,77,27,92,119,158.0,,1085,376,881,1257,2559.0,82,6.29,74,413,2481,10.4
23700,Ron Francis,1999-00,36.0,19,90,81,81,27,63,90,183.0,,1166,403,944,1347,2742.0,82,5.83,55,336,2444,9.8
23701,Ron Francis,2000-01,37.0,20,87,81,81,25,62,87,189.0,,1247,428,1006,1434,2931.0,82,5.28,57,380,2242,9.6
23702,Ron Francis,2001-02,38.0,21,52,82,82,21,31,52,133.0,1797.0,1329,449,1037,1486,3064.0,82,5.27,57,359,2285,9.4
23703,Ron Francis,2002-03,39.0,22,73,78,78,23,50,73,150.0,1714.0,1407,472,1087,1559,3214.0,82,5.49,53,331,2294,9.8
23704,Ron Francis,2003-04,40.0,23,65,82,82,15,50,65,130.0,1661.0,1489,487,1137,1624,3344.0,82,5.51,63,376,2272,9.9
23705,Ron Francis,2004-05,41.0,24,77,80,80,27,50,77,165.0,1655.0,1569,514,1187,1701,3509.0,82,5.24,53,338,2262,9.5
23706,Ron Francis,2005-06,42.0,25,57,82,82,22,35,57,156.0,1635.0,1651,536,1222,1758,3665.0,82,5.31,60,363,2326,9.4
23707,Ron Francis,2006-07,43.0,26,40,80,80,13,27,40,91.0,1266.0,1731,549,1249,1798,3756.0,82,5.14,57,348,2300,9.2
23708,Ron Friest,1983-84,25.0,4,1,4,4,1,0,1,6.0,,4,1,0,1,6.0,80,7.69,77,340,2441,12.6
23709,Ron Friest,1984-85,26.0,5,0,10,10,0,0,0,5.0,,14,1,0,1,11.0,80,8.03,73,320,2489,12.9
23710,Ron Friest,1985-86,27.0,6,13,50,50,6,7,13,44.0,,64,7,7,14,55.0,80,7.73,71,310,2444,12.7
23711,Ron Hainsey,2005-06,24.0,4,0,21,21,0,0,0,12.0,261.0,21,0,0,0,12.0,82,5.31,60,363,2326,9.4
23712,Ron Hainsey,2006-07,25.0,5,2,11,11,1,1,2,11.0,146.0,32,1,1,2,23.0,82,5.14,57,348,2300,9.2
23713,Ron Hainsey,2008-09,27.0,6,17,55,55,2,15,17,81.0,978.0,87,3,16,19,104.0,82,6.05,85,480,2458,10.1
23714,Ron Hainsey,2009-10,28.0,7,34,80,80,9,25,34,136.0,1831.0,167,12,41,53,240.0,82,5.76,70,398,2426,9.7
23715,Ron Hainsey,2010-11,29.0,8,32,78,78,8,24,32,161.0,1760.0,245,20,65,85,401.0,82,5.44,62,351,2383,9.4
23716,Ron Hainsey,2011-12,30.0,9,39,81,81,6,33,39,148.0,1812.0,326,26,98,124,549.0,82,5.7,65,341,2477,9.4
23717,Ron Hainsey,2012-13,31.0,10,26,80,80,5,21,26,121.0,1771.0,406,31,119,150,670.0,82,5.53,56,304,2486,9.1
23718,Ron Hainsey,2013-14,32.0,11,19,82,82,3,16,19,83.0,1483.0,488,34,135,169,753.0,82,5.46,52,291,2492,9.0
23719,Ron Hainsey,2014-15,33.0,12,10,56,56,0,10,10,57.0,1181.0,544,34,145,179,810.0,82,5.32,47,271,2439,8.9
23720,Ron Hainsey,2015-16,34.0,13,13,47,47,0,13,13,52.0,1074.0,591,34,158,192,862.0,48,5.31,29,160,1399,9.1
23721,Ron Hainsey,2016-17,35.0,14,15,82,82,4,11,15,72.0,1758.0,673,38,169,207,934.0,82,5.34,48,269,2463,8.9
23722,Ron Hainsey,2017-18,36.0,15,10,81,81,2,8,10,83.0,1709.0,754,40,177,217,1017.0,82,5.32,47,251,2453,8.9
23723,Ron Hainsey,2018-19,37.0,16,19,81,81,5,14,19,131.0,1808.0,835,45,191,236,1148.0,82,5.34,48,255,2438,9.0
23724,Ron Hainsey,2019-20,38.0,17,17,72,72,4,13,17,71.0,1586.0,907,49,204,253,1219.0,82,5.45,47,245,2478,9.0
23725,Ron Hainsey,2020-21,39.0,18,23,80,80,4,19,23,73.0,1749.0,987,53,223,276,1292.0,82,5.86,50,250,2620,9.2
23726,Ron Hainsey,2021-22,40.0,19,23,81,81,5,18,23,81.0,1641.0,1068,58,241,299,1373.0,82,5.96,47,239,2579,9.5
23727,Ron Hainsey,2022-23,41.0,20,12,64,64,1,11,12,43.0,1324.0,1132,59,252,311,1416.0,70,5.96,42,208,2192,9.5
23728,Ron Handy,1987-88,25.0,4,2,10,10,0,2,2,6.0,,10,0,2,2,6.0,80,7.77,71,321,2447,12.7
23729,Ron Handy,1990-91,28.0,5,1,4,4,0,1,1,4.0,,14,0,3,3,10.0,80,7.43,89,437,2435,12.2
23730,Ron Hoover,1992-93,26.0,4,0,2,2,0,0,0,2.0,,2,0,0,0,2.0,80,7.37,76,367,2421,12.2
23731,Ron Hoover,1993-94,27.0,5,4,15,15,4,0,4,17.0,,17,4,0,4,19.0,80,6.91,71,366,2385,11.6
23732,Ron Hoover,1994-95,28.0,6,0,1,1,0,0,0,1.0,,18,4,0,4,20.0,80,6.96,77,402,2440,11.4
23733,Ron Meighan,1984-85,21.0,4,2,7,7,1,1,2,4.0,,7,1,1,2,4.0,80,8.03,73,320,2489,12.9
23734,Ron Meighan,1985-86,22.0,5,8,41,41,2,6,8,48.0,,48,3,7,10,52.0,80,7.73,71,310,2444,12.7
23735,Ron Plumb,1982-83,32.0,4,7,26,26,3,4,7,38.0,,26,3,4,7,38.0,80,7.03,61,280,2352,12.0
23736,Ron Shudra,1990-91,23.0,4,5,10,10,0,5,5,8.0,,10,0,5,5,8.0,80,7.43,89,437,2435,12.2
23737,Ron Stern,1990-91,24.0,4,0,15,15,0,0,0,7.0,,15,0,0,0,7.0,80,7.43,89,437,2435,12.2
23738,Ron Stern,1991-92,25.0,5,1,17,17,1,0,1,13.0,,32,1,0,1,20.0,80,7.48,85,403,2430,12.3
23739,Ron Stern,1992-93,26.0,6,5,34,34,2,3,5,27.0,,66,3,3,6,47.0,80,7.37,76,367,2421,12.2
23740,Ron Stern,1993-94,27.0,7,9,44,44,3,6,9,45.0,,110,6,9,15,92.0,80,6.91,71,366,2385,11.6
23741,Ron Stern,1994-95,28.0,8,22,72,72,13,9,22,96.0,,182,19,18,37,188.0,80,6.96,77,402,2440,11.4
23742,Ron Stern,1995-96,29.0,9,25,70,70,10,15,25,82.0,,252,29,33,62,270.0,84,7.25,87,443,2603,11.7
23743,Ron Stern,1996-97,30.0,10,29,71,71,9,20,29,105.0,,323,38,53,91,375.0,84,6.48,76,407,2545,10.7
23744,Ron Stern,1997-98,31.0,11,13,39,39,9,4,13,69.0,,362,47,57,104,444.0,48,5.97,37,209,1408,10.2
23745,Ron Stern,1998-99,32.0,12,15,52,52,10,5,15,64.0,,414,57,62,119,508.0,82,6.29,74,413,2481,10.4
23746,Ron Stern,1999-00,33.0,13,17,79,79,7,10,17,98.0,,493,64,72,136,606.0,82,5.83,55,336,2444,9.8
23747,Ron Stern,2001-02,35.0,14,16,78,78,7,9,16,94.0,906.0,571,71,81,152,700.0,82,5.27,57,359,2285,9.4
23748,Ron Stern,2002-03,36.0,15,9,67,67,4,5,9,63.0,611.0,638,75,86,161,763.0,82,5.49,53,331,2294,9.8
23749,Ron Sutter,1985-86,22.0,4,2,10,10,1,1,2,4.0,,10,1,1,2,4.0,80,7.73,71,310,2444,12.7
23750,Ron Sutter,1986-87,23.0,5,51,79,79,19,32,51,146.0,,89,20,33,53,150.0,80,7.89,74,336,2448,12.9
23751,Ron Sutter,1987-88,24.0,6,45,73,73,16,29,45,144.0,,162,36,62,98,294.0,80,7.77,71,321,2447,12.7
23752,Ron Sutter,1988-89,25.0,7,60,75,75,18,42,60,146.0,,237,54,104,158,440.0,80,7.94,82,370,2484,12.8
23753,Ron Sutter,1989-90,26.0,8,28,39,39,10,18,28,68.0,,276,64,122,186,508.0,80,7.34,72,344,2400,12.2
23754,Ron Sutter,1990-91,27.0,9,33,69,69,8,25,33,107.0,,345,72,147,219,615.0,80,7.43,89,437,2435,12.2
23755,Ron Sutter,1991-92,28.0,10,48,55,55,26,22,48,106.0,,400,98,169,267,721.0,80,7.48,85,403,2430,12.3
23756,Ron Sutter,1992-93,29.0,11,48,75,75,22,26,48,157.0,,475,120,195,315,878.0,80,7.37,76,367,2421,12.2
23757,Ron Sutter,1993-94,30.0,12,45,80,80,17,28,45,149.0,,555,137,223,360,1027.0,80,6.91,71,366,2385,11.6
23758,Ron Sutter,1994-95,31.0,13,46,68,68,19,27,46,106.0,,623,156,250,406,1133.0,80,6.96,77,402,2440,11.4
23759,Ron Sutter,1995-96,32.0,14,27,59,59,12,15,27,90.0,,682,168,265,433,1223.0,84,7.25,87,443,2603,11.7
23760,Ron Sutter,1996-97,33.0,15,40,73,73,15,25,40,108.0,,755,183,290,473,1331.0,84,6.48,76,407,2545,10.7
23761,Ron Sutter,1997-98,34.0,16,5,27,27,1,4,5,29.0,,782,184,294,478,1360.0,48,5.97,37,209,1408,10.2
23762,Ron Sutter,1998-99,35.0,17,12,18,18,5,7,12,34.0,,800,189,301,490,1394.0,82,6.29,74,413,2481,10.4
23763,Ron Sutter,1999-00,36.0,18,12,78,78,5,7,12,78.0,,878,194,308,502,1472.0,82,5.83,55,336,2444,9.8
23764,Ron Sutter,2000-01,37.0,19,9,57,57,2,7,9,57.0,,935,196,315,511,1529.0,82,5.28,57,380,2242,9.6
23765,Ron Sutter,2001-02,38.0,20,9,59,59,3,6,9,67.0,584.0,994,199,321,520,1596.0,82,5.27,57,359,2285,9.4
23766,Ron Sutter,2002-03,39.0,21,11,78,78,5,6,11,68.0,746.0,1072,204,327,531,1664.0,82,5.49,53,331,2294,9.8
23767,Ron Sutter,2003-04,40.0,22,4,21,21,1,3,4,16.0,248.0,1093,205,330,535,1680.0,82,5.51,63,376,2272,9.9
23768,Ron Talakoski,1989-90,27.0,4,0,3,3,0,0,0,1.0,,3,0,0,0,1.0,80,7.34,72,344,2400,12.2
23769,Ron Talakoski,1990-91,28.0,5,1,6,6,0,1,1,6.0,,9,0,1,1,7.0,80,7.43,89,437,2435,12.2
23770,Ron Wilson,1982-83,26.0,4,57,79,79,21,36,57,176.0,,79,21,36,57,176.0,80,7.03,61,280,2352,12.0
23771,Ron Wilson,1983-84,27.0,5,51,77,77,18,33,51,192.0,,156,39,69,108,368.0,80,7.69,77,340,2441,12.6
23772,Ron Wilson,1984-85,28.0,6,16,39,39,3,13,16,53.0,,195,42,82,124,421.0,80,8.03,73,320,2489,12.9
23773,Ron Wilson,1985-86,29.0,7,9,12,12,6,3,9,20.0,,207,48,85,133,441.0,80,7.73,71,310,2444,12.7
23774,Ron Wilson,1986-87,30.0,8,15,51,51,3,12,15,51.0,,258,51,97,148,492.0,80,7.89,74,336,2448,12.9
23775,Ron Wilson,1987-88,31.0,9,19,74,74,10,9,19,65.0,,332,61,106,167,557.0,80,7.77,71,321,2447,12.7
23776,Ron Wilson,1988-89,32.0,10,13,54,54,6,7,13,64.0,,386,67,113,180,621.0,80,7.94,82,370,2484,12.8
23777,Ron Wilson,1989-90,33.0,11,16,80,80,3,13,16,75.0,,466,70,126,196,696.0,80,7.34,72,344,2400,12.2
23778,Ron Wilson,1990-91,34.0,12,13,69,69,5,8,13,80.0,,535,75,134,209,776.0,80,7.43,89,437,2435,12.2
23779,Ron Wilson,1992-93,36.0,13,20,33,33,3,17,20,40.0,,568,78,151,229,816.0,80,7.37,76,367,2421,12.2
23780,Ron Wilson,1993-94,37.0,14,37,73,73,10,27,37,101.0,,641,88,178,266,917.0,80,6.91,71,366,2385,11.6
23781,Ron Wilson,1994-95,38.0,15,29,64,64,12,17,29,100.0,,705,100,195,295,1017.0,80,6.96,77,402,2440,11.4
23782,Ron Wilson,1995-96,39.0,16,19,78,78,8,11,19,75.0,,783,108,206,314,1092.0,84,7.25,87,443,2603,11.7
23783,Ron Wilson,1996-97,40.0,17,12,48,48,2,10,12,39.0,,831,110,216,326,1131.0,84,6.48,76,407,2545,10.7
23784,Ronald Petrovicky,2003-04,26.0,4,9,30,30,4,5,9,30.0,346.0,30,4,5,9,30.0,82,5.51,63,376,2272,9.9
23785,Ronald Petrovicky,2004-05,27.0,5,12,77,77,5,7,12,78.0,900.0,107,9,12,21,108.0,82,5.24,53,338,2262,9.5
23786,Ronald Petrovicky,2005-06,28.0,6,14,66,66,5,9,14,65.0,820.0,173,14,21,35,173.0,82,5.31,60,363,2326,9.4
23787,Ronald Petrovicky,2006-07,29.0,7,31,78,78,16,15,31,102.0,1113.0,251,30,36,66,275.0,82,5.14,57,348,2300,9.2
23788,Ronald Petrovicky,2008-09,31.0,8,20,60,60,8,12,20,70.0,713.0,311,38,48,86,345.0,82,6.05,85,480,2458,10.1
23789,Ronald Petrovicky,2009-10,32.0,9,6,31,31,3,3,6,27.0,259.0,342,41,51,92,372.0,82,5.76,70,398,2426,9.7
23790,Ronalds Kenins,2017-18,26.0,4,12,30,30,4,8,12,38.0,368.0,30,4,8,12,38.0,82,5.32,47,251,2453,8.9
23791,Ronalds Kenins,2018-19,27.0,5,0,8,8,0,0,0,6.0,91.0,38,4,8,12,44.0,82,5.34,48,255,2438,9.0
23792,Ronnie Sundin,2000-01,30.0,4,0,1,1,0,0,0,0.0,,1,0,0,0,0.0,82,5.28,57,380,2242,9.6
23793,Roope Hintz,2021-22,25.0,4,22,58,58,9,13,22,99.0,815.0,58,9,13,22,99.0,82,5.96,47,239,2579,9.5
23794,Roope Hintz,2022-23,26.0,5,33,60,60,19,14,33,120.0,885.0,118,28,27,55,219.0,70,5.96,42,208,2192,9.5
23795,Rory Fitzpatrick,1998-99,24.0,4,2,42,42,0,2,2,31.0,,42,0,2,2,31.0,82,6.29,74,413,2481,10.4
23796,Rory Fitzpatrick,1999-00,25.0,5,1,8,8,0,1,1,6.0,,50,0,3,3,37.0,82,5.83,55,336,2444,9.8
23797,Rory Fitzpatrick,2001-02,27.0,6,0,1,1,0,0,0,0.0,5.0,51,0,3,3,37.0,82,5.27,57,359,2285,9.4
23798,Rory Fitzpatrick,2003-04,29.0,7,0,2,2,0,0,0,0.0,20.0,53,0,3,3,37.0,82,5.51,63,376,2272,9.9
23799,Rory Fitzpatrick,2004-05,30.0,8,0,5,5,0,0,0,2.0,60.0,58,0,3,3,39.0,82,5.24,53,338,2262,9.5
23800,Rory Fitzpatrick,2005-06,31.0,9,4,36,36,1,3,4,29.0,613.0,94,1,6,7,68.0,82,5.31,60,363,2326,9.4
23801,Rory Fitzpatrick,2006-07,32.0,10,11,60,60,4,7,11,78.0,1142.0,154,5,13,18,146.0,82,5.14,57,348,2300,9.2
23802,Rory Fitzpatrick,2008-09,34.0,11,9,56,56,4,5,9,45.0,916.0,210,9,18,27,191.0,82,6.05,85,480,2458,10.1
23803,Rory Fitzpatrick,2009-10,35.0,12,7,58,58,1,6,7,41.0,817.0,268,10,24,34,232.0,82,5.76,70,398,2426,9.7
23804,Rory Fitzpatrick,2010-11,36.0,13,1,19,19,0,1,1,10.0,242.0,287,10,25,35,242.0,82,5.44,62,351,2383,9.4
23805,Ross Cory,1982-83,25.0,4,11,46,46,2,9,11,47.0,,46,2,9,11,47.0,80,7.03,61,280,2352,12.0
23806,Ross Cory,1983-84,26.0,5,1,5,5,0,1,1,1.0,,51,2,10,12,48.0,80,7.69,77,340,2441,12.6
23807,Ross Fitzpatrick,1985-86,25.0,4,0,1,1,0,0,0,3.0,,1,0,0,0,3.0,80,7.73,71,310,2444,12.7
23808,Ross Fitzpatrick,1986-87,26.0,5,6,12,12,4,2,6,21.0,,13,4,2,6,24.0,80,7.89,74,336,2448,12.9
23809,Ross Fitzpatrick,1987-88,27.0,6,1,5,5,1,0,1,10.0,,18,5,2,7,34.0,80,7.77,71,321,2447,12.7
23810,Ross Fitzpatrick,1988-89,28.0,7,0,2,2,0,0,0,0.0,,20,5,2,7,34.0,80,7.94,82,370,2484,12.8
23811,Ross Johnston,2018-19,24.0,4,0,1,1,0,0,0,0.0,16.0,1,0,0,0,0.0,82,5.34,48,255,2438,9.0
23812,Ross Johnston,2020-21,26.0,5,6,24,24,3,3,6,19.0,224.0,25,3,3,6,19.0,82,5.86,50,250,2620,9.2
23813,Ross Johnston,2021-22,27.0,6,4,17,17,1,3,4,12.0,135.0,42,4,6,10,31.0,82,5.96,47,239,2579,9.5
23814,Ross Johnston,2022-23,28.0,7,4,32,32,3,1,4,16.0,256.0,74,7,7,14,47.0,70,5.96,42,208,2192,9.5
23815,Ross Lupaschuk,2005-06,25.0,4,0,3,3,0,0,0,3.0,49.0,3,0,0,0,3.0,82,5.31,60,363,2326,9.4
23816,Ross Yates,1986-87,27.0,4,2,7,7,1,1,2,6.0,,7,1,1,2,6.0,80,7.89,74,336,2448,12.9
23817,Rostislav Klesla,2003-04,21.0,4,2,8,8,2,0,2,10.0,147.0,8,2,0,2,10.0,82,5.51,63,376,2272,9.9
23818,Rostislav Klesla,2004-05,22.0,5,16,75,75,8,8,16,102.0,1415.0,83,10,8,18,112.0,82,5.24,53,338,2262,9.5
23819,Rostislav Klesla,2005-06,23.0,6,16,72,72,2,14,16,89.0,1350.0,155,12,22,34,201.0,82,5.31,60,363,2326,9.4
23820,Rostislav Klesla,2006-07,24.0,7,13,47,47,2,11,13,74.0,861.0,202,14,33,47,275.0,82,5.14,57,348,2300,9.2
23821,Rostislav Klesla,2008-09,26.0,8,19,51,51,6,13,19,84.0,1094.0,253,20,46,66,359.0,82,6.05,85,480,2458,10.1
23822,Rostislav Klesla,2009-10,27.0,9,22,75,75,9,13,22,159.0,1718.0,328,29,59,88,518.0,82,5.76,70,398,2426,9.7
23823,Rostislav Klesla,2010-11,28.0,10,18,82,82,6,12,18,130.0,1903.0,410,35,71,106,648.0,82,5.44,62,351,2383,9.4
23824,Rostislav Klesla,2011-12,29.0,11,9,34,34,1,8,9,30.0,713.0,444,36,79,115,678.0,82,5.7,65,341,2477,9.4
23825,Rostislav Klesla,2012-13,30.0,12,8,26,26,2,6,8,24.0,523.0,470,38,85,123,702.0,82,5.53,56,304,2486,9.1
23826,Rostislav Klesla,2013-14,31.0,13,11,61,61,4,7,11,67.0,1164.0,531,42,92,134,769.0,82,5.46,52,291,2492,9.0
23827,Rostislav Klesla,2014-15,32.0,14,13,65,65,3,10,13,87.0,1258.0,596,45,102,147,856.0,82,5.32,47,271,2439,8.9
23828,Rostislav Klesla,2015-16,33.0,15,8,38,38,2,6,8,44.0,670.0,634,47,108,155,900.0,48,5.31,29,160,1399,9.1
23829,Rostislav Klesla,2016-17,34.0,16,4,25,25,1,3,4,22.0,388.0,659,48,111,159,922.0,82,5.34,48,269,2463,8.9
23830,Rostislav Olesz,2008-09,23.0,4,21,59,59,8,13,21,105.0,877.0,59,8,13,21,105.0,82,6.05,85,480,2458,10.1
23831,Rostislav Olesz,2009-10,24.0,5,30,75,75,11,19,30,164.0,1163.0,134,19,32,51,269.0,82,5.76,70,398,2426,9.7
23832,Rostislav Olesz,2010-11,25.0,6,26,56,56,14,12,26,139.0,956.0,190,33,44,77,408.0,82,5.44,62,351,2383,9.4
23833,Rostislav Olesz,2011-12,26.0,7,9,37,37,4,5,9,69.0,488.0,227,37,49,86,477.0,82,5.7,65,341,2477,9.4
23834,Rostislav Olesz,2012-13,27.0,8,29,78,78,14,15,29,178.0,1201.0,305,51,64,115,655.0,82,5.53,56,304,2486,9.1
23835,Rostislav Olesz,2013-14,28.0,9,17,44,44,6,11,17,71.0,611.0,349,57,75,132,726.0,82,5.46,52,291,2492,9.0
23836,Rostislav Olesz,2014-15,29.0,10,0,6,6,0,0,0,6.0,55.0,355,57,75,132,732.0,82,5.32,47,271,2439,8.9
23837,Rostislav Olesz,2016-17,31.0,11,2,10,10,0,2,2,9.0,114.0,365,57,77,134,741.0,82,5.34,48,269,2463,8.9
23838,Rourke Chartier,2021-22,25.0,4,1,13,13,1,0,1,19.0,122.0,13,1,0,1,19.0,82,5.96,47,239,2579,9.5
23839,Roy Mitchell,1995-96,26.0,4,0,3,3,0,0,0,0.0,,3,0,0,0,0.0,84,7.25,87,443,2603,11.7
23840,Roy Sommer,1983-84,26.0,4,1,3,3,1,0,1,1.0,,3,1,0,1,1.0,80,7.69,77,340,2441,12.6
23841,Rudolfs Balcers,2021-22,24.0,4,14,36,36,5,9,14,48.0,445.0,36,5,9,14,48.0,82,5.96,47,239,2579,9.5
23842,Rudolfs Balcers,2022-23,25.0,5,3,15,15,1,2,3,23.0,182.0,51,6,11,17,71.0,70,5.96,42,208,2192,9.5
23843,Rudy Poeschek,1990-91,24.0,4,0,1,1,0,0,0,1.0,,1,0,0,0,1.0,80,7.43,89,437,2435,12.2
23844,Rudy Poeschek,1991-92,25.0,5,2,52,52,0,2,2,17.0,,53,0,2,2,18.0,80,7.48,85,403,2430,12.3
23845,Rudy Poeschek,1992-93,26.0,6,0,15,15,0,0,0,1.0,,68,0,2,2,19.0,80,7.37,76,367,2421,12.2
23846,Rudy Poeschek,1993-94,27.0,7,0,1,1,0,0,0,0.0,,69,0,2,2,19.0,80,6.91,71,366,2385,11.6
23847,Rudy Poeschek,1994-95,28.0,8,0,4,4,0,0,0,1.0,,73,0,2,2,20.0,80,6.96,77,402,2440,11.4
23848,Rudy Poeschek,1996-97,30.0,9,9,71,71,3,6,9,46.0,,144,3,8,11,66.0,84,6.48,76,407,2545,10.7
23849,Rudy Poeschek,1997-98,31.0,10,2,25,25,1,1,2,14.0,,169,4,9,13,80.0,48,5.97,37,209,1408,10.2
23850,Rudy Poeschek,1998-99,32.0,11,4,57,57,1,3,4,36.0,,226,5,12,17,116.0,82,6.29,74,413,2481,10.4
23851,Rudy Poeschek,1999-00,33.0,12,6,60,60,0,6,6,30.0,,286,5,18,23,146.0,82,5.83,55,336,2444,9.8
23852,Rudy Poeschek,2000-01,34.0,13,8,50,50,1,7,8,29.0,,336,6,25,31,175.0,82,5.28,57,380,2242,9.6
23853,Rudy Poeschek,2001-02,35.0,14,0,16,16,0,0,0,8.0,164.0,352,6,25,31,183.0,82,5.27,57,359,2285,9.4
23854,Rudy Poeschek,2002-03,36.0,15,0,12,12,0,0,0,8.0,135.0,364,6,25,31,191.0,82,5.49,53,331,2294,9.8
23855,Rumun Ndur,1999-00,24.0,4,0,2,2,0,0,0,0.0,,2,0,0,0,0.0,82,5.83,55,336,2444,9.8
23856,Rumun Ndur,2000-01,25.0,5,0,1,1,0,0,0,0.0,,3,0,0,0,0.0,82,5.28,57,380,2242,9.6
23857,Rumun Ndur,2001-02,26.0,6,4,39,39,1,3,4,22.0,459.0,42,1,3,4,22.0,82,5.27,57,359,2285,9.4
23858,Rumun Ndur,2002-03,27.0,7,1,27,27,1,0,1,6.0,356.0,69,2,3,5,28.0,82,5.49,53,331,2294,9.8
23859,Ruslan Batyrshin,1998-99,23.0,4,0,2,2,0,0,0,0.0,,2,0,0,0,0.0,82,6.29,74,413,2481,10.4
23860,Ruslan Fedotenko,2003-04,25.0,4,36,74,74,16,20,36,119.0,1082.0,74,16,20,36,119.0,82,5.51,63,376,2272,9.9
23861,Ruslan Fedotenko,2004-05,26.0,5,26,78,78,17,9,26,121.0,1087.0,152,33,29,62,240.0,82,5.24,53,338,2262,9.5
23862,Ruslan Fedotenko,2005-06,27.0,6,32,76,76,19,13,32,114.0,1217.0,228,52,42,94,354.0,82,5.31,60,363,2326,9.4
23863,Ruslan Fedotenko,2006-07,28.0,7,39,77,77,17,22,39,116.0,1128.0,305,69,64,133,470.0,82,5.14,57,348,2300,9.2
23864,Ruslan Fedotenko,2008-09,30.0,8,41,80,80,26,15,41,164.0,1228.0,385,95,79,174,634.0,82,6.05,85,480,2458,10.1
23865,Ruslan Fedotenko,2009-10,31.0,9,32,80,80,12,20,32,154.0,1301.0,465,107,99,206,788.0,82,5.76,70,398,2426,9.7
23866,Ruslan Fedotenko,2010-11,32.0,10,33,67,67,16,17,33,121.0,1119.0,532,123,116,239,909.0,82,5.44,62,351,2383,9.4
23867,Ruslan Fedotenko,2011-12,33.0,11,39,65,65,16,23,39,117.0,917.0,597,139,139,278,1026.0,82,5.7,65,341,2477,9.4
23868,Ruslan Fedotenko,2012-13,34.0,12,30,80,80,11,19,30,158.0,1172.0,677,150,158,308,1184.0,82,5.53,56,304,2486,9.1
23869,Ruslan Fedotenko,2013-14,35.0,13,25,66,66,10,15,25,120.0,990.0,743,160,173,333,1304.0,82,5.46,52,291,2492,9.0
23870,Ruslan Fedotenko,2014-15,36.0,14,20,73,73,9,11,20,94.0,993.0,816,169,184,353,1398.0,82,5.32,47,271,2439,8.9
23871,Ruslan Fedotenko,2015-16,37.0,15,13,47,47,4,9,13,43.0,591.0,863,173,193,366,1441.0,48,5.31,29,160,1399,9.1
23872,Ruslan Salei,1999-00,25.0,4,1,30,30,0,1,1,14.0,,30,0,1,1,14.0,82,5.83,55,336,2444,9.8
23873,Ruslan Salei,2000-01,26.0,5,15,66,66,5,10,15,104.0,,96,5,11,16,118.0,82,5.28,57,380,2242,9.6
23874,Ruslan Salei,2001-02,27.0,6,16,74,74,2,14,16,123.0,1632.0,170,7,25,32,241.0,82,5.27,57,359,2285,9.4
23875,Ruslan Salei,2002-03,28.0,7,10,71,71,5,5,10,116.0,1444.0,241,12,30,42,357.0,82,5.49,53,331,2294,9.8
23876,Ruslan Salei,2003-04,29.0,8,6,50,50,1,5,6,73.0,1033.0,291,13,35,48,430.0,82,5.51,63,376,2272,9.9
23877,Ruslan Salei,2004-05,30.0,9,11,82,82,4,7,11,96.0,1757.0,373,17,42,59,526.0,82,5.24,53,338,2262,9.5
23878,Ruslan Salei,2005-06,31.0,10,12,61,61,4,8,12,93.0,1335.0,434,21,50,71,619.0,82,5.31,60,363,2326,9.4
23879,Ruslan Salei,2006-07,32.0,11,15,82,82,4,11,15,145.0,1943.0,516,25,61,86,764.0,82,5.14,57,348,2300,9.2
23880,Ruslan Salei,2008-09,34.0,12,19,78,78,1,18,19,108.0,1756.0,594,26,79,105,872.0,82,6.05,85,480,2458,10.1
23881,Ruslan Salei,2009-10,35.0,13,32,82,82,6,26,32,148.0,1913.0,676,32,105,137,1020.0,82,5.76,70,398,2426,9.7
23882,Ruslan Salei,2010-11,36.0,14,30,82,82,6,24,30,111.0,1841.0,758,38,129,167,1131.0,82,5.44,62,351,2383,9.4
23883,Ruslan Salei,2011-12,37.0,15,21,70,70,4,17,21,93.0,1477.0,828,42,146,188,1224.0,82,5.7,65,341,2477,9.4
23884,Ruslan Salei,2012-13,38.0,16,6,14,14,1,5,6,22.0,263.0,842,43,151,194,1246.0,82,5.53,56,304,2486,9.1
23885,Ruslan Salei,2013-14,39.0,17,10,75,75,2,8,10,75.0,1347.0,917,45,159,204,1321.0,82,5.46,52,291,2492,9.0
23886,Russ Adam,1985-86,24.0,4,3,8,8,1,2,3,4.0,,8,1,2,3,4.0,80,7.73,71,310,2444,12.7
23887,Russ Courtnall,1986-87,21.0,4,12,14,14,3,9,12,30.0,,14,3,9,12,30.0,80,7.89,74,336,2448,12.9
23888,Russ Courtnall,1987-88,22.0,5,22,69,69,12,10,22,119.0,,83,15,19,34,149.0,80,7.77,71,321,2447,12.7
23889,Russ Courtnall,1988-89,23.0,6,60,73,73,22,38,60,204.0,,156,37,57,94,353.0,80,7.94,82,370,2484,12.8
23890,Russ Courtnall,1989-90,24.0,7,73,79,79,29,44,73,282.0,,235,66,101,167,635.0,80,7.34,72,344,2400,12.2
23891,Russ Courtnall,1990-91,25.0,8,49,65,65,23,26,49,212.0,,300,89,127,216,847.0,80,7.43,89,437,2435,12.2
23892,Russ Courtnall,1991-92,26.0,9,41,73,73,23,18,41,147.0,,373,112,145,257,994.0,80,7.48,85,403,2430,12.3
23893,Russ Courtnall,1992-93,27.0,10,59,80,80,27,32,59,294.0,,453,139,177,316,1288.0,80,7.37,76,367,2421,12.2
23894,Russ Courtnall,1993-94,28.0,11,76,79,79,26,50,76,279.0,,532,165,227,392,1567.0,80,6.91,71,366,2385,11.6
23895,Russ Courtnall,1994-95,29.0,12,21,27,27,7,14,21,63.0,,559,172,241,413,1630.0,80,6.96,77,402,2440,11.4
23896,Russ Courtnall,1995-96,30.0,13,79,84,84,36,43,79,294.0,,643,208,284,492,1924.0,84,7.25,87,443,2603,11.7
23897,Russ Courtnall,1996-97,31.0,14,80,84,84,23,57,80,231.0,,727,231,341,572,2155.0,84,6.48,76,407,2545,10.7
23898,Russ Courtnall,1997-98,32.0,15,35,45,45,11,24,35,132.0,,772,242,365,607,2287.0,48,5.97,37,209,1408,10.2
23899,Russ Courtnall,1998-99,33.0,16,65,81,81,26,39,65,205.0,,853,268,404,672,2492.0,82,6.29,74,413,2481,10.4
23900,Russ Courtnall,1999-00,34.0,17,35,61,61,11,24,35,125.0,,914,279,428,707,2617.0,82,5.83,55,336,2444,9.8
23901,Russ Courtnall,2000-01,35.0,18,18,58,58,12,6,18,97.0,,972,291,434,725,2714.0,82,5.28,57,380,2242,9.6
23902,Russ Courtnall,2001-02,36.0,19,19,57,57,6,13,19,77.0,858.0,1029,297,447,744,2791.0,82,5.27,57,359,2285,9.4
23903,Russell Romaniuk,1994-95,24.0,4,8,27,27,3,5,8,32.0,,27,3,5,8,32.0,80,6.96,77,402,2440,11.4
23904,Russell Romaniuk,1995-96,25.0,5,4,28,28,3,1,4,20.0,,55,6,6,12,52.0,84,7.25,87,443,2603,11.7
23905,Russell Romaniuk,1996-97,26.0,6,12,24,24,4,8,12,36.0,,79,10,14,24,88.0,84,6.48,76,407,2545,10.7
23906,Russell Romaniuk,1997-98,27.0,7,0,6,6,0,0,0,3.0,,85,10,14,24,91.0,48,5.97,37,209,1408,10.2
23907,Russell Romaniuk,1998-99,28.0,8,3,17,17,3,0,3,13.0,,102,13,14,27,104.0,82,6.29,74,413,2481,10.4
23908,Rusty Fitzgerald,1997-98,25.0,4,1,4,4,1,0,1,5.0,,4,1,0,1,5.0,48,5.97,37,209,1408,10.2
23909,Rusty Fitzgerald,1998-99,26.0,5,3,21,21,1,2,3,15.0,,25,2,2,4,20.0,82,6.29,74,413,2481,10.4
23910,Ryan Barnes,2006-07,27.0,4,0,2,2,0,0,0,0.0,5.0,2,0,0,0,0.0,82,5.14,57,348,2300,9.2
23911,Ryan Bast,2001-02,26.0,4,1,2,2,0,1,1,1.0,27.0,2,0,1,1,1.0,82,5.27,57,359,2285,9.4
23912,Ryan Bayda,2005-06,25.0,4,14,25,25,4,10,14,49.0,431.0,25,4,10,14,49.0,82,5.31,60,363,2326,9.4
23913,Ryan Bayda,2006-07,26.0,5,6,44,44,3,3,6,65.0,482.0,69,7,13,20,114.0,82,5.14,57,348,2300,9.2
23914,Ryan Bayda,2009-10,29.0,6,2,9,9,1,1,2,10.0,78.0,78,8,14,22,124.0,82,5.76,70,398,2426,9.7
23915,Ryan Bayda,2010-11,30.0,7,6,31,31,3,3,6,58.0,391.0,109,11,17,28,182.0,82,5.44,62,351,2383,9.4
23916,Ryan Bayda,2011-12,31.0,8,12,70,70,5,7,12,62.0,732.0,179,16,24,40,244.0,82,5.7,65,341,2477,9.4
23917,Ryan Bonni,2002-03,23.0,4,0,3,3,0,0,0,1.0,29.0,3,0,0,0,1.0,82,5.49,53,331,2294,9.8
23918,Ryan Bourque,2017-18,27.0,4,0,1,1,0,0,0,1.0,12.0,1,0,0,0,1.0,82,5.32,47,251,2453,8.9
23919,Ryan Caldwell,2008-09,27.0,4,0,2,2,0,0,0,2.0,33.0,2,0,0,0,2.0,82,6.05,85,480,2458,10.1
23920,Ryan Caldwell,2010-11,29.0,5,0,2,2,0,0,0,1.0,12.0,4,0,0,0,3.0,82,5.44,62,351,2383,9.4
23921,Ryan Callahan,2009-10,24.0,4,6,14,14,4,2,6,40.0,147.0,14,4,2,6,40.0,82,5.76,70,398,2426,9.7
23922,Ryan Callahan,2010-11,25.0,5,13,52,52,8,5,13,92.0,643.0,66,12,7,19,132.0,82,5.44,62,351,2383,9.4
23923,Ryan Callahan,2011-12,26.0,6,40,81,81,22,18,40,237.0,1382.0,147,34,25,59,369.0,82,5.7,65,341,2477,9.4
23924,Ryan Callahan,2012-13,27.0,7,37,77,77,19,18,37,204.0,1494.0,224,53,43,96,573.0,82,5.53,56,304,2486,9.1
23925,Ryan Callahan,2013-14,28.0,8,48,60,60,23,25,48,179.0,1194.0,284,76,68,144,752.0,82,5.46,52,291,2492,9.0
23926,Ryan Callahan,2014-15,29.0,9,54,76,76,29,25,54,235.0,1599.0,360,105,93,198,987.0,82,5.32,47,271,2439,8.9
23927,Ryan Callahan,2015-16,30.0,10,31,45,45,16,15,31,144.0,968.0,405,121,108,229,1131.0,48,5.31,29,160,1399,9.1
23928,Ryan Callahan,2016-17,31.0,11,36,65,65,17,19,36,163.0,1212.0,470,138,127,265,1294.0,82,5.34,48,269,2463,8.9
23929,Ryan Callahan,2017-18,32.0,12,54,77,77,24,30,54,191.0,1366.0,547,162,157,319,1485.0,82,5.32,47,251,2453,8.9
23930,Ryan Callahan,2018-19,33.0,13,28,73,73,10,18,28,156.0,1258.0,620,172,175,347,1641.0,82,5.34,48,255,2438,9.0
23931,Ryan Callahan,2019-20,34.0,14,4,18,18,2,2,4,22.0,255.0,638,174,177,351,1663.0,82,5.45,47,245,2478,9.0
23932,Ryan Callahan,2020-21,35.0,15,18,67,67,5,13,18,104.0,893.0,705,179,190,369,1767.0,82,5.86,50,250,2620,9.2
23933,Ryan Callahan,2021-22,36.0,16,17,52,52,7,10,17,76.0,579.0,757,186,200,386,1843.0,82,5.96,47,239,2579,9.5
23934,Ryan Carpenter,2018-19,28.0,4,0,1,1,0,0,0,0.0,7.0,1,0,0,0,0.0,82,5.34,48,255,2438,9.0
23935,Ryan Carpenter,2019-20,29.0,5,4,11,11,2,2,4,20.0,114.0,12,2,2,4,20.0,82,5.45,47,245,2478,9.0
23936,Ryan Carpenter,2020-21,30.0,6,15,52,52,9,6,15,85.0,655.0,64,11,8,19,105.0,82,5.86,50,250,2620,9.2
23937,Ryan Carpenter,2021-22,31.0,7,18,68,68,5,13,18,102.0,858.0,132,16,21,37,207.0,82,5.96,47,239,2579,9.5
23938,Ryan Carpenter,2022-23,32.0,8,15,69,69,3,12,15,80.0,971.0,201,19,33,52,287.0,70,5.96,42,208,2192,9.5
23939,Ryan Carter,2010-11,27.0,4,8,34,34,4,4,8,56.0,356.0,34,4,4,8,56.0,82,5.44,62,351,2383,9.4
23940,Ryan Carter,2011-12,28.0,5,9,48,48,3,6,9,40.0,437.0,82,7,10,17,96.0,82,5.7,65,341,2477,9.4
23941,Ryan Carter,2012-13,29.0,6,9,38,38,4,5,9,38.0,374.0,120,11,15,26,134.0,82,5.53,56,304,2486,9.1
23942,Ryan Carter,2013-14,30.0,7,9,62,62,3,6,9,63.0,621.0,182,14,21,35,197.0,82,5.46,52,291,2492,9.0
23943,Ryan Carter,2014-15,31.0,8,8,72,72,4,4,8,50.0,745.0,254,18,25,43,247.0,82,5.32,47,271,2439,8.9
23944,Ryan Carter,2015-16,32.0,9,15,44,44,6,9,15,63.0,574.0,298,24,34,58,310.0,48,5.31,29,160,1399,9.1
23945,Ryan Carter,2016-17,33.0,10,10,62,62,7,3,10,69.0,702.0,360,31,37,68,379.0,82,5.34,48,269,2463,8.9
23946,Ryan Carter,2017-18,34.0,11,13,53,53,3,10,13,47.0,535.0,413,34,47,81,426.0,82,5.32,47,251,2453,8.9
23947,Ryan Carter,2018-19,35.0,12,12,60,60,7,5,12,62.0,668.0,473,41,52,93,488.0,82,5.34,48,255,2438,9.0
23948,Ryan Christie,2002-03,24.0,4,0,5,5,0,0,0,1.0,12.0,5,0,0,0,1.0,82,5.49,53,331,2294,9.8
23949,Ryan Christie,2004-05,26.0,5,0,2,2,0,0,0,0.0,12.0,7,0,0,0,1.0,82,5.24,53,338,2262,9.5
23950,Ryan Craig,2008-09,27.0,4,28,48,48,15,13,28,81.0,737.0,48,15,13,28,81.0,82,6.05,85,480,2458,10.1
23951,Ryan Craig,2009-10,28.0,5,27,72,72,14,13,27,130.0,1104.0,120,29,26,55,211.0,82,5.76,70,398,2426,9.7
23952,Ryan Craig,2010-11,29.0,6,2,7,7,1,1,2,8.0,91.0,127,30,27,57,219.0,82,5.44,62,351,2383,9.4
23953,Ryan Craig,2011-12,30.0,7,6,54,54,2,4,6,64.0,555.0,181,32,31,63,283.0,82,5.7,65,341,2477,9.4
23954,Ryan Craig,2012-13,31.0,8,0,3,3,0,0,0,5.0,29.0,184,32,31,63,288.0,82,5.53,56,304,2486,9.1
23955,Ryan Craig,2013-14,32.0,9,0,6,6,0,0,0,7.0,59.0,190,32,31,63,295.0,82,5.46,52,291,2492,9.0
23956,Ryan Craig,2016-17,35.0,10,0,6,6,0,0,0,4.0,42.0,196,32,31,63,299.0,82,5.34,48,269,2463,8.9
23957,Ryan Craig,2017-18,36.0,11,0,2,2,0,0,0,2.0,15.0,198,32,31,63,301.0,82,5.32,47,251,2453,8.9
23958,Ryan Donato,2020-21,24.0,4,9,12,12,5,4,9,24.0,176.0,12,5,4,9,24.0,82,5.86,50,250,2620,9.2
23959,Ryan Donato,2021-22,25.0,5,25,56,56,10,15,25,139.0,767.0,68,15,19,34,163.0,82,5.96,47,239,2579,9.5
23960,Ryan Donato,2022-23,26.0,6,23,62,62,14,9,23,95.0,659.0,130,29,28,57,258.0,70,5.96,42,208,2192,9.5
23961,Ryan Dzingel,2018-19,26.0,4,9,30,30,3,6,9,23.0,324.0,30,3,6,9,23.0,82,5.34,48,255,2438,9.0
23962,Ryan Dzingel,2019-20,27.0,5,32,81,81,14,18,32,123.0,1165.0,111,17,24,41,146.0,82,5.45,47,245,2478,9.0
23963,Ryan Dzingel,2020-21,28.0,6,41,79,79,23,18,41,136.0,1303.0,190,40,42,82,282.0,82,5.86,50,250,2620,9.2
23964,Ryan Dzingel,2021-22,29.0,7,56,78,78,26,30,56,159.0,1312.0,268,66,72,138,441.0,82,5.96,47,239,2579,9.5
23965,Ryan Dzingel,2022-23,30.0,8,29,64,64,8,21,29,98.0,906.0,332,74,93,167,539.0,70,5.96,42,208,2192,9.5
23966,Ryan Ellis,2014-15,24.0,4,11,32,32,3,8,11,34.0,474.0,32,3,8,11,34.0,82,5.32,47,271,2439,8.9
23967,Ryan Ellis,2015-16,25.0,5,6,32,32,2,4,6,48.0,524.0,64,5,12,17,82.0,48,5.31,29,160,1399,9.1
23968,Ryan Ellis,2016-17,26.0,6,27,80,80,6,21,27,123.0,1285.0,144,11,33,44,205.0,82,5.34,48,269,2463,8.9
23969,Ryan Ellis,2017-18,27.0,7,27,58,58,9,18,27,118.0,1101.0,202,20,51,71,323.0,82,5.32,47,251,2453,8.9
23970,Ryan Ellis,2018-19,28.0,8,32,79,79,10,22,32,152.0,1651.0,281,30,73,103,475.0,82,5.34,48,255,2438,9.0
23971,Ryan Ellis,2019-20,29.0,9,38,71,71,16,22,38,140.0,1701.0,352,46,95,141,615.0,82,5.45,47,245,2478,9.0
23972,Ryan Ellis,2020-21,30.0,10,32,44,44,9,23,32,110.0,1028.0,396,55,118,173,725.0,82,5.86,50,250,2620,9.2
23973,Ryan Ellis,2021-22,31.0,11,41,82,82,7,34,41,149.0,1969.0,478,62,152,214,874.0,82,5.96,47,239,2579,9.5
23974,Ryan Ellis,2022-23,32.0,12,38,49,49,8,30,38,114.0,1152.0,527,70,182,252,988.0,70,5.96,42,208,2192,9.5
23975,Ryan Flinn,2004-05,24.0,4,0,10,10,0,0,0,2.0,35.0,10,0,0,0,2.0,82,5.24,53,338,2262,9.5
23976,Ryan Flinn,2005-06,25.0,5,1,19,19,1,0,1,13.0,104.0,29,1,0,1,15.0,82,5.31,60,363,2326,9.4
23977,Ryan Flinn,2008-09,28.0,6,0,2,2,0,0,0,0.0,1.0,31,1,0,1,15.0,82,6.05,85,480,2458,10.1
23978,Ryan Garbutt,2014-15,29.0,4,3,20,20,2,1,3,28.0,166.0,20,2,1,3,28.0,82,5.32,47,271,2439,8.9
23979,Ryan Garbutt,2015-16,30.0,5,10,36,36,3,7,10,59.0,357.0,56,5,8,13,87.0,48,5.31,29,160,1399,9.1
23980,Ryan Garbutt,2016-17,31.0,6,32,75,75,17,15,32,165.0,980.0,131,22,23,45,252.0,82,5.34,48,269,2463,8.9
23981,Ryan Garbutt,2017-18,32.0,7,25,67,67,8,17,25,143.0,909.0,198,30,40,70,395.0,82,5.32,47,251,2453,8.9
23982,Ryan Garbutt,2018-19,33.0,8,14,80,80,7,7,14,135.0,867.0,278,37,47,84,530.0,82,5.34,48,255,2438,9.0
23983,Ryan Garbutt,2019-20,34.0,9,3,27,27,2,1,3,26.0,247.0,305,39,48,87,556.0,82,5.45,47,245,2478,9.0
23984,Ryan Getzlaf,2008-09,23.0,4,39,57,57,14,25,39,116.0,717.0,57,14,25,39,116.0,82,6.05,85,480,2458,10.1
23985,Ryan Getzlaf,2009-10,24.0,5,58,82,82,25,33,58,203.0,1235.0,139,39,58,97,319.0,82,5.76,70,398,2426,9.7
23986,Ryan Getzlaf,2010-11,25.0,6,82,77,77,24,58,82,185.0,1513.0,216,63,116,179,504.0,82,5.44,62,351,2383,9.4
23987,Ryan Getzlaf,2011-12,26.0,7,91,81,81,25,66,91,227.0,1631.0,297,88,182,270,731.0,82,5.7,65,341,2477,9.4
23988,Ryan Getzlaf,2012-13,27.0,8,69,66,66,19,50,69,149.0,1430.0,363,107,232,339,880.0,82,5.53,56,304,2486,9.1
23989,Ryan Getzlaf,2013-14,28.0,9,76,67,67,19,57,76,117.0,1464.0,430,126,289,415,997.0,82,5.46,52,291,2492,9.0
23990,Ryan Getzlaf,2014-15,29.0,10,57,82,82,11,46,57,185.0,1771.0,512,137,335,472,1182.0,82,5.32,47,271,2439,8.9
23991,Ryan Getzlaf,2015-16,30.0,11,49,44,44,15,34,49,99.0,889.0,556,152,369,521,1281.0,48,5.31,29,160,1399,9.1
23992,Ryan Getzlaf,2016-17,31.0,12,87,77,77,31,56,87,204.0,1639.0,633,183,425,608,1485.0,82,5.34,48,269,2463,8.9
23993,Ryan Getzlaf,2017-18,32.0,13,70,77,77,25,45,70,191.0,1548.0,710,208,470,678,1676.0,82,5.32,47,251,2453,8.9
23994,Ryan Getzlaf,2018-19,33.0,14,63,77,77,13,50,63,178.0,1502.0,787,221,520,741,1854.0,82,5.34,48,255,2438,9.0
23995,Ryan Getzlaf,2019-20,34.0,15,73,74,74,15,58,73,138.0,1559.0,861,236,578,814,1992.0,82,5.45,47,245,2478,9.0
23996,Ryan Getzlaf,2020-21,35.0,16,61,56,56,11,50,61,117.0,1200.0,917,247,628,875,2109.0,82,5.86,50,250,2620,9.2
23997,Ryan Getzlaf,2021-22,36.0,17,48,67,67,14,34,48,133.0,1304.0,984,261,662,923,2242.0,82,5.96,47,239,2579,9.5
23998,Ryan Getzlaf,2022-23,37.0,18,42,69,69,13,29,42,143.0,1292.0,1053,274,691,965,2385.0,70,5.96,42,208,2192,9.5
23999,Ryan Graves,2021-22,26.0,4,5,26,26,3,2,5,26.0,289.0,26,3,2,5,26.0,82,5.96,47,239,2579,9.5
24000,Ryan Graves,2022-23,27.0,5,26,69,69,9,17,26,134.0,1307.0,95,12,19,31,160.0,70,5.96,42,208,2192,9.5
24001,Ryan Hamilton,2014-15,29.0,4,1,2,2,0,1,1,1.0,26.0,2,0,1,1,1.0,82,5.32,47,271,2439,8.9
24002,Ryan Hamilton,2015-16,30.0,5,2,10,10,0,2,2,6.0,109.0,12,0,3,3,7.0,48,5.31,29,160,1399,9.1
24003,Ryan Hamilton,2016-17,31.0,6,0,2,2,0,0,0,0.0,20.0,14,0,3,3,7.0,82,5.34,48,269,2463,8.9
24004,Ryan Hamilton,2017-18,32.0,7,2,16,16,1,1,2,12.0,211.0,30,1,4,5,19.0,82,5.32,47,251,2453,8.9
24005,Ryan Hartman,2017-18,23.0,4,0,5,5,0,0,0,8.0,41.0,5,0,0,0,8.0,82,5.32,47,251,2453,8.9
24006,Ryan Hartman,2018-19,24.0,5,1,3,3,0,1,1,3.0,28.0,8,0,1,1,11.0,82,5.34,48,255,2438,9.0
24007,Ryan Hartman,2019-20,25.0,6,31,76,76,19,12,31,170.0,970.0,84,19,13,32,181.0,82,5.45,47,245,2478,9.0
24008,Ryan Hartman,2020-21,26.0,7,31,78,78,11,20,31,129.0,1019.0,162,30,33,63,310.0,82,5.86,50,250,2620,9.2
24009,Ryan Hartman,2021-22,27.0,8,26,83,83,12,14,26,145.0,1089.0,245,42,47,89,455.0,82,5.96,47,239,2579,9.5
24010,Ryan Hartman,2022-23,28.0,9,20,69,69,9,11,20,114.0,846.0,314,51,58,109,569.0,70,5.96,42,208,2192,9.5
24011,Ryan Hollweg,2008-09,25.0,4,5,52,52,2,3,5,32.0,377.0,52,2,3,5,32.0,82,6.05,85,480,2458,10.1
24012,Ryan Hollweg,2009-10,26.0,5,3,78,78,1,2,3,63.0,643.0,130,3,5,8,95.0,82,5.76,70,398,2426,9.7
24013,Ryan Hollweg,2010-11,27.0,6,4,70,70,2,2,4,59.0,581.0,200,5,7,12,154.0,82,5.44,62,351,2383,9.4
24014,Ryan Hollweg,2011-12,28.0,7,2,25,25,0,2,2,12.0,162.0,225,5,9,14,166.0,82,5.7,65,341,2477,9.4
24015,Ryan Hollweg,2013-14,30.0,8,0,3,3,0,0,0,0.0,20.0,228,5,9,14,166.0,82,5.46,52,291,2492,9.0
24016,Ryan Hughes,1998-99,27.0,4,0,3,3,0,0,0,2.0,,3,0,0,0,2.0,82,6.29,74,413,2481,10.4
24017,Ryan Huska,2000-01,25.0,4,0,1,1,0,0,0,0.0,,1,0,0,0,0.0,82,5.28,57,380,2242,9.6
24018,Ryan Jardine,2004-05,24.0,4,2,8,8,0,2,2,6.0,71.0,8,0,2,2,6.0,82,5.24,53,338,2262,9.5
24019,Ryan Johansen,2014-15,22.0,4,21,67,67,9,12,21,99.0,853.0,67,9,12,21,99.0,82,5.32,47,271,2439,8.9
24020,Ryan Johansen,2015-16,23.0,5,12,40,40,5,7,12,84.0,643.0,107,14,19,33,183.0,48,5.31,29,160,1399,9.1
24021,Ryan Johansen,2016-17,24.0,6,63,82,82,33,30,63,237.0,1447.0,189,47,49,96,420.0,82,5.34,48,269,2463,8.9
24022,Ryan Johansen,2017-18,25.0,7,71,82,82,26,45,71,202.0,1599.0,271,73,94,167,622.0,82,5.32,47,251,2453,8.9
24023,Ryan Johansen,2018-19,26.0,8,60,80,80,14,46,60,185.0,1405.0,351,87,140,227,807.0,82,5.34,48,255,2438,9.0
24024,Ryan Johansen,2019-20,27.0,9,61,82,82,14,47,61,154.0,1545.0,433,101,187,288,961.0,82,5.45,47,245,2478,9.0
24025,Ryan Johansen,2020-21,28.0,10,54,79,79,15,39,54,129.0,1466.0,512,116,226,342,1090.0,82,5.86,50,250,2620,9.2
24026,Ryan Johansen,2021-22,29.0,11,64,80,80,14,50,64,136.0,1564.0,592,130,276,406,1226.0,82,5.96,47,239,2579,9.5
24027,Ryan Johansen,2022-23,30.0,12,36,68,68,14,22,36,101.0,1160.0,660,144,298,442,1327.0,70,5.96,42,208,2192,9.5
24028,Ryan Johnson,2000-01,24.0,4,2,10,10,0,2,2,6.0,,10,0,2,2,6.0,82,5.28,57,380,2242,9.6
24029,Ryan Johnson,2001-02,25.0,5,1,1,1,1,0,1,1.0,15.0,11,1,2,3,7.0,82,5.27,57,359,2285,9.4
24030,Ryan Johnson,2002-03,26.0,6,18,80,80,4,14,18,49.0,932.0,91,5,16,21,56.0,82,5.49,53,331,2294,9.8
24031,Ryan Johnson,2003-04,27.0,7,21,80,80,7,14,21,71.0,1262.0,171,12,30,42,127.0,82,5.51,63,376,2272,9.9
24032,Ryan Johnson,2004-05,28.0,8,4,29,29,1,3,4,24.0,377.0,200,13,33,46,151.0,82,5.24,53,338,2262,9.5
24033,Ryan Johnson,2005-06,29.0,9,7,75,75,2,5,7,67.0,798.0,275,15,38,53,218.0,82,5.31,60,363,2326,9.4
24034,Ryan Johnson,2006-07,30.0,10,11,69,69,4,7,11,36.0,683.0,344,19,45,64,254.0,82,5.14,57,348,2300,9.2
24035,Ryan Johnson,2008-09,32.0,11,9,65,65,3,6,9,57.0,741.0,409,22,51,73,311.0,82,6.05,85,480,2458,10.1
24036,Ryan Johnson,2009-10,33.0,12,11,59,59,7,4,11,50.0,729.0,468,29,55,84,361.0,82,5.76,70,398,2426,9.7
24037,Ryan Johnson,2010-11,34.0,13,18,79,79,5,13,18,85.0,1135.0,547,34,68,102,446.0,82,5.44,62,351,2383,9.4
24038,Ryan Johnson,2011-12,35.0,14,9,62,62,2,7,9,22.0,683.0,609,36,75,111,468.0,82,5.7,65,341,2477,9.4
24039,Ryan Johnson,2012-13,36.0,15,5,58,58,1,4,5,19.0,616.0,667,37,79,116,487.0,82,5.53,56,304,2486,9.1
24040,Ryan Johnson,2013-14,37.0,16,6,34,34,1,5,6,25.0,352.0,701,38,84,122,512.0,82,5.46,52,291,2492,9.0
24041,Ryan Johnston,2018-19,26.0,4,0,3,3,0,0,0,1.0,49.0,3,0,0,0,1.0,82,5.34,48,255,2438,9.0
24042,Ryan Johnston,2019-20,27.0,5,0,7,7,0,0,0,3.0,69.0,10,0,0,0,4.0,82,5.45,47,245,2478,9.0
24043,Ryan Jones,2011-12,27.0,4,17,46,46,7,10,17,63.0,526.0,46,7,10,17,63.0,82,5.7,65,341,2477,9.4
24044,Ryan Jones,2012-13,28.0,5,12,49,49,8,4,12,62.0,522.0,95,15,14,29,125.0,82,5.53,56,304,2486,9.1
24045,Ryan Jones,2013-14,29.0,6,25,81,81,18,7,25,126.0,1121.0,176,33,21,54,251.0,82,5.46,52,291,2492,9.0
24046,Ryan Jones,2014-15,30.0,7,33,79,79,17,16,33,137.0,1219.0,255,50,37,87,388.0,82,5.32,47,271,2439,8.9
24047,Ryan Jones,2015-16,31.0,8,7,27,27,2,5,7,38.0,350.0,282,52,42,94,426.0,48,5.31,29,160,1399,9.1
24048,Ryan Jones,2016-17,32.0,9,6,52,52,2,4,6,59.0,512.0,334,54,46,100,485.0,82,5.34,48,269,2463,8.9
24049,Ryan Keller,2012-13,29.0,4,0,6,6,0,0,0,5.0,37.0,6,0,0,0,5.0,82,5.53,56,304,2486,9.1
24050,Ryan Kesler,2006-07,22.0,4,5,28,28,2,3,5,23.0,300.0,28,2,3,5,23.0,82,5.14,57,348,2300,9.2
24051,Ryan Kesler,2008-09,24.0,5,23,82,82,10,13,23,119.0,1152.0,110,12,16,28,142.0,82,6.05,85,480,2458,10.1
24052,Ryan Kesler,2009-10,25.0,6,16,48,48,6,10,16,88.0,789.0,158,18,26,44,230.0,82,5.76,70,398,2426,9.7
24053,Ryan Kesler,2010-11,26.0,7,37,80,80,21,16,37,177.0,1524.0,238,39,42,81,407.0,82,5.44,62,351,2383,9.4
24054,Ryan Kesler,2011-12,27.0,8,59,82,82,26,33,59,179.0,1596.0,320,65,75,140,586.0,82,5.7,65,341,2477,9.4
24055,Ryan Kesler,2012-13,28.0,9,75,82,82,25,50,75,214.0,1609.0,402,90,125,215,800.0,82,5.53,56,304,2486,9.1
24056,Ryan Kesler,2013-14,29.0,10,73,82,82,41,32,73,260.0,1681.0,484,131,157,288,1060.0,82,5.46,52,291,2492,9.0
24057,Ryan Kesler,2014-15,30.0,11,49,77,77,22,27,49,222.0,1547.0,561,153,184,337,1282.0,82,5.32,47,271,2439,8.9
24058,Ryan Kesler,2015-16,31.0,12,13,17,17,4,9,13,36.0,322.0,578,157,193,350,1318.0,48,5.31,29,160,1399,9.1
24059,Ryan Kesler,2016-17,32.0,13,43,77,77,25,18,43,239.0,1680.0,655,182,211,393,1557.0,82,5.34,48,269,2463,8.9
24060,Ryan Kesler,2017-18,33.0,14,47,81,81,20,27,47,205.0,1581.0,736,202,238,440,1762.0,82,5.32,47,251,2453,8.9
24061,Ryan Kesler,2018-19,34.0,15,53,79,79,21,32,53,164.0,1543.0,815,223,270,493,1926.0,82,5.34,48,255,2438,9.0
24062,Ryan Kesler,2019-20,35.0,16,58,82,82,22,36,58,186.0,1747.0,897,245,306,551,2112.0,82,5.45,47,245,2478,9.0
24063,Ryan Kesler,2020-21,36.0,17,14,44,44,8,6,14,78.0,794.0,941,253,312,565,2190.0,82,5.86,50,250,2620,9.2
24064,Ryan Kesler,2021-22,37.0,18,8,60,60,5,3,8,86.0,990.0,1001,258,315,573,2276.0,82,5.96,47,239,2579,9.5
24065,Ryan Kraft,2005-06,30.0,4,1,7,7,0,1,1,1.0,60.0,7,0,1,1,1.0,82,5.31,60,363,2326,9.4
24066,Ryan Kuffner,2021-22,25.0,4,0,10,10,0,0,0,8.0,109.0,10,0,0,0,8.0,82,5.96,47,239,2579,9.5
24067,Ryan Lindgren,2021-22,23.0,4,0,5,5,0,0,0,8.0,73.0,5,0,0,0,8.0,82,5.96,47,239,2579,9.5
24068,Ryan Lindgren,2022-23,24.0,5,14,60,60,1,13,14,47.0,994.0,65,1,13,14,55.0,70,5.96,42,208,2192,9.5
24069,Ryan Lomberg,2020-21,26.0,4,1,7,7,0,1,1,5.0,44.0,7,0,1,1,5.0,82,5.86,50,250,2620,9.2
24070,Ryan Lomberg,2021-22,27.0,5,0,4,4,0,0,0,1.0,28.0,11,0,1,1,6.0,82,5.96,47,239,2579,9.5
24071,Ryan MacInnis,2022-23,26.0,4,1,10,10,0,1,1,13.0,94.0,10,0,1,1,13.0,70,5.96,42,208,2192,9.5
24072,Ryan Malone,2006-07,27.0,4,43,81,81,22,21,43,139.0,1530.0,81,22,21,43,139.0,82,5.14,57,348,2300,9.2
24073,Ryan Malone,2008-09,29.0,5,44,77,77,22,22,44,153.0,1393.0,158,44,43,87,292.0,82,6.05,85,480,2458,10.1
24074,Ryan Malone,2009-10,30.0,6,31,64,64,16,15,31,125.0,1040.0,222,60,58,118,417.0,82,5.76,70,398,2426,9.7
24075,Ryan Malone,2010-11,31.0,7,51,77,77,27,24,51,159.0,1469.0,299,87,82,169,576.0,82,5.44,62,351,2383,9.4
24076,Ryan Malone,2011-12,32.0,8,45,70,70,26,19,45,124.0,1243.0,369,113,101,214,700.0,82,5.7,65,341,2477,9.4
24077,Ryan Malone,2012-13,33.0,9,47,69,69,21,26,47,172.0,1295.0,438,134,127,261,872.0,82,5.53,56,304,2486,9.1
24078,Ryan Malone,2013-14,34.0,10,38,54,54,14,24,38,149.0,866.0,492,148,151,299,1021.0,82,5.46,52,291,2492,9.0
24079,Ryan Malone,2014-15,35.0,11,48,68,68,20,28,48,144.0,1203.0,560,168,179,347,1165.0,82,5.32,47,271,2439,8.9
24080,Ryan Malone,2015-16,36.0,12,8,24,24,6,2,8,37.0,378.0,584,174,181,355,1202.0,48,5.31,29,160,1399,9.1
24081,Ryan Malone,2016-17,37.0,13,15,57,57,5,10,15,95.0,671.0,641,179,191,370,1297.0,82,5.34,48,269,2463,8.9
24082,Ryan Malone,2017-18,38.0,14,0,6,6,0,0,0,6.0,60.0,647,179,191,370,1303.0,82,5.32,47,251,2453,8.9
24083,Ryan McDonagh,2013-14,24.0,4,9,40,40,1,8,9,27.0,750.0,40,1,8,9,27.0,82,5.46,52,291,2492,9.0
24084,Ryan McDonagh,2014-15,25.0,5,32,82,82,7,25,32,123.0,2029.0,122,8,33,41,150.0,82,5.32,47,271,2439,8.9
24085,Ryan McDonagh,2015-16,26.0,6,19,47,47,4,15,19,83.0,1145.0,169,12,48,60,233.0,48,5.31,29,160,1399,9.1
24086,Ryan McDonagh,2016-17,27.0,7,43,77,77,14,29,43,177.0,1911.0,246,26,77,103,410.0,82,5.34,48,269,2463,8.9
24087,Ryan McDonagh,2017-18,28.0,8,33,71,71,8,25,33,148.0,1642.0,317,34,102,136,558.0,82,5.32,47,251,2453,8.9
24088,Ryan McDonagh,2018-19,29.0,9,34,73,73,9,25,34,113.0,1632.0,390,43,127,170,671.0,82,5.34,48,255,2438,9.0
24089,Ryan McDonagh,2019-20,30.0,10,42,77,77,6,36,42,153.0,1876.0,467,49,163,212,824.0,82,5.45,47,245,2478,9.0
24090,Ryan McDonagh,2020-21,31.0,11,29,63,63,4,25,29,99.0,1470.0,530,53,188,241,923.0,82,5.86,50,250,2620,9.2
24091,Ryan McDonagh,2021-22,32.0,12,46,82,82,9,37,46,128.0,1811.0,612,62,225,287,1051.0,82,5.96,47,239,2579,9.5
24092,Ryan McDonagh,2022-23,33.0,13,12,50,50,1,11,12,50.0,1035.0,662,63,236,299,1101.0,70,5.96,42,208,2192,9.5
24093,Ryan McGill,1994-95,25.0,4,2,9,9,0,2,2,15.0,,9,0,2,2,15.0,80,6.96,77,402,2440,11.4
24094,Ryan McGill,1995-96,26.0,5,13,72,72,3,10,13,68.0,,81,3,12,15,83.0,84,7.25,87,443,2603,11.7
24095,Ryan McGill,1996-97,27.0,6,4,50,50,1,3,4,53.0,,131,4,15,19,136.0,84,6.48,76,407,2545,10.7
24096,Ryan McGill,1997-98,28.0,7,0,20,20,0,0,0,8.0,,151,4,15,19,144.0,48,5.97,37,209,1408,10.2
24097,Ryan Mulhern,2000-01,28.0,4,0,3,3,0,0,0,1.0,,3,0,0,0,1.0,82,5.28,57,380,2242,9.6
24098,Ryan Murphy,2015-16,22.0,4,0,4,4,0,0,0,7.0,84.0,4,0,0,0,7.0,48,5.31,29,160,1399,9.1
24099,Ryan Murphy,2016-17,23.0,5,12,48,48,2,10,12,81.0,878.0,52,2,10,12,88.0,82,5.34,48,269,2463,8.9
24100,Ryan Murphy,2017-18,24.0,6,13,37,37,4,9,13,61.0,677.0,89,6,19,25,149.0,82,5.32,47,251,2453,8.9
24101,Ryan Murphy,2018-19,25.0,7,10,35,35,0,10,10,47.0,604.0,124,6,29,35,196.0,82,5.34,48,255,2438,9.0
24102,Ryan Murphy,2019-20,26.0,8,2,27,27,0,2,2,17.0,356.0,151,6,31,37,213.0,82,5.45,47,245,2478,9.0
24103,Ryan Murphy,2020-21,27.0,9,5,21,21,2,3,5,25.0,399.0,172,8,34,42,238.0,82,5.86,50,250,2620,9.2
24104,Ryan Murphy,2021-22,28.0,10,1,3,3,0,1,1,1.0,34.0,175,8,35,43,239.0,82,5.96,47,239,2579,9.5
24105,Ryan Murray,2016-17,23.0,4,21,66,66,4,17,21,62.0,1311.0,66,4,17,21,62.0,82,5.34,48,269,2463,8.9
24106,Ryan Murray,2017-18,24.0,5,3,12,12,1,2,3,8.0,227.0,78,5,19,24,70.0,82,5.32,47,251,2453,8.9
24107,Ryan Murray,2018-19,25.0,6,25,82,82,4,21,25,90.0,1873.0,160,9,40,49,160.0,82,5.34,48,255,2438,9.0
24108,Ryan Murray,2019-20,26.0,7,11,60,60,2,9,11,52.0,1100.0,220,11,49,60,212.0,82,5.45,47,245,2478,9.0
24109,Ryan Murray,2020-21,27.0,8,12,44,44,1,11,12,34.0,811.0,264,12,60,72,246.0,82,5.86,50,250,2620,9.2
24110,Ryan Murray,2021-22,28.0,9,29,56,56,1,28,29,71.0,1201.0,320,13,88,101,317.0,82,5.96,47,239,2579,9.5
24111,Ryan Murray,2022-23,29.0,10,9,27,27,2,7,9,32.0,539.0,347,15,95,110,349.0,70,5.96,42,208,2192,9.5
24112,Ryan Nugent-Hopkins,2014-15,21.0,4,52,62,62,18,34,52,134.0,1092.0,62,18,34,52,134.0,82,5.32,47,271,2439,8.9
24113,Ryan Nugent-Hopkins,2015-16,22.0,5,24,40,40,4,20,24,78.0,755.0,102,22,54,76,212.0,48,5.31,29,160,1399,9.1
24114,Ryan Nugent-Hopkins,2016-17,23.0,6,56,80,80,19,37,56,178.0,1632.0,182,41,91,132,390.0,82,5.34,48,269,2463,8.9
24115,Ryan Nugent-Hopkins,2017-18,24.0,7,56,76,76,24,32,56,189.0,1569.0,258,65,123,188,579.0,82,5.32,47,251,2453,8.9
24116,Ryan Nugent-Hopkins,2018-19,25.0,8,34,55,55,12,22,34,108.0,1048.0,313,77,145,222,687.0,82,5.34,48,255,2438,9.0
24117,Ryan Nugent-Hopkins,2019-20,26.0,9,43,82,82,18,25,43,200.0,1451.0,395,95,170,265,887.0,82,5.45,47,245,2478,9.0
24118,Ryan Nugent-Hopkins,2020-21,27.0,10,48,62,62,24,24,48,151.0,1122.0,457,119,194,313,1038.0,82,5.86,50,250,2620,9.2
24119,Ryan Nugent-Hopkins,2021-22,28.0,11,69,82,82,28,41,69,208.0,1648.0,539,147,235,382,1246.0,82,5.96,47,239,2579,9.5
24120,Ryan Nugent-Hopkins,2022-23,29.0,12,61,65,65,22,39,61,172.0,1330.0,604,169,274,443,1418.0,70,5.96,42,208,2192,9.5
24121,Ryan O'Byrne,2010-11,26.0,4,7,33,33,1,6,7,10.0,442.0,33,1,6,7,10.0,82,5.44,62,351,2383,9.4
24122,Ryan O'Byrne,2011-12,27.0,5,5,37,37,0,5,5,14.0,559.0,70,1,11,12,24.0,82,5.7,65,341,2477,9.4
24123,Ryan O'Byrne,2012-13,28.0,6,4,55,55,1,3,4,27.0,839.0,125,2,14,16,51.0,82,5.53,56,304,2486,9.1
24124,Ryan O'Byrne,2013-14,29.0,7,10,67,67,0,10,10,45.0,1351.0,192,2,24,26,96.0,82,5.46,52,291,2492,9.0
24125,Ryan O'Byrne,2014-15,30.0,8,7,74,74,1,6,7,42.0,1395.0,266,3,30,33,138.0,82,5.32,47,271,2439,8.9
24126,Ryan O'Byrne,2015-16,31.0,9,6,42,42,2,4,6,26.0,778.0,308,5,34,39,164.0,48,5.31,29,160,1399,9.1
24127,Ryan O'Marra,2012-13,25.0,4,1,3,3,0,1,1,2.0,20.0,3,0,1,1,2.0,82,5.53,56,304,2486,9.1
24128,Ryan O'Marra,2013-14,26.0,5,5,21,21,1,4,5,13.0,231.0,24,1,5,6,15.0,82,5.46,52,291,2492,9.0
24129,Ryan O'Marra,2014-15,27.0,6,1,9,9,0,1,1,7.0,84.0,33,1,6,7,22.0,82,5.32,47,271,2439,8.9
24130,Ryan O'Reilly,2012-13,21.0,4,26,81,81,8,18,26,135.0,1358.0,81,8,18,26,135.0,82,5.53,56,304,2486,9.1
24131,Ryan O'Reilly,2013-14,22.0,5,26,74,74,13,13,26,119.0,1188.0,155,21,31,52,254.0,82,5.46,52,291,2492,9.0
24132,Ryan O'Reilly,2014-15,23.0,6,55,81,81,18,37,55,189.0,1582.0,236,39,68,107,443.0,82,5.32,47,271,2439,8.9
24133,Ryan O'Reilly,2015-16,24.0,7,20,29,29,6,14,20,66.0,537.0,265,45,82,127,509.0,48,5.31,29,160,1399,9.1
24134,Ryan O'Reilly,2016-17,25.0,8,64,80,80,28,36,64,201.0,1586.0,345,73,118,191,710.0,82,5.34,48,269,2463,8.9
24135,Ryan O'Reilly,2017-18,26.0,9,55,82,82,17,38,55,171.0,1617.0,427,90,156,246,881.0,82,5.32,47,251,2453,8.9
24136,Ryan O'Reilly,2018-19,27.0,10,60,71,71,21,39,60,157.0,1543.0,498,111,195,306,1038.0,82,5.34,48,255,2438,9.0
24137,Ryan O'Reilly,2019-20,28.0,11,55,72,72,20,35,55,189.0,1545.0,570,131,230,361,1227.0,82,5.45,47,245,2478,9.0
24138,Ryan O'Reilly,2020-21,29.0,12,61,81,81,24,37,61,230.0,1686.0,651,155,267,422,1457.0,82,5.86,50,250,2620,9.2
24139,Ryan O'Reilly,2021-22,30.0,13,77,82,82,28,49,77,234.0,1702.0,733,183,316,499,1691.0,82,5.96,47,239,2579,9.5
24140,Ryan O'Reilly,2022-23,31.0,14,61,71,71,12,49,61,118.0,1461.0,804,195,365,560,1809.0,70,5.96,42,208,2192,9.5
24141,Ryan Parent,2009-10,22.0,4,0,1,1,0,0,0,1.0,14.0,1,0,0,0,1.0,82,5.76,70,398,2426,9.7
24142,Ryan Parent,2010-11,23.0,5,0,22,22,0,0,0,9.0,330.0,23,0,0,0,10.0,82,5.44,62,351,2383,9.4
24143,Ryan Parent,2011-12,24.0,6,4,31,31,0,4,4,9.0,564.0,54,0,4,4,19.0,82,5.7,65,341,2477,9.4
24144,Ryan Parent,2012-13,25.0,7,3,48,48,1,2,3,27.0,709.0,102,1,6,7,46.0,82,5.53,56,304,2486,9.1
24145,Ryan Parent,2013-14,26.0,8,0,4,4,0,0,0,3.0,56.0,106,1,6,7,49.0,82,5.46,52,291,2492,9.0
24146,Ryan Poehling,2021-22,23.0,4,3,1,1,3,0,3,3.0,11.0,1,3,0,3,3.0,82,5.96,47,239,2579,9.5
24147,Ryan Poehling,2022-23,24.0,5,2,27,27,1,1,2,26.0,279.0,28,4,1,5,29.0,70,5.96,42,208,2192,9.5
24148,Ryan Potulny,2008-09,24.0,4,1,2,2,0,1,1,0.0,12.0,2,0,1,1,0.0,82,6.05,85,480,2458,10.1
24149,Ryan Potulny,2009-10,25.0,5,12,35,35,7,5,12,56.0,385.0,37,7,6,13,56.0,82,5.76,70,398,2426,9.7
24150,Ryan Potulny,2010-11,26.0,6,1,7,7,0,1,1,5.0,46.0,44,7,7,14,61.0,82,5.44,62,351,2383,9.4
24151,Ryan Potulny,2011-12,27.0,7,3,8,8,0,3,3,9.0,84.0,52,7,10,17,70.0,82,5.7,65,341,2477,9.4
24152,Ryan Potulny,2012-13,28.0,8,32,64,64,15,17,32,152.0,1042.0,116,22,27,49,222.0,82,5.53,56,304,2486,9.1
24153,Ryan Potulny,2013-14,29.0,9,0,10,10,0,0,0,7.0,79.0,126,22,27,49,229.0,82,5.46,52,291,2492,9.0
24154,Ryan Pulock,2018-19,24.0,4,4,15,15,2,2,4,15.0,236.0,15,2,2,4,15.0,82,5.34,48,255,2438,9.0
24155,Ryan Pulock,2019-20,25.0,5,0,1,1,0,0,0,0.0,4.0,16,2,2,4,15.0,82,5.45,47,245,2478,9.0
24156,Ryan Pulock,2020-21,26.0,6,32,68,68,10,22,32,184.0,1252.0,84,12,24,36,199.0,82,5.86,50,250,2620,9.2
24157,Ryan Pulock,2021-22,27.0,7,37,82,82,9,28,37,180.0,1834.0,166,21,52,73,379.0,82,5.96,47,239,2579,9.5
24158,Ryan Pulock,2022-23,28.0,8,35,68,68,10,25,35,163.0,1524.0,234,31,77,108,542.0,70,5.96,42,208,2192,9.5
24159,Ryan Ready,2008-09,30.0,4,1,7,7,0,1,1,9.0,57.0,7,0,1,1,9.0,82,6.05,85,480,2458,10.1
24160,Ryan Reaves,2013-14,27.0,4,4,28,28,2,2,4,16.0,191.0,28,2,2,4,16.0,82,5.46,52,291,2492,9.0
24161,Ryan Reaves,2014-15,28.0,5,4,60,60,3,1,4,32.0,392.0,88,5,3,8,48.0,82,5.32,47,271,2439,8.9
24162,Ryan Reaves,2015-16,29.0,6,6,43,43,4,2,6,24.0,320.0,131,9,5,14,72.0,48,5.31,29,160,1399,9.1
24163,Ryan Reaves,2016-17,30.0,7,8,63,63,2,6,8,25.0,537.0,194,11,11,22,97.0,82,5.34,48,269,2463,8.9
24164,Ryan Reaves,2017-18,31.0,8,12,81,81,6,6,12,55.0,690.0,275,17,17,34,152.0,82,5.32,47,251,2453,8.9
24165,Ryan Reaves,2018-19,32.0,9,4,64,64,3,1,4,31.0,514.0,339,20,18,38,183.0,82,5.34,48,255,2438,9.0
24166,Ryan Reaves,2019-20,33.0,10,13,80,80,7,6,13,58.0,711.0,419,27,24,51,241.0,82,5.45,47,245,2478,9.0
24167,Ryan Reaves,2020-21,34.0,11,10,79,79,4,6,10,42.0,600.0,498,31,30,61,283.0,82,5.86,50,250,2620,9.2
24168,Ryan Reaves,2021-22,35.0,12,20,80,80,9,11,20,95.0,870.0,578,40,41,81,378.0,82,5.96,47,239,2579,9.5
24169,Ryan Reaves,2022-23,36.0,13,15,71,71,8,7,15,61.0,720.0,649,48,48,96,439.0,70,5.96,42,208,2192,9.5
24170,Ryan Russell,2014-15,27.0,4,2,41,41,2,0,2,39.0,479.0,41,2,0,2,39.0,82,5.32,47,271,2439,8.9
24171,Ryan Savoia,2001-02,28.0,4,0,3,3,0,0,0,0.0,7.0,3,0,0,0,0.0,82,5.27,57,359,2285,9.4
24172,Ryan Shannon,2009-10,26.0,4,11,53,53,2,9,11,77.0,564.0,53,2,9,11,77.0,82,5.76,70,398,2426,9.7
24173,Ryan Shannon,2010-11,27.0,5,13,27,27,5,8,13,34.0,348.0,80,7,17,24,111.0,82,5.44,62,351,2383,9.4
24174,Ryan Shannon,2011-12,28.0,6,20,35,35,8,12,20,61.0,528.0,115,15,29,44,172.0,82,5.7,65,341,2477,9.4
24175,Ryan Shannon,2012-13,29.0,7,16,66,66,5,11,16,109.0,837.0,181,20,40,60,281.0,82,5.53,56,304,2486,9.1
24176,Ryan Shannon,2013-14,30.0,8,27,79,79,11,16,27,118.0,1021.0,260,31,56,87,399.0,82,5.46,52,291,2492,9.0
24177,Ryan Shannon,2014-15,31.0,9,12,45,45,4,8,12,46.0,541.0,305,35,64,99,445.0,82,5.32,47,271,2439,8.9
24178,Ryan Smyth,1997-98,21.0,4,0,3,3,0,0,0,2.0,,3,0,0,0,2.0,48,5.97,37,209,1408,10.2
24179,Ryan Smyth,1998-99,22.0,5,11,48,48,2,9,11,65.0,,51,2,9,11,67.0,82,6.29,74,413,2481,10.4
24180,Ryan Smyth,1999-00,23.0,6,61,82,82,39,22,61,265.0,,133,41,31,72,332.0,82,5.83,55,336,2444,9.8
24181,Ryan Smyth,2000-01,24.0,7,33,65,65,20,13,33,205.0,,198,61,44,105,537.0,82,5.28,57,380,2242,9.6
24182,Ryan Smyth,2001-02,25.0,8,31,71,71,13,18,31,161.0,1025.0,269,74,62,136,698.0,82,5.27,57,359,2285,9.4
24183,Ryan Smyth,2002-03,26.0,9,54,82,82,28,26,54,238.0,1574.0,351,102,88,190,936.0,82,5.49,53,331,2294,9.8
24184,Ryan Smyth,2003-04,27.0,10,70,82,82,31,39,70,245.0,1637.0,433,133,127,260,1181.0,82,5.51,63,376,2272,9.9
24185,Ryan Smyth,2004-05,28.0,11,50,61,61,15,35,50,150.0,1187.0,494,148,162,310,1331.0,82,5.24,53,338,2262,9.5
24186,Ryan Smyth,2005-06,29.0,12,61,66,66,27,34,61,199.0,1277.0,560,175,196,371,1530.0,82,5.31,60,363,2326,9.4
24187,Ryan Smyth,2006-07,30.0,13,59,82,82,23,36,59,245.0,1612.0,642,198,232,430,1775.0,82,5.14,57,348,2300,9.2
24188,Ryan Smyth,2008-09,32.0,14,66,75,75,36,30,66,230.0,1516.0,717,234,262,496,2005.0,82,6.05,85,480,2458,10.1
24189,Ryan Smyth,2009-10,33.0,15,68,71,71,36,32,68,210.0,1472.0,788,270,294,564,2215.0,82,5.76,70,398,2426,9.7
24190,Ryan Smyth,2010-11,34.0,16,37,55,55,14,23,37,168.0,1079.0,843,284,317,601,2383.0,82,5.44,62,351,2383,9.4
24191,Ryan Smyth,2011-12,35.0,17,59,77,77,26,33,59,257.0,1562.0,920,310,350,660,2640.0,82,5.7,65,341,2477,9.4
24192,Ryan Smyth,2012-13,36.0,18,53,67,67,22,31,53,206.0,1319.0,987,332,381,713,2846.0,82,5.53,56,304,2486,9.1
24193,Ryan Smyth,2013-14,37.0,19,47,82,82,23,24,47,195.0,1479.0,1069,355,405,760,3041.0,82,5.46,52,291,2492,9.0
24194,Ryan Smyth,2014-15,38.0,20,46,82,82,19,27,46,194.0,1565.0,1151,374,432,806,3235.0,82,5.32,47,271,2439,8.9
24195,Ryan Smyth,2015-16,39.0,21,13,47,47,2,11,13,69.0,722.0,1198,376,443,819,3304.0,48,5.31,29,160,1399,9.1
24196,Ryan Smyth,2016-17,40.0,22,23,72,72,10,13,23,129.0,1111.0,1270,386,456,842,3433.0,82,5.34,48,269,2463,8.9
24197,Ryan Spooner,2015-16,24.0,4,0,4,4,0,0,0,4.0,36.0,4,0,0,0,4.0,48,5.31,29,160,1399,9.1
24198,Ryan Spooner,2016-17,25.0,5,11,23,23,0,11,11,42.0,295.0,27,0,11,11,46.0,82,5.34,48,269,2463,8.9
24199,Ryan Spooner,2017-18,26.0,6,18,29,29,8,10,18,73.0,422.0,56,8,21,29,119.0,82,5.32,47,251,2453,8.9
24200,Ryan Spooner,2018-19,27.0,7,49,80,80,13,36,49,162.0,1211.0,136,21,57,78,281.0,82,5.34,48,255,2438,9.0
24201,Ryan Spooner,2019-20,28.0,8,39,78,78,11,28,39,145.0,1099.0,214,32,85,117,426.0,82,5.45,47,245,2478,9.0
24202,Ryan Spooner,2020-21,29.0,9,41,59,59,13,28,41,107.0,902.0,273,45,113,158,533.0,82,5.86,50,250,2620,9.2
24203,Ryan Spooner,2021-22,30.0,10,9,52,52,3,6,9,67.0,594.0,325,48,119,167,600.0,82,5.96,47,239,2579,9.5
24204,Ryan Sproul,2016-17,24.0,4,0,1,1,0,0,0,3.0,18.0,1,0,0,0,3.0,82,5.34,48,269,2463,8.9
24205,Ryan Sproul,2019-20,27.0,5,7,27,27,1,6,7,46.0,409.0,28,1,6,7,49.0,82,5.45,47,245,2478,9.0
24206,Ryan Sproul,2020-21,28.0,6,5,16,16,1,4,5,15.0,262.0,44,2,10,12,64.0,82,5.86,50,250,2620,9.2
24207,Ryan Stanton,2015-16,26.0,4,0,1,1,0,0,0,1.0,17.0,1,0,0,0,1.0,48,5.31,29,160,1399,9.1
24208,Ryan Stanton,2016-17,27.0,5,16,64,64,1,15,16,65.0,942.0,65,1,15,16,66.0,82,5.34,48,269,2463,8.9
24209,Ryan Stanton,2017-18,28.0,6,11,54,54,3,8,11,59.0,864.0,119,4,23,27,125.0,82,5.32,47,251,2453,8.9
24210,Ryan Stanton,2018-19,29.0,7,0,1,1,0,0,0,0.0,9.0,120,4,23,27,125.0,82,5.34,48,255,2438,9.0
24211,Ryan Stewart,1988-89,21.0,4,1,3,3,1,0,1,5.0,,3,1,0,1,5.0,80,7.94,82,370,2484,12.8
24212,Ryan Stoa,2012-13,25.0,4,3,12,12,2,1,3,26.0,133.0,12,2,1,3,26.0,82,5.53,56,304,2486,9.1
24213,Ryan Stoa,2013-14,26.0,5,4,25,25,2,2,4,45.0,334.0,37,4,3,7,71.0,82,5.46,52,291,2492,9.0
24214,Ryan Stoa,2016-17,29.0,6,0,3,3,0,0,0,2.0,27.0,40,4,3,7,73.0,82,5.34,48,269,2463,8.9
24215,Ryan Stone,2010-11,25.0,4,1,6,6,0,1,1,3.0,39.0,6,0,1,1,3.0,82,5.44,62,351,2383,9.4
24216,Ryan Stone,2011-12,26.0,5,0,2,2,0,0,0,5.0,21.0,8,0,1,1,8.0,82,5.7,65,341,2477,9.4
24217,Ryan Stone,2012-13,27.0,6,6,27,27,0,6,6,25.0,293.0,35,0,7,7,33.0,82,5.53,56,304,2486,9.1
24218,Ryan Strome,2016-17,23.0,4,18,37,37,7,11,18,89.0,562.0,37,7,11,18,89.0,82,5.34,48,269,2463,8.9
24219,Ryan Strome,2017-18,24.0,5,50,81,81,17,33,50,179.0,1247.0,118,24,44,68,268.0,82,5.32,47,251,2453,8.9
24220,Ryan Strome,2018-19,25.0,6,28,71,71,8,20,28,132.0,1112.0,189,32,64,96,400.0,82,5.34,48,255,2438,9.0
24221,Ryan Strome,2019-20,26.0,7,30,69,69,13,17,30,114.0,1008.0,258,45,81,126,514.0,82,5.45,47,245,2478,9.0
24222,Ryan Strome,2020-21,27.0,8,34,82,82,13,21,34,147.0,1248.0,340,58,102,160,661.0,82,5.86,50,250,2620,9.2
24223,Ryan Strome,2021-22,28.0,9,35,81,81,19,16,35,110.0,1261.0,421,77,118,195,771.0,82,5.96,47,239,2579,9.5
24224,Ryan Strome,2022-23,29.0,10,59,70,70,18,41,59,154.0,1371.0,491,95,159,254,925.0,70,5.96,42,208,2192,9.5
24225,Ryan Suter,2008-09,24.0,4,16,71,71,1,15,16,84.0,1232.0,71,1,15,16,84.0,82,6.05,85,480,2458,10.1
24226,Ryan Suter,2009-10,25.0,5,24,82,82,8,16,24,87.0,1652.0,153,9,31,40,171.0,82,5.76,70,398,2426,9.7
24227,Ryan Suter,2010-11,26.0,6,31,76,76,7,24,31,138.0,1564.0,229,16,55,71,309.0,82,5.44,62,351,2383,9.4
24228,Ryan Suter,2011-12,27.0,7,45,82,82,7,38,45,143.0,1989.0,311,23,93,116,452.0,82,5.7,65,341,2477,9.4
24229,Ryan Suter,2012-13,28.0,8,37,82,82,4,33,37,125.0,1966.0,393,27,126,153,577.0,82,5.53,56,304,2486,9.1
24230,Ryan Suter,2013-14,29.0,9,39,70,70,4,35,39,115.0,1764.0,463,31,161,192,692.0,82,5.46,52,291,2492,9.0
24231,Ryan Suter,2014-15,30.0,10,46,79,79,7,39,46,134.0,2094.0,542,38,200,238,826.0,82,5.32,47,271,2439,8.9
24232,Ryan Suter,2015-16,31.0,11,32,48,48,4,28,32,91.0,1309.0,590,42,228,270,917.0,48,5.31,29,160,1399,9.1
24233,Ryan Suter,2016-17,32.0,12,43,82,82,8,35,43,150.0,2412.0,672,50,263,313,1067.0,82,5.34,48,269,2463,8.9
24234,Ryan Suter,2017-18,33.0,13,38,77,77,2,36,38,150.0,2238.0,749,52,299,351,1217.0,82,5.32,47,251,2453,8.9
24235,Ryan Suter,2018-19,34.0,14,51,82,82,8,43,51,188.0,2345.0,831,60,342,402,1405.0,82,5.34,48,255,2438,9.0
24236,Ryan Suter,2019-20,35.0,15,40,82,82,9,31,40,164.0,2208.0,913,69,373,442,1569.0,82,5.45,47,245,2478,9.0
24237,Ryan Suter,2020-21,36.0,16,51,78,78,6,45,51,149.0,2089.0,991,75,418,493,1718.0,82,5.86,50,250,2620,9.2
24238,Ryan Suter,2021-22,37.0,17,47,82,82,7,40,47,136.0,2189.0,1073,82,458,540,1854.0,82,5.96,47,239,2579,9.5
24239,Ryan Suter,2022-23,38.0,18,48,69,69,8,40,48,111.0,1700.0,1142,90,498,588,1965.0,70,5.96,42,208,2192,9.5
24240,Ryan Thang,2014-15,27.0,4,0,1,1,0,0,0,0.0,9.0,1,0,0,0,0.0,82,5.32,47,271,2439,8.9
24241,Ryan Tobler,2004-05,28.0,4,0,4,4,0,0,0,1.0,17.0,4,0,0,0,1.0,82,5.24,53,338,2262,9.5
24242,Ryan VandenBussche,1999-00,26.0,4,1,11,11,1,0,1,4.0,,11,1,0,1,4.0,82,5.83,55,336,2444,9.8
24243,Ryan VandenBussche,2000-01,27.0,5,2,20,20,1,1,2,2.0,,31,2,1,3,6.0,82,5.28,57,380,2242,9.6
24244,Ryan VandenBussche,2001-02,28.0,6,0,6,6,0,0,0,3.0,57.0,37,2,1,3,9.0,82,5.27,57,359,2285,9.4
24245,Ryan VandenBussche,2002-03,29.0,7,1,52,52,0,1,1,19.0,292.0,89,2,2,4,28.0,82,5.49,53,331,2294,9.8
24246,Ryan VandenBussche,2003-04,30.0,8,7,64,64,2,5,7,24.0,497.0,153,4,7,11,52.0,82,5.51,63,376,2272,9.9
24247,Ryan VandenBussche,2004-05,31.0,9,3,50,50,1,2,3,22.0,316.0,203,5,9,14,74.0,82,5.24,53,338,2262,9.5
24248,Ryan VandenBussche,2005-06,32.0,10,0,22,22,0,0,0,7.0,143.0,225,5,9,14,81.0,82,5.31,60,363,2326,9.4
24249,Ryan VandenBussche,2006-07,33.0,11,5,65,65,4,1,5,25.0,407.0,290,9,10,19,106.0,82,5.14,57,348,2300,9.2
24250,Ryan VandenBussche,2008-09,35.0,12,1,20,20,1,0,1,5.0,87.0,310,10,10,20,111.0,82,6.05,85,480,2458,10.1
24251,Ryan Vesce,2011-12,29.0,4,0,10,10,0,0,0,11.0,97.0,10,0,0,0,11.0,82,5.7,65,341,2477,9.4
24252,Ryan Vesce,2012-13,30.0,5,5,9,9,3,2,5,20.0,99.0,19,3,2,5,31.0,82,5.53,56,304,2486,9.1
24253,Ryan White,2012-13,24.0,4,2,16,16,0,2,2,5.0,178.0,16,0,2,2,5.0,82,5.53,56,304,2486,9.1
24254,Ryan White,2013-14,25.0,5,5,27,27,2,3,5,30.0,241.0,43,2,5,7,35.0,82,5.46,52,291,2492,9.0
24255,Ryan White,2014-15,26.0,6,3,20,20,0,3,3,12.0,290.0,63,2,8,10,47.0,82,5.32,47,271,2439,8.9
24256,Ryan White,2015-16,27.0,7,1,26,26,1,0,1,16.0,245.0,89,3,8,11,63.0,48,5.31,29,160,1399,9.1
24257,Ryan White,2016-17,28.0,8,6,52,52,2,4,6,51.0,504.0,141,5,12,17,114.0,82,5.34,48,269,2463,8.9
24258,Ryan White,2017-18,29.0,9,12,34,34,6,6,12,45.0,399.0,175,11,18,29,159.0,82,5.32,47,251,2453,8.9
24259,Ryan White,2018-19,30.0,10,16,73,73,11,5,16,88.0,917.0,248,22,23,45,247.0,82,5.34,48,255,2438,9.0
24260,Ryan White,2019-20,31.0,11,16,65,65,9,7,16,60.0,693.0,313,31,30,61,307.0,82,5.45,47,245,2478,9.0
24261,Ryan Whitney,2008-09,25.0,4,38,68,68,6,32,38,113.0,1620.0,68,6,32,38,113.0,82,6.05,85,480,2458,10.1
24262,Ryan Whitney,2009-10,26.0,5,59,81,81,14,45,59,129.0,1939.0,149,20,77,97,242.0,82,5.76,70,398,2426,9.7
24263,Ryan Whitney,2010-11,27.0,6,40,76,76,12,28,40,119.0,1706.0,225,32,105,137,361.0,82,5.44,62,351,2383,9.4
24264,Ryan Whitney,2011-12,28.0,7,23,48,48,2,21,23,71.0,1146.0,273,34,126,160,432.0,82,5.7,65,341,2477,9.4
24265,Ryan Whitney,2012-13,29.0,8,39,81,81,7,32,39,151.0,2005.0,354,41,158,199,583.0,82,5.53,56,304,2486,9.1
24266,Ryan Whitney,2013-14,30.0,9,27,35,35,2,25,27,43.0,887.0,389,43,183,226,626.0,82,5.46,52,291,2492,9.0
24267,Ryan Whitney,2014-15,31.0,10,20,51,51,3,17,20,41.0,1069.0,440,46,200,246,667.0,82,5.32,47,271,2439,8.9
24268,Ryan Whitney,2015-16,32.0,11,13,34,34,4,9,13,30.0,628.0,474,50,209,259,697.0,48,5.31,29,160,1399,9.1
24269,Ryan Whitney,2016-17,33.0,12,0,7,7,0,0,0,8.0,117.0,481,50,209,259,705.0,82,5.34,48,269,2463,8.9
24270,Ryan Wilson,2012-13,25.0,4,21,61,61,3,18,21,46.0,993.0,61,3,18,21,46.0,82,5.53,56,304,2486,9.1
24271,Ryan Wilson,2013-14,26.0,5,16,67,67,3,13,16,62.0,1327.0,128,6,31,37,108.0,82,5.46,52,291,2492,9.0
24272,Ryan Wilson,2014-15,27.0,6,21,59,59,1,20,21,63.0,1105.0,187,7,51,58,171.0,82,5.32,47,271,2439,8.9
24273,Ryan Wilson,2015-16,28.0,7,3,12,12,0,3,3,23.0,222.0,199,7,54,61,194.0,48,5.31,29,160,1399,9.1
24274,Ryan Wilson,2016-17,29.0,8,6,28,28,0,6,6,23.0,411.0,227,7,60,67,217.0,82,5.34,48,269,2463,8.9
24275,Ryan Wilson,2017-18,30.0,9,0,3,3,0,0,0,3.0,34.0,230,7,60,67,220.0,82,5.32,47,251,2453,8.9
24276,Ryane Clowe,2008-09,26.0,4,2,18,18,0,2,2,14.0,174.0,18,0,2,2,14.0,82,6.05,85,480,2458,10.1
24277,Ryane Clowe,2009-10,27.0,5,34,58,58,16,18,34,93.0,765.0,76,16,20,36,107.0,82,5.76,70,398,2426,9.7
24278,Ryane Clowe,2010-11,28.0,6,8,15,15,3,5,8,22.0,214.0,91,19,25,44,129.0,82,5.44,62,351,2383,9.4
24279,Ryane Clowe,2011-12,29.0,7,52,71,71,22,30,52,161.0,1262.0,162,41,55,96,290.0,82,5.7,65,341,2477,9.4
24280,Ryane Clowe,2012-13,30.0,8,57,82,82,19,38,57,189.0,1408.0,244,60,93,153,479.0,82,5.53,56,304,2486,9.1
24281,Ryane Clowe,2013-14,31.0,9,62,75,75,24,38,62,185.0,1347.0,319,84,131,215,664.0,82,5.46,52,291,2492,9.0
24282,Ryane Clowe,2014-15,32.0,10,45,76,76,17,28,45,180.0,1358.0,395,101,159,260,844.0,82,5.32,47,271,2439,8.9
24283,Ryane Clowe,2015-16,33.0,11,19,40,40,3,16,19,87.0,665.0,435,104,175,279,931.0,48,5.31,29,160,1399,9.1
24284,Ryane Clowe,2016-17,34.0,12,26,43,43,7,19,26,74.0,694.0,478,111,194,305,1005.0,82,5.34,48,269,2463,8.9
24285,Ryane Clowe,2017-18,35.0,13,4,13,13,1,3,4,15.0,204.0,491,112,197,309,1020.0,82,5.32,47,251,2453,8.9
24286,Saku Koivu,1998-99,24.0,4,45,82,82,20,25,45,136.0,,82,20,25,45,136.0,82,6.29,74,413,2481,10.4
24287,Saku Koivu,1999-00,25.0,5,56,50,50,17,39,56,135.0,,132,37,64,101,271.0,82,5.83,55,336,2444,9.8
24288,Saku Koivu,2000-01,26.0,6,57,69,69,14,43,57,145.0,,201,51,107,158,416.0,82,5.28,57,380,2242,9.6
24289,Saku Koivu,2001-02,27.0,7,44,65,65,14,30,44,145.0,1302.0,266,65,137,202,561.0,82,5.27,57,359,2285,9.4
24290,Saku Koivu,2002-03,28.0,8,21,24,24,3,18,21,53.0,461.0,290,68,155,223,614.0,82,5.49,53,331,2294,9.8
24291,Saku Koivu,2003-04,29.0,9,47,54,54,17,30,47,113.0,1155.0,344,85,185,270,727.0,82,5.51,63,376,2272,9.9
24292,Saku Koivu,2004-05,30.0,10,2,3,3,0,2,2,2.0,42.0,347,85,187,272,729.0,82,5.24,53,338,2262,9.5
24293,Saku Koivu,2005-06,31.0,11,71,82,82,21,50,71,147.0,1578.0,429,106,237,343,876.0,82,5.31,60,363,2326,9.4
24294,Saku Koivu,2006-07,32.0,12,55,68,68,14,41,55,112.0,1312.0,497,120,278,398,988.0,82,5.14,57,348,2300,9.2
24295,Saku Koivu,2008-09,34.0,13,62,72,72,17,45,62,138.0,1334.0,569,137,323,460,1126.0,82,6.05,85,480,2458,10.1
24296,Saku Koivu,2009-10,35.0,14,75,81,81,22,53,75,154.0,1467.0,650,159,376,535,1280.0,82,5.76,70,398,2426,9.7
24297,Saku Koivu,2010-11,36.0,15,56,77,77,16,40,56,150.0,1395.0,727,175,416,591,1430.0,82,5.44,62,351,2383,9.4
24298,Saku Koivu,2011-12,37.0,16,50,65,65,16,34,50,123.0,1108.0,792,191,450,641,1553.0,82,5.7,65,341,2477,9.4
24299,Saku Koivu,2012-13,38.0,17,52,71,71,19,33,52,124.0,1319.0,863,210,483,693,1677.0,82,5.53,56,304,2486,9.1
24300,Saku Koivu,2013-14,39.0,18,45,75,75,15,30,45,104.0,1435.0,938,225,513,738,1781.0,82,5.46,52,291,2492,9.0
24301,Saku Koivu,2014-15,40.0,19,38,74,74,11,27,38,107.0,1341.0,1012,236,540,776,1888.0,82,5.32,47,271,2439,8.9
24302,Saku Koivu,2015-16,41.0,20,27,47,47,8,19,27,55.0,827.0,1059,244,559,803,1943.0,48,5.31,29,160,1399,9.1
24303,Saku Koivu,2016-17,42.0,21,29,65,65,11,18,29,81.0,978.0,1124,255,577,832,2024.0,82,5.34,48,269,2463,8.9
24304,Saku Maenalanen,2021-22,27.0,4,8,34,34,4,4,8,36.0,321.0,34,4,4,8,36.0,82,5.96,47,239,2579,9.5
24305,Sam Bennett,2017-18,21.0,4,1,1,1,0,1,1,1.0,16.0,1,0,1,1,1.0,82,5.32,47,251,2453,8.9
24306,Sam Bennett,2018-19,22.0,5,36,77,77,18,18,36,136.0,1166.0,78,18,19,37,137.0,82,5.34,48,255,2438,9.0
24307,Sam Bennett,2019-20,23.0,6,26,81,81,13,13,26,122.0,1214.0,159,31,32,63,259.0,82,5.45,47,245,2478,9.0
24308,Sam Bennett,2020-21,24.0,7,26,82,82,11,15,26,157.0,1181.0,241,42,47,89,416.0,82,5.86,50,250,2620,9.2
24309,Sam Bennett,2021-22,25.0,8,27,71,71,13,14,27,115.0,944.0,312,55,61,116,531.0,82,5.96,47,239,2579,9.5
24310,Sam Bennett,2022-23,26.0,9,12,52,52,8,4,12,82.0,651.0,364,63,65,128,613.0,70,5.96,42,208,2192,9.5
24311,Sam Carrick,2017-18,25.0,4,2,16,16,1,1,2,17.0,104.0,16,1,1,2,17.0,82,5.32,47,251,2453,8.9
24312,Sam Carrick,2018-19,26.0,5,0,3,3,0,0,0,4.0,34.0,19,1,1,2,21.0,82,5.34,48,255,2438,9.0
24313,Sam Carrick,2021-22,29.0,6,1,6,6,0,1,1,5.0,61.0,25,1,2,3,26.0,82,5.96,47,239,2579,9.5
24314,Sam Carrick,2022-23,30.0,7,2,9,9,1,1,2,16.0,124.0,34,2,3,5,42.0,70,5.96,42,208,2192,9.5
24315,Sam Gagner,2010-11,21.0,4,49,79,79,13,36,49,135.0,1239.0,79,13,36,49,135.0,82,5.44,62,351,2383,9.4
24316,Sam Gagner,2011-12,22.0,5,41,76,76,16,25,41,156.0,1274.0,155,29,61,90,291.0,82,5.7,65,341,2477,9.4
24317,Sam Gagner,2012-13,23.0,6,41,68,68,15,26,41,170.0,1108.0,223,44,87,131,461.0,82,5.53,56,304,2486,9.1
24318,Sam Gagner,2013-14,24.0,7,42,68,68,15,27,42,138.0,1207.0,291,59,114,173,599.0,82,5.46,52,291,2492,9.0
24319,Sam Gagner,2014-15,25.0,8,47,75,75,18,29,47,149.0,1289.0,366,77,143,220,748.0,82,5.32,47,271,2439,8.9
24320,Sam Gagner,2015-16,26.0,9,38,48,48,14,24,38,113.0,932.0,414,91,167,258,861.0,48,5.31,29,160,1399,9.1
24321,Sam Gagner,2016-17,27.0,10,37,67,67,10,27,37,143.0,1231.0,481,101,194,295,1004.0,82,5.34,48,269,2463,8.9
24322,Sam Gagner,2017-18,28.0,11,41,81,81,15,26,41,183.0,1397.0,562,116,220,336,1187.0,82,5.32,47,251,2453,8.9
24323,Sam Gagner,2018-19,29.0,12,16,53,53,8,8,16,86.0,735.0,615,124,228,352,1273.0,82,5.34,48,255,2438,9.0
24324,Sam Gagner,2019-20,30.0,13,50,81,81,18,32,50,178.0,1111.0,696,142,260,402,1451.0,82,5.45,47,245,2478,9.0
24325,Sam Gagner,2020-21,31.0,14,31,74,74,10,21,31,164.0,1118.0,770,152,281,433,1615.0,82,5.86,50,250,2620,9.2
24326,Sam Gagner,2021-22,32.0,15,13,32,32,6,7,13,68.0,467.0,802,158,288,446,1683.0,82,5.96,47,239,2579,9.5
24327,Sam Gagner,2022-23,33.0,16,13,42,42,6,7,13,79.0,561.0,844,164,295,459,1762.0,70,5.96,42,208,2192,9.5
24328,Sam Lafferty,2022-23,27.0,4,13,50,50,6,7,13,56.0,481.0,50,6,7,13,56.0,70,5.96,42,208,2192,9.5
24329,Sam Reinhart,2017-18,22.0,4,1,9,9,0,1,1,3.0,93.0,9,0,1,1,3.0,82,5.32,47,251,2453,8.9
24330,Sam Reinhart,2018-19,23.0,5,42,79,79,23,19,42,165.0,1330.0,88,23,20,43,168.0,82,5.34,48,255,2438,9.0
24331,Sam Reinhart,2019-20,24.0,6,47,79,79,17,30,47,178.0,1360.0,167,40,50,90,346.0,82,5.45,47,245,2478,9.0
24332,Sam Reinhart,2020-21,25.0,7,50,82,82,25,25,50,188.0,1402.0,249,65,75,140,534.0,82,5.86,50,250,2620,9.2
24333,Sam Reinhart,2021-22,26.0,8,65,82,82,22,43,65,180.0,1555.0,331,87,118,205,714.0,82,5.96,47,239,2579,9.5
24334,Sam Reinhart,2022-23,27.0,9,50,69,69,22,28,50,144.0,1423.0,400,109,146,255,858.0,70,5.96,42,208,2192,9.5
24335,Sam Steel,2021-22,23.0,4,11,22,22,6,5,11,33.0,329.0,22,6,5,11,33.0,82,5.96,47,239,2579,9.5
24336,Sam Steel,2022-23,24.0,5,22,65,65,6,16,22,85.0,1011.0,87,12,21,33,118.0,70,5.96,42,208,2192,9.5
24337,Sami Helenius,1999-00,26.0,4,1,3,3,0,1,1,1.0,,3,0,1,1,1.0,82,5.83,55,336,2444,9.8
24338,Sami Helenius,2001-02,28.0,5,1,8,8,1,0,1,4.0,109.0,11,1,1,2,5.0,82,5.27,57,359,2285,9.4
24339,Sami Helenius,2002-03,29.0,6,0,33,33,0,0,0,6.0,233.0,44,1,1,2,11.0,82,5.49,53,331,2294,9.8
24340,Sami Helenius,2003-04,30.0,7,3,57,57,1,2,3,18.0,607.0,101,2,3,5,29.0,82,5.51,63,376,2272,9.9
24341,Sami Helenius,2004-05,31.0,8,0,39,39,0,0,0,18.0,378.0,140,2,3,5,47.0,82,5.24,53,338,2262,9.5
24342,Sami Helenius,2005-06,32.0,9,1,15,15,0,1,1,7.0,162.0,155,2,4,6,54.0,82,5.31,60,363,2326,9.4
24343,Sami Kapanen,1998-99,25.0,4,9,35,35,5,4,9,46.0,,35,5,4,9,46.0,82,6.29,74,413,2481,10.4
24344,Sami Kapanen,1999-00,26.0,5,25,45,45,13,12,25,82.0,,80,18,16,34,128.0,82,5.83,55,336,2444,9.8
24345,Sami Kapanen,2000-01,27.0,6,63,81,81,26,37,63,190.0,,161,44,53,97,318.0,82,5.28,57,380,2242,9.6
24346,Sami Kapanen,2001-02,28.0,7,59,81,81,24,35,59,254.0,1573.0,242,68,88,156,572.0,82,5.27,57,359,2285,9.4
24347,Sami Kapanen,2002-03,29.0,8,48,76,76,24,24,48,229.0,1512.0,318,92,112,204,801.0,82,5.49,53,331,2294,9.8
24348,Sami Kapanen,2003-04,30.0,9,57,82,82,20,37,57,223.0,1552.0,400,112,149,261,1024.0,82,5.51,63,376,2272,9.9
24349,Sami Kapanen,2004-05,31.0,10,69,77,77,27,42,69,248.0,1589.0,477,139,191,330,1272.0,82,5.24,53,338,2262,9.5
24350,Sami Kapanen,2005-06,32.0,11,31,71,71,10,21,31,189.0,1342.0,548,149,212,361,1461.0,82,5.31,60,363,2326,9.4
24351,Sami Kapanen,2006-07,33.0,12,30,74,74,12,18,30,149.0,1222.0,622,161,230,391,1610.0,82,5.14,57,348,2300,9.2
24352,Sami Kapanen,2008-09,35.0,13,34,58,58,12,22,34,123.0,1048.0,680,173,252,425,1733.0,82,6.05,85,480,2458,10.1
24353,Sami Kapanen,2009-10,36.0,14,25,77,77,11,14,25,129.0,1307.0,757,184,266,450,1862.0,82,5.76,70,398,2426,9.7
24354,Sami Kapanen,2010-11,37.0,15,8,74,74,5,3,8,76.0,986.0,831,189,269,458,1938.0,82,5.44,62,351,2383,9.4
24355,Sami Lepisto,2010-11,26.0,4,1,7,7,0,1,1,8.0,93.0,7,0,1,1,8.0,82,5.44,62,351,2383,9.4
24356,Sami Lepisto,2011-12,27.0,5,4,7,7,0,4,4,7.0,137.0,14,0,5,5,15.0,82,5.7,65,341,2477,9.4
24357,Sami Lepisto,2012-13,28.0,6,11,66,66,1,10,11,68.0,1203.0,80,1,15,16,83.0,82,5.53,56,304,2486,9.1
24358,Sami Lepisto,2013-14,29.0,7,16,70,70,4,12,16,56.0,1229.0,150,5,27,32,139.0,82,5.46,52,291,2492,9.0
24359,Sami Lepisto,2014-15,30.0,8,3,26,26,1,2,3,19.0,275.0,176,6,29,35,158.0,82,5.32,47,271,2439,8.9
24360,Sami Niku,2020-21,24.0,4,1,1,1,1,0,1,2.0,15.0,1,1,0,1,2.0,82,5.86,50,250,2620,9.2
24361,Sami Niku,2021-22,25.0,5,4,30,30,1,3,4,19.0,418.0,31,2,3,5,21.0,82,5.96,47,239,2579,9.5
24362,Sami Niku,2022-23,26.0,6,5,17,17,0,5,5,27.0,275.0,48,2,8,10,48.0,70,5.96,42,208,2192,9.5
24363,Sami Salo,2001-02,27.0,4,19,61,61,7,12,19,106.0,1202.0,61,7,12,19,106.0,82,5.27,57,359,2285,9.4
24364,Sami Salo,2002-03,28.0,5,14,37,37,6,8,14,85.0,751.0,98,13,20,33,191.0,82,5.49,53,331,2294,9.8
24365,Sami Salo,2003-04,29.0,6,18,31,31,2,16,18,61.0,612.0,129,15,36,51,252.0,82,5.51,63,376,2272,9.9
24366,Sami Salo,2004-05,30.0,7,18,66,66,4,14,18,122.0,1311.0,195,19,50,69,374.0,82,5.24,53,338,2262,9.5
24367,Sami Salo,2005-06,31.0,8,30,79,79,9,21,30,126.0,1591.0,274,28,71,99,500.0,82,5.31,60,363,2326,9.4
24368,Sami Salo,2006-07,32.0,9,26,74,74,7,19,26,143.0,1646.0,348,35,90,125,643.0,82,5.14,57,348,2300,9.2
24369,Sami Salo,2008-09,34.0,10,33,59,59,10,23,33,140.0,1445.0,407,45,113,158,783.0,82,6.05,85,480,2458,10.1
24370,Sami Salo,2009-10,35.0,11,37,67,67,14,23,37,143.0,1437.0,474,59,136,195,926.0,82,5.76,70,398,2426,9.7
24371,Sami Salo,2010-11,36.0,12,25,63,63,8,17,25,122.0,1490.0,537,67,153,220,1048.0,82,5.44,62,351,2383,9.4
24372,Sami Salo,2011-12,37.0,13,25,60,60,5,20,25,110.0,1211.0,597,72,173,245,1158.0,82,5.7,65,341,2477,9.4
24373,Sami Salo,2012-13,38.0,14,28,68,68,9,19,28,119.0,1406.0,665,81,192,273,1277.0,82,5.53,56,304,2486,9.1
24374,Sami Salo,2013-14,39.0,15,7,27,27,3,4,7,39.0,549.0,692,84,196,280,1316.0,82,5.46,52,291,2492,9.0
24375,Sami Salo,2014-15,40.0,16,25,69,69,9,16,25,136.0,1411.0,761,93,212,305,1452.0,82,5.32,47,271,2439,8.9
24376,Sami Salo,2015-16,41.0,17,17,46,46,2,15,17,48.0,965.0,807,95,227,322,1500.0,48,5.31,29,160,1399,9.1
24377,Sami Salo,2016-17,42.0,18,17,71,71,4,13,17,81.0,1292.0,878,99,240,339,1581.0,82,5.34,48,269,2463,8.9
24378,Sami Vatanen,2015-16,24.0,4,2,8,8,2,0,2,6.0,127.0,8,2,0,2,6.0,48,5.31,29,160,1399,9.1
24379,Sami Vatanen,2016-17,25.0,5,21,48,48,6,15,21,73.0,838.0,56,8,15,23,79.0,82,5.34,48,269,2463,8.9
24380,Sami Vatanen,2017-18,26.0,6,37,67,67,12,25,37,122.0,1438.0,123,20,40,60,201.0,82,5.32,47,251,2453,8.9
24381,Sami Vatanen,2018-19,27.0,7,38,71,71,9,29,38,140.0,1513.0,194,29,69,98,341.0,82,5.34,48,255,2438,9.0
24382,Sami Vatanen,2019-20,28.0,8,24,71,71,3,21,24,117.0,1538.0,265,32,90,122,458.0,82,5.45,47,245,2478,9.0
24383,Sami Vatanen,2020-21,29.0,9,32,72,72,4,28,32,145.0,1613.0,337,36,118,154,603.0,82,5.86,50,250,2620,9.2
24384,Sami Vatanen,2021-22,30.0,10,17,50,50,4,13,17,107.0,1086.0,387,40,131,171,710.0,82,5.96,47,239,2579,9.5
24385,Sami Vatanen,2022-23,31.0,11,23,47,47,5,18,23,95.0,1022.0,434,45,149,194,805.0,70,5.96,42,208,2192,9.5
24386,Sammy Blais,2020-21,24.0,4,3,11,11,1,2,3,9.0,119.0,11,1,2,3,9.0,82,5.86,50,250,2620,9.2
24387,Sammy Blais,2021-22,25.0,5,4,32,32,2,2,4,27.0,315.0,43,3,4,7,36.0,82,5.96,47,239,2579,9.5
24388,Sammy Blais,2022-23,26.0,6,13,40,40,6,7,13,56.0,503.0,83,9,11,20,92.0,70,5.96,42,208,2192,9.5
24389,Samuel Girard,2020-21,22.0,4,23,73,73,4,19,23,84.0,1288.0,73,4,19,23,84.0,82,5.86,50,250,2620,9.2
24390,Samuel Girard,2021-22,23.0,5,27,82,82,4,23,27,116.0,1631.0,155,8,42,50,200.0,82,5.96,47,239,2579,9.5
24391,Samuel Girard,2022-23,24.0,6,34,70,70,4,30,34,96.0,1492.0,225,12,72,84,296.0,70,5.96,42,208,2192,9.5
24392,Samuel Henley,2019-20,26.0,4,1,1,1,1,0,1,1.0,5.0,1,1,0,1,1.0,82,5.45,47,245,2478,9.0
24393,Samuel Morin,2019-20,24.0,4,0,1,1,0,0,0,2.0,18.0,1,0,0,0,2.0,82,5.45,47,245,2478,9.0
24394,Samuel Morin,2020-21,25.0,5,0,2,2,0,0,0,1.0,32.0,3,0,0,0,3.0,82,5.86,50,250,2620,9.2
24395,Samuel Morin,2021-22,26.0,6,0,5,5,0,0,0,5.0,62.0,8,0,0,0,8.0,82,5.96,47,239,2579,9.5
24396,Samuel Morin,2022-23,27.0,7,0,1,1,0,0,0,0.0,13.0,9,0,0,0,8.0,70,5.96,42,208,2192,9.5
24397,Samuel Pahlsson,2003-04,26.0,4,9,76,76,4,5,9,59.0,1083.0,76,4,5,9,59.0,82,5.51,63,376,2272,9.9
24398,Samuel Pahlsson,2004-05,27.0,5,20,80,80,6,14,20,99.0,1313.0,156,10,19,29,158.0,82,5.24,53,338,2262,9.5
24399,Samuel Pahlsson,2005-06,28.0,6,15,34,34,4,11,15,28.0,453.0,190,14,30,44,186.0,82,5.31,60,363,2326,9.4
24400,Samuel Pahlsson,2006-07,29.0,7,22,82,82,8,14,22,134.0,1382.0,272,22,44,66,320.0,82,5.14,57,348,2300,9.2
24401,Samuel Pahlsson,2008-09,31.0,8,21,82,82,11,10,21,116.0,1354.0,354,33,54,87,436.0,82,6.05,85,480,2458,10.1
24402,Samuel Pahlsson,2009-10,32.0,9,26,82,82,8,18,26,111.0,1424.0,436,41,72,113,547.0,82,5.76,70,398,2426,9.7
24403,Samuel Pahlsson,2010-11,33.0,10,15,56,56,6,9,15,94.0,1051.0,492,47,81,128,641.0,82,5.44,62,351,2383,9.4
24404,Samuel Pahlsson,2011-12,34.0,11,18,65,65,7,11,18,88.0,1189.0,557,54,92,146,729.0,82,5.7,65,341,2477,9.4
24405,Samuel Pahlsson,2012-13,35.0,12,16,79,79,3,13,16,93.0,1286.0,636,57,105,162,822.0,82,5.53,56,304,2486,9.1
24406,Samuel Pahlsson,2013-14,36.0,13,20,82,82,7,13,20,108.0,1258.0,718,64,118,182,930.0,82,5.46,52,291,2492,9.0
24407,Samuel Pahlsson,2014-15,37.0,14,17,80,80,4,13,17,93.0,1182.0,798,68,131,199,1023.0,82,5.32,47,271,2439,8.9
24408,Sandis Ozolinsh,1995-96,23.0,4,23,37,37,7,16,23,83.0,,37,7,16,23,83.0,84,7.25,87,443,2603,11.7
24409,Sandis Ozolinsh,1996-97,24.0,5,64,81,81,26,38,64,157.0,,118,33,54,87,240.0,84,6.48,76,407,2545,10.7
24410,Sandis Ozolinsh,1997-98,25.0,6,25,48,48,9,16,25,83.0,,166,42,70,112,323.0,48,5.97,37,209,1408,10.2
24411,Sandis Ozolinsh,1998-99,26.0,7,54,73,73,14,40,54,166.0,,239,56,110,166,489.0,82,6.29,74,413,2481,10.4
24412,Sandis Ozolinsh,1999-00,27.0,8,68,80,80,23,45,68,232.0,,319,79,155,234,721.0,82,5.83,55,336,2444,9.8
24413,Sandis Ozolinsh,2000-01,28.0,9,51,66,66,13,38,51,135.0,,385,92,193,285,856.0,82,5.28,57,380,2242,9.6
24414,Sandis Ozolinsh,2001-02,29.0,10,32,39,39,7,25,32,81.0,862.0,424,99,218,317,937.0,82,5.27,57,359,2285,9.4
24415,Sandis Ozolinsh,2002-03,30.0,11,52,82,82,16,36,52,210.0,1861.0,506,115,254,369,1147.0,82,5.49,53,331,2294,9.8
24416,Sandis Ozolinsh,2003-04,31.0,12,44,72,72,12,32,44,145.0,1598.0,578,127,286,413,1292.0,82,5.51,63,376,2272,9.9
24417,Sandis Ozolinsh,2004-05,32.0,13,52,83,83,14,38,52,172.0,2025.0,661,141,324,465,1464.0,82,5.24,53,338,2262,9.5
24418,Sandis Ozolinsh,2005-06,33.0,14,44,82,82,12,32,44,137.0,2133.0,743,153,356,509,1601.0,82,5.31,60,363,2326,9.4
24419,Sandis Ozolinsh,2006-07,34.0,15,16,36,36,5,11,16,58.0,718.0,779,158,367,525,1659.0,82,5.14,57,348,2300,9.2
24420,Sandis Ozolinsh,2008-09,36.0,16,20,36,36,6,14,20,58.0,754.0,815,164,381,545,1717.0,82,6.05,85,480,2458,10.1
24421,Sandis Ozolinsh,2009-10,37.0,17,3,21,21,0,3,3,15.0,396.0,836,164,384,548,1732.0,82,5.76,70,398,2426,9.7
24422,Sandis Ozolinsh,2010-11,38.0,18,16,39,39,3,13,16,39.0,662.0,875,167,397,564,1771.0,82,5.44,62,351,2383,9.4
24423,Sandy Beadle,1983-84,23.0,4,1,6,6,1,0,1,7.0,,6,1,0,1,7.0,80,7.69,77,340,2441,12.6
24424,Sandy McCarthy,1996-97,24.0,4,10,79,79,5,5,10,39.0,,79,5,5,10,39.0,84,6.48,76,407,2545,10.7
24425,Sandy McCarthy,1997-98,25.0,5,8,37,37,5,3,8,29.0,,116,10,8,18,68.0,48,5.97,37,209,1408,10.2
24426,Sandy McCarthy,1998-99,26.0,6,16,75,75,9,7,16,98.0,,191,19,15,34,166.0,82,6.29,74,413,2481,10.4
24427,Sandy McCarthy,1999-00,27.0,7,8,33,33,3,5,8,38.0,,224,22,20,42,204.0,82,5.83,55,336,2444,9.8
24428,Sandy McCarthy,2000-01,28.0,8,18,66,66,8,10,18,94.0,,290,30,30,60,298.0,82,5.28,57,380,2242,9.6
24429,Sandy McCarthy,2001-02,29.0,9,13,80,80,5,8,13,107.0,884.0,370,35,38,73,405.0,82,5.27,57,359,2285,9.4
24430,Sandy McCarthy,2002-03,30.0,10,11,71,71,6,5,11,80.0,702.0,441,41,43,84,485.0,82,5.49,53,331,2294,9.8
24431,Sandy McCarthy,2003-04,31.0,11,21,81,81,11,10,21,95.0,843.0,522,52,53,105,580.0,82,5.51,63,376,2272,9.9
24432,Sandy McCarthy,2004-05,32.0,12,23,82,82,10,13,23,90.0,696.0,604,62,66,128,670.0,82,5.24,53,338,2262,9.5
24433,Sandy McCarthy,2005-06,33.0,13,15,82,82,6,9,15,81.0,609.0,686,68,75,143,751.0,82,5.31,60,363,2326,9.4
24434,Sandy McCarthy,2006-07,34.0,14,5,50,50,4,1,5,38.0,365.0,736,72,76,148,789.0,82,5.14,57,348,2300,9.2
24435,Sandy Moger,1997-98,28.0,4,8,18,18,2,6,8,32.0,,18,2,6,8,32.0,48,5.97,37,209,1408,10.2
24436,Sandy Moger,1998-99,29.0,5,29,80,80,15,14,29,103.0,,98,17,20,37,135.0,82,6.29,74,413,2481,10.4
24437,Sandy Moger,1999-00,30.0,6,13,34,34,10,3,13,54.0,,132,27,23,50,189.0,82,5.83,55,336,2444,9.8
24438,Sandy Moger,2000-01,31.0,7,24,62,62,11,13,24,89.0,,194,38,36,74,278.0,82,5.28,57,380,2242,9.6
24439,Sandy Moger,2001-02,32.0,8,5,42,42,3,2,5,28.0,433.0,236,41,38,79,306.0,82,5.27,57,359,2285,9.4
24440,Sascha Goc,2003-04,24.0,4,0,11,11,0,0,0,7.0,150.0,11,0,0,0,7.0,82,5.51,63,376,2272,9.9
24441,Sascha Goc,2004-05,25.0,5,0,11,11,0,0,0,4.0,89.0,22,0,0,0,11.0,82,5.24,53,338,2262,9.5
24442,Sasha Lakovic,1999-00,28.0,4,1,19,19,0,1,1,10.0,,19,0,1,1,10.0,82,5.83,55,336,2444,9.8
24443,Sasha Lakovic,2000-01,29.0,5,0,2,2,0,0,0,2.0,,21,0,1,1,12.0,82,5.28,57,380,2242,9.6
24444,Sasha Lakovic,2001-02,30.0,6,3,16,16,0,3,3,10.0,101.0,37,0,4,4,22.0,82,5.27,57,359,2285,9.4
24445,Scot Kleinendorst,1985-86,26.0,4,11,30,30,2,9,11,16.0,,30,2,9,11,16.0,80,7.73,71,310,2444,12.7
24446,Scot Kleinendorst,1986-87,27.0,5,2,23,23,0,2,2,13.0,,53,2,11,13,29.0,80,7.89,74,336,2448,12.9
24447,Scot Kleinendorst,1987-88,28.0,6,9,35,35,1,8,9,16.0,,88,3,19,22,45.0,80,7.77,71,321,2447,12.7
24448,Scot Kleinendorst,1988-89,29.0,7,9,41,41,2,7,9,27.0,,129,5,26,31,72.0,80,7.94,82,370,2484,12.8
24449,Scot Kleinendorst,1989-90,30.0,8,12,66,66,3,9,12,50.0,,195,8,35,43,122.0,80,7.34,72,344,2400,12.2
24450,Scot Kleinendorst,1990-91,31.0,9,9,44,44,3,6,9,44.0,,239,11,41,52,166.0,80,7.43,89,437,2435,12.2
24451,Scot Kleinendorst,1991-92,32.0,10,2,27,27,0,2,2,7.0,,266,11,43,54,173.0,80,7.48,85,403,2430,12.3
24452,Scot Kleinendorst,1992-93,33.0,11,4,15,15,1,3,4,13.0,,281,12,46,58,186.0,80,7.37,76,367,2421,12.2
24453,Scott Arniel,1984-85,22.0,4,9,17,17,1,8,9,18.0,,17,1,8,9,18.0,80,8.03,73,320,2489,12.9
24454,Scott Arniel,1985-86,23.0,5,18,75,75,13,5,18,92.0,,92,14,13,27,110.0,80,7.73,71,310,2444,12.7
24455,Scott Arniel,1986-87,24.0,6,56,80,80,21,35,56,140.0,,172,35,48,83,250.0,80,7.89,74,336,2448,12.9
24456,Scott Arniel,1987-88,25.0,7,44,79,79,22,22,44,141.0,,251,57,70,127,391.0,80,7.77,71,321,2447,12.7
24457,Scott Arniel,1988-89,26.0,8,43,80,80,18,25,43,125.0,,331,75,95,170,516.0,80,7.94,82,370,2484,12.8
24458,Scott Arniel,1989-90,27.0,9,25,63,63,11,14,25,90.0,,394,86,109,195,606.0,80,7.34,72,344,2400,12.2
24459,Scott Arniel,1990-91,28.0,10,40,73,73,17,23,40,111.0,,467,103,132,235,717.0,80,7.43,89,437,2435,12.2
24460,Scott Arniel,1991-92,29.0,11,41,80,80,18,23,41,122.0,,547,121,155,276,839.0,80,7.48,85,403,2430,12.3
24461,Scott Arniel,1992-93,30.0,12,32,79,79,18,14,32,123.0,,626,139,169,308,962.0,80,7.37,76,367,2421,12.2
24462,Scott Arniel,1993-94,31.0,13,22,75,75,5,17,22,91.0,,701,144,186,330,1053.0,80,6.91,71,366,2385,11.6
24463,Scott Arniel,1994-95,32.0,14,8,29,29,5,3,8,34.0,,730,149,189,338,1087.0,80,6.96,77,402,2440,11.4
24464,Scott Barney,2005-06,26.0,4,0,5,5,0,0,0,5.0,45.0,5,0,0,0,5.0,82,5.31,60,363,2326,9.4
24465,Scott Barney,2006-07,27.0,5,11,19,19,5,6,11,31.0,213.0,24,5,6,11,36.0,82,5.14,57,348,2300,9.2
24466,Scott Barney,2008-09,29.0,6,0,3,3,0,0,0,4.0,20.0,27,5,6,11,40.0,82,6.05,85,480,2458,10.1
24467,Scott Bjugstad,1986-87,25.0,4,0,5,5,0,0,0,5.0,,5,0,0,0,5.0,80,7.89,74,336,2448,12.9
24468,Scott Bjugstad,1987-88,26.0,5,15,72,72,11,4,15,107.0,,77,11,4,15,112.0,80,7.77,71,321,2447,12.7
24469,Scott Bjugstad,1988-89,27.0,6,76,80,80,43,33,76,217.0,,157,54,37,91,329.0,80,7.94,82,370,2484,12.8
24470,Scott Bjugstad,1989-90,28.0,7,13,39,39,4,9,13,58.0,,196,58,46,104,387.0,80,7.34,72,344,2400,12.2
24471,Scott Bjugstad,1990-91,29.0,8,22,33,33,10,12,22,72.0,,229,68,58,126,459.0,80,7.43,89,437,2435,12.2
24472,Scott Bjugstad,1991-92,30.0,9,3,24,24,3,0,3,21.0,,253,71,58,129,480.0,80,7.48,85,403,2430,12.3
24473,Scott Bjugstad,1992-93,31.0,10,3,11,11,1,2,3,10.0,,264,72,60,132,490.0,80,7.37,76,367,2421,12.2
24474,Scott Bjugstad,1993-94,32.0,11,6,31,31,2,4,6,39.0,,295,74,64,138,529.0,80,6.91,71,366,2385,11.6
24475,Scott Bjugstad,1994-95,33.0,12,6,22,22,2,4,6,25.0,,317,76,68,144,554.0,80,6.96,77,402,2440,11.4
24476,Scott Campbell,1982-83,25.0,4,20,63,63,3,17,20,92.0,,63,3,17,20,92.0,80,7.03,61,280,2352,12.0
24477,Scott Campbell,1983-84,26.0,5,5,14,14,1,4,5,12.0,,77,4,21,25,104.0,80,7.69,77,340,2441,12.6
24478,Scott Campbell,1984-85,27.0,6,0,3,3,0,0,0,0.0,,80,4,21,25,104.0,80,8.03,73,320,2489,12.9
24479,Scott Daniels,1995-96,26.0,4,0,1,1,0,0,0,0.0,,1,0,0,0,0.0,84,7.25,87,443,2603,11.7
24480,Scott Daniels,1997-98,28.0,5,2,12,12,0,2,2,7.0,,13,0,2,2,7.0,48,5.97,37,209,1408,10.2
24481,Scott Daniels,1998-99,29.0,6,7,53,53,3,4,7,43.0,,66,3,6,9,50.0,82,6.29,74,413,2481,10.4
24482,Scott Daniels,1999-00,30.0,7,8,56,56,5,3,8,48.0,,122,8,9,17,98.0,82,5.83,55,336,2444,9.8
24483,Scott Daniels,2000-01,31.0,8,3,26,26,0,3,3,17.0,,148,8,12,20,115.0,82,5.28,57,380,2242,9.6
24484,Scott Daniels,2001-02,32.0,9,0,1,1,0,0,0,0.0,2.0,149,8,12,20,115.0,82,5.27,57,359,2285,9.4
24485,Scott Ferguson,2000-01,28.0,4,0,1,1,0,0,0,0.0,,1,0,0,0,0.0,82,5.28,57,380,2242,9.6
24486,Scott Ferguson,2001-02,29.0,5,1,2,2,0,1,1,1.0,30.0,3,0,1,1,1.0,82,5.27,57,359,2285,9.4
24487,Scott Ferguson,2003-04,31.0,6,1,20,20,0,1,1,8.0,218.0,23,0,2,2,9.0,82,5.51,63,376,2272,9.9
24488,Scott Ferguson,2004-05,32.0,7,5,50,50,3,2,5,27.0,683.0,73,3,4,7,36.0,82,5.24,53,338,2262,9.5
24489,Scott Ferguson,2005-06,33.0,8,8,78,78,3,5,8,45.0,959.0,151,6,9,15,81.0,82,5.31,60,363,2326,9.4
24490,Scott Ferguson,2006-07,34.0,9,6,52,52,1,5,6,38.0,695.0,203,7,14,21,119.0,82,5.14,57,348,2300,9.2
24491,Scott Ferguson,2008-09,36.0,10,0,15,15,0,0,0,6.0,138.0,218,7,14,21,125.0,82,6.05,85,480,2458,10.1
24492,Scott Fraser,1998-99,26.0,4,2,14,14,2,0,2,9.0,,14,2,0,2,9.0,82,6.29,74,413,2481,10.4
24493,Scott Fraser,2000-01,28.0,5,23,29,29,12,11,23,61.0,,43,14,11,25,70.0,82,5.28,57,380,2242,9.6
24494,Scott Fraser,2001-02,29.0,6,6,28,28,2,4,6,35.0,283.0,71,16,15,31,105.0,82,5.27,57,359,2285,9.4
24495,Scott Glennie,2014-15,23.0,4,0,1,1,0,0,0,0.0,10.0,1,0,0,0,0.0,82,5.32,47,271,2439,8.9
24496,Scott Gomez,2002-03,23.0,4,70,82,82,19,51,70,204.0,1341.0,82,19,51,70,204.0,82,5.49,53,331,2294,9.8
24497,Scott Gomez,2003-04,24.0,5,63,76,76,14,49,63,155.0,1198.0,158,33,100,133,359.0,82,5.51,63,376,2272,9.9
24498,Scott Gomez,2004-05,25.0,6,48,76,76,10,38,48,156.0,1274.0,234,43,138,181,515.0,82,5.24,53,338,2262,9.5
24499,Scott Gomez,2005-06,26.0,7,55,80,80,13,42,55,205.0,1281.0,314,56,180,236,720.0,82,5.31,60,363,2326,9.4
24500,Scott Gomez,2006-07,27.0,8,70,80,80,14,56,70,189.0,1281.0,394,70,236,306,909.0,82,5.14,57,348,2300,9.2
24501,Scott Gomez,2008-09,29.0,9,84,82,82,33,51,84,244.0,1540.0,476,103,287,390,1153.0,82,6.05,85,480,2458,10.1
24502,Scott Gomez,2009-10,30.0,10,60,72,72,13,47,60,248.0,1363.0,548,116,334,450,1401.0,82,5.76,70,398,2426,9.7
24503,Scott Gomez,2010-11,31.0,11,70,81,81,16,54,70,242.0,1611.0,629,132,388,520,1643.0,82,5.44,62,351,2383,9.4
24504,Scott Gomez,2011-12,32.0,12,58,77,77,16,42,58,271.0,1622.0,706,148,430,578,1914.0,82,5.7,65,341,2477,9.4
24505,Scott Gomez,2012-13,33.0,13,59,78,78,12,47,59,180.0,1555.0,784,160,477,637,2094.0,82,5.53,56,304,2486,9.1
24506,Scott Gomez,2013-14,34.0,14,38,80,80,7,31,38,157.0,1485.0,864,167,508,675,2251.0,82,5.46,52,291,2492,9.0
24507,Scott Gomez,2014-15,35.0,15,11,38,38,2,9,11,59.0,537.0,902,169,517,686,2310.0,82,5.32,47,271,2439,8.9
24508,Scott Gomez,2015-16,36.0,16,15,39,39,2,13,15,58.0,528.0,941,171,530,701,2368.0,48,5.31,29,160,1399,9.1
24509,Scott Gomez,2016-17,37.0,17,12,46,46,2,10,12,56.0,604.0,987,173,540,713,2424.0,82,5.34,48,269,2463,8.9
24510,Scott Gomez,2017-18,38.0,18,34,58,58,7,27,34,70.0,958.0,1045,180,567,747,2494.0,82,5.32,47,251,2453,8.9
24511,Scott Gomez,2018-19,39.0,19,9,34,34,1,8,9,20.0,385.0,1079,181,575,756,2514.0,82,5.34,48,255,2438,9.0
24512,Scott Gruhl,1984-85,25.0,4,3,7,7,2,1,3,8.0,,7,2,1,3,8.0,80,8.03,73,320,2489,12.9
24513,Scott Gruhl,1985-86,26.0,5,2,7,7,0,2,2,13.0,,14,2,3,5,21.0,80,7.73,71,310,2444,12.7
24514,Scott Gruhl,1990-91,31.0,6,1,6,6,1,0,1,7.0,,20,3,3,6,28.0,80,7.43,89,437,2435,12.2
24515,Scott Hannan,2001-02,23.0,4,2,5,5,0,2,2,4.0,36.0,5,0,2,2,4.0,82,5.27,57,359,2285,9.4
24516,Scott Hannan,2002-03,24.0,5,3,30,30,1,2,3,28.0,514.0,35,1,4,5,32.0,82,5.49,53,331,2294,9.8
24517,Scott Hannan,2003-04,25.0,6,17,75,75,3,14,17,96.0,1427.0,110,4,18,22,128.0,82,5.51,63,376,2272,9.9
24518,Scott Hannan,2004-05,26.0,7,14,75,75,2,12,14,68.0,1524.0,185,6,30,36,196.0,82,5.24,53,338,2262,9.5
24519,Scott Hannan,2005-06,27.0,8,22,81,81,3,19,22,103.0,1965.0,266,9,49,58,299.0,82,5.31,60,363,2326,9.4
24520,Scott Hannan,2006-07,28.0,9,21,82,82,6,15,21,114.0,1942.0,348,15,64,79,413.0,82,5.14,57,348,2300,9.2
24521,Scott Hannan,2008-09,30.0,10,24,81,81,6,18,24,104.0,1991.0,429,21,82,103,517.0,82,6.05,85,480,2458,10.1
24522,Scott Hannan,2009-10,31.0,11,24,79,79,4,20,24,79.0,1803.0,508,25,102,127,596.0,82,5.76,70,398,2426,9.7
24523,Scott Hannan,2010-11,32.0,12,21,82,82,2,19,21,79.0,1860.0,590,27,121,148,675.0,82,5.44,62,351,2383,9.4
24524,Scott Hannan,2011-12,33.0,13,10,81,81,1,9,10,70.0,1812.0,671,28,130,158,745.0,82,5.7,65,341,2477,9.4
24525,Scott Hannan,2012-13,34.0,14,16,81,81,2,14,16,53.0,1776.0,752,30,144,174,798.0,82,5.53,56,304,2486,9.1
24526,Scott Hannan,2013-14,35.0,15,11,78,78,1,10,11,56.0,1543.0,830,31,154,185,854.0,82,5.46,52,291,2492,9.0
24527,Scott Hannan,2014-15,36.0,16,12,78,78,2,10,12,49.0,1588.0,908,33,164,197,903.0,82,5.32,47,271,2439,8.9
24528,Scott Hannan,2015-16,37.0,17,1,33,33,0,1,1,25.0,639.0,941,33,165,198,928.0,48,5.31,29,160,1399,9.1
24529,Scott Hannan,2016-17,38.0,18,12,56,56,3,9,12,52.0,995.0,997,36,174,210,980.0,82,5.34,48,269,2463,8.9
24530,Scott Hannan,2017-18,39.0,19,7,58,58,2,5,7,53.0,946.0,1055,38,179,217,1033.0,82,5.32,47,251,2453,8.9
24531,Scott Harlow,1990-91,27.0,4,1,1,1,0,1,1,2.0,,1,0,1,1,2.0,80,7.43,89,437,2435,12.2
24532,Scott Harrington,2017-18,24.0,4,0,10,10,0,0,0,9.0,158.0,10,0,0,0,9.0,82,5.32,47,251,2453,8.9
24533,Scott Harrington,2018-19,25.0,5,1,15,15,0,1,1,9.0,196.0,25,0,1,1,18.0,82,5.34,48,255,2438,9.0
24534,Scott Harrington,2019-20,26.0,6,3,22,22,1,2,3,16.0,286.0,47,1,3,4,34.0,82,5.45,47,245,2478,9.0
24535,Scott Harrington,2020-21,27.0,7,5,32,32,2,3,5,28.0,426.0,79,3,6,9,62.0,82,5.86,50,250,2620,9.2
24536,Scott Harrington,2021-22,28.0,8,17,73,73,2,15,17,54.0,952.0,152,5,21,26,116.0,82,5.96,47,239,2579,9.5
24537,Scott Harrington,2022-23,29.0,9,8,39,39,1,7,8,37.0,544.0,191,6,28,34,153.0,70,5.96,42,208,2192,9.5
24538,Scott Hartnell,2003-04,21.0,4,16,75,75,2,14,16,92.0,818.0,75,2,14,16,92.0,82,5.51,63,376,2272,9.9
24539,Scott Hartnell,2004-05,22.0,5,41,75,75,14,27,41,162.0,1273.0,150,16,41,57,254.0,82,5.24,53,338,2262,9.5
24540,Scott Hartnell,2005-06,23.0,6,34,82,82,12,22,34,221.0,1254.0,232,28,63,91,475.0,82,5.31,60,363,2326,9.4
24541,Scott Hartnell,2006-07,24.0,7,33,59,59,18,15,33,154.0,960.0,291,46,78,124,629.0,82,5.14,57,348,2300,9.2
24542,Scott Hartnell,2008-09,26.0,8,48,81,81,25,23,48,211.0,1303.0,372,71,101,172,840.0,82,6.05,85,480,2458,10.1
24543,Scott Hartnell,2009-10,27.0,9,39,64,64,22,17,39,150.0,1006.0,436,93,118,211,990.0,82,5.76,70,398,2426,9.7
24544,Scott Hartnell,2010-11,28.0,10,43,80,80,24,19,43,176.0,1294.0,516,117,137,254,1166.0,82,5.44,62,351,2383,9.4
24545,Scott Hartnell,2011-12,29.0,11,60,82,82,30,30,60,210.0,1460.0,598,147,167,314,1376.0,82,5.7,65,341,2477,9.4
24546,Scott Hartnell,2012-13,30.0,12,44,81,81,14,30,44,171.0,1273.0,679,161,197,358,1547.0,82,5.53,56,304,2486,9.1
24547,Scott Hartnell,2013-14,31.0,13,49,82,82,24,25,49,177.0,1362.0,761,185,222,407,1724.0,82,5.46,52,291,2492,9.0
24548,Scott Hartnell,2014-15,32.0,14,67,82,82,37,30,67,232.0,1458.0,843,222,252,474,1956.0,82,5.32,47,271,2439,8.9
24549,Scott Hartnell,2015-16,33.0,15,11,32,32,8,3,11,74.0,508.0,875,230,255,485,2030.0,48,5.31,29,160,1399,9.1
24550,Scott Hartnell,2016-17,34.0,16,52,78,78,20,32,52,207.0,1317.0,953,250,287,537,2237.0,82,5.34,48,269,2463,8.9
24551,Scott Hartnell,2017-18,35.0,17,60,77,77,28,32,60,204.0,1332.0,1030,278,319,597,2441.0,82,5.32,47,251,2453,8.9
24552,Scott Hartnell,2018-19,36.0,18,49,79,79,23,26,49,150.0,1231.0,1109,301,345,646,2591.0,82,5.34,48,255,2438,9.0
24553,Scott Hartnell,2019-20,37.0,19,37,78,78,13,24,37,104.0,941.0,1187,314,369,683,2695.0,82,5.45,47,245,2478,9.0
24554,Scott Hartnell,2020-21,38.0,20,24,62,62,13,11,24,82.0,745.0,1249,327,380,707,2777.0,82,5.86,50,250,2620,9.2
24555,Scott Howson,1987-88,27.0,4,5,8,8,4,1,5,6.0,,8,4,1,5,6.0,80,7.77,71,321,2447,12.7
24556,Scott Howson,1988-89,28.0,5,3,10,10,1,2,3,8.0,,18,5,3,8,14.0,80,7.94,82,370,2484,12.8
24557,Scott Jackson,2012-13,25.0,4,0,1,1,0,0,0,0.0,14.0,1,0,0,0,0.0,82,5.53,56,304,2486,9.1
24558,Scott Kosmachuk,2018-19,25.0,4,3,8,8,0,3,3,9.0,92.0,8,0,3,3,9.0,82,5.34,48,255,2438,9.0
24559,Scott Lachance,1994-95,22.0,4,5,17,17,1,4,5,20.0,,17,1,4,5,20.0,80,6.96,77,402,2440,11.4
24560,Scott Lachance,1995-96,23.0,5,24,75,75,7,17,24,62.0,,92,8,21,29,82.0,84,7.25,87,443,2603,11.7
24561,Scott Lachance,1996-97,24.0,6,14,74,74,3,11,14,59.0,,166,11,32,43,141.0,84,6.48,76,407,2545,10.7
24562,Scott Lachance,1997-98,25.0,7,13,26,26,6,7,13,56.0,,192,17,39,56,197.0,48,5.97,37,209,1408,10.2
24563,Scott Lachance,1998-99,26.0,8,13,55,55,3,10,13,81.0,,247,20,49,69,278.0,82,6.29,74,413,2481,10.4
24564,Scott Lachance,1999-00,27.0,9,14,81,81,3,11,14,97.0,,328,23,60,83,375.0,82,5.83,55,336,2444,9.8
24565,Scott Lachance,2000-01,28.0,10,13,63,63,2,11,13,62.0,,391,25,71,96,437.0,82,5.28,57,380,2242,9.6
24566,Scott Lachance,2001-02,29.0,11,11,76,76,2,9,11,59.0,1655.0,467,27,80,107,496.0,82,5.27,57,359,2285,9.4
24567,Scott Lachance,2002-03,30.0,12,6,57,57,0,6,6,41.0,1013.0,524,27,86,113,537.0,82,5.49,53,331,2294,9.8
24568,Scott Lachance,2003-04,31.0,13,14,76,76,3,11,14,55.0,1477.0,600,30,97,127,592.0,82,5.51,63,376,2272,9.9
24569,Scott Lachance,2004-05,32.0,14,11,81,81,1,10,11,48.0,1623.0,681,31,107,138,640.0,82,5.24,53,338,2262,9.5
24570,Scott Lachance,2005-06,33.0,15,1,61,61,0,1,1,35.0,1221.0,742,31,108,139,675.0,82,5.31,60,363,2326,9.4
24571,Scott Lachance,2006-07,34.0,16,4,77,77,0,4,4,35.0,1461.0,819,31,112,143,710.0,82,5.14,57,348,2300,9.2
24572,Scott Laughton,2015-16,21.0,4,0,5,5,0,0,0,10.0,58.0,5,0,0,0,10.0,48,5.31,29,160,1399,9.1
24573,Scott Laughton,2017-18,23.0,5,6,31,31,2,4,6,51.0,394.0,36,2,4,6,61.0,82,5.32,47,251,2453,8.9
24574,Scott Laughton,2018-19,24.0,6,21,71,71,7,14,21,85.0,741.0,107,9,18,27,146.0,82,5.34,48,255,2438,9.0
24575,Scott Laughton,2019-20,25.0,7,0,2,2,0,0,0,4.0,20.0,109,9,18,27,150.0,82,5.45,47,245,2478,9.0
24576,Scott Laughton,2020-21,26.0,8,20,81,81,10,10,20,108.0,901.0,190,19,28,47,258.0,82,5.86,50,250,2620,9.2
24577,Scott Laughton,2021-22,27.0,9,32,82,82,12,20,32,130.0,1218.0,272,31,48,79,388.0,82,5.96,47,239,2579,9.5
24578,Scott Laughton,2022-23,28.0,10,27,49,49,13,14,27,74.0,716.0,321,44,62,106,462.0,70,5.96,42,208,2192,9.5
24579,Scott Lehman,2011-12,26.0,4,0,1,1,0,0,0,0.0,3.0,1,0,0,0,0.0,82,5.7,65,341,2477,9.4
24580,Scott Levins,1995-96,26.0,4,1,9,9,0,1,1,8.0,,9,0,1,1,8.0,84,7.25,87,443,2603,11.7
24581,Scott Levins,1996-97,27.0,5,19,62,62,8,11,19,77.0,,71,8,12,20,85.0,84,6.48,76,407,2545,10.7
24582,Scott Levins,1997-98,28.0,6,11,24,24,5,6,11,34.0,,95,13,18,31,119.0,48,5.97,37,209,1408,10.2
24583,Scott Levins,1998-99,29.0,7,2,27,27,0,2,2,6.0,,122,13,20,33,125.0,82,6.29,74,413,2481,10.4
24584,Scott Levins,2000-01,31.0,8,0,2,2,0,0,0,2.0,,124,13,20,33,127.0,82,5.28,57,380,2242,9.6
24585,Scott Mayfield,2016-17,24.0,4,0,5,5,0,0,0,7.0,87.0,5,0,0,0,7.0,82,5.34,48,269,2463,8.9
24586,Scott Mayfield,2018-19,26.0,5,1,6,6,1,0,1,4.0,103.0,11,1,0,1,11.0,82,5.34,48,255,2438,9.0
24587,Scott Mayfield,2019-20,27.0,6,9,25,25,2,7,9,39.0,354.0,36,3,7,10,50.0,82,5.45,47,245,2478,9.0
24588,Scott Mayfield,2020-21,28.0,7,12,47,47,2,10,12,58.0,839.0,83,5,17,22,108.0,82,5.86,50,250,2620,9.2
24589,Scott Mayfield,2021-22,29.0,8,19,79,79,4,15,19,104.0,1480.0,162,9,32,41,212.0,82,5.96,47,239,2579,9.5
24590,Scott Mayfield,2022-23,30.0,9,13,67,67,5,8,13,98.0,1336.0,229,14,40,54,310.0,70,5.96,42,208,2192,9.5
24591,Scott McKay,1996-97,25.0,4,0,1,1,0,0,0,1.0,,1,0,0,0,1.0,84,6.48,76,407,2545,10.7
24592,Scott McLellan,1985-86,22.0,4,0,2,2,0,0,0,0.0,,2,0,0,0,0.0,80,7.73,71,310,2444,12.7
24593,Scott Mellanby,1988-89,22.0,4,0,2,2,0,0,0,0.0,,2,0,0,0,0.0,80,7.94,82,370,2484,12.8
24594,Scott Mellanby,1989-90,23.0,5,32,71,71,11,21,32,118.0,,73,11,21,32,118.0,80,7.34,72,344,2400,12.2
24595,Scott Mellanby,1990-91,24.0,6,51,75,75,25,26,51,190.0,,148,36,47,83,308.0,80,7.43,89,437,2435,12.2
24596,Scott Mellanby,1991-92,25.0,7,50,76,76,21,29,50,202.0,,224,57,76,133,510.0,80,7.48,85,403,2430,12.3
24597,Scott Mellanby,1992-93,26.0,8,23,57,57,6,17,23,104.0,,281,63,93,156,614.0,80,7.37,76,367,2421,12.2
24598,Scott Mellanby,1993-94,27.0,9,41,74,74,20,21,41,165.0,,355,83,114,197,779.0,80,6.91,71,366,2385,11.6
24599,Scott Mellanby,1994-95,28.0,10,50,80,80,23,27,50,159.0,,435,106,141,247,938.0,80,6.96,77,402,2440,11.4
24600,Scott Mellanby,1995-96,29.0,11,32,69,69,15,17,32,114.0,,504,121,158,279,1052.0,84,7.25,87,443,2603,11.7
24601,Scott Mellanby,1996-97,30.0,12,60,80,80,30,30,60,204.0,,584,151,188,339,1256.0,84,6.48,76,407,2545,10.7
24602,Scott Mellanby,1997-98,31.0,13,25,48,48,13,12,25,130.0,,632,164,200,364,1386.0,48,5.97,37,209,1408,10.2
24603,Scott Mellanby,1998-99,32.0,14,70,79,79,32,38,70,225.0,,711,196,238,434,1611.0,82,6.29,74,413,2481,10.4
24604,Scott Mellanby,1999-00,33.0,15,56,82,82,27,29,56,221.0,,793,223,267,490,1832.0,82,5.83,55,336,2444,9.8
24605,Scott Mellanby,2000-01,34.0,16,39,79,79,15,24,39,188.0,,872,238,291,529,2020.0,82,5.28,57,380,2242,9.6
24606,Scott Mellanby,2001-02,35.0,17,45,67,67,18,27,45,136.0,1088.0,939,256,318,574,2156.0,82,5.27,57,359,2285,9.4
24607,Scott Mellanby,2002-03,36.0,18,46,77,77,18,28,46,134.0,1144.0,1016,274,346,620,2290.0,82,5.49,53,331,2294,9.8
24608,Scott Mellanby,2003-04,37.0,19,21,63,63,11,10,21,95.0,944.0,1079,285,356,641,2385.0,82,5.51,63,376,2272,9.9
24609,Scott Mellanby,2004-05,38.0,20,41,64,64,15,26,41,137.0,1003.0,1143,300,382,682,2522.0,82,5.24,53,338,2262,9.5
24610,Scott Mellanby,2005-06,39.0,21,57,80,80,26,31,57,132.0,1332.0,1223,326,413,739,2654.0,82,5.31,60,363,2326,9.4
24611,Scott Mellanby,2006-07,40.0,22,31,68,68,14,17,31,103.0,1052.0,1291,340,430,770,2757.0,82,5.14,57,348,2300,9.2
24612,Scott Mellanby,2008-09,42.0,23,34,71,71,12,22,34,100.0,952.0,1362,352,452,804,2857.0,82,6.05,85,480,2458,10.1
24613,Scott Mellanby,2009-10,43.0,24,36,69,69,12,24,36,103.0,947.0,1431,364,476,840,2960.0,82,5.76,70,398,2426,9.7
24614,Scott Metcalfe,1990-91,24.0,4,1,3,3,0,1,1,1.0,,3,0,1,1,1.0,80,7.43,89,437,2435,12.2
24615,Scott Metcalfe,1991-92,25.0,5,2,9,9,1,1,2,11.0,,12,1,2,3,12.0,80,7.48,85,403,2430,12.3
24616,Scott Metcalfe,1992-93,26.0,6,0,7,7,0,0,0,5.0,,19,1,2,3,17.0,80,7.37,76,367,2421,12.2
24617,Scott Morrow,1997-98,28.0,4,0,4,4,0,0,0,1.0,,4,0,0,0,1.0,48,5.97,37,209,1408,10.2
24618,Scott Nichol,1998-99,24.0,4,0,2,2,0,0,0,4.0,,2,0,0,0,4.0,82,6.29,74,413,2481,10.4
24619,Scott Nichol,2000-01,26.0,5,0,3,3,0,0,0,5.0,,5,0,0,0,9.0,82,5.28,57,380,2242,9.6
24620,Scott Nichol,2004-05,30.0,6,17,60,60,8,9,17,49.0,761.0,65,8,9,17,58.0,82,5.24,53,338,2262,9.5
24621,Scott Nichol,2005-06,31.0,7,10,68,68,5,5,10,66.0,733.0,133,13,14,27,124.0,82,5.31,60,363,2326,9.4
24622,Scott Nichol,2006-07,32.0,8,18,75,75,7,11,18,112.0,1183.0,208,20,25,45,236.0,82,5.14,57,348,2300,9.2
24623,Scott Nichol,2008-09,34.0,9,6,34,34,3,3,6,32.0,357.0,242,23,28,51,268.0,82,6.05,85,480,2458,10.1
24624,Scott Nichol,2009-10,35.0,10,13,59,59,7,6,13,58.0,740.0,301,30,34,64,326.0,82,5.76,70,398,2426,9.7
24625,Scott Nichol,2010-11,36.0,11,18,73,73,10,8,18,101.0,968.0,374,40,42,82,427.0,82,5.44,62,351,2383,9.4
24626,Scott Nichol,2011-12,37.0,12,10,43,43,4,6,10,42.0,476.0,417,44,48,92,469.0,82,5.7,65,341,2477,9.4
24627,Scott Nichol,2012-13,38.0,13,19,79,79,4,15,19,93.0,1032.0,496,48,63,111,562.0,82,5.53,56,304,2486,9.1
24628,Scott Nichol,2013-14,39.0,14,7,56,56,4,3,7,61.0,546.0,552,52,66,118,623.0,82,5.46,52,291,2492,9.0
24629,Scott Nichol,2014-15,40.0,15,8,80,80,3,5,8,67.0,745.0,632,55,71,126,690.0,82,5.32,47,271,2439,8.9
24630,Scott Nichol,2015-16,41.0,16,1,30,30,1,0,1,13.0,293.0,662,56,71,127,703.0,48,5.31,29,160,1399,9.1
24631,Scott Niedermayer,1994-95,21.0,4,1,4,4,0,1,1,4.0,,4,0,1,1,4.0,80,6.96,77,402,2440,11.4
24632,Scott Niedermayer,1995-96,22.0,5,40,80,80,11,29,40,131.0,,84,11,30,41,135.0,84,7.25,87,443,2603,11.7
24633,Scott Niedermayer,1996-97,23.0,6,46,81,81,10,36,46,135.0,,165,21,66,87,270.0,84,6.48,76,407,2545,10.7
24634,Scott Niedermayer,1997-98,24.0,7,19,48,48,4,15,19,52.0,,213,25,81,106,322.0,48,5.97,37,209,1408,10.2
24635,Scott Niedermayer,1998-99,25.0,8,33,79,79,8,25,33,179.0,,292,33,106,139,501.0,82,6.29,74,413,2481,10.4
24636,Scott Niedermayer,1999-00,26.0,9,35,81,81,5,30,35,159.0,,373,38,136,174,660.0,82,5.83,55,336,2444,9.8
24637,Scott Niedermayer,2000-01,27.0,10,57,81,81,14,43,57,175.0,,454,52,179,231,835.0,82,5.28,57,380,2242,9.6
24638,Scott Niedermayer,2001-02,28.0,11,46,72,72,11,35,46,161.0,1776.0,526,63,214,277,996.0,82,5.27,57,359,2285,9.4
24639,Scott Niedermayer,2002-03,29.0,12,38,71,71,7,31,38,109.0,1729.0,597,70,245,315,1105.0,82,5.49,53,331,2294,9.8
24640,Scott Niedermayer,2003-04,30.0,13,35,57,57,6,29,35,87.0,1329.0,654,76,274,350,1192.0,82,5.51,63,376,2272,9.9
24641,Scott Niedermayer,2004-05,31.0,14,33,76,76,11,22,33,129.0,1845.0,730,87,296,383,1321.0,82,5.24,53,338,2262,9.5
24642,Scott Niedermayer,2005-06,32.0,15,39,81,81,11,28,39,164.0,1984.0,811,98,324,422,1485.0,82,5.31,60,363,2326,9.4
24643,Scott Niedermayer,2006-07,33.0,16,54,81,81,14,40,54,165.0,2100.0,892,112,364,476,1650.0,82,5.14,57,348,2300,9.2
24644,Scott Niedermayer,2008-09,35.0,17,63,82,82,13,50,63,181.0,2092.0,974,125,414,539,1831.0,82,6.05,85,480,2458,10.1
24645,Scott Niedermayer,2009-10,36.0,18,69,79,79,15,54,69,172.0,2173.0,1053,140,468,608,2003.0,82,5.76,70,398,2426,9.7
24646,Scott Niedermayer,2010-11,37.0,19,25,48,48,8,17,25,87.0,1148.0,1101,148,485,633,2090.0,82,5.44,62,351,2383,9.4
24647,Scott Niedermayer,2011-12,38.0,20,59,82,82,14,45,59,178.0,2207.0,1183,162,530,692,2268.0,82,5.7,65,341,2477,9.4
24648,Scott Niedermayer,2012-13,39.0,21,48,80,80,10,38,48,168.0,2120.0,1263,172,568,740,2436.0,82,5.53,56,304,2486,9.1
24649,Scott Parker,2001-02,24.0,4,0,27,27,0,0,0,3.0,44.0,27,0,0,0,3.0,82,5.27,57,359,2285,9.4
24650,Scott Parker,2003-04,26.0,5,5,69,69,2,3,5,35.0,394.0,96,2,3,5,38.0,82,5.51,63,376,2272,9.9
24651,Scott Parker,2004-05,27.0,6,5,63,63,1,4,5,32.0,367.0,159,3,7,10,70.0,82,5.24,53,338,2262,9.5
24652,Scott Parker,2005-06,28.0,7,4,43,43,1,3,4,20.0,269.0,202,4,10,14,90.0,82,5.31,60,363,2326,9.4
24653,Scott Parker,2006-07,29.0,8,4,50,50,1,3,4,20.0,331.0,252,5,13,18,110.0,82,5.14,57,348,2300,9.2
24654,Scott Parker,2008-09,31.0,9,1,10,10,1,0,1,6.0,56.0,262,6,13,19,116.0,82,6.05,85,480,2458,10.1
24655,Scott Parker,2009-10,32.0,10,2,21,21,1,1,2,5.0,112.0,283,7,14,21,121.0,82,5.76,70,398,2426,9.7
24656,Scott Parker,2010-11,33.0,11,0,25,25,0,0,0,5.0,92.0,308,7,14,21,126.0,82,5.44,62,351,2383,9.4
24657,Scott Parse,2012-13,28.0,4,24,59,59,11,13,24,78.0,621.0,59,11,13,24,78.0,82,5.53,56,304,2486,9.1
24658,Scott Parse,2013-14,29.0,5,4,5,5,1,3,4,6.0,69.0,64,12,16,28,84.0,82,5.46,52,291,2492,9.0
24659,Scott Parse,2014-15,30.0,6,2,9,9,2,0,2,9.0,102.0,73,14,16,30,93.0,82,5.32,47,271,2439,8.9
24660,Scott Pearson,1991-92,22.0,4,1,9,9,0,1,1,6.0,,9,0,1,1,6.0,80,7.48,85,403,2430,12.3
24661,Scott Pearson,1992-93,23.0,5,15,41,41,5,10,15,66.0,,50,5,11,16,72.0,80,7.37,76,367,2421,12.2
24662,Scott Pearson,1993-94,24.0,6,15,47,47,11,4,15,74.0,,97,16,15,31,146.0,80,6.91,71,366,2385,11.6
24663,Scott Pearson,1994-95,25.0,7,3,10,10,1,2,3,14.0,,107,17,17,34,160.0,80,6.96,77,402,2440,11.4
24664,Scott Pearson,1995-96,26.0,8,14,41,41,13,1,14,45.0,,148,30,18,48,205.0,84,7.25,87,443,2603,11.7
24665,Scott Pearson,1996-97,27.0,9,37,72,72,19,18,37,160.0,,220,49,36,85,365.0,84,6.48,76,407,2545,10.7
24666,Scott Pearson,1997-98,28.0,10,8,42,42,3,5,8,40.0,,262,52,41,93,405.0,48,5.97,37,209,1408,10.2
24667,Scott Pearson,1998-99,29.0,11,4,27,27,4,0,4,26.0,,289,56,41,97,431.0,82,6.29,74,413,2481,10.4
24668,Scott Pearson,1999-00,30.0,12,0,1,1,0,0,0,0.0,,290,56,41,97,431.0,82,5.83,55,336,2444,9.8
24669,Scott Pearson,2002-03,33.0,13,1,2,2,0,1,1,5.0,26.0,292,56,42,98,436.0,82,5.49,53,331,2294,9.8
24670,Scott Pellerin,1995-96,26.0,4,21,45,45,10,11,21,60.0,,45,10,11,21,60.0,84,7.25,87,443,2603,11.7
24671,Scott Pellerin,1996-97,27.0,5,0,1,1,0,0,0,0.0,,46,10,11,21,60.0,84,6.48,76,407,2545,10.7
24672,Scott Pellerin,1998-99,29.0,6,3,6,6,2,1,3,9.0,,52,12,12,24,69.0,82,6.29,74,413,2481,10.4
24673,Scott Pellerin,1999-00,30.0,7,18,54,54,8,10,18,76.0,,106,20,22,42,145.0,82,5.83,55,336,2444,9.8
24674,Scott Pellerin,2000-01,31.0,8,29,80,80,8,21,29,96.0,,186,28,43,71,241.0,82,5.28,57,380,2242,9.6
24675,Scott Pellerin,2001-02,32.0,9,41,80,80,20,21,41,138.0,1384.0,266,48,64,112,379.0,82,5.27,57,359,2285,9.4
24676,Scott Pellerin,2002-03,33.0,10,23,80,80,8,15,23,120.0,1183.0,346,56,79,135,499.0,82,5.49,53,331,2294,9.8
24677,Scott Pellerin,2003-04,34.0,11,44,77,77,11,33,44,138.0,1353.0,423,67,112,179,637.0,82,5.51,63,376,2272,9.9
24678,Scott Pellerin,2004-05,35.0,12,14,68,68,4,10,14,63.0,711.0,491,71,122,193,700.0,82,5.24,53,338,2262,9.5
24679,Scott Pellerin,2005-06,36.0,13,5,43,43,1,4,5,37.0,433.0,534,72,126,198,737.0,82,5.31,60,363,2326,9.4
24680,Scott Pellerin,2006-07,37.0,14,0,2,2,0,0,0,1.0,28.0,536,72,126,198,738.0,82,5.14,57,348,2300,9.2
24681,Scott Robinson,1992-93,28.0,4,0,1,1,0,0,0,0.0,,1,0,0,0,0.0,80,7.37,76,367,2421,12.2
24682,Scott Sabourin,2022-23,30.0,4,6,35,35,2,4,6,29.0,246.0,35,2,4,6,29.0,70,5.96,42,208,2192,9.5
24683,Scott Sandelin,1989-90,25.0,4,0,1,1,0,0,0,0.0,,1,0,0,0,0.0,80,7.34,72,344,2400,12.2
24684,Scott Sandelin,1990-91,26.0,5,1,8,8,0,1,1,5.0,,9,0,1,1,5.0,80,7.43,89,437,2435,12.2
24685,Scott Sandelin,1993-94,29.0,6,3,15,15,0,3,3,4.0,,24,0,4,4,9.0,80,6.91,71,366,2385,11.6
24686,Scott Sandelin,1994-95,30.0,7,0,1,1,0,0,0,1.0,,25,0,4,4,10.0,80,6.96,77,402,2440,11.4
24687,Scott Scissons,1993-94,22.0,4,0,1,1,0,0,0,1.0,,1,0,0,0,1.0,80,6.91,71,366,2385,11.6
24688,Scott Scissons,1996-97,25.0,5,0,1,1,0,0,0,0.0,,2,0,0,0,1.0,84,6.48,76,407,2545,10.7
24689,Scott Shaunessy,1989-90,26.0,4,0,3,3,0,0,0,0.0,,3,0,0,0,0.0,80,7.34,72,344,2400,12.2
24690,Scott Shaunessy,1991-92,28.0,5,0,4,4,0,0,0,0.0,,7,0,0,0,0.0,80,7.48,85,403,2430,12.3
24691,Scott Stevens,1985-86,21.0,4,25,77,77,9,16,25,121.0,,77,9,16,25,121.0,80,7.73,71,310,2444,12.7
24692,Scott Stevens,1986-87,22.0,5,45,78,78,13,32,45,155.0,,155,22,48,70,276.0,80,7.89,74,336,2448,12.9
24693,Scott Stevens,1987-88,23.0,6,65,80,80,21,44,65,170.0,,235,43,92,135,446.0,80,7.77,71,321,2447,12.7
24694,Scott Stevens,1988-89,24.0,7,53,73,73,15,38,53,121.0,,308,58,130,188,567.0,80,7.94,82,370,2484,12.8
24695,Scott Stevens,1989-90,25.0,8,61,77,77,10,51,61,163.0,,385,68,181,249,730.0,80,7.34,72,344,2400,12.2
24696,Scott Stevens,1990-91,26.0,9,72,80,80,12,60,72,231.0,,465,80,241,321,961.0,80,7.43,89,437,2435,12.2
24697,Scott Stevens,1991-92,27.0,10,68,80,80,7,61,68,195.0,,545,87,302,389,1156.0,80,7.48,85,403,2430,12.3
24698,Scott Stevens,1992-93,28.0,11,40,56,56,11,29,40,143.0,,601,98,331,429,1299.0,80,7.37,76,367,2421,12.2
24699,Scott Stevens,1993-94,29.0,12,49,78,78,5,44,49,160.0,,679,103,375,478,1459.0,80,6.91,71,366,2385,11.6
24700,Scott Stevens,1994-95,30.0,13,59,68,68,17,42,59,156.0,,747,120,417,537,1615.0,80,6.96,77,402,2440,11.4
24701,Scott Stevens,1995-96,31.0,14,57,81,81,12,45,57,146.0,,828,132,462,594,1761.0,84,7.25,87,443,2603,11.7
24702,Scott Stevens,1996-97,32.0,15,78,83,83,18,60,78,215.0,,911,150,522,672,1976.0,84,6.48,76,407,2545,10.7
24703,Scott Stevens,1997-98,33.0,16,22,48,48,2,20,22,111.0,,959,152,542,694,2087.0,48,5.97,37,209,1408,10.2
24704,Scott Stevens,1998-99,34.0,17,28,82,82,5,23,28,174.0,,1041,157,565,722,2261.0,82,6.29,74,413,2481,10.4
24705,Scott Stevens,1999-00,35.0,18,24,79,79,5,19,24,166.0,,1120,162,584,746,2427.0,82,5.83,55,336,2444,9.8
24706,Scott Stevens,2000-01,36.0,19,26,80,80,4,22,26,94.0,,1200,166,606,772,2521.0,82,5.28,57,380,2242,9.6
24707,Scott Stevens,2001-02,37.0,20,27,75,75,5,22,27,111.0,1814.0,1275,171,628,799,2632.0,82,5.27,57,359,2285,9.4
24708,Scott Stevens,2002-03,38.0,21,29,78,78,8,21,29,133.0,1824.0,1353,179,649,828,2765.0,82,5.49,53,331,2294,9.8
24709,Scott Stevens,2003-04,39.0,22,31,81,81,9,22,31,171.0,1994.0,1434,188,671,859,2936.0,82,5.51,63,376,2272,9.9
24710,Scott Stevens,2004-05,40.0,23,17,82,82,1,16,17,121.0,1912.0,1516,189,687,876,3057.0,82,5.24,53,338,2262,9.5
24711,Scott Stevens,2005-06,41.0,24,20,81,81,4,16,20,113.0,1870.0,1597,193,703,896,3170.0,82,5.31,60,363,2326,9.4
24712,Scott Stevens,2006-07,42.0,25,12,38,38,3,9,12,68.0,913.0,1635,196,712,908,3238.0,82,5.14,57,348,2300,9.2
24713,Scott Thomas,1995-96,26.0,4,2,7,7,1,1,2,4.0,,7,1,1,2,4.0,84,7.25,87,443,2603,11.7
24714,Scott Thomas,1996-97,27.0,5,4,32,32,2,2,4,26.0,,39,3,3,6,30.0,84,6.48,76,407,2545,10.7
24715,Scott Thomas,2003-04,34.0,6,4,24,24,3,1,4,16.0,195.0,63,6,4,10,46.0,82,5.51,63,376,2272,9.9
24716,Scott Thornton,1993-94,23.0,4,4,33,33,1,3,4,31.0,,33,1,3,4,31.0,80,6.91,71,366,2385,11.6
24717,Scott Thornton,1994-95,24.0,5,1,15,15,0,1,1,11.0,,48,1,4,5,42.0,80,6.96,77,402,2440,11.4
24718,Scott Thornton,1995-96,25.0,6,1,9,9,0,1,1,7.0,,57,1,5,6,49.0,84,7.25,87,443,2603,11.7
24719,Scott Thornton,1996-97,26.0,7,11,61,61,4,7,11,65.0,,118,5,12,17,114.0,84,6.48,76,407,2545,10.7
24720,Scott Thornton,1997-98,27.0,8,22,47,47,10,12,22,69.0,,165,15,24,39,183.0,48,5.97,37,209,1408,10.2
24721,Scott Thornton,1998-99,28.0,9,18,77,77,9,9,18,95.0,,242,24,33,57,278.0,82,6.29,74,413,2481,10.4
24722,Scott Thornton,1999-00,29.0,10,20,73,73,10,10,20,110.0,,315,34,43,77,388.0,82,5.83,55,336,2444,9.8
24723,Scott Thornton,2000-01,30.0,11,15,67,67,6,9,15,51.0,,382,40,52,92,439.0,82,5.28,57,380,2242,9.6
24724,Scott Thornton,2001-02,31.0,12,11,47,47,7,4,11,56.0,583.0,429,47,56,103,495.0,82,5.27,57,359,2285,9.4
24725,Scott Thornton,2002-03,32.0,13,14,65,65,8,6,14,83.0,835.0,494,55,62,117,578.0,82,5.49,53,331,2294,9.8
24726,Scott Thornton,2003-04,33.0,14,36,73,73,19,17,36,159.0,1015.0,567,74,79,153,737.0,82,5.51,63,376,2272,9.9
24727,Scott Thornton,2004-05,34.0,15,42,77,77,26,16,42,144.0,1041.0,644,100,95,195,881.0,82,5.24,53,338,2262,9.5
24728,Scott Thornton,2005-06,35.0,16,21,41,41,9,12,21,64.0,569.0,685,109,107,216,945.0,82,5.31,60,363,2326,9.4
24729,Scott Thornton,2006-07,36.0,17,27,80,80,13,14,27,127.0,1116.0,765,122,121,243,1072.0,82,5.14,57,348,2300,9.2
24730,Scott Thornton,2008-09,38.0,18,21,71,71,10,11,21,122.0,945.0,836,132,132,264,1194.0,82,6.05,85,480,2458,10.1
24731,Scott Thornton,2009-10,39.0,19,13,58,58,7,6,13,65.0,719.0,894,139,138,277,1259.0,82,5.76,70,398,2426,9.7
24732,Scott Thornton,2010-11,40.0,20,8,47,47,5,3,8,35.0,413.0,941,144,141,285,1294.0,82,5.44,62,351,2383,9.4
24733,Scott Timmins,2013-14,24.0,4,1,19,19,1,0,1,13.0,206.0,19,1,0,1,13.0,82,5.46,52,291,2492,9.0
24734,Scott Timmins,2015-16,26.0,5,0,5,5,0,0,0,6.0,53.0,24,1,0,1,19.0,48,5.31,29,160,1399,9.1
24735,Scott Walker,1997-98,24.0,4,1,11,11,0,1,1,8.0,,11,0,1,1,8.0,48,5.97,37,209,1408,10.2
24736,Scott Walker,1998-99,25.0,5,12,63,63,4,8,12,45.0,,74,4,9,13,53.0,82,6.29,74,413,2481,10.4
24737,Scott Walker,1999-00,26.0,6,18,64,64,3,15,18,55.0,,138,7,24,31,108.0,82,5.83,55,336,2444,9.8
24738,Scott Walker,2000-01,27.0,7,13,59,59,3,10,13,40.0,,197,10,34,44,148.0,82,5.28,57,380,2242,9.6
24739,Scott Walker,2001-02,28.0,8,40,71,71,15,25,40,96.0,1161.0,268,25,59,84,244.0,82,5.27,57,359,2285,9.4
24740,Scott Walker,2002-03,29.0,9,28,69,69,7,21,28,98.0,1092.0,337,32,80,112,342.0,82,5.49,53,331,2294,9.8
24741,Scott Walker,2003-04,30.0,10,54,74,74,25,29,54,159.0,1427.0,411,57,109,166,501.0,82,5.51,63,376,2272,9.9
24742,Scott Walker,2004-05,31.0,11,9,28,28,4,5,9,46.0,522.0,439,61,114,175,547.0,82,5.24,53,338,2262,9.5
24743,Scott Walker,2005-06,32.0,12,33,60,60,15,18,33,124.0,1190.0,499,76,132,208,671.0,82,5.31,60,363,2326,9.4
24744,Scott Walker,2006-07,33.0,13,67,75,75,25,42,67,157.0,1504.0,574,101,174,275,828.0,82,5.14,57,348,2300,9.2
24745,Scott Walker,2008-09,35.0,14,16,33,33,5,11,16,57.0,574.0,607,106,185,291,885.0,82,6.05,85,480,2458,10.1
24746,Scott Walker,2009-10,36.0,15,51,81,81,21,30,51,183.0,1310.0,688,127,215,342,1068.0,82,5.76,70,398,2426,9.7
24747,Scott Walker,2010-11,37.0,16,32,58,58,14,18,32,122.0,964.0,746,141,233,374,1190.0,82,5.44,62,351,2383,9.4
24748,Scott Walker,2011-12,38.0,17,15,41,41,5,10,15,71.0,547.0,787,146,243,389,1261.0,82,5.7,65,341,2477,9.4
24749,Scott Walker,2012-13,39.0,18,8,42,42,5,3,8,63.0,407.0,829,151,246,397,1324.0,82,5.53,56,304,2486,9.1
24750,Scott Wilson,2017-18,25.0,4,0,1,1,0,0,0,0.0,4.0,1,0,0,0,0.0,82,5.32,47,251,2453,8.9
24751,Scott Wilson,2018-19,26.0,5,6,24,24,5,1,6,39.0,256.0,25,5,1,6,39.0,82,5.34,48,255,2438,9.0
24752,Scott Wilson,2019-20,27.0,6,26,78,78,8,18,26,127.0,854.0,103,13,19,32,166.0,82,5.45,47,245,2478,9.0
24753,Scott Wilson,2020-21,28.0,7,14,69,69,6,8,14,98.0,842.0,172,19,27,46,264.0,82,5.86,50,250,2620,9.2
24754,Scott Wilson,2021-22,29.0,8,3,15,15,0,3,3,25.0,172.0,187,19,30,49,289.0,82,5.96,47,239,2579,9.5
24755,Scott Wilson,2022-23,30.0,9,2,6,6,1,1,2,8.0,70.0,193,20,31,51,297.0,70,5.96,42,208,2192,9.5
24756,Scott Young,1990-91,23.0,4,0,7,7,0,0,0,6.0,,7,0,0,0,6.0,80,7.43,89,437,2435,12.2
24757,Scott Young,1991-92,24.0,5,59,76,76,19,40,59,203.0,,83,19,40,59,209.0,80,7.48,85,403,2430,12.3
24758,Scott Young,1992-93,25.0,6,64,80,80,24,40,64,239.0,,163,43,80,123,448.0,80,7.37,76,367,2421,12.2
24759,Scott Young,1993-94,26.0,7,42,77,77,17,25,42,210.0,,240,60,105,165,658.0,80,6.91,71,366,2385,11.6
24760,Scott Young,1995-96,28.0,8,60,82,82,30,30,60,225.0,,322,90,135,225,883.0,84,7.25,87,443,2603,11.7
24761,Scott Young,1996-97,29.0,9,51,76,76,26,25,51,236.0,,398,116,160,276,1119.0,84,6.48,76,407,2545,10.7
24762,Scott Young,1997-98,30.0,10,39,48,48,18,21,39,167.0,,446,134,181,315,1286.0,48,5.97,37,209,1408,10.2
24763,Scott Young,1998-99,31.0,11,60,81,81,21,39,60,229.0,,527,155,220,375,1515.0,82,6.29,74,413,2481,10.4
24764,Scott Young,1999-00,32.0,12,37,72,72,18,19,37,164.0,,599,173,239,412,1679.0,82,5.83,55,336,2444,9.8
24765,Scott Young,2000-01,33.0,13,33,73,73,13,20,33,187.0,,672,186,259,445,1866.0,82,5.28,57,380,2242,9.6
24766,Scott Young,2001-02,34.0,14,52,75,75,24,28,52,205.0,1143.0,747,210,287,497,2071.0,82,5.27,57,359,2285,9.4
24767,Scott Young,2002-03,35.0,15,39,75,75,24,15,39,244.0,1208.0,822,234,302,536,2315.0,82,5.49,53,331,2294,9.8
24768,Scott Young,2003-04,36.0,16,73,81,81,40,33,73,321.0,1563.0,903,274,335,609,2636.0,82,5.51,63,376,2272,9.9
24769,Scott Young,2004-05,37.0,17,41,67,67,19,22,41,210.0,1240.0,970,293,357,650,2846.0,82,5.24,53,338,2262,9.5
24770,Scott Young,2005-06,38.0,18,42,79,79,23,19,42,237.0,1275.0,1049,316,376,692,3083.0,82,5.31,60,363,2326,9.4
24771,Scott Young,2006-07,39.0,19,16,53,53,8,8,16,134.0,782.0,1102,324,384,708,3217.0,82,5.14,57,348,2300,9.2
24772,Scott Young,2008-09,41.0,20,49,79,79,18,31,49,284.0,1452.0,1181,342,415,757,3501.0,82,6.05,85,480,2458,10.1
24773,Scottie Upshall,2005-06,22.0,4,1,8,8,1,0,1,6.0,70.0,8,1,0,1,6.0,82,5.31,60,363,2326,9.4
24774,Scottie Upshall,2006-07,23.0,5,1,7,7,0,1,1,6.0,64.0,15,1,1,2,12.0,82,5.14,57,348,2300,9.2
24775,Scottie Upshall,2008-09,25.0,6,23,48,48,8,15,23,72.0,501.0,63,9,16,25,84.0,82,6.05,85,480,2458,10.1
24776,Scottie Upshall,2009-10,26.0,7,16,32,32,8,8,16,87.0,472.0,95,17,24,41,171.0,82,5.76,70,398,2426,9.7
24777,Scottie Upshall,2010-11,27.0,8,30,61,61,14,16,30,128.0,814.0,156,31,40,71,299.0,82,5.44,62,351,2383,9.4
24778,Scottie Upshall,2011-12,28.0,9,34,74,74,15,19,34,192.0,1080.0,230,46,59,105,491.0,82,5.7,65,341,2477,9.4
24779,Scottie Upshall,2012-13,29.0,10,32,49,49,18,14,32,119.0,737.0,279,64,73,137,610.0,82,5.53,56,304,2486,9.1
24780,Scottie Upshall,2013-14,30.0,11,34,82,82,22,12,34,191.0,1151.0,361,86,85,171,801.0,82,5.46,52,291,2492,9.0
24781,Scottie Upshall,2014-15,31.0,12,5,26,26,2,3,5,53.0,331.0,387,88,88,176,854.0,82,5.32,47,271,2439,8.9
24782,Scottie Upshall,2015-16,32.0,13,5,27,27,4,1,5,54.0,364.0,414,92,89,181,908.0,48,5.31,29,160,1399,9.1
24783,Scottie Upshall,2016-17,33.0,14,37,76,76,15,22,37,161.0,1210.0,490,107,111,218,1069.0,82,5.34,48,269,2463,8.9
24784,Scottie Upshall,2017-18,34.0,15,15,63,63,8,7,15,93.0,799.0,553,115,118,233,1162.0,82,5.32,47,251,2453,8.9
24785,Scottie Upshall,2018-19,35.0,16,14,70,70,6,8,14,113.0,766.0,623,121,126,247,1275.0,82,5.34,48,255,2438,9.0
24786,Scottie Upshall,2019-20,36.0,17,18,73,73,10,8,18,85.0,802.0,696,131,134,265,1360.0,82,5.45,47,245,2478,9.0
24787,Scottie Upshall,2020-21,37.0,18,19,63,63,7,12,19,71.0,684.0,759,138,146,284,1431.0,82,5.86,50,250,2620,9.2
24788,Sean Avery,2004-05,24.0,4,4,36,36,2,2,4,30.0,283.0,36,2,2,4,30.0,82,5.24,53,338,2262,9.5
24789,Sean Avery,2005-06,25.0,5,15,51,51,6,9,15,59.0,441.0,87,8,11,19,89.0,82,5.31,60,363,2326,9.4
24790,Sean Avery,2006-07,26.0,6,28,76,76,9,19,28,125.0,889.0,163,17,30,47,214.0,82,5.14,57,348,2300,9.2
24791,Sean Avery,2008-09,28.0,7,39,75,75,15,24,39,189.0,1021.0,238,32,54,86,403.0,82,6.05,85,480,2458,10.1
24792,Sean Avery,2009-10,29.0,8,48,84,84,18,30,48,249.0,1444.0,322,50,84,134,652.0,82,5.76,70,398,2426,9.7
24793,Sean Avery,2010-11,30.0,9,33,57,57,15,18,33,125.0,903.0,379,65,102,167,777.0,82,5.44,62,351,2383,9.4
24794,Sean Avery,2011-12,31.0,10,22,41,41,8,14,22,99.0,646.0,420,73,116,189,876.0,82,5.7,65,341,2477,9.4
24795,Sean Avery,2012-13,32.0,11,31,69,69,11,20,31,139.0,923.0,489,84,136,220,1015.0,82,5.53,56,304,2486,9.1
24796,Sean Avery,2013-14,33.0,12,24,76,76,3,21,24,137.0,854.0,565,87,157,244,1152.0,82,5.46,52,291,2492,9.0
24797,Sean Avery,2014-15,34.0,13,3,15,15,3,0,3,15.0,105.0,580,90,157,247,1167.0,82,5.32,47,271,2439,8.9
24798,Sean Bentivoglio,2011-12,26.0,4,0,1,1,0,0,0,2.0,12.0,1,0,0,0,2.0,82,5.7,65,341,2477,9.4
24799,Sean Bergenheim,2006-07,22.0,4,2,18,18,1,1,2,12.0,161.0,18,1,1,2,12.0,82,5.14,57,348,2300,9.2
24800,Sean Bergenheim,2008-09,24.0,5,9,28,28,4,5,9,63.0,372.0,46,5,6,11,75.0,82,6.05,85,480,2458,10.1
24801,Sean Bergenheim,2010-11,26.0,6,22,78,78,10,12,22,155.0,878.0,124,15,18,33,230.0,82,5.44,62,351,2383,9.4
24802,Sean Bergenheim,2011-12,27.0,7,24,59,59,15,9,24,152.0,841.0,183,30,27,57,382.0,82,5.7,65,341,2477,9.4
24803,Sean Bergenheim,2012-13,28.0,8,23,63,63,10,13,23,133.0,886.0,246,40,40,80,515.0,82,5.53,56,304,2486,9.1
24804,Sean Bergenheim,2013-14,29.0,9,29,80,80,14,15,29,182.0,1118.0,326,54,55,109,697.0,82,5.46,52,291,2492,9.0
24805,Sean Bergenheim,2014-15,30.0,10,23,62,62,17,6,23,185.0,1018.0,388,71,61,132,882.0,82,5.32,47,271,2439,8.9
24806,Sean Bergenheim,2016-17,32.0,11,29,62,62,16,13,29,190.0,1023.0,450,87,74,161,1072.0,82,5.34,48,269,2463,8.9
24807,Sean Bergenheim,2017-18,33.0,12,19,56,56,9,10,19,108.0,735.0,506,96,84,180,1180.0,82,5.32,47,251,2453,8.9
24808,Sean Brown,1999-00,23.0,4,0,5,5,0,0,0,2.0,,5,0,0,0,2.0,82,5.83,55,336,2444,9.8
24809,Sean Brown,2000-01,24.0,5,1,18,18,0,1,1,9.0,,23,0,1,1,11.0,82,5.28,57,380,2242,9.6
24810,Sean Brown,2001-02,25.0,6,7,51,51,0,7,7,27.0,624.0,74,0,8,8,38.0,82,5.27,57,359,2285,9.4
24811,Sean Brown,2002-03,26.0,7,12,72,72,4,8,12,36.0,914.0,146,4,16,20,74.0,82,5.49,53,331,2294,9.8
24812,Sean Brown,2003-04,27.0,8,5,62,62,2,3,5,30.0,690.0,208,6,19,25,104.0,82,5.51,63,376,2272,9.9
24813,Sean Brown,2004-05,28.0,9,11,73,73,6,5,11,64.0,965.0,281,12,24,36,168.0,82,5.24,53,338,2262,9.5
24814,Sean Brown,2005-06,29.0,10,6,69,69,1,5,6,39.0,444.0,350,13,29,42,207.0,82,5.31,60,363,2326,9.4
24815,Sean Brown,2006-07,30.0,11,3,39,39,0,3,3,25.0,544.0,389,13,32,45,232.0,82,5.14,57,348,2300,9.2
24816,Sean Brown,2008-09,32.0,12,12,47,47,1,11,12,49.0,709.0,436,14,43,57,281.0,82,6.05,85,480,2458,10.1
24817,Sean Collins,2011-12,28.0,4,2,15,15,1,1,2,14.0,218.0,15,1,1,2,14.0,82,5.7,65,341,2477,9.4
24818,Sean Collins,2013-14,30.0,5,1,4,4,1,0,1,4.0,59.0,19,2,1,3,18.0,82,5.46,52,291,2492,9.0
24819,Sean Collins,2014-15,31.0,6,0,2,2,0,0,0,3.0,22.0,21,2,1,3,21.0,82,5.32,47,271,2439,8.9
24820,Sean Collins0,2015-16,27.0,4,0,5,5,0,0,0,0.0,62.0,5,0,0,0,0.0,48,5.31,29,160,1399,9.1
24821,Sean Collins0,2016-17,28.0,5,1,6,6,0,1,1,6.0,49.0,11,0,1,1,6.0,82,5.34,48,269,2463,8.9
24822,Sean Collins0,2017-18,29.0,6,2,8,8,0,2,2,4.0,83.0,19,0,3,3,10.0,82,5.32,47,251,2453,8.9
24823,Sean Collins0,2018-19,30.0,7,0,2,2,0,0,0,0.0,17.0,21,0,3,3,10.0,82,5.34,48,255,2438,9.0
24824,Sean Couturier,2014-15,22.0,4,27,77,77,13,14,27,116.0,1089.0,77,13,14,27,116.0,82,5.32,47,271,2439,8.9
24825,Sean Couturier,2015-16,23.0,5,15,46,46,4,11,15,75.0,731.0,123,17,25,42,191.0,48,5.31,29,160,1399,9.1
24826,Sean Couturier,2016-17,24.0,6,39,82,82,13,26,39,165.0,1565.0,205,30,51,81,356.0,82,5.34,48,269,2463,8.9
24827,Sean Couturier,2017-18,25.0,7,37,82,82,15,22,37,148.0,1508.0,287,45,73,118,504.0,82,5.32,47,251,2453,8.9
24828,Sean Couturier,2018-19,26.0,8,39,63,63,11,28,39,119.0,1172.0,350,56,101,157,623.0,82,5.34,48,255,2438,9.0
24829,Sean Couturier,2019-20,27.0,9,34,66,66,14,20,34,120.0,1217.0,416,70,121,191,743.0,82,5.45,47,245,2478,9.0
24830,Sean Couturier,2020-21,28.0,10,76,82,82,31,45,76,227.0,1771.0,498,101,166,267,970.0,82,5.86,50,250,2620,9.2
24831,Sean Couturier,2021-22,29.0,11,76,80,80,33,43,76,223.0,1770.0,578,134,209,343,1193.0,82,5.96,47,239,2579,9.5
24832,Sean Couturier,2022-23,30.0,12,59,69,69,22,37,59,185.0,1368.0,647,156,246,402,1378.0,70,5.96,42,208,2192,9.5
24833,Sean Gagnon,2000-01,27.0,4,1,5,5,0,1,1,3.0,,5,0,1,1,3.0,82,5.28,57,380,2242,9.6
24834,Sean Gagnon,2001-02,28.0,5,0,2,2,0,0,0,1.0,16.0,7,0,1,1,4.0,82,5.27,57,359,2285,9.4
24835,Sean Gagnon,2003-04,30.0,6,0,5,5,0,0,0,0.0,54.0,12,0,1,1,4.0,82,5.51,63,376,2272,9.9
24836,Sean Haggerty,1998-99,22.0,4,0,1,1,0,0,0,0.0,,1,0,0,0,0.0,82,6.29,74,413,2481,10.4
24837,Sean Haggerty,2000-01,24.0,5,0,5,5,0,0,0,2.0,,6,0,0,0,2.0,82,5.28,57,380,2242,9.6
24838,Sean Haggerty,2002-03,26.0,6,2,5,5,1,1,2,2.0,48.0,11,1,1,2,4.0,82,5.49,53,331,2294,9.8
24839,Sean Haggerty,2003-04,27.0,7,1,3,3,0,1,1,2.0,26.0,14,1,2,3,6.0,82,5.51,63,376,2272,9.9
24840,Sean Hill,1995-96,25.0,4,8,31,31,2,6,8,37.0,,31,2,6,8,37.0,84,7.25,87,443,2603,11.7
24841,Sean Hill,1996-97,26.0,5,27,68,68,7,20,27,165.0,,99,9,26,35,202.0,84,6.48,76,407,2545,10.7
24842,Sean Hill,1997-98,27.0,6,15,45,45,1,14,15,107.0,,144,10,40,50,309.0,48,5.97,37,209,1408,10.2
24843,Sean Hill,1998-99,28.0,7,21,80,80,7,14,21,157.0,,224,17,54,71,466.0,82,6.29,74,413,2481,10.4
24844,Sean Hill,1999-00,29.0,8,0,5,5,0,0,0,9.0,,229,17,54,71,475.0,82,5.83,55,336,2444,9.8
24845,Sean Hill,2000-01,30.0,9,7,55,55,1,6,7,53.0,,284,18,60,78,528.0,82,5.28,57,380,2242,9.6
24846,Sean Hill,2001-02,31.0,10,10,54,54,0,10,10,44.0,1028.0,338,18,70,88,572.0,82,5.27,57,359,2285,9.4
24847,Sean Hill,2002-03,32.0,11,44,62,62,13,31,44,150.0,1520.0,400,31,101,132,722.0,82,5.49,53,331,2294,9.8
24848,Sean Hill,2003-04,33.0,12,11,48,48,1,10,11,47.0,835.0,448,32,111,143,769.0,82,5.51,63,376,2272,9.9
24849,Sean Hill,2004-05,34.0,13,33,72,72,7,26,33,145.0,1541.0,520,39,137,176,914.0,82,5.24,53,338,2262,9.5
24850,Sean Hill,2005-06,35.0,14,29,82,82,5,24,29,188.0,1996.0,602,44,161,205,1102.0,82,5.31,60,363,2326,9.4
24851,Sean Hill,2006-07,36.0,15,39,80,80,13,26,39,228.0,2032.0,682,57,187,244,1330.0,82,5.14,57,348,2300,9.2
24852,Sean Hill,2008-09,38.0,16,20,78,78,2,18,20,110.0,1572.0,760,59,205,264,1440.0,82,6.05,85,480,2458,10.1
24853,Sean Hill,2009-10,39.0,17,25,81,81,1,24,25,88.0,1826.0,841,60,229,289,1528.0,82,5.76,70,398,2426,9.7
24854,Sean Hill,2010-11,40.0,18,9,35,35,2,7,9,18.0,532.0,876,62,236,298,1546.0,82,5.44,62,351,2383,9.4
24855,Sean Kuraly,2019-20,27.0,4,1,8,8,0,1,1,11.0,74.0,8,0,1,1,11.0,82,5.45,47,245,2478,9.0
24856,Sean Kuraly,2020-21,28.0,5,14,75,75,6,8,14,134.0,919.0,83,6,9,15,145.0,82,5.86,50,250,2620,9.2
24857,Sean Kuraly,2021-22,29.0,6,21,71,71,8,13,21,134.0,978.0,154,14,22,36,279.0,82,5.96,47,239,2579,9.5
24858,Sean Kuraly,2022-23,30.0,7,23,69,69,6,17,23,95.0,917.0,223,20,39,59,374.0,70,5.96,42,208,2192,9.5
24859,Sean Malone,2019-20,24.0,4,0,1,1,0,0,0,1.0,12.0,1,0,0,0,1.0,82,5.45,47,245,2478,9.0
24860,Sean McKenna,1984-85,22.0,4,1,3,3,0,1,1,6.0,,3,0,1,1,6.0,80,8.03,73,320,2489,12.9
24861,Sean McKenna,1985-86,23.0,5,24,46,46,10,14,24,62.0,,49,10,15,25,68.0,80,7.73,71,310,2444,12.7
24862,Sean McKenna,1986-87,24.0,6,30,78,78,20,10,30,107.0,,127,30,25,55,175.0,80,7.89,74,336,2448,12.9
24863,Sean McKenna,1987-88,25.0,7,36,65,65,20,16,36,110.0,,192,50,41,91,285.0,80,7.77,71,321,2447,12.7
24864,Sean McKenna,1988-89,26.0,8,22,75,75,10,12,22,130.0,,267,60,53,113,415.0,80,7.94,82,370,2484,12.8
24865,Sean McKenna,1989-90,27.0,9,33,69,69,14,19,33,102.0,,336,74,72,146,517.0,80,7.34,72,344,2400,12.2
24866,Sean McKenna,1990-91,28.0,10,15,70,70,8,7,15,80.0,,406,82,79,161,597.0,80,7.43,89,437,2435,12.2
24867,Sean McKenna,1991-92,29.0,11,1,3,3,0,1,1,1.0,,409,82,80,162,598.0,80,7.48,85,403,2430,12.3
24868,Sean McKenna,1992-93,30.0,12,0,5,5,0,0,0,6.0,,414,82,80,162,604.0,80,7.37,76,367,2421,12.2
24869,Sean McMorrow,2005-06,24.0,4,0,1,1,0,0,0,0.0,1.0,1,0,0,0,0.0,82,5.31,60,363,2326,9.4
24870,Sean Monahan,2016-17,22.0,4,34,75,75,22,12,34,140.0,1198.0,75,22,12,34,140.0,82,5.34,48,269,2463,8.9
24871,Sean Monahan,2017-18,23.0,5,62,81,81,31,31,62,191.0,1589.0,156,53,43,96,331.0,82,5.32,47,251,2453,8.9
24872,Sean Monahan,2018-19,24.0,6,63,81,81,27,36,63,197.0,1552.0,237,80,79,159,528.0,82,5.34,48,255,2438,9.0
24873,Sean Monahan,2019-20,25.0,7,58,82,82,27,31,58,199.0,1441.0,319,107,110,217,727.0,82,5.45,47,245,2478,9.0
24874,Sean Monahan,2020-21,26.0,8,64,74,74,31,33,64,202.0,1382.0,393,138,143,281,929.0,82,5.86,50,250,2620,9.2
24875,Sean Monahan,2021-22,27.0,9,82,78,78,34,48,82,211.0,1486.0,471,172,191,363,1140.0,82,5.96,47,239,2579,9.5
24876,Sean Monahan,2022-23,28.0,10,48,70,70,22,26,48,166.0,1267.0,541,194,217,411,1306.0,70,5.96,42,208,2192,9.5
24877,Sean O'Donnell,1997-98,26.0,4,2,15,15,0,2,2,12.0,,15,0,2,2,12.0,48,5.97,37,209,1408,10.2
24878,Sean O'Donnell,1998-99,27.0,5,7,71,71,2,5,7,65.0,,86,2,7,9,77.0,82,6.29,74,413,2481,10.4
24879,Sean O'Donnell,1999-00,28.0,6,17,55,55,5,12,17,68.0,,141,7,19,26,145.0,82,5.83,55,336,2444,9.8
24880,Sean O'Donnell,2000-01,29.0,7,17,80,80,2,15,17,71.0,,221,9,34,43,216.0,82,5.28,57,380,2242,9.6
24881,Sean O'Donnell,2001-02,30.0,8,14,80,80,1,13,14,64.0,1533.0,301,10,47,57,280.0,82,5.27,57,359,2285,9.4
24882,Sean O'Donnell,2002-03,31.0,9,14,80,80,2,12,14,51.0,1415.0,381,12,59,71,331.0,82,5.49,53,331,2294,9.8
24883,Sean O'Donnell,2003-04,32.0,10,17,80,80,4,13,17,67.0,1729.0,461,16,72,88,398.0,82,5.51,63,376,2272,9.9
24884,Sean O'Donnell,2004-05,33.0,11,25,80,80,3,22,25,112.0,1986.0,541,19,94,113,510.0,82,5.24,53,338,2262,9.5
24885,Sean O'Donnell,2005-06,34.0,12,16,70,70,1,15,16,61.0,1546.0,611,20,109,129,571.0,82,5.31,60,363,2326,9.4
24886,Sean O'Donnell,2006-07,35.0,13,11,82,82,1,10,11,72.0,1689.0,693,21,119,140,643.0,82,5.14,57,348,2300,9.2
24887,Sean O'Donnell,2008-09,37.0,14,11,78,78,2,9,11,33.0,1291.0,771,23,128,151,676.0,82,6.05,85,480,2458,10.1
24888,Sean O'Donnell,2009-10,38.0,15,17,79,79,2,15,17,47.0,1574.0,850,25,143,168,723.0,82,5.76,70,398,2426,9.7
24889,Sean O'Donnell,2010-11,39.0,16,9,82,82,2,7,9,25.0,1413.0,932,27,150,177,748.0,82,5.44,62,351,2383,9.4
24890,Sean O'Donnell,2011-12,40.0,17,12,82,82,0,12,12,32.0,1680.0,1014,27,162,189,780.0,82,5.7,65,341,2477,9.4
24891,Sean O'Donnell,2012-13,41.0,18,15,78,78,3,12,15,44.0,1462.0,1092,30,174,204,824.0,82,5.53,56,304,2486,9.1
24892,Sean O'Donnell,2013-14,42.0,19,18,81,81,1,17,18,34.0,1259.0,1173,31,191,222,858.0,82,5.46,52,291,2492,9.0
24893,Sean O'Donnell,2014-15,43.0,20,7,51,51,0,7,7,30.0,689.0,1224,31,198,229,888.0,82,5.32,47,271,2439,8.9
24894,Sean Pronger,1998-99,26.0,4,1,7,7,0,1,1,3.0,,7,0,1,1,3.0,82,6.29,74,413,2481,10.4
24895,Sean Pronger,1999-00,27.0,5,14,39,39,7,7,14,43.0,,46,7,8,15,46.0,82,5.83,55,336,2444,9.8
24896,Sean Pronger,2000-01,28.0,6,21,67,67,6,15,21,73.0,,113,13,23,36,119.0,82,5.28,57,380,2242,9.6
24897,Sean Pronger,2001-02,29.0,7,4,29,29,0,4,4,14.0,251.0,142,13,27,40,133.0,82,5.27,57,359,2285,9.4
24898,Sean Pronger,2002-03,30.0,8,1,11,11,0,1,1,7.0,119.0,153,13,28,41,140.0,82,5.49,53,331,2294,9.8
24899,Sean Pronger,2004-05,32.0,9,4,26,26,3,1,4,25.0,297.0,179,16,29,45,165.0,82,5.24,53,338,2262,9.5
24900,Sean Pronger,2005-06,33.0,10,13,78,78,7,6,13,67.0,899.0,257,23,35,58,232.0,82,5.31,60,363,2326,9.4
24901,Sean Pronger,2006-07,34.0,11,1,3,3,0,1,1,6.0,31.0,260,23,36,59,238.0,82,5.14,57,348,2300,9.2
24902,Sean Selmser,2003-04,29.0,4,0,1,1,0,0,0,2.0,11.0,1,0,0,0,2.0,82,5.51,63,376,2272,9.9
24903,Sean Toomey,1989-90,24.0,4,0,1,1,0,0,0,2.0,,1,0,0,0,2.0,80,7.34,72,344,2400,12.2
24904,Sean Walker,2021-22,27.0,4,10,39,39,3,7,10,55.0,602.0,39,3,7,10,55.0,82,5.96,47,239,2579,9.5
24905,Sean Walker,2022-23,28.0,5,24,70,70,5,19,24,127.0,1319.0,109,8,26,34,182.0,70,5.96,42,208,2192,9.5
24906,Sean Whyte,1994-95,24.0,4,0,3,3,0,0,0,0.0,,3,0,0,0,0.0,80,6.96,77,402,2440,11.4
24907,Sean Whyte,1995-96,25.0,5,2,18,18,0,2,2,7.0,,21,0,2,2,7.0,84,7.25,87,443,2603,11.7
24908,Sean Williams,1994-95,27.0,4,0,2,2,0,0,0,0.0,,2,0,0,0,0.0,80,6.96,77,402,2440,11.4
24909,Sebastian Aho,2019-20,22.0,4,49,82,82,24,25,49,214.0,1377.0,82,24,25,49,214.0,82,5.45,47,245,2478,9.0
24910,Sebastian Aho,2020-21,23.0,5,65,78,78,29,36,65,200.0,1398.0,160,53,61,114,414.0,82,5.86,50,250,2620,9.2
24911,Sebastian Aho,2021-22,24.0,6,83,82,82,30,53,83,243.0,1652.0,242,83,114,197,657.0,82,5.96,47,239,2579,9.5
24912,Sebastian Aho,2022-23,25.0,7,66,68,68,38,28,66,206.0,1321.0,310,121,142,263,863.0,70,5.96,42,208,2192,9.5
24913,Sebastian Aho0,2020-21,24.0,4,4,22,22,1,3,4,24.0,357.0,22,1,3,4,24.0,82,5.86,50,250,2620,9.2
24914,Sebastien Bisaillon,2009-10,23.0,4,0,2,2,0,0,0,3.0,28.0,2,0,0,0,3.0,82,5.76,70,398,2426,9.7
24915,Sebastien Bordeleau,1998-99,23.0,4,0,4,4,0,0,0,0.0,,4,0,0,0,0.0,82,6.29,74,413,2481,10.4
24916,Sebastien Bordeleau,1999-00,24.0,5,11,28,28,2,9,11,27.0,,32,2,9,11,27.0,82,5.83,55,336,2444,9.8
24917,Sebastien Bordeleau,2000-01,25.0,6,14,53,53,6,8,14,55.0,,85,8,17,25,82.0,82,5.28,57,380,2242,9.6
24918,Sebastien Bordeleau,2001-02,26.0,7,40,72,72,16,24,40,168.0,1102.0,157,24,41,65,250.0,82,5.27,57,359,2285,9.4
24919,Sebastien Bordeleau,2002-03,27.0,8,23,60,60,10,13,23,127.0,836.0,217,34,54,88,377.0,82,5.49,53,331,2294,9.8
24920,Sebastien Bordeleau,2003-04,28.0,9,5,14,14,2,3,5,20.0,177.0,231,36,57,93,397.0,82,5.51,63,376,2272,9.9
24921,Sebastien Bordeleau,2004-05,29.0,10,5,20,20,1,4,5,28.0,237.0,251,37,61,98,425.0,82,5.24,53,338,2262,9.5
24922,Selmar Odelein,1988-89,22.0,4,0,4,4,0,0,0,2.0,,4,0,0,0,2.0,80,7.94,82,370,2484,12.8
24923,Selmar Odelein,1990-91,24.0,5,2,12,12,0,2,2,17.0,,16,0,2,2,19.0,80,7.43,89,437,2435,12.2
24924,Selmar Odelein,1991-92,25.0,6,0,2,2,0,0,0,0.0,,18,0,2,2,19.0,80,7.48,85,403,2430,12.3
24925,Serge Aubin,2001-02,26.0,4,0,1,1,0,0,0,1.0,4.0,1,0,0,0,1.0,82,5.27,57,359,2285,9.4
24926,Serge Aubin,2002-03,27.0,5,3,15,15,2,1,3,14.0,99.0,16,2,1,3,15.0,82,5.49,53,331,2294,9.8
24927,Serge Aubin,2003-04,28.0,6,30,81,81,13,17,30,110.0,1324.0,97,15,18,33,125.0,82,5.51,63,376,2272,9.9
24928,Serge Aubin,2004-05,29.0,7,16,71,71,8,8,16,86.0,1100.0,168,23,26,49,211.0,82,5.24,53,338,2262,9.5
24929,Serge Aubin,2005-06,30.0,8,10,66,66,4,6,10,62.0,789.0,234,27,32,59,273.0,82,5.31,60,363,2326,9.4
24930,Serge Aubin,2006-07,31.0,9,25,66,66,10,15,25,97.0,1056.0,300,37,47,84,370.0,82,5.14,57,348,2300,9.2
24931,Serge Aubin,2008-09,33.0,10,24,74,74,7,17,24,82.0,821.0,374,44,64,108,452.0,82,6.05,85,480,2458,10.1
24932,Serge Beaudoin,1982-83,30.0,4,0,3,3,0,0,0,1.0,,3,0,0,0,1.0,80,7.03,61,280,2352,12.0
24933,Serge Boisvert,1985-86,26.0,4,2,17,17,0,2,2,18.0,,17,0,2,2,18.0,80,7.73,71,310,2444,12.7
24934,Serge Boisvert,1987-88,28.0,5,4,14,14,2,2,4,18.0,,31,2,4,6,36.0,80,7.77,71,321,2447,12.7
24935,Serge Boisvert,1988-89,29.0,6,4,9,9,2,2,4,18.0,,40,4,6,10,54.0,80,7.94,82,370,2484,12.8
24936,Serge Boisvert,1989-90,30.0,7,0,1,1,0,0,0,0.0,,41,4,6,10,54.0,80,7.34,72,344,2400,12.2
24937,Serge Boisvert,1990-91,31.0,8,2,5,5,1,1,2,5.0,,46,5,7,12,59.0,80,7.43,89,437,2435,12.2
24938,Serge Payer,2003-04,24.0,4,6,43,43,5,1,6,34.0,320.0,43,5,1,6,34.0,82,5.51,63,376,2272,9.9
24939,Serge Payer,2006-07,27.0,5,1,5,5,0,1,1,2.0,53.0,48,5,2,7,36.0,82,5.14,57,348,2300,9.2
24940,Serge Payer,2008-09,29.0,6,6,71,71,2,4,6,70.0,702.0,119,7,6,13,106.0,82,6.05,85,480,2458,10.1
24941,Serge Payer,2009-10,30.0,7,0,5,5,0,0,0,4.0,35.0,124,7,6,13,110.0,82,5.76,70,398,2426,9.7
24942,Serge Roberge,1993-94,28.0,4,0,9,9,0,0,0,0.0,,9,0,0,0,0.0,80,6.91,71,366,2385,11.6
24943,Sergei Bautin,1995-96,28.0,4,23,71,71,5,18,23,82.0,,71,5,18,23,82.0,84,7.25,87,443,2603,11.7
24944,Sergei Bautin,1996-97,29.0,5,7,60,60,0,7,7,39.0,,131,5,25,30,121.0,84,6.48,76,407,2545,10.7
24945,Sergei Bautin,1998-99,31.0,6,0,1,1,0,0,0,0.0,,132,5,25,30,121.0,82,6.29,74,413,2481,10.4
24946,Sergei Berezin,1999-00,28.0,4,41,73,73,25,16,41,177.0,,73,25,16,41,177.0,82,5.83,55,336,2444,9.8
24947,Sergei Berezin,2000-01,29.0,5,31,68,68,16,15,31,167.0,,141,41,31,72,344.0,82,5.28,57,380,2242,9.6
24948,Sergei Berezin,2001-02,30.0,6,59,76,76,37,22,59,263.0,1181.0,217,78,53,131,607.0,82,5.27,57,359,2285,9.4
24949,Sergei Berezin,2002-03,31.0,7,39,61,61,26,13,39,241.0,1029.0,278,104,66,170,848.0,82,5.49,53,331,2294,9.8
24950,Sergei Berezin,2003-04,32.0,8,50,79,79,22,28,50,256.0,1239.0,357,126,94,220,1104.0,82,5.51,63,376,2272,9.9
24951,Sergei Berezin,2004-05,33.0,9,26,70,70,11,15,26,200.0,1044.0,427,137,109,246,1304.0,82,5.24,53,338,2262,9.5
24952,Sergei Berezin,2005-06,34.0,10,40,75,75,23,17,40,199.0,1217.0,502,160,126,286,1503.0,82,5.31,60,363,2326,9.4
24953,Sergei Brylin,1997-98,24.0,4,14,26,26,6,8,14,41.0,,26,6,8,14,41.0,48,5.97,37,209,1408,10.2
24954,Sergei Brylin,1998-99,25.0,5,9,50,50,4,5,9,51.0,,76,10,13,23,92.0,82,6.29,74,413,2481,10.4
24955,Sergei Brylin,1999-00,26.0,6,4,29,29,2,2,4,34.0,,105,12,15,27,126.0,82,5.83,55,336,2444,9.8
24956,Sergei Brylin,2000-01,27.0,7,5,18,18,2,3,5,20.0,,123,14,18,32,146.0,82,5.28,57,380,2242,9.6
24957,Sergei Brylin,2001-02,28.0,8,15,47,47,5,10,15,51.0,607.0,170,19,28,47,197.0,82,5.27,57,359,2285,9.4
24958,Sergei Brylin,2002-03,29.0,9,20,64,64,9,11,20,84.0,857.0,234,28,39,67,281.0,82,5.49,53,331,2294,9.8
24959,Sergei Brylin,2003-04,30.0,10,52,75,75,23,29,52,130.0,1163.0,309,51,68,119,411.0,82,5.51,63,376,2272,9.9
24960,Sergei Brylin,2004-05,31.0,11,44,76,76,16,28,44,133.0,1306.0,385,67,96,163,544.0,82,5.24,53,338,2262,9.5
24961,Sergei Brylin,2005-06,32.0,12,19,52,52,11,8,19,86.0,841.0,437,78,104,182,630.0,82,5.31,60,363,2326,9.4
24962,Sergei Brylin,2006-07,33.0,13,33,82,82,14,19,33,98.0,1346.0,519,92,123,215,728.0,82,5.14,57,348,2300,9.2
24963,Sergei Brylin,2008-09,35.0,14,37,82,82,15,22,37,126.0,1290.0,601,107,145,252,854.0,82,6.05,85,480,2458,10.1
24964,Sergei Brylin,2009-10,36.0,15,40,82,82,16,24,40,97.0,1456.0,683,123,169,292,951.0,82,5.76,70,398,2426,9.7
24965,Sergei Brylin,2010-11,37.0,16,16,82,82,6,10,16,65.0,1111.0,765,129,179,308,1016.0,82,5.44,62,351,2383,9.4
24966,Sergei Fedorov,1993-94,24.0,4,79,77,77,31,48,79,259.0,,77,31,48,79,259.0,80,6.91,71,366,2385,11.6
24967,Sergei Fedorov,1994-95,25.0,5,86,80,80,32,54,86,249.0,,157,63,102,165,508.0,80,6.96,77,402,2440,11.4
24968,Sergei Fedorov,1995-96,26.0,6,87,73,73,34,53,87,217.0,,230,97,155,252,725.0,84,7.25,87,443,2603,11.7
24969,Sergei Fedorov,1996-97,27.0,7,120,82,82,56,64,120,337.0,,312,153,219,372,1062.0,84,6.48,76,407,2545,10.7
24970,Sergei Fedorov,1997-98,28.0,8,50,42,42,20,30,50,147.0,,354,173,249,422,1209.0,48,5.97,37,209,1408,10.2
24971,Sergei Fedorov,1998-99,29.0,9,107,78,78,39,68,107,306.0,,432,212,317,529,1515.0,82,6.29,74,413,2481,10.4
24972,Sergei Fedorov,1999-00,30.0,10,63,74,74,30,33,63,273.0,,506,242,350,592,1788.0,82,5.83,55,336,2444,9.8
24973,Sergei Fedorov,2000-01,31.0,11,17,21,21,6,11,17,68.0,,527,248,361,609,1856.0,82,5.28,57,380,2242,9.6
24974,Sergei Fedorov,2001-02,32.0,12,63,77,77,26,37,63,224.0,1490.0,604,274,398,672,2080.0,82,5.27,57,359,2285,9.4
24975,Sergei Fedorov,2002-03,33.0,13,62,68,68,27,35,62,263.0,1366.0,672,301,433,734,2343.0,82,5.49,53,331,2294,9.8
24976,Sergei Fedorov,2003-04,34.0,14,69,75,75,32,37,69,268.0,1581.0,747,333,470,803,2611.0,82,5.51,63,376,2272,9.9
24977,Sergei Fedorov,2004-05,35.0,15,68,81,81,31,37,68,256.0,1583.0,828,364,507,871,2867.0,82,5.24,53,338,2262,9.5
24978,Sergei Fedorov,2005-06,36.0,16,83,80,80,36,47,83,281.0,1694.0,908,400,554,954,3148.0,82,5.31,60,363,2326,9.4
24979,Sergei Fedorov,2006-07,37.0,17,65,80,80,31,34,65,268.0,1686.0,988,431,588,1019,3416.0,82,5.14,57,348,2300,9.2
24980,Sergei Fedorov,2008-09,39.0,18,44,67,67,12,32,44,160.0,1409.0,1055,443,620,1063,3576.0,82,6.05,85,480,2458,10.1
24981,Sergei Fedorov,2009-10,40.0,19,42,73,73,18,24,42,163.0,1455.0,1128,461,644,1105,3739.0,82,5.76,70,398,2426,9.7
24982,Sergei Fedorov,2010-11,41.0,20,41,68,68,11,30,41,128.0,1202.0,1196,472,674,1146,3867.0,82,5.44,62,351,2383,9.4
24983,Sergei Fedorov,2011-12,42.0,21,33,52,52,11,22,33,118.0,859.0,1248,483,696,1179,3985.0,82,5.7,65,341,2477,9.4
24984,Sergei Gonchar,1997-98,23.0,4,7,31,31,2,5,7,38.0,,31,2,5,7,38.0,48,5.97,37,209,1408,10.2
24985,Sergei Gonchar,1998-99,24.0,5,41,78,78,15,26,41,139.0,,109,17,31,48,177.0,82,6.29,74,413,2481,10.4
24986,Sergei Gonchar,1999-00,25.0,6,30,57,57,13,17,30,129.0,,166,30,48,78,306.0,82,5.83,55,336,2444,9.8
24987,Sergei Gonchar,2000-01,26.0,7,21,72,72,5,16,21,134.0,,238,35,64,99,440.0,82,5.28,57,380,2242,9.6
24988,Sergei Gonchar,2001-02,27.0,8,31,53,53,21,10,31,180.0,1268.0,291,56,74,130,620.0,82,5.27,57,359,2285,9.4
24989,Sergei Gonchar,2002-03,28.0,9,54,73,73,18,36,54,181.0,1589.0,364,74,110,184,801.0,82,5.49,53,331,2294,9.8
24990,Sergei Gonchar,2003-04,29.0,10,57,76,76,19,38,57,241.0,1705.0,440,93,148,241,1042.0,82,5.51,63,376,2272,9.9
24991,Sergei Gonchar,2004-05,30.0,11,59,76,76,26,33,59,216.0,1813.0,516,119,181,300,1258.0,82,5.24,53,338,2262,9.5
24992,Sergei Gonchar,2005-06,31.0,12,67,82,82,18,49,67,224.0,2179.0,598,137,230,367,1482.0,82,5.31,60,363,2326,9.4
24993,Sergei Gonchar,2006-07,32.0,13,58,71,71,11,47,58,161.0,1948.0,669,148,277,425,1643.0,82,5.14,57,348,2300,9.2
24994,Sergei Gonchar,2008-09,34.0,14,58,75,75,12,46,58,192.0,1850.0,744,160,323,483,1835.0,82,6.05,85,480,2458,10.1
24995,Sergei Gonchar,2009-10,35.0,15,67,82,82,13,54,67,191.0,2178.0,826,173,377,550,2026.0,82,5.76,70,398,2426,9.7
24996,Sergei Gonchar,2010-11,36.0,16,65,78,78,12,53,65,173.0,2021.0,904,185,430,615,2199.0,82,5.44,62,351,2383,9.4
24997,Sergei Gonchar,2011-12,37.0,17,19,25,25,6,13,19,71.0,630.0,929,191,443,634,2270.0,82,5.7,65,341,2477,9.4
24998,Sergei Gonchar,2012-13,38.0,18,50,62,62,11,39,50,138.0,1513.0,991,202,482,684,2408.0,82,5.53,56,304,2486,9.1
24999,Sergei Gonchar,2013-14,39.0,19,27,67,67,7,20,27,107.0,1554.0,1058,209,502,711,2515.0,82,5.46,52,291,2492,9.0
25000,Sergei Gonchar,2014-15,40.0,20,37,74,74,5,32,37,131.0,1647.0,1132,214,534,748,2646.0,82,5.32,47,271,2439,8.9
25001,Sergei Gonchar,2015-16,41.0,21,27,45,45,3,24,27,85.0,1080.0,1177,217,558,775,2731.0,48,5.31,29,160,1399,9.1
25002,Sergei Gonchar,2016-17,42.0,22,22,76,76,2,20,22,89.0,1338.0,1253,219,578,797,2820.0,82,5.34,48,269,2463,8.9
25003,Sergei Gonchar,2017-18,43.0,23,14,48,48,1,13,14,46.0,849.0,1301,220,591,811,2866.0,82,5.32,47,251,2453,8.9
25004,Sergei Kharin,1993-94,30.0,4,5,7,7,2,3,5,13.0,,7,2,3,5,13.0,80,6.91,71,366,2385,11.6
25005,Sergei Klimovich,1999-00,25.0,4,0,1,1,0,0,0,0.0,,1,0,0,0,0.0,82,5.83,55,336,2444,9.8
25006,Sergei Kostitsyn,2010-11,23.0,4,27,52,52,9,18,27,49.0,746.0,52,9,18,27,49.0,82,5.44,62,351,2383,9.4
25007,Sergei Kostitsyn,2011-12,24.0,5,23,56,56,8,15,23,74.0,792.0,108,17,33,50,123.0,82,5.7,65,341,2477,9.4
25008,Sergei Kostitsyn,2012-13,25.0,6,18,47,47,7,11,18,59.0,666.0,155,24,44,68,182.0,82,5.53,56,304,2486,9.1
25009,Sergei Kostitsyn,2013-14,26.0,7,50,77,77,23,27,50,93.0,1170.0,232,47,71,118,275.0,82,5.46,52,291,2492,9.0
25010,Sergei Kostitsyn,2014-15,27.0,8,43,75,75,17,26,43,97.0,1235.0,307,64,97,161,372.0,82,5.32,47,271,2439,8.9
25011,Sergei Kostitsyn,2015-16,28.0,9,15,46,46,3,12,15,42.0,769.0,353,67,109,176,414.0,48,5.31,29,160,1399,9.1
25012,Sergei Krivokrasov,1995-96,21.0,4,0,4,4,0,0,0,0.0,,4,0,0,0,0.0,84,7.25,87,443,2603,11.7
25013,Sergei Krivokrasov,1996-97,22.0,5,1,9,9,1,0,1,7.0,,13,1,0,1,7.0,84,6.48,76,407,2545,10.7
25014,Sergei Krivokrasov,1997-98,23.0,6,19,41,41,12,7,19,72.0,,54,13,7,20,79.0,48,5.97,37,209,1408,10.2
25015,Sergei Krivokrasov,1998-99,24.0,7,16,46,46,6,10,16,52.0,,100,19,17,36,131.0,82,6.29,74,413,2481,10.4
25016,Sergei Krivokrasov,1999-00,25.0,8,24,67,67,13,11,24,104.0,,167,32,28,60,235.0,82,5.83,55,336,2444,9.8
25017,Sergei Krivokrasov,2000-01,26.0,9,23,58,58,10,13,23,127.0,,225,42,41,83,362.0,82,5.28,57,380,2242,9.6
25018,Sergei Krivokrasov,2001-02,27.0,10,48,70,70,25,23,48,208.0,1129.0,295,67,64,131,570.0,82,5.27,57,359,2285,9.4
25019,Sergei Krivokrasov,2002-03,28.0,11,37,75,75,10,27,37,159.0,988.0,370,77,91,168,729.0,82,5.49,53,331,2294,9.8
25020,Sergei Krivokrasov,2003-04,29.0,12,22,54,54,7,15,22,107.0,706.0,424,84,106,190,836.0,82,5.51,63,376,2272,9.9
25021,Sergei Krivokrasov,2004-05,30.0,13,5,26,26,2,3,5,51.0,315.0,450,86,109,195,887.0,82,5.24,53,338,2262,9.5
25022,Sergei Makarov,1992-93,34.0,4,86,80,80,24,62,86,118.0,,80,24,62,86,118.0,80,7.37,76,367,2421,12.2
25023,Sergei Makarov,1993-94,35.0,5,79,78,78,30,49,79,93.0,,158,54,111,165,211.0,80,6.91,71,366,2385,11.6
25024,Sergei Makarov,1994-95,36.0,6,70,68,68,22,48,70,83.0,,226,76,159,235,294.0,80,6.96,77,402,2440,11.4
25025,Sergei Makarov,1995-96,37.0,7,57,71,71,18,39,57,105.0,,297,94,198,292,399.0,84,7.25,87,443,2603,11.7
25026,Sergei Makarov,1996-97,38.0,8,68,80,80,30,38,68,155.0,,377,124,236,360,554.0,84,6.48,76,407,2545,10.7
25027,Sergei Makarov,1997-98,39.0,9,24,43,43,10,14,24,56.0,,420,134,250,384,610.0,48,5.97,37,209,1408,10.2
25028,Sergei Makarov,1999-00,41.0,10,0,4,4,0,0,0,0.0,,424,134,250,384,610.0,82,5.83,55,336,2444,9.8
25029,Sergei Nemchinov,1994-95,31.0,4,58,73,73,30,28,58,124.0,,73,30,28,58,124.0,80,6.96,77,402,2440,11.4
25030,Sergei Nemchinov,1995-96,32.0,5,54,81,81,23,31,54,144.0,,154,53,59,112,268.0,84,7.25,87,443,2603,11.7
25031,Sergei Nemchinov,1996-97,33.0,6,49,76,76,22,27,49,144.0,,230,75,86,161,412.0,84,6.48,76,407,2545,10.7
25032,Sergei Nemchinov,1997-98,34.0,7,13,47,47,7,6,13,67.0,,277,82,92,174,479.0,48,5.97,37,209,1408,10.2
25033,Sergei Nemchinov,1998-99,35.0,8,32,78,78,17,15,32,118.0,,355,99,107,206,597.0,82,6.29,74,413,2481,10.4
25034,Sergei Nemchinov,1999-00,36.0,9,24,69,69,8,16,24,97.0,,424,107,123,230,694.0,82,5.83,55,336,2444,9.8
25035,Sergei Nemchinov,2000-01,37.0,10,29,74,74,10,19,29,94.0,,498,117,142,259,788.0,82,5.28,57,380,2242,9.6
25036,Sergei Nemchinov,2001-02,38.0,11,20,77,77,12,8,20,74.0,1117.0,575,129,150,279,862.0,82,5.27,57,359,2285,9.4
25037,Sergei Nemchinov,2002-03,39.0,12,26,53,53,10,16,26,55.0,726.0,628,139,166,305,917.0,82,5.49,53,331,2294,9.8
25038,Sergei Nemchinov,2003-04,40.0,13,30,65,65,8,22,30,70.0,859.0,693,147,188,335,987.0,82,5.51,63,376,2272,9.9
25039,Sergei Nemchinov,2004-05,41.0,14,10,68,68,5,5,10,49.0,759.0,761,152,193,345,1036.0,82,5.24,53,338,2262,9.5
25040,Sergei Petrenko,1996-97,28.0,4,4,14,14,0,4,4,7.0,,14,0,4,4,7.0,84,6.48,76,407,2545,10.7
25041,Sergei Plotnikov,2018-19,28.0,4,3,45,45,0,3,3,41.0,445.0,45,0,3,3,41.0,82,5.34,48,255,2438,9.0
25042,Sergei Priakin,1991-92,28.0,4,0,2,2,0,0,0,2.0,,2,0,0,0,2.0,80,7.48,85,403,2430,12.3
25043,Sergei Priakin,1992-93,29.0,5,4,20,20,2,2,4,17.0,,22,2,2,4,19.0,80,7.37,76,367,2421,12.2
25044,Sergei Priakin,1993-94,30.0,6,7,24,24,1,6,7,26.0,,46,3,8,11,45.0,80,6.91,71,366,2385,11.6
25045,Sergei Samsonov,2000-01,22.0,4,47,81,81,22,25,47,159.0,,81,22,25,47,159.0,82,5.28,57,380,2242,9.6
25046,Sergei Samsonov,2001-02,23.0,5,51,79,79,25,26,51,160.0,1294.0,160,47,51,98,319.0,82,5.27,57,359,2285,9.4
25047,Sergei Samsonov,2002-03,24.0,6,45,77,77,19,26,45,145.0,1273.0,237,66,77,143,464.0,82,5.49,53,331,2294,9.8
25048,Sergei Samsonov,2003-04,25.0,7,75,82,82,29,46,75,215.0,1590.0,319,95,123,218,679.0,82,5.51,63,376,2272,9.9
25049,Sergei Samsonov,2004-05,26.0,8,70,74,74,29,41,70,192.0,1390.0,393,124,164,288,871.0,82,5.24,53,338,2262,9.5
25050,Sergei Samsonov,2005-06,27.0,9,11,8,8,5,6,11,23.0,163.0,401,129,170,299,894.0,82,5.31,60,363,2326,9.4
25051,Sergei Samsonov,2006-07,28.0,10,40,58,58,17,23,40,132.0,1012.0,459,146,193,339,1026.0,82,5.14,57,348,2300,9.2
25052,Sergei Samsonov,2008-09,30.0,11,53,74,74,23,30,53,143.0,1222.0,533,169,223,392,1169.0,82,6.05,85,480,2458,10.1
25053,Sergei Samsonov,2009-10,31.0,12,26,63,63,9,17,26,114.0,881.0,596,178,240,418,1283.0,82,5.76,70,398,2426,9.7
25054,Sergei Samsonov,2010-11,32.0,13,36,61,61,14,22,36,109.0,970.0,657,192,262,454,1392.0,82,5.44,62,351,2383,9.4
25055,Sergei Samsonov,2011-12,33.0,14,48,81,81,16,32,48,155.0,1403.0,738,208,294,502,1547.0,82,5.7,65,341,2477,9.4
25056,Sergei Samsonov,2012-13,34.0,15,29,72,72,14,15,29,104.0,963.0,810,222,309,531,1651.0,82,5.53,56,304,2486,9.1
25057,Sergei Samsonov,2013-14,35.0,16,40,78,78,13,27,40,123.0,1205.0,888,235,336,571,1774.0,82,5.46,52,291,2492,9.0
25058,Sergei Shirokov,2012-13,26.0,4,0,6,6,0,0,0,4.0,77.0,6,0,0,0,4.0,82,5.53,56,304,2486,9.1
25059,Sergei Shirokov,2013-14,27.0,5,1,2,2,1,0,1,6.0,21.0,8,1,0,1,10.0,82,5.46,52,291,2492,9.0
25060,Sergei Starikov,1992-93,34.0,4,1,16,16,0,1,1,6.0,,16,0,1,1,6.0,80,7.37,76,367,2421,12.2
25061,Sergei Varlamov,2000-01,22.0,4,0,1,1,0,0,0,0.0,,1,0,0,0,0.0,82,5.28,57,380,2242,9.6
25062,Sergei Varlamov,2002-03,24.0,5,3,7,7,3,0,3,11.0,73.0,8,3,0,3,11.0,82,5.49,53,331,2294,9.8
25063,Sergei Varlamov,2004-05,26.0,6,12,52,52,5,7,12,83.0,581.0,60,8,7,15,94.0,82,5.24,53,338,2262,9.5
25064,Sergei Varlamov,2005-06,27.0,7,0,3,3,0,0,0,5.0,34.0,63,8,7,15,99.0,82,5.31,60,363,2326,9.4
25065,Sergei Vyshedkevich,2002-03,28.0,4,4,7,7,1,3,4,5.0,163.0,7,1,3,4,5.0,82,5.49,53,331,2294,9.8
25066,Sergei Vyshedkevich,2003-04,29.0,5,3,23,23,1,2,3,28.0,473.0,30,2,5,7,33.0,82,5.51,63,376,2272,9.9
25067,Sergei Zholtok,1995-96,23.0,4,1,1,1,0,1,1,2.0,,1,0,1,1,2.0,84,7.25,87,443,2603,11.7
25068,Sergei Zholtok,1996-97,24.0,5,3,24,24,2,1,3,25.0,,25,2,2,4,27.0,84,6.48,76,407,2545,10.7
25069,Sergei Zholtok,1999-00,27.0,6,28,57,57,12,16,28,96.0,,82,14,18,32,123.0,82,5.83,55,336,2444,9.8
25070,Sergei Zholtok,2000-01,28.0,7,23,78,78,10,13,23,127.0,,160,24,31,55,250.0,82,5.28,57,380,2242,9.6
25071,Sergei Zholtok,2001-02,29.0,8,22,70,70,7,15,22,102.0,783.0,230,31,46,77,352.0,82,5.27,57,359,2285,9.4
25072,Sergei Zholtok,2002-03,30.0,9,38,68,68,26,12,38,163.0,1175.0,298,57,58,115,515.0,82,5.49,53,331,2294,9.8
25073,Sergei Zholtok,2003-04,31.0,10,31,69,69,5,26,31,139.0,979.0,367,62,84,146,654.0,82,5.51,63,376,2272,9.9
25074,Sergei Zholtok,2004-05,32.0,11,39,73,73,19,20,39,146.0,1173.0,440,81,104,185,800.0,82,5.24,53,338,2262,9.5
25075,Sergei Zholtok,2005-06,33.0,12,42,78,78,16,26,42,153.0,1294.0,518,97,130,227,953.0,82,5.31,60,363,2326,9.4
25076,Sergei Zholtok,2006-07,34.0,13,31,70,70,14,17,31,132.0,1085.0,588,111,147,258,1085.0,82,5.14,57,348,2300,9.2
25077,Sergei Zinovjev,2006-07,26.0,4,1,10,10,0,1,1,8.0,98.0,10,0,1,1,8.0,82,5.14,57,348,2300,9.2
25078,Sergei Zubov,1995-96,25.0,4,31,49,49,8,23,31,93.0,,49,8,23,31,93.0,84,7.25,87,443,2603,11.7
25079,Sergei Zubov,1996-97,26.0,5,89,78,78,12,77,89,222.0,,127,20,100,120,315.0,84,6.48,76,407,2545,10.7
25080,Sergei Zubov,1997-98,27.0,6,36,38,38,10,26,36,116.0,,165,30,126,156,431.0,48,5.97,37,209,1408,10.2
25081,Sergei Zubov,1998-99,28.0,7,66,64,64,11,55,66,141.0,,229,41,181,222,572.0,82,6.29,74,413,2481,10.4
25082,Sergei Zubov,1999-00,29.0,8,43,78,78,13,30,43,133.0,,307,54,211,265,705.0,82,5.83,55,336,2444,9.8
25083,Sergei Zubov,2000-01,30.0,9,57,73,73,10,47,57,148.0,,380,64,258,322,853.0,82,5.28,57,380,2242,9.6
25084,Sergei Zubov,2001-02,31.0,10,51,81,81,10,41,51,155.0,1963.0,461,74,299,373,1008.0,82,5.27,57,359,2285,9.4
25085,Sergei Zubov,2002-03,32.0,11,42,77,77,9,33,42,179.0,2220.0,538,83,332,415,1187.0,82,5.49,53,331,2294,9.8
25086,Sergei Zubov,2003-04,33.0,12,51,79,79,10,41,51,173.0,2102.0,617,93,373,466,1360.0,82,5.51,63,376,2272,9.9
25087,Sergei Zubov,2004-05,34.0,13,44,80,80,12,32,44,198.0,2142.0,697,105,405,510,1558.0,82,5.24,53,338,2262,9.5
25088,Sergei Zubov,2005-06,35.0,14,55,82,82,11,44,55,158.0,2118.0,779,116,449,565,1716.0,82,5.31,60,363,2326,9.4
25089,Sergei Zubov,2006-07,36.0,15,42,77,77,7,35,42,154.0,1990.0,856,123,484,607,1870.0,82,5.14,57,348,2300,9.2
25090,Sergei Zubov,2008-09,38.0,16,71,78,78,13,58,71,141.0,2063.0,934,136,542,678,2011.0,82,6.05,85,480,2458,10.1
25091,Sergei Zubov,2009-10,39.0,17,54,78,78,12,42,54,156.0,2024.0,1012,148,584,732,2167.0,82,5.76,70,398,2426,9.7
25092,Sergei Zubov,2010-11,40.0,18,35,46,46,4,31,35,84.0,1182.0,1058,152,615,767,2251.0,82,5.44,62,351,2383,9.4
25093,Sergei Zubov,2011-12,41.0,19,4,10,10,0,4,4,15.0,243.0,1068,152,619,771,2266.0,82,5.7,65,341,2477,9.4
25094,Sergey Gusev,2000-01,25.0,4,0,9,9,0,0,0,5.0,,9,0,0,0,5.0,82,5.28,57,380,2242,9.6
25095,Sergey Gusev,2001-02,26.0,5,8,36,36,1,7,8,46.0,566.0,45,1,7,8,51.0,82,5.27,57,359,2285,9.4
25096,Sergey Gusev,2002-03,27.0,6,5,28,28,2,3,5,23.0,492.0,73,3,10,13,74.0,82,5.49,53,331,2294,9.8
25097,Sergey Gusev,2003-04,28.0,7,1,16,16,1,0,1,13.0,214.0,89,4,10,14,87.0,82,5.51,63,376,2272,9.9
25098,Sergey Kalinin,2018-19,27.0,4,15,78,78,8,7,15,70.0,1039.0,78,8,7,15,70.0,82,5.34,48,255,2438,9.0
25099,Sergey Kalinin,2019-20,28.0,5,4,43,43,2,2,4,38.0,550.0,121,10,9,19,108.0,82,5.45,47,245,2478,9.0
25100,Sergey Tolchinsky,2018-19,23.0,4,1,2,2,0,1,1,1.0,24.0,2,0,1,1,1.0,82,5.34,48,255,2438,9.0
25101,Sergey Tolchinsky,2019-20,24.0,5,1,2,2,0,1,1,2.0,23.0,4,0,2,2,3.0,82,5.45,47,245,2478,9.0
25102,Sergio Momesso,1986-87,21.0,4,0,1,1,0,0,0,0.0,,1,0,0,0,0.0,80,7.89,74,336,2448,12.9
25103,Sergio Momesso,1988-89,23.0,5,15,24,24,8,7,15,37.0,,25,8,7,15,37.0,80,7.94,82,370,2484,12.8
25104,Sergio Momesso,1989-90,24.0,6,31,59,59,14,17,31,95.0,,84,22,24,46,132.0,80,7.34,72,344,2400,12.2
25105,Sergio Momesso,1990-91,25.0,7,21,53,53,7,14,21,72.0,,137,29,38,67,204.0,80,7.43,89,437,2435,12.2
25106,Sergio Momesso,1991-92,26.0,8,26,53,53,9,17,26,81.0,,190,38,55,93,285.0,80,7.48,85,403,2430,12.3
25107,Sergio Momesso,1992-93,27.0,9,56,79,79,24,32,56,182.0,,269,62,87,149,467.0,80,7.37,76,367,2421,12.2
25108,Sergio Momesso,1993-94,28.0,10,36,70,70,16,20,36,119.0,,339,78,107,185,586.0,80,6.91,71,366,2385,11.6
25109,Sergio Momesso,1994-95,29.0,11,43,58,58,20,23,43,153.0,,397,98,130,228,739.0,80,6.96,77,402,2440,11.4
25110,Sergio Momesso,1995-96,30.0,12,38,84,84,18,20,38,146.0,,481,116,150,266,885.0,84,7.25,87,443,2603,11.7
25111,Sergio Momesso,1996-97,31.0,13,27,68,68,14,13,27,112.0,,549,130,163,293,997.0,84,6.48,76,407,2545,10.7
25112,Sergio Momesso,1997-98,32.0,14,25,48,48,10,15,25,82.0,,597,140,178,318,1079.0,48,5.97,37,209,1408,10.2
25113,Sergio Momesso,1998-99,33.0,15,23,73,73,11,12,23,126.0,,670,151,190,341,1205.0,82,6.29,74,413,2481,10.4
25114,Sergio Momesso,1999-00,34.0,16,4,40,40,1,3,4,43.0,,710,152,193,345,1248.0,82,5.83,55,336,2444,9.8
25115,Seth Griffith,2017-18,25.0,4,10,30,30,6,4,10,33.0,403.0,30,6,4,10,33.0,82,5.32,47,251,2453,8.9
25116,Seth Griffith,2018-19,26.0,5,1,4,4,0,1,1,2.0,40.0,34,6,5,11,35.0,82,5.34,48,255,2438,9.0
25117,Seth Griffith,2019-20,27.0,6,5,24,24,0,5,5,21.0,306.0,58,6,10,16,56.0,82,5.45,47,245,2478,9.0
25118,Seth Griffith,2020-21,28.0,7,3,21,21,2,1,3,15.0,222.0,79,8,11,19,71.0,82,5.86,50,250,2620,9.2
25119,Seth Helgeson,2017-18,27.0,4,2,22,22,0,2,2,11.0,296.0,22,0,2,2,11.0,82,5.32,47,251,2453,8.9
25120,Seth Helgeson,2018-19,28.0,5,1,19,19,0,1,1,9.0,265.0,41,0,3,3,20.0,82,5.34,48,255,2438,9.0
25121,Seth Helgeson,2019-20,29.0,6,1,9,9,1,0,1,3.0,121.0,50,1,3,4,23.0,82,5.45,47,245,2478,9.0
25122,Seth Jones,2016-17,22.0,4,25,77,77,6,19,25,100.0,1511.0,77,6,19,25,100.0,82,5.34,48,269,2463,8.9
25123,Seth Jones,2017-18,23.0,5,27,82,82,8,19,27,123.0,1630.0,159,14,38,52,223.0,82,5.32,47,251,2453,8.9
25124,Seth Jones,2018-19,24.0,6,31,81,81,3,28,31,157.0,1788.0,240,17,66,83,380.0,82,5.34,48,255,2438,9.0
25125,Seth Jones,2019-20,25.0,7,42,75,75,12,30,42,152.0,1755.0,315,29,96,125,532.0,82,5.45,47,245,2478,9.0
25126,Seth Jones,2020-21,26.0,8,57,78,78,16,41,57,249.0,1919.0,393,45,137,182,781.0,82,5.86,50,250,2620,9.2
25127,Seth Jones,2021-22,27.0,9,46,75,75,9,37,46,184.0,1937.0,468,54,174,228,965.0,82,5.96,47,239,2579,9.5
25128,Seth Jones,2022-23,28.0,10,30,56,56,6,24,30,126.0,1416.0,524,60,198,258,1091.0,70,5.96,42,208,2192,9.5
25129,Shane Churla,1989-90,24.0,4,1,20,20,0,1,1,2.0,,20,0,1,1,2.0,80,7.34,72,344,2400,12.2
25130,Shane Churla,1990-91,25.0,5,6,31,31,1,5,6,15.0,,51,1,6,7,17.0,80,7.43,89,437,2435,12.2
25131,Shane Churla,1991-92,26.0,6,1,18,18,1,0,1,8.0,,69,2,6,8,25.0,80,7.48,85,403,2430,12.3
25132,Shane Churla,1992-93,27.0,7,5,53,53,2,3,5,40.0,,122,4,9,13,65.0,80,7.37,76,367,2421,12.2
25133,Shane Churla,1993-94,28.0,8,4,40,40,2,2,4,32.0,,162,6,11,17,97.0,80,6.91,71,366,2385,11.6
25134,Shane Churla,1994-95,29.0,9,5,57,57,4,1,5,42.0,,219,10,12,22,139.0,80,6.96,77,402,2440,11.4
25135,Shane Churla,1995-96,30.0,10,21,73,73,5,16,21,61.0,,292,15,28,43,200.0,84,7.25,87,443,2603,11.7
25136,Shane Churla,1996-97,31.0,11,13,69,69,6,7,13,62.0,,361,21,35,56,262.0,84,6.48,76,407,2545,10.7
25137,Shane Churla,1997-98,32.0,12,4,27,27,1,3,4,22.0,,388,22,38,60,284.0,48,5.97,37,209,1408,10.2
25138,Shane Churla,1998-99,33.0,13,10,55,55,4,6,10,32.0,,443,26,44,70,316.0,82,6.29,74,413,2481,10.4
25139,Shane Churla,1999-00,34.0,14,1,45,45,0,1,1,19.0,,488,26,45,71,335.0,82,5.83,55,336,2444,9.8
25140,Shane Doan,1998-99,22.0,4,17,74,74,7,10,17,106.0,,74,7,10,17,106.0,82,6.29,74,413,2481,10.4
25141,Shane Doan,1999-00,23.0,5,12,63,63,4,8,12,100.0,,137,11,18,29,206.0,82,5.83,55,336,2444,9.8
25142,Shane Doan,2000-01,24.0,6,11,33,33,5,6,11,42.0,,170,16,24,40,248.0,82,5.28,57,380,2242,9.6
25143,Shane Doan,2001-02,25.0,7,22,79,79,6,16,22,156.0,1003.0,249,22,40,62,404.0,82,5.27,57,359,2285,9.4
25144,Shane Doan,2002-03,26.0,8,51,81,81,26,25,51,221.0,1365.0,330,48,65,113,625.0,82,5.49,53,331,2294,9.8
25145,Shane Doan,2003-04,27.0,9,63,76,76,26,37,63,220.0,1485.0,406,74,102,176,845.0,82,5.51,63,376,2272,9.9
25146,Shane Doan,2004-05,28.0,10,49,81,81,20,29,49,205.0,1471.0,487,94,131,225,1050.0,82,5.24,53,338,2262,9.5
25147,Shane Doan,2005-06,29.0,11,58,82,82,21,37,58,225.0,1540.0,569,115,168,283,1275.0,82,5.31,60,363,2326,9.4
25148,Shane Doan,2006-07,30.0,12,68,79,79,27,41,68,254.0,1719.0,648,142,209,351,1529.0,82,5.14,57,348,2300,9.2
25149,Shane Doan,2008-09,32.0,13,66,82,82,30,36,66,254.0,1568.0,730,172,245,417,1783.0,82,6.05,85,480,2458,10.1
25150,Shane Doan,2009-10,33.0,14,55,73,73,27,28,55,209.0,1493.0,803,199,273,472,1992.0,82,5.76,70,398,2426,9.7
25151,Shane Doan,2010-11,34.0,15,78,80,80,28,50,78,243.0,1661.0,883,227,323,550,2235.0,82,5.44,62,351,2383,9.4
25152,Shane Doan,2011-12,35.0,16,73,82,82,31,42,73,230.0,1660.0,965,258,365,623,2465.0,82,5.7,65,341,2477,9.4
25153,Shane Doan,2012-13,36.0,17,55,82,82,18,37,55,234.0,1571.0,1047,276,402,678,2699.0,82,5.53,56,304,2486,9.1
25154,Shane Doan,2013-14,37.0,18,60,72,72,20,40,60,221.0,1389.0,1119,296,442,738,2920.0,82,5.46,52,291,2492,9.0
25155,Shane Doan,2014-15,38.0,19,50,79,79,22,28,50,226.0,1548.0,1198,318,470,788,3146.0,82,5.32,47,271,2439,8.9
25156,Shane Doan,2015-16,39.0,20,27,48,48,13,14,27,129.0,867.0,1246,331,484,815,3275.0,48,5.31,29,160,1399,9.1
25157,Shane Doan,2016-17,40.0,21,47,69,69,23,24,47,167.0,1307.0,1315,354,508,862,3442.0,82,5.34,48,269,2463,8.9
25158,Shane Doan,2017-18,41.0,22,36,79,79,14,22,36,189.0,1492.0,1394,368,530,898,3631.0,82,5.32,47,251,2453,8.9
25159,Shane Doan,2018-19,42.0,23,47,72,72,28,19,47,170.0,1267.0,1466,396,549,945,3801.0,82,5.34,48,255,2438,9.0
25160,Shane Doan,2019-20,43.0,24,27,74,74,6,21,27,144.0,1114.0,1540,402,570,972,3945.0,82,5.45,47,245,2478,9.0
25161,Shane Endicott,2004-05,23.0,4,1,4,4,0,1,1,2.0,34.0,4,0,1,1,2.0,82,5.24,53,338,2262,9.5
25162,Shane Endicott,2008-09,27.0,5,2,41,41,1,1,2,44.0,480.0,45,1,2,3,46.0,82,6.05,85,480,2458,10.1
25163,Shane Gersich,2020-21,24.0,4,1,3,3,0,1,1,4.0,27.0,3,0,1,1,4.0,82,5.86,50,250,2620,9.2
25164,Shane Harper,2019-20,30.0,4,3,14,14,2,1,3,13.0,144.0,14,2,1,3,13.0,82,5.45,47,245,2478,9.0
25165,Shane Hnidy,2003-04,28.0,4,5,52,52,3,2,5,47.0,681.0,52,3,2,5,47.0,82,5.51,63,376,2272,9.9
25166,Shane Hnidy,2004-05,29.0,5,2,33,33,1,1,2,34.0,559.0,85,4,3,7,81.0,82,5.24,53,338,2262,9.5
25167,Shane Hnidy,2005-06,30.0,6,8,67,67,0,8,8,58.0,932.0,152,4,11,15,139.0,82,5.31,60,363,2326,9.4
25168,Shane Hnidy,2006-07,31.0,7,7,46,46,0,7,7,28.0,582.0,198,4,18,22,167.0,82,5.14,57,348,2300,9.2
25169,Shane Hnidy,2008-09,33.0,8,3,66,66,0,3,3,50.0,675.0,264,4,21,25,217.0,82,6.05,85,480,2458,10.1
25170,Shane Hnidy,2009-10,34.0,9,12,72,72,5,7,12,86.0,1126.0,336,9,28,37,303.0,82,5.76,70,398,2426,9.7
25171,Shane Hnidy,2010-11,35.0,10,8,76,76,2,6,8,49.0,1066.0,412,11,34,45,352.0,82,5.44,62,351,2383,9.4
25172,Shane Hnidy,2011-12,36.0,11,12,65,65,3,9,12,49.0,1016.0,477,14,43,57,401.0,82,5.7,65,341,2477,9.4
25173,Shane Hnidy,2012-13,37.0,12,14,70,70,2,12,14,49.0,948.0,547,16,55,71,450.0,82,5.53,56,304,2486,9.1
25174,Shane Hnidy,2013-14,38.0,13,0,3,3,0,0,0,3.0,44.0,550,16,55,71,453.0,82,5.46,52,291,2492,9.0
25175,Shane MacEachern,1990-91,23.0,4,0,1,1,0,0,0,0.0,,1,0,0,0,0.0,80,7.43,89,437,2435,12.2
25176,Shane O'Brien,2009-10,26.0,4,16,80,80,2,14,16,72.0,1198.0,80,2,14,16,72.0,82,5.76,70,398,2426,9.7
25177,Shane O'Brien,2010-11,27.0,5,21,77,77,4,17,21,69.0,1634.0,157,6,31,37,141.0,82,5.44,62,351,2383,9.4
25178,Shane O'Brien,2011-12,28.0,6,10,77,77,0,10,10,39.0,1149.0,234,6,41,47,180.0,82,5.7,65,341,2477,9.4
25179,Shane O'Brien,2012-13,29.0,7,8,65,65,2,6,8,37.0,1106.0,299,8,47,55,217.0,82,5.53,56,304,2486,9.1
25180,Shane O'Brien,2013-14,30.0,8,9,80,80,2,7,9,50.0,1369.0,379,10,54,64,267.0,82,5.46,52,291,2492,9.0
25181,Shane O'Brien,2014-15,31.0,9,20,76,76,3,17,20,114.0,1461.0,455,13,71,84,381.0,82,5.32,47,271,2439,8.9
25182,Shane O'Brien,2015-16,32.0,10,4,28,28,0,4,4,28.0,434.0,483,13,75,88,409.0,48,5.31,29,160,1399,9.1
25183,Shane O'Brien,2016-17,33.0,11,3,45,45,0,3,3,16.0,507.0,528,13,78,91,425.0,82,5.34,48,269,2463,8.9
25184,Shane O'Brien,2017-18,34.0,12,1,9,9,0,1,1,4.0,121.0,537,13,79,92,429.0,82,5.32,47,251,2453,8.9
25185,Shane Prince,2017-18,25.0,4,1,2,2,0,1,1,2.0,21.0,2,0,1,1,2.0,82,5.32,47,251,2453,8.9
25186,Shane Prince,2018-19,26.0,5,17,62,62,6,11,17,88.0,696.0,64,6,12,18,90.0,82,5.34,48,255,2438,9.0
25187,Shane Prince,2019-20,27.0,6,18,50,50,5,13,18,71.0,649.0,114,11,25,36,161.0,82,5.45,47,245,2478,9.0
25188,Shane Prince,2020-21,28.0,7,2,14,14,1,1,2,20.0,168.0,128,12,26,38,181.0,82,5.86,50,250,2620,9.2
25189,Shane Sims,2013-14,25.0,4,0,1,1,0,0,0,0.0,7.0,1,0,0,0,0.0,82,5.46,52,291,2492,9.0
25190,Shane Willis,2001-02,24.0,4,0,7,7,0,0,0,1.0,16.0,7,0,0,0,1.0,82,5.27,57,359,2285,9.4
25191,Shane Willis,2002-03,25.0,5,0,2,2,0,0,0,1.0,12.0,9,0,0,0,2.0,82,5.49,53,331,2294,9.8
25192,Shane Willis,2003-04,26.0,6,44,73,73,20,24,44,172.0,1166.0,82,20,24,44,174.0,82,5.51,63,376,2272,9.9
25193,Shane Willis,2004-05,27.0,7,24,80,80,11,13,24,155.0,1004.0,162,31,37,68,329.0,82,5.24,53,338,2262,9.5
25194,Shane Willis,2006-07,29.0,8,6,12,12,0,6,6,27.0,166.0,174,31,43,74,356.0,82,5.14,57,348,2300,9.2
25195,Shaone Morrisonn,2005-06,23.0,4,0,11,11,0,0,0,4.0,98.0,11,0,0,0,4.0,82,5.31,60,363,2326,9.4
25196,Shaone Morrisonn,2006-07,24.0,5,8,33,33,1,7,8,14.0,602.0,44,1,7,8,18.0,82,5.14,57,348,2300,9.2
25197,Shaone Morrisonn,2008-09,26.0,6,14,80,80,1,13,14,56.0,1658.0,124,2,20,22,74.0,82,6.05,85,480,2458,10.1
25198,Shaone Morrisonn,2009-10,27.0,7,13,78,78,3,10,13,46.0,1634.0,202,5,30,35,120.0,82,5.76,70,398,2426,9.7
25199,Shaone Morrisonn,2010-11,28.0,8,10,76,76,1,9,10,47.0,1540.0,278,6,39,45,167.0,82,5.44,62,351,2383,9.4
25200,Shaone Morrisonn,2011-12,29.0,9,13,72,72,3,10,13,50.0,1295.0,350,9,49,58,217.0,82,5.7,65,341,2477,9.4
25201,Shaone Morrisonn,2012-13,30.0,10,12,68,68,1,11,12,32.0,1195.0,418,10,60,70,249.0,82,5.53,56,304,2486,9.1
25202,Shaone Morrisonn,2013-14,31.0,11,5,62,62,1,4,5,44.0,1003.0,480,11,64,75,293.0,82,5.46,52,291,2492,9.0
25203,Shaun Heshka,2012-13,27.0,4,2,8,8,0,2,2,3.0,107.0,8,0,2,2,3.0,82,5.53,56,304,2486,9.1
25204,Shaun Sabol,1992-93,26.0,4,0,2,2,0,0,0,2.0,,2,0,0,0,2.0,80,7.37,76,367,2421,12.2
25205,Shaun Van Allen,1993-94,26.0,4,0,2,2,0,0,0,0.0,,2,0,0,0,0.0,80,6.91,71,366,2385,11.6
25206,Shaun Van Allen,1995-96,28.0,5,5,21,21,1,4,5,19.0,,23,1,4,5,19.0,84,7.25,87,443,2603,11.7
25207,Shaun Van Allen,1996-97,29.0,6,33,80,80,8,25,33,104.0,,103,9,29,38,123.0,84,6.48,76,407,2545,10.7
25208,Shaun Van Allen,1997-98,30.0,7,29,45,45,8,21,29,68.0,,148,17,50,67,191.0,48,5.97,37,209,1408,10.2
25209,Shaun Van Allen,1998-99,31.0,8,25,49,49,8,17,25,78.0,,197,25,67,92,269.0,82,6.29,74,413,2481,10.4
25210,Shaun Van Allen,1999-00,32.0,9,25,80,80,11,14,25,123.0,,277,36,81,117,392.0,82,5.83,55,336,2444,9.8
25211,Shaun Van Allen,2000-01,33.0,10,19,80,80,4,15,19,104.0,,357,40,96,136,496.0,82,5.28,57,380,2242,9.6
25212,Shaun Van Allen,2001-02,34.0,11,17,79,79,6,11,17,47.0,878.0,436,46,107,153,543.0,82,5.27,57,359,2285,9.4
25213,Shaun Van Allen,2002-03,35.0,12,28,75,75,9,19,28,75.0,886.0,511,55,126,181,618.0,82,5.49,53,331,2294,9.8
25214,Shaun Van Allen,2003-04,36.0,13,23,59,59,7,16,23,51.0,712.0,570,62,142,204,669.0,82,5.51,63,376,2272,9.9
25215,Shaun Van Allen,2004-05,37.0,14,21,73,73,8,13,21,48.0,794.0,643,70,155,225,717.0,82,5.24,53,338,2262,9.5
25216,Shaun Van Allen,2005-06,38.0,15,32,78,78,12,20,32,53.0,974.0,721,82,175,257,770.0,82,5.31,60,363,2326,9.4
25217,Shaun Van Allen,2006-07,39.0,16,12,73,73,2,10,12,41.0,839.0,794,84,185,269,811.0,82,5.14,57,348,2300,9.2
25218,Shawn Anderson,1989-90,21.0,4,13,41,41,2,11,13,26.0,,41,2,11,13,26.0,80,7.34,72,344,2400,12.2
25219,Shawn Anderson,1990-91,22.0,5,3,23,23,1,2,3,29.0,,64,3,13,16,55.0,80,7.43,89,437,2435,12.2
25220,Shawn Anderson,1991-92,23.0,6,12,33,33,2,10,12,26.0,,97,5,23,28,81.0,80,7.48,85,403,2430,12.3
25221,Shawn Anderson,1992-93,24.0,7,4,16,16,1,3,4,16.0,,113,6,26,32,97.0,80,7.37,76,367,2421,12.2
25222,Shawn Anderson,1993-94,25.0,8,13,31,31,3,10,13,44.0,,144,9,36,45,141.0,80,6.91,71,366,2385,11.6
25223,Shawn Anderson,1995-96,27.0,9,8,60,60,2,6,8,42.0,,204,11,42,53,183.0,84,7.25,87,443,2603,11.7
25224,Shawn Anderson,1996-97,28.0,10,9,50,50,0,9,9,31.0,,254,11,51,62,214.0,84,6.48,76,407,2545,10.7
25225,Shawn Anderson,1997-98,29.0,11,0,1,1,0,0,0,0.0,,255,11,51,62,214.0,48,5.97,37,209,1408,10.2
25226,Shawn Antoski,1993-94,23.0,4,0,2,2,0,0,0,2.0,,2,0,0,0,2.0,80,6.91,71,366,2385,11.6
25227,Shawn Antoski,1994-95,24.0,5,0,4,4,0,0,0,6.0,,6,0,0,0,8.0,80,6.96,77,402,2440,11.4
25228,Shawn Antoski,1995-96,25.0,6,0,2,2,0,0,0,0.0,,8,0,0,0,8.0,84,7.25,87,443,2603,11.7
25229,Shawn Antoski,1996-97,26.0,7,3,55,55,1,2,3,25.0,,63,1,2,3,33.0,84,6.48,76,407,2545,10.7
25230,Shawn Antoski,1997-98,27.0,8,0,32,32,0,0,0,16.0,,95,1,2,3,49.0,48,5.97,37,209,1408,10.2
25231,Shawn Antoski,1998-99,28.0,9,4,64,64,1,3,4,34.0,,159,2,5,7,83.0,82,6.29,74,413,2481,10.4
25232,Shawn Antoski,1999-00,29.0,10,0,15,15,0,0,0,3.0,,174,2,5,7,86.0,82,5.83,55,336,2444,9.8
25233,Shawn Antoski,2000-01,30.0,11,1,9,9,1,0,1,6.0,,183,3,5,8,92.0,82,5.28,57,380,2242,9.6
25234,Shawn Bates,2000-01,25.0,4,2,13,13,2,0,2,12.0,,13,2,0,2,12.0,82,5.28,57,380,2242,9.6
25235,Shawn Bates,2001-02,26.0,5,9,33,33,5,4,9,30.0,283.0,46,7,4,11,42.0,82,5.27,57,359,2285,9.4
25236,Shawn Bates,2002-03,27.0,6,12,44,44,5,7,12,65.0,478.0,90,12,11,23,107.0,82,5.49,53,331,2294,9.8
25237,Shawn Bates,2003-04,28.0,7,5,45,45,2,3,5,59.0,419.0,135,14,14,28,166.0,82,5.51,63,376,2272,9.9
25238,Shawn Bates,2004-05,29.0,8,52,71,71,17,35,52,150.0,1332.0,206,31,49,80,316.0,82,5.24,53,338,2262,9.5
25239,Shawn Bates,2005-06,30.0,9,42,74,74,13,29,42,126.0,1364.0,280,44,78,122,442.0,82,5.31,60,363,2326,9.4
25240,Shawn Bates,2006-07,31.0,10,32,69,69,9,23,32,115.0,1272.0,349,53,101,154,557.0,82,5.14,57,348,2300,9.2
25241,Shawn Bates,2008-09,33.0,11,34,66,66,15,19,34,95.0,1135.0,415,68,120,188,652.0,82,6.05,85,480,2458,10.1
25242,Shawn Bates,2009-10,34.0,12,10,48,48,4,6,10,50.0,601.0,463,72,126,198,702.0,82,5.76,70,398,2426,9.7
25243,Shawn Bates,2010-11,35.0,13,0,2,2,0,0,0,0.0,14.0,465,72,126,198,702.0,82,5.44,62,351,2383,9.4
25244,Shawn Belle,2009-10,25.0,4,1,9,9,0,1,1,3.0,89.0,9,0,1,1,3.0,82,5.76,70,398,2426,9.7
25245,Shawn Belle,2012-13,28.0,5,0,2,2,0,0,0,1.0,21.0,11,0,1,1,4.0,82,5.53,56,304,2486,9.1
25246,Shawn Belle,2013-14,29.0,6,0,9,9,0,0,0,8.0,154.0,20,0,1,1,12.0,82,5.46,52,291,2492,9.0
25247,Shawn Burr,1987-88,21.0,4,0,9,9,0,0,0,4.0,,9,0,0,0,4.0,80,7.77,71,321,2447,12.7
25248,Shawn Burr,1988-89,22.0,5,1,5,5,1,0,1,6.0,,14,1,0,1,10.0,80,7.94,82,370,2484,12.8
25249,Shawn Burr,1989-90,23.0,6,47,80,80,22,25,47,153.0,,94,23,25,48,163.0,80,7.34,72,344,2400,12.2
25250,Shawn Burr,1990-91,24.0,7,40,78,78,17,23,40,124.0,,172,40,48,88,287.0,80,7.43,89,437,2435,12.2
25251,Shawn Burr,1991-92,25.0,8,46,79,79,19,27,46,149.0,,251,59,75,134,436.0,80,7.48,85,403,2430,12.3
25252,Shawn Burr,1992-93,26.0,9,56,76,76,24,32,56,173.0,,327,83,107,190,609.0,80,7.37,76,367,2421,12.2
25253,Shawn Burr,1993-94,27.0,10,50,80,80,20,30,50,164.0,,407,103,137,240,773.0,80,6.91,71,366,2385,11.6
25254,Shawn Burr,1994-95,28.0,11,51,79,79,19,32,51,140.0,,486,122,169,291,913.0,80,6.96,77,402,2440,11.4
25255,Shawn Burr,1995-96,29.0,12,35,80,80,10,25,35,99.0,,566,132,194,326,1012.0,84,7.25,87,443,2603,11.7
25256,Shawn Burr,1996-97,30.0,13,22,51,51,10,12,22,64.0,,617,142,206,348,1076.0,84,6.48,76,407,2545,10.7
25257,Shawn Burr,1997-98,31.0,14,14,42,42,6,8,14,65.0,,659,148,214,362,1141.0,48,5.97,37,209,1408,10.2
25258,Shawn Burr,1998-99,32.0,15,28,81,81,13,15,28,122.0,,740,161,229,390,1263.0,82,6.29,74,413,2481,10.4
25259,Shawn Burr,1999-00,33.0,16,35,74,74,14,21,35,128.0,,814,175,250,425,1391.0,82,5.83,55,336,2444,9.8
25260,Shawn Burr,2000-01,34.0,17,12,42,42,6,6,12,63.0,,856,181,256,437,1454.0,82,5.28,57,380,2242,9.6
25261,Shawn Burr,2001-02,35.0,18,1,18,18,0,1,1,22.0,157.0,874,181,257,438,1476.0,82,5.27,57,359,2285,9.4
25262,Shawn Burr,2002-03,36.0,19,2,4,4,0,2,2,6.0,46.0,878,181,259,440,1482.0,82,5.49,53,331,2294,9.8
25263,Shawn Byram,1993-94,25.0,4,0,4,4,0,0,0,2.0,,4,0,0,0,2.0,80,6.91,71,366,2385,11.6
25264,Shawn Byram,1994-95,26.0,5,0,1,1,0,0,0,1.0,,5,0,0,0,3.0,80,6.96,77,402,2440,11.4
25265,Shawn Chambers,1990-91,24.0,4,8,19,19,1,7,8,28.0,,19,1,7,8,28.0,80,7.43,89,437,2435,12.2
25266,Shawn Chambers,1991-92,25.0,5,24,72,72,5,19,24,131.0,,91,6,26,32,159.0,80,7.48,85,403,2430,12.3
25267,Shawn Chambers,1992-93,26.0,6,26,78,78,8,18,26,116.0,,169,14,44,58,275.0,80,7.37,76,367,2421,12.2
25268,Shawn Chambers,1993-94,27.0,7,4,29,29,1,3,4,55.0,,198,15,47,62,330.0,80,6.91,71,366,2385,11.6
25269,Shawn Chambers,1994-95,28.0,8,0,2,2,0,0,0,1.0,,200,15,47,62,331.0,80,6.96,77,402,2440,11.4
25270,Shawn Chambers,1995-96,29.0,9,39,55,55,10,29,39,152.0,,255,25,76,101,483.0,84,7.25,87,443,2603,11.7
25271,Shawn Chambers,1996-97,30.0,10,34,66,66,11,23,34,142.0,,321,36,99,135,625.0,84,6.48,76,407,2545,10.7
25272,Shawn Chambers,1997-98,31.0,11,21,45,45,4,17,21,67.0,,366,40,116,156,692.0,48,5.97,37,209,1408,10.2
25273,Shawn Chambers,1998-99,32.0,12,23,64,64,2,21,23,112.0,,430,42,137,179,804.0,82,6.29,74,413,2481,10.4
25274,Shawn Chambers,1999-00,33.0,13,21,73,73,4,17,21,114.0,,503,46,154,200,918.0,82,5.83,55,336,2444,9.8
25275,Shawn Chambers,2000-01,34.0,14,24,57,57,2,22,24,73.0,,560,48,176,224,991.0,82,5.28,57,380,2242,9.6
25276,Shawn Chambers,2001-02,35.0,15,11,61,61,2,9,11,82.0,1060.0,621,50,185,235,1073.0,82,5.27,57,359,2285,9.4
25277,Shawn Chambers,2002-03,36.0,16,0,4,4,0,0,0,2.0,92.0,625,50,185,235,1075.0,82,5.49,53,331,2294,9.8
25278,Shawn Cronin,1991-92,28.0,4,0,1,1,0,0,0,0.0,,1,0,0,0,0.0,80,7.48,85,403,2430,12.3
25279,Shawn Cronin,1992-93,29.0,5,4,61,61,0,4,4,30.0,,62,0,4,4,30.0,80,7.37,76,367,2421,12.2
25280,Shawn Cronin,1993-94,30.0,6,6,67,67,1,5,6,40.0,,129,1,9,10,70.0,80,6.91,71,366,2385,11.6
25281,Shawn Cronin,1994-95,31.0,7,4,65,65,0,4,4,25.0,,194,1,13,14,95.0,80,6.96,77,402,2440,11.4
25282,Shawn Cronin,1995-96,32.0,8,3,35,35,2,1,3,12.0,,229,3,14,17,107.0,84,7.25,87,443,2603,11.7
25283,Shawn Cronin,1996-97,33.0,9,2,34,34,0,2,2,14.0,,263,3,16,19,121.0,84,6.48,76,407,2545,10.7
25284,Shawn Cronin,1997-98,34.0,10,2,29,29,0,2,2,12.0,,292,3,18,21,133.0,48,5.97,37,209,1408,10.2
25285,Shawn Evans,1988-89,23.0,4,0,7,7,0,0,0,1.0,,7,0,0,0,1.0,80,7.94,82,370,2484,12.8
25286,Shawn Evans,1992-93,27.0,5,1,2,2,1,0,1,4.0,,9,1,0,1,5.0,80,7.37,76,367,2421,12.2
25287,Shawn Heaphy,1995-96,27.0,4,0,1,1,0,0,0,2.0,,1,0,0,0,2.0,84,7.25,87,443,2603,11.7
25288,Shawn Heins,2001-02,28.0,4,0,5,5,0,0,0,4.0,68.0,5,0,0,0,4.0,82,5.27,57,359,2285,9.4
25289,Shawn Heins,2002-03,29.0,5,0,1,1,0,0,0,1.0,11.0,6,0,0,0,5.0,82,5.49,53,331,2294,9.8
25290,Shawn Heins,2003-04,30.0,6,7,38,38,3,4,7,45.0,389.0,44,3,4,7,50.0,82,5.51,63,376,2272,9.9
25291,Shawn Heins,2004-05,31.0,7,2,17,17,0,2,2,20.0,166.0,61,3,6,9,70.0,82,5.24,53,338,2262,9.5
25292,Shawn Heins,2005-06,32.0,8,3,47,47,1,2,3,38.0,689.0,108,4,8,12,108.0,82,5.31,60,363,2326,9.4
25293,Shawn Heins,2006-07,33.0,9,4,17,17,0,4,4,17.0,236.0,125,4,12,16,125.0,82,5.14,57,348,2300,9.2
25294,Shawn Horcoff,2003-04,25.0,4,16,49,49,9,7,16,42.0,452.0,49,9,7,16,42.0,82,5.51,63,376,2272,9.9
25295,Shawn Horcoff,2004-05,26.0,5,22,61,61,8,14,22,57.0,691.0,110,17,21,38,99.0,82,5.24,53,338,2262,9.5
25296,Shawn Horcoff,2005-06,27.0,6,33,78,78,12,21,33,98.0,1053.0,188,29,42,71,197.0,82,5.31,60,363,2326,9.4
25297,Shawn Horcoff,2006-07,28.0,7,40,80,80,15,25,40,110.0,1402.0,268,44,67,111,307.0,82,5.14,57,348,2300,9.2
25298,Shawn Horcoff,2008-09,30.0,8,73,79,79,22,51,73,167.0,1578.0,347,66,118,184,474.0,82,6.05,85,480,2458,10.1
25299,Shawn Horcoff,2009-10,31.0,9,51,80,80,16,35,51,168.0,1666.0,427,82,153,235,642.0,82,5.76,70,398,2426,9.7
25300,Shawn Horcoff,2010-11,32.0,10,50,53,53,21,29,50,115.0,1178.0,480,103,182,285,757.0,82,5.44,62,351,2383,9.4
25301,Shawn Horcoff,2011-12,33.0,11,53,80,80,17,36,53,178.0,1709.0,560,120,218,338,935.0,82,5.7,65,341,2477,9.4
25302,Shawn Horcoff,2012-13,34.0,12,36,77,77,13,23,36,123.0,1496.0,637,133,241,374,1058.0,82,5.53,56,304,2486,9.1
25303,Shawn Horcoff,2013-14,35.0,13,27,47,47,9,18,27,78.0,878.0,684,142,259,401,1136.0,82,5.46,52,291,2492,9.0
25304,Shawn Horcoff,2014-15,36.0,14,34,81,81,13,21,34,123.0,1586.0,765,155,280,435,1259.0,82,5.32,47,271,2439,8.9
25305,Shawn Horcoff,2015-16,37.0,15,12,31,31,7,5,12,41.0,523.0,796,162,285,447,1300.0,48,5.31,29,160,1399,9.1
25306,Shawn Horcoff,2016-17,38.0,16,20,77,77,7,13,20,68.0,990.0,873,169,298,467,1368.0,82,5.34,48,269,2463,8.9
25307,Shawn Horcoff,2017-18,39.0,17,29,76,76,11,18,29,82.0,989.0,949,180,316,496,1450.0,82,5.32,47,251,2453,8.9
25308,Shawn Horcoff,2018-19,40.0,18,15,59,59,6,9,15,73.0,784.0,1008,186,325,511,1523.0,82,5.34,48,255,2438,9.0
25309,Shawn Lalonde,2015-16,25.0,4,0,1,1,0,0,0,0.0,15.0,1,0,0,0,0.0,48,5.31,29,160,1399,9.1
25310,Shawn Matthias,2010-11,22.0,4,2,4,4,2,0,2,5.0,53.0,4,2,0,2,5.0,82,5.44,62,351,2383,9.4
25311,Shawn Matthias,2011-12,23.0,5,2,16,16,0,2,2,11.0,147.0,20,2,2,4,16.0,82,5.7,65,341,2477,9.4
25312,Shawn Matthias,2012-13,24.0,6,16,55,55,7,9,16,67.0,594.0,75,9,11,20,83.0,82,5.53,56,304,2486,9.1
25313,Shawn Matthias,2013-14,25.0,7,16,51,51,6,10,16,90.0,604.0,126,15,21,36,173.0,82,5.46,52,291,2492,9.0
25314,Shawn Matthias,2014-15,26.0,8,24,79,79,10,14,24,133.0,1091.0,205,25,35,60,306.0,82,5.32,47,271,2439,8.9
25315,Shawn Matthias,2015-16,27.0,9,21,48,48,14,7,21,106.0,729.0,253,39,42,81,412.0,48,5.31,29,160,1399,9.1
25316,Shawn Matthias,2016-17,28.0,10,23,77,77,12,11,23,127.0,1002.0,330,51,53,104,539.0,82,5.34,48,269,2463,8.9
25317,Shawn Matthias,2017-18,29.0,11,27,78,78,18,9,27,132.0,1022.0,408,69,62,131,671.0,82,5.32,47,251,2453,8.9
25318,Shawn Matthias,2018-19,30.0,12,28,71,71,12,16,28,101.0,959.0,479,81,78,159,772.0,82,5.34,48,255,2438,9.0
25319,Shawn Matthias,2019-20,31.0,13,12,45,45,8,4,12,51.0,610.0,524,89,82,171,823.0,82,5.45,47,245,2478,9.0
25320,Shawn Matthias,2020-21,32.0,14,3,27,27,1,2,3,26.0,302.0,551,90,84,174,849.0,82,5.86,50,250,2620,9.2
25321,Shawn McCosh,1994-95,25.0,4,0,4,4,0,0,0,2.0,,4,0,0,0,2.0,80,6.96,77,402,2440,11.4
25322,Shawn McCosh,1997-98,28.0,5,1,5,5,1,0,1,2.0,,9,1,0,1,4.0,48,5.97,37,209,1408,10.2
25323,Shawn McEachern,1994-95,25.0,4,4,15,15,0,4,4,14.0,,15,0,4,4,14.0,80,6.96,77,402,2440,11.4
25324,Shawn McEachern,1995-96,26.0,5,61,84,84,28,33,61,196.0,,99,28,37,65,210.0,84,7.25,87,443,2603,11.7
25325,Shawn McEachern,1996-97,27.0,6,42,76,76,20,22,42,159.0,,175,48,59,107,369.0,84,6.48,76,407,2545,10.7
25326,Shawn McEachern,1997-98,28.0,7,26,44,44,13,13,26,97.0,,219,61,72,133,466.0,48,5.97,37,209,1408,10.2
25327,Shawn McEachern,1998-99,29.0,8,53,82,82,24,29,53,238.0,,301,85,101,186,704.0,82,6.29,74,413,2481,10.4
25328,Shawn McEachern,1999-00,30.0,9,31,65,65,11,20,31,150.0,,366,96,121,217,854.0,82,5.83,55,336,2444,9.8
25329,Shawn McEachern,2000-01,31.0,10,48,81,81,24,24,48,229.0,,447,120,145,265,1083.0,82,5.28,57,380,2242,9.6
25330,Shawn McEachern,2001-02,32.0,11,56,77,77,31,25,56,223.0,1444.0,524,151,170,321,1306.0,82,5.27,57,359,2285,9.4
25331,Shawn McEachern,2002-03,33.0,12,51,69,69,29,22,51,219.0,1231.0,593,180,192,372,1525.0,82,5.49,53,331,2294,9.8
25332,Shawn McEachern,2003-04,34.0,13,72,82,82,32,40,72,231.0,1510.0,675,212,232,444,1756.0,82,5.51,63,376,2272,9.9
25333,Shawn McEachern,2004-05,35.0,14,46,80,80,15,31,46,196.0,1413.0,755,227,263,490,1952.0,82,5.24,53,338,2262,9.5
25334,Shawn McEachern,2005-06,36.0,15,26,46,46,10,16,26,120.0,888.0,801,237,279,516,2072.0,82,5.31,60,363,2326,9.4
25335,Shawn McEachern,2006-07,37.0,16,55,82,82,17,38,55,176.0,1659.0,883,254,317,571,2248.0,82,5.14,57,348,2300,9.2
25336,Shawn McEachern,2008-09,39.0,17,8,28,28,2,6,8,40.0,402.0,911,256,323,579,2288.0,82,6.05,85,480,2458,10.1
25337,Shawn Rivers,1995-96,25.0,4,2,4,4,0,2,2,3.0,,4,0,2,2,3.0,84,7.25,87,443,2603,11.7
25338,Shawn Thornton,2005-06,28.0,4,2,13,13,1,1,2,15.0,111.0,13,1,1,2,15.0,82,5.31,60,363,2326,9.4
25339,Shawn Thornton,2006-07,29.0,5,1,8,8,1,0,1,14.0,90.0,21,2,1,3,29.0,82,5.14,57,348,2300,9.2
25340,Shawn Thornton,2008-09,31.0,6,0,10,10,0,0,0,16.0,73.0,31,2,1,3,45.0,82,6.05,85,480,2458,10.1
25341,Shawn Thornton,2009-10,32.0,7,9,48,48,2,7,9,60.0,405.0,79,4,8,12,105.0,82,5.76,70,398,2426,9.7
25342,Shawn Thornton,2010-11,33.0,8,7,58,58,4,3,7,65.0,429.0,137,8,11,19,170.0,82,5.44,62,351,2383,9.4
25343,Shawn Thornton,2011-12,34.0,9,11,79,79,6,5,11,136.0,793.0,216,14,16,30,306.0,82,5.7,65,341,2477,9.4
25344,Shawn Thornton,2012-13,35.0,10,10,74,74,1,9,10,119.0,669.0,290,15,25,40,425.0,82,5.53,56,304,2486,9.1
25345,Shawn Thornton,2013-14,36.0,11,20,79,79,10,10,20,151.0,796.0,369,25,35,60,576.0,82,5.46,52,291,2492,9.0
25346,Shawn Thornton,2014-15,37.0,12,13,81,81,5,8,13,114.0,744.0,450,30,43,73,690.0,82,5.32,47,271,2439,8.9
25347,Shawn Thornton,2015-16,38.0,13,7,45,45,3,4,7,55.0,365.0,495,33,47,80,745.0,48,5.31,29,160,1399,9.1
25348,Shawn Thornton,2016-17,39.0,14,8,64,64,5,3,8,93.0,563.0,559,38,50,88,838.0,82,5.34,48,269,2463,8.9
25349,Shawn Thornton,2017-18,40.0,15,5,46,46,1,4,5,53.0,441.0,605,39,54,93,891.0,82,5.32,47,251,2453,8.9
25350,Shawn Thornton,2018-19,41.0,16,5,50,50,1,4,5,58.0,434.0,655,40,58,98,949.0,82,5.34,48,255,2438,9.0
25351,Shawn Thornton,2019-20,42.0,17,4,50,50,2,2,4,42.0,384.0,705,42,60,102,991.0,82,5.45,47,245,2478,9.0
25352,Shay Stephenson,2009-10,26.0,4,0,2,2,0,0,0,0.0,15.0,2,0,0,0,0.0,82,5.76,70,398,2426,9.7
25353,Shayne Corson,1988-89,22.0,4,0,3,3,0,0,0,1.0,,3,0,0,0,1.0,80,7.94,82,370,2484,12.8
25354,Shayne Corson,1989-90,23.0,5,23,55,55,12,11,23,69.0,,58,12,11,23,70.0,80,7.34,72,344,2400,12.2
25355,Shayne Corson,1990-91,24.0,6,39,71,71,12,27,39,90.0,,129,24,38,62,160.0,80,7.43,89,437,2435,12.2
25356,Shayne Corson,1991-92,25.0,7,50,80,80,26,24,50,133.0,,209,50,62,112,293.0,80,7.48,85,403,2430,12.3
25357,Shayne Corson,1992-93,26.0,8,75,76,76,31,44,75,192.0,,285,81,106,187,485.0,80,7.37,76,367,2421,12.2
25358,Shayne Corson,1993-94,27.0,9,47,71,71,23,24,47,164.0,,356,104,130,234,649.0,80,6.91,71,366,2385,11.6
25359,Shayne Corson,1994-95,28.0,10,53,64,64,17,36,53,165.0,,420,121,166,287,814.0,80,6.96,77,402,2440,11.4
25360,Shayne Corson,1995-96,29.0,11,47,80,80,16,31,47,164.0,,500,137,197,334,978.0,84,7.25,87,443,2603,11.7
25361,Shayne Corson,1996-97,30.0,12,54,64,64,25,29,54,171.0,,564,162,226,388,1149.0,84,6.48,76,407,2545,10.7
25362,Shayne Corson,1997-98,31.0,13,36,48,48,12,24,36,131.0,,612,174,250,424,1280.0,48,5.97,37,209,1408,10.2
25363,Shayne Corson,1998-99,32.0,14,46,77,77,18,28,46,150.0,,689,192,278,470,1430.0,82,6.29,74,413,2481,10.4
25364,Shayne Corson,1999-00,33.0,15,24,58,58,8,16,24,115.0,,747,200,294,494,1545.0,82,5.83,55,336,2444,9.8
25365,Shayne Corson,2000-01,34.0,16,55,62,62,21,34,55,142.0,,809,221,328,549,1687.0,82,5.28,57,380,2242,9.6
25366,Shayne Corson,2001-02,35.0,17,32,63,63,12,20,32,142.0,1304.0,872,233,348,581,1829.0,82,5.27,57,359,2285,9.4
25367,Shayne Corson,2002-03,36.0,18,28,70,70,8,20,28,121.0,1336.0,942,241,368,609,1950.0,82,5.49,53,331,2294,9.8
25368,Shayne Corson,2003-04,37.0,19,26,77,77,8,18,26,102.0,1220.0,1019,249,386,635,2052.0,82,5.51,63,376,2272,9.9
25369,Shayne Corson,2004-05,38.0,20,33,74,74,12,21,33,111.0,1263.0,1093,261,407,668,2163.0,82,5.24,53,338,2262,9.5
25370,Shayne Corson,2005-06,39.0,21,15,46,46,7,8,15,69.0,692.0,1139,268,415,683,2232.0,82,5.31,60,363,2326,9.4
25371,Shayne Corson,2006-07,40.0,22,10,17,17,5,5,10,21.0,230.0,1156,273,420,693,2253.0,82,5.14,57,348,2300,9.2
25372,Shayne Gostisbehere,2017-18,24.0,4,0,2,2,0,0,0,2.0,25.0,2,0,0,0,2.0,82,5.32,47,251,2453,8.9
25373,Shayne Gostisbehere,2018-19,25.0,5,46,64,64,17,29,46,152.0,1286.0,66,17,29,46,154.0,82,5.34,48,255,2438,9.0
25374,Shayne Gostisbehere,2019-20,26.0,6,39,76,76,7,32,39,198.0,1489.0,142,24,61,85,352.0,82,5.45,47,245,2478,9.0
25375,Shayne Gostisbehere,2020-21,27.0,7,65,78,78,13,52,65,221.0,1674.0,220,37,113,150,573.0,82,5.86,50,250,2620,9.2
25376,Shayne Gostisbehere,2021-22,28.0,8,37,78,78,9,28,37,180.0,1533.0,298,46,141,187,753.0,82,5.96,47,239,2579,9.5
25377,Shayne Gostisbehere,2022-23,29.0,9,12,42,42,5,7,12,73.0,768.0,340,51,148,199,826.0,70,5.96,42,208,2192,9.5
25378,Shayne Stevenson,1993-94,23.0,4,0,14,14,0,0,0,8.0,,14,0,0,0,8.0,80,6.91,71,366,2385,11.6
25379,Shayne Stevenson,1994-95,24.0,5,1,5,5,0,1,1,3.0,,19,0,1,1,11.0,80,6.96,77,402,2440,11.4
25380,Shayne Stevenson,1995-96,25.0,6,1,8,8,0,1,1,4.0,,27,0,2,2,15.0,84,7.25,87,443,2603,11.7
25381,Shayne Toporowski,1999-00,24.0,4,0,3,3,0,0,0,3.0,,3,0,0,0,3.0,82,5.83,55,336,2444,9.8
25382,Shea Theodore,2018-19,23.0,4,8,19,19,3,5,8,28.0,363.0,19,3,5,8,28.0,82,5.34,48,255,2438,9.0
25383,Shea Theodore,2019-20,24.0,5,9,34,34,2,7,9,60.0,589.0,53,5,12,17,88.0,82,5.45,47,245,2478,9.0
25384,Shea Theodore,2020-21,25.0,6,29,61,61,6,23,29,144.0,1241.0,114,11,35,46,232.0,82,5.86,50,250,2620,9.2
25385,Shea Theodore,2021-22,26.0,7,37,79,79,12,25,37,202.0,1588.0,193,23,60,83,434.0,82,5.96,47,239,2579,9.5
25386,Shea Theodore,2022-23,27.0,8,46,71,71,13,33,46,219.0,1579.0,264,36,93,129,653.0,70,5.96,42,208,2192,9.5
25387,Shea Weber,2008-09,23.0,4,10,28,28,2,8,10,46.0,476.0,28,2,8,10,46.0,82,6.05,85,480,2458,10.1
25388,Shea Weber,2009-10,24.0,5,40,79,79,17,23,40,152.0,1532.0,107,19,31,50,198.0,82,5.76,70,398,2426,9.7
25389,Shea Weber,2010-11,25.0,6,20,54,54,6,14,20,152.0,1053.0,161,25,45,70,350.0,82,5.44,62,351,2383,9.4
25390,Shea Weber,2011-12,26.0,7,53,81,81,23,30,53,251.0,1942.0,242,48,75,123,601.0,82,5.7,65,341,2477,9.4
25391,Shea Weber,2012-13,27.0,8,43,78,78,16,27,43,222.0,1807.0,320,64,102,166,823.0,82,5.53,56,304,2486,9.1
25392,Shea Weber,2013-14,28.0,9,48,82,82,16,32,48,254.0,2076.0,402,80,134,214,1077.0,82,5.46,52,291,2492,9.0
25393,Shea Weber,2014-15,29.0,10,49,78,78,19,30,49,230.0,2041.0,480,99,164,263,1307.0,82,5.32,47,271,2439,8.9
25394,Shea Weber,2015-16,30.0,11,28,48,48,9,19,28,124.0,1244.0,528,108,183,291,1431.0,48,5.31,29,160,1399,9.1
25395,Shea Weber,2016-17,31.0,12,56,79,79,23,33,56,195.0,2125.0,607,131,216,347,1626.0,82,5.34,48,269,2463,8.9
25396,Shea Weber,2017-18,32.0,13,45,78,78,15,30,45,237.0,2057.0,685,146,246,392,1863.0,82,5.32,47,251,2453,8.9
25397,Shea Weber,2018-19,33.0,14,51,78,78,20,31,51,189.0,1979.0,763,166,277,443,2052.0,82,5.34,48,255,2438,9.0
25398,Shea Weber,2019-20,34.0,15,42,78,78,17,25,42,183.0,1955.0,841,183,302,485,2235.0,82,5.45,47,245,2478,9.0
25399,Shea Weber,2020-21,35.0,16,16,26,26,6,10,16,75.0,659.0,867,189,312,501,2310.0,82,5.86,50,250,2620,9.2
25400,Shea Weber,2021-22,36.0,17,33,58,58,14,19,33,166.0,1362.0,925,203,331,534,2476.0,82,5.96,47,239,2579,9.5
25401,Shea Weber,2022-23,37.0,18,36,65,65,15,21,36,185.0,1561.0,990,218,352,570,2661.0,70,5.96,42,208,2192,9.5
25402,Shean Donovan,1997-98,23.0,4,0,14,14,0,0,0,13.0,,14,0,0,0,13.0,48,5.97,37,209,1408,10.2
25403,Shean Donovan,1998-99,24.0,5,21,74,74,13,8,21,73.0,,88,13,8,21,86.0,82,6.29,74,413,2481,10.4
25404,Shean Donovan,1999-00,25.0,6,15,73,73,9,6,15,115.0,,161,22,14,36,201.0,82,5.83,55,336,2444,9.8
25405,Shean Donovan,2000-01,26.0,7,18,67,67,8,10,18,81.0,,228,30,24,54,282.0,82,5.28,57,380,2242,9.6
25406,Shean Donovan,2001-02,27.0,8,19,68,68,7,12,19,81.0,596.0,296,37,36,73,363.0,82,5.27,57,359,2285,9.4
25407,Shean Donovan,2002-03,28.0,9,12,51,51,5,7,12,66.0,569.0,347,42,43,85,429.0,82,5.49,53,331,2294,9.8
25408,Shean Donovan,2003-04,29.0,10,23,63,63,12,11,23,93.0,886.0,410,54,54,108,522.0,82,5.51,63,376,2272,9.9
25409,Shean Donovan,2004-05,30.0,11,15,61,61,8,7,15,82.0,837.0,471,62,61,123,604.0,82,5.24,53,338,2262,9.5
25410,Shean Donovan,2005-06,31.0,12,12,65,65,5,7,12,88.0,880.0,536,67,68,135,692.0,82,5.31,60,363,2326,9.4
25411,Shean Donovan,2006-07,32.0,13,42,82,82,18,24,42,138.0,1224.0,618,85,92,177,830.0,82,5.14,57,348,2300,9.2
25412,Shean Donovan,2008-09,34.0,14,20,80,80,9,11,20,132.0,943.0,698,94,103,197,962.0,82,6.05,85,480,2458,10.1
25413,Shean Donovan,2009-10,35.0,15,17,76,76,6,11,17,108.0,1076.0,774,100,114,214,1070.0,82,5.76,70,398,2426,9.7
25414,Shean Donovan,2010-11,36.0,16,12,82,82,5,7,12,91.0,785.0,856,105,121,226,1161.0,82,5.44,62,351,2383,9.4
25415,Shean Donovan,2011-12,37.0,17,10,65,65,5,5,10,58.0,509.0,921,110,126,236,1219.0,82,5.7,65,341,2477,9.4
25416,Shean Donovan,2012-13,38.0,18,5,30,30,2,3,5,24.0,223.0,951,112,129,241,1243.0,82,5.53,56,304,2486,9.1
25417,Sheldon Brookbank,2009-10,29.0,4,1,3,3,0,1,1,3.0,25.0,3,0,1,1,3.0,82,5.76,70,398,2426,9.7
25418,Sheldon Brookbank,2010-11,30.0,5,8,44,44,0,8,8,43.0,666.0,47,0,9,9,46.0,82,5.44,62,351,2383,9.4
25419,Sheldon Brookbank,2011-12,31.0,6,4,44,44,1,3,4,30.0,534.0,91,1,12,13,76.0,82,5.7,65,341,2477,9.4
25420,Sheldon Brookbank,2012-13,32.0,7,9,66,66,0,9,9,60.0,987.0,157,1,21,22,136.0,82,5.53,56,304,2486,9.1
25421,Sheldon Brookbank,2013-14,33.0,8,0,40,40,0,0,0,29.0,533.0,197,1,21,22,165.0,82,5.46,52,291,2492,9.0
25422,Sheldon Brookbank,2014-15,34.0,9,14,80,80,3,11,14,49.0,1248.0,277,4,32,36,214.0,82,5.32,47,271,2439,8.9
25423,Sheldon Brookbank,2015-16,35.0,10,1,26,26,1,0,1,25.0,332.0,303,5,32,37,239.0,48,5.31,29,160,1399,9.1
25424,Sheldon Brookbank,2016-17,36.0,11,7,48,48,2,5,7,43.0,619.0,351,7,37,44,282.0,82,5.34,48,269,2463,8.9
25425,Sheldon Dries,2021-22,27.0,4,6,40,40,3,3,6,44.0,363.0,40,3,3,6,44.0,82,5.96,47,239,2579,9.5
25426,Sheldon Dries,2022-23,28.0,5,0,5,5,0,0,0,2.0,34.0,45,3,3,6,46.0,70,5.96,42,208,2192,9.5
25427,Sheldon Keefe,2003-04,23.0,4,4,49,49,4,0,4,32.0,392.0,49,4,0,4,32.0,82,5.51,63,376,2272,9.9
25428,Sheldon Keefe,2004-05,24.0,5,13,39,39,6,7,13,52.0,507.0,88,10,7,17,84.0,82,5.24,53,338,2262,9.5
25429,Sheldon Keefe,2005-06,25.0,6,7,37,37,2,5,7,51.0,379.0,125,12,12,24,135.0,82,5.31,60,363,2326,9.4
25430,Sheldon Kennedy,1992-93,23.0,4,9,20,20,2,7,9,23.0,,20,2,7,9,23.0,80,7.37,76,367,2421,12.2
25431,Sheldon Kennedy,1993-94,24.0,5,1,7,7,1,0,1,11.0,,27,3,7,10,34.0,80,6.91,71,366,2385,11.6
25432,Sheldon Kennedy,1994-95,25.0,6,11,27,27,3,8,11,33.0,,54,6,15,21,67.0,80,6.96,77,402,2440,11.4
25433,Sheldon Kennedy,1995-96,26.0,7,30,68,68,19,11,30,110.0,,122,25,26,51,177.0,84,7.25,87,443,2603,11.7
25434,Sheldon Kennedy,1996-97,27.0,8,13,61,61,6,7,13,60.0,,183,31,33,64,237.0,84,6.48,76,407,2545,10.7
25435,Sheldon Kennedy,1997-98,28.0,9,15,30,30,7,8,15,44.0,,213,38,41,79,281.0,48,5.97,37,209,1408,10.2
25436,Sheldon Kennedy,1998-99,29.0,10,10,41,41,3,7,10,54.0,,254,41,48,89,335.0,82,6.29,74,413,2481,10.4
25437,Sheldon Kennedy,1999-00,30.0,11,18,56,56,8,10,18,65.0,,310,49,58,107,400.0,82,5.83,55,336,2444,9.8
25438,Sheldon Rempal,2021-22,26.0,4,0,7,7,0,0,0,3.0,61.0,7,0,0,0,3.0,82,5.96,47,239,2579,9.5
25439,Sheldon Souray,2000-01,24.0,4,10,60,60,3,7,10,74.0,,60,3,7,10,74.0,82,5.28,57,380,2242,9.6
25440,Sheldon Souray,2001-02,25.0,5,8,70,70,1,7,8,101.0,1045.0,130,4,14,18,175.0,82,5.27,57,359,2285,9.4
25441,Sheldon Souray,2002-03,26.0,6,11,71,71,3,8,11,113.0,1261.0,201,7,22,29,288.0,82,5.49,53,331,2294,9.8
25442,Sheldon Souray,2003-04,27.0,7,11,52,52,3,8,11,103.0,1072.0,253,10,30,40,391.0,82,5.51,63,376,2272,9.9
25443,Sheldon Souray,2004-05,28.0,8,8,34,34,3,5,8,56.0,618.0,287,13,35,48,447.0,82,5.24,53,338,2262,9.5
25444,Sheldon Souray,2006-07,30.0,9,35,63,63,15,20,35,186.0,1476.0,350,28,55,83,633.0,82,5.14,57,348,2300,9.2
25445,Sheldon Souray,2008-09,32.0,10,39,75,75,12,27,39,202.0,1669.0,425,40,82,122,835.0,82,6.05,85,480,2458,10.1
25446,Sheldon Souray,2009-10,33.0,11,64,81,81,26,38,64,224.0,1878.0,506,66,120,186,1059.0,82,5.76,70,398,2426,9.7
25447,Sheldon Souray,2010-11,34.0,12,10,26,26,3,7,10,71.0,633.0,532,69,127,196,1130.0,82,5.44,62,351,2383,9.4
25448,Sheldon Souray,2011-12,35.0,13,53,81,81,23,30,53,268.0,2012.0,613,92,157,249,1398.0,82,5.7,65,341,2477,9.4
25449,Sheldon Souray,2012-13,36.0,14,13,37,37,4,9,13,113.0,837.0,650,96,166,262,1511.0,82,5.53,56,304,2486,9.1
25450,Sheldon Souray,2014-15,38.0,15,21,64,64,6,15,21,179.0,1310.0,714,102,181,283,1690.0,82,5.32,47,271,2439,8.9
25451,Sheldon Souray,2015-16,39.0,16,17,44,44,7,10,17,80.0,921.0,758,109,191,300,1770.0,48,5.31,29,160,1399,9.1
25452,Shjon Podein,1995-96,27.0,4,19,40,40,13,6,19,64.0,,40,13,6,19,64.0,84,7.25,87,443,2603,11.7
25453,Shjon Podein,1996-97,28.0,5,8,28,28,3,5,8,26.0,,68,16,11,27,90.0,84,6.48,76,407,2545,10.7
25454,Shjon Podein,1997-98,29.0,6,10,44,44,3,7,10,48.0,,112,19,18,37,138.0,48,5.97,37,209,1408,10.2
25455,Shjon Podein,1998-99,30.0,7,25,79,79,15,10,25,115.0,,191,34,28,62,253.0,82,6.29,74,413,2481,10.4
25456,Shjon Podein,1999-00,31.0,8,32,82,82,14,18,32,153.0,,273,48,46,94,406.0,82,5.83,55,336,2444,9.8
25457,Shjon Podein,2000-01,32.0,9,24,82,82,11,13,24,126.0,,355,59,59,118,532.0,82,5.28,57,380,2242,9.6
25458,Shjon Podein,2001-02,33.0,10,9,55,55,3,6,9,75.0,651.0,410,62,65,127,607.0,82,5.27,57,359,2285,9.4
25459,Shjon Podein,2002-03,34.0,11,19,75,75,11,8,19,104.0,1014.0,485,73,73,146,711.0,82,5.49,53,331,2294,9.8
25460,Shjon Podein,2003-04,35.0,12,32,82,82,15,17,32,137.0,1180.0,567,88,90,178,848.0,82,5.51,63,376,2272,9.9
25461,Shjon Podein,2004-05,36.0,13,18,64,64,8,10,18,67.0,881.0,631,96,100,196,915.0,82,5.24,53,338,2262,9.5
25462,Shjon Podein,2005-06,37.0,14,10,68,68,4,6,10,52.0,741.0,699,100,106,206,967.0,82,5.31,60,363,2326,9.4
25463,Sidney Crosby,2008-09,21.0,4,102,81,81,39,63,102,278.0,1630.0,81,39,63,102,278.0,82,6.05,85,480,2458,10.1
25464,Sidney Crosby,2009-10,22.0,5,120,79,79,36,84,120,250.0,1640.0,160,75,147,222,528.0,82,5.76,70,398,2426,9.7
25465,Sidney Crosby,2010-11,23.0,6,72,53,53,24,48,72,173.0,1105.0,213,99,195,294,701.0,82,5.44,62,351,2383,9.4
25466,Sidney Crosby,2011-12,24.0,7,103,77,77,33,70,103,238.0,1690.0,290,132,265,397,939.0,82,5.7,65,341,2477,9.4
25467,Sidney Crosby,2012-13,25.0,8,109,81,81,51,58,109,298.0,1778.0,371,183,323,506,1237.0,82,5.53,56,304,2486,9.1
25468,Sidney Crosby,2013-14,26.0,9,66,41,41,32,34,66,161.0,899.0,412,215,357,572,1398.0,82,5.46,52,291,2492,9.0
25469,Sidney Crosby,2014-15,27.0,10,37,22,22,8,29,37,75.0,406.0,434,223,386,609,1473.0,82,5.32,47,271,2439,8.9
25470,Sidney Crosby,2015-16,28.0,11,56,36,36,15,41,56,124.0,760.0,470,238,427,665,1597.0,48,5.31,29,160,1399,9.1
25471,Sidney Crosby,2016-17,29.0,12,104,80,80,36,68,104,259.0,1758.0,550,274,495,769,1856.0,82,5.34,48,269,2463,8.9
25472,Sidney Crosby,2017-18,30.0,13,84,77,77,28,56,84,237.0,1538.0,627,302,551,853,2093.0,82,5.32,47,251,2453,8.9
25473,Sidney Crosby,2018-19,31.0,14,85,80,80,36,49,85,248.0,1638.0,707,338,600,938,2341.0,82,5.34,48,255,2438,9.0
25474,Sidney Crosby,2019-20,32.0,15,89,75,75,44,45,89,255.0,1491.0,782,382,645,1027,2596.0,82,5.45,47,245,2478,9.0
25475,Sidney Crosby,2020-21,33.0,16,89,82,82,29,60,89,247.0,1697.0,864,411,705,1116,2843.0,82,5.86,50,250,2620,9.2
25476,Sidney Crosby,2021-22,34.0,17,100,79,79,35,65,100,220.0,1658.0,943,446,770,1216,3063.0,82,5.96,47,239,2579,9.5
25477,Sidney Crosby,2022-23,35.0,18,47,41,41,16,31,47,109.0,831.0,984,462,801,1263,3172.0,70,5.96,42,208,2192,9.5
25478,Simo Saarinen,1987-88,24.0,4,0,8,8,0,0,0,8.0,,8,0,0,0,8.0,80,7.77,71,321,2447,12.7
25479,Simon Despres,2014-15,23.0,4,4,18,18,1,3,4,22.0,256.0,18,1,3,4,22.0,82,5.32,47,271,2439,8.9
25480,Simon Despres,2015-16,24.0,5,7,33,33,2,5,7,33.0,499.0,51,3,8,11,55.0,48,5.31,29,160,1399,9.1
25481,Simon Despres,2016-17,25.0,6,5,34,34,0,5,5,41.0,569.0,85,3,13,16,96.0,82,5.34,48,269,2463,8.9
25482,Simon Despres,2017-18,26.0,7,23,75,75,3,20,23,103.0,1265.0,160,6,33,39,199.0,82,5.32,47,251,2453,8.9
25483,Simon Despres,2018-19,27.0,8,4,32,32,0,4,4,32.0,628.0,192,6,37,43,231.0,82,5.34,48,255,2438,9.0
25484,Simon Despres,2019-20,28.0,9,0,1,1,0,0,0,1.0,16.0,193,6,37,43,232.0,82,5.45,47,245,2478,9.0
25485,Simon Gagne,2002-03,22.0,4,48,80,80,20,28,48,159.0,1198.0,80,20,28,48,159.0,82,5.49,53,331,2294,9.8
25486,Simon Gagne,2003-04,23.0,5,59,69,69,27,32,59,191.0,1247.0,149,47,60,107,350.0,82,5.51,63,376,2272,9.9
25487,Simon Gagne,2004-05,24.0,6,66,79,79,33,33,66,199.0,1434.0,228,80,93,173,549.0,82,5.24,53,338,2262,9.5
25488,Simon Gagne,2005-06,25.0,7,27,46,46,9,18,27,115.0,800.0,274,89,111,200,664.0,82,5.31,60,363,2326,9.4
25489,Simon Gagne,2006-07,26.0,8,45,80,80,24,21,45,211.0,1316.0,354,113,132,245,875.0,82,5.14,57,348,2300,9.2
25490,Simon Gagne,2008-09,28.0,9,79,72,72,47,32,79,334.0,1495.0,426,160,164,324,1209.0,82,6.05,85,480,2458,10.1
25491,Simon Gagne,2009-10,29.0,10,68,76,76,41,27,68,291.0,1599.0,502,201,191,392,1500.0,82,5.76,70,398,2426,9.7
25492,Simon Gagne,2010-11,30.0,11,18,25,25,7,11,18,76.0,454.0,527,208,202,410,1576.0,82,5.44,62,351,2383,9.4
25493,Simon Gagne,2011-12,31.0,12,74,79,79,34,40,74,221.0,1503.0,606,242,242,484,1797.0,82,5.7,65,341,2477,9.4
25494,Simon Gagne,2012-13,32.0,13,40,58,58,17,23,40,183.0,1080.0,664,259,265,524,1980.0,82,5.53,56,304,2486,9.1
25495,Simon Gagne,2013-14,33.0,14,40,63,63,17,23,40,154.0,1064.0,727,276,288,564,2134.0,82,5.46,52,291,2492,9.0
25496,Simon Gagne,2014-15,34.0,15,17,34,34,7,10,17,75.0,612.0,761,283,298,581,2209.0,82,5.32,47,271,2439,8.9
25497,Simon Gagne,2015-16,35.0,16,16,38,38,5,11,16,76.0,537.0,799,288,309,597,2285.0,48,5.31,29,160,1399,9.1
25498,Simon Gagne,2017-18,37.0,17,4,23,23,3,1,4,27.0,260.0,822,291,310,601,2312.0,82,5.32,47,251,2453,8.9
25499,Simon Gamache,2005-06,25.0,4,0,2,2,0,0,0,3.0,25.0,2,0,0,0,3.0,82,5.31,60,363,2326,9.4
25500,Simon Gamache,2006-07,26.0,5,2,9,9,1,1,2,5.0,66.0,11,1,1,2,8.0,82,5.14,57,348,2300,9.2
25501,Simon Gamache,2008-09,28.0,6,7,26,26,3,4,7,36.0,299.0,37,4,5,9,44.0,82,6.05,85,480,2458,10.1
25502,Simon Gamache,2010-11,30.0,7,4,11,11,2,2,4,11.0,106.0,48,6,7,13,55.0,82,5.44,62,351,2383,9.4
25503,Simon Moser,2016-17,27.0,4,2,6,6,1,1,2,7.0,61.0,6,1,1,2,7.0,82,5.34,48,269,2463,8.9
25504,Simon Wheeldon,1990-91,24.0,4,1,5,5,0,1,1,2.0,,5,0,1,1,2.0,80,7.43,89,437,2435,12.2
25505,Simon Wheeldon,1991-92,25.0,5,1,6,6,0,1,1,2.0,,11,0,2,2,4.0,80,7.48,85,403,2430,12.3
25506,Simon Wheeldon,1993-94,27.0,6,0,4,4,0,0,0,4.0,,15,0,2,2,8.0,80,6.91,71,366,2385,11.6
25507,Slater Koekkoek,2017-18,23.0,4,0,3,3,0,0,0,6.0,50.0,3,0,0,0,6.0,82,5.32,47,251,2453,8.9
25508,Slater Koekkoek,2018-19,24.0,5,1,9,9,0,1,1,11.0,93.0,12,0,1,1,17.0,82,5.34,48,255,2438,9.0
25509,Slater Koekkoek,2019-20,25.0,6,4,29,29,0,4,4,27.0,377.0,41,0,5,5,44.0,82,5.45,47,245,2478,9.0
25510,Slater Koekkoek,2020-21,26.0,7,8,35,35,4,4,8,43.0,393.0,76,4,9,13,87.0,82,5.86,50,250,2620,9.2
25511,Slater Koekkoek,2021-22,27.0,8,6,31,31,2,4,6,36.0,491.0,107,6,13,19,123.0,82,5.96,47,239,2579,9.5
25512,Slater Koekkoek,2022-23,28.0,9,10,42,42,1,9,10,47.0,704.0,149,7,22,29,170.0,70,5.96,42,208,2192,9.5
25513,Slava Voynov,2014-15,25.0,4,20,54,54,8,12,20,86.0,1001.0,54,8,12,20,86.0,82,5.32,47,271,2439,8.9
25514,Slava Voynov,2015-16,26.0,5,25,48,48,6,19,25,79.0,1071.0,102,14,31,45,165.0,48,5.31,29,160,1399,9.1
25515,Slava Voynov,2016-17,27.0,6,34,82,82,4,30,34,143.0,1829.0,184,18,61,79,308.0,82,5.34,48,269,2463,8.9
25516,Slava Voynov,2017-18,28.0,7,2,6,6,0,2,2,5.0,139.0,190,18,63,81,313.0,82,5.32,47,251,2453,8.9
25517,Sonny Milano,2018-19,22.0,4,1,3,3,0,1,1,2.0,40.0,3,0,1,1,2.0,82,5.34,48,255,2438,9.0
25518,Sonny Milano,2019-20,23.0,5,0,4,4,0,0,0,2.0,47.0,7,0,1,1,4.0,82,5.45,47,245,2478,9.0
25519,Sonny Milano,2020-21,24.0,6,22,55,55,14,8,22,69.0,641.0,62,14,9,23,73.0,82,5.86,50,250,2620,9.2
25520,Sonny Milano,2021-22,25.0,7,1,8,8,1,0,1,5.0,67.0,70,15,9,24,78.0,82,5.96,47,239,2579,9.5
25521,Sonny Milano,2022-23,26.0,8,23,55,55,7,16,23,75.0,720.0,125,22,25,47,153.0,70,5.96,42,208,2192,9.5
25522,Spencer Abbott,2016-17,28.0,4,0,1,1,0,0,0,2.0,5.0,1,0,0,0,2.0,82,5.34,48,269,2463,8.9
25523,Spencer Abbott,2019-20,31.0,5,0,1,1,0,0,0,1.0,9.0,2,0,0,0,3.0,82,5.45,47,245,2478,9.0
25524,Spencer Foo,2020-21,26.0,4,2,4,4,2,0,2,16.0,63.0,4,2,0,2,16.0,82,5.86,50,250,2620,9.2
25525,Spencer Machacek,2011-12,23.0,4,0,2,2,0,0,0,1.0,16.0,2,0,0,0,1.0,82,5.7,65,341,2477,9.4
25526,Spencer Machacek,2013-14,25.0,5,0,10,10,0,0,0,7.0,77.0,12,0,0,0,8.0,82,5.46,52,291,2492,9.0
25527,Spencer Machacek,2014-15,26.0,6,9,13,13,2,7,9,12.0,98.0,25,2,7,9,20.0,82,5.32,47,271,2439,8.9
25528,Stacy Roest,2001-02,27.0,4,12,59,59,4,8,12,50.0,476.0,59,4,8,12,50.0,82,5.27,57,359,2285,9.4
25529,Stacy Roest,2002-03,28.0,5,16,49,49,7,9,16,56.0,487.0,108,11,17,28,106.0,82,5.49,53,331,2294,9.8
25530,Stacy Roest,2003-04,29.0,6,27,76,76,7,20,27,125.0,1065.0,184,18,37,55,231.0,82,5.51,63,376,2272,9.9
25531,Stacy Roest,2004-05,30.0,7,21,58,58,10,11,21,98.0,919.0,242,28,48,76,329.0,82,5.24,53,338,2262,9.5
25532,Stacy Roest,2005-06,31.0,8,0,2,2,0,0,0,2.0,15.0,244,28,48,76,331.0,82,5.31,60,363,2326,9.4
25533,Staffan Kronwall,2008-09,26.0,4,1,34,34,0,1,1,18.0,440.0,34,0,1,1,18.0,82,6.05,85,480,2458,10.1
25534,Staffan Kronwall,2010-11,28.0,5,0,18,18,0,0,0,9.0,200.0,52,0,1,1,27.0,82,5.44,62,351,2383,9.4
25535,Staffan Kronwall,2011-12,29.0,6,0,3,3,0,0,0,4.0,40.0,55,0,1,1,31.0,82,5.7,65,341,2477,9.4
25536,Staffan Kronwall,2012-13,30.0,7,3,11,11,1,2,3,6.0,109.0,66,1,3,4,37.0,82,5.53,56,304,2486,9.1
25537,Stan Drulia,1995-96,28.0,4,3,24,24,2,1,3,22.0,,24,2,1,3,22.0,84,7.25,87,443,2603,11.7
25538,Stan Drulia,2002-03,35.0,5,33,68,68,11,22,33,94.0,1130.0,92,13,23,36,116.0,82,5.49,53,331,2294,9.8
25539,Stan Drulia,2003-04,36.0,6,6,34,34,2,4,6,20.0,363.0,126,15,27,42,136.0,82,5.51,63,376,2272,9.9
25540,Stan Neckar,1997-98,22.0,4,4,48,48,1,3,4,34.0,,48,1,3,4,34.0,48,5.97,37,209,1408,10.2
25541,Stan Neckar,1998-99,23.0,5,12,82,82,3,9,12,57.0,,130,4,12,16,91.0,82,6.29,74,413,2481,10.4
25542,Stan Neckar,1999-00,24.0,6,0,5,5,0,0,0,3.0,,135,4,12,16,94.0,82,5.83,55,336,2444,9.8
25543,Stan Neckar,2000-01,25.0,7,4,60,60,2,2,4,43.0,,195,6,14,20,137.0,82,5.28,57,380,2242,9.6
25544,Stan Neckar,2001-02,26.0,8,3,32,32,0,3,3,16.0,462.0,227,6,17,23,153.0,82,5.27,57,359,2285,9.4
25545,Stan Neckar,2002-03,27.0,9,10,66,66,2,8,10,34.0,954.0,293,8,25,33,187.0,82,5.49,53,331,2294,9.8
25546,Stan Neckar,2003-04,28.0,10,6,69,69,2,4,6,26.0,1115.0,362,10,29,39,213.0,82,5.51,63,376,2272,9.9
25547,Stan Neckar,2004-05,29.0,11,8,77,77,1,7,8,38.0,1580.0,439,11,36,47,251.0,82,5.24,53,338,2262,9.5
25548,Stan Neckar,2005-06,30.0,12,5,70,70,1,4,5,38.0,1309.0,509,12,40,52,289.0,82,5.31,60,363,2326,9.4
25549,Stan Neckar,2006-07,31.0,13,1,1,1,0,1,1,0.0,15.0,510,12,41,53,289.0,82,5.14,57,348,2300,9.2
25550,Stanislav Chistov,2005-06,22.0,4,30,79,79,12,18,30,114.0,1073.0,79,12,18,30,114.0,82,5.31,60,363,2326,9.4
25551,Stanislav Chistov,2006-07,23.0,5,18,56,56,2,16,18,70.0,690.0,135,14,34,48,184.0,82,5.14,57,348,2300,9.2
25552,Stanislav Chistov,2009-10,26.0,6,13,61,61,5,8,13,49.0,519.0,196,19,42,61,233.0,82,5.76,70,398,2426,9.7
25553,Stanislav Galiev,2017-18,26.0,4,1,2,2,1,0,1,2.0,19.0,2,1,0,1,2.0,82,5.32,47,251,2453,8.9
25554,Stanislav Galiev,2018-19,27.0,5,3,24,24,0,3,3,30.0,219.0,26,1,3,4,32.0,82,5.34,48,255,2438,9.0
25555,Stanislav Gron,2003-04,25.0,4,0,1,1,0,0,0,2.0,10.0,1,0,0,0,2.0,82,5.51,63,376,2272,9.9
25556,Stefan Bergkvist,1998-99,23.0,4,0,2,2,0,0,0,4.0,,2,0,0,0,4.0,82,6.29,74,413,2481,10.4
25557,Stefan Bergkvist,1999-00,24.0,5,0,5,5,0,0,0,0.0,,7,0,0,0,4.0,82,5.83,55,336,2444,9.8
25558,Stefan Della Rovere,2013-14,23.0,4,0,7,7,0,0,0,4.0,43.0,7,0,0,0,4.0,82,5.46,52,291,2492,9.0
25559,Stefan Elliott,2014-15,24.0,4,13,39,39,4,9,13,84.0,669.0,39,4,9,13,84.0,82,5.32,47,271,2439,8.9
25560,Stefan Elliott,2015-16,25.0,5,4,18,18,1,3,4,35.0,315.0,57,5,12,17,119.0,48,5.31,29,160,1399,9.1
25561,Stefan Elliott,2016-17,26.0,6,1,1,1,1,0,1,1.0,17.0,58,6,12,18,120.0,82,5.34,48,269,2463,8.9
25562,Stefan Elliott,2017-18,27.0,7,0,5,5,0,0,0,10.0,70.0,63,6,12,18,130.0,82,5.32,47,251,2453,8.9
25563,Stefan Elliott,2018-19,28.0,8,6,21,21,2,4,6,37.0,298.0,84,8,16,24,167.0,82,5.34,48,255,2438,9.0
25564,Stefan Elliott,2021-22,31.0,9,1,3,3,0,1,1,3.0,27.0,87,8,17,25,170.0,82,5.96,47,239,2579,9.5
25565,Stefan Matteau,2015-16,21.0,4,3,17,17,1,2,3,22.0,156.0,17,1,2,3,22.0,48,5.31,29,160,1399,9.1
25566,Stefan Matteau,2017-18,23.0,5,1,7,7,1,0,1,8.0,83.0,24,2,2,4,30.0,82,5.32,47,251,2453,8.9
25567,Stefan Matteau,2018-19,24.0,6,2,32,32,1,1,2,27.0,329.0,56,3,3,6,57.0,82,5.34,48,255,2438,9.0
25568,Stefan Matteau,2020-21,26.0,7,1,8,8,0,1,1,8.0,66.0,64,3,4,7,65.0,82,5.86,50,250,2620,9.2
25569,Stefan Matteau,2022-23,28.0,8,3,9,9,2,1,3,18.0,111.0,73,5,5,10,83.0,70,5.96,42,208,2192,9.5
25570,Stefan Meyer,2010-11,25.0,4,0,4,4,0,0,0,0.0,10.0,4,0,0,0,0.0,82,5.44,62,351,2383,9.4
25571,Stefan Meyer,2013-14,28.0,5,2,16,16,0,2,2,12.0,124.0,20,0,2,2,12.0,82,5.46,52,291,2492,9.0
25572,Stefan Noesen,2017-18,24.0,4,0,1,1,0,0,0,0.0,7.0,1,0,0,0,0.0,82,5.32,47,251,2453,8.9
25573,Stefan Noesen,2018-19,25.0,5,0,1,1,0,0,0,0.0,10.0,2,0,0,0,0.0,82,5.34,48,255,2438,9.0
25574,Stefan Noesen,2019-20,26.0,6,10,44,44,8,2,10,63.0,490.0,46,8,2,10,63.0,82,5.45,47,245,2478,9.0
25575,Stefan Noesen,2020-21,27.0,7,27,72,72,13,14,27,127.0,957.0,118,21,16,37,190.0,82,5.86,50,250,2620,9.2
25576,Stefan Noesen,2021-22,28.0,8,8,41,41,3,5,8,64.0,522.0,159,24,21,45,254.0,82,5.96,47,239,2579,9.5
25577,Stefan Noesen,2022-23,29.0,9,9,40,40,7,2,9,67.0,461.0,199,31,23,54,321.0,70,5.96,42,208,2192,9.5
25578,Stefan Ruzicka,2008-09,23.0,4,0,1,1,0,0,0,1.0,5.0,1,0,0,0,1.0,82,6.05,85,480,2458,10.1
25579,Stefan Ruzicka,2009-10,24.0,5,13,40,40,3,10,13,75.0,509.0,41,3,10,13,76.0,82,5.76,70,398,2426,9.7
25580,Stefan Ruzicka,2010-11,25.0,6,4,14,14,1,3,4,10.0,121.0,55,4,13,17,86.0,82,5.44,62,351,2383,9.4
25581,Stefan Ustorf,1998-99,25.0,4,17,48,48,7,10,17,39.0,,48,7,10,17,39.0,82,6.29,74,413,2481,10.4
25582,Stefan Ustorf,1999-00,26.0,5,0,6,6,0,0,0,7.0,,54,7,10,17,46.0,82,5.83,55,336,2444,9.8
25583,Stephan Lebeau,1991-92,23.0,4,1,1,1,0,1,1,1.0,,1,0,1,1,1.0,80,7.48,85,403,2430,12.3
25584,Stephan Lebeau,1992-93,24.0,5,35,57,57,15,20,35,79.0,,58,15,21,36,80.0,80,7.37,76,367,2421,12.2
25585,Stephan Lebeau,1993-94,25.0,6,53,73,73,22,31,53,108.0,,131,37,52,89,188.0,80,6.91,71,366,2385,11.6
25586,Stephan Lebeau,1994-95,26.0,7,58,77,77,27,31,58,178.0,,208,64,83,147,366.0,80,6.96,77,402,2440,11.4
25587,Stephan Lebeau,1995-96,27.0,8,80,71,71,31,49,80,150.0,,279,95,132,227,516.0,84,7.25,87,443,2603,11.7
25588,Stephan Lebeau,1996-97,28.0,9,26,56,56,15,11,26,98.0,,335,110,143,253,614.0,84,6.48,76,407,2545,10.7
25589,Stephan Lebeau,1997-98,29.0,10,24,38,38,8,16,24,70.0,,373,118,159,277,684.0,48,5.97,37,209,1408,10.2
25590,Stephane Brochu,1991-92,24.0,4,0,1,1,0,0,0,1.0,,1,0,0,0,1.0,80,7.48,85,403,2430,12.3
25591,Stephane Charbonneau,1994-95,24.0,4,0,2,2,0,0,0,4.0,,2,0,0,0,4.0,80,6.96,77,402,2440,11.4
25592,Stephane Da Costa,2013-14,24.0,4,0,4,4,0,0,0,9.0,46.0,4,0,0,0,9.0,82,5.46,52,291,2492,9.0
25593,Stephane Da Costa,2014-15,25.0,5,5,22,22,3,2,5,31.0,268.0,26,3,2,5,40.0,82,5.32,47,271,2439,8.9
25594,Stephane Da Costa,2015-16,26.0,6,2,9,9,1,1,2,15.0,107.0,35,4,3,7,55.0,48,5.31,29,160,1399,9.1
25595,Stephane Da Costa,2016-17,27.0,7,4,12,12,3,1,4,20.0,125.0,47,7,4,11,75.0,82,5.34,48,269,2463,8.9
25596,Stephane Guerard,1990-91,22.0,4,0,30,30,0,0,0,12.0,,30,0,0,0,12.0,80,7.43,89,437,2435,12.2
25597,Stephane Guerard,1992-93,24.0,5,0,4,4,0,0,0,9.0,,34,0,0,0,21.0,80,7.37,76,367,2421,12.2
25598,Stephane Matteau,1993-94,24.0,4,34,78,78,15,19,34,114.0,,78,15,19,34,114.0,80,6.91,71,366,2385,11.6
25599,Stephane Matteau,1994-95,25.0,5,14,24,24,6,8,14,38.0,,102,21,27,48,152.0,80,6.96,77,402,2440,11.4
25600,Stephane Matteau,1995-96,26.0,6,33,79,79,15,18,33,95.0,,181,36,45,81,247.0,84,7.25,87,443,2603,11.7
25601,Stephane Matteau,1996-97,27.0,7,38,77,77,19,19,38,135.0,,258,55,64,119,382.0,84,6.48,76,407,2545,10.7
25602,Stephane Matteau,1997-98,28.0,8,8,41,41,3,5,8,37.0,,299,58,69,127,419.0,48,5.97,37,209,1408,10.2
25603,Stephane Matteau,1998-99,29.0,9,26,78,78,11,15,26,109.0,,377,69,84,153,528.0,82,6.29,74,413,2481,10.4
25604,Stephane Matteau,1999-00,30.0,10,36,74,74,16,20,36,98.0,,451,85,104,189,626.0,82,5.83,55,336,2444,9.8
25605,Stephane Matteau,2000-01,31.0,11,29,73,73,15,14,29,79.0,,524,100,118,218,705.0,82,5.28,57,380,2242,9.6
25606,Stephane Matteau,2001-02,32.0,12,23,68,68,8,15,23,72.0,923.0,592,108,133,241,777.0,82,5.27,57,359,2285,9.4
25607,Stephane Matteau,2002-03,33.0,13,24,69,69,12,12,24,73.0,818.0,661,120,145,265,850.0,82,5.49,53,331,2294,9.8
25608,Stephane Matteau,2003-04,34.0,14,32,80,80,13,19,32,81.0,873.0,741,133,164,297,931.0,82,5.51,63,376,2272,9.9
25609,Stephane Matteau,2004-05,35.0,15,11,55,55,7,4,11,43.0,503.0,796,140,168,308,974.0,82,5.24,53,338,2262,9.5
25610,Stephane Matteau,2005-06,36.0,16,8,52,52,4,4,8,47.0,560.0,848,144,172,316,1021.0,82,5.31,60,363,2326,9.4
25611,Stephane Morin,1992-93,23.0,4,2,6,6,0,2,2,11.0,,6,0,2,2,11.0,80,7.37,76,367,2421,12.2
25612,Stephane Morin,1993-94,24.0,5,40,48,48,13,27,40,63.0,,54,13,29,42,74.0,80,6.91,71,366,2385,11.6
25613,Stephane Morin,1994-95,25.0,6,10,30,30,2,8,10,41.0,,84,15,37,52,115.0,80,6.96,77,402,2440,11.4
25614,Stephane Morin,1995-96,26.0,7,1,1,1,0,1,1,3.0,,85,15,38,53,118.0,84,7.25,87,443,2603,11.7
25615,Stephane Morin,1996-97,27.0,8,2,5,5,1,1,2,6.0,,90,16,39,55,124.0,84,6.48,76,407,2545,10.7
25616,Stephane Quintal,1991-92,23.0,4,1,26,26,0,1,1,23.0,,26,0,1,1,23.0,80,7.48,85,403,2430,12.3
25617,Stephane Quintal,1992-93,24.0,5,4,38,38,2,2,4,43.0,,64,2,3,5,66.0,80,7.37,76,367,2421,12.2
25618,Stephane Quintal,1993-94,25.0,6,8,45,45,2,6,8,54.0,,109,4,9,13,120.0,80,6.91,71,366,2385,11.6
25619,Stephane Quintal,1994-95,26.0,7,20,75,75,4,16,20,71.0,,184,8,25,33,191.0,80,6.96,77,402,2440,11.4
25620,Stephane Quintal,1995-96,27.0,8,11,75,75,1,10,11,81.0,,259,9,35,44,272.0,84,7.25,87,443,2603,11.7
25621,Stephane Quintal,1996-97,28.0,9,26,81,81,8,18,26,154.0,,340,17,53,70,426.0,84,6.48,76,407,2545,10.7
25622,Stephane Quintal,1997-98,29.0,10,23,43,43,6,17,23,107.0,,383,23,70,93,533.0,48,5.97,37,209,1408,10.2
25623,Stephane Quintal,1998-99,30.0,11,16,68,68,2,14,16,104.0,,451,25,84,109,637.0,82,6.29,74,413,2481,10.4
25624,Stephane Quintal,1999-00,31.0,12,22,71,71,7,15,22,139.0,,522,32,99,131,776.0,82,5.83,55,336,2444,9.8
25625,Stephane Quintal,2000-01,32.0,13,16,71,71,6,10,16,88.0,,593,38,109,147,864.0,82,5.28,57,380,2242,9.6
25626,Stephane Quintal,2001-02,33.0,14,27,82,82,8,19,27,159.0,1812.0,675,46,128,174,1023.0,82,5.27,57,359,2285,9.4
25627,Stephane Quintal,2002-03,34.0,15,16,75,75,2,14,16,102.0,1430.0,750,48,142,190,1125.0,82,5.49,53,331,2294,9.8
25628,Stephane Quintal,2003-04,35.0,16,19,72,72,1,18,19,109.0,1620.0,822,49,160,209,1234.0,82,5.51,63,376,2272,9.9
25629,Stephane Quintal,2004-05,36.0,17,16,75,75,6,10,16,85.0,1415.0,897,55,170,225,1319.0,82,5.24,53,338,2262,9.5
25630,Stephane Quintal,2005-06,37.0,18,10,67,67,5,5,10,73.0,1249.0,964,60,175,235,1392.0,82,5.31,60,363,2326,9.4
25631,Stephane Quintal,2006-07,38.0,19,8,73,73,3,5,8,86.0,1506.0,1037,63,180,243,1478.0,82,5.14,57,348,2300,9.2
25632,Stephane Richer,1987-88,21.0,4,0,1,1,0,0,0,0.0,,1,0,0,0,0.0,80,7.77,71,321,2447,12.7
25633,Stephane Richer,1988-89,22.0,5,37,65,65,21,16,37,112.0,,66,21,16,37,112.0,80,7.94,82,370,2484,12.8
25634,Stephane Richer,1989-90,23.0,6,39,57,57,20,19,39,109.0,,123,41,35,76,221.0,80,7.34,72,344,2400,12.2
25635,Stephane Richer,1990-91,24.0,7,78,72,72,50,28,78,263.0,,195,91,63,154,484.0,80,7.43,89,437,2435,12.2
25636,Stephane Richer,1991-92,25.0,8,60,68,68,25,35,60,214.0,,263,116,98,214,698.0,80,7.48,85,403,2430,12.3
25637,Stephane Richer,1992-93,26.0,9,91,75,75,51,40,91,269.0,,338,167,138,305,967.0,80,7.37,76,367,2421,12.2
25638,Stephane Richer,1993-94,27.0,10,61,75,75,31,30,61,221.0,,413,198,168,366,1188.0,80,6.91,71,366,2385,11.6
25639,Stephane Richer,1994-95,28.0,11,64,74,74,29,35,64,240.0,,487,227,203,430,1428.0,80,6.96,77,402,2440,11.4
25640,Stephane Richer,1995-96,29.0,12,73,78,78,38,35,73,286.0,,565,265,238,503,1714.0,84,7.25,87,443,2603,11.7
25641,Stephane Richer,1996-97,30.0,13,72,80,80,36,36,72,217.0,,645,301,274,575,1931.0,84,6.48,76,407,2545,10.7
25642,Stephane Richer,1997-98,31.0,14,39,45,45,23,16,39,133.0,,690,324,290,614,2064.0,48,5.97,37,209,1408,10.2
25643,Stephane Richer,1998-99,32.0,15,32,73,73,20,12,32,192.0,,763,344,302,646,2256.0,82,6.29,74,413,2481,10.4
25644,Stephane Richer,1999-00,33.0,16,46,63,63,22,24,46,126.0,,826,366,326,692,2382.0,82,5.83,55,336,2444,9.8
25645,Stephane Richer,2000-01,34.0,17,29,40,40,14,15,29,95.0,,866,380,341,721,2477.0,82,5.28,57,380,2242,9.6
25646,Stephane Richer,2001-02,35.0,18,33,64,64,12,21,33,139.0,1074.0,930,392,362,754,2616.0,82,5.27,57,359,2285,9.4
25647,Stephane Richer,2002-03,36.0,19,37,56,56,15,22,37,110.0,775.0,986,407,384,791,2726.0,82,5.49,53,331,2294,9.8
25648,Stephane Richer,2004-05,38.0,20,28,68,68,14,14,28,123.0,938.0,1054,421,398,819,2849.0,82,5.24,53,338,2262,9.5
25649,Stephane Richer0,1995-96,29.0,4,5,24,24,1,4,5,24.0,,24,1,4,5,24.0,84,7.25,87,443,2603,11.7
25650,Stephane Richer0,1996-97,30.0,5,1,2,2,0,1,1,3.0,,26,1,5,6,27.0,84,6.48,76,407,2545,10.7
25651,Stephane Richer0,1997-98,31.0,6,0,1,1,0,0,0,0.0,,27,1,5,6,27.0,48,5.97,37,209,1408,10.2
25652,Stephane Robidas,2002-03,25.0,4,0,1,1,0,0,0,0.0,16.0,1,0,0,0,0.0,82,5.49,53,331,2294,9.8
25653,Stephane Robidas,2003-04,26.0,5,12,65,65,6,6,12,77.0,1348.0,66,6,6,12,77.0,82,5.51,63,376,2272,9.9
25654,Stephane Robidas,2004-05,27.0,6,11,56,56,1,10,11,68.0,1063.0,122,7,16,23,145.0,82,5.24,53,338,2262,9.5
25655,Stephane Robidas,2005-06,28.0,7,10,76,76,3,7,10,47.0,980.0,198,10,23,33,192.0,82,5.31,60,363,2326,9.4
25656,Stephane Robidas,2006-07,29.0,8,13,59,59,3,10,13,63.0,1123.0,257,13,33,46,255.0,82,5.14,57,348,2300,9.2
25657,Stephane Robidas,2008-09,31.0,9,20,75,75,5,15,20,95.0,1274.0,332,18,48,66,350.0,82,6.05,85,480,2458,10.1
25658,Stephane Robidas,2009-10,32.0,10,17,75,75,0,17,17,106.0,1355.0,407,18,65,83,456.0,82,5.76,70,398,2426,9.7
25659,Stephane Robidas,2010-11,33.0,11,26,82,82,9,17,26,153.0,1693.0,489,27,82,109,609.0,82,5.44,62,351,2383,9.4
25660,Stephane Robidas,2011-12,34.0,12,26,72,72,3,23,26,158.0,1767.0,561,30,105,135,767.0,82,5.7,65,341,2477,9.4
25661,Stephane Robidas,2012-13,35.0,13,41,82,82,10,31,41,199.0,2008.0,643,40,136,176,966.0,82,5.53,56,304,2486,9.1
25662,Stephane Robidas,2013-14,36.0,14,30,81,81,5,25,30,106.0,1987.0,724,45,161,206,1072.0,82,5.46,52,291,2492,9.0
25663,Stephane Robidas,2014-15,37.0,15,22,75,75,5,17,22,75.0,1707.0,799,50,178,228,1147.0,82,5.32,47,271,2439,8.9
25664,Stephane Robidas,2015-16,38.0,16,13,48,48,1,12,13,46.0,1067.0,847,51,190,241,1193.0,48,5.31,29,160,1399,9.1
25665,Stephane Robidas,2016-17,39.0,17,10,38,38,5,5,10,56.0,767.0,885,56,195,251,1249.0,82,5.34,48,269,2463,8.9
25666,Stephane Robidas,2017-18,40.0,18,7,52,52,1,6,7,34.0,888.0,937,57,201,258,1283.0,82,5.32,47,251,2453,8.9
25667,Stephane Roy,1990-91,23.0,4,1,12,12,1,0,1,14.0,,12,1,0,1,14.0,80,7.43,89,437,2435,12.2
25668,Stephane Veilleux,2005-06,24.0,4,5,38,38,3,2,5,52.0,461.0,38,3,2,5,52.0,82,5.31,60,363,2326,9.4
25669,Stephane Veilleux,2006-07,25.0,5,10,19,19,2,8,10,37.0,272.0,57,5,10,15,89.0,82,5.14,57,348,2300,9.2
25670,Stephane Veilleux,2008-09,27.0,6,16,71,71,7,9,16,87.0,920.0,128,12,19,31,176.0,82,6.05,85,480,2458,10.1
25671,Stephane Veilleux,2009-10,28.0,7,18,75,75,7,11,18,84.0,922.0,203,19,30,49,260.0,82,5.76,70,398,2426,9.7
25672,Stephane Veilleux,2010-11,29.0,8,18,77,77,11,7,18,136.0,1119.0,280,30,37,67,396.0,82,5.44,62,351,2383,9.4
25673,Stephane Veilleux,2011-12,30.0,9,23,81,81,13,10,23,146.0,1280.0,361,43,47,90,542.0,82,5.7,65,341,2477,9.4
25674,Stephane Veilleux,2012-13,31.0,10,9,77,77,3,6,9,94.0,946.0,438,46,53,99,636.0,82,5.53,56,304,2486,9.1
25675,Stephane Veilleux,2014-15,33.0,11,2,22,22,0,2,2,16.0,216.0,460,46,55,101,652.0,82,5.32,47,271,2439,8.9
25676,Stephane Veilleux,2016-17,35.0,12,3,34,34,3,0,3,26.0,287.0,494,49,55,104,678.0,82,5.34,48,269,2463,8.9
25677,Stephane Veilleux,2017-18,36.0,13,2,12,12,1,1,2,9.0,92.0,506,50,56,106,687.0,82,5.32,47,251,2453,8.9
25678,Stephane Yelle,1998-99,24.0,4,27,71,71,13,14,27,93.0,,71,13,14,27,93.0,82,6.29,74,413,2481,10.4
25679,Stephane Yelle,1999-00,25.0,5,26,79,79,9,17,26,89.0,,150,22,31,53,182.0,82,5.83,55,336,2444,9.8
25680,Stephane Yelle,2000-01,26.0,6,22,81,81,7,15,22,93.0,,231,29,46,75,275.0,82,5.28,57,380,2242,9.6
25681,Stephane Yelle,2001-02,27.0,7,15,72,72,8,7,15,99.0,1098.0,303,37,53,90,374.0,82,5.27,57,359,2285,9.4
25682,Stephane Yelle,2002-03,28.0,8,22,79,79,8,14,22,90.0,1253.0,382,45,67,112,464.0,82,5.49,53,331,2294,9.8
25683,Stephane Yelle,2003-04,29.0,9,14,50,50,4,10,14,54.0,723.0,432,49,77,126,518.0,82,5.51,63,376,2272,9.9
25684,Stephane Yelle,2004-05,30.0,10,17,73,73,5,12,17,71.0,1024.0,505,54,89,143,589.0,82,5.24,53,338,2262,9.5
25685,Stephane Yelle,2005-06,31.0,11,25,82,82,10,15,25,121.0,1484.0,587,64,104,168,710.0,82,5.31,60,363,2326,9.4
25686,Stephane Yelle,2006-07,32.0,12,17,53,53,4,13,17,76.0,838.0,640,68,117,185,786.0,82,5.14,57,348,2300,9.2
25687,Stephane Yelle,2008-09,34.0,13,18,74,74,4,14,18,93.0,1069.0,714,72,131,203,879.0,82,6.05,85,480,2458,10.1
25688,Stephane Yelle,2009-10,35.0,14,24,56,56,10,14,24,55.0,819.0,770,82,145,227,934.0,82,5.76,70,398,2426,9.7
25689,Stephane Yelle,2010-11,36.0,15,12,74,74,3,9,12,62.0,884.0,844,85,154,239,996.0,82,5.44,62,351,2383,9.4
25690,Stephane Yelle,2011-12,37.0,16,18,77,77,7,11,18,72.0,1022.0,921,92,165,257,1068.0,82,5.7,65,341,2477,9.4
25691,Stephane Yelle,2012-13,38.0,17,8,70,70,4,4,8,39.0,662.0,991,96,169,265,1107.0,82,5.53,56,304,2486,9.1
25692,Stephen Gionta,2013-14,30.0,4,0,12,12,0,0,0,13.0,108.0,12,0,0,0,13.0,82,5.46,52,291,2492,9.0
25693,Stephen Gionta,2014-15,31.0,5,1,1,1,1,0,1,2.0,11.0,13,1,0,1,15.0,82,5.32,47,271,2439,8.9
25694,Stephen Gionta,2015-16,32.0,6,14,48,48,4,10,14,58.0,625.0,61,5,10,15,73.0,48,5.31,29,160,1399,9.1
25695,Stephen Gionta,2016-17,33.0,7,11,66,66,4,7,11,89.0,822.0,127,9,17,26,162.0,82,5.34,48,269,2463,8.9
25696,Stephen Gionta,2017-18,34.0,8,13,61,61,5,8,13,84.0,804.0,188,14,25,39,246.0,82,5.32,47,251,2453,8.9
25697,Stephen Gionta,2018-19,35.0,9,11,82,82,1,10,11,62.0,1001.0,270,15,35,50,308.0,82,5.34,48,255,2438,9.0
25698,Stephen Gionta,2019-20,36.0,10,6,26,26,1,5,6,17.0,291.0,296,16,40,56,325.0,82,5.45,47,245,2478,9.0
25699,Stephen Gionta,2021-22,38.0,11,0,5,5,0,0,0,4.0,44.0,301,16,40,56,329.0,82,5.96,47,239,2579,9.5
25700,Stephen Johns,2018-19,26.0,4,3,14,14,1,2,3,13.0,250.0,14,1,2,3,13.0,82,5.34,48,255,2438,9.0
25701,Stephen Johns,2019-20,27.0,5,10,61,61,4,6,10,91.0,1114.0,75,5,8,13,104.0,82,5.45,47,245,2478,9.0
25702,Stephen Johns,2020-21,28.0,6,15,75,75,8,7,15,121.0,1316.0,150,13,15,28,225.0,82,5.86,50,250,2620,9.2
25703,Stephen Johns,2022-23,30.0,7,5,17,17,2,3,5,30.0,300.0,167,15,18,33,255.0,70,5.96,42,208,2192,9.5
25704,Stephen Leach,1988-89,23.0,4,2,11,11,1,1,2,4.0,,11,1,1,2,4.0,80,7.94,82,370,2484,12.8
25705,Stephen Leach,1989-90,24.0,5,1,15,15,1,0,1,17.0,,26,2,1,3,21.0,80,7.34,72,344,2400,12.2
25706,Stephen Leach,1990-91,25.0,6,2,8,8,1,1,2,5.0,,34,3,2,5,26.0,80,7.43,89,437,2435,12.2
25707,Stephen Leach,1991-92,26.0,7,30,74,74,11,19,30,145.0,,108,14,21,35,171.0,80,7.48,85,403,2430,12.3
25708,Stephen Leach,1992-93,27.0,8,32,70,70,18,14,32,122.0,,178,32,35,67,293.0,80,7.37,76,367,2421,12.2
25709,Stephen Leach,1993-94,28.0,9,30,68,68,11,19,30,134.0,,246,43,54,97,427.0,80,6.91,71,366,2385,11.6
25710,Stephen Leach,1994-95,29.0,10,60,78,78,31,29,60,243.0,,324,74,83,157,670.0,80,6.96,77,402,2440,11.4
25711,Stephen Leach,1995-96,30.0,11,51,79,79,26,25,51,256.0,,403,100,108,208,926.0,84,7.25,87,443,2603,11.7
25712,Stephen Leach,1996-97,31.0,12,15,42,42,5,10,15,89.0,,445,105,118,223,1015.0,84,6.48,76,407,2545,10.7
25713,Stephen Leach,1997-98,32.0,13,11,35,35,5,6,11,82.0,,480,110,124,234,1097.0,48,5.97,37,209,1408,10.2
25714,Stephen Leach,1998-99,33.0,14,28,73,73,11,17,28,157.0,,553,121,141,262,1254.0,82,6.29,74,413,2481,10.4
25715,Stephen Leach,1999-00,34.0,15,3,17,17,2,1,3,33.0,,570,123,142,265,1287.0,82,5.83,55,336,2444,9.8
25716,Stephen Leach,2000-01,35.0,16,9,45,45,4,5,9,60.0,,615,127,147,274,1347.0,82,5.28,57,380,2242,9.6
25717,Stephen Leach,2001-02,36.0,17,4,31,31,1,3,4,27.0,260.0,646,128,150,278,1374.0,82,5.27,57,359,2285,9.4
25718,Stephen Leach,2002-03,37.0,18,5,56,56,2,3,5,41.0,372.0,702,130,153,283,1415.0,82,5.49,53,331,2294,9.8
25719,Stephen Peat,2004-05,24.0,4,4,38,38,2,2,4,11.0,192.0,38,2,2,4,11.0,82,5.24,53,338,2262,9.5
25720,Stephen Peat,2005-06,25.0,5,1,27,27,1,0,1,7.0,112.0,65,3,2,5,18.0,82,5.31,60,363,2326,9.4
25721,Stephen Peat,2006-07,26.0,6,5,64,64,5,0,5,21.0,424.0,129,8,2,10,39.0,82,5.14,57,348,2300,9.2
25722,Stephen Peat,2008-09,28.0,7,0,1,1,0,0,0,2.0,5.0,130,8,2,10,41.0,82,6.05,85,480,2458,10.1
25723,Stephen Tepper,1995-96,26.0,4,0,1,1,0,0,0,0.0,,1,0,0,0,0.0,84,7.25,87,443,2603,11.7
25724,Stephen Weiss,2004-05,21.0,4,2,7,7,1,1,2,15.0,114.0,7,1,1,2,15.0,82,5.24,53,338,2262,9.5
25725,Stephen Weiss,2005-06,22.0,5,21,77,77,6,15,21,87.0,1100.0,84,7,16,23,102.0,82,5.31,60,363,2326,9.4
25726,Stephen Weiss,2006-07,23.0,6,29,50,50,12,17,29,82.0,885.0,134,19,33,52,184.0,82,5.14,57,348,2300,9.2
25727,Stephen Weiss,2008-09,25.0,7,21,41,41,9,12,21,74.0,625.0,175,28,45,73,258.0,82,6.05,85,480,2458,10.1
25728,Stephen Weiss,2009-10,26.0,8,48,74,74,20,28,48,176.0,1266.0,249,48,73,121,434.0,82,5.76,70,398,2426,9.7
25729,Stephen Weiss,2010-11,27.0,9,42,74,74,13,29,42,132.0,1301.0,323,61,102,163,566.0,82,5.44,62,351,2383,9.4
25730,Stephen Weiss,2011-12,28.0,10,61,78,78,14,47,61,154.0,1389.0,401,75,149,224,720.0,82,5.7,65,341,2477,9.4
25731,Stephen Weiss,2012-13,29.0,11,60,80,80,28,32,60,180.0,1600.0,481,103,181,284,900.0,82,5.53,56,304,2486,9.1
25732,Stephen Weiss,2013-14,30.0,12,49,76,76,21,28,49,172.0,1528.0,557,124,209,333,1072.0,82,5.46,52,291,2492,9.0
25733,Stephen Weiss,2014-15,31.0,13,57,80,80,20,37,57,149.0,1641.0,637,144,246,390,1221.0,82,5.32,47,271,2439,8.9
25734,Stephen Weiss,2015-16,32.0,14,4,17,17,1,3,4,19.0,314.0,654,145,249,394,1240.0,48,5.31,29,160,1399,9.1
25735,Stephen Weiss,2016-17,33.0,15,4,26,26,2,2,4,28.0,384.0,680,147,251,398,1268.0,82,5.34,48,269,2463,8.9
25736,Stephen Weiss,2017-18,34.0,16,25,52,52,9,16,25,52.0,590.0,732,156,267,423,1320.0,82,5.32,47,251,2453,8.9
25737,Steve Alley,1982-83,29.0,4,2,7,7,1,1,2,5.0,,7,1,1,2,5.0,80,7.03,61,280,2352,12.0
25738,Steve Alley,1983-84,30.0,5,4,8,8,2,2,4,10.0,,15,3,3,6,15.0,80,7.69,77,340,2441,12.6
25739,Steve Bancroft,1995-96,25.0,4,0,1,1,0,0,0,0.0,,1,0,0,0,0.0,84,7.25,87,443,2603,11.7
25740,Steve Bancroft,2004-05,34.0,5,1,5,5,0,1,1,5.0,52.0,6,0,1,1,5.0,82,5.24,53,338,2262,9.5
25741,Steve Begin,2000-01,22.0,4,0,5,5,0,0,0,2.0,,5,0,0,0,2.0,82,5.28,57,380,2242,9.6
25742,Steve Begin,2002-03,24.0,5,2,13,13,1,1,2,3.0,94.0,18,1,1,2,5.0,82,5.49,53,331,2294,9.8
25743,Steve Begin,2003-04,25.0,6,0,4,4,0,0,0,3.0,24.0,22,1,1,2,8.0,82,5.51,63,376,2272,9.9
25744,Steve Begin,2004-05,26.0,7,12,51,51,7,5,12,65.0,480.0,73,8,6,14,73.0,82,5.24,53,338,2262,9.5
25745,Steve Begin,2005-06,27.0,8,4,50,50,3,1,4,59.0,461.0,123,11,7,18,132.0,82,5.31,60,363,2326,9.4
25746,Steve Begin,2006-07,28.0,9,15,52,52,10,5,15,91.0,652.0,175,21,12,33,223.0,82,5.14,57,348,2300,9.2
25747,Steve Begin,2008-09,30.0,10,23,76,76,11,12,23,134.0,1087.0,251,32,24,56,357.0,82,6.05,85,480,2458,10.1
25748,Steve Begin,2009-10,31.0,11,10,52,52,5,5,10,64.0,619.0,303,37,29,66,421.0,82,5.76,70,398,2426,9.7
25749,Steve Begin,2010-11,32.0,12,8,44,44,3,5,8,67.0,512.0,347,40,34,74,488.0,82,5.44,62,351,2383,9.4
25750,Steve Begin,2011-12,33.0,13,12,62,62,7,5,12,90.0,665.0,409,47,39,86,578.0,82,5.7,65,341,2477,9.4
25751,Steve Begin,2012-13,34.0,14,14,77,77,5,9,14,110.0,988.0,486,52,48,100,688.0,82,5.53,56,304,2486,9.1
25752,Steve Begin,2013-14,35.0,15,0,2,2,0,0,0,2.0,20.0,488,52,48,100,690.0,82,5.46,52,291,2492,9.0
25753,Steve Begin,2015-16,37.0,16,8,36,36,4,4,8,31.0,288.0,524,56,52,108,721.0,48,5.31,29,160,1399,9.1
25754,Steve Bernier,2008-09,23.0,4,27,39,39,14,13,27,75.0,551.0,39,14,13,27,75.0,82,6.05,85,480,2458,10.1
25755,Steve Bernier,2009-10,24.0,5,31,62,62,15,16,31,104.0,842.0,101,29,29,58,179.0,82,5.76,70,398,2426,9.7
25756,Steve Bernier,2010-11,25.0,6,32,76,76,16,16,32,131.0,1014.0,177,45,45,90,310.0,82,5.44,62,351,2383,9.4
25757,Steve Bernier,2011-12,26.0,7,32,81,81,15,17,32,137.0,1121.0,258,60,62,122,447.0,82,5.7,65,341,2477,9.4
25758,Steve Bernier,2012-13,27.0,8,22,59,59,11,11,22,95.0,836.0,317,71,73,144,542.0,82,5.53,56,304,2486,9.1
25759,Steve Bernier,2013-14,28.0,9,15,68,68,5,10,15,97.0,886.0,385,76,83,159,639.0,82,5.46,52,291,2492,9.0
25760,Steve Bernier,2014-15,29.0,10,6,32,32,1,5,6,23.0,383.0,417,77,88,165,662.0,82,5.32,47,271,2439,8.9
25761,Steve Bernier,2015-16,30.0,11,15,47,47,8,7,15,88.0,647.0,464,85,95,180,750.0,48,5.31,29,160,1399,9.1
25762,Steve Bernier,2016-17,31.0,12,12,78,78,3,9,12,104.0,971.0,542,88,104,192,854.0,82,5.34,48,269,2463,8.9
25763,Steve Bernier,2017-18,32.0,13,32,67,67,16,16,32,107.0,867.0,609,104,120,224,961.0,82,5.32,47,251,2453,8.9
25764,Steve Bernier,2018-19,33.0,14,6,24,24,1,5,6,27.0,269.0,633,105,125,230,988.0,82,5.34,48,255,2438,9.0
25765,Steve Bernier,2020-21,35.0,15,0,4,4,0,0,0,4.0,40.0,637,105,125,230,992.0,82,5.86,50,250,2620,9.2
25766,Steve Bozek,1984-85,24.0,4,56,71,71,33,23,56,182.0,,71,33,23,56,182.0,80,8.03,73,320,2489,12.9
25767,Steve Bozek,1985-86,25.0,5,26,53,53,13,13,26,104.0,,124,46,36,82,286.0,80,7.73,71,310,2444,12.7
25768,Steve Bozek,1986-87,26.0,6,20,46,46,10,10,20,76.0,,170,56,46,102,362.0,80,7.89,74,336,2448,12.9
25769,Steve Bozek,1987-88,27.0,7,35,54,54,13,22,35,90.0,,224,69,68,137,452.0,80,7.77,71,321,2447,12.7
25770,Steve Bozek,1988-89,28.0,8,43,64,64,21,22,43,147.0,,288,90,90,180,599.0,80,7.94,82,370,2484,12.8
25771,Steve Bozek,1989-90,29.0,9,35,71,71,17,18,35,137.0,,359,107,108,215,736.0,80,7.34,72,344,2400,12.2
25772,Steve Bozek,1990-91,30.0,10,10,33,33,3,7,10,43.0,,392,110,115,225,779.0,80,7.43,89,437,2435,12.2
25773,Steve Bozek,1991-92,31.0,11,35,71,71,17,18,35,138.0,,463,127,133,260,917.0,80,7.48,85,403,2430,12.3
25774,Steve Bozek,1992-93,32.0,12,23,58,58,14,9,23,105.0,,521,141,142,283,1022.0,80,7.37,76,367,2421,12.2
25775,Steve Bozek,1993-94,33.0,13,32,62,62,15,17,32,126.0,,583,156,159,315,1148.0,80,6.91,71,366,2385,11.6
25776,Steve Bozek,1994-95,34.0,14,16,58,58,8,8,16,105.0,,641,164,167,331,1253.0,80,6.96,77,402,2440,11.4
25777,Steve Brule,2005-06,31.0,4,0,2,2,0,0,0,2.0,18.0,2,0,0,0,2.0,82,5.31,60,363,2326,9.4
25778,Steve Carlson,1982-83,27.0,4,21,52,52,9,12,21,45.0,,52,9,12,21,45.0,80,7.03,61,280,2352,12.0
25779,Steve Chiasson,1989-90,22.0,4,5,45,45,1,4,5,44.0,,45,1,4,5,44.0,80,7.34,72,344,2400,12.2
25780,Steve Chiasson,1990-91,23.0,5,11,29,29,2,9,11,45.0,,74,3,13,16,89.0,80,7.43,89,437,2435,12.2
25781,Steve Chiasson,1991-92,24.0,6,47,65,65,12,35,47,187.0,,139,15,48,63,276.0,80,7.48,85,403,2430,12.3
25782,Steve Chiasson,1992-93,25.0,7,42,67,67,14,28,42,190.0,,206,29,76,105,466.0,80,7.37,76,367,2421,12.2
25783,Steve Chiasson,1993-94,26.0,8,20,42,42,3,17,20,101.0,,248,32,93,125,567.0,80,6.91,71,366,2385,11.6
25784,Steve Chiasson,1994-95,27.0,9,34,62,62,10,24,34,143.0,,310,42,117,159,710.0,80,6.96,77,402,2440,11.4
25785,Steve Chiasson,1995-96,28.0,10,62,79,79,12,50,62,227.0,,389,54,167,221,937.0,84,7.25,87,443,2603,11.7
25786,Steve Chiasson,1996-97,29.0,11,46,82,82,13,33,46,238.0,,471,67,200,267,1175.0,84,6.48,76,407,2545,10.7
25787,Steve Chiasson,1997-98,30.0,12,25,45,45,2,23,25,110.0,,516,69,223,292,1285.0,48,5.97,37,209,1408,10.2
25788,Steve Chiasson,1998-99,31.0,13,33,76,76,8,25,33,175.0,,592,77,248,325,1460.0,82,6.29,74,413,2481,10.4
25789,Steve Chiasson,1999-00,32.0,14,30,65,65,8,22,30,168.0,,657,85,270,355,1628.0,82,5.83,55,336,2444,9.8
25790,Steve Chiasson,2000-01,33.0,15,34,66,66,7,27,34,173.0,,723,92,297,389,1801.0,82,5.28,57,380,2242,9.6
25791,Steve Chiasson,2001-02,34.0,16,9,28,28,1,8,9,74.0,649.0,751,93,305,398,1875.0,82,5.27,57,359,2285,9.4
25792,Steve Christoff,1982-83,25.0,4,15,20,20,8,7,15,34.0,,20,8,7,15,34.0,80,7.03,61,280,2352,12.0
25793,Steve Christoff,1983-84,26.0,5,39,56,56,26,13,39,132.0,,76,34,20,54,166.0,80,7.69,77,340,2441,12.6
25794,Steve Christoff,1984-85,27.0,6,55,69,69,26,29,55,178.0,,145,60,49,109,344.0,80,8.03,73,320,2489,12.9
25795,Steve Christoff,1985-86,28.0,7,17,45,45,9,8,17,50.0,,190,69,57,126,394.0,80,7.73,71,310,2444,12.7
25796,Steve Christoff,1986-87,29.0,8,15,58,58,8,7,15,74.0,,248,77,64,141,468.0,80,7.89,74,336,2448,12.9
25797,Steve Downie,2010-11,23.0,4,12,32,32,6,6,12,25.0,315.0,32,6,6,12,25.0,82,5.44,62,351,2383,9.4
25798,Steve Downie,2011-12,24.0,5,6,29,29,3,3,6,26.0,244.0,61,9,9,18,51.0,82,5.7,65,341,2477,9.4
25799,Steve Downie,2012-13,25.0,6,46,79,79,22,24,46,116.0,1162.0,140,31,33,64,167.0,82,5.53,56,304,2486,9.1
25800,Steve Downie,2013-14,26.0,7,32,57,57,10,22,32,83.0,828.0,197,41,55,96,250.0,82,5.46,52,291,2492,9.0
25801,Steve Downie,2014-15,27.0,8,41,75,75,14,27,41,140.0,1195.0,272,55,82,137,390.0,82,5.32,47,271,2439,8.9
25802,Steve Downie,2015-16,28.0,9,1,2,2,0,1,1,2.0,18.0,274,55,83,138,392.0,48,5.31,29,160,1399,9.1
25803,Steve Downie,2016-17,29.0,10,24,62,62,4,20,24,88.0,874.0,336,59,103,162,480.0,82,5.34,48,269,2463,8.9
25804,Steve Downie,2017-18,30.0,11,28,72,72,14,14,28,104.0,895.0,408,73,117,190,584.0,82,5.32,47,251,2453,8.9
25805,Steve Downie,2018-19,31.0,12,6,26,26,3,3,6,22.0,234.0,434,76,120,196,606.0,82,5.34,48,255,2438,9.0
25806,Steve Dubinsky,1996-97,26.0,4,8,27,27,2,6,8,20.0,,27,2,6,8,20.0,84,6.48,76,407,2545,10.7
25807,Steve Dubinsky,1997-98,27.0,5,0,16,16,0,0,0,16.0,,43,2,6,8,36.0,48,5.97,37,209,1408,10.2
25808,Steve Dubinsky,1998-99,28.0,6,5,43,43,2,3,5,33.0,,86,4,9,13,69.0,82,6.29,74,413,2481,10.4
25809,Steve Dubinsky,1999-00,29.0,7,0,5,5,0,0,0,4.0,,91,4,9,13,73.0,82,5.83,55,336,2444,9.8
25810,Steve Dubinsky,2000-01,30.0,8,18,82,82,5,13,18,112.0,,173,9,22,31,185.0,82,5.28,57,380,2242,9.6
25811,Steve Dubinsky,2001-02,31.0,9,14,62,62,4,10,14,70.0,898.0,235,13,32,45,255.0,82,5.27,57,359,2285,9.4
25812,Steve Dubinsky,2002-03,32.0,10,1,23,23,0,1,1,29.0,278.0,258,13,33,46,284.0,82,5.49,53,331,2294,9.8
25813,Steve Dubinsky,2003-04,33.0,11,10,60,60,6,4,10,70.0,660.0,318,19,37,56,354.0,82,5.51,63,376,2272,9.9
25814,Steve Dubinsky,2004-05,34.0,12,8,29,29,6,2,8,48.0,449.0,347,25,39,64,402.0,82,5.24,53,338,2262,9.5
25815,Steve Dubinsky,2005-06,35.0,13,6,28,28,0,6,6,23.0,301.0,375,25,45,70,425.0,82,5.31,60,363,2326,9.4
25816,Steve Duchesne,1989-90,24.0,4,38,75,75,13,25,38,113.0,,75,13,25,38,113.0,80,7.34,72,344,2400,12.2
25817,Steve Duchesne,1990-91,25.0,5,55,71,71,16,39,55,190.0,,146,29,64,93,303.0,80,7.43,89,437,2435,12.2
25818,Steve Duchesne,1991-92,26.0,6,75,79,79,25,50,75,215.0,,225,54,114,168,518.0,80,7.48,85,403,2430,12.3
25819,Steve Duchesne,1992-93,27.0,7,62,79,79,20,42,62,224.0,,304,74,156,230,742.0,80,7.37,76,367,2421,12.2
25820,Steve Duchesne,1993-94,28.0,8,62,78,78,21,41,62,171.0,,382,95,197,292,913.0,80,6.91,71,366,2385,11.6
25821,Steve Duchesne,1994-95,29.0,9,56,78,78,18,38,56,229.0,,460,113,235,348,1142.0,80,6.96,77,402,2440,11.4
25822,Steve Duchesne,1995-96,30.0,10,82,82,82,20,62,82,227.0,,542,133,297,430,1369.0,84,7.25,87,443,2603,11.7
25823,Steve Duchesne,1996-97,31.0,11,31,36,36,12,19,31,115.0,,578,145,316,461,1484.0,84,6.48,76,407,2545,10.7
25824,Steve Duchesne,1997-98,32.0,12,38,47,47,12,26,38,116.0,,625,157,342,499,1600.0,48,5.97,37,209,1408,10.2
25825,Steve Duchesne,1998-99,33.0,13,36,62,62,12,24,36,163.0,,687,169,366,535,1763.0,82,6.29,74,413,2481,10.4
25826,Steve Duchesne,1999-00,34.0,14,47,78,78,19,28,47,208.0,,765,188,394,582,1971.0,82,5.83,55,336,2444,9.8
25827,Steve Duchesne,2000-01,35.0,15,56,80,80,14,42,56,153.0,,845,202,436,638,2124.0,82,5.28,57,380,2242,9.6
25828,Steve Duchesne,2001-02,36.0,16,30,71,71,6,24,30,118.0,1518.0,916,208,460,668,2242.0,82,5.27,57,359,2285,9.4
25829,Steve Duchesne,2002-03,37.0,17,41,79,79,10,31,41,154.0,1677.0,995,218,491,709,2396.0,82,5.49,53,331,2294,9.8
25830,Steve Duchesne,2003-04,38.0,18,25,54,54,6,19,25,76.0,990.0,1049,224,510,734,2472.0,82,5.51,63,376,2272,9.9
25831,Steve Duchesne,2004-05,39.0,19,18,64,64,3,15,18,70.0,1017.0,1113,227,525,752,2542.0,82,5.24,53,338,2262,9.5
25832,Steve Dykstra,1988-89,26.0,4,25,64,64,4,21,25,70.0,,64,4,21,25,70.0,80,7.94,82,370,2484,12.8
25833,Steve Dykstra,1989-90,27.0,5,1,37,37,0,1,1,21.0,,101,4,22,26,91.0,80,7.34,72,344,2400,12.2
25834,Steve Dykstra,1990-91,28.0,6,7,42,42,3,4,7,26.0,,143,7,26,33,117.0,80,7.43,89,437,2435,12.2
25835,Steve Dykstra,1991-92,29.0,7,7,65,65,1,6,7,38.0,,208,8,32,40,155.0,80,7.48,85,403,2430,12.3
25836,Steve Dykstra,1992-93,30.0,8,0,9,9,0,0,0,10.0,,217,8,32,40,165.0,80,7.37,76,367,2421,12.2
25837,Steve Eminger,2005-06,22.0,4,2,17,17,0,2,2,6.0,172.0,17,0,2,2,6.0,82,5.31,60,363,2326,9.4
25838,Steve Eminger,2006-07,23.0,5,4,41,41,0,4,4,12.0,719.0,58,0,6,6,18.0,82,5.14,57,348,2300,9.2
25839,Steve Eminger,2008-09,25.0,6,18,66,66,5,13,18,50.0,1409.0,124,5,19,24,68.0,82,6.05,85,480,2458,10.1
25840,Steve Eminger,2009-10,26.0,7,17,68,68,1,16,17,27.0,1288.0,192,6,35,41,95.0,82,5.76,70,398,2426,9.7
25841,Steve Eminger,2010-11,27.0,8,2,20,20,0,2,2,14.0,223.0,212,6,37,43,109.0,82,5.44,62,351,2383,9.4
25842,Steve Eminger,2011-12,28.0,9,26,71,71,5,21,26,85.0,1535.0,283,11,58,69,194.0,82,5.7,65,341,2477,9.4
25843,Steve Eminger,2012-13,29.0,10,16,63,63,4,12,16,45.0,1227.0,346,15,70,85,239.0,82,5.53,56,304,2486,9.1
25844,Steve Eminger,2013-14,30.0,11,6,65,65,2,4,6,23.0,1030.0,411,17,74,91,262.0,82,5.46,52,291,2492,9.0
25845,Steve Eminger,2014-15,31.0,12,5,42,42,2,3,5,19.0,558.0,453,19,77,96,281.0,82,5.32,47,271,2439,8.9
25846,Steve Eminger,2015-16,32.0,13,3,35,35,0,3,3,22.0,456.0,488,19,80,99,303.0,48,5.31,29,160,1399,9.1
25847,Steve Gainey,2003-04,25.0,4,0,1,1,0,0,0,0.0,2.0,1,0,0,0,0.0,82,5.51,63,376,2272,9.9
25848,Steve Gainey,2004-05,26.0,5,1,5,5,0,1,1,1.0,37.0,6,0,1,1,1.0,82,5.24,53,338,2262,9.5
25849,Steve Gainey,2006-07,28.0,6,0,7,7,0,0,0,0.0,38.0,13,0,1,1,1.0,82,5.14,57,348,2300,9.2
25850,Steve Gainey,2008-09,30.0,7,1,20,20,0,1,1,11.0,165.0,33,0,2,2,12.0,82,6.05,85,480,2458,10.1
25851,Steve Gatzos,1984-85,23.0,4,14,16,16,6,8,14,36.0,,16,6,8,14,36.0,80,8.03,73,320,2489,12.9
25852,Steve Gatzos,1985-86,24.0,5,13,44,44,6,7,13,70.0,,60,12,15,27,106.0,80,7.73,71,310,2444,12.7
25853,Steve Gatzos,1986-87,25.0,6,6,23,23,3,3,6,29.0,,83,15,18,33,135.0,80,7.89,74,336,2448,12.9
25854,Steve Gatzos,1987-88,26.0,7,2,6,6,0,2,2,6.0,,89,15,20,35,141.0,80,7.77,71,321,2447,12.7
25855,Steve Gotaas,1990-91,23.0,4,11,36,36,5,6,11,27.0,,36,5,6,11,27.0,80,7.43,89,437,2435,12.2
25856,Steve Gotaas,1991-92,24.0,5,4,12,12,1,3,4,18.0,,48,6,9,15,45.0,80,7.48,85,403,2430,12.3
25857,Steve Gotaas,1993-94,26.0,6,0,1,1,0,0,0,2.0,,49,6,9,15,47.0,80,6.91,71,366,2385,11.6
25858,Steve Graves,1986-87,22.0,4,0,2,2,0,0,0,2.0,,2,0,0,0,2.0,80,7.89,74,336,2448,12.9
25859,Steve Graves,1989-90,25.0,5,2,12,12,2,0,2,12.0,,14,2,0,2,14.0,80,7.34,72,344,2400,12.2
25860,Steve Graves,1990-91,26.0,6,7,21,21,3,4,7,21.0,,35,5,4,9,35.0,80,7.43,89,437,2435,12.2
25861,Steve Guolla,1999-00,26.0,4,21,43,43,13,8,21,81.0,,43,13,8,21,81.0,82,5.83,55,336,2444,9.8
25862,Steve Guolla,2000-01,27.0,5,2,7,7,1,1,2,9.0,,50,14,9,23,90.0,82,5.28,57,380,2242,9.6
25863,Steve Guolla,2001-02,28.0,6,4,14,14,2,2,4,22.0,195.0,64,16,11,27,112.0,82,5.27,57,359,2285,9.4
25864,Steve Guolla,2002-03,29.0,7,29,66,66,10,19,29,86.0,882.0,130,26,30,56,198.0,82,5.49,53,331,2294,9.8
25865,Steve Guolla,2003-04,30.0,8,28,63,63,12,16,28,96.0,925.0,193,38,46,84,294.0,82,5.51,63,376,2272,9.9
25866,Steve Guolla,2005-06,32.0,9,2,12,12,2,0,2,6.0,96.0,205,40,46,86,300.0,82,5.31,60,363,2326,9.4
25867,Steve Hazlett,1982-83,25.0,4,0,1,1,0,0,0,2.0,,1,0,0,0,2.0,80,7.03,61,280,2352,12.0
25868,Steve Heinze,1994-95,25.0,4,7,14,14,3,4,7,29.0,,14,3,4,7,29.0,80,6.96,77,402,2440,11.4
25869,Steve Heinze,1995-96,26.0,5,31,73,73,18,13,31,146.0,,87,21,17,38,175.0,84,7.25,87,443,2603,11.7
25870,Steve Heinze,1996-97,27.0,6,21,77,77,10,11,21,183.0,,164,31,28,59,358.0,84,6.48,76,407,2545,10.7
25871,Steve Heinze,1997-98,28.0,7,16,36,36,7,9,16,70.0,,200,38,37,75,428.0,48,5.97,37,209,1408,10.2
25872,Steve Heinze,1998-99,29.0,8,28,76,76,16,12,28,129.0,,276,54,49,103,557.0,82,6.29,74,413,2481,10.4
25873,Steve Heinze,1999-00,30.0,9,25,30,30,17,8,25,96.0,,306,71,57,128,653.0,82,5.83,55,336,2444,9.8
25874,Steve Heinze,2000-01,31.0,10,46,61,61,26,20,46,160.0,,367,97,77,174,813.0,82,5.28,57,380,2242,9.6
25875,Steve Heinze,2001-02,32.0,11,40,73,73,22,18,40,146.0,1153.0,440,119,95,214,959.0,82,5.27,57,359,2285,9.4
25876,Steve Heinze,2002-03,33.0,12,25,75,75,12,13,25,145.0,1121.0,515,131,108,239,1104.0,82,5.49,53,331,2294,9.8
25877,Steve Heinze,2003-04,34.0,13,54,79,79,27,27,54,144.0,1439.0,594,158,135,293,1248.0,82,5.51,63,376,2272,9.9
25878,Steve Heinze,2004-05,35.0,14,31,73,73,15,16,31,123.0,1152.0,667,173,151,324,1371.0,82,5.24,53,338,2262,9.5
25879,Steve Heinze,2005-06,36.0,15,12,27,27,5,7,12,44.0,413.0,694,178,158,336,1415.0,82,5.31,60,363,2326,9.4
25880,Steve Junker,1996-97,24.0,4,0,5,5,0,0,0,2.0,,5,0,0,0,2.0,84,6.48,76,407,2545,10.7
25881,Steve Kariya,2002-03,25.0,4,19,45,45,8,11,19,41.0,569.0,45,8,11,19,41.0,82,5.49,53,331,2294,9.8
25882,Steve Kariya,2003-04,26.0,5,7,17,17,1,6,7,22.0,199.0,62,9,17,26,63.0,82,5.51,63,376,2272,9.9
25883,Steve Kariya,2004-05,27.0,6,1,3,3,0,1,1,0.0,37.0,65,9,18,27,63.0,82,5.24,53,338,2262,9.5
25884,Steve Kasper,1983-84,22.0,4,56,76,76,21,35,56,165.0,,76,21,35,56,165.0,80,7.69,77,340,2441,12.6
25885,Steve Kasper,1984-85,23.0,5,51,73,73,20,31,51,151.0,,149,41,66,107,316.0,80,8.03,73,320,2489,12.9
25886,Steve Kasper,1985-86,24.0,6,8,24,24,2,6,8,26.0,,173,43,72,115,342.0,80,7.73,71,310,2444,12.7
25887,Steve Kasper,1986-87,25.0,7,14,27,27,3,11,14,39.0,,200,46,83,129,381.0,80,7.89,74,336,2448,12.9
25888,Steve Kasper,1987-88,26.0,8,40,77,77,16,24,40,144.0,,277,62,107,169,525.0,80,7.77,71,321,2447,12.7
25889,Steve Kasper,1988-89,27.0,9,40,80,80,17,23,40,149.0,,357,79,130,209,674.0,80,7.94,82,370,2484,12.8
25890,Steve Kasper,1989-90,28.0,10,50,79,79,20,30,50,110.0,,436,99,160,259,784.0,80,7.34,72,344,2400,12.2
25891,Steve Kasper,1990-91,29.0,11,70,79,79,26,44,70,166.0,,515,125,204,329,950.0,80,7.43,89,437,2435,12.2
25892,Steve Kasper,1991-92,30.0,12,50,78,78,19,31,50,130.0,,593,144,235,379,1080.0,80,7.48,85,403,2430,12.3
25893,Steve Kasper,1992-93,31.0,13,45,77,77,17,28,45,72.0,,670,161,263,424,1152.0,80,7.37,76,367,2421,12.2
25894,Steve Kasper,1993-94,32.0,14,28,67,67,9,19,28,70.0,,737,170,282,452,1222.0,80,6.91,71,366,2385,11.6
25895,Steve Kasper,1994-95,33.0,15,5,16,16,3,2,5,13.0,,753,173,284,457,1235.0,80,6.96,77,402,2440,11.4
25896,Steve Kasper,1995-96,34.0,16,11,68,68,4,7,11,32.0,,821,177,291,468,1267.0,84,7.25,87,443,2603,11.7
25897,Steve Kelly,1999-00,23.0,4,1,8,8,1,0,1,6.0,,8,1,0,1,6.0,82,5.83,55,336,2444,9.8
25898,Steve Kelly,2000-01,24.0,5,5,43,43,2,3,5,22.0,,51,3,3,6,28.0,82,5.28,57,380,2242,9.6
25899,Steve Kelly,2001-02,25.0,6,4,34,34,1,3,4,15.0,369.0,85,4,6,10,43.0,82,5.27,57,359,2285,9.4
25900,Steve Kelly,2002-03,26.0,7,0,1,1,0,0,0,0.0,4.0,86,4,6,10,43.0,82,5.49,53,331,2294,9.8
25901,Steve Kelly,2003-04,27.0,8,5,35,35,3,2,5,22.0,313.0,121,7,8,15,65.0,82,5.51,63,376,2272,9.9
25902,Steve Kelly,2004-05,28.0,9,1,8,8,0,1,1,0.0,55.0,129,7,9,16,65.0,82,5.24,53,338,2262,9.5
25903,Steve Kelly,2005-06,29.0,10,5,15,15,2,3,5,14.0,187.0,144,9,12,21,79.0,82,5.31,60,363,2326,9.4
25904,Steve Kelly,2006-07,30.0,11,0,3,3,0,0,0,5.0,32.0,147,9,12,21,84.0,82,5.14,57,348,2300,9.2
25905,Steve Kelly,2010-11,34.0,12,0,2,2,0,0,0,1.0,7.0,149,9,12,21,85.0,82,5.44,62,351,2383,9.4
25906,Steve Konowalchuk,1994-95,22.0,4,0,1,1,0,0,0,1.0,,1,0,0,0,1.0,80,6.96,77,402,2440,11.4
25907,Steve Konowalchuk,1995-96,23.0,5,11,36,36,4,7,11,34.0,,37,4,7,11,35.0,84,7.25,87,443,2603,11.7
25908,Steve Konowalchuk,1996-97,24.0,6,26,62,62,12,14,26,63.0,,99,16,21,37,98.0,84,6.48,76,407,2545,10.7
25909,Steve Konowalchuk,1997-98,25.0,7,25,46,46,11,14,25,88.0,,145,27,35,62,186.0,48,5.97,37,209,1408,10.2
25910,Steve Konowalchuk,1998-99,26.0,8,45,70,70,23,22,45,197.0,,215,50,57,107,383.0,82,6.29,74,413,2481,10.4
25911,Steve Konowalchuk,1999-00,27.0,9,42,78,78,17,25,42,155.0,,293,67,82,149,538.0,82,5.83,55,336,2444,9.8
25912,Steve Konowalchuk,2000-01,28.0,10,34,80,80,10,24,34,131.0,,373,77,106,183,669.0,82,5.28,57,380,2242,9.6
25913,Steve Konowalchuk,2001-02,29.0,11,24,45,45,12,12,24,98.0,803.0,418,89,118,207,767.0,82,5.27,57,359,2285,9.4
25914,Steve Konowalchuk,2002-03,30.0,12,43,82,82,16,27,43,146.0,1444.0,500,105,145,250,913.0,82,5.49,53,331,2294,9.8
25915,Steve Konowalchuk,2003-04,31.0,13,47,82,82,24,23,47,163.0,1400.0,582,129,168,297,1076.0,82,5.51,63,376,2272,9.9
25916,Steve Konowalchuk,2004-05,32.0,14,14,28,28,2,12,14,36.0,461.0,610,131,180,311,1112.0,82,5.24,53,338,2262,9.5
25917,Steve Konowalchuk,2005-06,33.0,15,30,77,77,15,15,30,119.0,1286.0,687,146,195,341,1231.0,82,5.31,60,363,2326,9.4
25918,Steve Konowalchuk,2006-07,34.0,16,40,82,82,19,21,40,152.0,1481.0,769,165,216,381,1383.0,82,5.14,57,348,2300,9.2
25919,Steve Konowalchuk,2008-09,36.0,17,15,21,21,6,9,15,39.0,348.0,790,171,225,396,1422.0,82,6.05,85,480,2458,10.1
25920,Steve Konroyd,1983-84,22.0,4,0,4,4,0,0,0,0.0,,4,0,0,0,0.0,80,7.69,77,340,2441,12.6
25921,Steve Konroyd,1984-85,23.0,5,17,63,63,3,14,17,57.0,,67,3,14,17,57.0,80,8.03,73,320,2489,12.9
25922,Steve Konroyd,1985-86,24.0,6,17,79,79,4,13,17,80.0,,146,7,27,34,137.0,80,7.73,71,310,2444,12.7
25923,Steve Konroyd,1986-87,25.0,7,14,80,80,1,13,14,94.0,,226,8,40,48,231.0,80,7.89,74,336,2448,12.9
25924,Steve Konroyd,1987-88,26.0,8,26,64,64,3,23,26,121.0,,290,11,63,74,352.0,80,7.77,71,321,2447,12.7
25925,Steve Konroyd,1988-89,27.0,9,32,73,73,7,25,32,124.0,,363,18,88,106,476.0,80,7.94,82,370,2484,12.8
25926,Steve Konroyd,1989-90,28.0,10,21,72,72,5,16,21,119.0,,435,23,104,127,595.0,80,7.34,72,344,2400,12.2
25927,Steve Konroyd,1990-91,29.0,11,17,62,62,2,15,17,105.0,,497,25,119,144,700.0,80,7.43,89,437,2435,12.2
25928,Steve Konroyd,1991-92,30.0,12,18,78,78,6,12,18,132.0,,575,31,131,162,832.0,80,7.48,85,403,2430,12.3
25929,Steve Konroyd,1992-93,31.0,13,17,75,75,3,14,17,93.0,,650,34,145,179,925.0,80,7.37,76,367,2421,12.2
25930,Steve Konroyd,1993-94,32.0,14,12,70,70,0,12,12,93.0,,720,34,157,191,1018.0,80,6.91,71,366,2385,11.6
25931,Steve Konroyd,1994-95,33.0,15,28,82,82,4,24,28,126.0,,802,38,181,219,1144.0,80,6.96,77,402,2440,11.4
25932,Steve Konroyd,1995-96,34.0,16,15,65,65,3,12,15,66.0,,867,41,193,234,1210.0,84,7.25,87,443,2603,11.7
25933,Steve Konroyd,1996-97,35.0,17,2,27,27,0,2,2,21.0,,894,41,195,236,1231.0,84,6.48,76,407,2545,10.7
25934,Steve Konroyd,1997-98,36.0,18,0,1,1,0,0,0,0.0,,895,41,195,236,1231.0,48,5.97,37,209,1408,10.2
25935,Steve Larmer,1983-84,22.0,4,1,4,4,0,1,1,3.0,,4,0,1,1,3.0,80,7.69,77,340,2441,12.6
25936,Steve Larmer,1984-85,23.0,5,0,3,3,0,0,0,1.0,,7,0,1,1,4.0,80,8.03,73,320,2489,12.9
25937,Steve Larmer,1985-86,24.0,6,90,80,80,43,47,90,195.0,,87,43,48,91,199.0,80,7.73,71,310,2444,12.7
25938,Steve Larmer,1986-87,25.0,7,75,80,80,35,40,75,202.0,,167,78,88,166,401.0,80,7.89,74,336,2448,12.9
25939,Steve Larmer,1987-88,26.0,8,86,80,80,46,40,86,209.0,,247,124,128,252,610.0,80,7.77,71,321,2447,12.7
25940,Steve Larmer,1988-89,27.0,9,76,80,80,31,45,76,184.0,,327,155,173,328,794.0,80,7.94,82,370,2484,12.8
25941,Steve Larmer,1989-90,28.0,10,84,80,80,28,56,84,221.0,,407,183,229,412,1015.0,80,7.34,72,344,2400,12.2
25942,Steve Larmer,1990-91,29.0,11,89,80,80,41,48,89,245.0,,487,224,277,501,1260.0,80,7.43,89,437,2435,12.2
25943,Steve Larmer,1991-92,30.0,12,87,80,80,43,44,87,269.0,,567,267,321,588,1529.0,80,7.48,85,403,2430,12.3
25944,Steve Larmer,1992-93,31.0,13,90,80,80,31,59,90,265.0,,647,298,380,678,1794.0,80,7.37,76,367,2421,12.2
25945,Steve Larmer,1993-94,32.0,14,101,80,80,44,57,101,231.0,,727,342,437,779,2025.0,80,6.91,71,366,2385,11.6
25946,Steve Larmer,1994-95,33.0,15,74,80,80,29,45,74,292.0,,807,371,482,853,2317.0,80,6.96,77,402,2440,11.4
25947,Steve Larmer,1995-96,34.0,16,70,84,84,35,35,70,228.0,,891,406,517,923,2545.0,84,7.25,87,443,2603,11.7
25948,Steve Larmer,1996-97,35.0,17,60,68,68,21,39,60,146.0,,959,427,556,983,2691.0,84,6.48,76,407,2545,10.7
25949,Steve Larmer,1997-98,36.0,18,29,47,47,14,15,29,116.0,,1006,441,571,1012,2807.0,48,5.97,37,209,1408,10.2
25950,Steve Larouche,1997-98,26.0,4,15,18,18,8,7,15,38.0,,18,8,7,15,38.0,48,5.97,37,209,1408,10.2
25951,Steve Larouche,1998-99,27.0,5,3,8,8,1,2,3,14.0,,26,9,9,18,52.0,82,6.29,74,413,2481,10.4
25952,Steve Ludzik,1984-85,23.0,4,3,8,8,2,1,3,9.0,,8,2,1,3,9.0,80,8.03,73,320,2489,12.9
25953,Steve Ludzik,1985-86,24.0,5,25,66,66,6,19,25,55.0,,74,8,20,28,64.0,80,7.73,71,310,2444,12.7
25954,Steve Ludzik,1986-87,25.0,6,29,80,80,9,20,29,101.0,,154,17,40,57,165.0,80,7.89,74,336,2448,12.9
25955,Steve Ludzik,1987-88,26.0,7,31,79,79,11,20,31,99.0,,233,28,60,88,264.0,80,7.77,71,321,2447,12.7
25956,Steve Ludzik,1988-89,27.0,8,11,49,49,6,5,11,41.0,,282,34,65,99,305.0,80,7.94,82,370,2484,12.8
25957,Steve Ludzik,1989-90,28.0,9,17,52,52,5,12,17,56.0,,334,39,77,116,361.0,80,7.34,72,344,2400,12.2
25958,Steve Ludzik,1990-91,29.0,10,21,73,73,6,15,21,55.0,,407,45,92,137,416.0,80,7.43,89,437,2435,12.2
25959,Steve Ludzik,1991-92,30.0,11,1,6,6,1,0,1,7.0,,413,46,92,138,423.0,80,7.48,85,403,2430,12.3
25960,Steve Ludzik,1992-93,31.0,12,1,11,11,0,1,1,15.0,,424,46,93,139,438.0,80,7.37,76,367,2421,12.2
25961,Steve MacIntyre,2011-12,31.0,4,2,22,22,2,0,2,6.0,86.0,22,2,0,2,6.0,82,5.7,65,341,2477,9.4
25962,Steve MacIntyre,2012-13,32.0,5,1,22,22,0,1,1,3.0,63.0,44,2,1,3,9.0,82,5.53,56,304,2486,9.1
25963,Steve MacIntyre,2013-14,33.0,6,1,34,34,0,1,1,6.0,120.0,78,2,2,4,15.0,82,5.46,52,291,2492,9.0
25964,Steve MacIntyre,2014-15,34.0,7,0,12,12,0,0,0,0.0,38.0,90,2,2,4,15.0,82,5.32,47,271,2439,8.9
25965,Steve MacIntyre,2015-16,35.0,8,0,1,1,0,0,0,0.0,5.0,91,2,2,4,15.0,48,5.31,29,160,1399,9.1
25966,Steve Maltais,1992-93,24.0,4,0,8,8,0,0,0,11.0,,8,0,0,0,11.0,80,7.37,76,367,2421,12.2
25967,Steve Maltais,1993-94,25.0,5,0,7,7,0,0,0,3.0,,15,0,0,0,14.0,80,6.91,71,366,2385,11.6
25968,Steve Maltais,1994-95,26.0,6,3,12,12,2,1,3,6.0,,27,2,1,3,20.0,80,6.96,77,402,2440,11.4
25969,Steve Maltais,1995-96,27.0,7,20,63,63,7,13,20,96.0,,90,9,14,23,116.0,84,7.25,87,443,2603,11.7
25970,Steve Maltais,1996-97,28.0,8,1,4,4,0,1,1,2.0,,94,9,15,24,118.0,84,6.48,76,407,2545,10.7
25971,Steve Maltais,2003-04,35.0,9,3,26,26,0,3,3,30.0,311.0,120,9,18,27,148.0,82,5.51,63,376,2272,9.9
25972,Steve Martins,1998-99,26.0,4,4,23,23,1,3,4,27.0,,23,1,3,4,27.0,82,6.29,74,413,2481,10.4
25973,Steve Martins,1999-00,27.0,5,1,2,2,0,1,1,2.0,,25,1,4,5,29.0,82,5.83,55,336,2444,9.8
25974,Steve Martins,2000-01,28.0,6,0,3,3,0,0,0,0.0,,28,1,4,5,29.0,82,5.28,57,380,2242,9.6
25975,Steve Martins,2001-02,29.0,7,7,36,36,4,3,7,27.0,305.0,64,5,7,12,56.0,82,5.27,57,359,2285,9.4
25976,Steve Martins,2002-03,30.0,8,13,59,59,6,7,13,65.0,789.0,123,11,14,25,121.0,82,5.49,53,331,2294,9.8
25977,Steve Martins,2003-04,31.0,9,6,59,59,2,4,6,46.0,569.0,182,13,18,31,167.0,82,5.51,63,376,2272,9.9
25978,Steve Martins,2004-05,32.0,10,1,14,14,1,0,1,11.0,134.0,196,14,18,32,178.0,82,5.24,53,338,2262,9.5
25979,Steve Martins,2005-06,33.0,11,11,42,42,5,6,11,38.0,518.0,238,19,24,43,216.0,82,5.31,60,363,2326,9.4
25980,Steve Martins,2006-07,34.0,12,1,25,25,1,0,1,27.0,262.0,263,20,24,44,243.0,82,5.14,57,348,2300,9.2
25981,Steve Martins,2008-09,36.0,13,2,4,4,1,1,2,6.0,31.0,267,21,25,46,249.0,82,6.05,85,480,2458,10.1
25982,Steve Martinson,1990-91,31.0,4,2,10,10,1,1,2,3.0,,10,1,1,2,3.0,80,7.43,89,437,2435,12.2
25983,Steve Martinson,1991-92,32.0,5,1,25,25,1,0,1,8.0,,35,2,1,3,11.0,80,7.48,85,403,2430,12.3
25984,Steve Martinson,1992-93,33.0,6,0,13,13,0,0,0,2.0,,48,2,1,3,13.0,80,7.37,76,367,2421,12.2
25985,Steve Martinson,1994-95,35.0,7,0,1,1,0,0,0,0.0,,49,2,1,3,13.0,80,6.96,77,402,2440,11.4
25986,Steve McCarthy,2002-03,21.0,4,2,5,5,1,1,2,4.0,76.0,5,1,1,2,4.0,82,5.49,53,331,2294,9.8
25987,Steve McCarthy,2003-04,22.0,5,5,44,44,0,5,5,32.0,650.0,49,1,6,7,36.0,82,5.51,63,376,2272,9.9
25988,Steve McCarthy,2004-05,23.0,6,0,3,3,0,0,0,2.0,35.0,52,1,6,7,38.0,82,5.24,53,338,2262,9.5
25989,Steve McCarthy,2005-06,24.0,7,5,57,57,1,4,5,55.0,935.0,109,2,10,12,93.0,82,5.31,60,363,2326,9.4
25990,Steve McCarthy,2006-07,25.0,8,4,25,25,1,3,4,29.0,484.0,134,3,13,16,122.0,82,5.14,57,348,2300,9.2
25991,Steve McCarthy,2008-09,27.0,9,16,67,67,9,7,16,66.0,945.0,201,12,20,32,188.0,82,6.05,85,480,2458,10.1
25992,Steve McCarthy,2009-10,28.0,10,16,46,46,4,12,16,51.0,703.0,247,16,32,48,239.0,82,5.76,70,398,2426,9.7
25993,Steve McCarthy,2010-11,29.0,11,7,55,55,1,6,7,41.0,869.0,302,17,38,55,280.0,82,5.44,62,351,2383,9.4
25994,Steve McKenna,1999-00,26.0,4,0,9,9,0,0,0,6.0,,9,0,0,0,6.0,82,5.83,55,336,2444,9.8
25995,Steve McKenna,2000-01,27.0,5,8,62,62,4,4,8,42.0,,71,4,4,8,48.0,82,5.28,57,380,2242,9.6
25996,Steve McKenna,2001-02,28.0,6,1,20,20,1,0,1,12.0,168.0,91,5,4,9,60.0,82,5.27,57,359,2285,9.4
25997,Steve McKenna,2002-03,29.0,7,5,46,46,0,5,5,14.0,225.0,137,5,9,14,74.0,82,5.49,53,331,2294,9.8
25998,Steve McKenna,2003-04,30.0,8,2,54,54,1,1,2,19.0,271.0,191,6,10,16,93.0,82,5.51,63,376,2272,9.9
25999,Steve McKenna,2004-05,31.0,9,3,54,54,2,1,3,17.0,215.0,245,8,11,19,110.0,82,5.24,53,338,2262,9.5
26000,Steve McKenna,2005-06,32.0,10,10,79,79,9,1,10,59.0,613.0,324,17,12,29,169.0,82,5.31,60,363,2326,9.4
26001,Steve McKenna,2006-07,33.0,11,3,49,49,1,2,3,30.0,310.0,373,18,14,32,199.0,82,5.14,57,348,2300,9.2
26002,Steve McLaren,2006-07,31.0,4,0,6,6,0,0,0,2.0,17.0,6,0,0,0,2.0,82,5.14,57,348,2300,9.2
26003,Steve Montador,2004-05,25.0,4,3,11,11,1,2,3,10.0,134.0,11,1,2,3,10.0,82,5.24,53,338,2262,9.5
26004,Steve Montador,2005-06,26.0,5,2,50,50,1,1,2,64.0,759.0,61,2,3,5,74.0,82,5.31,60,363,2326,9.4
26005,Steve Montador,2006-07,27.0,6,3,26,26,1,2,3,31.0,306.0,87,3,5,8,105.0,82,5.14,57,348,2300,9.2
26006,Steve Montador,2008-09,29.0,7,7,58,58,2,5,7,55.0,801.0,145,5,10,15,160.0,82,6.05,85,480,2458,10.1
26007,Steve Montador,2009-10,30.0,8,9,72,72,1,8,9,88.0,946.0,217,6,18,24,248.0,82,5.76,70,398,2426,9.7
26008,Steve Montador,2010-11,31.0,9,23,73,73,8,15,23,96.0,850.0,290,14,33,47,344.0,82,5.44,62,351,2383,9.4
26009,Steve Montador,2011-12,32.0,10,21,78,78,4,17,21,117.0,1260.0,368,18,50,68,461.0,82,5.7,65,341,2477,9.4
26010,Steve Montador,2012-13,33.0,11,23,78,78,5,18,23,134.0,1333.0,446,23,68,91,595.0,82,5.53,56,304,2486,9.1
26011,Steve Montador,2013-14,34.0,12,26,73,73,5,21,26,118.0,1440.0,519,28,89,117,713.0,82,5.46,52,291,2492,9.0
26012,Steve Montador,2014-15,35.0,13,14,52,52,5,9,14,57.0,768.0,571,33,98,131,770.0,82,5.32,47,271,2439,8.9
26013,Steve Moore,2004-05,26.0,4,0,8,8,0,0,0,5.0,57.0,8,0,0,0,5.0,82,5.24,53,338,2262,9.5
26014,Steve Moore,2005-06,27.0,5,0,4,4,0,0,0,0.0,36.0,12,0,0,0,5.0,82,5.31,60,363,2326,9.4
26015,Steve Moore,2006-07,28.0,6,12,57,57,5,7,12,52.0,747.0,69,5,7,12,57.0,82,5.14,57,348,2300,9.2
26016,Steve Nemeth,1990-91,23.0,4,2,12,12,2,0,2,12.0,,12,2,0,2,12.0,80,7.43,89,437,2435,12.2
26017,Steve Ott,2005-06,23.0,4,7,26,26,3,4,7,25.0,228.0,26,3,4,7,25.0,82,5.31,60,363,2326,9.4
26018,Steve Ott,2006-07,24.0,5,12,73,73,2,10,12,74.0,747.0,99,5,14,19,99.0,82,5.14,57,348,2300,9.2
26019,Steve Ott,2008-09,26.0,6,22,82,82,5,17,22,89.0,976.0,181,10,31,41,188.0,82,6.05,85,480,2458,10.1
26020,Steve Ott,2009-10,27.0,7,4,19,19,0,4,4,17.0,175.0,200,10,35,45,205.0,82,5.76,70,398,2426,9.7
26021,Steve Ott,2010-11,28.0,8,22,73,73,11,11,22,89.0,1056.0,273,21,46,67,294.0,82,5.44,62,351,2383,9.4
26022,Steve Ott,2011-12,29.0,9,46,64,64,19,27,46,132.0,1125.0,337,40,73,113,426.0,82,5.7,65,341,2477,9.4
26023,Steve Ott,2012-13,30.0,10,36,73,73,22,14,36,146.0,1202.0,410,62,87,149,572.0,82,5.53,56,304,2486,9.1
26024,Steve Ott,2013-14,31.0,11,32,82,82,12,20,32,120.0,1407.0,492,74,107,181,692.0,82,5.46,52,291,2492,9.0
26025,Steve Ott,2014-15,32.0,12,39,74,74,11,28,39,108.0,1357.0,566,85,135,220,800.0,82,5.32,47,271,2439,8.9
26026,Steve Ott,2015-16,33.0,13,24,48,48,9,15,24,73.0,891.0,614,94,150,244,873.0,48,5.31,29,160,1399,9.1
26027,Steve Ott,2016-17,34.0,14,23,82,82,9,14,23,127.0,1495.0,696,103,164,267,1000.0,82,5.34,48,269,2463,8.9
26028,Steve Ott,2017-18,35.0,15,12,78,78,3,9,12,49.0,907.0,774,106,173,279,1049.0,82,5.32,47,251,2453,8.9
26029,Steve Ott,2018-19,36.0,16,2,21,21,0,2,2,21.0,229.0,795,106,175,281,1070.0,82,5.34,48,255,2438,9.0
26030,Steve Ott,2019-20,37.0,17,7,53,53,3,4,7,45.0,570.0,848,109,179,288,1115.0,82,5.45,47,245,2478,9.0
26031,Steve Patrick,1983-84,22.0,4,8,30,30,1,7,8,35.0,,30,1,7,8,35.0,80,7.69,77,340,2441,12.6
26032,Steve Patrick,1984-85,23.0,5,16,41,41,8,8,16,52.0,,71,9,15,24,87.0,80,8.03,73,320,2489,12.9
26033,Steve Patrick,1985-86,24.0,6,22,56,56,9,13,22,63.0,,127,18,28,46,150.0,80,7.73,71,310,2444,12.7
26034,Steve Patrick,1986-87,25.0,7,5,11,11,1,4,5,11.0,,138,19,32,51,161.0,80,7.89,74,336,2448,12.9
26035,Steve Patrick,1987-88,26.0,8,33,57,57,13,20,33,74.0,,195,32,52,84,235.0,80,7.77,71,321,2447,12.7
26036,Steve Patrick,1988-89,27.0,9,24,55,55,8,16,24,49.0,,250,40,68,108,284.0,80,7.94,82,370,2484,12.8
26037,Steve Peters,1982-83,23.0,4,1,2,2,0,1,1,0.0,,2,0,1,1,0.0,80,7.03,61,280,2352,12.0
26038,Steve Pinizzotto,2015-16,31.0,4,0,12,12,0,0,0,9.0,120.0,12,0,0,0,9.0,48,5.31,29,160,1399,9.1
26039,Steve Pinizzotto,2016-17,32.0,5,2,6,6,0,2,2,2.0,58.0,18,0,2,2,11.0,82,5.34,48,269,2463,8.9
26040,Steve Pinizzotto,2017-18,33.0,6,4,18,18,2,2,4,15.0,143.0,36,2,4,6,26.0,82,5.32,47,251,2453,8.9
26041,Steve Poapst,1998-99,30.0,4,1,3,3,1,0,1,2.0,,3,1,0,1,2.0,82,6.29,74,413,2481,10.4
26042,Steve Poapst,2001-02,33.0,5,0,22,22,0,0,0,11.0,274.0,25,1,0,1,13.0,82,5.27,57,359,2285,9.4
26043,Steve Poapst,2003-04,35.0,6,5,36,36,2,3,5,27.0,614.0,61,3,3,6,40.0,82,5.51,63,376,2272,9.9
26044,Steve Poapst,2004-05,36.0,7,8,56,56,1,7,8,48.0,833.0,117,4,10,14,88.0,82,5.24,53,338,2262,9.5
26045,Steve Poapst,2005-06,37.0,8,13,75,75,2,11,13,49.0,1714.0,192,6,21,27,137.0,82,5.31,60,363,2326,9.4
26046,Steve Poapst,2006-07,38.0,9,4,53,53,2,2,4,55.0,1179.0,245,8,23,31,192.0,82,5.14,57,348,2300,9.2
26047,Steve Poapst,2008-09,40.0,10,5,62,62,0,5,5,23.0,1011.0,307,8,28,36,215.0,82,6.05,85,480,2458,10.1
26048,Steve Regier,2008-09,24.0,4,0,9,9,0,0,0,4.0,54.0,9,0,0,0,4.0,82,6.05,85,480,2458,10.1
26049,Steve Regier,2009-10,25.0,5,0,1,1,0,0,0,0.0,5.0,10,0,0,0,4.0,82,5.76,70,398,2426,9.7
26050,Steve Regier,2010-11,26.0,6,0,8,8,0,0,0,7.0,64.0,18,0,0,0,11.0,82,5.44,62,351,2383,9.4
26051,Steve Regier,2011-12,27.0,7,4,8,8,3,1,4,11.0,88.0,26,3,1,4,22.0,82,5.7,65,341,2477,9.4
26052,Steve Reinprecht,2002-03,26.0,4,0,1,1,0,0,0,0.0,6.0,1,0,0,0,0.0,82,5.49,53,331,2294,9.8
26053,Steve Reinprecht,2003-04,27.0,5,36,80,80,15,21,36,100.0,1075.0,81,15,21,36,100.0,82,5.51,63,376,2272,9.9
26054,Steve Reinprecht,2004-05,28.0,6,46,67,67,19,27,46,111.0,1107.0,148,34,48,82,211.0,82,5.24,53,338,2262,9.5
26055,Steve Reinprecht,2005-06,29.0,7,51,77,77,18,33,51,146.0,1337.0,225,52,81,133,357.0,82,5.31,60,363,2326,9.4
26056,Steve Reinprecht,2006-07,30.0,8,29,44,44,7,22,29,68.0,752.0,269,59,103,162,425.0,82,5.14,57,348,2300,9.2
26057,Steve Reinprecht,2008-09,32.0,9,52,80,80,22,30,52,130.0,1305.0,349,81,133,214,555.0,82,6.05,85,480,2458,10.1
26058,Steve Reinprecht,2009-10,33.0,10,33,49,49,9,24,33,71.0,768.0,398,90,157,247,626.0,82,5.76,70,398,2426,9.7
26059,Steve Reinprecht,2010-11,34.0,11,46,81,81,16,30,46,105.0,1272.0,479,106,187,293,731.0,82,5.44,62,351,2383,9.4
26060,Steve Reinprecht,2011-12,35.0,12,41,73,73,14,27,41,95.0,1161.0,552,120,214,334,826.0,82,5.7,65,341,2477,9.4
26061,Steve Reinprecht,2012-13,36.0,13,38,82,82,16,22,38,124.0,1319.0,634,136,236,372,950.0,82,5.53,56,304,2486,9.1
26062,Steve Reinprecht,2013-14,37.0,14,10,29,29,4,6,10,31.0,341.0,663,140,242,382,981.0,82,5.46,52,291,2492,9.0
26063,Steve Richmond,1986-87,27.0,4,7,26,26,2,5,7,15.0,,26,2,5,7,15.0,80,7.89,74,336,2448,12.9
26064,Steve Richmond,1987-88,28.0,5,5,34,34,0,5,5,15.0,,60,2,10,12,30.0,80,7.77,71,321,2447,12.7
26065,Steve Richmond,1988-89,29.0,6,5,46,46,1,4,5,26.0,,106,3,14,17,56.0,80,7.94,82,370,2484,12.8
26066,Steve Richmond,1989-90,30.0,7,8,44,44,1,7,8,31.0,,150,4,21,25,87.0,80,7.34,72,344,2400,12.2
26067,Steve Richmond,1991-92,32.0,8,2,9,9,0,2,2,1.0,,159,4,23,27,88.0,80,7.48,85,403,2430,12.3
26068,Steve Rooney,1987-88,25.0,4,1,3,3,1,0,1,3.0,,3,1,0,1,3.0,80,7.77,71,321,2447,12.7
26069,Steve Rooney,1988-89,26.0,5,5,38,38,2,3,5,24.0,,41,3,3,6,27.0,80,7.94,82,370,2484,12.8
26070,Steve Rooney,1989-90,27.0,6,5,32,32,2,3,5,25.0,,73,5,6,11,52.0,80,7.34,72,344,2400,12.2
26071,Steve Rooney,1990-91,28.0,7,13,56,56,7,6,13,62.0,,129,12,12,24,114.0,80,7.43,89,437,2435,12.2
26072,Steve Rooney,1991-92,29.0,8,4,25,25,3,1,4,23.0,,154,15,13,28,137.0,80,7.48,85,403,2430,12.3
26073,Steve Rucchin,1997-98,26.0,4,17,43,43,6,11,17,59.0,,43,6,11,17,59.0,48,5.97,37,209,1408,10.2
26074,Steve Rucchin,1998-99,27.0,5,44,64,64,19,25,44,113.0,,107,25,36,61,172.0,82,6.29,74,413,2481,10.4
26075,Steve Rucchin,1999-00,28.0,6,67,79,79,19,48,67,153.0,,186,44,84,128,325.0,82,5.83,55,336,2444,9.8
26076,Steve Rucchin,2000-01,29.0,7,53,72,72,17,36,53,131.0,,258,61,120,181,456.0,82,5.28,57,380,2242,9.6
26077,Steve Rucchin,2001-02,30.0,8,62,69,69,23,39,62,145.0,1556.0,327,84,159,243,601.0,82,5.27,57,359,2285,9.4
26078,Steve Rucchin,2002-03,31.0,9,57,71,71,19,38,57,131.0,1576.0,398,103,197,300,732.0,82,5.49,53,331,2294,9.8
26079,Steve Rucchin,2003-04,32.0,10,8,16,16,3,5,8,19.0,301.0,414,106,202,308,751.0,82,5.51,63,376,2272,9.9
26080,Steve Rucchin,2004-05,33.0,11,23,38,38,7,16,23,57.0,733.0,452,113,218,331,808.0,82,5.24,53,338,2262,9.5
26081,Steve Rucchin,2005-06,34.0,12,58,82,82,20,38,58,194.0,1729.0,534,133,256,389,1002.0,82,5.31,60,363,2326,9.4
26082,Steve Rucchin,2006-07,35.0,13,43,82,82,20,23,43,148.0,1621.0,616,153,279,432,1150.0,82,5.14,57,348,2300,9.2
26083,Steve Rucchin,2008-09,37.0,14,36,72,72,13,23,36,111.0,1151.0,688,166,302,468,1261.0,82,6.05,85,480,2458,10.1
26084,Steve Rucchin,2009-10,38.0,15,21,47,47,5,16,21,56.0,862.0,735,171,318,489,1317.0,82,5.76,70,398,2426,9.7
26085,Steve Seftel,1993-94,25.0,4,0,4,4,0,0,0,2.0,,4,0,0,0,2.0,80,6.91,71,366,2385,11.6
26086,Steve Seguin,1987-88,23.0,4,0,5,5,0,0,0,5.0,,5,0,0,0,5.0,80,7.77,71,321,2447,12.7
26087,Steve Smith,1984-85,21.0,4,1,8,8,0,1,1,9.0,,8,0,1,1,9.0,80,8.03,73,320,2489,12.9
26088,Steve Smith,1987-88,24.0,5,0,2,2,0,0,0,0.0,,10,0,1,1,9.0,80,7.77,71,321,2447,12.7
26089,Steve Smith,1988-89,25.0,6,0,2,2,0,0,0,1.0,,12,0,1,1,10.0,80,7.94,82,370,2484,12.8
26090,Steve Smith,1989-90,26.0,7,0,2,2,0,0,0,2.0,,14,0,1,1,12.0,80,7.34,72,344,2400,12.2
26091,Steve Smith,1991-92,28.0,8,0,3,3,0,0,0,2.0,,17,0,1,1,14.0,80,7.48,85,403,2430,12.3
26092,Steve Smith0,1987-88,24.0,4,0,2,2,0,0,0,3.0,,2,0,0,0,3.0,80,7.77,71,321,2447,12.7
26093,Steve Smith0,1988-89,25.0,5,24,55,55,4,20,24,74.0,,57,4,20,24,77.0,80,7.94,82,370,2484,12.8
26094,Steve Smith0,1989-90,26.0,6,22,62,62,7,15,22,73.0,,119,11,35,46,150.0,80,7.34,72,344,2400,12.2
26095,Steve Smith0,1990-91,27.0,7,55,79,79,12,43,55,116.0,,198,23,78,101,266.0,80,7.43,89,437,2435,12.2
26096,Steve Smith0,1991-92,28.0,8,22,35,35,3,19,22,47.0,,233,26,97,123,313.0,80,7.48,85,403,2430,12.3
26097,Steve Smith0,1992-93,29.0,9,41,75,75,7,34,41,125.0,,308,33,131,164,438.0,80,7.37,76,367,2421,12.2
26098,Steve Smith0,1993-94,30.0,10,54,77,77,13,41,54,114.0,,385,46,172,218,552.0,80,6.91,71,366,2385,11.6
26099,Steve Smith0,1994-95,31.0,11,30,76,76,9,21,30,153.0,,461,55,193,248,705.0,80,6.96,77,402,2440,11.4
26100,Steve Smith0,1995-96,32.0,12,57,78,78,10,47,57,212.0,,539,65,240,305,917.0,84,7.25,87,443,2603,11.7
26101,Steve Smith0,1996-97,33.0,13,27,57,57,5,22,27,89.0,,596,70,262,332,1006.0,84,6.48,76,407,2545,10.7
26102,Steve Smith0,1997-98,34.0,14,13,48,48,1,12,13,43.0,,644,71,274,345,1049.0,48,5.97,37,209,1408,10.2
26103,Steve Smith0,1998-99,35.0,15,9,37,37,0,9,9,17.0,,681,71,283,354,1066.0,82,6.29,74,413,2481,10.4
26104,Steve Smith0,1999-00,36.0,16,0,21,21,0,0,0,7.0,,702,71,283,354,1073.0,82,5.83,55,336,2444,9.8
26105,Steve Smith0,2001-02,38.0,17,15,69,69,1,14,15,42.0,1556.0,771,72,297,369,1115.0,82,5.27,57,359,2285,9.4
26106,Steve Smith0,2002-03,39.0,18,4,20,20,0,4,4,10.0,422.0,791,72,301,373,1125.0,82,5.49,53,331,2294,9.8
26107,Steve Smith0,2003-04,40.0,19,2,13,13,0,2,2,3.0,247.0,804,72,303,375,1128.0,82,5.51,63,376,2272,9.9
26108,Steve Staios,1998-99,25.0,4,0,12,12,0,0,0,4.0,,12,0,0,0,4.0,82,6.29,74,413,2481,10.4
26109,Steve Staios,1999-00,26.0,5,17,63,63,3,14,17,66.0,,75,3,14,17,70.0,82,5.83,55,336,2444,9.8
26110,Steve Staios,2000-01,27.0,6,7,77,77,3,4,7,45.0,,152,6,18,24,115.0,82,5.28,57,380,2242,9.6
26111,Steve Staios,2001-02,28.0,7,2,57,57,0,2,2,33.0,392.0,209,6,20,26,148.0,82,5.27,57,359,2285,9.4
26112,Steve Staios,2002-03,29.0,8,5,27,27,2,3,5,38.0,351.0,236,8,23,31,186.0,82,5.49,53,331,2294,9.8
26113,Steve Staios,2003-04,30.0,9,22,70,70,9,13,22,156.0,1522.0,306,17,36,53,342.0,82,5.51,63,376,2272,9.9
26114,Steve Staios,2004-05,31.0,10,10,73,73,5,5,10,101.0,1320.0,379,22,41,63,443.0,82,5.24,53,338,2262,9.5
26115,Steve Staios,2005-06,32.0,11,26,76,76,5,21,26,126.0,1694.0,455,27,62,89,569.0,82,5.31,60,363,2326,9.4
26116,Steve Staios,2006-07,33.0,12,28,82,82,6,22,28,153.0,1890.0,537,33,84,117,722.0,82,5.14,57,348,2300,9.2
26117,Steve Staios,2008-09,35.0,13,28,82,82,8,20,28,140.0,1712.0,619,41,104,145,862.0,82,6.05,85,480,2458,10.1
26118,Steve Staios,2009-10,36.0,14,17,58,58,2,15,17,71.0,1240.0,677,43,119,162,933.0,82,5.76,70,398,2426,9.7
26119,Steve Staios,2010-11,37.0,15,16,82,82,7,9,16,73.0,1806.0,759,50,128,178,1006.0,82,5.44,62,351,2383,9.4
26120,Steve Staios,2011-12,38.0,16,14,80,80,2,12,14,78.0,1584.0,839,52,140,192,1084.0,82,5.7,65,341,2477,9.4
26121,Steve Staios,2012-13,39.0,17,10,58,58,1,9,10,61.0,1085.0,897,53,149,202,1145.0,82,5.53,56,304,2486,9.1
26122,Steve Staios,2013-14,40.0,18,10,39,39,3,7,10,23.0,574.0,936,56,156,212,1168.0,82,5.46,52,291,2492,9.0
26123,Steve Staios,2014-15,41.0,19,8,65,65,0,8,8,67.0,1110.0,1001,56,164,220,1235.0,82,5.32,47,271,2439,8.9
26124,Steve Stoyanovich,1986-87,29.0,4,8,23,23,3,5,8,60.0,,23,3,5,8,60.0,80,7.89,74,336,2448,12.9
26125,Steve Sullivan,1998-99,24.0,4,9,16,16,5,4,9,23.0,,16,5,4,9,23.0,82,6.29,74,413,2481,10.4
26126,Steve Sullivan,1999-00,25.0,5,38,54,54,13,25,38,108.0,,70,18,29,47,131.0,82,5.83,55,336,2444,9.8
26127,Steve Sullivan,2000-01,26.0,6,28,63,63,10,18,28,112.0,,133,28,47,75,243.0,82,5.28,57,380,2242,9.6
26128,Steve Sullivan,2001-02,27.0,7,40,63,63,20,20,40,110.0,895.0,196,48,67,115,353.0,82,5.27,57,359,2285,9.4
26129,Steve Sullivan,2002-03,28.0,8,65,80,80,22,43,65,180.0,1403.0,276,70,110,180,533.0,82,5.49,53,331,2294,9.8
26130,Steve Sullivan,2003-04,29.0,9,75,81,81,34,41,75,204.0,1664.0,357,104,151,255,737.0,82,5.51,63,376,2272,9.9
26131,Steve Sullivan,2004-05,30.0,10,60,78,78,21,39,60,155.0,1495.0,435,125,190,315,892.0,82,5.24,53,338,2262,9.5
26132,Steve Sullivan,2005-06,31.0,11,61,82,82,26,35,61,190.0,1579.0,517,151,225,376,1082.0,82,5.31,60,363,2326,9.4
26133,Steve Sullivan,2006-07,32.0,12,73,80,80,24,49,73,218.0,1674.0,597,175,274,449,1300.0,82,5.14,57,348,2300,9.2
26134,Steve Sullivan,2008-09,34.0,13,68,69,69,31,37,68,192.0,1317.0,666,206,311,517,1492.0,82,6.05,85,480,2458,10.1
26135,Steve Sullivan,2009-10,35.0,14,60,57,57,22,38,60,122.0,1107.0,723,228,349,577,1614.0,82,5.76,70,398,2426,9.7
26136,Steve Sullivan,2011-12,37.0,15,32,41,41,11,21,32,83.0,758.0,764,239,370,609,1697.0,82,5.7,65,341,2477,9.4
26137,Steve Sullivan,2012-13,38.0,16,51,82,82,17,34,51,152.0,1470.0,846,256,404,660,1849.0,82,5.53,56,304,2486,9.1
26138,Steve Sullivan,2013-14,39.0,17,22,44,44,10,12,22,79.0,705.0,890,266,416,682,1928.0,82,5.46,52,291,2492,9.0
26139,Steve Sullivan,2014-15,40.0,18,48,79,79,17,31,48,140.0,1213.0,969,283,447,730,2068.0,82,5.32,47,271,2439,8.9
26140,Steve Sullivan,2015-16,41.0,19,17,42,42,7,10,17,61.0,611.0,1011,290,457,747,2129.0,48,5.31,29,160,1399,9.1
26141,Steve Thomas,1987-88,24.0,4,2,18,18,1,1,2,26.0,,18,1,1,2,26.0,80,7.77,71,321,2447,12.7
26142,Steve Thomas,1988-89,25.0,5,57,65,65,20,37,57,197.0,,83,21,38,59,223.0,80,7.94,82,370,2484,12.8
26143,Steve Thomas,1989-90,26.0,6,62,78,78,35,27,62,245.0,,161,56,65,121,468.0,80,7.34,72,344,2400,12.2
26144,Steve Thomas,1990-91,27.0,7,26,30,30,13,13,26,69.0,,191,69,78,147,537.0,80,7.43,89,437,2435,12.2
26145,Steve Thomas,1991-92,28.0,8,40,45,45,21,19,40,124.0,,236,90,97,187,661.0,80,7.48,85,403,2430,12.3
26146,Steve Thomas,1992-93,29.0,9,70,76,76,40,30,70,235.0,,312,130,127,257,896.0,80,7.37,76,367,2421,12.2
26147,Steve Thomas,1993-94,30.0,10,54,69,69,19,35,54,192.0,,381,149,162,311,1088.0,80,6.91,71,366,2385,11.6
26148,Steve Thomas,1994-95,31.0,11,78,82,82,30,48,78,245.0,,463,179,210,389,1333.0,80,6.96,77,402,2440,11.4
26149,Steve Thomas,1995-96,32.0,12,87,79,79,37,50,87,264.0,,542,216,260,476,1597.0,84,7.25,87,443,2603,11.7
26150,Steve Thomas,1996-97,33.0,13,75,78,78,42,33,75,249.0,,620,258,293,551,1846.0,84,6.48,76,407,2545,10.7
26151,Steve Thomas,1997-98,34.0,14,26,47,47,11,15,26,133.0,,667,269,308,577,1979.0,48,5.97,37,209,1408,10.2
26152,Steve Thomas,1998-99,35.0,15,61,81,81,26,35,61,192.0,,748,295,343,638,2171.0,82,6.29,74,413,2481,10.4
26153,Steve Thomas,1999-00,36.0,16,34,57,57,15,19,34,124.0,,805,310,362,672,2295.0,82,5.83,55,336,2444,9.8
26154,Steve Thomas,2000-01,37.0,17,24,55,55,14,10,24,111.0,,860,324,372,696,2406.0,82,5.28,57,380,2242,9.6
26155,Steve Thomas,2001-02,38.0,18,73,78,78,28,45,73,209.0,1434.0,938,352,417,769,2615.0,82,5.27,57,359,2285,9.4
26156,Steve Thomas,2002-03,39.0,19,63,81,81,26,37,63,151.0,1321.0,1019,378,454,832,2766.0,82,5.49,53,331,2294,9.8
26157,Steve Thomas,2003-04,40.0,20,34,57,57,8,26,34,140.0,914.0,1076,386,480,866,2906.0,82,5.51,63,376,2272,9.9
26158,Steve Thomas,2004-05,41.0,21,15,34,34,11,4,15,66.0,590.0,1110,397,484,881,2972.0,82,5.24,53,338,2262,9.5
26159,Steve Thomas,2005-06,42.0,22,30,81,81,14,16,30,118.0,1044.0,1191,411,500,911,3090.0,82,5.31,60,363,2326,9.4
26160,Steve Thomas,2006-07,43.0,23,22,44,44,10,12,22,80.0,561.0,1235,421,512,933,3170.0,82,5.14,57,348,2300,9.2
26161,Steve Tuttle,1991-92,26.0,4,25,53,53,13,12,25,82.0,,53,13,12,25,82.0,80,7.48,85,403,2430,12.3
26162,Steve Tuttle,1992-93,27.0,5,22,71,71,12,10,22,92.0,,124,25,22,47,174.0,80,7.37,76,367,2421,12.2
26163,Steve Tuttle,1993-94,28.0,6,9,20,20,3,6,9,16.0,,144,28,28,56,190.0,80,6.91,71,366,2385,11.6
26164,Steve Wagner,2010-11,26.0,4,8,24,24,2,6,8,25.0,443.0,24,2,6,8,25.0,82,5.44,62,351,2383,9.4
26165,Steve Wagner,2011-12,27.0,5,4,22,22,2,2,4,16.0,344.0,46,4,8,12,41.0,82,5.7,65,341,2477,9.4
26166,Steve Washburn,1998-99,23.0,4,1,1,1,0,1,1,1.0,,1,0,1,1,1.0,82,6.29,74,413,2481,10.4
26167,Steve Washburn,1999-00,24.0,5,9,18,18,3,6,9,21.0,,19,3,7,10,22.0,82,5.83,55,336,2444,9.8
26168,Steve Washburn,2000-01,25.0,6,19,58,58,11,8,19,61.0,,77,14,15,29,83.0,82,5.28,57,380,2242,9.6
26169,Steve Washburn,2001-02,26.0,7,0,12,12,0,0,0,6.0,90.0,89,14,15,29,89.0,82,5.27,57,359,2285,9.4
26170,Steve Washburn,2002-03,27.0,8,0,1,1,0,0,0,1.0,14.0,90,14,15,29,90.0,82,5.49,53,331,2294,9.8
26171,Steve Washburn,2003-04,28.0,9,0,3,3,0,0,0,0.0,21.0,93,14,15,29,90.0,82,5.51,63,376,2272,9.9
26172,Steve Webb,1999-00,24.0,4,5,41,41,1,4,5,21.0,,41,1,4,5,21.0,82,5.83,55,336,2444,9.8
26173,Steve Webb,2000-01,25.0,5,0,20,20,0,0,0,6.0,,61,1,4,5,27.0,82,5.28,57,380,2242,9.6
26174,Steve Webb,2001-02,26.0,6,0,45,45,0,0,0,18.0,190.0,106,1,4,5,45.0,82,5.27,57,359,2285,9.4
26175,Steve Webb,2002-03,27.0,7,4,65,65,1,3,4,27.0,455.0,171,2,7,9,72.0,82,5.49,53,331,2294,9.8
26176,Steve Webb,2003-04,28.0,8,2,31,31,0,2,2,8.0,200.0,202,2,9,11,80.0,82,5.51,63,376,2272,9.9
26177,Steve Webb,2004-05,29.0,9,6,60,60,2,4,6,31.0,389.0,262,4,13,17,111.0,82,5.24,53,338,2262,9.5
26178,Steve Webb,2005-06,30.0,10,1,49,49,1,0,1,27.0,296.0,311,5,13,18,138.0,82,5.31,60,363,2326,9.4
26179,Steve Webb,2006-07,31.0,11,0,10,10,0,0,0,3.0,51.0,321,5,13,18,141.0,82,5.14,57,348,2300,9.2
26180,Steve Yzerman,1986-87,21.0,4,87,80,80,39,48,87,177.0,,80,39,48,87,177.0,80,7.89,74,336,2448,12.9
26181,Steve Yzerman,1987-88,22.0,5,89,80,80,30,59,89,231.0,,160,69,107,176,408.0,80,7.77,71,321,2447,12.7
26182,Steve Yzerman,1988-89,23.0,6,42,51,51,14,28,42,132.0,,211,83,135,218,540.0,80,7.94,82,370,2484,12.8
26183,Steve Yzerman,1989-90,24.0,7,90,80,80,31,59,90,217.0,,291,114,194,308,757.0,80,7.34,72,344,2400,12.2
26184,Steve Yzerman,1990-91,25.0,8,102,64,64,50,52,102,242.0,,355,164,246,410,999.0,80,7.43,89,437,2435,12.2
26185,Steve Yzerman,1991-92,26.0,9,155,80,80,65,90,155,388.0,,435,229,336,565,1387.0,80,7.48,85,403,2430,12.3
26186,Steve Yzerman,1992-93,27.0,10,127,79,79,62,65,127,332.0,,514,291,401,692,1719.0,80,7.37,76,367,2421,12.2
26187,Steve Yzerman,1993-94,28.0,11,108,80,80,51,57,108,326.0,,594,342,458,800,2045.0,80,6.91,71,366,2385,11.6
26188,Steve Yzerman,1994-95,29.0,12,103,79,79,45,58,103,295.0,,673,387,516,903,2340.0,80,6.96,77,402,2440,11.4
26189,Steve Yzerman,1995-96,30.0,13,137,84,84,58,79,137,307.0,,757,445,595,1040,2647.0,84,7.25,87,443,2603,11.7
26190,Steve Yzerman,1996-97,31.0,14,82,58,58,24,58,82,217.0,,815,469,653,1122,2864.0,84,6.48,76,407,2545,10.7
26191,Steve Yzerman,1997-98,32.0,15,38,47,47,12,26,38,134.0,,862,481,679,1160,2998.0,48,5.97,37,209,1408,10.2
26192,Steve Yzerman,1998-99,33.0,16,95,80,80,36,59,95,220.0,,942,517,738,1255,3218.0,82,6.29,74,413,2481,10.4
26193,Steve Yzerman,1999-00,34.0,17,85,81,81,22,63,85,232.0,,1023,539,801,1340,3450.0,82,5.83,55,336,2444,9.8
26194,Steve Yzerman,2000-01,35.0,18,69,75,75,24,45,69,188.0,,1098,563,846,1409,3638.0,82,5.28,57,380,2242,9.6
26195,Steve Yzerman,2001-02,36.0,19,74,80,80,29,45,74,231.0,1727.0,1178,592,891,1483,3869.0,82,5.27,57,359,2285,9.4
26196,Steve Yzerman,2002-03,37.0,20,79,78,78,35,44,79,234.0,1647.0,1256,627,935,1562,4103.0,82,5.49,53,331,2294,9.8
26197,Steve Yzerman,2003-04,38.0,21,52,54,54,18,34,52,155.0,1201.0,1310,645,969,1614,4258.0,82,5.51,63,376,2272,9.9
26198,Steve Yzerman,2004-05,39.0,22,48,52,52,13,35,48,104.0,1070.0,1362,658,1004,1662,4362.0,82,5.24,53,338,2262,9.5
26199,Steve Yzerman,2005-06,40.0,23,8,16,16,2,6,8,13.0,249.0,1378,660,1010,1670,4375.0,82,5.31,60,363,2326,9.4
26200,Steve Yzerman,2006-07,41.0,24,51,75,75,18,33,51,141.0,1315.0,1453,678,1043,1721,4516.0,82,5.14,57,348,2300,9.2
26201,Steve Yzerman,2008-09,43.0,25,34,61,61,14,20,34,86.0,779.0,1514,692,1063,1755,4602.0,82,6.05,85,480,2458,10.1
26202,Steven Finn,1988-89,22.0,4,1,17,17,0,1,1,8.0,,17,0,1,1,8.0,80,7.94,82,370,2484,12.8
26203,Steven Finn,1989-90,23.0,5,7,36,36,2,5,7,35.0,,53,2,6,8,43.0,80,7.34,72,344,2400,12.2
26204,Steven Finn,1990-91,24.0,6,10,75,75,3,7,10,70.0,,128,5,13,18,113.0,80,7.43,89,437,2435,12.2
26205,Steven Finn,1991-92,25.0,7,8,77,77,2,6,8,86.0,,205,7,19,26,199.0,80,7.48,85,403,2430,12.3
26206,Steven Finn,1992-93,26.0,8,12,64,64,3,9,12,74.0,,269,10,28,38,273.0,80,7.37,76,367,2421,12.2
26207,Steven Finn,1993-94,27.0,9,19,71,71,6,13,19,91.0,,340,16,41,57,364.0,80,6.91,71,366,2385,11.6
26208,Steven Finn,1994-95,28.0,10,11,65,65,4,7,11,63.0,,405,20,48,68,427.0,80,6.96,77,402,2440,11.4
26209,Steven Finn,1995-96,29.0,11,14,80,80,5,9,14,61.0,,485,25,57,82,488.0,84,7.25,87,443,2603,11.7
26210,Steven Finn,1996-97,30.0,12,17,80,80,4,13,17,74.0,,565,29,70,99,562.0,84,6.48,76,407,2545,10.7
26211,Steven Finn,1997-98,31.0,13,3,40,40,0,3,3,28.0,,605,29,73,102,590.0,48,5.97,37,209,1408,10.2
26212,Steven Finn,1998-99,32.0,14,5,66,66,3,2,5,54.0,,671,32,75,107,644.0,82,6.29,74,413,2481,10.4
26213,Steven Finn,1999-00,33.0,15,5,54,54,2,3,5,35.0,,725,34,78,112,679.0,82,5.83,55,336,2444,9.8
26214,Steven Fletcher,1991-92,29.0,4,0,3,3,0,0,0,1.0,,3,0,0,0,1.0,80,7.48,85,403,2430,12.3
26215,Steven Fogarty,2020-21,27.0,4,0,1,1,0,0,0,1.0,12.0,1,0,0,0,1.0,82,5.86,50,250,2620,9.2
26216,Steven Fogarty,2021-22,28.0,5,0,10,10,0,0,0,9.0,78.0,11,0,0,0,10.0,82,5.96,47,239,2579,9.5
26217,Steven Fogarty,2022-23,29.0,6,0,7,7,0,0,0,2.0,41.0,18,0,0,0,12.0,70,5.96,42,208,2192,9.5
26218,Steven Goertzen,2008-09,24.0,4,0,39,39,0,0,0,23.0,333.0,39,0,0,0,23.0,82,6.05,85,480,2458,10.1
26219,Steven Goertzen,2009-10,25.0,5,0,7,7,0,0,0,1.0,37.0,46,0,0,0,24.0,82,5.76,70,398,2426,9.7
26220,Steven Goertzen,2011-12,27.0,6,4,16,16,2,2,4,18.0,155.0,62,2,2,4,42.0,82,5.7,65,341,2477,9.4
26221,Steven Goertzen,2012-13,28.0,7,0,6,6,0,0,0,1.0,46.0,68,2,2,4,43.0,82,5.53,56,304,2486,9.1
26222,Steven Halko,2000-01,26.0,4,2,18,18,0,2,2,7.0,,18,0,2,2,7.0,82,5.28,57,380,2242,9.6
26223,Steven Halko,2001-02,27.0,5,3,20,20,0,3,3,6.0,319.0,38,0,5,5,13.0,82,5.27,57,359,2285,9.4
26224,Steven Halko,2002-03,28.0,6,8,58,58,0,8,8,54.0,969.0,96,0,13,13,67.0,82,5.49,53,331,2294,9.8
26225,Steven Halko,2003-04,29.0,7,1,48,48,0,1,1,24.0,645.0,144,0,14,14,91.0,82,5.51,63,376,2272,9.9
26226,Steven Halko,2004-05,30.0,8,1,5,5,0,1,1,0.0,49.0,149,0,15,15,91.0,82,5.24,53,338,2262,9.5
26227,Steven Halko,2005-06,31.0,9,0,6,6,0,0,0,5.0,61.0,155,0,15,15,96.0,82,5.31,60,363,2326,9.4
26228,Steven Kampfer,2013-14,25.0,4,10,38,38,5,5,10,57.0,674.0,38,5,5,10,57.0,82,5.46,52,291,2492,9.0
26229,Steven Kampfer,2014-15,26.0,5,5,23,23,2,3,5,20.0,343.0,61,7,8,15,77.0,82,5.32,47,271,2439,8.9
26230,Steven Kampfer,2017-18,29.0,6,4,25,25,2,2,4,28.0,430.0,86,9,10,19,105.0,82,5.32,47,251,2453,8.9
26231,Steven Kampfer,2018-19,30.0,7,4,47,47,0,4,4,54.0,709.0,133,9,14,23,159.0,82,5.34,48,255,2438,9.0
26232,Steven Kampfer,2019-20,31.0,8,2,11,11,1,1,2,10.0,146.0,144,10,15,25,169.0,82,5.45,47,245,2478,9.0
26233,Steven Kampfer,2020-21,32.0,9,1,22,22,0,1,1,31.0,380.0,166,10,16,26,200.0,82,5.86,50,250,2620,9.2
26234,Steven Kampfer,2021-22,33.0,10,6,35,35,3,3,6,40.0,512.0,201,13,19,32,240.0,82,5.96,47,239,2579,9.5
26235,Steven Kampfer,2022-23,34.0,11,2,10,10,0,2,2,13.0,136.0,211,13,21,34,253.0,70,5.96,42,208,2192,9.5
26236,Steven King,1995-96,26.0,4,12,24,24,7,5,12,42.0,,24,7,5,12,42.0,84,7.25,87,443,2603,11.7
26237,Steven King,1996-97,27.0,5,11,36,36,8,3,11,50.0,,60,15,8,23,92.0,84,6.48,76,407,2545,10.7
26238,Steven King,1998-99,29.0,6,2,7,7,2,0,2,5.0,,67,17,8,25,97.0,82,6.29,74,413,2481,10.4
26239,Steven Oleksy,2015-16,29.0,4,9,28,28,1,8,9,25.0,484.0,28,1,8,9,25.0,48,5.31,29,160,1399,9.1
26240,Steven Oleksy,2016-17,30.0,5,10,33,33,2,8,10,27.0,504.0,61,3,16,19,52.0,82,5.34,48,269,2463,8.9
26241,Steven Oleksy,2017-18,31.0,6,0,1,1,0,0,0,1.0,12.0,62,3,16,19,53.0,82,5.32,47,251,2453,8.9
26242,Steven Oleksy,2019-20,33.0,7,1,11,11,0,1,1,11.0,151.0,73,3,17,20,64.0,82,5.45,47,245,2478,9.0
26243,Steven Rice,1993-94,22.0,4,2,11,11,1,1,2,12.0,,11,1,1,2,12.0,80,6.91,71,366,2385,11.6
26244,Steven Rice,1994-95,23.0,5,0,3,3,0,0,0,2.0,,14,1,1,2,14.0,80,6.96,77,402,2440,11.4
26245,Steven Rice,1995-96,24.0,6,7,28,28,2,5,7,29.0,,42,3,6,9,43.0,84,7.25,87,443,2603,11.7
26246,Steven Rice,1996-97,25.0,7,32,63,63,17,15,32,129.0,,105,20,21,41,172.0,84,6.48,76,407,2545,10.7
26247,Steven Rice,1997-98,26.0,8,21,40,40,11,10,21,57.0,,145,31,31,62,229.0,48,5.97,37,209,1408,10.2
26248,Steven Rice,1998-99,27.0,9,22,59,59,10,12,22,108.0,,204,41,43,84,337.0,82,6.29,74,413,2481,10.4
26249,Steven Rice,1999-00,28.0,10,35,78,78,21,14,35,159.0,,282,62,57,119,496.0,82,5.83,55,336,2444,9.8
26250,Steven Rice,2000-01,29.0,11,6,47,47,2,4,6,39.0,,329,64,61,125,535.0,82,5.28,57,380,2242,9.6
26251,Steven Santini,2018-19,23.0,4,0,1,1,0,0,0,1.0,15.0,1,0,0,0,1.0,82,5.34,48,255,2438,9.0
26252,Steven Santini,2019-20,24.0,5,7,38,38,2,5,7,46.0,611.0,39,2,5,7,47.0,82,5.45,47,245,2478,9.0
26253,Steven Santini,2020-21,25.0,6,10,36,36,2,8,10,56.0,730.0,75,4,13,17,103.0,82,5.86,50,250,2620,9.2
26254,Steven Santini,2021-22,26.0,7,4,39,39,1,3,4,41.0,650.0,114,5,16,21,144.0,82,5.96,47,239,2579,9.5
26255,Steven Santini,2022-23,27.0,8,0,2,2,0,0,0,1.0,19.0,116,5,16,21,145.0,70,5.96,42,208,2192,9.5
26256,Steven Stamkos,2011-12,21.0,4,46,79,79,23,23,46,181.0,1180.0,79,23,23,46,181.0,82,5.7,65,341,2477,9.4
26257,Steven Stamkos,2012-13,22.0,5,95,82,82,51,44,95,297.0,1685.0,161,74,67,141,478.0,82,5.53,56,304,2486,9.1
26258,Steven Stamkos,2013-14,23.0,6,91,82,82,45,46,91,272.0,1656.0,243,119,113,232,750.0,82,5.46,52,291,2492,9.0
26259,Steven Stamkos,2014-15,24.0,7,97,82,82,60,37,97,303.0,1806.0,325,179,150,329,1053.0,82,5.32,47,271,2439,8.9
26260,Steven Stamkos,2015-16,25.0,8,57,48,48,29,28,57,157.0,1057.0,373,208,178,386,1210.0,48,5.31,29,160,1399,9.1
26261,Steven Stamkos,2016-17,26.0,9,40,37,37,25,15,40,124.0,749.0,410,233,193,426,1334.0,82,5.34,48,269,2463,8.9
26262,Steven Stamkos,2017-18,27.0,10,72,82,82,43,29,72,268.0,1588.0,492,276,222,498,1602.0,82,5.32,47,251,2453,8.9
26263,Steven Stamkos,2018-19,28.0,11,64,77,77,36,28,64,216.0,1521.0,569,312,250,562,1818.0,82,5.34,48,255,2438,9.0
26264,Steven Stamkos,2019-20,29.0,12,20,17,17,9,11,20,58.0,304.0,586,321,261,582,1876.0,82,5.45,47,245,2478,9.0
26265,Steven Stamkos,2020-21,30.0,13,86,78,78,27,59,86,212.0,1464.0,664,348,320,668,2088.0,82,5.86,50,250,2620,9.2
26266,Steven Stamkos,2021-22,31.0,14,98,82,82,45,53,98,234.0,1501.0,746,393,373,766,2322.0,82,5.96,47,239,2579,9.5
26267,Steven Stamkos,2022-23,32.0,15,66,57,57,29,37,66,176.0,1050.0,803,422,410,832,2498.0,70,5.96,42,208,2192,9.5
26268,Steven Zalewski,2012-13,26.0,4,0,3,3,0,0,0,3.0,25.0,3,0,0,0,3.0,82,5.53,56,304,2486,9.1
26269,Steven Zalewski,2014-15,28.0,5,0,7,7,0,0,0,6.0,74.0,10,0,0,0,9.0,82,5.32,47,271,2439,8.9
26270,Stew Gavin,1983-84,23.0,4,3,14,14,1,2,3,13.0,,14,1,2,3,13.0,80,7.69,77,340,2441,12.6
26271,Stew Gavin,1984-85,24.0,5,11,38,38,5,6,11,66.0,,52,6,8,14,79.0,80,8.03,73,320,2489,12.9
26272,Stew Gavin,1985-86,25.0,6,11,63,63,6,5,11,77.0,,115,12,13,25,156.0,80,7.73,71,310,2444,12.7
26273,Stew Gavin,1986-87,26.0,7,32,80,80,10,22,32,96.0,,195,22,35,57,252.0,80,7.89,74,336,2448,12.9
26274,Stew Gavin,1987-88,27.0,8,25,73,73,12,13,25,149.0,,268,34,48,82,401.0,80,7.77,71,321,2447,12.7
26275,Stew Gavin,1988-89,28.0,9,55,76,76,26,29,55,161.0,,344,60,77,137,562.0,80,7.94,82,370,2484,12.8
26276,Stew Gavin,1989-90,29.0,10,41,79,79,20,21,41,162.0,,423,80,98,178,724.0,80,7.34,72,344,2400,12.2
26277,Stew Gavin,1990-91,30.0,11,21,56,56,11,10,21,125.0,,479,91,108,199,849.0,80,7.43,89,437,2435,12.2
26278,Stew Gavin,1991-92,31.0,12,26,73,73,8,18,26,129.0,,552,99,126,225,978.0,80,7.48,85,403,2430,12.3
26279,Stew Gavin,1992-93,32.0,13,25,80,80,12,13,25,146.0,,632,111,139,250,1124.0,80,7.37,76,367,2421,12.2
26280,Stew Gavin,1993-94,33.0,14,8,38,38,4,4,8,56.0,,670,115,143,258,1180.0,80,6.91,71,366,2385,11.6
26281,Stew Gavin,1994-95,34.0,15,9,35,35,5,4,9,49.0,,705,120,147,267,1229.0,80,6.96,77,402,2440,11.4
26282,Stew Gavin,1995-96,35.0,16,18,63,63,10,8,18,114.0,,768,130,155,285,1343.0,84,7.25,87,443,2603,11.7
26283,Stewart Malgunas,1996-97,26.0,4,4,67,67,1,3,4,54.0,,67,1,3,4,54.0,84,6.48,76,407,2545,10.7
26284,Stewart Malgunas,1997-98,27.0,5,0,4,4,0,0,0,1.0,,71,1,3,4,55.0,48,5.97,37,209,1408,10.2
26285,Stewart Malgunas,1998-99,28.0,6,1,30,30,0,1,1,13.0,,101,1,4,5,68.0,82,6.29,74,413,2481,10.4
26286,Stewart Malgunas,1999-00,29.0,7,0,6,6,0,0,0,3.0,,107,1,4,5,71.0,82,5.83,55,336,2444,9.8
26287,Stewart Malgunas,2000-01,30.0,8,0,8,8,0,0,0,5.0,,115,1,4,5,76.0,82,5.28,57,380,2242,9.6
26288,Stewart Malgunas,2001-02,31.0,9,0,10,10,0,0,0,2.0,90.0,125,1,4,5,78.0,82,5.27,57,359,2285,9.4
26289,Stewart Malgunas,2002-03,32.0,10,1,4,4,0,1,1,0.0,52.0,129,1,5,6,78.0,82,5.49,53,331,2294,9.8
26290,Stu Barnes,1994-95,24.0,4,17,46,46,8,9,17,75.0,,46,8,9,17,75.0,80,6.96,77,402,2440,11.4
26291,Stu Barnes,1995-96,25.0,5,22,38,38,12,10,22,73.0,,84,20,19,39,148.0,84,7.25,87,443,2603,11.7
26292,Stu Barnes,1996-97,26.0,6,47,77,77,23,24,47,172.0,,161,43,43,86,320.0,84,6.48,76,407,2545,10.7
26293,Stu Barnes,1997-98,27.0,7,29,41,41,10,19,29,93.0,,202,53,62,115,413.0,48,5.97,37,209,1408,10.2
26294,Stu Barnes,1998-99,28.0,8,44,72,72,19,25,44,158.0,,274,72,87,159,571.0,82,6.29,74,413,2481,10.4
26295,Stu Barnes,1999-00,29.0,9,49,81,81,19,30,49,176.0,,355,91,117,208,747.0,82,5.83,55,336,2444,9.8
26296,Stu Barnes,2000-01,30.0,10,65,78,78,30,35,65,196.0,,433,121,152,273,943.0,82,5.28,57,380,2242,9.6
26297,Stu Barnes,2001-02,31.0,11,36,81,81,20,16,36,180.0,1455.0,514,141,168,309,1123.0,82,5.27,57,359,2285,9.4
26298,Stu Barnes,2002-03,32.0,12,45,82,82,20,25,45,137.0,1426.0,596,161,193,354,1260.0,82,5.49,53,331,2294,9.8
26299,Stu Barnes,2003-04,33.0,13,43,75,75,19,24,43,160.0,1433.0,671,180,217,397,1420.0,82,5.51,63,376,2272,9.9
26300,Stu Barnes,2004-05,34.0,14,48,68,68,17,31,48,127.0,1263.0,739,197,248,445,1547.0,82,5.24,53,338,2262,9.5
26301,Stu Barnes,2005-06,35.0,15,39,81,81,13,26,39,149.0,1483.0,820,210,274,484,1696.0,82,5.31,60,363,2326,9.4
26302,Stu Barnes,2006-07,36.0,16,29,77,77,11,18,29,135.0,1392.0,897,221,292,513,1831.0,82,5.14,57,348,2300,9.2
26303,Stu Barnes,2008-09,38.0,17,36,78,78,15,21,36,123.0,1285.0,975,236,313,549,1954.0,82,6.05,85,480,2458,10.1
26304,Stu Barnes,2009-10,39.0,18,25,82,82,13,12,25,118.0,1320.0,1057,249,325,574,2072.0,82,5.76,70,398,2426,9.7
26305,Stu Barnes,2010-11,40.0,19,23,79,79,12,11,23,71.0,1076.0,1136,261,336,597,2143.0,82,5.44,62,351,2383,9.4
26306,Stu Bickel,2014-15,28.0,4,9,51,51,0,9,9,22.0,532.0,51,0,9,9,22.0,82,5.32,47,271,2439,8.9
26307,Stu Bickel,2015-16,29.0,5,0,16,16,0,0,0,2.0,88.0,67,0,9,9,24.0,48,5.31,29,160,1399,9.1
26308,Stu Bickel,2017-18,31.0,6,1,9,9,0,1,1,3.0,49.0,76,0,10,10,27.0,82,5.32,47,251,2453,8.9
26309,Stu Grimson,1991-92,26.0,4,0,1,1,0,0,0,0.0,,1,0,0,0,0.0,80,7.48,85,403,2430,12.3
26310,Stu Grimson,1992-93,27.0,5,0,3,3,0,0,0,0.0,,4,0,0,0,0.0,80,7.37,76,367,2421,12.2
26311,Stu Grimson,1993-94,28.0,6,1,35,35,0,1,1,14.0,,39,0,1,1,14.0,80,6.91,71,366,2385,11.6
26312,Stu Grimson,1994-95,29.0,7,4,54,54,2,2,4,23.0,,93,2,3,5,37.0,80,6.96,77,402,2440,11.4
26313,Stu Grimson,1995-96,30.0,8,2,78,78,1,1,2,14.0,,171,3,4,7,51.0,84,7.25,87,443,2603,11.7
26314,Stu Grimson,1996-97,31.0,9,6,77,77,1,5,6,34.0,,248,4,9,13,85.0,84,6.48,76,407,2545,10.7
26315,Stu Grimson,1997-98,32.0,10,1,42,42,0,1,1,18.0,,290,4,10,14,103.0,48,5.97,37,209,1408,10.2
26316,Stu Grimson,1998-99,33.0,11,1,56,56,0,1,1,19.0,,346,4,11,15,122.0,82,6.29,74,413,2481,10.4
26317,Stu Grimson,1999-00,34.0,12,4,76,76,2,2,4,17.0,,422,6,13,19,139.0,82,5.83,55,336,2444,9.8
26318,Stu Grimson,2000-01,35.0,13,7,82,82,3,4,7,17.0,,504,9,17,26,156.0,82,5.28,57,380,2242,9.6
26319,Stu Grimson,2001-02,36.0,14,3,73,73,3,0,3,10.0,249.0,577,12,17,29,166.0,82,5.27,57,359,2285,9.4
26320,Stu Grimson,2002-03,37.0,15,3,50,50,1,2,3,14.0,260.0,627,13,19,32,180.0,82,5.49,53,331,2294,9.8
26321,Stu Grimson,2003-04,38.0,16,5,72,72,3,2,5,26.0,432.0,699,16,21,37,206.0,82,5.51,63,376,2272,9.9
26322,Stu Grimson,2004-05,39.0,17,2,30,30,1,1,2,5.0,184.0,729,17,22,39,211.0,82,5.24,53,338,2262,9.5
26323,Stu Kulak,1985-86,22.0,4,2,4,4,1,1,2,2.0,,4,1,1,2,2.0,80,7.73,71,310,2444,12.7
26324,Stu Kulak,1989-90,26.0,5,6,54,54,4,2,6,56.0,,58,5,3,8,58.0,80,7.34,72,344,2400,12.2
26325,Stu Kulak,1990-91,27.0,6,2,14,14,1,1,2,22.0,,72,6,4,10,80.0,80,7.43,89,437,2435,12.2
26326,Stu Kulak,1991-92,28.0,7,2,18,18,2,0,2,18.0,,90,8,4,12,98.0,80,7.48,85,403,2430,12.3
26327,Stu Smith,1982-83,22.0,4,0,4,4,0,0,0,3.0,,4,0,0,0,3.0,80,7.03,61,280,2352,12.0
26328,Stu Smith,1983-84,23.0,5,8,38,38,1,7,8,34.0,,42,1,7,8,37.0,80,7.69,77,340,2441,12.6
26329,Stu Smith,1984-85,24.0,6,3,17,17,0,3,3,14.0,,59,1,10,11,51.0,80,8.03,73,320,2489,12.9
26330,Stu Smith,1985-86,25.0,7,1,18,18,1,0,1,21.0,,77,2,10,12,72.0,80,7.73,71,310,2444,12.7
26331,Stuart Percy,2017-18,24.0,4,3,9,9,0,3,3,13.0,163.0,9,0,3,3,13.0,82,5.32,47,251,2453,8.9
26332,Stuart Percy,2018-19,25.0,5,0,3,3,0,0,0,1.0,39.0,12,0,3,3,14.0,82,5.34,48,255,2438,9.0
26333,Sven Andrighetto,2017-18,24.0,4,3,12,12,2,1,3,12.0,113.0,12,2,1,3,12.0,82,5.32,47,251,2453,8.9
26334,Sven Andrighetto,2018-19,25.0,5,17,44,44,7,10,17,74.0,621.0,56,9,11,20,86.0,82,5.34,48,255,2438,9.0
26335,Sven Andrighetto,2019-20,26.0,6,24,46,46,7,17,24,68.0,643.0,102,16,28,44,154.0,82,5.45,47,245,2478,9.0
26336,Sven Andrighetto,2020-21,27.0,7,22,50,50,8,14,22,111.0,724.0,152,24,42,66,265.0,82,5.86,50,250,2620,9.2
26337,Sven Andrighetto,2021-22,28.0,8,17,64,64,7,10,17,95.0,708.0,216,31,52,83,360.0,82,5.96,47,239,2579,9.5
26338,Sven Baertschi,2014-15,22.0,4,3,5,5,3,0,3,10.0,56.0,5,3,0,3,10.0,82,5.32,47,271,2439,8.9
26339,Sven Baertschi,2015-16,23.0,5,10,20,20,3,7,10,28.0,268.0,25,6,7,13,38.0,48,5.31,29,160,1399,9.1
26340,Sven Baertschi,2016-17,24.0,6,11,26,26,2,9,11,30.0,367.0,51,8,16,24,68.0,82,5.34,48,269,2463,8.9
26341,Sven Baertschi,2017-18,25.0,7,6,18,18,2,4,6,15.0,174.0,69,10,20,30,83.0,82,5.32,47,251,2453,8.9
26342,Sven Baertschi,2018-19,26.0,8,28,69,69,15,13,28,108.0,929.0,138,25,33,58,191.0,82,5.34,48,255,2438,9.0
26343,Sven Baertschi,2019-20,27.0,9,35,68,68,18,17,35,114.0,1080.0,206,43,50,93,305.0,82,5.45,47,245,2478,9.0
26344,Sven Baertschi,2020-21,28.0,10,29,53,53,14,15,29,82.0,827.0,259,57,65,122,387.0,82,5.86,50,250,2620,9.2
26345,Sven Baertschi,2021-22,29.0,11,14,26,26,9,5,14,43.0,394.0,285,66,70,136,430.0,82,5.96,47,239,2579,9.5
26346,Sven Baertschi,2022-23,30.0,12,2,6,6,0,2,2,7.0,71.0,291,66,72,138,437.0,70,5.96,42,208,2192,9.5
26347,Sven Butenschön,2000-01,24.0,4,0,8,8,0,0,0,4.0,,8,0,0,0,4.0,82,5.28,57,380,2242,9.6
26348,Sven Butenschön,2001-02,25.0,5,0,17,17,0,0,0,8.0,223.0,25,0,0,0,12.0,82,5.27,57,359,2285,9.4
26349,Sven Butenschön,2002-03,26.0,6,0,3,3,0,0,0,2.0,49.0,28,0,0,0,14.0,82,5.49,53,331,2294,9.8
26350,Sven Butenschön,2003-04,27.0,7,3,12,12,1,2,3,9.0,167.0,40,1,2,3,23.0,82,5.51,63,376,2272,9.9
26351,Sven Butenschön,2004-05,28.0,8,0,14,14,0,0,0,8.0,135.0,54,1,2,3,31.0,82,5.24,53,338,2262,9.5
26352,Sven Butenschön,2005-06,29.0,9,4,37,37,0,4,4,19.0,460.0,91,1,6,7,50.0,82,5.31,60,363,2326,9.4
26353,Sven Butenschön,2006-07,30.0,10,7,41,41,1,6,7,17.0,461.0,132,2,12,14,67.0,82,5.14,57,348,2300,9.2
26354,Sven Butenschön,2008-09,32.0,11,0,8,8,0,0,0,4.0,113.0,140,2,12,14,71.0,82,6.05,85,480,2458,10.1
26355,Sylvain Blouin,1999-00,25.0,4,0,6,6,0,0,0,1.0,,6,0,0,0,1.0,82,5.83,55,336,2444,9.8
26356,Sylvain Blouin,2000-01,26.0,5,0,1,1,0,0,0,0.0,,7,0,0,0,1.0,82,5.28,57,380,2242,9.6
26357,Sylvain Blouin,2001-02,27.0,6,0,5,5,0,0,0,1.0,18.0,12,0,0,0,2.0,82,5.27,57,359,2285,9.4
26358,Sylvain Blouin,2003-04,29.0,7,5,41,41,3,2,5,37.0,406.0,53,3,2,5,39.0,82,5.51,63,376,2272,9.9
26359,Sylvain Blouin,2004-05,30.0,8,2,43,43,0,2,2,28.0,424.0,96,3,4,7,67.0,82,5.24,53,338,2262,9.5
26360,Sylvain Blouin,2005-06,31.0,9,0,19,19,0,0,0,4.0,77.0,115,3,4,7,71.0,82,5.31,60,363,2326,9.4
26361,Sylvain Cloutier,2001-02,27.0,4,0,7,7,0,0,0,3.0,38.0,7,0,0,0,3.0,82,5.27,57,359,2285,9.4
26362,Sylvain Cote,1987-88,22.0,4,12,67,67,3,9,12,88.0,,67,3,9,12,88.0,80,7.77,71,321,2447,12.7
26363,Sylvain Cote,1988-89,23.0,5,0,2,2,0,0,0,0.0,,69,3,9,12,88.0,80,7.94,82,370,2484,12.8
26364,Sylvain Cote,1989-90,24.0,6,10,67,67,2,8,10,100.0,,136,5,17,22,188.0,80,7.34,72,344,2400,12.2
26365,Sylvain Cote,1990-91,25.0,7,28,67,67,7,21,28,142.0,,203,12,38,50,330.0,80,7.43,89,437,2435,12.2
26366,Sylvain Cote,1991-92,26.0,8,17,78,78,8,9,17,130.0,,281,20,47,67,460.0,80,7.48,85,403,2430,12.3
26367,Sylvain Cote,1992-93,27.0,9,6,28,28,4,2,6,50.0,,309,24,49,73,510.0,80,7.37,76,367,2421,12.2
26368,Sylvain Cote,1993-94,28.0,10,19,73,73,7,12,19,154.0,,382,31,61,92,664.0,80,6.91,71,366,2385,11.6
26369,Sylvain Cote,1994-95,29.0,11,40,78,78,11,29,40,151.0,,460,42,90,132,815.0,80,6.96,77,402,2440,11.4
26370,Sylvain Cote,1995-96,30.0,12,50,77,77,21,29,50,206.0,,537,63,119,182,1021.0,84,7.25,87,443,2603,11.7
26371,Sylvain Cote,1996-97,31.0,13,51,84,84,16,35,51,212.0,,621,79,154,233,1233.0,84,6.48,76,407,2545,10.7
26372,Sylvain Cote,1997-98,32.0,14,19,47,47,5,14,19,124.0,,668,84,168,252,1357.0,48,5.97,37,209,1408,10.2
26373,Sylvain Cote,1998-99,33.0,15,38,81,81,5,33,38,212.0,,749,89,201,290,1569.0,82,6.29,74,413,2481,10.4
26374,Sylvain Cote,1999-00,34.0,16,24,57,57,6,18,24,131.0,,806,95,219,314,1700.0,82,5.83,55,336,2444,9.8
26375,Sylvain Cote,2000-01,35.0,17,25,71,71,4,21,25,103.0,,877,99,240,339,1803.0,82,5.28,57,380,2242,9.6
26376,Sylvain Cote,2001-02,36.0,18,29,79,79,5,24,29,119.0,1664.0,956,104,264,368,1922.0,82,5.27,57,359,2285,9.4
26377,Sylvain Cote,2002-03,37.0,19,35,76,76,8,27,35,128.0,1625.0,1032,112,291,403,2050.0,82,5.49,53,331,2294,9.8
26378,Sylvain Cote,2003-04,38.0,20,18,68,68,7,11,18,86.0,1210.0,1100,119,302,421,2136.0,82,5.51,63,376,2272,9.9
26379,Sylvain Cote,2004-05,39.0,21,14,70,70,3,11,14,101.0,1381.0,1170,122,313,435,2237.0,82,5.24,53,338,2262,9.5
26380,Sylvain Cote,2005-06,40.0,22,0,1,1,0,0,0,0.0,4.0,1171,122,313,435,2237.0,82,5.31,60,363,2326,9.4
26381,Sylvain Couturier,1991-92,23.0,4,4,16,16,1,3,4,15.0,,16,1,3,4,15.0,80,7.48,85,403,2430,12.3
26382,Sylvain Couturier,1993-94,25.0,5,1,3,3,0,1,1,2.0,,19,1,4,5,17.0,80,6.91,71,366,2385,11.6
26383,Sylvain Couturier,1994-95,26.0,6,4,14,14,3,1,4,21.0,,33,4,5,9,38.0,80,6.96,77,402,2440,11.4
26384,Sylvain Lefebvre,1992-93,25.0,4,13,68,68,3,10,13,89.0,,68,3,10,13,89.0,80,7.37,76,367,2421,12.2
26385,Sylvain Lefebvre,1993-94,26.0,5,23,63,63,5,18,23,76.0,,131,8,28,36,165.0,80,6.91,71,366,2385,11.6
26386,Sylvain Lefebvre,1994-95,27.0,6,17,69,69,3,14,17,85.0,,200,11,42,53,250.0,80,6.96,77,402,2440,11.4
26387,Sylvain Lefebvre,1995-96,28.0,7,14,81,81,2,12,14,81.0,,281,13,54,67,331.0,84,7.25,87,443,2603,11.7
26388,Sylvain Lefebvre,1996-97,29.0,8,11,84,84,2,9,11,96.0,,365,15,63,78,427.0,84,6.48,76,407,2545,10.7
26389,Sylvain Lefebvre,1997-98,30.0,9,13,48,48,2,11,13,81.0,,413,17,74,91,508.0,48,5.97,37,209,1408,10.2
26390,Sylvain Lefebvre,1998-99,31.0,10,16,75,75,5,11,16,115.0,,488,22,85,107,623.0,82,6.29,74,413,2481,10.4
26391,Sylvain Lefebvre,1999-00,32.0,11,13,71,71,2,11,13,77.0,,559,24,96,120,700.0,82,5.83,55,336,2444,9.8
26392,Sylvain Lefebvre,2000-01,33.0,12,10,81,81,0,10,10,66.0,,640,24,106,130,766.0,82,5.28,57,380,2242,9.6
26393,Sylvain Lefebvre,2001-02,34.0,13,20,76,76,2,18,20,64.0,1591.0,716,26,124,150,830.0,82,5.27,57,359,2285,9.4
26394,Sylvain Lefebvre,2002-03,35.0,14,12,82,82,2,10,12,67.0,1525.0,798,28,134,162,897.0,82,5.49,53,331,2294,9.8
26395,Sylvain Lefebvre,2003-04,36.0,15,15,71,71,2,13,15,39.0,1289.0,869,30,147,177,936.0,82,5.51,63,376,2272,9.9
26396,Sylvain Lefebvre,2004-05,37.0,16,5,41,41,0,5,5,20.0,682.0,910,30,152,182,956.0,82,5.24,53,338,2262,9.5
26397,Sylvain Lefebvre,2005-06,38.0,17,2,35,35,0,2,2,14.0,535.0,945,30,154,184,970.0,82,5.31,60,363,2326,9.4
26398,Sylvain Turgeon,1986-87,22.0,4,72,76,76,40,32,72,238.0,,76,40,32,72,238.0,80,7.89,74,336,2448,12.9
26399,Sylvain Turgeon,1987-88,23.0,5,62,64,64,31,31,62,186.0,,140,71,63,134,424.0,80,7.77,71,321,2447,12.7
26400,Sylvain Turgeon,1988-89,24.0,6,79,76,76,45,34,79,249.0,,216,116,97,213,673.0,80,7.94,82,370,2484,12.8
26401,Sylvain Turgeon,1989-90,25.0,7,36,41,41,23,13,36,137.0,,257,139,110,249,810.0,80,7.34,72,344,2400,12.2
26402,Sylvain Turgeon,1990-91,26.0,8,49,71,71,23,26,49,247.0,,328,162,136,298,1057.0,80,7.43,89,437,2435,12.2
26403,Sylvain Turgeon,1991-92,27.0,9,30,42,42,16,14,30,122.0,,370,178,150,328,1179.0,80,7.48,85,403,2430,12.3
26404,Sylvain Turgeon,1992-93,28.0,10,47,72,72,30,17,47,218.0,,442,208,167,375,1397.0,80,7.37,76,367,2421,12.2
26405,Sylvain Turgeon,1993-94,29.0,11,12,19,19,5,7,12,41.0,,461,213,174,387,1438.0,80,6.91,71,366,2385,11.6
26406,Sylvain Turgeon,1994-95,30.0,12,20,56,56,9,11,20,99.0,,517,222,185,407,1537.0,80,6.96,77,402,2440,11.4
26407,Sylvain Turgeon,1995-96,31.0,13,43,72,72,25,18,43,249.0,,589,247,203,450,1786.0,84,7.25,87,443,2603,11.7
26408,Sylvain Turgeon,1996-97,32.0,14,26,47,47,11,15,26,116.0,,636,258,218,476,1902.0,84,6.48,76,407,2545,10.7
26409,Sylvain Turgeon,1997-98,33.0,15,19,33,33,11,8,19,83.0,,669,269,226,495,1985.0,48,5.97,37,209,1408,10.2
26410,T.J. Brennan,2014-15,25.0,4,1,11,11,1,0,1,14.0,155.0,11,1,0,1,14.0,82,5.32,47,271,2439,8.9
26411,T.J. Brennan,2015-16,26.0,5,10,29,29,3,7,10,42.0,484.0,40,4,7,11,56.0,48,5.31,29,160,1399,9.1
26412,T.J. Brennan,2017-18,28.0,6,1,6,6,0,1,1,11.0,101.0,46,4,8,12,67.0,82,5.32,47,251,2453,8.9
26413,T.J. Brennan,2018-19,29.0,7,1,7,7,1,0,1,11.0,106.0,53,5,8,13,78.0,82,5.34,48,255,2438,9.0
26414,T.J. Brodie,2013-14,23.0,4,0,3,3,0,0,0,1.0,48.0,3,0,0,0,1.0,82,5.46,52,291,2492,9.0
26415,T.J. Brodie,2014-15,24.0,5,14,54,54,2,12,14,44.0,890.0,57,2,12,14,45.0,82,5.32,47,271,2439,8.9
26416,T.J. Brodie,2015-16,25.0,6,14,47,47,2,12,14,44.0,950.0,104,4,24,28,89.0,48,5.31,29,160,1399,9.1
26417,T.J. Brodie,2016-17,26.0,7,31,81,81,4,27,31,104.0,1949.0,185,8,51,59,193.0,82,5.34,48,269,2463,8.9
26418,T.J. Brodie,2017-18,27.0,8,41,81,81,11,30,41,133.0,2042.0,266,19,81,100,326.0,82,5.32,47,251,2453,8.9
26419,T.J. Brodie,2018-19,28.0,9,45,70,70,6,39,45,79.0,1768.0,336,25,120,145,405.0,82,5.34,48,255,2438,9.0
26420,T.J. Brodie,2019-20,29.0,10,36,82,82,6,30,36,78.0,1934.0,418,31,150,181,483.0,82,5.45,47,245,2478,9.0
26421,T.J. Brodie,2020-21,30.0,11,32,73,73,4,28,32,118.0,1729.0,491,35,178,213,601.0,82,5.86,50,250,2620,9.2
26422,T.J. Brodie,2021-22,31.0,12,34,79,79,9,25,34,102.0,1696.0,570,44,203,247,703.0,82,5.96,47,239,2579,9.5
26423,T.J. Brodie,2022-23,32.0,13,19,64,64,4,15,19,65.0,1309.0,634,48,218,266,768.0,70,5.96,42,208,2192,9.5
26424,T.J. Galiardi,2011-12,23.0,4,4,11,11,3,1,4,14.0,180.0,11,3,1,4,14.0,82,5.7,65,341,2477,9.4
26425,T.J. Galiardi,2012-13,24.0,5,39,70,70,15,24,39,120.0,1273.0,81,18,25,43,134.0,82,5.53,56,304,2486,9.1
26426,T.J. Galiardi,2013-14,25.0,6,15,35,35,7,8,15,62.0,567.0,116,25,33,58,196.0,82,5.46,52,291,2492,9.0
26427,T.J. Galiardi,2014-15,26.0,7,15,69,69,9,6,15,113.0,900.0,185,34,39,73,309.0,82,5.32,47,271,2439,8.9
26428,T.J. Galiardi,2015-16,27.0,8,14,36,36,5,9,14,68.0,499.0,221,39,48,87,377.0,48,5.31,29,160,1399,9.1
26429,T.J. Galiardi,2016-17,28.0,9,17,62,62,4,13,17,100.0,906.0,283,43,61,104,477.0,82,5.34,48,269,2463,8.9
26430,T.J. Galiardi,2017-18,29.0,10,1,38,38,1,0,1,35.0,398.0,321,44,61,105,512.0,82,5.32,47,251,2453,8.9
26431,T.J. Hensick,2010-11,25.0,4,11,31,31,6,5,11,52.0,372.0,31,6,5,11,52.0,82,5.44,62,351,2383,9.4
26432,T.J. Hensick,2011-12,26.0,5,21,61,61,4,17,21,116.0,787.0,92,10,22,32,168.0,82,5.7,65,341,2477,9.4
26433,T.J. Hensick,2012-13,27.0,6,3,7,7,1,2,3,13.0,66.0,99,11,24,35,181.0,82,5.53,56,304,2486,9.1
26434,T.J. Hensick,2013-14,28.0,7,3,13,13,1,2,3,12.0,118.0,112,12,26,38,193.0,82,5.46,52,291,2492,9.0
26435,T.J. Oshie,2011-12,25.0,4,39,57,57,14,25,39,101.0,945.0,57,14,25,39,101.0,82,5.7,65,341,2477,9.4
26436,T.J. Oshie,2012-13,26.0,5,48,76,76,18,30,48,158.0,1392.0,133,32,55,87,259.0,82,5.53,56,304,2486,9.1
26437,T.J. Oshie,2013-14,27.0,6,34,49,49,12,22,34,103.0,940.0,182,44,77,121,362.0,82,5.46,52,291,2492,9.0
26438,T.J. Oshie,2014-15,28.0,7,54,80,80,19,35,54,188.0,1562.0,262,63,112,175,550.0,82,5.32,47,271,2439,8.9
26439,T.J. Oshie,2015-16,29.0,8,20,30,30,7,13,20,65.0,573.0,292,70,125,195,615.0,48,5.31,29,160,1399,9.1
26440,T.J. Oshie,2016-17,30.0,9,60,79,79,21,39,60,152.0,1500.0,371,91,164,255,767.0,82,5.34,48,269,2463,8.9
26441,T.J. Oshie,2017-18,31.0,10,55,72,72,19,36,55,162.0,1356.0,443,110,200,310,929.0,82,5.32,47,251,2453,8.9
26442,T.J. Oshie,2018-19,32.0,11,51,80,80,26,25,51,185.0,1517.0,523,136,225,361,1114.0,82,5.34,48,255,2438,9.0
26443,T.J. Oshie,2019-20,33.0,12,56,68,68,33,23,56,143.0,1214.0,591,169,248,417,1257.0,82,5.45,47,245,2478,9.0
26444,T.J. Oshie,2020-21,34.0,13,47,74,74,18,29,47,127.0,1362.0,665,187,277,464,1384.0,82,5.86,50,250,2620,9.2
26445,T.J. Oshie,2021-22,35.0,14,54,69,69,25,29,54,143.0,1284.0,734,212,306,518,1527.0,82,5.96,47,239,2579,9.5
26446,T.J. Oshie,2022-23,36.0,15,49,69,69,26,23,49,133.0,1262.0,803,238,329,567,1660.0,70,5.96,42,208,2192,9.5
26447,T.J. Tynan,2019-20,27.0,4,0,3,3,0,0,0,3.0,22.0,3,0,0,0,3.0,82,5.45,47,245,2478,9.0
26448,T.J. Tynan,2022-23,30.0,5,1,16,16,0,1,1,7.0,136.0,19,0,1,1,10.0,70,5.96,42,208,2192,9.5
26449,Tage Thompson,2020-21,23.0,4,9,41,41,3,6,9,55.0,489.0,41,3,6,9,55.0,82,5.86,50,250,2620,9.2
26450,Tage Thompson,2021-22,24.0,5,12,65,65,7,5,12,108.0,788.0,106,10,11,21,163.0,82,5.96,47,239,2579,9.5
26451,Tage Thompson,2022-23,25.0,6,0,1,1,0,0,0,0.0,7.0,107,10,11,21,163.0,70,5.96,42,208,2192,9.5
26452,Tanner Fritz,2020-21,29.0,4,7,34,34,3,4,7,27.0,426.0,34,3,4,7,27.0,82,5.86,50,250,2620,9.2
26453,Tanner Fritz,2021-22,30.0,5,1,8,8,0,1,1,6.0,87.0,42,3,5,8,33.0,82,5.96,47,239,2579,9.5
26454,Tanner Glass,2010-11,27.0,4,2,41,41,1,1,2,11.0,181.0,41,1,1,2,11.0,82,5.44,62,351,2383,9.4
26455,Tanner Glass,2011-12,28.0,5,0,3,3,0,0,0,1.0,20.0,44,1,1,2,12.0,82,5.7,65,341,2477,9.4
26456,Tanner Glass,2012-13,29.0,6,11,67,67,4,7,11,52.0,702.0,111,5,8,13,64.0,82,5.53,56,304,2486,9.1
26457,Tanner Glass,2013-14,30.0,7,10,73,73,3,7,10,45.0,652.0,184,8,15,23,109.0,82,5.46,52,291,2492,9.0
26458,Tanner Glass,2014-15,31.0,8,16,78,78,5,11,16,86.0,1047.0,262,13,26,39,195.0,82,5.32,47,271,2439,8.9
26459,Tanner Glass,2015-16,32.0,9,2,48,48,1,1,2,38.0,483.0,310,14,27,41,233.0,48,5.31,29,160,1399,9.1
26460,Tanner Glass,2016-17,33.0,10,13,67,67,4,9,13,56.0,790.0,377,18,36,54,289.0,82,5.34,48,269,2463,8.9
26461,Tanner Glass,2017-18,34.0,11,6,66,66,1,5,6,53.0,676.0,443,19,41,60,342.0,82,5.32,47,251,2453,8.9
26462,Tanner Glass,2018-19,35.0,12,7,57,57,4,3,7,49.0,586.0,500,23,44,67,391.0,82,5.34,48,255,2438,9.0
26463,Tanner Glass,2019-20,36.0,13,2,11,11,1,1,2,8.0,120.0,511,24,45,69,399.0,82,5.45,47,245,2478,9.0
26464,Tanner Glass,2020-21,37.0,14,0,16,16,0,0,0,14.0,150.0,527,24,45,69,413.0,82,5.86,50,250,2620,9.2
26465,Tanner Kero,2018-19,26.0,4,3,17,17,1,2,3,26.0,209.0,17,1,2,3,26.0,82,5.34,48,255,2438,9.0
26466,Tanner Kero,2019-20,27.0,5,16,47,47,6,10,16,60.0,634.0,64,7,12,19,86.0,82,5.45,47,245,2478,9.0
26467,Tanner Kero,2020-21,28.0,6,3,8,8,1,2,3,7.0,92.0,72,8,14,22,93.0,82,5.86,50,250,2620,9.2
26468,Tanner Pearson,2016-17,24.0,4,7,25,25,3,4,7,31.0,270.0,25,3,4,7,31.0,82,5.34,48,269,2463,8.9
26469,Tanner Pearson,2017-18,25.0,5,16,42,42,12,4,16,68.0,558.0,67,15,8,23,99.0,82,5.32,47,251,2453,8.9
26470,Tanner Pearson,2018-19,26.0,6,36,79,79,15,21,36,137.0,1142.0,146,30,29,59,236.0,82,5.34,48,255,2438,9.0
26471,Tanner Pearson,2019-20,27.0,7,44,80,80,24,20,44,187.0,1306.0,226,54,49,103,423.0,82,5.45,47,245,2478,9.0
26472,Tanner Pearson,2020-21,28.0,8,40,82,82,15,25,40,180.0,1309.0,308,69,74,143,603.0,82,5.86,50,250,2620,9.2
26473,Tanner Pearson,2021-22,29.0,9,27,80,80,18,9,27,147.0,1124.0,388,87,83,170,750.0,82,5.96,47,239,2579,9.5
26474,Tanner Pearson,2022-23,30.0,10,45,69,69,21,24,45,164.0,1139.0,457,108,107,215,914.0,70,5.96,42,208,2192,9.5
26475,Tanner Richard,2019-20,26.0,4,0,3,3,0,0,0,1.0,38.0,3,0,0,0,1.0,82,5.45,47,245,2478,9.0
26476,Tapio Levo,1984-85,29.0,4,22,34,34,9,13,22,70.0,,34,9,13,22,70.0,80,8.03,73,320,2489,12.9
26477,Tapio Levo,1985-86,30.0,5,47,73,73,7,40,47,187.0,,107,16,53,69,257.0,80,7.73,71,310,2444,12.7
26478,Taro Hirose,2021-22,25.0,4,7,10,10,1,6,7,15.0,153.0,10,1,6,7,15.0,82,5.96,47,239,2579,9.5
26479,Taro Hirose,2022-23,26.0,5,7,26,26,2,5,7,21.0,326.0,36,3,11,14,36.0,70,5.96,42,208,2192,9.5
26480,Tavis Hansen,1997-98,22.0,4,0,1,1,0,0,0,0.0,,1,0,0,0,0.0,48,5.97,37,209,1408,10.2
26481,Tavis Hansen,1999-00,24.0,5,0,1,1,0,0,0,0.0,,2,0,0,0,0.0,82,5.83,55,336,2444,9.8
26482,Tavis Hansen,2001-02,26.0,6,3,20,20,2,1,3,14.0,162.0,22,2,1,3,14.0,82,5.27,57,359,2285,9.4
26483,Tavis Hansen,2002-03,27.0,7,0,5,5,0,0,0,2.0,21.0,27,2,1,3,16.0,82,5.49,53,331,2294,9.8
26484,Tavis Hansen,2003-04,28.0,8,0,7,7,0,0,0,2.0,36.0,34,2,1,3,18.0,82,5.51,63,376,2272,9.9
26485,Taylor Beck,2015-16,24.0,4,7,16,16,3,4,7,39.0,258.0,16,3,4,7,39.0,48,5.31,29,160,1399,9.1
26486,Taylor Beck,2016-17,25.0,5,0,7,7,0,0,0,9.0,90.0,23,3,4,7,48.0,82,5.34,48,269,2463,8.9
26487,Taylor Beck,2017-18,26.0,6,16,62,62,8,8,16,78.0,740.0,85,11,12,23,126.0,82,5.32,47,251,2453,8.9
26488,Taylor Beck,2018-19,27.0,7,0,2,2,0,0,0,0.0,17.0,87,11,12,23,126.0,82,5.34,48,255,2438,9.0
26489,Taylor Beck,2019-20,28.0,8,0,5,5,0,0,0,5.0,44.0,92,11,12,23,131.0,82,5.45,47,245,2478,9.0
26490,Taylor Chorney,2011-12,24.0,4,0,2,2,0,0,0,0.0,31.0,2,0,0,0,0.0,82,5.7,65,341,2477,9.4
26491,Taylor Chorney,2012-13,25.0,5,3,42,42,0,3,3,35.0,730.0,44,0,3,3,35.0,82,5.53,56,304,2486,9.1
26492,Taylor Chorney,2013-14,26.0,6,4,12,12,1,3,4,13.0,192.0,56,1,6,7,48.0,82,5.46,52,291,2492,9.0
26493,Taylor Chorney,2014-15,27.0,7,0,5,5,0,0,0,2.0,71.0,61,1,6,7,50.0,82,5.32,47,271,2439,8.9
26494,Taylor Chorney,2017-18,30.0,8,0,7,7,0,0,0,4.0,85.0,68,1,6,7,54.0,82,5.32,47,251,2453,8.9
26495,Taylor Chorney,2018-19,31.0,9,6,55,55,1,5,6,28.0,726.0,123,2,11,13,82.0,82,5.34,48,255,2438,9.0
26496,Taylor Chorney,2019-20,32.0,10,5,18,18,1,4,5,19.0,257.0,141,3,15,18,101.0,82,5.45,47,245,2478,9.0
26497,Taylor Chorney,2020-21,33.0,11,4,25,25,1,3,4,14.0,328.0,166,4,18,22,115.0,82,5.86,50,250,2620,9.2
26498,Taylor Fedun,2016-17,28.0,4,2,4,4,2,0,2,6.0,49.0,4,2,0,2,6.0,82,5.34,48,269,2463,8.9
26499,Taylor Fedun,2017-18,29.0,5,4,7,7,0,4,4,12.0,119.0,11,2,4,6,18.0,82,5.32,47,251,2453,8.9
26500,Taylor Fedun,2018-19,30.0,6,1,1,1,0,1,1,0.0,19.0,12,2,5,7,18.0,82,5.34,48,255,2438,9.0
26501,Taylor Fedun,2019-20,31.0,7,7,27,27,0,7,7,24.0,361.0,39,2,12,14,42.0,82,5.45,47,245,2478,9.0
26502,Taylor Fedun,2020-21,32.0,8,1,7,7,0,1,1,8.0,103.0,46,2,13,15,50.0,82,5.86,50,250,2620,9.2
26503,Taylor Fedun,2021-22,33.0,9,11,54,54,4,7,11,86.0,748.0,100,6,20,26,136.0,82,5.96,47,239,2579,9.5
26504,Taylor Fedun,2022-23,34.0,10,9,27,27,2,7,9,40.0,371.0,127,8,27,35,176.0,70,5.96,42,208,2192,9.5
26505,Taylor Hall,1986-87,22.0,4,1,4,4,1,0,1,3.0,,4,1,0,1,3.0,80,7.89,74,336,2448,12.9
26506,Taylor Hall,1987-88,23.0,5,5,7,7,1,4,5,14.0,,11,2,4,6,17.0,80,7.77,71,321,2447,12.7
26507,Taylor Hall,1988-89,24.0,6,10,19,19,5,5,10,30.0,,30,7,9,16,47.0,80,7.94,82,370,2484,12.8
26508,Taylor Hall,1989-90,25.0,7,0,4,4,0,0,0,1.0,,34,7,9,16,48.0,80,7.34,72,344,2400,12.2
26509,Taylor Hall,1990-91,26.0,8,0,7,7,0,0,0,5.0,,41,7,9,16,53.0,80,7.43,89,437,2435,12.2
26510,Taylor Hall0,2013-14,22.0,4,42,65,65,22,20,42,186.0,1184.0,65,22,20,42,186.0,82,5.46,52,291,2492,9.0
26511,Taylor Hall0,2014-15,23.0,5,53,61,61,27,26,53,207.0,1111.0,126,49,46,95,393.0,82,5.32,47,271,2439,8.9
26512,Taylor Hall0,2015-16,24.0,6,50,45,45,16,34,50,154.0,838.0,171,65,80,145,547.0,48,5.31,29,160,1399,9.1
26513,Taylor Hall0,2016-17,25.0,7,80,75,75,27,53,80,250.0,1501.0,246,92,133,225,797.0,82,5.34,48,269,2463,8.9
26514,Taylor Hall0,2017-18,26.0,8,38,53,53,14,24,38,158.0,1019.0,299,106,157,263,955.0,82,5.32,47,251,2453,8.9
26515,Taylor Hall0,2018-19,27.0,9,65,82,82,26,39,65,286.0,1575.0,381,132,196,328,1241.0,82,5.34,48,255,2438,9.0
26516,Taylor Hall0,2019-20,28.0,10,53,72,72,20,33,53,238.0,1392.0,453,152,229,381,1479.0,82,5.45,47,245,2478,9.0
26517,Taylor Hall0,2020-21,29.0,11,93,76,76,39,54,93,278.0,1455.0,529,191,283,474,1757.0,82,5.86,50,250,2620,9.2
26518,Taylor Hall0,2021-22,30.0,12,37,33,33,11,26,37,113.0,650.0,562,202,309,511,1870.0,82,5.96,47,239,2579,9.5
26519,Taylor Hall0,2022-23,31.0,13,52,65,65,16,36,52,232.0,1246.0,627,218,345,563,2102.0,70,5.96,42,208,2192,9.5
26520,Taylor Leier,2018-19,24.0,4,0,6,6,0,0,0,3.0,46.0,6,0,0,0,3.0,82,5.34,48,255,2438,9.0
26521,Taylor Leier,2019-20,25.0,5,2,10,10,1,1,2,7.0,91.0,16,1,1,2,10.0,82,5.45,47,245,2478,9.0
26522,Taylor Leier,2020-21,26.0,6,5,39,39,1,4,5,48.0,409.0,55,2,5,7,58.0,82,5.86,50,250,2620,9.2
26523,Taylor Pyatt,2003-04,22.0,4,18,78,78,4,14,18,86.0,954.0,78,4,14,18,86.0,82,5.51,63,376,2272,9.9
26524,Taylor Pyatt,2004-05,23.0,5,20,48,48,10,10,20,61.0,648.0,126,14,24,38,147.0,82,5.24,53,338,2262,9.5
26525,Taylor Pyatt,2005-06,24.0,6,28,78,78,14,14,28,110.0,1099.0,204,28,38,66,257.0,82,5.31,60,363,2326,9.4
26526,Taylor Pyatt,2006-07,25.0,7,20,63,63,8,12,20,98.0,983.0,267,36,50,86,355.0,82,5.14,57,348,2300,9.2
26527,Taylor Pyatt,2008-09,27.0,8,12,41,41,6,6,12,62.0,461.0,308,42,56,98,417.0,82,6.05,85,480,2458,10.1
26528,Taylor Pyatt,2009-10,28.0,9,37,76,76,23,14,37,150.0,1061.0,384,65,70,135,567.0,82,5.76,70,398,2426,9.7
26529,Taylor Pyatt,2010-11,29.0,10,37,79,79,16,21,37,167.0,1247.0,463,81,91,172,734.0,82,5.44,62,351,2383,9.4
26530,Taylor Pyatt,2011-12,30.0,11,19,69,69,10,9,19,99.0,1015.0,532,91,100,191,833.0,82,5.7,65,341,2477,9.4
26531,Taylor Pyatt,2012-13,31.0,12,23,74,74,12,11,23,121.0,996.0,606,103,111,214,954.0,82,5.53,56,304,2486,9.1
26532,Taylor Pyatt,2013-14,32.0,13,31,76,76,18,13,31,126.0,1178.0,682,121,124,245,1080.0,82,5.46,52,291,2492,9.0
26533,Taylor Pyatt,2014-15,33.0,14,19,73,73,9,10,19,111.0,899.0,755,130,134,264,1191.0,82,5.32,47,271,2439,8.9
26534,Taylor Pyatt,2015-16,34.0,15,11,48,48,6,5,11,56.0,629.0,803,136,139,275,1247.0,48,5.31,29,160,1399,9.1
26535,Taylor Pyatt,2016-17,35.0,16,5,56,56,4,1,5,52.0,648.0,859,140,140,280,1299.0,82,5.34,48,269,2463,8.9
26536,Ted Crowley,1996-97,26.0,4,3,21,21,1,2,3,28.0,,21,1,2,3,28.0,84,6.48,76,407,2545,10.7
26537,Ted Crowley,2001-02,31.0,5,3,13,13,1,2,3,20.0,140.0,34,2,4,6,48.0,82,5.27,57,359,2285,9.4
26538,Ted Donato,1994-95,25.0,4,3,10,10,1,2,3,13.0,,10,1,2,3,13.0,80,6.96,77,402,2440,11.4
26539,Ted Donato,1995-96,26.0,5,35,82,82,15,20,35,118.0,,92,16,22,38,131.0,84,7.25,87,443,2603,11.7
26540,Ted Donato,1996-97,27.0,6,54,84,84,22,32,54,158.0,,176,38,54,92,289.0,84,6.48,76,407,2545,10.7
26541,Ted Donato,1997-98,28.0,7,20,47,47,10,10,20,71.0,,223,48,64,112,360.0,48,5.97,37,209,1408,10.2
26542,Ted Donato,1998-99,29.0,8,49,82,82,23,26,49,152.0,,305,71,90,161,512.0,82,6.29,74,413,2481,10.4
26543,Ted Donato,1999-00,30.0,9,51,67,67,25,26,51,172.0,,372,96,116,212,684.0,82,5.83,55,336,2444,9.8
26544,Ted Donato,2000-01,31.0,10,39,79,79,16,23,39,129.0,,451,112,139,251,813.0,82,5.28,57,380,2242,9.6
26545,Ted Donato,2001-02,32.0,11,27,82,82,11,16,27,106.0,1028.0,533,123,155,278,919.0,82,5.27,57,359,2285,9.4
26546,Ted Donato,2002-03,33.0,12,30,81,81,11,19,30,138.0,1181.0,614,134,174,308,1057.0,82,5.49,53,331,2294,9.8
26547,Ted Donato,2003-04,34.0,13,25,65,65,8,17,25,71.0,664.0,679,142,191,333,1128.0,82,5.51,63,376,2272,9.9
26548,Ted Donato,2004-05,35.0,14,0,5,5,0,0,0,2.0,41.0,684,142,191,333,1130.0,82,5.24,53,338,2262,9.5
26549,Ted Donato,2005-06,36.0,15,3,49,49,2,1,3,30.0,419.0,733,144,192,336,1160.0,82,5.31,60,363,2326,9.4
26550,Ted Donato,2006-07,37.0,16,11,63,63,6,5,11,35.0,584.0,796,150,197,347,1195.0,82,5.14,57,348,2300,9.2
26551,Ted Drury,1996-97,25.0,4,18,50,50,6,12,18,80.0,,50,6,12,18,80.0,84,6.48,76,407,2545,10.7
26552,Ted Drury,1997-98,26.0,5,9,34,34,3,6,9,31.0,,84,9,18,27,111.0,48,5.97,37,209,1408,10.2
26553,Ted Drury,1998-99,27.0,6,16,42,42,9,7,16,80.0,,126,18,25,43,191.0,82,6.29,74,413,2481,10.4
26554,Ted Drury,1999-00,28.0,7,18,73,73,9,9,18,114.0,,199,27,34,61,305.0,82,5.83,55,336,2444,9.8
26555,Ted Drury,2000-01,29.0,8,16,73,73,6,10,16,110.0,,272,33,44,77,415.0,82,5.28,57,380,2242,9.6
26556,Ted Drury,2001-02,30.0,9,11,75,75,5,6,11,79.0,619.0,347,38,50,88,494.0,82,5.27,57,359,2285,9.4
26557,Ted Drury,2002-03,31.0,10,5,66,66,3,2,5,57.0,487.0,413,41,52,93,551.0,82,5.49,53,331,2294,9.8
26558,Ted Drury,2003-04,32.0,11,0,1,1,0,0,0,3.0,15.0,414,41,52,93,554.0,82,5.51,63,376,2272,9.9
26559,Ted Fauss,1989-90,28.0,4,1,15,15,0,1,1,4.0,,15,0,1,1,4.0,80,7.34,72,344,2400,12.2
26560,Ted Fauss,1990-91,29.0,5,1,13,13,0,1,1,2.0,,28,0,2,2,6.0,80,7.43,89,437,2435,12.2
26561,Ted Nolan,1984-85,26.0,4,17,41,41,4,13,17,67.0,,41,4,13,17,67.0,80,8.03,73,320,2489,12.9
26562,Ted Nolan,1986-87,28.0,5,3,19,19,1,2,3,15.0,,60,5,15,20,82.0,80,7.89,74,336,2448,12.9
26563,Ted Nolan,1988-89,30.0,6,2,18,18,1,1,2,17.0,,78,6,16,22,99.0,80,7.94,82,370,2484,12.8
26564,Ted Speers,1988-89,28.0,4,2,4,4,1,1,2,6.0,,4,1,1,2,6.0,80,7.94,82,370,2484,12.8
26565,Teddy Blueger,2021-22,27.0,4,10,28,28,6,4,10,33.0,310.0,28,6,4,10,33.0,82,5.96,47,239,2579,9.5
26566,Teddy Blueger,2022-23,28.0,5,22,69,69,9,13,22,102.0,1091.0,97,15,17,32,135.0,70,5.96,42,208,2192,9.5
26567,Teddy Purcell,2010-11,25.0,4,3,10,10,1,2,3,10.0,120.0,10,1,2,3,10.0,82,5.44,62,351,2383,9.4
26568,Teddy Purcell,2011-12,26.0,5,16,40,40,4,12,16,68.0,541.0,50,5,14,19,78.0,82,5.7,65,341,2477,9.4
26569,Teddy Purcell,2012-13,27.0,6,15,60,60,6,9,15,101.0,772.0,110,11,23,34,179.0,82,5.53,56,304,2486,9.1
26570,Teddy Purcell,2013-14,28.0,7,51,81,81,17,34,51,196.0,1142.0,191,28,57,85,375.0,82,5.46,52,291,2492,9.0
26571,Teddy Purcell,2014-15,29.0,8,65,81,81,24,41,65,152.0,1307.0,272,52,98,150,527.0,82,5.32,47,271,2439,8.9
26572,Teddy Purcell,2015-16,30.0,9,36,48,48,11,25,36,94.0,804.0,320,63,123,186,621.0,48,5.31,29,160,1399,9.1
26573,Teddy Purcell,2016-17,31.0,10,42,81,81,12,30,42,157.0,1334.0,401,75,153,228,778.0,82,5.34,48,269,2463,8.9
26574,Teddy Purcell,2017-18,32.0,11,34,82,82,12,22,34,146.0,1407.0,483,87,175,262,924.0,82,5.32,47,251,2453,8.9
26575,Teddy Purcell,2018-19,33.0,12,43,76,76,14,29,43,149.0,1279.0,559,101,204,305,1073.0,82,5.34,48,255,2438,9.0
26576,Teddy Purcell,2019-20,34.0,13,2,12,12,0,2,2,10.0,155.0,571,101,206,307,1083.0,82,5.45,47,245,2478,9.0
26577,Teemu Hartikainen,2013-14,23.0,4,5,12,12,3,2,5,21.0,209.0,12,3,2,5,21.0,82,5.46,52,291,2492,9.0
26578,Teemu Hartikainen,2014-15,24.0,5,5,17,17,2,3,5,24.0,221.0,29,5,5,10,45.0,82,5.32,47,271,2439,8.9
26579,Teemu Hartikainen,2015-16,25.0,6,3,23,23,1,2,3,21.0,243.0,52,6,7,13,66.0,48,5.31,29,160,1399,9.1
26580,Teemu Laakso,2012-13,25.0,4,0,7,7,0,0,0,5.0,76.0,7,0,0,0,5.0,82,5.53,56,304,2486,9.1
26581,Teemu Laakso,2013-14,26.0,5,0,1,1,0,0,0,0.0,3.0,8,0,0,0,5.0,82,5.46,52,291,2492,9.0
26582,Teemu Laakso,2014-15,27.0,6,0,9,9,0,0,0,4.0,104.0,17,0,0,0,9.0,82,5.32,47,271,2439,8.9
26583,Teemu Pulkkinen,2016-17,25.0,4,0,3,3,0,0,0,4.0,22.0,3,0,0,0,4.0,82,5.34,48,269,2463,8.9
26584,Teemu Pulkkinen,2017-18,26.0,5,8,31,31,5,3,8,67.0,356.0,34,5,3,8,71.0,82,5.32,47,251,2453,8.9
26585,Teemu Pulkkinen,2018-19,27.0,6,12,36,36,6,6,12,65.0,416.0,70,11,9,20,136.0,82,5.34,48,255,2438,9.0
26586,Teemu Pulkkinen,2019-20,28.0,7,2,13,13,2,0,2,10.0,124.0,83,13,9,22,146.0,82,5.45,47,245,2478,9.0
26587,Teemu Selanne,1995-96,25.0,4,132,84,84,76,56,132,387.0,,84,76,56,132,387.0,84,7.25,87,443,2603,11.7
26588,Teemu Selanne,1996-97,26.0,5,54,51,51,25,29,54,191.0,,135,101,85,186,578.0,84,6.48,76,407,2545,10.7
26589,Teemu Selanne,1997-98,27.0,6,48,45,45,22,26,48,167.0,,180,123,111,234,745.0,48,5.97,37,209,1408,10.2
26590,Teemu Selanne,1998-99,28.0,7,108,79,79,40,68,108,267.0,,259,163,179,342,1012.0,82,6.29,74,413,2481,10.4
26591,Teemu Selanne,1999-00,29.0,8,109,78,78,51,58,109,273.0,,337,214,237,451,1285.0,82,5.83,55,336,2444,9.8
26592,Teemu Selanne,2000-01,30.0,9,86,73,73,52,34,86,268.0,,410,266,271,537,1553.0,82,5.28,57,380,2242,9.6
26593,Teemu Selanne,2001-02,31.0,10,107,75,75,47,60,107,281.0,1709.0,485,313,331,644,1834.0,82,5.27,57,359,2285,9.4
26594,Teemu Selanne,2002-03,32.0,11,85,79,79,33,52,85,236.0,1795.0,564,346,383,729,2070.0,82,5.49,53,331,2294,9.8
26595,Teemu Selanne,2003-04,33.0,12,72,73,73,33,39,72,233.0,1552.0,637,379,422,801,2303.0,82,5.51,63,376,2272,9.9
26596,Teemu Selanne,2004-05,34.0,13,54,82,82,29,25,54,202.0,1392.0,719,408,447,855,2505.0,82,5.24,53,338,2262,9.5
26597,Teemu Selanne,2005-06,35.0,14,64,82,82,28,36,64,253.0,1577.0,801,436,483,919,2758.0,82,5.31,60,363,2326,9.4
26598,Teemu Selanne,2006-07,36.0,15,32,78,78,16,16,32,182.0,1261.0,879,452,499,951,2940.0,82,5.14,57,348,2300,9.2
26599,Teemu Selanne,2008-09,38.0,16,90,80,80,40,50,90,267.0,1424.0,959,492,549,1041,3207.0,82,6.05,85,480,2458,10.1
26600,Teemu Selanne,2009-10,39.0,17,94,82,82,48,46,94,257.0,1451.0,1041,540,595,1135,3464.0,82,5.76,70,398,2426,9.7
26601,Teemu Selanne,2010-11,40.0,18,23,26,26,12,11,23,87.0,471.0,1067,552,606,1158,3551.0,82,5.44,62,351,2383,9.4
26602,Teemu Selanne,2011-12,41.0,19,54,65,65,27,27,54,186.0,1072.0,1132,579,633,1212,3737.0,82,5.7,65,341,2477,9.4
26603,Teemu Selanne,2012-13,42.0,20,48,54,54,27,21,48,173.0,935.0,1186,606,654,1260,3910.0,82,5.53,56,304,2486,9.1
26604,Teemu Selanne,2013-14,43.0,21,80,73,73,31,49,80,213.0,1310.0,1259,637,703,1340,4123.0,82,5.46,52,291,2492,9.0
26605,Teemu Selanne,2014-15,44.0,22,66,82,82,26,40,66,210.0,1466.0,1341,663,743,1406,4333.0,82,5.32,47,271,2439,8.9
26606,Teemu Selanne,2015-16,45.0,23,24,46,46,12,12,24,96.0,722.0,1387,675,755,1430,4429.0,48,5.31,29,160,1399,9.1
26607,Teemu Selanne,2016-17,46.0,24,27,64,64,9,18,27,111.0,904.0,1451,684,773,1457,4540.0,82,5.34,48,269,2463,8.9
26608,Teppo Numminen,1991-92,23.0,4,15,69,69,1,14,15,85.0,,69,1,14,15,85.0,80,7.48,85,403,2430,12.3
26609,Teppo Numminen,1992-93,24.0,5,43,79,79,11,32,43,105.0,,148,12,46,58,190.0,80,7.37,76,367,2421,12.2
26610,Teppo Numminen,1993-94,25.0,6,33,80,80,8,25,33,151.0,,228,20,71,91,341.0,80,6.91,71,366,2385,11.6
26611,Teppo Numminen,1994-95,26.0,7,39,80,80,5,34,39,143.0,,308,25,105,130,484.0,80,6.96,77,402,2440,11.4
26612,Teppo Numminen,1995-96,27.0,8,37,66,66,7,30,37,103.0,,374,32,135,167,587.0,84,7.25,87,443,2603,11.7
26613,Teppo Numminen,1996-97,28.0,9,23,57,57,5,18,23,89.0,,431,37,153,190,676.0,84,6.48,76,407,2545,10.7
26614,Teppo Numminen,1997-98,29.0,10,21,42,42,5,16,21,86.0,,473,42,169,211,762.0,48,5.97,37,209,1408,10.2
26615,Teppo Numminen,1998-99,30.0,11,54,74,74,11,43,54,165.0,,547,53,212,265,927.0,82,6.29,74,413,2481,10.4
26616,Teppo Numminen,1999-00,31.0,12,27,82,82,2,25,27,135.0,,629,55,237,292,1062.0,82,5.83,55,336,2444,9.8
26617,Teppo Numminen,2000-01,32.0,13,51,82,82,11,40,51,126.0,,711,66,277,343,1188.0,82,5.28,57,380,2242,9.6
26618,Teppo Numminen,2001-02,33.0,14,40,82,82,10,30,40,156.0,2004.0,793,76,307,383,1344.0,82,5.27,57,359,2285,9.4
26619,Teppo Numminen,2002-03,34.0,15,42,79,79,8,34,42,126.0,1866.0,872,84,341,425,1470.0,82,5.49,53,331,2294,9.8
26620,Teppo Numminen,2003-04,35.0,16,31,72,72,5,26,31,109.0,1762.0,944,89,367,456,1579.0,82,5.51,63,376,2272,9.9
26621,Teppo Numminen,2004-05,36.0,17,48,76,76,13,35,48,117.0,1813.0,1020,102,402,504,1696.0,82,5.24,53,338,2262,9.5
26622,Teppo Numminen,2005-06,37.0,18,30,78,78,6,24,30,108.0,1861.0,1098,108,426,534,1804.0,82,5.31,60,363,2326,9.4
26623,Teppo Numminen,2006-07,38.0,19,17,62,62,3,14,17,83.0,1343.0,1160,111,440,551,1887.0,82,5.14,57,348,2300,9.2
26624,Teppo Numminen,2008-09,40.0,20,40,75,75,2,38,40,60.0,1463.0,1235,113,478,591,1947.0,82,6.05,85,480,2458,10.1
26625,Teppo Numminen,2009-10,41.0,21,29,79,79,2,27,29,69.0,1643.0,1314,115,505,620,2016.0,82,5.76,70,398,2426,9.7
26626,Teppo Numminen,2010-11,42.0,22,0,1,1,0,0,0,1.0,16.0,1315,115,505,620,2017.0,82,5.44,62,351,2383,9.4
26627,Teppo Numminen,2011-12,43.0,23,17,57,57,2,15,17,34.0,998.0,1372,117,520,637,2051.0,82,5.7,65,341,2477,9.4
26628,Terran Sandwith,2000-01,28.0,4,0,8,8,0,0,0,4.0,,8,0,0,0,4.0,82,5.28,57,380,2242,9.6
26629,Terry Carkner,1989-90,23.0,4,15,52,52,2,13,15,33.0,,52,2,13,15,33.0,80,7.34,72,344,2400,12.2
26630,Terry Carkner,1990-91,24.0,5,27,63,63,3,24,27,54.0,,115,5,37,42,87.0,80,7.43,89,437,2435,12.2
26631,Terry Carkner,1991-92,25.0,6,43,78,78,11,32,43,84.0,,193,16,69,85,171.0,80,7.48,85,403,2430,12.3
26632,Terry Carkner,1992-93,26.0,7,22,63,63,4,18,22,60.0,,256,20,87,107,231.0,80,7.37,76,367,2421,12.2
26633,Terry Carkner,1993-94,27.0,8,32,79,79,7,25,32,97.0,,335,27,112,139,328.0,80,6.91,71,366,2385,11.6
26634,Terry Carkner,1994-95,28.0,9,16,73,73,4,12,16,70.0,,408,31,124,155,398.0,80,6.96,77,402,2440,11.4
26635,Terry Carkner,1995-96,29.0,10,19,83,83,3,16,19,45.0,,491,34,140,174,443.0,84,7.25,87,443,2603,11.7
26636,Terry Carkner,1996-97,30.0,11,7,68,68,1,6,7,32.0,,559,35,146,181,475.0,84,6.48,76,407,2545,10.7
26637,Terry Carkner,1997-98,31.0,12,3,20,20,1,2,3,9.0,,579,36,148,184,484.0,48,5.97,37,209,1408,10.2
26638,Terry Carkner,1998-99,32.0,13,13,73,73,3,10,13,42.0,,652,39,158,197,526.0,82,6.29,74,413,2481,10.4
26639,Terry Carkner,1999-00,33.0,14,14,70,70,0,14,14,38.0,,722,39,172,211,564.0,82,5.83,55,336,2444,9.8
26640,Terry Carkner,2000-01,34.0,15,8,74,74,1,7,8,34.0,,796,40,179,219,598.0,82,5.28,57,380,2242,9.6
26641,Terry Carkner,2001-02,35.0,16,11,62,62,2,9,11,25.0,1130.0,858,42,188,230,623.0,82,5.27,57,359,2285,9.4
26642,Terry Hollinger,1996-97,25.0,4,0,2,2,0,0,0,0.0,,2,0,0,0,0.0,84,6.48,76,407,2545,10.7
26643,Terry Hollinger,1997-98,26.0,5,0,5,5,0,0,0,1.0,,7,0,0,0,1.0,48,5.97,37,209,1408,10.2
26644,Terry Johnson,1982-83,24.0,4,0,3,3,0,0,0,0.0,,3,0,0,0,0.0,80,7.03,61,280,2352,12.0
26645,Terry Johnson,1983-84,25.0,5,1,13,13,0,1,1,5.0,,16,0,1,1,5.0,80,7.69,77,340,2441,12.6
26646,Terry Johnson,1984-85,26.0,6,1,6,6,0,1,1,0.0,,22,0,2,2,5.0,80,8.03,73,320,2489,12.9
26647,Terry Johnson,1985-86,27.0,7,0,3,3,0,0,0,0.0,,25,0,2,2,5.0,80,7.73,71,310,2444,12.7
26648,Terry Johnson,1986-87,28.0,8,8,65,65,2,6,8,36.0,,90,2,8,10,41.0,80,7.89,74,336,2448,12.9
26649,Terry Johnson,1987-88,29.0,9,7,74,74,0,7,7,39.0,,164,2,15,17,80.0,80,7.77,71,321,2447,12.7
26650,Terry Johnson,1988-89,30.0,10,9,73,73,1,8,9,32.0,,237,3,23,26,112.0,80,7.94,82,370,2484,12.8
26651,Terry Johnson,1989-90,31.0,11,1,48,48,0,1,1,11.0,,285,3,24,27,123.0,80,7.34,72,344,2400,12.2
26652,Terry Ruskowski,1982-83,28.0,4,70,74,74,15,55,70,88.0,,74,15,55,70,88.0,80,7.03,61,280,2352,12.0
26653,Terry Ruskowski,1983-84,29.0,5,59,72,72,8,51,59,88.0,,146,23,106,129,176.0,80,7.69,77,340,2441,12.6
26654,Terry Ruskowski,1984-85,30.0,6,37,60,60,7,30,37,69.0,,206,30,136,166,245.0,80,8.03,73,320,2489,12.9
26655,Terry Ruskowski,1985-86,31.0,7,46,76,76,14,32,46,74.0,,282,44,168,212,319.0,80,7.73,71,310,2444,12.7
26656,Terry Ruskowski,1986-87,32.0,8,32,77,77,7,25,32,51.0,,359,51,193,244,370.0,80,7.89,74,336,2448,12.9
26657,Terry Ruskowski,1987-88,33.0,9,49,78,78,16,33,49,75.0,,437,67,226,293,445.0,80,7.77,71,321,2447,12.7
26658,Terry Ruskowski,1988-89,34.0,10,63,72,72,26,37,63,92.0,,509,93,263,356,537.0,80,7.94,82,370,2484,12.8
26659,Terry Ruskowski,1989-90,35.0,11,51,70,70,14,37,51,71.0,,579,107,300,407,608.0,80,7.34,72,344,2400,12.2
26660,Terry Ruskowski,1990-91,36.0,12,17,47,47,5,12,17,33.0,,626,112,312,424,641.0,80,7.43,89,437,2435,12.2
26661,Terry Ruskowski,1991-92,37.0,13,2,3,3,1,1,2,2.0,,629,113,313,426,643.0,80,7.48,85,403,2430,12.3
26662,Terry Ryan,1999-00,23.0,4,0,3,3,0,0,0,0.0,,3,0,0,0,0.0,82,5.83,55,336,2444,9.8
26663,Terry Ryan,2000-01,24.0,5,0,4,4,0,0,0,0.0,,7,0,0,0,0.0,82,5.28,57,380,2242,9.6
26664,Terry Ryan,2001-02,25.0,6,0,1,1,0,0,0,0.0,3.0,8,0,0,0,0.0,82,5.27,57,359,2285,9.4
26665,Terry Virtue,2001-02,31.0,4,0,4,4,0,0,0,2.0,39.0,4,0,0,0,2.0,82,5.27,57,359,2285,9.4
26666,Terry Virtue,2002-03,32.0,5,0,1,1,0,0,0,2.0,13.0,5,0,0,0,4.0,82,5.49,53,331,2294,9.8
26667,Terry Yake,1991-92,23.0,4,0,2,2,0,0,0,0.0,,2,0,0,0,0.0,80,7.48,85,403,2430,12.3
26668,Terry Yake,1992-93,24.0,5,1,2,2,0,1,1,2.0,,4,0,1,1,2.0,80,7.37,76,367,2421,12.2
26669,Terry Yake,1993-94,25.0,6,5,19,19,1,4,5,19.0,,23,1,5,6,21.0,80,6.91,71,366,2385,11.6
26670,Terry Yake,1994-95,26.0,7,2,15,15,1,1,2,12.0,,38,2,6,8,33.0,80,6.96,77,402,2440,11.4
26671,Terry Yake,1995-96,27.0,8,53,66,66,22,31,53,98.0,,104,24,37,61,131.0,84,7.25,87,443,2603,11.7
26672,Terry Yake,1996-97,28.0,9,52,82,82,21,31,52,188.0,,186,45,68,113,319.0,84,6.48,76,407,2545,10.7
26673,Terry Yake,1997-98,29.0,10,5,19,19,3,2,5,26.0,,205,48,70,118,345.0,48,5.97,37,209,1408,10.2
26674,Terry Yake,2000-01,32.0,11,25,65,65,10,15,25,60.0,,270,58,85,143,405.0,82,5.28,57,380,2242,9.6
26675,Terry Yake,2001-02,33.0,12,27,60,60,9,18,27,59.0,890.0,330,67,103,170,464.0,82,5.27,57,359,2285,9.4
26676,Terry Yake,2002-03,34.0,13,24,61,61,10,14,24,55.0,801.0,391,77,117,194,519.0,82,5.49,53,331,2294,9.8
26677,Terry Yake,2003-04,35.0,14,3,12,12,0,3,3,13.0,146.0,403,77,120,197,532.0,82,5.51,63,376,2272,9.9
26678,Teuvo Teravainen,2016-17,22.0,4,0,3,3,0,0,0,4.0,42.0,3,0,0,0,4.0,82,5.34,48,269,2463,8.9
26679,Teuvo Teravainen,2017-18,23.0,5,9,34,34,4,5,9,66.0,435.0,37,4,5,9,70.0,82,5.32,47,251,2453,8.9
26680,Teuvo Teravainen,2018-19,24.0,6,35,78,78,13,22,35,136.0,1197.0,115,17,27,44,206.0,82,5.34,48,255,2438,9.0
26681,Teuvo Teravainen,2019-20,25.0,7,42,81,81,15,27,42,169.0,1315.0,196,32,54,86,375.0,82,5.45,47,245,2478,9.0
26682,Teuvo Teravainen,2020-21,26.0,8,64,82,82,23,41,64,185.0,1385.0,278,55,95,150,560.0,82,5.86,50,250,2620,9.2
26683,Teuvo Teravainen,2021-22,27.0,9,76,82,82,21,55,76,167.0,1469.0,360,76,150,226,727.0,82,5.96,47,239,2579,9.5
26684,Teuvo Teravainen,2022-23,28.0,10,63,68,68,15,48,63,182.0,1305.0,428,91,198,289,909.0,70,5.96,42,208,2192,9.5
26685,Theo Peckham,2010-11,23.0,4,0,1,1,0,0,0,0.0,13.0,1,0,0,0,0.0,82,5.44,62,351,2383,9.4
26686,Theo Peckham,2011-12,24.0,5,0,15,15,0,0,0,8.0,174.0,16,0,0,0,8.0,82,5.7,65,341,2477,9.4
26687,Theo Peckham,2012-13,25.0,6,1,15,15,0,1,1,9.0,241.0,31,0,1,1,17.0,82,5.53,56,304,2486,9.1
26688,Theo Peckham,2013-14,26.0,7,13,71,71,3,10,13,41.0,1320.0,102,3,11,14,58.0,82,5.46,52,291,2492,9.0
26689,Theo Peckham,2014-15,27.0,8,3,54,54,1,2,3,25.0,911.0,156,4,13,17,83.0,82,5.32,47,271,2439,8.9
26690,Theo Peckham,2015-16,28.0,9,0,4,4,0,0,0,2.0,71.0,160,4,13,17,85.0,48,5.31,29,160,1399,9.1
26691,Theoren Fleury,1991-92,23.0,4,34,36,36,14,20,34,89.0,,36,14,20,34,89.0,80,7.48,85,403,2430,12.3
26692,Theoren Fleury,1992-93,24.0,5,66,80,80,31,35,66,200.0,,116,45,55,100,289.0,80,7.37,76,367,2421,12.2
26693,Theoren Fleury,1993-94,25.0,6,104,79,79,51,53,104,249.0,,195,96,108,204,538.0,80,6.91,71,366,2385,11.6
26694,Theoren Fleury,1994-95,26.0,7,73,80,80,33,40,73,225.0,,275,129,148,277,763.0,80,6.96,77,402,2440,11.4
26695,Theoren Fleury,1995-96,27.0,8,100,83,83,34,66,100,250.0,,358,163,214,377,1013.0,84,7.25,87,443,2603,11.7
26696,Theoren Fleury,1996-97,28.0,9,85,83,83,40,45,85,278.0,,441,203,259,462,1291.0,84,6.48,76,407,2545,10.7
26697,Theoren Fleury,1997-98,29.0,10,58,47,47,29,29,58,173.0,,488,232,288,520,1464.0,48,5.97,37,209,1408,10.2
26698,Theoren Fleury,1998-99,30.0,11,96,80,80,46,50,96,353.0,,568,278,338,616,1817.0,82,6.29,74,413,2481,10.4
26699,Theoren Fleury,1999-00,31.0,12,67,81,81,29,38,67,336.0,,649,307,376,683,2153.0,82,5.83,55,336,2444,9.8
26700,Theoren Fleury,2000-01,32.0,13,78,82,82,27,51,78,282.0,,731,334,427,761,2435.0,82,5.28,57,380,2242,9.6
26701,Theoren Fleury,2001-02,33.0,14,93,75,75,40,53,93,301.0,1751.0,806,374,480,854,2736.0,82,5.27,57,359,2285,9.4
26702,Theoren Fleury,2002-03,34.0,15,64,80,80,15,49,64,246.0,1575.0,886,389,529,918,2982.0,82,5.49,53,331,2294,9.8
26703,Theoren Fleury,2003-04,35.0,16,74,62,62,30,44,74,238.0,1351.0,948,419,573,992,3220.0,82,5.51,63,376,2272,9.9
26704,Theoren Fleury,2004-05,36.0,17,63,82,82,24,39,63,267.0,1706.0,1030,443,612,1055,3487.0,82,5.24,53,338,2262,9.5
26705,Theoren Fleury,2005-06,37.0,18,33,54,54,12,21,33,124.0,904.0,1084,455,633,1088,3611.0,82,5.31,60,363,2326,9.4
26706,Thomas Chabot,2019-20,23.0,4,0,1,1,0,0,0,1.0,7.0,1,0,0,0,1.0,82,5.45,47,245,2478,9.0
26707,Thomas Chabot,2020-21,24.0,5,25,63,63,9,16,25,94.0,1103.0,64,9,16,25,95.0,82,5.86,50,250,2620,9.2
26708,Thomas Chabot,2021-22,25.0,6,55,70,70,14,41,55,185.0,1700.0,134,23,57,80,280.0,82,5.96,47,239,2579,9.5
26709,Thomas Chabot,2022-23,26.0,7,39,71,71,6,33,39,186.0,1846.0,205,29,90,119,466.0,70,5.96,42,208,2192,9.5
26710,Thomas Di Pauli,2022-23,28.0,4,0,2,2,0,0,0,2.0,12.0,2,0,0,0,2.0,70,5.96,42,208,2192,9.5
26711,Thomas Eriksson,1983-84,24.0,4,11,24,24,1,10,11,49.0,,24,1,10,11,49.0,80,7.69,77,340,2441,12.6
26712,Thomas Eriksson,1984-85,25.0,5,0,1,1,0,0,0,0.0,,25,1,10,11,49.0,80,8.03,73,320,2489,12.9
26713,Thomas Eriksson,1986-87,27.0,6,44,68,68,11,33,44,108.0,,93,12,43,55,157.0,80,7.89,74,336,2448,12.9
26714,Thomas Eriksson,1987-88,28.0,7,39,72,72,10,29,39,127.0,,165,22,72,94,284.0,80,7.77,71,321,2447,12.7
26715,Thomas Eriksson,1988-89,29.0,8,4,43,43,0,4,4,33.0,,208,22,76,98,317.0,80,7.94,82,370,2484,12.8
26716,Thomas Hickey,2015-16,26.0,4,4,39,39,1,3,4,40.0,658.0,39,1,3,4,40.0,48,5.31,29,160,1399,9.1
26717,Thomas Hickey,2016-17,27.0,5,22,82,82,4,18,22,96.0,1547.0,121,5,21,26,136.0,82,5.34,48,269,2463,8.9
26718,Thomas Hickey,2017-18,28.0,6,22,81,81,2,20,22,82.0,1533.0,202,7,41,48,218.0,82,5.32,47,251,2453,8.9
26719,Thomas Hickey,2018-19,29.0,7,18,62,62,6,12,18,55.0,1079.0,264,13,53,66,273.0,82,5.34,48,255,2438,9.0
26720,Thomas Hickey,2019-20,30.0,8,20,76,76,4,16,20,87.0,1331.0,340,17,69,86,360.0,82,5.45,47,245,2478,9.0
26721,Thomas Hickey,2020-21,31.0,9,25,69,69,5,20,25,87.0,1247.0,409,22,89,111,447.0,82,5.86,50,250,2620,9.2
26722,Thomas Hickey,2021-22,32.0,10,4,40,40,0,4,4,47.0,740.0,449,22,93,115,494.0,82,5.96,47,239,2579,9.5
26723,Thomas Pock,2006-07,25.0,4,4,6,6,2,2,4,8.0,112.0,6,2,2,4,8.0,82,5.14,57,348,2300,9.2
26724,Thomas Pock,2008-09,27.0,5,2,8,8,1,1,2,15.0,121.0,14,3,3,6,23.0,82,6.05,85,480,2458,10.1
26725,Thomas Pock,2009-10,28.0,6,8,44,44,4,4,8,76.0,714.0,58,7,7,14,99.0,82,5.76,70,398,2426,9.7
26726,Thomas Pock,2010-11,29.0,7,0,1,1,0,0,0,2.0,19.0,59,7,7,14,101.0,82,5.44,62,351,2383,9.4
26727,Thomas Pock,2011-12,30.0,8,3,59,59,1,2,3,51.0,750.0,118,8,9,17,152.0,82,5.7,65,341,2477,9.4
26728,Thomas Rundqvist,1987-88,27.0,4,1,2,2,0,1,1,1.0,,2,0,1,1,1.0,80,7.77,71,321,2447,12.7
26729,Thomas Steen,1984-85,24.0,4,44,73,73,15,29,44,133.0,,73,15,29,44,133.0,80,8.03,73,320,2489,12.9
26730,Thomas Steen,1985-86,25.0,5,59,75,75,26,33,59,157.0,,148,41,62,103,290.0,80,7.73,71,310,2444,12.7
26731,Thomas Steen,1986-87,26.0,6,65,78,78,20,45,65,181.0,,226,61,107,168,471.0,80,7.89,74,336,2448,12.9
26732,Thomas Steen,1987-88,27.0,7,84,79,79,30,54,84,239.0,,305,91,161,252,710.0,80,7.77,71,321,2447,12.7
26733,Thomas Steen,1988-89,28.0,8,64,78,78,17,47,64,195.0,,383,108,208,316,905.0,80,7.94,82,370,2484,12.8
26734,Thomas Steen,1989-90,29.0,9,50,75,75,17,33,50,143.0,,458,125,241,366,1048.0,80,7.34,72,344,2400,12.2
26735,Thomas Steen,1990-91,30.0,10,54,76,76,16,38,54,167.0,,534,141,279,420,1215.0,80,7.43,89,437,2435,12.2
26736,Thomas Steen,1991-92,31.0,11,88,80,80,27,61,88,173.0,,614,168,340,508,1388.0,80,7.48,85,403,2430,12.3
26737,Thomas Steen,1992-93,32.0,12,66,53,53,18,48,66,129.0,,667,186,388,574,1517.0,80,7.37,76,367,2421,12.2
26738,Thomas Steen,1993-94,33.0,13,67,58,58,19,48,67,125.0,,725,205,436,641,1642.0,80,6.91,71,366,2385,11.6
26739,Thomas Steen,1994-95,34.0,14,38,38,38,13,25,38,75.0,,763,218,461,679,1717.0,80,6.96,77,402,2440,11.4
26740,Thomas Steen,1995-96,35.0,15,72,80,80,22,50,72,150.0,,843,240,511,751,1867.0,84,7.25,87,443,2603,11.7
26741,Thomas Steen,1996-97,36.0,16,51,76,76,19,32,51,137.0,,919,259,543,802,2004.0,84,6.48,76,407,2545,10.7
26742,Thomas Steen,1997-98,37.0,17,15,31,31,5,10,15,32.0,,950,264,553,817,2036.0,48,5.97,37,209,1408,10.2
26743,Thomas Vanek,2008-09,25.0,4,48,81,81,25,23,48,204.0,1193.0,81,25,23,48,204.0,82,6.05,85,480,2458,10.1
26744,Thomas Vanek,2009-10,26.0,5,84,82,82,43,41,84,237.0,1376.0,163,68,64,132,441.0,82,5.76,70,398,2426,9.7
26745,Thomas Vanek,2010-11,27.0,6,64,82,82,36,28,64,240.0,1382.0,245,104,92,196,681.0,82,5.44,62,351,2383,9.4
26746,Thomas Vanek,2011-12,28.0,7,64,73,73,40,24,64,211.0,1255.0,318,144,116,260,892.0,82,5.7,65,341,2477,9.4
26747,Thomas Vanek,2012-13,29.0,8,53,71,71,28,25,53,182.0,1190.0,389,172,141,313,1074.0,82,5.53,56,304,2486,9.1
26748,Thomas Vanek,2013-14,30.0,9,73,80,80,32,41,73,238.0,1388.0,469,204,182,386,1312.0,82,5.46,52,291,2492,9.0
26749,Thomas Vanek,2014-15,31.0,10,61,78,78,26,35,61,204.0,1321.0,547,230,217,447,1516.0,82,5.32,47,271,2439,8.9
26750,Thomas Vanek,2015-16,32.0,11,41,38,38,20,21,41,119.0,699.0,585,250,238,488,1635.0,48,5.31,29,160,1399,9.1
26751,Thomas Vanek,2016-17,33.0,12,68,78,78,27,41,68,248.0,1509.0,663,277,279,556,1883.0,82,5.34,48,269,2463,8.9
26752,Thomas Vanek,2017-18,34.0,13,52,80,80,21,31,52,171.0,1297.0,743,298,310,608,2054.0,82,5.32,47,251,2453,8.9
26753,Thomas Vanek,2018-19,35.0,14,41,74,74,18,23,41,146.0,1155.0,817,316,333,649,2200.0,82,5.34,48,255,2438,9.0
26754,Thomas Vanek,2019-20,36.0,15,48,68,68,17,31,48,133.0,979.0,885,333,364,697,2333.0,82,5.45,47,245,2478,9.0
26755,Thomas Vanek,2020-21,37.0,16,56,80,80,24,32,56,168.0,1127.0,965,357,396,753,2501.0,82,5.86,50,250,2620,9.2
26756,Thomas Vanek,2021-22,38.0,17,36,64,64,16,20,36,108.0,903.0,1029,373,416,789,2609.0,82,5.96,47,239,2579,9.5
26757,Thomas Ziegler,2003-04,25.0,4,0,5,5,0,0,0,2.0,25.0,5,0,0,0,2.0,82,5.51,63,376,2272,9.9
26758,Thommy Abrahamsson,1983-84,36.0,4,17,32,32,6,11,17,66.0,,32,6,11,17,66.0,80,7.69,77,340,2441,12.6
26759,Tie Domi,1992-93,23.0,4,0,2,2,0,0,0,0.0,,2,0,0,0,0.0,80,7.37,76,367,2421,12.2
26760,Tie Domi,1993-94,24.0,5,1,28,28,1,0,1,5.0,,30,1,0,1,5.0,80,6.91,71,366,2385,11.6
26761,Tie Domi,1994-95,25.0,6,6,42,42,2,4,6,20.0,,72,3,4,7,25.0,80,6.96,77,402,2440,11.4
26762,Tie Domi,1995-96,26.0,7,15,61,61,5,10,15,40.0,,133,8,14,22,65.0,84,7.25,87,443,2603,11.7
26763,Tie Domi,1996-97,27.0,8,19,81,81,8,11,19,98.0,,214,16,25,41,163.0,84,6.48,76,407,2545,10.7
26764,Tie Domi,1997-98,28.0,9,9,40,40,4,5,9,46.0,,254,20,30,50,209.0,48,5.97,37,209,1408,10.2
26765,Tie Domi,1998-99,29.0,10,13,72,72,7,6,13,61.0,,326,27,36,63,270.0,82,6.29,74,413,2481,10.4
26766,Tie Domi,1999-00,30.0,11,28,80,80,11,17,28,98.0,,406,38,53,91,368.0,82,5.83,55,336,2444,9.8
26767,Tie Domi,2000-01,31.0,12,14,80,80,4,10,14,72.0,,486,42,63,105,440.0,82,5.28,57,380,2242,9.6
26768,Tie Domi,2001-02,32.0,13,22,72,72,8,14,22,65.0,698.0,558,50,77,127,505.0,82,5.27,57,359,2285,9.4
26769,Tie Domi,2002-03,33.0,14,14,70,70,5,9,14,64.0,698.0,628,55,86,141,569.0,82,5.49,53,331,2294,9.8
26770,Tie Domi,2003-04,34.0,15,20,82,82,13,7,20,60.0,687.0,710,68,93,161,629.0,82,5.51,63,376,2272,9.9
26771,Tie Domi,2004-05,35.0,16,19,74,74,9,10,19,93.0,764.0,784,77,103,180,722.0,82,5.24,53,338,2262,9.5
26772,Tie Domi,2005-06,36.0,17,29,79,79,15,14,29,91.0,864.0,863,92,117,209,813.0,82,5.31,60,363,2326,9.4
26773,Tie Domi,2006-07,37.0,18,20,80,80,7,13,20,84.0,896.0,943,99,130,229,897.0,82,5.14,57,348,2300,9.2
26774,Tie Domi,2008-09,39.0,19,16,77,77,5,11,16,67.0,749.0,1020,104,141,245,964.0,82,6.05,85,480,2458,10.1
26775,Tim Armstrong,1991-92,24.0,4,1,11,11,1,0,1,5.0,,11,1,0,1,5.0,80,7.48,85,403,2430,12.3
26776,Tim Bergland,1992-93,28.0,4,7,32,32,2,5,7,20.0,,32,2,5,7,20.0,80,7.37,76,367,2421,12.2
26777,Tim Bergland,1993-94,29.0,5,14,47,47,5,9,14,41.0,,79,7,14,21,61.0,80,6.91,71,366,2385,11.6
26778,Tim Bergland,1994-95,30.0,6,5,22,22,1,4,5,18.0,,101,8,18,26,79.0,80,6.96,77,402,2440,11.4
26779,Tim Bergland,1995-96,31.0,7,6,27,27,3,3,6,44.0,,128,11,21,32,123.0,84,7.25,87,443,2603,11.7
26780,Tim Bergland,1996-97,32.0,8,11,54,54,6,5,11,65.0,,182,17,26,43,188.0,84,6.48,76,407,2545,10.7
26781,Tim Brent,2009-10,25.0,4,1,15,15,1,0,1,14.0,104.0,15,1,0,1,14.0,82,5.76,70,398,2426,9.7
26782,Tim Brent,2010-11,26.0,5,0,1,1,0,0,0,0.0,5.0,16,1,0,1,14.0,82,5.44,62,351,2383,9.4
26783,Tim Brent,2011-12,27.0,6,0,2,2,0,0,0,0.0,17.0,18,1,0,1,14.0,82,5.7,65,341,2477,9.4
26784,Tim Brent,2012-13,28.0,7,0,1,1,0,0,0,3.0,13.0,19,1,0,1,17.0,82,5.53,56,304,2486,9.1
26785,Tim Brent,2013-14,29.0,8,20,79,79,8,12,20,60.0,920.0,98,9,12,21,77.0,82,5.46,52,291,2492,9.0
26786,Tim Brent,2014-15,30.0,9,24,79,79,12,12,24,71.0,860.0,177,21,24,45,148.0,82,5.32,47,271,2439,8.9
26787,Tim Brent,2015-16,31.0,10,3,30,30,0,3,3,23.0,294.0,207,21,27,48,171.0,48,5.31,29,160,1399,9.1
26788,Tim Conboy,2010-11,28.0,4,5,19,19,0,5,5,16.0,132.0,19,0,5,5,16.0,82,5.44,62,351,2383,9.4
26789,Tim Conboy,2011-12,29.0,5,1,28,28,0,1,1,13.0,150.0,47,0,6,6,29.0,82,5.7,65,341,2477,9.4
26790,Tim Conboy,2012-13,30.0,6,0,12,12,0,0,0,5.0,52.0,59,0,6,6,34.0,82,5.53,56,304,2486,9.1
26791,Tim Connolly,2002-03,21.0,4,34,81,81,14,20,34,114.0,1321.0,81,14,20,34,114.0,82,5.49,53,331,2294,9.8
26792,Tim Connolly,2003-04,22.0,5,41,82,82,10,31,41,171.0,1642.0,163,24,51,75,285.0,82,5.51,63,376,2272,9.9
26793,Tim Connolly,2004-05,23.0,6,45,82,82,10,35,45,126.0,1391.0,245,34,86,120,411.0,82,5.24,53,338,2262,9.5
26794,Tim Connolly,2005-06,24.0,7,25,80,80,12,13,25,159.0,1279.0,325,46,99,145,570.0,82,5.31,60,363,2326,9.4
26795,Tim Connolly,2008-09,27.0,8,55,63,63,16,39,55,99.0,1134.0,388,62,138,200,669.0,82,6.05,85,480,2458,10.1
26796,Tim Connolly,2009-10,28.0,9,1,2,2,1,0,1,2.0,26.0,390,63,138,201,671.0,82,5.76,70,398,2426,9.7
26797,Tim Connolly,2010-11,29.0,10,40,48,48,7,33,40,111.0,896.0,438,70,171,241,782.0,82,5.44,62,351,2383,9.4
26798,Tim Connolly,2011-12,30.0,11,47,48,48,18,29,47,126.0,918.0,486,88,200,288,908.0,82,5.7,65,341,2477,9.4
26799,Tim Connolly,2012-13,31.0,12,65,73,73,17,48,65,206.0,1359.0,559,105,248,353,1114.0,82,5.53,56,304,2486,9.1
26800,Tim Connolly,2013-14,32.0,13,42,68,68,13,29,42,151.0,1150.0,627,118,277,395,1265.0,82,5.46,52,291,2492,9.0
26801,Tim Connolly,2014-15,33.0,14,36,70,70,13,23,36,104.0,1190.0,697,131,300,431,1369.0,82,5.32,47,271,2439,8.9
26802,Tim Coulis,1982-83,24.0,4,3,19,19,1,2,3,13.0,,19,1,2,3,13.0,80,7.03,61,280,2352,12.0
26803,Tim Coulis,1986-87,28.0,5,0,2,2,0,0,0,0.0,,21,1,2,3,13.0,80,7.89,74,336,2448,12.9
26804,Tim Coulis,1987-88,29.0,6,2,7,7,1,1,2,10.0,,28,2,3,5,23.0,80,7.77,71,321,2447,12.7
26805,Tim Coulis,1988-89,30.0,7,4,19,19,2,2,4,13.0,,47,4,5,9,36.0,80,7.94,82,370,2484,12.8
26806,Tim Erixon,2014-15,23.0,4,2,18,18,0,2,2,9.0,234.0,18,0,2,2,9.0,82,5.32,47,271,2439,8.9
26807,Tim Erixon,2015-16,24.0,5,5,31,31,0,5,5,21.0,487.0,49,0,7,7,30.0,48,5.31,29,160,1399,9.1
26808,Tim Erixon,2016-17,25.0,6,0,2,2,0,0,0,1.0,29.0,51,0,7,7,31.0,82,5.34,48,269,2463,8.9
26809,Tim Erixon,2017-18,26.0,7,7,42,42,2,5,7,36.0,639.0,93,2,12,14,67.0,82,5.32,47,251,2453,8.9
26810,Tim Friday,1988-89,27.0,4,3,23,23,0,3,3,13.0,,23,0,3,3,13.0,80,7.94,82,370,2484,12.8
26811,Tim Gleason,2006-07,24.0,4,7,47,47,0,7,7,45.0,704.0,47,0,7,7,45.0,82,5.14,57,348,2300,9.2
26812,Tim Gleason,2008-09,26.0,5,21,78,78,2,19,21,72.0,1380.0,125,2,26,28,117.0,82,6.05,85,480,2458,10.1
26813,Tim Gleason,2009-10,27.0,6,6,57,57,2,4,6,72.0,1076.0,182,4,30,34,189.0,82,5.76,70,398,2426,9.7
26814,Tim Gleason,2010-11,28.0,7,19,80,80,3,16,19,98.0,1491.0,262,7,46,53,287.0,82,5.44,62,351,2383,9.4
26815,Tim Gleason,2011-12,29.0,8,12,70,70,0,12,12,61.0,1447.0,332,7,58,65,348.0,82,5.7,65,341,2477,9.4
26816,Tim Gleason,2012-13,30.0,9,19,61,61,5,14,19,76.0,1293.0,393,12,72,84,424.0,82,5.53,56,304,2486,9.1
26817,Tim Gleason,2013-14,31.0,10,16,82,82,2,14,16,84.0,1719.0,475,14,86,100,508.0,82,5.46,52,291,2492,9.0
26818,Tim Gleason,2014-15,32.0,11,18,82,82,1,17,18,65.0,1698.0,557,15,103,118,573.0,82,5.32,47,271,2439,8.9
26819,Tim Gleason,2015-16,33.0,12,9,42,42,0,9,9,36.0,822.0,599,15,112,127,609.0,48,5.31,29,160,1399,9.1
26820,Tim Gleason,2016-17,34.0,13,6,56,56,1,5,6,43.0,931.0,655,16,117,133,652.0,82,5.34,48,269,2463,8.9
26821,Tim Gleason,2017-18,35.0,14,9,72,72,1,8,9,54.0,1176.0,727,17,125,142,706.0,82,5.32,47,251,2453,8.9
26822,Tim Harrer,1985-86,28.0,4,0,3,3,0,0,0,3.0,,3,0,0,0,3.0,80,7.73,71,310,2444,12.7
26823,Tim Heed,2019-20,29.0,4,0,1,1,0,0,0,1.0,16.0,1,0,0,0,1.0,82,5.45,47,245,2478,9.0
26824,Tim Heed,2020-21,30.0,5,11,29,29,3,8,11,51.0,465.0,30,3,8,11,52.0,82,5.86,50,250,2620,9.2
26825,Tim Heed,2021-22,31.0,6,13,37,37,2,11,13,41.0,532.0,67,5,19,24,93.0,82,5.96,47,239,2579,9.5
26826,Tim Heed,2022-23,32.0,7,5,38,38,1,4,5,44.0,494.0,105,6,23,29,137.0,70,5.96,42,208,2192,9.5
26827,Tim Hrynewich,1985-86,22.0,4,5,30,30,2,3,5,22.0,,30,2,3,5,22.0,80,7.73,71,310,2444,12.7
26828,Tim Hrynewich,1986-87,23.0,5,9,25,25,4,5,9,24.0,,55,6,8,14,46.0,80,7.89,74,336,2448,12.9
26829,Tim Hunter,1984-85,24.0,4,0,2,2,0,0,0,0.0,,2,0,0,0,0.0,80,8.03,73,320,2489,12.9
26830,Tim Hunter,1985-86,25.0,5,1,16,16,1,0,1,7.0,,18,1,0,1,7.0,80,7.73,71,310,2444,12.7
26831,Tim Hunter,1986-87,26.0,6,8,43,43,4,4,8,22.0,,61,5,4,9,29.0,80,7.89,74,336,2448,12.9
26832,Tim Hunter,1987-88,27.0,7,22,71,71,11,11,22,68.0,,132,16,15,31,97.0,80,7.77,71,321,2447,12.7
26833,Tim Hunter,1988-89,28.0,8,15,66,66,8,7,15,65.0,,198,24,22,46,162.0,80,7.94,82,370,2484,12.8
26834,Tim Hunter,1989-90,29.0,9,21,73,73,6,15,21,65.0,,271,30,37,67,227.0,80,7.34,72,344,2400,12.2
26835,Tim Hunter,1990-91,30.0,10,13,68,68,8,5,13,60.0,,339,38,42,80,287.0,80,7.43,89,437,2435,12.2
26836,Tim Hunter,1991-92,31.0,11,12,75,75,3,9,12,67.0,,414,41,51,92,354.0,80,7.48,85,403,2430,12.3
26837,Tim Hunter,1992-93,32.0,12,5,67,67,2,3,5,69.0,,481,43,54,97,423.0,80,7.37,76,367,2421,12.2
26838,Tim Hunter,1993-94,33.0,13,7,34,34,5,2,7,29.0,,515,48,56,104,452.0,80,6.91,71,366,2385,11.6
26839,Tim Hunter,1994-95,34.0,14,4,30,30,1,3,4,19.0,,545,49,59,108,471.0,80,6.96,77,402,2440,11.4
26840,Tim Hunter,1995-96,35.0,15,12,74,74,5,7,12,40.0,,619,54,66,120,511.0,84,7.25,87,443,2603,11.7
26841,Tim Hunter,1996-97,36.0,16,7,56,56,3,4,7,41.0,,675,57,70,127,552.0,84,6.48,76,407,2545,10.7
26842,Tim Hunter,1997-98,37.0,17,5,34,34,3,2,5,17.0,,709,60,72,132,569.0,48,5.97,37,209,1408,10.2
26843,Tim Hunter,1998-99,38.0,18,2,60,60,2,0,2,26.0,,769,62,72,134,595.0,82,6.29,74,413,2481,10.4
26844,Tim Hunter,1999-00,39.0,19,4,46,46,0,4,4,13.0,,815,62,76,138,608.0,82,5.83,55,336,2444,9.8
26845,Tim Jackman,2006-07,25.0,4,3,19,19,1,2,3,18.0,189.0,19,1,2,3,18.0,82,5.14,57,348,2300,9.2
26846,Tim Jackman,2008-09,27.0,5,0,8,8,0,0,0,4.0,58.0,27,1,2,3,22.0,82,6.05,85,480,2458,10.1
26847,Tim Jackman,2009-10,28.0,6,0,5,5,0,0,0,3.0,33.0,32,1,2,3,25.0,82,5.76,70,398,2426,9.7
26848,Tim Jackman,2010-11,29.0,7,4,36,36,1,3,4,36.0,238.0,68,2,5,7,61.0,82,5.44,62,351,2383,9.4
26849,Tim Jackman,2011-12,30.0,8,12,69,69,5,7,12,99.0,811.0,137,7,12,19,160.0,82,5.7,65,341,2477,9.4
26850,Tim Jackman,2012-13,31.0,9,9,54,54,4,5,9,51.0,521.0,191,11,17,28,211.0,82,5.53,56,304,2486,9.1
26851,Tim Jackman,2013-14,32.0,10,23,82,82,10,13,23,131.0,806.0,273,21,30,51,342.0,82,5.46,52,291,2492,9.0
26852,Tim Jackman,2014-15,33.0,11,7,75,75,1,6,7,103.0,684.0,348,22,36,58,445.0,82,5.32,47,271,2439,8.9
26853,Tim Jackman,2015-16,34.0,12,5,42,42,1,4,5,42.0,319.0,390,23,40,63,487.0,48,5.31,29,160,1399,9.1
26854,Tim Jackman,2016-17,35.0,13,5,36,36,4,1,5,46.0,256.0,426,27,41,68,533.0,82,5.34,48,269,2463,8.9
26855,Tim Jackman,2017-18,36.0,14,7,55,55,5,2,7,55.0,461.0,481,32,43,75,588.0,82,5.32,47,251,2453,8.9
26856,Tim Jackman,2018-19,37.0,15,0,2,2,0,0,0,1.0,11.0,483,32,43,75,589.0,82,5.34,48,255,2438,9.0
26857,Tim Kennedy,2011-12,25.0,4,0,1,1,0,0,0,1.0,11.0,1,0,0,0,1.0,82,5.7,65,341,2477,9.4
26858,Tim Kennedy,2012-13,26.0,5,26,78,78,10,16,26,98.0,1010.0,79,10,16,26,99.0,82,5.53,56,304,2486,9.1
26859,Tim Kennedy,2013-14,27.0,6,1,6,6,0,1,1,2.0,62.0,85,10,17,27,101.0,82,5.46,52,291,2492,9.0
26860,Tim Kennedy,2014-15,28.0,7,2,27,27,1,1,2,22.0,301.0,112,11,18,29,123.0,82,5.32,47,271,2439,8.9
26861,Tim Kennedy,2015-16,29.0,8,2,13,13,2,0,2,24.0,177.0,125,13,18,31,147.0,48,5.31,29,160,1399,9.1
26862,Tim Kennedy,2016-17,30.0,9,8,37,37,2,6,8,42.0,435.0,162,15,24,39,189.0,82,5.34,48,269,2463,8.9
26863,Tim Kerr,1983-84,24.0,4,45,68,68,22,23,45,95.0,,68,22,23,45,95.0,80,7.69,77,340,2441,12.6
26864,Tim Kerr,1984-85,25.0,5,51,61,61,21,30,51,118.0,,129,43,53,96,213.0,80,8.03,73,320,2489,12.9
26865,Tim Kerr,1985-86,26.0,6,19,24,24,11,8,19,50.0,,153,54,61,115,263.0,80,7.73,71,310,2444,12.7
26866,Tim Kerr,1986-87,27.0,7,93,79,79,54,39,93,288.0,,232,108,100,208,551.0,80,7.89,74,336,2448,12.9
26867,Tim Kerr,1987-88,28.0,8,98,74,74,54,44,98,278.0,,306,162,144,306,829.0,80,7.77,71,321,2447,12.7
26868,Tim Kerr,1988-89,29.0,9,84,76,76,58,26,84,285.0,,382,220,170,390,1114.0,80,7.94,82,370,2484,12.8
26869,Tim Kerr,1989-90,30.0,10,95,75,75,58,37,95,261.0,,457,278,207,485,1375.0,80,7.34,72,344,2400,12.2
26870,Tim Kerr,1990-91,31.0,11,5,8,8,3,2,5,34.0,,465,281,209,490,1409.0,80,7.43,89,437,2435,12.2
26871,Tim Kerr,1991-92,32.0,12,88,69,69,48,40,88,236.0,,534,329,249,578,1645.0,80,7.48,85,403,2430,12.3
26872,Tim Kerr,1992-93,33.0,13,48,40,40,24,24,48,162.0,,574,353,273,626,1807.0,80,7.37,76,367,2421,12.2
26873,Tim Kerr,1993-94,34.0,14,24,27,27,10,14,24,74.0,,601,363,287,650,1881.0,80,6.91,71,366,2385,11.6
26874,Tim Kerr,1994-95,35.0,15,18,32,32,7,11,18,56.0,,633,370,298,668,1937.0,80,6.96,77,402,2440,11.4
26875,Tim Kerr,1995-96,36.0,16,6,22,22,0,6,6,48.0,,655,370,304,674,1985.0,84,7.25,87,443,2603,11.7
26876,Tim Lenardon,1989-90,27.0,4,2,7,7,1,1,2,13.0,,7,1,1,2,13.0,80,7.34,72,344,2400,12.2
26877,Tim Lenardon,1992-93,30.0,5,1,8,8,1,0,1,9.0,,15,2,1,3,22.0,80,7.37,76,367,2421,12.2
26878,Tim Ramholt,2010-11,26.0,4,0,1,1,0,0,0,0.0,1.0,1,0,0,0,0.0,82,5.44,62,351,2383,9.4
26879,Tim Schaller,2017-18,27.0,4,2,18,18,1,1,2,19.0,204.0,18,1,1,2,19.0,82,5.32,47,251,2453,8.9
26880,Tim Schaller,2018-19,28.0,5,3,17,17,1,2,3,18.0,142.0,35,2,3,5,37.0,82,5.34,48,255,2438,9.0
26881,Tim Schaller,2019-20,29.0,6,14,59,59,7,7,14,89.0,724.0,94,9,10,19,126.0,82,5.45,47,245,2478,9.0
26882,Tim Schaller,2020-21,30.0,7,22,82,82,12,10,22,133.0,1089.0,176,21,20,41,259.0,82,5.86,50,250,2620,9.2
26883,Tim Schaller,2021-22,31.0,8,10,47,47,3,7,10,44.0,501.0,223,24,27,51,303.0,82,5.96,47,239,2579,9.5
26884,Tim Schaller,2022-23,32.0,9,6,53,53,5,1,6,49.0,613.0,276,29,28,57,352.0,70,5.96,42,208,2192,9.5
26885,Tim Sestito,2011-12,27.0,4,0,1,1,0,0,0,1.0,6.0,1,0,0,0,1.0,82,5.7,65,341,2477,9.4
26886,Tim Sestito,2012-13,28.0,5,1,9,9,0,1,1,7.0,110.0,10,0,1,1,8.0,82,5.53,56,304,2486,9.1
26887,Tim Sestito,2013-14,29.0,6,2,36,36,0,2,2,22.0,390.0,46,0,3,3,30.0,82,5.46,52,291,2492,9.0
26888,Tim Sestito,2014-15,30.0,7,0,18,18,0,0,0,6.0,149.0,64,0,3,3,36.0,82,5.32,47,271,2439,8.9
26889,Tim Sestito,2015-16,31.0,8,0,6,6,0,0,0,4.0,47.0,70,0,3,3,40.0,48,5.31,29,160,1399,9.1
26890,Tim Sestito,2016-17,32.0,9,3,16,16,0,3,3,13.0,146.0,86,0,6,6,53.0,82,5.34,48,269,2463,8.9
26891,Tim Sestito,2017-18,33.0,10,2,15,15,0,2,2,10.0,148.0,101,0,8,8,63.0,82,5.32,47,251,2453,8.9
26892,Tim Stapleton,2011-12,29.0,4,1,4,4,1,0,1,9.0,60.0,4,1,0,1,9.0,82,5.7,65,341,2477,9.4
26893,Tim Stapleton,2012-13,30.0,5,2,6,6,2,0,2,6.0,71.0,10,3,0,3,15.0,82,5.53,56,304,2486,9.1
26894,Tim Stapleton,2013-14,31.0,6,7,45,45,5,2,7,44.0,500.0,55,8,2,10,59.0,82,5.46,52,291,2492,9.0
26895,Tim Stapleton,2014-15,32.0,7,27,63,63,11,16,27,74.0,639.0,118,19,18,37,133.0,82,5.32,47,271,2439,8.9
26896,Tim Sweeney,1993-94,26.0,4,16,42,42,7,9,16,40.0,,42,7,9,16,40.0,80,6.91,71,366,2385,11.6
26897,Tim Sweeney,1994-95,27.0,5,3,11,11,1,2,3,16.0,,53,8,11,19,56.0,80,6.96,77,402,2440,11.4
26898,Tim Sweeney,1995-96,28.0,6,8,14,14,1,7,8,15.0,,67,9,18,27,71.0,84,7.25,87,443,2603,11.7
26899,Tim Sweeney,1996-97,29.0,7,43,78,78,16,27,43,114.0,,145,25,45,70,185.0,84,6.48,76,407,2545,10.7
26900,Tim Sweeney,1997-98,30.0,8,2,13,13,1,1,2,11.0,,158,26,46,72,196.0,48,5.97,37,209,1408,10.2
26901,Tim Sweeney,1998-99,31.0,9,16,41,41,8,8,16,47.0,,199,34,54,88,243.0,82,6.29,74,413,2481,10.4
26902,Tim Sweeney,1999-00,32.0,10,21,36,36,10,11,21,65.0,,235,44,65,109,308.0,82,5.83,55,336,2444,9.8
26903,Tim Sweeney,2000-01,33.0,11,29,56,56,11,18,29,75.0,,291,55,83,138,383.0,82,5.28,57,380,2242,9.6
26904,Tim Taylor,1996-97,27.0,4,1,1,1,1,0,1,4.0,,1,1,0,1,4.0,84,6.48,76,407,2545,10.7
26905,Tim Taylor,1997-98,28.0,5,4,22,22,0,4,4,21.0,,23,1,4,5,25.0,48,5.97,37,209,1408,10.2
26906,Tim Taylor,1998-99,29.0,6,25,72,72,11,14,25,81.0,,95,12,18,30,106.0,82,6.29,74,413,2481,10.4
26907,Tim Taylor,1999-00,30.0,7,7,44,44,3,4,7,44.0,,139,15,22,37,150.0,82,5.83,55,336,2444,9.8
26908,Tim Taylor,2000-01,31.0,8,31,79,79,20,11,31,127.0,,218,35,33,68,277.0,82,5.28,57,380,2242,9.6
26909,Tim Taylor,2001-02,32.0,9,11,49,49,4,7,11,76.0,781.0,267,39,40,79,353.0,82,5.27,57,359,2285,9.4
26910,Tim Taylor,2002-03,33.0,10,20,76,76,9,11,20,79.0,1075.0,343,48,51,99,432.0,82,5.49,53,331,2294,9.8
26911,Tim Taylor,2003-04,34.0,11,7,38,38,2,5,7,34.0,340.0,381,50,56,106,466.0,82,5.51,63,376,2272,9.9
26912,Tim Taylor,2004-05,35.0,12,8,48,48,4,4,8,50.0,647.0,429,54,60,114,516.0,82,5.24,53,338,2262,9.5
26913,Tim Taylor,2005-06,36.0,13,12,82,82,4,8,12,95.0,1124.0,511,58,68,126,611.0,82,5.31,60,363,2326,9.4
26914,Tim Taylor,2006-07,37.0,14,22,82,82,7,15,22,95.0,1057.0,593,65,83,148,706.0,82,5.14,57,348,2300,9.2
26915,Tim Taylor,2008-09,39.0,15,13,82,82,7,6,13,109.0,1021.0,675,72,89,161,815.0,82,6.05,85,480,2458,10.1
26916,Tim Taylor,2009-10,40.0,16,6,71,71,1,5,6,59.0,562.0,746,73,94,167,874.0,82,5.76,70,398,2426,9.7
26917,Tim Tookey,1983-84,23.0,4,23,29,29,10,13,23,33.0,,29,10,13,23,33.0,80,7.69,77,340,2441,12.6
26918,Tim Tookey,1984-85,24.0,5,16,28,28,8,8,16,52.0,,57,18,21,39,85.0,80,8.03,73,320,2489,12.9
26919,Tim Tookey,1985-86,25.0,6,7,12,12,1,6,7,8.0,,69,19,27,46,93.0,80,7.73,71,310,2444,12.7
26920,Tim Tookey,1986-87,26.0,7,2,8,8,0,2,2,7.0,,77,19,29,48,100.0,80,7.89,74,336,2448,12.9
26921,Tim Tookey,1989-90,29.0,8,0,2,2,0,0,0,1.0,,79,19,29,48,101.0,80,7.34,72,344,2400,12.2
26922,Tim Tookey,1990-91,30.0,9,7,20,20,1,6,7,28.0,,99,20,35,55,129.0,80,7.43,89,437,2435,12.2
26923,Tim Tookey,1991-92,31.0,10,3,7,7,2,1,3,8.0,,106,22,36,58,137.0,80,7.48,85,403,2430,12.3
26924,Tim Trimper,1982-83,23.0,4,16,30,30,6,10,16,65.0,,30,6,10,16,65.0,80,7.03,61,280,2352,12.0
26925,Tim Trimper,1983-84,24.0,5,29,56,56,15,14,29,95.0,,86,21,24,45,160.0,80,7.69,77,340,2441,12.6
26926,Tim Trimper,1984-85,25.0,6,16,74,74,8,8,16,68.0,,160,29,32,61,228.0,80,8.03,73,320,2489,12.9
26927,Tim Trimper,1985-86,26.0,7,0,5,5,0,0,0,2.0,,165,29,32,61,230.0,80,7.73,71,310,2444,12.7
26928,Tim Trimper,1986-87,27.0,8,0,5,5,0,0,0,1.0,,170,29,32,61,231.0,80,7.89,74,336,2448,12.9
26929,Tim Trimper,1987-88,28.0,9,5,20,20,1,4,5,28.0,,190,30,36,66,259.0,80,7.77,71,321,2447,12.7
26930,Tim Wallace,2011-12,27.0,4,2,16,16,0,2,2,17.0,130.0,16,0,2,2,17.0,82,5.7,65,341,2477,9.4
26931,Tim Wallace,2012-13,28.0,5,0,1,1,0,0,0,0.0,6.0,17,0,2,2,17.0,82,5.53,56,304,2486,9.1
26932,Tim Wallace,2013-14,29.0,6,0,7,7,0,0,0,1.0,56.0,24,0,2,2,18.0,82,5.46,52,291,2492,9.0
26933,Tim Wallace,2014-15,30.0,7,9,49,49,3,6,9,26.0,421.0,73,3,8,11,44.0,82,5.32,47,271,2439,8.9
26934,Tim Wallace,2015-16,31.0,8,2,28,28,1,1,2,20.0,281.0,101,4,9,13,64.0,48,5.31,29,160,1399,9.1
26935,Tim Watters,1984-85,25.0,4,24,69,69,2,22,24,66.0,,69,2,22,24,66.0,80,8.03,73,320,2489,12.9
26936,Tim Watters,1985-86,26.0,5,23,77,77,5,18,23,57.0,,146,7,40,47,123.0,80,7.73,71,310,2444,12.7
26937,Tim Watters,1986-87,27.0,6,23,74,74,3,20,23,65.0,,220,10,60,70,188.0,80,7.89,74,336,2448,12.9
26938,Tim Watters,1987-88,28.0,7,22,63,63,2,20,22,53.0,,283,12,80,92,241.0,80,7.77,71,321,2447,12.7
26939,Tim Watters,1988-89,29.0,8,14,56,56,6,8,14,37.0,,339,18,88,106,278.0,80,7.94,82,370,2484,12.8
26940,Tim Watters,1989-90,30.0,9,16,63,63,3,13,16,44.0,,402,21,101,122,322.0,80,7.34,72,344,2400,12.2
26941,Tim Watters,1990-91,31.0,10,0,36,36,0,0,0,21.0,,438,21,101,122,343.0,80,7.43,89,437,2435,12.2
26942,Tim Watters,1991-92,32.0,11,21,76,76,3,18,21,62.0,,514,24,119,143,405.0,80,7.48,85,403,2430,12.3
26943,Tim Watters,1992-93,33.0,12,11,62,62,1,10,11,50.0,,576,25,129,154,455.0,80,7.37,76,367,2421,12.2
26944,Tim Watters,1993-94,34.0,13,4,45,45,0,4,4,29.0,,621,25,133,158,484.0,80,6.91,71,366,2385,11.6
26945,Tim Watters,1994-95,35.0,14,7,37,37,0,7,7,29.0,,658,25,140,165,513.0,80,6.96,77,402,2440,11.4
26946,Tim Watters,1995-96,36.0,15,2,22,22,0,2,2,8.0,,680,25,142,167,521.0,84,7.25,87,443,2603,11.7
26947,Tim Watters,1996-97,37.0,16,10,60,60,1,9,10,38.0,,740,26,151,177,559.0,84,6.48,76,407,2545,10.7
26948,Tim Watters,1997-98,38.0,17,0,1,1,0,0,0,1.0,,741,26,151,177,560.0,48,5.97,37,209,1408,10.2
26949,Timo Blomqvist,1984-85,24.0,4,12,44,44,1,11,12,53.0,,44,1,11,12,53.0,80,8.03,73,320,2489,12.9
26950,Timo Blomqvist,1985-86,25.0,5,18,61,61,1,17,18,71.0,,105,2,28,30,124.0,80,7.73,71,310,2444,12.7
26951,Timo Blomqvist,1986-87,26.0,6,20,65,65,1,19,20,69.0,,170,3,47,50,193.0,80,7.89,74,336,2448,12.9
26952,Timo Blomqvist,1987-88,27.0,7,5,53,53,1,4,5,59.0,,223,4,51,55,252.0,80,7.77,71,321,2447,12.7
26953,Timo Blomqvist,1989-90,29.0,8,2,20,20,0,2,2,16.0,,243,4,53,57,268.0,80,7.34,72,344,2400,12.2
26954,Timo Helbling,2008-09,27.0,4,1,9,9,0,1,1,2.0,93.0,9,0,1,1,2.0,82,6.05,85,480,2458,10.1
26955,Timo Helbling,2009-10,28.0,5,0,2,2,0,0,0,0.0,24.0,11,0,1,1,2.0,82,5.76,70,398,2426,9.7
26956,Timo Jutila,1987-88,24.0,4,6,10,10,1,5,6,28.0,,10,1,5,6,28.0,80,7.77,71,321,2447,12.7
26957,Timo Meier,2019-20,23.0,4,6,34,34,3,3,6,85.0,424.0,34,3,3,6,85.0,82,5.45,47,245,2478,9.0
26958,Timo Meier,2020-21,24.0,5,36,81,81,21,15,36,210.0,1204.0,115,24,18,42,295.0,82,5.86,50,250,2620,9.2
26959,Timo Meier,2021-22,25.0,6,66,78,78,30,36,66,250.0,1324.0,193,54,54,108,545.0,82,5.96,47,239,2579,9.5
26960,Timo Meier,2022-23,26.0,7,49,70,70,22,27,49,199.0,1210.0,263,76,81,157,744.0,70,5.96,42,208,2192,9.5
26961,Timo Parssinen,2004-05,28.0,4,3,17,17,0,3,3,16.0,200.0,17,0,3,3,16.0,82,5.24,53,338,2262,9.5
26962,Timofei Shishkanov,2006-07,23.0,4,0,2,2,0,0,0,0.0,13.0,2,0,0,0,0.0,82,5.14,57,348,2300,9.2
26963,Timofei Shishkanov,2008-09,25.0,5,5,22,22,3,2,5,26.0,186.0,24,3,2,5,26.0,82,6.05,85,480,2458,10.1
26964,Timothy Gettinger,2021-22,23.0,4,0,4,4,0,0,0,2.0,30.0,4,0,0,0,2.0,82,5.96,47,239,2579,9.5
26965,Timothy Gettinger,2022-23,24.0,5,1,2,2,0,1,1,3.0,17.0,6,0,1,1,5.0,70,5.96,42,208,2192,9.5
26966,Timothy Liljegren,2022-23,23.0,4,1,11,11,0,1,1,2.0,113.0,11,0,1,1,2.0,70,5.96,42,208,2192,9.5
26967,Tobias Bjornfot,2022-23,21.0,4,0,3,3,0,0,0,0.0,39.0,3,0,0,0,0.0,70,5.96,42,208,2192,9.5
26968,Tobias Lindberg,2018-19,23.0,4,2,6,6,0,2,2,12.0,95.0,6,0,2,2,12.0,82,5.34,48,255,2438,9.0
26969,Tobias Rieder,2017-18,25.0,4,21,72,72,13,8,21,189.0,1217.0,72,13,8,21,189.0,82,5.32,47,251,2453,8.9
26970,Tobias Rieder,2018-19,26.0,5,37,82,82,14,23,37,189.0,1419.0,154,27,31,58,378.0,82,5.34,48,255,2438,9.0
26971,Tobias Rieder,2019-20,27.0,6,34,80,80,16,18,34,155.0,1385.0,234,43,49,92,533.0,82,5.45,47,245,2478,9.0
26972,Tobias Rieder,2020-21,28.0,7,25,78,78,12,13,25,114.0,1143.0,312,55,62,117,647.0,82,5.86,50,250,2620,9.2
26973,Tobias Rieder,2021-22,29.0,8,11,67,67,0,11,11,92.0,847.0,379,55,73,128,739.0,82,5.96,47,239,2579,9.5
26974,Tobias Rieder,2022-23,30.0,9,10,55,55,4,6,10,77.0,610.0,434,59,79,138,816.0,70,5.96,42,208,2192,9.5
26975,Toby Enstrom,2010-11,26.0,4,38,82,82,5,33,38,105.0,2007.0,82,5,33,38,105.0,82,5.44,62,351,2383,9.4
26976,Toby Enstrom,2011-12,27.0,5,32,82,82,5,27,32,86.0,1929.0,164,10,60,70,191.0,82,5.7,65,341,2477,9.4
26977,Toby Enstrom,2012-13,28.0,6,50,82,82,6,44,50,109.0,1826.0,246,16,104,120,300.0,82,5.53,56,304,2486,9.1
26978,Toby Enstrom,2013-14,29.0,7,51,72,72,10,41,51,113.0,1705.0,318,26,145,171,413.0,82,5.46,52,291,2492,9.0
26979,Toby Enstrom,2014-15,30.0,8,33,62,62,6,27,33,94.0,1478.0,380,32,172,204,507.0,82,5.32,47,271,2439,8.9
26980,Toby Enstrom,2015-16,31.0,9,15,22,22,4,11,15,21.0,496.0,402,36,183,219,528.0,48,5.31,29,160,1399,9.1
26981,Toby Enstrom,2016-17,32.0,10,30,82,82,10,20,30,106.0,1960.0,484,46,203,249,634.0,82,5.34,48,269,2463,8.9
26982,Toby Enstrom,2017-18,33.0,11,23,60,60,4,19,23,58.0,1414.0,544,50,222,272,692.0,82,5.32,47,251,2453,8.9
26983,Toby Enstrom,2018-19,34.0,12,16,72,72,2,14,16,50.0,1502.0,616,52,236,288,742.0,82,5.34,48,255,2438,9.0
26984,Toby Enstrom,2019-20,35.0,13,14,60,60,1,13,14,46.0,1314.0,676,53,249,302,788.0,82,5.45,47,245,2478,9.0
26985,Toby Enstrom,2020-21,36.0,14,6,43,43,1,5,6,31.0,732.0,719,54,254,308,819.0,82,5.86,50,250,2620,9.2
26986,Toby Petersen,2003-04,25.0,4,8,12,12,2,6,8,25.0,160.0,12,2,6,8,25.0,82,5.51,63,376,2272,9.9
26987,Toby Petersen,2004-05,26.0,5,18,79,79,8,10,18,116.0,969.0,91,10,16,26,141.0,82,5.24,53,338,2262,9.5
26988,Toby Petersen,2009-10,31.0,6,15,64,64,6,9,15,92.0,875.0,155,16,25,41,233.0,82,5.76,70,398,2426,9.7
26989,Toby Petersen,2010-11,32.0,7,3,8,8,0,3,3,6.0,63.0,163,16,28,44,239.0,82,5.44,62,351,2383,9.4
26990,Toby Petersen,2011-12,33.0,8,11,57,57,4,7,11,80.0,651.0,220,20,35,55,319.0,82,5.7,65,341,2477,9.4
26991,Toby Petersen,2012-13,34.0,9,15,78,78,9,6,15,110.0,852.0,298,29,41,70,429.0,82,5.53,56,304,2486,9.1
26992,Toby Petersen,2013-14,35.0,10,6,60,60,2,4,6,58.0,602.0,358,31,45,76,487.0,82,5.46,52,291,2492,9.0
26993,Toby Petersen,2014-15,36.0,11,5,39,39,2,3,5,44.0,299.0,397,33,48,81,531.0,82,5.32,47,271,2439,8.9
26994,Toby Petersen,2015-16,37.0,12,0,1,1,0,0,0,0.0,7.0,398,33,48,81,531.0,48,5.31,29,160,1399,9.1
26995,Todd Bergen,1987-88,24.0,4,16,14,14,11,5,16,39.0,,14,11,5,16,39.0,80,7.77,71,321,2447,12.7
26996,Todd Bertuzzi,1998-99,23.0,4,39,76,76,18,21,39,127.0,,76,18,21,39,127.0,82,6.29,74,413,2481,10.4
26997,Todd Bertuzzi,1999-00,24.0,5,23,64,64,10,13,23,79.0,,140,28,34,62,206.0,82,5.83,55,336,2444,9.8
26998,Todd Bertuzzi,2000-01,25.0,6,33,74,74,13,20,33,102.0,,214,41,54,95,308.0,82,5.28,57,380,2242,9.6
26999,Todd Bertuzzi,2001-02,26.0,7,16,32,32,8,8,16,72.0,591.0,246,49,62,111,380.0,82,5.27,57,359,2285,9.4
27000,Todd Bertuzzi,2002-03,27.0,8,50,80,80,25,25,50,173.0,1232.0,326,74,87,161,553.0,82,5.49,53,331,2294,9.8
27001,Todd Bertuzzi,2003-04,28.0,9,55,79,79,25,30,55,203.0,1360.0,405,99,117,216,756.0,82,5.51,63,376,2272,9.9
27002,Todd Bertuzzi,2004-05,29.0,10,85,72,72,36,49,85,203.0,1416.0,477,135,166,301,959.0,82,5.24,53,338,2262,9.5
27003,Todd Bertuzzi,2005-06,30.0,11,97,82,82,46,51,97,243.0,1687.0,559,181,217,398,1202.0,82,5.31,60,363,2326,9.4
27004,Todd Bertuzzi,2006-07,31.0,12,60,69,69,17,43,60,156.0,1450.0,628,198,260,458,1358.0,82,5.14,57,348,2300,9.2
27005,Todd Bertuzzi,2008-09,33.0,13,71,82,82,25,46,71,200.0,1568.0,710,223,306,529,1558.0,82,6.05,85,480,2458,10.1
27006,Todd Bertuzzi,2009-10,34.0,14,11,15,15,3,8,11,23.0,240.0,725,226,314,540,1581.0,82,5.76,70,398,2426,9.7
27007,Todd Bertuzzi,2010-11,35.0,15,40,68,68,14,26,40,121.0,1119.0,793,240,340,580,1702.0,82,5.44,62,351,2383,9.4
27008,Todd Bertuzzi,2011-12,36.0,16,44,66,66,15,29,44,127.0,1228.0,859,255,369,624,1829.0,82,5.7,65,341,2477,9.4
27009,Todd Bertuzzi,2012-13,37.0,17,44,82,82,18,26,44,216.0,1375.0,941,273,395,668,2045.0,82,5.53,56,304,2486,9.1
27010,Todd Bertuzzi,2013-14,38.0,18,45,81,81,16,29,45,138.0,1293.0,1022,289,424,713,2183.0,82,5.46,52,291,2492,9.0
27011,Todd Bertuzzi,2014-15,39.0,19,38,71,71,14,24,38,118.0,1104.0,1093,303,448,751,2301.0,82,5.32,47,271,2439,8.9
27012,Todd Bertuzzi,2015-16,40.0,20,3,7,7,2,1,3,10.0,109.0,1100,305,449,754,2311.0,48,5.31,29,160,1399,9.1
27013,Todd Bertuzzi,2016-17,41.0,21,16,59,59,9,7,16,100.0,865.0,1159,314,456,770,2411.0,82,5.34,48,269,2463,8.9
27014,Todd Bidner,1984-85,23.0,4,3,12,12,2,1,3,5.0,,12,2,1,3,5.0,80,8.03,73,320,2489,12.9
27015,Todd Charlesworth,1986-87,21.0,4,0,10,10,0,0,0,6.0,,10,0,0,0,6.0,80,7.89,74,336,2448,12.9
27016,Todd Charlesworth,1987-88,22.0,5,9,67,67,1,8,9,68.0,,77,1,8,9,74.0,80,7.77,71,321,2447,12.7
27017,Todd Charlesworth,1988-89,23.0,6,1,2,2,0,1,1,1.0,,79,1,9,10,75.0,80,7.94,82,370,2484,12.8
27018,Todd Charlesworth,1989-90,24.0,7,0,1,1,0,0,0,0.0,,80,1,9,10,75.0,80,7.34,72,344,2400,12.2
27019,Todd Charlesworth,1990-91,25.0,8,2,6,6,2,0,2,4.0,,86,3,9,12,79.0,80,7.43,89,437,2435,12.2
27020,Todd Charlesworth,1992-93,27.0,9,0,7,7,0,0,0,4.0,,93,3,9,12,83.0,80,7.37,76,367,2421,12.2
27021,Todd Elik,1992-93,26.0,4,33,48,48,10,23,33,86.0,,48,10,23,33,86.0,80,7.37,76,367,2421,12.2
27022,Todd Elik,1993-94,27.0,5,58,74,74,21,37,58,153.0,,122,31,60,91,239.0,80,6.91,71,366,2385,11.6
27023,Todd Elik,1994-95,28.0,6,46,62,62,14,32,46,118.0,,184,45,92,137,357.0,80,6.96,77,402,2440,11.4
27024,Todd Elik,1995-96,29.0,7,41,60,60,14,27,41,104.0,,244,59,119,178,461.0,84,7.25,87,443,2603,11.7
27025,Todd Elik,1996-97,30.0,8,66,79,79,25,41,66,185.0,,323,84,160,244,646.0,84,6.48,76,407,2545,10.7
27026,Todd Elik,1997-98,31.0,9,23,35,35,9,14,23,76.0,,358,93,174,267,722.0,48,5.97,37,209,1408,10.2
27027,Todd Elik,1998-99,32.0,10,46,59,59,13,33,46,108.0,,417,106,207,313,830.0,82,6.29,74,413,2481,10.4
27028,Todd Elik,1999-00,33.0,11,16,31,31,4,12,16,72.0,,448,110,219,329,902.0,82,5.83,55,336,2444,9.8
27029,Todd Ewen,1989-90,23.0,4,2,23,23,2,0,2,11.0,,23,2,0,2,11.0,80,7.34,72,344,2400,12.2
27030,Todd Ewen,1990-91,24.0,5,6,64,64,4,2,6,38.0,,87,6,2,8,49.0,80,7.43,89,437,2435,12.2
27031,Todd Ewen,1991-92,25.0,6,9,34,34,4,5,9,22.0,,121,10,7,17,71.0,80,7.48,85,403,2430,12.3
27032,Todd Ewen,1992-93,26.0,7,10,44,44,4,6,10,29.0,,165,14,13,27,100.0,80,7.37,76,367,2421,12.2
27033,Todd Ewen,1993-94,27.0,8,5,28,28,3,2,5,13.0,,193,17,15,32,113.0,80,6.91,71,366,2385,11.6
27034,Todd Ewen,1994-95,28.0,9,3,46,46,1,2,3,19.0,,239,18,17,35,132.0,80,6.96,77,402,2440,11.4
27035,Todd Ewen,1995-96,29.0,10,14,75,75,5,9,14,59.0,,314,23,26,49,191.0,84,7.25,87,443,2603,11.7
27036,Todd Ewen,1996-97,30.0,11,18,76,76,9,9,18,59.0,,390,32,35,67,250.0,84,6.48,76,407,2545,10.7
27037,Todd Ewen,1997-98,31.0,12,0,24,24,0,0,0,14.0,,414,32,35,67,264.0,48,5.97,37,209,1408,10.2
27038,Todd Ewen,1998-99,32.0,13,7,53,53,4,3,7,52.0,,467,36,38,74,316.0,82,6.29,74,413,2481,10.4
27039,Todd Ewen,1999-00,33.0,14,2,51,51,0,2,2,22.0,,518,36,40,76,338.0,82,5.83,55,336,2444,9.8
27040,Todd Fedoruk,2003-04,24.0,4,10,53,53,5,5,10,28.0,373.0,53,5,5,10,28.0,82,5.51,63,376,2272,9.9
27041,Todd Fedoruk,2004-05,25.0,5,7,55,55,3,4,7,21.0,349.0,108,8,9,17,49.0,82,5.24,53,338,2262,9.5
27042,Todd Fedoruk,2005-06,26.0,6,6,63,63,1,5,6,33.0,409.0,171,9,14,23,82.0,82,5.31,60,363,2326,9.4
27043,Todd Fedoruk,2006-07,27.0,7,5,49,49,1,4,5,33.0,332.0,220,10,18,28,115.0,82,5.14,57,348,2300,9.2
27044,Todd Fedoruk,2008-09,29.0,8,23,76,76,4,19,23,69.0,639.0,296,14,37,51,184.0,82,6.05,85,480,2458,10.1
27045,Todd Fedoruk,2009-10,30.0,9,14,58,58,3,11,14,30.0,509.0,354,17,48,65,214.0,82,5.76,70,398,2426,9.7
27046,Todd Fedoruk,2010-11,31.0,10,13,69,69,6,7,13,57.0,712.0,423,23,55,78,271.0,82,5.44,62,351,2383,9.4
27047,Todd Fedoruk,2011-12,32.0,11,13,72,72,6,7,13,56.0,763.0,495,29,62,91,327.0,82,5.7,65,341,2477,9.4
27048,Todd Fedoruk,2012-13,33.0,12,6,50,50,3,3,6,22.0,376.0,545,32,65,97,349.0,82,5.53,56,304,2486,9.1
27049,Todd Flichel,1990-91,26.0,4,0,2,2,0,0,0,1.0,,2,0,0,0,1.0,80,7.43,89,437,2435,12.2
27050,Todd Flichel,1991-92,27.0,5,0,1,1,0,0,0,1.0,,3,0,0,0,2.0,80,7.48,85,403,2430,12.3
27051,Todd Flichel,1992-93,28.0,6,1,3,3,0,1,1,1.0,,6,0,1,1,3.0,80,7.37,76,367,2421,12.2
27052,Todd Gill,1987-88,22.0,4,1,10,10,1,0,1,9.0,,10,1,0,1,9.0,80,7.77,71,321,2447,12.7
27053,Todd Gill,1988-89,23.0,5,3,15,15,1,2,3,9.0,,25,2,2,4,18.0,80,7.94,82,370,2484,12.8
27054,Todd Gill,1989-90,24.0,6,31,61,61,4,27,31,51.0,,86,6,29,35,69.0,80,7.34,72,344,2400,12.2
27055,Todd Gill,1990-91,25.0,7,25,65,65,8,17,25,109.0,,151,14,46,60,178.0,80,7.43,89,437,2435,12.2
27056,Todd Gill,1991-92,26.0,8,25,59,59,11,14,25,92.0,,210,25,60,85,270.0,80,7.48,85,403,2430,12.3
27057,Todd Gill,1992-93,27.0,9,15,48,48,1,14,15,44.0,,258,26,74,100,314.0,80,7.37,76,367,2421,12.2
27058,Todd Gill,1993-94,28.0,10,24,72,72,2,22,24,90.0,,330,28,96,124,404.0,80,6.91,71,366,2385,11.6
27059,Todd Gill,1994-95,29.0,11,17,74,74,2,15,17,82.0,,404,30,111,141,486.0,80,6.96,77,402,2440,11.4
27060,Todd Gill,1995-96,30.0,12,43,69,69,11,32,43,113.0,,473,41,143,184,599.0,84,7.25,87,443,2603,11.7
27061,Todd Gill,1996-97,31.0,13,28,45,45,4,24,28,74.0,,518,45,167,212,673.0,84,6.48,76,407,2545,10.7
27062,Todd Gill,1997-98,32.0,14,32,47,47,7,25,32,82.0,,565,52,192,244,755.0,48,5.97,37,209,1408,10.2
27063,Todd Gill,1998-99,33.0,15,25,74,74,7,18,25,109.0,,639,59,210,269,864.0,82,6.29,74,413,2481,10.4
27064,Todd Gill,1999-00,34.0,16,21,79,79,0,21,21,101.0,,718,59,231,290,965.0,82,5.83,55,336,2444,9.8
27065,Todd Gill,2000-01,35.0,17,30,75,75,13,17,30,122.0,,793,72,248,320,1087.0,82,5.28,57,380,2242,9.6
27066,Todd Gill,2001-02,36.0,18,9,51,51,4,5,9,61.0,924.0,844,76,253,329,1148.0,82,5.27,57,359,2285,9.4
27067,Todd Gill,2002-03,37.0,19,9,54,54,3,6,9,61.0,862.0,898,79,259,338,1209.0,82,5.49,53,331,2294,9.8
27068,Todd Gill,2003-04,38.0,20,11,68,68,3,8,11,66.0,1265.0,966,82,267,349,1275.0,82,5.51,63,376,2272,9.9
27069,Todd Gill,2004-05,39.0,21,4,36,36,0,4,4,26.0,458.0,1002,82,271,353,1301.0,82,5.24,53,338,2262,9.5
27070,Todd Gill,2005-06,40.0,22,1,5,5,0,1,1,9.0,98.0,1007,82,272,354,1310.0,82,5.31,60,363,2326,9.4
27071,Todd Harkins,1994-95,26.0,4,0,5,5,0,0,0,4.0,,5,0,0,0,4.0,80,6.96,77,402,2440,11.4
27072,Todd Harkins,1995-96,27.0,5,5,15,15,2,3,5,17.0,,20,2,3,5,21.0,84,7.25,87,443,2603,11.7
27073,Todd Harkins,1996-97,28.0,6,1,28,28,1,0,1,15.0,,48,3,3,6,36.0,84,6.48,76,407,2545,10.7
27074,Todd Harvey,1997-98,22.0,4,20,40,40,11,9,20,64.0,,40,11,9,20,64.0,48,5.97,37,209,1408,10.2
27075,Todd Harvey,1998-99,23.0,5,29,69,69,9,20,29,101.0,,109,20,29,49,165.0,82,6.29,74,413,2481,10.4
27076,Todd Harvey,1999-00,24.0,6,31,71,71,9,22,31,99.0,,180,29,51,80,264.0,82,5.83,55,336,2444,9.8
27077,Todd Harvey,2000-01,25.0,7,19,59,59,9,10,19,88.0,,239,38,61,99,352.0,82,5.28,57,380,2242,9.6
27078,Todd Harvey,2001-02,26.0,8,28,37,37,11,17,28,58.0,641.0,276,49,78,127,410.0,82,5.27,57,359,2285,9.4
27079,Todd Harvey,2002-03,27.0,9,18,71,71,11,7,18,90.0,900.0,347,60,85,145,500.0,82,5.49,53,331,2294,9.8
27080,Todd Harvey,2003-04,28.0,10,21,69,69,10,11,21,66.0,765.0,416,70,96,166,566.0,82,5.51,63,376,2272,9.9
27081,Todd Harvey,2004-05,29.0,11,22,69,69,9,13,22,66.0,675.0,485,79,109,188,632.0,82,5.24,53,338,2262,9.5
27082,Todd Harvey,2005-06,30.0,12,19,76,76,3,16,19,64.0,756.0,561,82,125,207,696.0,82,5.31,60,363,2326,9.4
27083,Todd Harvey,2006-07,31.0,13,9,47,47,4,5,9,51.0,459.0,608,86,130,216,747.0,82,5.14,57,348,2300,9.2
27084,Todd Harvey,2008-09,33.0,14,7,63,63,5,2,7,45.0,476.0,671,91,132,223,792.0,82,6.05,85,480,2458,10.1
27085,Todd Hawkins,1991-92,25.0,4,0,4,4,0,0,0,2.0,,4,0,0,0,2.0,80,7.48,85,403,2430,12.3
27086,Todd Hawkins,1992-93,26.0,5,0,4,4,0,0,0,3.0,,8,0,0,0,5.0,80,7.37,76,367,2421,12.2
27087,Todd Hawkins,1994-95,28.0,6,0,2,2,0,0,0,0.0,,10,0,0,0,5.0,80,6.96,77,402,2440,11.4
27088,Todd Hlushko,1996-97,26.0,4,1,2,2,1,0,1,2.0,,2,1,0,1,2.0,84,6.48,76,407,2545,10.7
27089,Todd Hlushko,1997-98,27.0,5,1,2,2,0,1,1,3.0,,4,1,1,2,5.0,48,5.97,37,209,1408,10.2
27090,Todd Hlushko,1998-99,28.0,6,0,4,4,0,0,0,6.0,,8,1,1,2,11.0,82,6.29,74,413,2481,10.4
27091,Todd Hlushko,1999-00,29.0,7,18,58,58,7,11,18,76.0,,66,8,12,20,87.0,82,5.83,55,336,2444,9.8
27092,Todd Hlushko,2000-01,30.0,8,1,13,13,0,1,1,7.0,,79,8,13,21,94.0,82,5.28,57,380,2242,9.6
27093,Todd Krygier,1992-93,27.0,4,30,58,58,18,12,30,103.0,,58,18,12,30,103.0,80,7.37,76,367,2421,12.2
27094,Todd Krygier,1993-94,28.0,5,30,72,72,13,17,30,113.0,,130,31,29,60,216.0,80,6.91,71,366,2385,11.6
27095,Todd Krygier,1994-95,29.0,6,30,67,67,13,17,30,127.0,,197,44,46,90,343.0,80,6.96,77,402,2440,11.4
27096,Todd Krygier,1995-96,30.0,7,23,77,77,11,12,23,133.0,,274,55,58,113,476.0,84,7.25,87,443,2603,11.7
27097,Todd Krygier,1996-97,31.0,8,30,66,66,12,18,30,146.0,,340,67,76,143,622.0,84,6.48,76,407,2545,10.7
27098,Todd Krygier,1997-98,32.0,9,22,35,35,11,11,22,90.0,,375,78,87,165,712.0,48,5.97,37,209,1408,10.2
27099,Todd Krygier,1998-99,33.0,10,48,76,76,15,33,48,181.0,,451,93,120,213,893.0,82,6.29,74,413,2481,10.4
27100,Todd Krygier,1999-00,34.0,11,16,47,47,5,11,16,121.0,,498,98,131,229,1014.0,82,5.83,55,336,2444,9.8
27101,Todd Krygier,2000-01,35.0,12,14,45,45,2,12,14,71.0,,543,100,143,243,1085.0,82,5.28,57,380,2242,9.6
27102,Todd Marchant,1996-97,23.0,4,1,4,4,0,1,1,6.0,,4,0,1,1,6.0,84,6.48,76,407,2545,10.7
27103,Todd Marchant,1997-98,24.0,5,27,45,45,13,14,27,95.0,,49,13,15,28,101.0,48,5.97,37,209,1408,10.2
27104,Todd Marchant,1998-99,25.0,6,38,81,81,19,19,38,221.0,,130,32,34,66,322.0,82,6.29,74,413,2481,10.4
27105,Todd Marchant,1999-00,26.0,7,33,79,79,14,19,33,202.0,,209,46,53,99,524.0,82,5.83,55,336,2444,9.8
27106,Todd Marchant,2000-01,27.0,8,35,76,76,14,21,35,194.0,,285,60,74,134,718.0,82,5.28,57,380,2242,9.6
27107,Todd Marchant,2001-02,28.0,9,36,82,82,14,22,36,183.0,1376.0,367,74,96,170,901.0,82,5.27,57,359,2285,9.4
27108,Todd Marchant,2002-03,29.0,10,40,82,82,17,23,40,170.0,1405.0,449,91,119,210,1071.0,82,5.49,53,331,2294,9.8
27109,Todd Marchant,2003-04,30.0,11,39,71,71,13,26,39,113.0,1271.0,520,104,145,249,1184.0,82,5.51,63,376,2272,9.9
27110,Todd Marchant,2004-05,31.0,12,34,82,82,12,22,34,124.0,1392.0,602,116,167,283,1308.0,82,5.24,53,338,2262,9.5
27111,Todd Marchant,2005-06,32.0,13,60,77,77,20,40,60,146.0,1532.0,679,136,207,343,1454.0,82,5.31,60,363,2326,9.4
27112,Todd Marchant,2006-07,33.0,14,34,77,77,9,25,34,163.0,1590.0,756,145,232,377,1617.0,82,5.14,57,348,2300,9.2
27113,Todd Marchant,2008-09,35.0,15,34,79,79,9,25,34,132.0,1363.0,835,154,257,411,1749.0,82,6.05,85,480,2458,10.1
27114,Todd Marchant,2009-10,36.0,16,23,56,56,8,15,23,115.0,850.0,891,162,272,434,1864.0,82,5.76,70,398,2426,9.7
27115,Todd Marchant,2010-11,37.0,17,16,75,75,9,7,16,93.0,1112.0,966,171,279,450,1957.0,82,5.44,62,351,2383,9.4
27116,Todd Marchant,2011-12,38.0,18,18,72,72,5,13,18,101.0,1046.0,1038,176,292,468,2058.0,82,5.7,65,341,2477,9.4
27117,Todd Marchant,2012-13,39.0,19,22,78,78,9,13,22,83.0,1233.0,1116,185,305,490,2141.0,82,5.53,56,304,2486,9.1
27118,Todd Marchant,2013-14,40.0,20,8,79,79,1,7,8,63.0,1050.0,1195,186,312,498,2204.0,82,5.46,52,291,2492,9.0
27119,Todd McLellan,1990-91,23.0,4,2,5,5,1,1,2,4.0,,5,1,1,2,4.0,80,7.43,89,437,2435,12.2
27120,Todd Nelson,1994-95,25.0,4,0,1,1,0,0,0,0.0,,1,0,0,0,0.0,80,6.96,77,402,2440,11.4
27121,Todd Nelson,1996-97,27.0,5,1,2,2,1,0,1,1.0,,3,1,0,1,1.0,84,6.48,76,407,2545,10.7
27122,Todd Okerlund,1990-91,26.0,4,0,4,4,0,0,0,3.0,,4,0,0,0,3.0,80,7.43,89,437,2435,12.2
27123,Todd Reirden,2001-02,30.0,4,5,17,17,2,3,5,26.0,294.0,17,2,3,5,26.0,82,5.27,57,359,2285,9.4
27124,Todd Reirden,2002-03,31.0,5,25,56,56,4,21,25,77.0,1025.0,73,6,24,30,103.0,82,5.49,53,331,2294,9.8
27125,Todd Reirden,2003-04,32.0,6,6,38,38,2,4,6,58.0,640.0,111,8,28,36,161.0,82,5.51,63,376,2272,9.9
27126,Todd Reirden,2004-05,33.0,7,8,65,65,3,5,8,85.0,1172.0,176,11,33,44,246.0,82,5.24,53,338,2262,9.5
27127,Todd Reirden,2006-07,35.0,8,2,7,7,0,2,2,9.0,108.0,183,11,35,46,255.0,82,5.14,57,348,2300,9.2
27128,Todd Richards,1993-94,27.0,4,4,2,2,0,4,4,4.0,,2,0,4,4,4.0,80,6.91,71,366,2385,11.6
27129,Todd Richards,1994-95,28.0,5,0,6,6,0,0,0,3.0,,8,0,4,4,7.0,80,6.96,77,402,2440,11.4
27130,Todd Rohloff,2004-05,31.0,4,1,16,16,0,1,1,6.0,227.0,16,0,1,1,6.0,82,5.24,53,338,2262,9.5
27131,Todd Rohloff,2006-07,33.0,5,5,59,59,0,5,5,35.0,956.0,75,0,6,6,41.0,82,5.14,57,348,2300,9.2
27132,Todd Simon,1996-97,24.0,4,1,15,15,0,1,1,14.0,,15,0,1,1,14.0,84,6.48,76,407,2545,10.7
27133,Todd Simpson,1998-99,25.0,4,0,6,6,0,0,0,3.0,,6,0,0,0,3.0,82,6.29,74,413,2481,10.4
27134,Todd Simpson,1999-00,26.0,5,14,82,82,1,13,14,85.0,,88,1,13,14,88.0,82,5.83,55,336,2444,9.8
27135,Todd Simpson,2000-01,27.0,6,6,53,53,1,5,6,51.0,,141,2,18,20,139.0,82,5.28,57,380,2242,9.6
27136,Todd Simpson,2001-02,28.0,7,10,73,73,2,8,10,52.0,1264.0,214,4,26,30,191.0,82,5.27,57,359,2285,9.4
27137,Todd Simpson,2002-03,29.0,8,7,82,82,1,6,7,50.0,1360.0,296,5,32,37,241.0,82,5.49,53,331,2294,9.8
27138,Todd Simpson,2003-04,30.0,9,5,38,38,1,4,5,35.0,593.0,334,6,36,42,276.0,82,5.51,63,376,2272,9.9
27139,Todd Simpson,2004-05,31.0,10,15,67,67,2,13,15,51.0,1161.0,401,8,49,57,327.0,82,5.24,53,338,2262,9.5
27140,Todd Simpson,2005-06,32.0,11,9,66,66,2,7,9,67.0,1121.0,467,10,56,66,394.0,82,5.31,60,363,2326,9.4
27141,Todd Simpson,2006-07,33.0,12,8,62,62,4,4,8,52.0,887.0,529,14,60,74,446.0,82,5.14,57,348,2300,9.2
27142,Todd Simpson,2008-09,35.0,13,3,51,51,0,3,3,31.0,685.0,580,14,63,77,477.0,82,6.05,85,480,2458,10.1
27143,Todd Strueby,1984-85,21.0,4,0,3,3,0,0,0,1.0,,3,0,0,0,1.0,80,8.03,73,320,2489,12.9
27144,Todd Strueby,1985-86,22.0,5,0,1,1,0,0,0,1.0,,4,0,0,0,2.0,80,7.73,71,310,2444,12.7
27145,Todd Strueby,1986-87,23.0,6,1,1,1,0,1,1,1.0,,5,0,1,1,3.0,80,7.89,74,336,2448,12.9
27146,Todd Warriner,1997-98,24.0,4,0,5,5,0,0,0,1.0,,5,0,0,0,1.0,48,5.97,37,209,1408,10.2
27147,Todd Warriner,1998-99,25.0,5,15,57,57,7,8,15,79.0,,62,7,8,15,80.0,82,6.29,74,413,2481,10.4
27148,Todd Warriner,1999-00,26.0,6,33,75,75,12,21,33,146.0,,137,19,29,48,226.0,82,5.83,55,336,2444,9.8
27149,Todd Warriner,2000-01,27.0,7,13,45,45,5,8,13,73.0,,182,24,37,61,299.0,82,5.28,57,380,2242,9.6
27150,Todd Warriner,2001-02,28.0,8,19,53,53,9,10,19,96.0,747.0,235,33,47,80,395.0,82,5.27,57,359,2285,9.4
27151,Todd Warriner,2002-03,29.0,9,28,73,73,14,14,28,133.0,1132.0,308,47,61,108,528.0,82,5.49,53,331,2294,9.8
27152,Todd Warriner,2003-04,30.0,10,21,64,64,10,11,21,99.0,942.0,372,57,72,129,627.0,82,5.51,63,376,2272,9.9
27153,Todd Warriner,2004-05,31.0,11,9,32,32,2,7,9,28.0,322.0,404,59,79,138,655.0,82,5.24,53,338,2262,9.5
27154,Todd Warriner,2005-06,32.0,12,16,49,49,6,10,16,72.0,528.0,453,65,89,154,727.0,82,5.31,60,363,2326,9.4
27155,Todd White,2000-01,25.0,4,1,7,7,1,0,1,3.0,,7,1,0,1,3.0,82,5.28,57,380,2242,9.6
27156,Todd White,2001-02,26.0,5,13,35,35,5,8,13,43.0,478.0,42,6,8,14,46.0,82,5.27,57,359,2285,9.4
27157,Todd White,2002-03,27.0,6,1,4,4,1,0,1,4.0,44.0,46,7,8,15,50.0,82,5.49,53,331,2294,9.8
27158,Todd White,2003-04,28.0,7,5,16,16,4,1,5,12.0,137.0,62,11,9,20,62.0,82,5.51,63,376,2272,9.9
27159,Todd White,2004-05,29.0,8,50,81,81,20,30,50,147.0,1487.0,143,31,39,70,209.0,82,5.24,53,338,2262,9.5
27160,Todd White,2005-06,30.0,9,60,80,80,25,35,60,144.0,1437.0,223,56,74,130,353.0,82,5.31,60,363,2326,9.4
27161,Todd White,2006-07,31.0,10,29,53,53,9,20,29,98.0,929.0,276,65,94,159,451.0,82,5.14,57,348,2300,9.2
27162,Todd White,2008-09,33.0,11,40,61,61,19,21,40,109.0,1049.0,337,84,115,199,560.0,82,6.05,85,480,2458,10.1
27163,Todd White,2009-10,34.0,12,44,77,77,13,31,44,162.0,1326.0,414,97,146,243,722.0,82,5.76,70,398,2426,9.7
27164,Todd White,2010-11,35.0,13,37,74,74,14,23,37,111.0,1364.0,488,111,169,280,833.0,82,5.44,62,351,2383,9.4
27165,Todd White,2011-12,36.0,14,73,82,82,22,51,73,150.0,1481.0,570,133,220,353,983.0,82,5.7,65,341,2477,9.4
27166,Todd White,2012-13,37.0,15,26,65,65,7,19,26,92.0,991.0,635,140,239,379,1075.0,82,5.53,56,304,2486,9.1
27167,Todd White,2013-14,38.0,16,2,18,18,1,1,2,11.0,138.0,653,141,240,381,1086.0,82,5.46,52,291,2492,9.0
27168,Tom Bissett,1993-94,27.0,4,0,5,5,0,0,0,2.0,,5,0,0,0,2.0,80,6.91,71,366,2385,11.6
27169,Tom Cavanagh,2010-11,28.0,4,1,1,1,0,1,1,0.0,14.0,1,0,1,1,0.0,82,5.44,62,351,2383,9.4
27170,Tom Cavanagh,2011-12,29.0,5,2,17,17,1,1,2,9.0,131.0,18,1,2,3,9.0,82,5.7,65,341,2477,9.4
27171,Tom Chorske,1992-93,26.0,4,4,14,14,3,1,4,19.0,,14,3,1,4,19.0,80,7.37,76,367,2421,12.2
27172,Tom Chorske,1993-94,27.0,5,20,57,57,9,11,20,82.0,,71,12,12,24,101.0,80,6.91,71,366,2385,11.6
27173,Tom Chorske,1994-95,28.0,6,36,76,76,19,17,36,143.0,,147,31,29,60,244.0,80,6.96,77,402,2440,11.4
27174,Tom Chorske,1995-96,29.0,7,19,50,50,7,12,19,63.0,,197,38,41,79,307.0,84,7.25,87,443,2603,11.7
27175,Tom Chorske,1996-97,30.0,8,41,76,76,21,20,41,131.0,,273,59,61,120,438.0,84,6.48,76,407,2545,10.7
27176,Tom Chorske,1997-98,31.0,9,18,42,42,10,8,18,59.0,,315,69,69,138,497.0,48,5.97,37,209,1408,10.2
27177,Tom Chorske,1998-99,32.0,10,29,72,72,15,14,29,118.0,,387,84,83,167,615.0,82,6.29,74,413,2481,10.4
27178,Tom Chorske,1999-00,33.0,11,26,68,68,18,8,26,116.0,,455,102,91,193,731.0,82,5.83,55,336,2444,9.8
27179,Tom Chorske,2000-01,34.0,12,35,82,82,12,23,35,132.0,,537,114,114,228,863.0,82,5.28,57,380,2242,9.6
27180,Tom Chorske,2001-02,35.0,13,3,26,26,0,3,3,44.0,317.0,563,114,117,231,907.0,82,5.27,57,359,2285,9.4
27181,Tom Chorske,2002-03,36.0,14,6,33,33,1,5,6,14.0,259.0,596,115,122,237,921.0,82,5.49,53,331,2294,9.8
27182,Tom Fergus,1984-85,22.0,4,39,61,61,15,24,39,116.0,,61,15,24,39,116.0,80,8.03,73,320,2489,12.9
27183,Tom Fergus,1985-86,23.0,5,63,80,80,28,35,63,169.0,,141,43,59,102,285.0,80,7.73,71,310,2444,12.7
27184,Tom Fergus,1986-87,24.0,6,61,69,69,25,36,61,123.0,,210,68,95,163,408.0,80,7.89,74,336,2448,12.9
27185,Tom Fergus,1987-88,25.0,7,73,79,79,30,43,73,188.0,,289,98,138,236,596.0,80,7.77,71,321,2447,12.7
27186,Tom Fergus,1988-89,26.0,8,73,78,78,31,42,73,168.0,,367,129,180,309,764.0,80,7.94,82,370,2484,12.8
27187,Tom Fergus,1989-90,27.0,9,49,57,57,21,28,49,119.0,,424,150,208,358,883.0,80,7.34,72,344,2400,12.2
27188,Tom Fergus,1990-91,28.0,10,50,63,63,19,31,50,124.0,,487,169,239,408,1007.0,80,7.43,89,437,2435,12.2
27189,Tom Fergus,1991-92,29.0,11,67,80,80,22,45,67,151.0,,567,191,284,475,1158.0,80,7.48,85,403,2430,12.3
27190,Tom Fergus,1992-93,30.0,12,45,54,54,19,26,45,120.0,,621,210,310,520,1278.0,80,7.37,76,367,2421,12.2
27191,Tom Fergus,1993-94,31.0,13,9,14,14,5,4,9,17.0,,635,215,314,529,1295.0,80,6.91,71,366,2385,11.6
27192,Tom Fergus,1994-95,32.0,14,38,55,55,15,23,38,103.0,,690,230,337,567,1398.0,80,6.96,77,402,2440,11.4
27193,Tom Fergus,1995-96,33.0,15,14,36,36,5,9,14,29.0,,726,235,346,581,1427.0,84,7.25,87,443,2603,11.7
27194,Tom Fitzgerald,1991-92,23.0,4,8,23,23,3,5,8,24.0,,23,3,5,8,24.0,80,7.48,85,403,2430,12.3
27195,Tom Fitzgerald,1992-93,24.0,5,7,19,19,2,5,7,24.0,,42,5,10,15,48.0,80,7.37,76,367,2421,12.2
27196,Tom Fitzgerald,1993-94,25.0,6,10,41,41,5,5,10,60.0,,83,10,15,25,108.0,80,6.91,71,366,2385,11.6
27197,Tom Fitzgerald,1994-95,26.0,7,17,45,45,6,11,17,71.0,,128,16,26,42,179.0,80,6.96,77,402,2440,11.4
27198,Tom Fitzgerald,1995-96,27.0,8,27,77,77,9,18,27,83.0,,205,25,44,69,262.0,84,7.25,87,443,2603,11.7
27199,Tom Fitzgerald,1996-97,28.0,9,32,83,83,18,14,32,144.0,,288,43,58,101,406.0,84,6.48,76,407,2545,10.7
27200,Tom Fitzgerald,1997-98,29.0,10,16,48,48,3,13,16,78.0,,336,46,71,117,484.0,48,5.97,37,209,1408,10.2
27201,Tom Fitzgerald,1998-99,30.0,11,34,82,82,13,21,34,141.0,,418,59,92,151,625.0,82,6.29,74,413,2481,10.4
27202,Tom Fitzgerald,1999-00,31.0,12,24,71,71,10,14,24,135.0,,489,69,106,175,760.0,82,5.83,55,336,2444,9.8
27203,Tom Fitzgerald,2000-01,32.0,13,18,80,80,12,6,18,119.0,,569,81,112,193,879.0,82,5.28,57,380,2242,9.6
27204,Tom Fitzgerald,2001-02,33.0,14,32,80,80,13,19,32,180.0,1383.0,649,94,131,225,1059.0,82,5.27,57,359,2285,9.4
27205,Tom Fitzgerald,2002-03,34.0,15,22,82,82,13,9,22,119.0,1144.0,731,107,140,247,1178.0,82,5.49,53,331,2294,9.8
27206,Tom Fitzgerald,2003-04,35.0,16,18,82,82,9,9,18,135.0,1227.0,813,116,149,265,1313.0,82,5.51,63,376,2272,9.9
27207,Tom Fitzgerald,2004-05,36.0,17,20,78,78,8,12,20,125.0,1142.0,891,124,161,285,1438.0,82,5.24,53,338,2262,9.5
27208,Tom Fitzgerald,2005-06,37.0,18,17,66,66,4,13,17,89.0,799.0,957,128,174,302,1527.0,82,5.31,60,363,2326,9.4
27209,Tom Fitzgerald,2006-07,38.0,19,17,69,69,7,10,17,81.0,854.0,1026,135,184,319,1608.0,82,5.14,57,348,2300,9.2
27210,Tom Fitzgerald,2008-09,40.0,20,10,71,71,4,6,10,50.0,671.0,1097,139,190,329,1658.0,82,6.05,85,480,2458,10.1
27211,Tom Gilbert,2009-10,27.0,4,6,12,12,1,5,6,13.0,241.0,12,1,5,6,13.0,82,5.76,70,398,2426,9.7
27212,Tom Gilbert,2010-11,28.0,5,33,82,82,13,20,33,98.0,1820.0,94,14,25,39,111.0,82,5.44,62,351,2383,9.4
27213,Tom Gilbert,2011-12,29.0,6,45,82,82,5,40,45,107.0,1802.0,176,19,65,84,218.0,82,5.7,65,341,2477,9.4
27214,Tom Gilbert,2012-13,30.0,7,31,82,82,5,26,31,98.0,1839.0,258,24,91,115,316.0,82,5.53,56,304,2486,9.1
27215,Tom Gilbert,2013-14,31.0,8,26,79,79,6,20,26,106.0,1936.0,337,30,111,141,422.0,82,5.46,52,291,2492,9.0
27216,Tom Gilbert,2014-15,32.0,9,22,67,67,3,19,22,72.0,1612.0,404,33,130,163,494.0,82,5.32,47,271,2439,8.9
27217,Tom Gilbert,2015-16,33.0,10,13,43,43,3,10,13,36.0,831.0,447,36,140,176,530.0,48,5.31,29,160,1399,9.1
27218,Tom Gilbert,2016-17,34.0,11,28,73,73,3,25,28,93.0,1558.0,520,39,165,204,623.0,82,5.34,48,269,2463,8.9
27219,Tom Gilbert,2017-18,35.0,12,12,72,72,4,8,12,70.0,1392.0,592,43,173,216,693.0,82,5.32,47,251,2453,8.9
27220,Tom Gilbert,2018-19,36.0,13,2,45,45,1,1,2,36.0,759.0,637,44,174,218,729.0,82,5.34,48,255,2438,9.0
27221,Tom Gilbert,2019-20,37.0,14,5,18,18,1,4,5,12.0,278.0,655,45,178,223,741.0,82,5.45,47,245,2478,9.0
27222,Tom Hirsch,1986-87,24.0,4,4,15,15,1,3,4,24.0,,15,1,3,4,24.0,80,7.89,74,336,2448,12.9
27223,Tom Hirsch,1987-88,25.0,5,4,15,15,0,4,4,14.0,,30,1,7,8,38.0,80,7.77,71,321,2447,12.7
27224,Tom Hirsch,1990-91,28.0,6,0,1,1,0,0,0,0.0,,31,1,7,8,38.0,80,7.43,89,437,2435,12.2
27225,Tom Koivisto,2005-06,31.0,4,6,22,22,2,4,6,26.0,368.0,22,2,4,6,26.0,82,5.31,60,363,2326,9.4
27226,Tom Kostopoulos,2004-05,26.0,4,3,11,11,1,2,3,8.0,132.0,11,1,2,3,8.0,82,5.24,53,338,2262,9.5
27227,Tom Kostopoulos,2005-06,27.0,5,1,8,8,0,1,1,6.0,36.0,19,1,3,4,14.0,82,5.31,60,363,2326,9.4
27228,Tom Kostopoulos,2006-07,28.0,6,22,60,60,9,13,22,101.0,866.0,79,10,16,26,115.0,82,5.14,57,348,2300,9.2
27229,Tom Kostopoulos,2008-09,30.0,7,22,76,76,8,14,22,74.0,983.0,155,18,30,48,189.0,82,6.05,85,480,2458,10.1
27230,Tom Kostopoulos,2009-10,31.0,8,22,76,76,7,15,22,90.0,879.0,231,25,45,70,279.0,82,5.76,70,398,2426,9.7
27231,Tom Kostopoulos,2010-11,32.0,9,13,67,67,7,6,13,98.0,755.0,298,32,51,83,377.0,82,5.44,62,351,2383,9.4
27232,Tom Kostopoulos,2011-12,33.0,10,22,78,78,8,14,22,121.0,1103.0,376,40,65,105,498.0,82,5.7,65,341,2477,9.4
27233,Tom Kostopoulos,2012-13,34.0,11,21,82,82,8,13,21,103.0,1027.0,458,48,78,126,601.0,82,5.53,56,304,2486,9.1
27234,Tom Kostopoulos,2013-14,35.0,12,18,76,76,8,10,18,79.0,938.0,534,56,88,144,680.0,82,5.46,52,291,2492,9.0
27235,Tom Kostopoulos,2014-15,36.0,13,12,81,81,4,8,12,91.0,998.0,615,60,96,156,771.0,82,5.32,47,271,2439,8.9
27236,Tom Kostopoulos,2015-16,37.0,14,1,15,15,1,0,1,13.0,136.0,630,61,96,157,784.0,48,5.31,29,160,1399,9.1
27237,Tom Kuhnhackl,2018-19,27.0,4,15,42,42,5,10,15,52.0,512.0,42,5,10,15,52.0,82,5.34,48,255,2438,9.0
27238,Tom Kuhnhackl,2019-20,28.0,5,16,57,57,4,12,16,49.0,607.0,99,9,22,31,101.0,82,5.45,47,245,2478,9.0
27239,Tom Kuhnhackl,2020-21,29.0,6,8,69,69,2,6,8,63.0,691.0,168,11,28,39,164.0,82,5.86,50,250,2620,9.2
27240,Tom Kuhnhackl,2021-22,30.0,7,9,36,36,4,5,9,30.0,457.0,204,15,33,48,194.0,82,5.96,47,239,2579,9.5
27241,Tom Kuhnhackl,2022-23,31.0,8,6,28,28,3,3,6,28.0,316.0,232,18,36,54,222.0,70,5.96,42,208,2192,9.5
27242,Tom Kurvers,1987-88,25.0,4,45,75,75,10,35,45,136.0,,75,10,35,45,136.0,80,7.77,71,321,2447,12.7
27243,Tom Kurvers,1988-89,26.0,5,30,62,62,7,23,30,69.0,,137,17,58,75,205.0,80,7.94,82,370,2484,12.8
27244,Tom Kurvers,1989-90,27.0,6,23,56,56,6,17,23,73.0,,193,23,75,98,278.0,80,7.34,72,344,2400,12.2
27245,Tom Kurvers,1990-91,28.0,7,34,56,56,5,29,34,88.0,,249,28,104,132,366.0,80,7.43,89,437,2435,12.2
27246,Tom Kurvers,1991-92,29.0,8,66,74,74,16,50,66,190.0,,323,44,154,198,556.0,80,7.48,85,403,2430,12.3
27247,Tom Kurvers,1992-93,30.0,9,52,71,71,15,37,52,156.0,,394,59,191,250,712.0,80,7.37,76,367,2421,12.2
27248,Tom Kurvers,1993-94,31.0,10,30,51,51,4,26,30,99.0,,445,63,217,280,811.0,80,6.91,71,366,2385,11.6
27249,Tom Kurvers,1994-95,32.0,11,56,74,74,9,47,56,132.0,,519,72,264,336,943.0,80,6.96,77,402,2440,11.4
27250,Tom Kurvers,1995-96,33.0,12,38,52,52,8,30,38,128.0,,571,80,294,374,1071.0,84,7.25,87,443,2603,11.7
27251,Tom Kurvers,1996-97,34.0,13,40,66,66,9,31,40,141.0,,637,89,325,414,1212.0,84,6.48,76,407,2545,10.7
27252,Tom Kurvers,1997-98,35.0,14,7,22,22,4,3,7,44.0,,659,93,328,421,1256.0,48,5.97,37,209,1408,10.2
27253,Tom Laidlaw,1983-84,25.0,4,29,80,80,6,23,29,101.0,,80,6,23,29,101.0,80,7.69,77,340,2441,12.6
27254,Tom Laidlaw,1984-85,26.0,5,21,79,79,3,18,21,62.0,,159,9,41,50,163.0,80,8.03,73,320,2489,12.9
27255,Tom Laidlaw,1985-86,27.0,6,10,80,80,0,10,10,44.0,,239,9,51,60,207.0,80,7.73,71,310,2444,12.7
27256,Tom Laidlaw,1986-87,28.0,7,18,79,79,3,15,18,64.0,,318,12,66,78,271.0,80,7.89,74,336,2448,12.9
27257,Tom Laidlaw,1987-88,29.0,8,12,61,61,1,11,12,37.0,,379,13,77,90,308.0,80,7.77,71,321,2447,12.7
27258,Tom Laidlaw,1988-89,30.0,9,18,68,68,6,12,18,49.0,,447,19,89,108,357.0,80,7.94,82,370,2484,12.8
27259,Tom Laidlaw,1989-90,31.0,10,14,74,74,1,13,14,42.0,,521,20,102,122,399.0,80,7.34,72,344,2400,12.2
27260,Tom Laidlaw,1990-91,32.0,11,13,57,57,1,12,13,30.0,,578,21,114,135,429.0,80,7.43,89,437,2435,12.2
27261,Tom Laidlaw,1991-92,33.0,12,20,70,70,3,17,20,31.0,,648,24,131,155,460.0,80,7.48,85,403,2430,12.3
27262,Tom Laidlaw,1992-93,34.0,13,9,57,57,1,8,9,27.0,,705,25,139,164,487.0,80,7.37,76,367,2421,12.2
27263,Tom Martin,1987-88,23.0,4,1,8,8,1,0,1,4.0,,8,1,0,1,4.0,80,7.77,71,321,2447,12.7
27264,Tom Martin,1988-89,24.0,5,0,5,5,0,0,0,1.0,,13,1,0,1,5.0,80,7.94,82,370,2484,12.8
27265,Tom Martin,1989-90,25.0,6,1,11,11,1,0,1,3.0,,24,2,0,2,8.0,80,7.34,72,344,2400,12.2
27266,Tom Martin,1990-91,26.0,7,3,5,5,1,2,3,8.0,,29,3,2,5,16.0,80,7.43,89,437,2435,12.2
27267,Tom Martin,1991-92,27.0,8,15,42,42,8,7,15,46.0,,71,11,9,20,62.0,80,7.48,85,403,2430,12.3
27268,Tom Martin,1992-93,28.0,9,3,21,21,1,2,3,13.0,,92,12,11,23,75.0,80,7.37,76,367,2421,12.2
27269,Tom McCarthy,1982-83,22.0,4,36,68,68,16,20,36,101.0,,68,16,20,36,101.0,80,7.03,61,280,2352,12.0
27270,Tom McCarthy,1983-84,23.0,5,48,62,62,23,25,48,147.0,,130,39,45,84,248.0,80,7.69,77,340,2441,12.6
27271,Tom McCarthy,1984-85,24.0,6,42,40,40,12,30,42,89.0,,170,51,75,126,337.0,80,8.03,73,320,2489,12.9
27272,Tom McCarthy,1985-86,25.0,7,76,80,80,28,48,76,171.0,,250,79,123,202,508.0,80,7.73,71,310,2444,12.7
27273,Tom McCarthy,1986-87,26.0,8,70,66,66,39,31,70,165.0,,316,118,154,272,673.0,80,7.89,74,336,2448,12.9
27274,Tom McCarthy,1987-88,27.0,9,37,44,44,16,21,37,80.0,,360,134,175,309,753.0,80,7.77,71,321,2447,12.7
27275,Tom McCarthy,1988-89,28.0,10,24,25,25,12,12,24,45.0,,385,146,187,333,798.0,80,7.94,82,370,2484,12.8
27276,Tom McCarthy,1989-90,29.0,11,59,68,68,30,29,59,121.0,,453,176,216,392,919.0,80,7.34,72,344,2400,12.2
27277,Tom McCarthy,1990-91,30.0,12,7,7,7,2,5,7,10.0,,460,178,221,399,929.0,80,7.43,89,437,2435,12.2
27278,Tom McMurchy,1986-87,23.0,4,4,27,27,3,1,4,21.0,,27,3,1,4,21.0,80,7.89,74,336,2448,12.9
27279,Tom McMurchy,1987-88,24.0,5,3,15,15,1,2,3,8.0,,42,4,3,7,29.0,80,7.77,71,321,2447,12.7
27280,Tom McMurchy,1988-89,25.0,6,0,4,4,0,0,0,2.0,,46,4,3,7,31.0,80,7.94,82,370,2484,12.8
27281,Tom McMurchy,1990-91,27.0,7,5,9,9,4,1,5,11.0,,55,8,4,12,42.0,80,7.43,89,437,2435,12.2
27282,Tom O'Regan,1986-87,25.0,4,14,51,51,4,10,14,44.0,,51,4,10,14,44.0,80,7.89,74,336,2448,12.9
27283,Tom O'Regan,1987-88,26.0,5,0,1,1,0,0,0,1.0,,52,4,10,14,45.0,80,7.77,71,321,2447,12.7
27284,Tom O'Regan,1988-89,27.0,6,3,9,9,1,2,3,7.0,,61,5,12,17,52.0,80,7.94,82,370,2484,12.8
27285,Tom Pederson,1995-96,26.0,4,20,44,44,7,13,20,102.0,,44,7,13,20,102.0,84,7.25,87,443,2603,11.7
27286,Tom Pederson,1996-97,27.0,5,25,74,74,6,19,25,185.0,,118,13,32,45,287.0,84,6.48,76,407,2545,10.7
27287,Tom Pederson,1997-98,28.0,6,16,47,47,5,11,16,59.0,,165,18,43,61,346.0,48,5.97,37,209,1408,10.2
27288,Tom Pederson,1998-99,29.0,7,5,60,60,1,4,5,59.0,,225,19,47,66,405.0,82,6.29,74,413,2481,10.4
27289,Tom Pederson,1999-00,30.0,8,3,15,15,1,2,3,23.0,,240,20,49,69,428.0,82,5.83,55,336,2444,9.8
27290,Tom Poti,2001-02,24.0,4,21,73,73,5,16,21,94.0,1427.0,73,5,16,21,94.0,82,5.27,57,359,2285,9.4
27291,Tom Poti,2002-03,25.0,5,35,76,76,9,26,35,125.0,1836.0,149,14,42,56,219.0,82,5.49,53,331,2294,9.8
27292,Tom Poti,2003-04,26.0,6,32,81,81,12,20,32,161.0,1842.0,230,26,62,88,380.0,82,5.51,63,376,2272,9.9
27293,Tom Poti,2004-05,27.0,7,25,66,66,2,23,25,109.0,1589.0,296,28,85,113,489.0,82,5.24,53,338,2262,9.5
27294,Tom Poti,2005-06,28.0,8,48,80,80,11,37,48,148.0,1977.0,376,39,122,161,637.0,82,5.31,60,363,2326,9.4
27295,Tom Poti,2006-07,29.0,9,24,67,67,10,14,24,124.0,1506.0,443,49,136,185,761.0,82,5.14,57,348,2300,9.2
27296,Tom Poti,2008-09,31.0,10,23,73,73,3,20,23,122.0,1517.0,516,52,156,208,883.0,82,6.05,85,480,2458,10.1
27297,Tom Poti,2009-10,32.0,11,44,78,78,6,38,44,134.0,2006.0,594,58,194,252,1017.0,82,5.76,70,398,2426,9.7
27298,Tom Poti,2010-11,33.0,12,29,71,71,2,27,29,99.0,1667.0,665,60,221,281,1116.0,82,5.44,62,351,2383,9.4
27299,Tom Poti,2011-12,34.0,13,13,52,52,3,10,13,48.0,1100.0,717,63,231,294,1164.0,82,5.7,65,341,2477,9.4
27300,Tom Poti,2012-13,35.0,14,24,70,70,4,20,24,69.0,1498.0,787,67,251,318,1233.0,82,5.53,56,304,2486,9.1
27301,Tom Poti,2013-14,36.0,15,7,21,21,2,5,7,20.0,386.0,808,69,256,325,1253.0,82,5.46,52,291,2492,9.0
27302,Tom Poti,2015-16,38.0,16,2,16,16,0,2,2,8.0,244.0,824,69,258,327,1261.0,48,5.31,29,160,1399,9.1
27303,Tom Preissing,2006-07,28.0,4,19,69,69,2,17,19,89.0,1255.0,69,2,17,19,89.0,82,5.14,57,348,2300,9.2
27304,Tom Preissing,2008-09,30.0,5,43,74,74,11,32,43,131.0,1517.0,143,13,49,62,220.0,82,6.05,85,480,2458,10.1
27305,Tom Preissing,2009-10,31.0,6,38,80,80,7,31,38,94.0,1220.0,223,20,80,100,314.0,82,5.76,70,398,2426,9.7
27306,Tom Preissing,2010-11,32.0,7,24,77,77,8,16,24,93.0,1377.0,300,28,96,124,407.0,82,5.44,62,351,2383,9.4
27307,Tom Preissing,2011-12,33.0,8,7,22,22,3,4,7,40.0,368.0,322,31,100,131,447.0,82,5.7,65,341,2477,9.4
27308,Tom Preissing,2012-13,34.0,9,1,4,4,0,1,1,6.0,52.0,326,31,101,132,453.0,82,5.53,56,304,2486,9.1
27309,Tom Pyatt,2012-13,25.0,4,5,40,40,2,3,5,48.0,443.0,40,2,3,5,48.0,82,5.53,56,304,2486,9.1
27310,Tom Pyatt,2013-14,26.0,5,7,61,61,2,5,7,65.0,649.0,101,4,8,12,113.0,82,5.46,52,291,2492,9.0
27311,Tom Pyatt,2014-15,27.0,6,19,74,74,12,7,19,95.0,1095.0,175,16,15,31,208.0,82,5.32,47,271,2439,8.9
27312,Tom Pyatt,2015-16,28.0,7,16,43,43,8,8,16,60.0,584.0,218,24,23,47,268.0,48,5.31,29,160,1399,9.1
27313,Tom Pyatt,2016-17,29.0,8,7,27,27,3,4,7,27.0,309.0,245,27,27,54,295.0,82,5.34,48,269,2463,8.9
27314,Tom Pyatt,2019-20,32.0,9,23,82,82,9,14,23,95.0,1281.0,327,36,41,77,390.0,82,5.45,47,245,2478,9.0
27315,Tom Pyatt,2020-21,33.0,10,22,81,81,7,15,22,103.0,1138.0,408,43,56,99,493.0,82,5.86,50,250,2620,9.2
27316,Tom Pyatt,2021-22,34.0,11,2,37,37,0,2,2,29.0,433.0,445,43,58,101,522.0,82,5.96,47,239,2579,9.5
27317,Tom Roulston,1983-84,26.0,4,2,11,11,1,1,2,9.0,,11,1,1,2,9.0,80,7.69,77,340,2441,12.6
27318,Tom Roulston,1984-85,27.0,5,14,35,35,11,3,14,54.0,,46,12,4,16,63.0,80,8.03,73,320,2489,12.9
27319,Tom Roulston,1985-86,28.0,6,40,67,67,19,21,40,107.0,,113,31,25,56,170.0,80,7.73,71,310,2444,12.7
27320,Tom Roulston,1986-87,29.0,7,40,77,77,16,24,40,148.0,,190,47,49,96,318.0,80,7.89,74,336,2448,12.9
27321,Tom Roulston,1988-89,31.0,8,0,5,5,0,0,0,6.0,,195,47,49,96,324.0,80,7.94,82,370,2484,12.8
27322,Tom Sestito,2010-11,23.0,4,0,1,1,0,0,0,0.0,5.0,1,0,0,0,0.0,82,5.44,62,351,2383,9.4
27323,Tom Sestito,2012-13,25.0,5,0,3,3,0,0,0,0.0,17.0,4,0,0,0,0.0,82,5.53,56,304,2486,9.1
27324,Tom Sestito,2013-14,26.0,6,4,9,9,2,2,4,7.0,86.0,13,2,2,4,7.0,82,5.46,52,291,2492,9.0
27325,Tom Sestito,2014-15,27.0,7,1,14,14,0,1,1,4.0,97.0,27,2,3,5,11.0,82,5.32,47,271,2439,8.9
27326,Tom Sestito,2015-16,28.0,8,3,30,30,3,0,3,14.0,193.0,57,5,3,8,25.0,48,5.31,29,160,1399,9.1
27327,Tom Sestito,2016-17,29.0,9,9,77,77,5,4,9,31.0,497.0,134,10,7,17,56.0,82,5.34,48,269,2463,8.9
27328,Tom Sestito,2017-18,30.0,10,1,3,3,0,1,1,1.0,19.0,137,10,8,18,57.0,82,5.32,47,251,2453,8.9
27329,Tom Sestito,2018-19,31.0,11,1,4,4,0,1,1,1.0,23.0,141,10,9,19,58.0,82,5.34,48,255,2438,9.0
27330,Tom Sestito,2019-20,32.0,12,2,13,13,0,2,2,3.0,72.0,154,10,11,21,61.0,82,5.45,47,245,2478,9.0
27331,Tom Thornbury,1986-87,23.0,4,9,14,14,1,8,9,44.0,,14,1,8,9,44.0,80,7.89,74,336,2448,12.9
27332,Tom Tilley,1991-92,26.0,4,23,70,70,1,22,23,77.0,,70,1,22,23,77.0,80,7.48,85,403,2430,12.3
27333,Tom Tilley,1992-93,27.0,5,5,34,34,0,5,5,19.0,,104,1,27,28,96.0,80,7.37,76,367,2421,12.2
27334,Tom Tilley,1993-94,28.0,6,6,22,22,2,4,6,28.0,,126,3,31,34,124.0,80,6.91,71,366,2385,11.6
27335,Tom Tilley,1996-97,31.0,7,8,48,48,1,7,8,41.0,,174,4,38,42,165.0,84,6.48,76,407,2545,10.7
27336,Tom Wandell,2011-12,25.0,4,3,14,14,1,2,3,23.0,156.0,14,1,2,3,23.0,82,5.7,65,341,2477,9.4
27337,Tom Wandell,2012-13,26.0,5,15,50,50,5,10,15,85.0,694.0,64,6,12,18,108.0,82,5.53,56,304,2486,9.1
27338,Tom Wandell,2013-14,27.0,6,9,75,75,7,2,9,94.0,882.0,139,13,14,27,202.0,82,5.46,52,291,2492,9.0
27339,Tom Wandell,2014-15,28.0,7,15,72,72,6,9,15,103.0,701.0,211,19,23,42,305.0,82,5.32,47,271,2439,8.9
27340,Tom Wandell,2015-16,29.0,8,1,18,18,1,0,1,14.0,152.0,229,20,23,43,319.0,48,5.31,29,160,1399,9.1
27341,Tom Wilson,2016-17,22.0,4,10,82,82,3,7,10,63.0,651.0,82,3,7,10,63.0,82,5.34,48,269,2463,8.9
27342,Tom Wilson,2017-18,23.0,5,17,67,67,4,13,17,79.0,733.0,149,7,20,27,142.0,82,5.32,47,251,2453,8.9
27343,Tom Wilson,2018-19,24.0,6,23,82,82,7,16,23,99.0,1059.0,231,14,36,50,241.0,82,5.34,48,255,2438,9.0
27344,Tom Wilson,2019-20,25.0,7,19,82,82,7,12,19,95.0,1060.0,313,21,48,69,336.0,82,5.45,47,245,2478,9.0
27345,Tom Wilson,2020-21,26.0,8,35,78,78,14,21,35,123.0,1247.0,391,35,69,104,459.0,82,5.86,50,250,2620,9.2
27346,Tom Wilson,2021-22,27.0,9,40,63,63,22,18,40,130.0,1143.0,454,57,87,144,589.0,82,5.96,47,239,2579,9.5
27347,Tom Wilson,2022-23,28.0,10,44,68,68,21,23,44,154.0,1242.0,522,78,110,188,743.0,70,5.96,42,208,2192,9.5
27348,Tomas Divisek,2003-04,24.0,4,0,2,2,0,0,0,2.0,23.0,2,0,0,0,2.0,82,5.51,63,376,2272,9.9
27349,Tomas Divisek,2004-05,25.0,5,1,3,3,1,0,1,3.0,25.0,5,1,0,1,5.0,82,5.24,53,338,2262,9.5
27350,Tomas Fleischmann,2008-09,24.0,4,2,14,14,0,2,2,11.0,95.0,14,0,2,2,11.0,82,6.05,85,480,2458,10.1
27351,Tomas Fleischmann,2009-10,25.0,5,8,29,29,4,4,8,52.0,337.0,43,4,6,10,63.0,82,5.76,70,398,2426,9.7
27352,Tomas Fleischmann,2010-11,26.0,6,30,75,75,10,20,30,107.0,947.0,118,14,26,40,170.0,82,5.44,62,351,2383,9.4
27353,Tomas Fleischmann,2011-12,27.0,7,37,73,73,19,18,37,131.0,1101.0,191,33,44,77,301.0,82,5.7,65,341,2477,9.4
27354,Tomas Fleischmann,2012-13,28.0,8,51,69,69,23,28,51,121.0,1106.0,260,56,72,128,422.0,82,5.53,56,304,2486,9.1
27355,Tomas Fleischmann,2013-14,29.0,9,31,45,45,12,19,31,98.0,736.0,305,68,91,159,520.0,82,5.46,52,291,2492,9.0
27356,Tomas Fleischmann,2014-15,30.0,10,61,82,82,27,34,61,217.0,1566.0,387,95,125,220,737.0,82,5.32,47,271,2439,8.9
27357,Tomas Fleischmann,2015-16,31.0,11,35,48,48,12,23,35,121.0,899.0,435,107,148,255,858.0,48,5.31,29,160,1399,9.1
27358,Tomas Fleischmann,2016-17,32.0,12,28,80,80,8,20,28,188.0,1370.0,515,115,168,283,1046.0,82,5.34,48,269,2463,8.9
27359,Tomas Fleischmann,2017-18,33.0,13,27,66,66,8,19,27,131.0,970.0,581,123,187,310,1177.0,82,5.32,47,251,2453,8.9
27360,Tomas Fleischmann,2018-19,34.0,14,25,76,76,14,11,25,123.0,1156.0,657,137,198,335,1300.0,82,5.34,48,255,2438,9.0
27361,Tomas Forslund,1994-95,26.0,4,14,38,38,5,9,14,48.0,,38,5,9,14,48.0,80,6.96,77,402,2440,11.4
27362,Tomas Forslund,1995-96,27.0,5,2,6,6,0,2,2,3.0,,44,5,11,16,51.0,84,7.25,87,443,2603,11.7
27363,Tomas Hertl,2016-17,23.0,4,25,37,37,15,10,25,98.0,567.0,37,15,10,25,98.0,82,5.34,48,269,2463,8.9
27364,Tomas Hertl,2017-18,24.0,5,31,82,82,13,18,31,145.0,1193.0,119,28,28,56,243.0,82,5.32,47,251,2453,8.9
27365,Tomas Hertl,2018-19,25.0,6,46,81,81,21,25,46,202.0,1294.0,200,49,53,102,445.0,82,5.34,48,255,2438,9.0
27366,Tomas Hertl,2019-20,26.0,7,22,49,49,10,12,22,100.0,844.0,249,59,65,124,545.0,82,5.45,47,245,2478,9.0
27367,Tomas Hertl,2020-21,27.0,8,46,79,79,22,24,46,175.0,1430.0,328,81,89,170,720.0,82,5.86,50,250,2620,9.2
27368,Tomas Hertl,2021-22,28.0,9,74,77,77,35,39,74,176.0,1465.0,405,116,128,244,896.0,82,5.96,47,239,2579,9.5
27369,Tomas Hertl,2022-23,29.0,10,36,48,48,16,20,36,117.0,885.0,453,132,148,280,1013.0,70,5.96,42,208,2192,9.5
27370,Tomas Holmstrom,1999-00,27.0,4,9,47,47,6,3,9,53.0,,47,6,3,9,53.0,82,5.83,55,336,2444,9.8
27371,Tomas Holmstrom,2000-01,28.0,5,22,57,57,5,17,22,48.0,,104,11,20,31,101.0,82,5.28,57,380,2242,9.6
27372,Tomas Holmstrom,2001-02,29.0,6,34,82,82,13,21,34,100.0,1014.0,186,24,41,65,201.0,82,5.27,57,359,2285,9.4
27373,Tomas Holmstrom,2002-03,30.0,7,35,72,72,13,22,35,71.0,871.0,258,37,63,100,272.0,82,5.49,53,331,2294,9.8
27374,Tomas Holmstrom,2003-04,31.0,8,40,73,73,16,24,40,74.0,852.0,331,53,87,140,346.0,82,5.51,63,376,2272,9.9
27375,Tomas Holmstrom,2004-05,32.0,9,26,69,69,8,18,26,79.0,855.0,400,61,105,166,425.0,82,5.24,53,338,2262,9.5
27376,Tomas Holmstrom,2005-06,33.0,10,40,74,74,20,20,40,109.0,922.0,474,81,125,206,534.0,82,5.31,60,363,2326,9.4
27377,Tomas Holmstrom,2006-07,34.0,11,30,67,67,15,15,30,74.0,830.0,541,96,140,236,608.0,82,5.14,57,348,2300,9.2
27378,Tomas Holmstrom,2008-09,36.0,12,59,81,81,29,30,59,140.0,1132.0,622,125,170,295,748.0,82,6.05,85,480,2458,10.1
27379,Tomas Holmstrom,2009-10,37.0,13,52,77,77,30,22,52,176.0,1171.0,699,155,192,347,924.0,82,5.76,70,398,2426,9.7
27380,Tomas Holmstrom,2010-11,38.0,14,40,59,59,20,20,40,137.0,1035.0,758,175,212,387,1061.0,82,5.44,62,351,2383,9.4
27381,Tomas Holmstrom,2011-12,39.0,15,37,53,53,14,23,37,75.0,809.0,811,189,235,424,1136.0,82,5.7,65,341,2477,9.4
27382,Tomas Holmstrom,2012-13,40.0,16,45,68,68,25,20,45,131.0,1075.0,879,214,255,469,1267.0,82,5.53,56,304,2486,9.1
27383,Tomas Holmstrom,2013-14,41.0,17,37,73,73,18,19,37,125.0,1081.0,952,232,274,506,1392.0,82,5.46,52,291,2492,9.0
27384,Tomas Holmstrom,2014-15,42.0,18,24,74,74,11,13,24,97.0,879.0,1026,243,287,530,1489.0,82,5.32,47,271,2439,8.9
27385,Tomas Hyka,2020-21,27.0,4,3,10,10,1,2,3,15.0,121.0,10,1,2,3,15.0,82,5.86,50,250,2620,9.2
27386,Tomas Hyka,2021-22,28.0,5,4,17,17,1,3,4,22.0,200.0,27,2,5,7,37.0,82,5.96,47,239,2579,9.5
27387,Tomas Jelinek,1995-96,33.0,4,13,49,49,7,6,13,60.0,,49,7,6,13,60.0,84,7.25,87,443,2603,11.7
27388,Tomas Jonsson,1984-85,24.0,4,34,70,70,9,25,34,89.0,,70,9,25,34,89.0,80,8.03,73,320,2489,12.9
27389,Tomas Jonsson,1985-86,25.0,5,48,72,72,13,35,48,99.0,,142,22,60,82,188.0,80,7.73,71,310,2444,12.7
27390,Tomas Jonsson,1986-87,26.0,6,47,72,72,11,36,47,122.0,,214,33,96,129,310.0,80,7.89,74,336,2448,12.9
27391,Tomas Jonsson,1987-88,27.0,7,50,69,69,16,34,50,128.0,,283,49,130,179,438.0,80,7.77,71,321,2447,12.7
27392,Tomas Jonsson,1988-89,28.0,8,44,77,77,14,30,44,119.0,,360,63,160,223,557.0,80,7.94,82,370,2484,12.8
27393,Tomas Jonsson,1989-90,29.0,9,31,47,47,6,25,31,99.0,,407,69,185,254,656.0,80,7.34,72,344,2400,12.2
27394,Tomas Jonsson,1990-91,30.0,10,47,72,72,6,41,47,121.0,,479,75,226,301,777.0,80,7.43,89,437,2435,12.2
27395,Tomas Jonsson,1991-92,31.0,11,43,73,73,10,33,43,149.0,,552,85,259,344,926.0,80,7.48,85,403,2430,12.3
27396,Tomas Jurco,2016-17,24.0,4,15,36,36,8,7,15,77.0,485.0,36,8,7,15,77.0,82,5.34,48,269,2463,8.9
27397,Tomas Jurco,2017-18,25.0,5,18,63,63,3,15,18,92.0,725.0,99,11,22,33,169.0,82,5.32,47,251,2453,8.9
27398,Tomas Jurco,2018-19,26.0,6,6,44,44,4,2,6,43.0,404.0,143,15,24,39,212.0,82,5.34,48,255,2438,9.0
27399,Tomas Jurco,2019-20,27.0,7,1,29,29,1,0,1,35.0,308.0,172,16,24,40,247.0,82,5.45,47,245,2478,9.0
27400,Tomas Jurco,2020-21,28.0,8,10,29,29,6,4,10,44.0,366.0,201,22,28,50,291.0,82,5.86,50,250,2620,9.2
27401,Tomas Jurco,2022-23,30.0,9,2,12,12,0,2,2,7.0,120.0,213,22,30,52,298.0,70,5.96,42,208,2192,9.5
27402,Tomas Kaberle,2001-02,23.0,4,22,57,57,4,18,22,71.0,1066.0,57,4,18,22,71.0,82,5.27,57,359,2285,9.4
27403,Tomas Kaberle,2002-03,24.0,5,40,82,82,7,33,40,82.0,1879.0,139,11,51,62,153.0,82,5.49,53,331,2294,9.8
27404,Tomas Kaberle,2003-04,25.0,6,45,82,82,6,39,45,96.0,1860.0,221,17,90,107,249.0,82,5.51,63,376,2272,9.9
27405,Tomas Kaberle,2004-05,26.0,7,39,69,69,10,29,39,85.0,1725.0,290,27,119,146,334.0,82,5.24,53,338,2262,9.5
27406,Tomas Kaberle,2005-06,27.0,8,47,82,82,11,36,47,119.0,2037.0,372,38,155,193,453.0,82,5.31,60,363,2326,9.4
27407,Tomas Kaberle,2006-07,28.0,9,31,71,71,3,28,31,88.0,1647.0,443,41,183,224,541.0,82,5.14,57,348,2300,9.2
27408,Tomas Kaberle,2008-09,30.0,10,67,82,82,9,58,67,163.0,2310.0,525,50,241,291,704.0,82,6.05,85,480,2458,10.1
27409,Tomas Kaberle,2009-10,31.0,11,58,74,74,11,47,58,128.0,1915.0,599,61,288,349,832.0,82,5.76,70,398,2426,9.7
27410,Tomas Kaberle,2010-11,32.0,12,53,82,82,8,45,53,155.0,2039.0,681,69,333,402,987.0,82,5.44,62,351,2383,9.4
27411,Tomas Kaberle,2011-12,33.0,13,31,57,57,4,27,31,93.0,1337.0,738,73,360,433,1080.0,82,5.7,65,341,2477,9.4
27412,Tomas Kaberle,2012-13,34.0,14,49,82,82,7,42,49,158.0,1833.0,820,80,402,482,1238.0,82,5.53,56,304,2486,9.1
27413,Tomas Kaberle,2013-14,35.0,15,47,82,82,4,43,47,130.0,1813.0,902,84,445,529,1368.0,82,5.46,52,291,2492,9.0
27414,Tomas Kaberle,2014-15,36.0,16,31,72,72,3,28,31,87.0,1276.0,974,87,473,560,1455.0,82,5.32,47,271,2439,8.9
27415,Tomas Kaberle,2015-16,37.0,17,3,10,10,0,3,3,11.0,135.0,984,87,476,563,1466.0,48,5.31,29,160,1399,9.1
27416,Tomas Kana,2012-13,25.0,4,2,6,6,0,2,2,4.0,52.0,6,0,2,2,4.0,82,5.53,56,304,2486,9.1
27417,Tomas Kloucek,2003-04,23.0,4,5,43,43,1,4,5,22.0,719.0,43,1,4,5,22.0,82,5.51,63,376,2272,9.9
27418,Tomas Kloucek,2004-05,24.0,5,4,52,52,1,3,4,21.0,623.0,95,2,7,9,43.0,82,5.24,53,338,2262,9.5
27419,Tomas Kloucek,2005-06,25.0,6,0,3,3,0,0,0,1.0,29.0,98,2,7,9,44.0,82,5.31,60,363,2326,9.4
27420,Tomas Kloucek,2006-07,26.0,7,1,42,42,0,1,1,12.0,354.0,140,2,8,10,56.0,82,5.14,57,348,2300,9.2
27421,Tomas Kloucek,2008-09,28.0,8,0,1,1,0,0,0,0.0,3.0,141,2,8,10,56.0,82,6.05,85,480,2458,10.1
27422,Tomas Kopecky,2008-09,26.0,4,0,1,1,0,0,0,1.0,10.0,1,0,0,0,1.0,82,6.05,85,480,2458,10.1
27423,Tomas Kopecky,2009-10,27.0,5,1,26,26,1,0,1,27.0,189.0,27,1,0,1,28.0,82,5.76,70,398,2426,9.7
27424,Tomas Kopecky,2010-11,28.0,6,12,77,77,5,7,12,87.0,740.0,104,6,7,13,115.0,82,5.44,62,351,2383,9.4
27425,Tomas Kopecky,2011-12,29.0,7,19,79,79,6,13,19,110.0,823.0,183,12,20,32,225.0,82,5.7,65,341,2477,9.4
27426,Tomas Kopecky,2012-13,30.0,8,21,74,74,10,11,21,95.0,701.0,257,22,31,53,320.0,82,5.53,56,304,2486,9.1
27427,Tomas Kopecky,2013-14,31.0,9,42,81,81,15,27,42,178.0,1241.0,338,37,58,95,498.0,82,5.46,52,291,2492,9.0
27428,Tomas Kopecky,2014-15,32.0,10,32,80,80,10,22,32,143.0,1382.0,418,47,80,127,641.0,82,5.32,47,271,2439,8.9
27429,Tomas Kopecky,2015-16,33.0,11,27,47,47,15,12,27,92.0,831.0,465,62,92,154,733.0,48,5.31,29,160,1399,9.1
27430,Tomas Kopecky,2016-17,34.0,12,12,49,49,4,8,12,95.0,778.0,514,66,100,166,828.0,82,5.34,48,269,2463,8.9
27431,Tomas Kopecky,2017-18,35.0,13,8,64,64,2,6,8,106.0,826.0,578,68,106,174,934.0,82,5.32,47,251,2453,8.9
27432,Tomas Kubalik,2013-14,23.0,4,2,4,4,0,2,2,5.0,59.0,4,0,2,2,5.0,82,5.46,52,291,2492,9.0
27433,Tomas Kubalik,2014-15,24.0,5,2,8,8,1,1,2,8.0,106.0,12,1,3,4,13.0,82,5.32,47,271,2439,8.9
27434,Tomas Kundratek,2014-15,25.0,4,0,5,5,0,0,0,2.0,49.0,5,0,0,0,2.0,82,5.32,47,271,2439,8.9
27435,Tomas Kundratek,2015-16,26.0,5,7,25,25,1,6,7,23.0,404.0,30,1,6,7,25.0,48,5.31,29,160,1399,9.1
27436,Tomas Kurka,2005-06,24.0,4,5,14,14,3,2,5,22.0,210.0,14,3,2,5,22.0,82,5.31,60,363,2326,9.4
27437,Tomas Kurka,2006-07,25.0,5,0,3,3,0,0,0,3.0,26.0,17,3,2,5,25.0,82,5.14,57,348,2300,9.2
27438,Tomas Malec,2005-06,23.0,4,2,41,41,0,2,2,30.0,460.0,41,0,2,2,30.0,82,5.31,60,363,2326,9.4
27439,Tomas Malec,2006-07,24.0,5,0,2,2,0,0,0,1.0,19.0,43,0,2,2,31.0,82,5.14,57,348,2300,9.2
27440,Tomas Malec,2008-09,26.0,6,0,2,2,0,0,0,1.0,23.0,45,0,2,2,32.0,82,6.05,85,480,2458,10.1
27441,Tomas Malec,2009-10,27.0,7,0,1,1,0,0,0,1.0,15.0,46,0,2,2,33.0,82,5.76,70,398,2426,9.7
27442,Tomas Mojzis,2008-09,26.0,4,1,7,7,0,1,1,7.0,98.0,7,0,1,1,7.0,82,6.05,85,480,2458,10.1
27443,Tomas Mojzis,2009-10,27.0,5,1,6,6,1,0,1,7.0,60.0,13,1,1,2,14.0,82,5.76,70,398,2426,9.7
27444,Tomas Mojzis,2011-12,29.0,6,1,4,4,0,1,1,2.0,29.0,17,1,2,3,16.0,82,5.7,65,341,2477,9.4
27445,Tomas Nosek,2018-19,26.0,4,0,6,6,0,0,0,2.0,61.0,6,0,0,0,2.0,82,5.34,48,255,2438,9.0
27446,Tomas Nosek,2019-20,27.0,5,1,11,11,1,0,1,19.0,111.0,17,1,0,1,21.0,82,5.45,47,245,2478,9.0
27447,Tomas Nosek,2020-21,28.0,6,15,67,67,7,8,15,92.0,743.0,84,8,8,16,113.0,82,5.86,50,250,2620,9.2
27448,Tomas Nosek,2021-22,29.0,7,17,68,68,8,9,17,116.0,848.0,152,16,17,33,229.0,82,5.96,47,239,2579,9.5
27449,Tomas Nosek,2022-23,30.0,8,15,67,67,8,7,15,93.0,778.0,219,24,24,48,322.0,70,5.96,42,208,2192,9.5
27450,Tomas Plekanec,2006-07,24.0,4,0,2,2,0,0,0,0.0,18.0,2,0,0,0,0.0,82,5.14,57,348,2300,9.2
27451,Tomas Plekanec,2008-09,26.0,5,29,67,67,9,20,29,99.0,888.0,69,9,20,29,99.0,82,6.05,85,480,2458,10.1
27452,Tomas Plekanec,2009-10,27.0,6,47,81,81,20,27,47,150.0,1294.0,150,29,47,76,249.0,82,5.76,70,398,2426,9.7
27453,Tomas Plekanec,2010-11,28.0,7,69,81,81,29,40,69,186.0,1464.0,231,58,87,145,435.0,82,5.44,62,351,2383,9.4
27454,Tomas Plekanec,2011-12,29.0,8,39,80,80,20,19,39,202.0,1380.0,311,78,106,184,637.0,82,5.7,65,341,2477,9.4
27455,Tomas Plekanec,2012-13,30.0,9,70,82,82,25,45,70,216.0,1637.0,393,103,151,254,853.0,82,5.53,56,304,2486,9.1
27456,Tomas Plekanec,2013-14,31.0,10,57,77,77,22,35,57,227.0,1559.0,470,125,186,311,1080.0,82,5.46,52,291,2492,9.0
27457,Tomas Plekanec,2014-15,32.0,11,52,81,81,17,35,52,220.0,1681.0,551,142,221,363,1300.0,82,5.32,47,271,2439,8.9
27458,Tomas Plekanec,2015-16,33.0,12,33,47,47,14,19,33,133.0,903.0,598,156,240,396,1433.0,48,5.31,29,160,1399,9.1
27459,Tomas Plekanec,2016-17,34.0,13,43,81,81,20,23,43,199.0,1602.0,679,176,263,439,1632.0,82,5.34,48,269,2463,8.9
27460,Tomas Plekanec,2017-18,35.0,14,60,82,82,26,34,60,248.0,1571.0,761,202,297,499,1880.0,82,5.32,47,251,2453,8.9
27461,Tomas Plekanec,2018-19,36.0,15,54,82,82,14,40,54,189.0,1520.0,843,216,337,553,2069.0,82,5.34,48,255,2438,9.0
27462,Tomas Plekanec,2019-20,37.0,16,28,78,78,10,18,28,139.0,1312.0,921,226,355,581,2208.0,82,5.45,47,245,2478,9.0
27463,Tomas Plekanec,2020-21,38.0,17,26,77,77,6,20,26,144.0,1165.0,998,232,375,607,2352.0,82,5.86,50,250,2620,9.2
27464,Tomas Plekanec,2021-22,39.0,18,1,3,3,1,0,1,8.0,33.0,1001,233,375,608,2360.0,82,5.96,47,239,2579,9.5
27465,Tomas Plihal,2009-10,26.0,4,0,3,3,0,0,0,10.0,29.0,3,0,0,0,10.0,82,5.76,70,398,2426,9.7
27466,Tomas Plihal,2010-11,27.0,5,3,22,22,2,1,3,34.0,238.0,25,2,1,3,44.0,82,5.44,62,351,2383,9.4
27467,Tomas Plihal,2011-12,28.0,6,13,64,64,5,8,13,79.0,649.0,89,7,9,16,123.0,82,5.7,65,341,2477,9.4
27468,Tomas Sandstrom,1987-88,23.0,4,58,74,74,29,29,58,188.0,,74,29,29,58,188.0,80,7.77,71,321,2447,12.7
27469,Tomas Sandstrom,1988-89,24.0,5,54,73,73,25,29,54,238.0,,147,54,58,112,426.0,80,7.94,82,370,2484,12.8
27470,Tomas Sandstrom,1989-90,25.0,6,74,64,64,40,34,74,241.0,,211,94,92,186,667.0,80,7.34,72,344,2400,12.2
27471,Tomas Sandstrom,1990-91,26.0,7,68,69,69,28,40,68,204.0,,280,122,132,254,871.0,80,7.43,89,437,2435,12.2
27472,Tomas Sandstrom,1991-92,27.0,8,88,79,79,32,56,88,240.0,,359,154,188,342,1111.0,80,7.48,85,403,2430,12.3
27473,Tomas Sandstrom,1992-93,28.0,9,71,76,76,32,39,71,249.0,,435,186,227,413,1360.0,80,7.37,76,367,2421,12.2
27474,Tomas Sandstrom,1993-94,29.0,10,89,68,68,45,44,89,221.0,,503,231,271,502,1581.0,80,6.91,71,366,2385,11.6
27475,Tomas Sandstrom,1994-95,30.0,11,39,49,49,17,22,39,147.0,,552,248,293,541,1728.0,80,6.96,77,402,2440,11.4
27476,Tomas Sandstrom,1995-96,31.0,12,52,39,39,25,27,52,134.0,,591,273,320,593,1862.0,84,7.25,87,443,2603,11.7
27477,Tomas Sandstrom,1996-97,32.0,13,58,78,78,23,35,58,193.0,,669,296,355,651,2055.0,84,6.48,76,407,2545,10.7
27478,Tomas Sandstrom,1997-98,33.0,14,44,47,47,21,23,44,116.0,,716,317,378,695,2171.0,48,5.97,37,209,1408,10.2
27479,Tomas Sandstrom,1998-99,34.0,15,70,58,58,35,35,70,187.0,,774,352,413,765,2358.0,82,6.29,74,413,2481,10.4
27480,Tomas Sandstrom,1999-00,35.0,16,42,74,74,18,24,42,139.0,,848,370,437,807,2497.0,82,5.83,55,336,2444,9.8
27481,Tomas Sandstrom,2000-01,36.0,17,17,77,77,9,8,17,136.0,,925,379,445,824,2633.0,82,5.28,57,380,2242,9.6
27482,Tomas Sandstrom,2001-02,37.0,18,32,58,58,15,17,32,107.0,1007.0,983,394,462,856,2740.0,82,5.27,57,359,2285,9.4
27483,Tomas Srsen,1993-94,27.0,4,0,2,2,0,0,0,2.0,,2,0,0,0,2.0,80,6.91,71,366,2385,11.6
27484,Tomas Surovy,2005-06,24.0,4,11,26,26,4,7,11,47.0,372.0,26,4,7,11,47.0,82,5.31,60,363,2326,9.4
27485,Tomas Surovy,2006-07,25.0,5,23,47,47,11,12,23,112.0,586.0,73,15,19,34,159.0,82,5.14,57,348,2300,9.2
27486,Tomas Surovy,2008-09,27.0,6,25,53,53,12,13,25,107.0,720.0,126,27,32,59,266.0,82,6.05,85,480,2458,10.1
27487,Tomas Tatar,2013-14,23.0,4,1,9,9,1,0,1,6.0,86.0,9,1,0,1,6.0,82,5.46,52,291,2492,9.0
27488,Tomas Tatar,2015-16,25.0,5,7,18,18,4,3,7,32.0,205.0,27,5,3,8,38.0,48,5.31,29,160,1399,9.1
27489,Tomas Tatar,2016-17,26.0,6,39,73,73,19,20,39,158.0,1048.0,100,24,23,47,196.0,82,5.34,48,269,2463,8.9
27490,Tomas Tatar,2017-18,27.0,7,56,82,82,29,27,56,211.0,1330.0,182,53,50,103,407.0,82,5.32,47,251,2453,8.9
27491,Tomas Tatar,2018-19,28.0,8,45,81,81,21,24,45,165.0,1162.0,263,74,74,148,572.0,82,5.34,48,255,2438,9.0
27492,Tomas Tatar,2019-20,29.0,9,46,82,82,25,21,46,166.0,1417.0,345,99,95,194,738.0,82,5.45,47,245,2478,9.0
27493,Tomas Tatar,2020-21,30.0,10,34,82,82,20,14,34,174.0,1334.0,427,119,109,228,912.0,82,5.86,50,250,2620,9.2
27494,Tomas Tatar,2021-22,31.0,11,58,80,80,25,33,58,195.0,1313.0,507,144,142,286,1107.0,82,5.96,47,239,2579,9.5
27495,Tomas Tatar,2022-23,32.0,12,61,68,68,22,39,61,162.0,1108.0,575,166,181,347,1269.0,70,5.96,42,208,2192,9.5
27496,Tomas Vincour,2013-14,23.0,4,2,24,24,1,1,2,26.0,226.0,24,1,1,2,26.0,82,5.46,52,291,2492,9.0
27497,Tomas Vincour,2014-15,24.0,5,10,47,47,4,6,10,65.0,485.0,71,5,7,12,91.0,82,5.32,47,271,2439,8.9
27498,Tomas Vincour,2015-16,25.0,6,4,17,17,2,2,4,12.0,151.0,88,7,9,16,103.0,48,5.31,29,160,1399,9.1
27499,Tomas Vincour,2017-18,27.0,7,1,7,7,0,1,1,2.0,50.0,95,7,10,17,105.0,82,5.32,47,251,2453,8.9
27500,Tomas Vlasak,2003-04,28.0,4,4,10,10,1,3,4,15.0,115.0,10,1,3,4,15.0,82,5.51,63,376,2272,9.9
27501,Tomas Zizka,2005-06,26.0,4,3,10,10,0,3,3,12.0,154.0,10,0,3,3,12.0,82,5.31,60,363,2326,9.4
27502,Tomas Zizka,2006-07,27.0,5,5,15,15,2,3,5,24.0,254.0,25,2,6,8,36.0,82,5.14,57,348,2300,9.2
27503,Tomi Kallio,2003-04,27.0,4,27,56,56,14,13,27,115.0,912.0,56,14,13,27,115.0,82,5.51,63,376,2272,9.9
27504,Tomi Kallio,2004-05,28.0,5,22,60,60,8,14,22,102.0,885.0,116,22,27,49,217.0,82,5.24,53,338,2262,9.5
27505,Tomi Kallio,2005-06,29.0,6,6,24,24,2,4,6,28.0,309.0,140,24,31,55,245.0,82,5.31,60,363,2326,9.4
27506,Tomi Maki,2009-10,26.0,4,0,1,1,0,0,0,0.0,11.0,1,0,0,0,0.0,82,5.76,70,398,2426,9.7
27507,Tomi Pettinen,2005-06,28.0,4,0,2,2,0,0,0,0.0,23.0,2,0,0,0,0.0,82,5.31,60,363,2326,9.4
27508,Tomi Pettinen,2006-07,29.0,5,0,4,4,0,0,0,2.0,42.0,6,0,0,0,2.0,82,5.14,57,348,2300,9.2
27509,Tomi Pettinen,2008-09,31.0,6,0,18,18,0,0,0,7.0,264.0,24,0,0,0,9.0,82,6.05,85,480,2458,10.1
27510,Tommi Santala,2006-07,27.0,4,3,33,33,1,2,3,23.0,334.0,33,1,2,3,23.0,82,5.14,57,348,2300,9.2
27511,Tommi Santala,2009-10,30.0,5,6,30,30,1,5,6,20.0,221.0,63,2,7,9,43.0,82,5.76,70,398,2426,9.7
27512,Tommy Albelin,1990-91,26.0,4,26,60,60,3,23,26,98.0,,60,3,23,26,98.0,80,7.43,89,437,2435,12.2
27513,Tommy Albelin,1991-92,27.0,5,37,60,60,9,28,37,98.0,,120,12,51,63,196.0,80,7.48,85,403,2430,12.3
27514,Tommy Albelin,1992-93,28.0,6,29,68,68,6,23,29,125.0,,188,18,74,92,321.0,80,7.37,76,367,2421,12.2
27515,Tommy Albelin,1993-94,29.0,7,14,47,47,2,12,14,66.0,,235,20,86,106,387.0,80,6.91,71,366,2385,11.6
27516,Tommy Albelin,1994-95,30.0,8,4,19,19,0,4,4,18.0,,254,20,90,110,405.0,80,6.96,77,402,2440,11.4
27517,Tommy Albelin,1995-96,31.0,9,6,36,36,1,5,6,33.0,,290,21,95,116,438.0,84,7.25,87,443,2603,11.7
27518,Tommy Albelin,1996-97,32.0,10,19,62,62,2,17,19,62.0,,352,23,112,135,500.0,84,6.48,76,407,2545,10.7
27519,Tommy Albelin,1997-98,33.0,11,15,48,48,5,10,15,60.0,,400,28,122,150,560.0,48,5.97,37,209,1408,10.2
27520,Tommy Albelin,1998-99,34.0,12,14,73,73,1,13,14,121.0,,473,29,135,164,681.0,82,6.29,74,413,2481,10.4
27521,Tommy Albelin,1999-00,35.0,13,15,72,72,4,11,15,103.0,,545,33,146,179,784.0,82,5.83,55,336,2444,9.8
27522,Tommy Albelin,2000-01,36.0,14,19,69,69,2,17,19,88.0,,614,35,163,198,872.0,82,5.28,57,380,2242,9.6
27523,Tommy Albelin,2001-02,37.0,15,6,60,60,1,5,6,54.0,1148.0,674,36,168,204,926.0,82,5.27,57,359,2285,9.4
27524,Tommy Albelin,2002-03,38.0,16,10,41,41,4,6,10,37.0,885.0,715,40,174,214,963.0,82,5.49,53,331,2294,9.8
27525,Tommy Albelin,2003-04,39.0,17,20,77,77,1,19,20,69.0,1608.0,792,41,193,234,1032.0,82,5.51,63,376,2272,9.9
27526,Tommy Albelin,2004-05,40.0,18,4,42,42,1,3,4,33.0,560.0,834,42,196,238,1065.0,82,5.24,53,338,2262,9.5
27527,Tommy Albelin,2005-06,41.0,19,7,37,37,1,6,7,30.0,563.0,871,43,202,245,1095.0,82,5.31,60,363,2326,9.4
27528,Tommy Albelin,2006-07,42.0,20,4,45,45,1,3,4,27.0,666.0,916,44,205,249,1122.0,82,5.14,57,348,2300,9.2
27529,Tommy Albelin,2008-09,44.0,21,6,36,36,0,6,6,15.0,503.0,952,44,211,255,1137.0,82,6.05,85,480,2458,10.1
27530,Tommy Cross,2018-19,29.0,4,1,3,3,0,1,1,0.0,39.0,3,0,1,1,0.0,82,5.34,48,255,2438,9.0
27531,Tommy Lehman,1990-91,26.0,4,4,9,9,1,3,4,5.0,,9,1,3,4,5.0,80,7.43,89,437,2435,12.2
27532,Tommy Lehman,1991-92,27.0,5,6,26,26,4,2,6,26.0,,35,5,5,10,31.0,80,7.48,85,403,2430,12.3
27533,Tommy Lehman,1992-93,28.0,6,0,1,1,0,0,0,0.0,,36,5,5,10,31.0,80,7.37,76,367,2421,12.2
27534,Tommy Sjodin,1995-96,30.0,4,36,77,77,7,29,36,175.0,,77,7,29,36,175.0,84,7.25,87,443,2603,11.7
27535,Tommy Sjodin,1996-97,31.0,5,12,29,29,1,11,12,54.0,,106,8,40,48,229.0,84,6.48,76,407,2545,10.7
27536,Tommy Westlund,2002-03,28.0,4,12,81,81,4,8,12,67.0,841.0,81,4,8,12,67.0,82,5.49,53,331,2294,9.8
27537,Tommy Westlund,2003-04,29.0,5,8,79,79,5,3,8,47.0,740.0,160,9,11,20,114.0,82,5.51,63,376,2272,9.9
27538,Tommy Westlund,2004-05,30.0,6,2,40,40,0,2,2,29.0,425.0,200,9,13,22,143.0,82,5.24,53,338,2262,9.5
27539,Tommy Westlund,2005-06,31.0,7,0,3,3,0,0,0,0.0,19.0,203,9,13,22,143.0,82,5.31,60,363,2326,9.4
27540,Tommy Wingels,2013-14,25.0,4,0,5,5,0,0,0,1.0,26.0,5,0,0,0,1.0,82,5.46,52,291,2492,9.0
27541,Tommy Wingels,2014-15,26.0,5,9,33,33,3,6,9,71.0,454.0,38,3,6,9,72.0,82,5.32,47,271,2439,8.9
27542,Tommy Wingels,2015-16,27.0,6,13,42,42,5,8,13,69.0,598.0,80,8,14,22,141.0,48,5.31,29,160,1399,9.1
27543,Tommy Wingels,2016-17,28.0,7,38,77,77,16,22,38,163.0,1241.0,157,24,36,60,304.0,82,5.34,48,269,2463,8.9
27544,Tommy Wingels,2017-18,29.0,8,36,75,75,15,21,36,158.0,1235.0,232,39,57,96,462.0,82,5.32,47,251,2453,8.9
27545,Tommy Wingels,2018-19,30.0,9,18,68,68,7,11,18,111.0,927.0,300,46,68,114,573.0,82,5.34,48,255,2438,9.0
27546,Tommy Wingels,2019-20,31.0,10,12,73,73,7,5,12,81.0,767.0,373,53,73,126,654.0,82,5.45,47,245,2478,9.0
27547,Tommy Wingels,2020-21,32.0,11,17,75,75,9,8,17,86.0,861.0,448,62,81,143,740.0,82,5.86,50,250,2620,9.2
27548,Toni Dahlman,2004-05,25.0,4,1,10,10,0,1,1,5.0,71.0,10,0,1,1,5.0,82,5.24,53,338,2262,9.5
27549,Toni Dahlman,2005-06,26.0,5,1,12,12,1,0,1,5.0,74.0,22,1,1,2,10.0,82,5.31,60,363,2326,9.4
27550,Toni Lydman,2003-04,26.0,4,19,62,62,3,16,19,80.0,1278.0,62,3,16,19,80.0,82,5.51,63,376,2272,9.9
27551,Toni Lydman,2004-05,27.0,5,28,79,79,6,22,28,126.0,1672.0,141,9,38,47,206.0,82,5.24,53,338,2262,9.5
27552,Toni Lydman,2005-06,28.0,6,26,81,81,6,20,26,143.0,2088.0,222,15,58,73,349.0,82,5.31,60,363,2326,9.4
27553,Toni Lydman,2006-07,29.0,7,20,67,67,4,16,20,93.0,1421.0,289,19,74,93,442.0,82,5.14,57,348,2300,9.2
27554,Toni Lydman,2008-09,31.0,8,17,75,75,1,16,17,68.0,1623.0,364,20,90,110,510.0,82,6.05,85,480,2458,10.1
27555,Toni Lydman,2009-10,32.0,9,19,67,67,2,17,19,44.0,1380.0,431,22,107,129,554.0,82,5.76,70,398,2426,9.7
27556,Toni Lydman,2010-11,33.0,10,26,82,82,4,22,26,86.0,1776.0,513,26,129,155,640.0,82,5.44,62,351,2383,9.4
27557,Toni Lydman,2011-12,34.0,11,23,80,80,3,20,23,99.0,1742.0,593,29,149,178,739.0,82,5.7,65,341,2477,9.4
27558,Toni Lydman,2012-13,35.0,12,20,67,67,4,16,20,77.0,1264.0,660,33,165,198,816.0,82,5.53,56,304,2486,9.1
27559,Toni Lydman,2013-14,36.0,13,25,78,78,3,22,25,99.0,1729.0,738,36,187,223,915.0,82,5.46,52,291,2492,9.0
27560,Toni Lydman,2014-15,37.0,14,13,74,74,0,13,13,46.0,1399.0,812,36,200,236,961.0,82,5.32,47,271,2439,8.9
27561,Toni Lydman,2015-16,38.0,15,6,35,35,0,6,6,28.0,679.0,847,36,206,242,989.0,48,5.31,29,160,1399,9.1
27562,Tony Amonte,1994-95,24.0,4,69,79,79,35,34,69,234.0,,79,35,34,69,234.0,80,6.96,77,402,2440,11.4
27563,Tony Amonte,1995-96,25.0,5,76,83,83,33,43,76,270.0,,162,68,77,145,504.0,84,7.25,87,443,2603,11.7
27564,Tony Amonte,1996-97,26.0,6,42,79,79,17,25,42,195.0,,241,85,102,187,699.0,84,6.48,76,407,2545,10.7
27565,Tony Amonte,1997-98,27.0,7,35,48,48,15,20,35,105.0,,289,100,122,222,804.0,48,5.97,37,209,1408,10.2
27566,Tony Amonte,1998-99,28.0,8,63,81,81,31,32,63,216.0,,370,131,154,285,1020.0,82,6.29,74,413,2481,10.4
27567,Tony Amonte,1999-00,29.0,9,77,81,81,41,36,77,266.0,,451,172,190,362,1286.0,82,5.83,55,336,2444,9.8
27568,Tony Amonte,2000-01,30.0,10,73,82,82,31,42,73,296.0,,533,203,232,435,1582.0,82,5.28,57,380,2242,9.6
27569,Tony Amonte,2001-02,31.0,11,75,82,82,44,31,75,256.0,1820.0,615,247,263,510,1838.0,82,5.27,57,359,2285,9.4
27570,Tony Amonte,2002-03,32.0,12,84,82,82,43,41,84,260.0,1795.0,697,290,304,594,2098.0,82,5.49,53,331,2294,9.8
27571,Tony Amonte,2003-04,33.0,13,64,82,82,35,29,64,256.0,1816.0,779,325,333,658,2354.0,82,5.51,63,376,2272,9.9
27572,Tony Amonte,2004-05,34.0,14,66,82,82,27,39,66,232.0,1746.0,861,352,372,724,2586.0,82,5.24,53,338,2262,9.5
27573,Tony Amonte,2005-06,35.0,15,51,72,72,20,31,51,207.0,1377.0,933,372,403,775,2793.0,82,5.31,60,363,2326,9.4
27574,Tony Amonte,2006-07,36.0,16,53,80,80,20,33,53,173.0,1219.0,1013,392,436,828,2966.0,82,5.14,57,348,2300,9.2
27575,Tony Amonte,2008-09,38.0,17,42,80,80,14,28,42,155.0,1369.0,1093,406,464,870,3121.0,82,6.05,85,480,2458,10.1
27576,Tony Amonte,2009-10,39.0,18,30,81,81,10,20,30,139.0,1146.0,1174,416,484,900,3260.0,82,5.76,70,398,2426,9.7
27577,Tony Camazzola,1984-85,22.0,4,0,3,3,0,0,0,0.0,,3,0,0,0,0.0,80,8.03,73,320,2489,12.9
27578,Tony Cassolato,1982-83,26.0,4,2,9,9,0,2,2,6.0,,9,0,2,2,6.0,80,7.03,61,280,2352,12.0
27579,Tony Cassolato,1983-84,27.0,5,0,2,2,0,0,0,1.0,,11,0,2,2,7.0,80,7.69,77,340,2441,12.6
27580,Tony Cassolato,1984-85,28.0,6,5,12,12,1,4,5,15.0,,23,1,6,7,22.0,80,8.03,73,320,2489,12.9
27581,Tony Cimellaro,1995-96,24.0,4,0,2,2,0,0,0,4.0,,2,0,0,0,4.0,84,7.25,87,443,2603,11.7
27582,Tony Curtale,1983-84,22.0,4,0,2,2,0,0,0,4.0,,2,0,0,0,4.0,80,7.69,77,340,2441,12.6
27583,Tony Feltrin,1983-84,22.0,4,0,2,2,0,0,0,0.0,,2,0,0,0,0.0,80,7.69,77,340,2441,12.6
27584,Tony Feltrin,1984-85,23.0,5,0,4,4,0,0,0,3.0,,6,0,0,0,3.0,80,8.03,73,320,2489,12.9
27585,Tony Feltrin,1985-86,24.0,6,6,32,32,3,3,6,36.0,,38,3,3,6,39.0,80,7.73,71,310,2444,12.7
27586,Tony Feltrin,1988-89,27.0,7,0,10,10,0,0,0,8.0,,48,3,3,6,47.0,80,7.94,82,370,2484,12.8
27587,Tony Granato,1991-92,27.0,4,63,78,78,36,27,63,234.0,,78,36,27,63,234.0,80,7.48,85,403,2430,12.3
27588,Tony Granato,1992-93,28.0,5,36,56,56,12,24,36,120.0,,134,48,51,99,354.0,80,7.37,76,367,2421,12.2
27589,Tony Granato,1993-94,29.0,6,64,68,68,30,34,64,197.0,,202,78,85,163,551.0,80,6.91,71,366,2385,11.6
27590,Tony Granato,1994-95,30.0,7,68,80,80,39,29,68,223.0,,282,117,114,231,774.0,80,6.96,77,402,2440,11.4
27591,Tony Granato,1995-96,31.0,8,82,81,81,37,45,82,247.0,,363,154,159,313,1021.0,84,7.25,87,443,2603,11.7
27592,Tony Granato,1996-97,32.0,9,21,50,50,7,14,21,117.0,,413,161,173,334,1138.0,84,6.48,76,407,2545,10.7
27593,Tony Granato,1997-98,33.0,10,24,33,33,13,11,24,106.0,,446,174,184,358,1244.0,48,5.97,37,209,1408,10.2
27594,Tony Granato,1998-99,34.0,11,35,49,49,17,18,35,156.0,,495,191,202,393,1400.0,82,6.29,74,413,2481,10.4
27595,Tony Granato,1999-00,35.0,12,40,76,76,25,15,40,231.0,,571,216,217,433,1631.0,82,5.83,55,336,2444,9.8
27596,Tony Granato,2000-01,36.0,13,25,59,59,16,9,25,119.0,,630,232,226,458,1750.0,82,5.28,57,380,2242,9.6
27597,Tony Granato,2001-02,37.0,14,12,35,35,6,6,12,65.0,367.0,665,238,232,470,1815.0,82,5.27,57,359,2285,9.4
27598,Tony Granato,2002-03,38.0,15,13,48,48,6,7,13,67.0,436.0,713,244,239,483,1882.0,82,5.49,53,331,2294,9.8
27599,Tony Granato,2003-04,39.0,16,9,60,60,4,5,9,85.0,505.0,773,248,244,492,1967.0,82,5.51,63,376,2272,9.9
27600,Tony Horacek,1992-93,25.0,4,10,48,48,5,5,10,31.0,,48,5,5,10,31.0,80,7.37,76,367,2421,12.2
27601,Tony Horacek,1993-94,26.0,5,9,34,34,3,6,9,35.0,,82,8,11,19,66.0,80,6.91,71,366,2385,11.6
27602,Tony Horacek,1994-95,27.0,6,9,46,46,2,7,9,32.0,,128,10,18,28,98.0,80,6.96,77,402,2440,11.4
27603,Tony Horacek,1996-97,29.0,7,0,7,7,0,0,0,2.0,,135,10,18,28,100.0,84,6.48,76,407,2545,10.7
27604,Tony Horacek,1997-98,30.0,8,1,19,19,0,1,1,6.0,,154,10,19,29,106.0,48,5.97,37,209,1408,10.2
27605,Tony Hrkac,1990-91,24.0,4,48,67,67,11,37,48,86.0,,67,11,37,48,86.0,80,7.43,89,437,2435,12.2
27606,Tony Hrkac,1991-92,25.0,5,45,70,70,17,28,45,133.0,,137,28,65,93,219.0,80,7.48,85,403,2430,12.3
27607,Tony Hrkac,1992-93,26.0,6,29,50,50,9,20,29,70.0,,187,37,85,122,289.0,80,7.37,76,367,2421,12.2
27608,Tony Hrkac,1993-94,27.0,7,48,70,70,16,32,48,122.0,,257,53,117,170,411.0,80,6.91,71,366,2385,11.6
27609,Tony Hrkac,1994-95,28.0,8,15,40,40,3,12,15,53.0,,297,56,129,185,464.0,80,6.96,77,402,2440,11.4
27610,Tony Hrkac,1996-97,30.0,9,11,36,36,6,5,11,43.0,,333,62,134,196,507.0,84,6.48,76,407,2545,10.7
27611,Tony Hrkac,2000-01,34.0,10,27,49,49,13,14,27,57.0,,382,75,148,223,564.0,82,5.28,57,380,2242,9.6
27612,Tony Hrkac,2001-02,35.0,11,27,69,69,13,14,27,67.0,830.0,451,88,162,250,631.0,82,5.27,57,359,2285,9.4
27613,Tony Hrkac,2002-03,36.0,12,13,67,67,4,9,13,39.0,624.0,518,92,171,263,670.0,82,5.49,53,331,2294,9.8
27614,Tony Hrkac,2003-04,37.0,13,38,80,80,13,25,38,88.0,1102.0,598,105,196,301,758.0,82,5.51,63,376,2272,9.9
27615,Tony Hrkac,2004-05,38.0,14,44,80,80,18,26,44,101.0,1398.0,678,123,222,345,859.0,82,5.24,53,338,2262,9.5
27616,Tony Hrkac,2005-06,39.0,15,26,80,80,9,17,26,86.0,1288.0,758,132,239,371,945.0,82,5.31,60,363,2326,9.4
27617,Tony Joseph,1991-92,22.0,4,1,2,2,1,0,1,4.0,,2,1,0,1,4.0,80,7.48,85,403,2430,12.3
27618,Tony Martensson,2006-07,26.0,4,2,6,6,1,1,2,4.0,42.0,6,1,1,2,4.0,82,5.14,57,348,2300,9.2
27619,Tony Salmelainen,2006-07,25.0,4,1,13,13,0,1,1,17.0,125.0,13,0,1,1,17.0,82,5.14,57,348,2300,9.2
27620,Tony Salmelainen,2009-10,28.0,5,17,57,57,6,11,17,54.0,563.0,70,6,12,18,71.0,82,5.76,70,398,2426,9.7
27621,Tony Stiles,1986-87,27.0,4,9,30,30,2,7,9,19.0,,30,2,7,9,19.0,80,7.89,74,336,2448,12.9
27622,Tony Tanti,1984-85,21.0,4,0,2,2,0,0,0,0.0,,2,0,0,0,0.0,80,8.03,73,320,2489,12.9
27623,Tony Tanti,1985-86,22.0,5,17,40,40,9,8,17,85.0,,42,9,8,17,85.0,80,7.73,71,310,2444,12.7
27624,Tony Tanti,1986-87,23.0,6,86,79,79,45,41,86,247.0,,121,54,49,103,332.0,80,7.89,74,336,2448,12.9
27625,Tony Tanti,1987-88,24.0,7,59,68,68,39,20,59,217.0,,189,93,69,162,549.0,80,7.77,71,321,2447,12.7
27626,Tony Tanti,1988-89,25.0,8,72,77,77,39,33,72,213.0,,266,132,102,234,762.0,80,7.94,82,370,2484,12.8
27627,Tony Tanti,1989-90,26.0,9,79,77,77,41,38,79,242.0,,343,173,140,313,1004.0,80,7.34,72,344,2400,12.2
27628,Tony Tanti,1990-91,27.0,10,77,73,73,40,37,77,202.0,,416,213,177,390,1206.0,80,7.43,89,437,2435,12.2
27629,Tony Tanti,1991-92,28.0,11,49,77,77,24,25,49,211.0,,493,237,202,439,1417.0,80,7.48,85,403,2430,12.3
27630,Tony Tanti,1992-93,29.0,12,64,78,78,28,36,64,192.0,,571,265,238,503,1609.0,80,7.37,76,367,2421,12.2
27631,Tony Tanti,1993-94,30.0,13,26,56,56,7,19,26,93.0,,627,272,257,529,1702.0,80,6.91,71,366,2385,11.6
27632,Tony Tanti,1994-95,31.0,14,31,70,70,15,16,31,133.0,,697,287,273,560,1835.0,80,6.96,77,402,2440,11.4
27633,Tony Tuzzolino,2000-01,25.0,4,0,1,1,0,0,0,0.0,,1,0,0,0,0.0,82,5.28,57,380,2242,9.6
27634,Tony Tuzzolino,2003-04,28.0,5,0,6,6,0,0,0,3.0,22.0,7,0,0,0,3.0,82,5.51,63,376,2272,9.9
27635,Tony Tuzzolino,2004-05,29.0,6,0,2,2,0,0,0,1.0,11.0,9,0,0,0,4.0,82,5.24,53,338,2262,9.5
27636,Tony Twist,1992-93,24.0,4,0,28,28,0,0,0,2.0,,28,0,0,0,2.0,80,7.37,76,367,2421,12.2
27637,Tony Twist,1993-94,25.0,5,0,24,24,0,0,0,2.0,,52,0,0,0,4.0,80,6.91,71,366,2385,11.6
27638,Tony Twist,1994-95,26.0,6,1,44,44,0,1,1,9.0,,96,0,1,1,13.0,80,6.96,77,402,2440,11.4
27639,Tony Twist,1995-96,27.0,7,2,34,34,0,2,2,14.0,,130,0,3,3,27.0,84,7.25,87,443,2603,11.7
27640,Tony Twist,1996-97,28.0,8,4,49,49,0,4,4,15.0,,179,0,7,7,42.0,84,6.48,76,407,2545,10.7
27641,Tony Twist,1997-98,29.0,9,3,28,28,3,0,3,8.0,,207,3,7,10,50.0,48,5.97,37,209,1408,10.2
27642,Tony Twist,1998-99,30.0,10,5,51,51,3,2,5,12.0,,258,6,9,15,62.0,82,6.29,74,413,2481,10.4
27643,Tony Twist,1999-00,31.0,11,3,64,64,1,2,3,21.0,,322,7,11,18,83.0,82,5.83,55,336,2444,9.8
27644,Tony Twist,2000-01,32.0,12,2,60,60,1,1,2,17.0,,382,8,12,20,100.0,82,5.28,57,380,2242,9.6
27645,Tony Twist,2001-02,33.0,13,8,63,63,2,6,8,23.0,326.0,445,10,18,28,123.0,82,5.27,57,359,2285,9.4
27646,Tony Virta,2004-05,32.0,4,5,8,8,2,3,5,15.0,107.0,8,2,3,5,15.0,82,5.24,53,338,2262,9.5
27647,Torey Krug,2014-15,23.0,4,1,2,2,0,1,1,3.0,34.0,2,0,1,1,3.0,82,5.32,47,271,2439,8.9
27648,Torey Krug,2015-16,24.0,5,1,1,1,0,1,1,0.0,16.0,3,0,2,2,3.0,48,5.31,29,160,1399,9.1
27649,Torey Krug,2016-17,25.0,6,40,79,79,14,26,40,183.0,1383.0,82,14,28,42,186.0,82,5.34,48,269,2463,8.9
27650,Torey Krug,2017-18,26.0,7,39,78,78,12,27,39,205.0,1529.0,160,26,55,81,391.0,82,5.32,47,251,2453,8.9
27651,Torey Krug,2018-19,27.0,8,44,81,81,4,40,44,244.0,1751.0,241,30,95,125,635.0,82,5.34,48,255,2438,9.0
27652,Torey Krug,2019-20,28.0,9,51,81,81,8,43,51,208.0,1750.0,322,38,138,176,843.0,82,5.45,47,245,2478,9.0
27653,Torey Krug,2020-21,29.0,10,59,76,76,14,45,59,197.0,1551.0,398,52,183,235,1040.0,82,5.86,50,250,2620,9.2
27654,Torey Krug,2021-22,30.0,11,53,64,64,6,47,53,151.0,1363.0,462,58,230,288,1191.0,82,5.96,47,239,2579,9.5
27655,Torey Krug,2022-23,31.0,12,49,61,61,9,40,49,144.0,1250.0,523,67,270,337,1335.0,70,5.96,42,208,2192,9.5
27656,Torrey Mitchell,2010-11,26.0,4,20,82,82,10,10,20,110.0,1174.0,82,10,10,20,110.0,82,5.44,62,351,2383,9.4
27657,Torrey Mitchell,2012-13,28.0,5,11,56,56,2,9,11,59.0,640.0,138,12,19,31,169.0,82,5.53,56,304,2486,9.1
27658,Torrey Mitchell,2013-14,29.0,6,23,66,66,9,14,23,116.0,881.0,204,21,33,54,285.0,82,5.46,52,291,2492,9.0
27659,Torrey Mitchell,2014-15,30.0,7,19,76,76,9,10,19,100.0,945.0,280,30,43,73,385.0,82,5.32,47,271,2439,8.9
27660,Torrey Mitchell,2015-16,31.0,8,8,45,45,4,4,8,39.0,472.0,325,34,47,81,424.0,48,5.31,29,160,1399,9.1
27661,Torrey Mitchell,2016-17,32.0,9,10,67,67,2,8,10,56.0,729.0,392,36,55,91,480.0,82,5.34,48,269,2463,8.9
27662,Torrey Mitchell,2017-18,33.0,10,14,65,65,6,8,14,55.0,923.0,457,42,63,105,535.0,82,5.32,47,251,2453,8.9
27663,Torrey Mitchell,2018-19,34.0,11,19,71,71,11,8,19,69.0,901.0,528,53,71,124,604.0,82,5.34,48,255,2438,9.0
27664,Torrey Mitchell,2019-20,35.0,12,17,78,78,8,9,17,68.0,983.0,606,61,80,141,672.0,82,5.45,47,245,2478,9.0
27665,Torrey Mitchell,2020-21,36.0,13,11,60,60,6,5,11,55.0,684.0,666,67,85,152,727.0,82,5.86,50,250,2620,9.2
27666,Torrie Robertson,1983-84,22.0,4,0,3,3,0,0,0,3.0,,3,0,0,0,3.0,80,7.69,77,340,2441,12.6
27667,Torrie Robertson,1984-85,23.0,5,21,54,54,8,13,21,46.0,,57,8,13,21,49.0,80,8.03,73,320,2489,12.9
27668,Torrie Robertson,1985-86,24.0,6,2,5,5,2,0,2,5.0,,62,10,13,23,54.0,80,7.73,71,310,2444,12.7
27669,Torrie Robertson,1986-87,25.0,7,20,66,66,7,13,20,62.0,,128,17,26,43,116.0,80,7.89,74,336,2448,12.9
27670,Torrie Robertson,1987-88,26.0,8,41,74,74,11,30,41,74.0,,202,28,56,84,190.0,80,7.77,71,321,2447,12.7
27671,Torrie Robertson,1988-89,27.0,9,37,76,76,13,24,37,87.0,,278,41,80,121,277.0,80,7.94,82,370,2484,12.8
27672,Torrie Robertson,1989-90,28.0,10,1,20,20,1,0,1,19.0,,298,42,80,122,296.0,80,7.34,72,344,2400,12.2
27673,Torrie Robertson,1990-91,29.0,11,10,63,63,2,8,10,46.0,,361,44,88,132,342.0,80,7.43,89,437,2435,12.2
27674,Torrie Robertson,1991-92,30.0,12,10,39,39,4,6,10,26.0,,400,48,94,142,368.0,80,7.48,85,403,2430,12.3
27675,Torrie Robertson,1992-93,31.0,13,6,42,42,1,5,6,20.0,,442,49,99,148,388.0,80,7.37,76,367,2421,12.2
27676,Travis Boyd,2020-21,27.0,4,1,8,8,0,1,1,2.0,71.0,8,0,1,1,2.0,82,5.86,50,250,2620,9.2
27677,Travis Boyd,2021-22,28.0,5,20,53,53,5,15,20,35.0,521.0,61,5,16,21,37.0,82,5.96,47,239,2579,9.5
27678,Travis Boyd,2022-23,29.0,6,10,24,24,3,7,10,26.0,282.0,85,8,23,31,63.0,70,5.96,42,208,2192,9.5
27679,Travis Brigley,2000-01,23.0,4,0,2,2,0,0,0,1.0,,2,0,0,0,1.0,82,5.28,57,380,2242,9.6
27680,Travis Brigley,2002-03,25.0,5,2,17,17,0,2,2,17.0,242.0,19,0,2,2,18.0,82,5.49,53,331,2294,9.8
27681,Travis Brigley,2006-07,29.0,6,7,36,36,3,4,7,39.0,427.0,55,3,6,9,57.0,82,5.14,57,348,2300,9.2
27682,Travis Dermott,2020-21,24.0,4,13,37,37,1,12,13,54.0,592.0,37,1,12,13,54.0,82,5.86,50,250,2620,9.2
27683,Travis Dermott,2021-22,25.0,5,17,64,64,4,13,17,98.0,1108.0,101,5,25,30,152.0,82,5.96,47,239,2579,9.5
27684,Travis Dermott,2022-23,26.0,6,11,56,56,4,7,11,65.0,969.0,157,9,32,41,217.0,70,5.96,42,208,2192,9.5
27685,Travis Green,1995-96,25.0,4,25,61,61,7,18,25,115.0,,61,7,18,25,115.0,84,7.25,87,443,2603,11.7
27686,Travis Green,1996-97,26.0,5,40,83,83,18,22,40,164.0,,144,25,40,65,279.0,84,6.48,76,407,2545,10.7
27687,Travis Green,1997-98,27.0,6,12,42,42,5,7,12,59.0,,186,30,47,77,338.0,48,5.97,37,209,1408,10.2
27688,Travis Green,1998-99,28.0,7,70,69,69,25,45,70,186.0,,255,55,92,147,524.0,82,6.29,74,413,2481,10.4
27689,Travis Green,1999-00,29.0,8,64,79,79,23,41,64,177.0,,334,78,133,211,701.0,82,5.83,55,336,2444,9.8
27690,Travis Green,2000-01,30.0,9,42,76,76,19,23,42,141.0,,410,97,156,253,842.0,82,5.28,57,380,2242,9.6
27691,Travis Green,2001-02,31.0,10,30,79,79,13,17,30,165.0,1365.0,489,110,173,283,1007.0,82,5.27,57,359,2285,9.4
27692,Travis Green,2002-03,32.0,11,46,78,78,25,21,46,157.0,1294.0,567,135,194,329,1164.0,82,5.49,53,331,2294,9.8
27693,Travis Green,2003-04,33.0,12,28,69,69,13,15,28,113.0,1110.0,636,148,209,357,1277.0,82,5.51,63,376,2272,9.9
27694,Travis Green,2004-05,34.0,13,34,82,82,11,23,34,119.0,1191.0,718,159,232,391,1396.0,82,5.24,53,338,2262,9.5
27695,Travis Green,2005-06,35.0,14,24,75,75,12,12,24,86.0,971.0,793,171,244,415,1482.0,82,5.31,60,363,2326,9.4
27696,Travis Green,2006-07,36.0,15,16,64,64,11,5,16,104.0,978.0,857,182,249,431,1586.0,82,5.14,57,348,2300,9.2
27697,Travis Green,2008-09,38.0,16,22,82,82,10,12,22,118.0,1235.0,939,192,261,453,1704.0,82,6.05,85,480,2458,10.1
27698,Travis Green,2009-10,39.0,17,2,31,31,1,1,2,22.0,276.0,970,193,262,455,1726.0,82,5.76,70,398,2426,9.7
27699,Travis Hamonic,2013-14,23.0,4,26,62,62,5,21,26,118.0,1338.0,62,5,21,26,118.0,82,5.46,52,291,2492,9.0
27700,Travis Hamonic,2014-15,24.0,5,24,73,73,2,22,24,124.0,1637.0,135,7,43,50,242.0,82,5.32,47,271,2439,8.9
27701,Travis Hamonic,2015-16,25.0,6,10,48,48,3,7,10,83.0,1095.0,183,10,50,60,325.0,48,5.31,29,160,1399,9.1
27702,Travis Hamonic,2016-17,26.0,7,18,69,69,3,15,18,134.0,1726.0,252,13,65,78,459.0,82,5.34,48,269,2463,8.9
27703,Travis Hamonic,2017-18,27.0,8,33,71,71,5,28,33,132.0,1547.0,323,18,93,111,591.0,82,5.32,47,251,2453,8.9
27704,Travis Hamonic,2018-19,28.0,9,21,72,72,5,16,21,147.0,1715.0,395,23,109,132,738.0,82,5.34,48,255,2438,9.0
27705,Travis Hamonic,2019-20,29.0,10,14,49,49,3,11,14,74.0,1002.0,444,26,120,146,812.0,82,5.45,47,245,2478,9.0
27706,Travis Hamonic,2020-21,30.0,11,11,74,74,1,10,11,107.0,1532.0,518,27,130,157,919.0,82,5.86,50,250,2620,9.2
27707,Travis Hamonic,2021-22,31.0,12,19,69,69,7,12,19,128.0,1440.0,587,34,142,176,1047.0,82,5.96,47,239,2579,9.5
27708,Travis Hamonic,2022-23,32.0,13,12,50,50,3,9,12,83.0,1060.0,637,37,151,188,1130.0,70,5.96,42,208,2192,9.5
27709,Travis Konecny,2019-20,22.0,4,28,70,70,11,17,28,133.0,986.0,70,11,17,28,133.0,82,5.45,47,245,2478,9.0
27710,Travis Konecny,2020-21,23.0,5,47,81,81,24,23,47,177.0,1207.0,151,35,40,75,310.0,82,5.86,50,250,2620,9.2
27711,Travis Konecny,2021-22,24.0,6,49,82,82,24,25,49,182.0,1251.0,233,59,65,124,492.0,82,5.96,47,239,2579,9.5
27712,Travis Konecny,2022-23,25.0,7,61,66,66,24,37,61,141.0,1109.0,299,83,102,185,633.0,70,5.96,42,208,2192,9.5
27713,Travis Moen,2006-07,24.0,4,6,82,82,4,2,6,51.0,898.0,82,4,2,6,51.0,82,5.14,57,348,2300,9.2
27714,Travis Moen,2008-09,26.0,5,5,39,39,4,1,5,28.0,431.0,121,8,3,11,79.0,82,6.05,85,480,2458,10.1
27715,Travis Moen,2009-10,27.0,6,21,82,82,11,10,21,124.0,1214.0,203,19,13,32,203.0,82,5.76,70,398,2426,9.7
27716,Travis Moen,2010-11,28.0,7,8,77,77,3,5,8,98.0,1219.0,280,22,18,40,301.0,82,5.44,62,351,2383,9.4
27717,Travis Moen,2011-12,29.0,8,16,82,82,7,9,16,101.0,1229.0,362,29,27,56,402.0,82,5.7,65,341,2477,9.4
27718,Travis Moen,2012-13,30.0,9,19,81,81,8,11,19,107.0,1214.0,443,37,38,75,509.0,82,5.53,56,304,2486,9.1
27719,Travis Moen,2013-14,31.0,10,16,79,79,6,10,16,99.0,1042.0,522,43,48,91,608.0,82,5.46,52,291,2492,9.0
27720,Travis Moen,2014-15,32.0,11,16,48,48,9,7,16,45.0,754.0,570,52,55,107,653.0,82,5.32,47,271,2439,8.9
27721,Travis Moen,2015-16,33.0,12,6,45,45,2,4,6,32.0,524.0,615,54,59,113,685.0,48,5.31,29,160,1399,9.1
27722,Travis Moen,2016-17,34.0,13,12,65,65,2,10,12,56.0,749.0,680,56,69,125,741.0,82,5.34,48,269,2463,8.9
27723,Travis Moen,2017-18,35.0,14,9,44,44,3,6,9,34.0,413.0,724,59,75,134,775.0,82,5.32,47,251,2453,8.9
27724,Travis Moen,2018-19,36.0,15,2,23,23,0,2,2,12.0,188.0,747,59,77,136,787.0,82,5.34,48,255,2438,9.0
27725,Travis Morin,2013-14,30.0,4,0,3,3,0,0,0,2.0,27.0,3,0,0,0,2.0,82,5.46,52,291,2492,9.0
27726,Travis Morin,2016-17,33.0,5,1,4,4,0,1,1,4.0,41.0,7,0,1,1,6.0,82,5.34,48,269,2463,8.9
27727,Travis Morin,2017-18,34.0,6,0,6,6,0,0,0,10.0,73.0,13,0,1,1,16.0,82,5.32,47,251,2453,8.9
27728,Travis Richards,1997-98,27.0,4,0,2,2,0,0,0,1.0,,2,0,0,0,1.0,48,5.97,37,209,1408,10.2
27729,Travis Richards,1998-99,28.0,5,0,1,1,0,0,0,0.0,,3,0,0,0,1.0,82,6.29,74,413,2481,10.4
27730,Travis Roche,2003-04,25.0,4,0,1,1,0,0,0,0.0,15.0,1,0,0,0,0.0,82,5.51,63,376,2272,9.9
27731,Travis Roche,2004-05,26.0,5,0,4,4,0,0,0,1.0,50.0,5,0,0,0,1.0,82,5.24,53,338,2262,9.5
27732,Travis Roche,2006-07,28.0,6,1,5,5,0,1,1,5.0,81.0,10,0,1,1,6.0,82,5.14,57,348,2300,9.2
27733,Travis Roche,2009-10,31.0,7,19,50,50,6,13,19,32.0,851.0,60,6,14,20,38.0,82,5.76,70,398,2426,9.7
27734,Travis Sanheim,2020-21,24.0,4,10,49,49,2,8,10,72.0,764.0,49,2,8,10,72.0,82,5.86,50,250,2620,9.2
27735,Travis Sanheim,2021-22,25.0,5,35,82,82,9,26,35,121.0,1604.0,131,11,34,45,193.0,82,5.96,47,239,2579,9.5
27736,Travis Sanheim,2022-23,26.0,6,25,69,69,8,17,25,110.0,1391.0,200,19,51,70,303.0,70,5.96,42,208,2192,9.5
27737,Travis Turnbull,2014-15,28.0,4,1,3,3,1,0,1,3.0,15.0,3,1,0,1,3.0,82,5.32,47,271,2439,8.9
27738,Travis Zajac,2009-10,24.0,4,42,80,80,17,25,42,134.0,1283.0,80,17,25,42,134.0,82,5.76,70,398,2426,9.7
27739,Travis Zajac,2010-11,25.0,5,34,82,82,14,20,34,155.0,1372.0,162,31,45,76,289.0,82,5.44,62,351,2383,9.4
27740,Travis Zajac,2011-12,26.0,6,62,82,82,20,42,62,185.0,1529.0,244,51,87,138,474.0,82,5.7,65,341,2477,9.4
27741,Travis Zajac,2012-13,27.0,7,67,82,82,25,42,67,210.0,1658.0,326,76,129,205,684.0,82,5.53,56,304,2486,9.1
27742,Travis Zajac,2013-14,28.0,8,44,82,82,13,31,44,173.0,1622.0,408,89,160,249,857.0,82,5.46,52,291,2492,9.0
27743,Travis Zajac,2014-15,29.0,9,6,15,15,2,4,6,25.0,261.0,423,91,164,255,882.0,82,5.32,47,271,2439,8.9
27744,Travis Zajac,2015-16,30.0,10,20,48,48,7,13,20,82.0,938.0,471,98,177,275,964.0,48,5.31,29,160,1399,9.1
27745,Travis Zajac,2016-17,31.0,11,48,80,80,18,30,48,165.0,1625.0,551,116,207,323,1129.0,82,5.34,48,269,2463,8.9
27746,Travis Zajac,2017-18,32.0,12,25,74,74,11,14,25,112.0,1411.0,625,127,221,348,1241.0,82,5.32,47,251,2453,8.9
27747,Travis Zajac,2018-19,33.0,13,42,74,74,14,28,42,111.0,1469.0,699,141,249,390,1352.0,82,5.34,48,255,2438,9.0
27748,Travis Zajac,2019-20,34.0,14,45,80,80,14,31,45,126.0,1578.0,779,155,280,435,1478.0,82,5.45,47,245,2478,9.0
27749,Travis Zajac,2020-21,35.0,15,26,63,63,12,14,26,91.0,1128.0,842,167,294,461,1569.0,82,5.86,50,250,2620,9.2
27750,Travis Zajac,2021-22,36.0,16,46,80,80,19,27,46,120.0,1542.0,922,186,321,507,1689.0,82,5.96,47,239,2579,9.5
27751,Travis Zajac,2022-23,37.0,17,25,69,69,9,16,25,72.0,1180.0,991,195,337,532,1761.0,70,5.96,42,208,2192,9.5
27752,Trent Frederic,2021-22,23.0,4,0,15,15,0,0,0,19.0,141.0,15,0,0,0,19.0,82,5.96,47,239,2579,9.5
27753,Trent Frederic,2022-23,24.0,5,0,2,2,0,0,0,1.0,13.0,17,0,0,0,20.0,70,5.96,42,208,2192,9.5
27754,Trent Hunter,2005-06,25.0,4,4,8,8,0,4,4,19.0,98.0,8,0,4,4,19.0,82,5.31,60,363,2326,9.4
27755,Trent Hunter,2006-07,26.0,5,51,77,77,25,26,51,187.0,1205.0,85,25,30,55,206.0,82,5.14,57,348,2300,9.2
27756,Trent Hunter,2008-09,28.0,6,35,82,82,16,19,35,221.0,1462.0,167,41,49,90,427.0,82,6.05,85,480,2458,10.1
27757,Trent Hunter,2009-10,29.0,7,35,77,77,20,15,35,168.0,1232.0,244,61,64,125,595.0,82,5.76,70,398,2426,9.7
27758,Trent Hunter,2010-11,30.0,8,41,82,82,12,29,41,222.0,1493.0,326,73,93,166,817.0,82,5.44,62,351,2383,9.4
27759,Trent Hunter,2011-12,31.0,9,31,55,55,14,17,31,154.0,901.0,381,87,110,197,971.0,82,5.7,65,341,2477,9.4
27760,Trent Hunter,2012-13,32.0,10,28,61,61,11,17,28,159.0,926.0,442,98,127,225,1130.0,82,5.53,56,304,2486,9.1
27761,Trent Hunter,2013-14,33.0,11,4,17,17,1,3,4,30.0,215.0,459,99,130,229,1160.0,82,5.46,52,291,2492,9.0
27762,Trent Hunter,2014-15,34.0,12,7,38,38,2,5,7,51.0,384.0,497,101,135,236,1211.0,82,5.32,47,271,2439,8.9
27763,Trent Kaese,1991-92,24.0,4,0,1,1,0,0,0,5.0,,1,0,0,0,5.0,80,7.48,85,403,2430,12.3
27764,Trent Klatt,1994-95,24.0,4,0,1,1,0,0,0,1.0,,1,0,0,0,1.0,80,6.96,77,402,2440,11.4
27765,Trent Klatt,1995-96,25.0,5,23,47,47,4,19,23,69.0,,48,4,19,23,70.0,84,7.25,87,443,2603,11.7
27766,Trent Klatt,1996-97,26.0,6,38,61,61,14,24,38,86.0,,109,18,43,61,156.0,84,6.48,76,407,2545,10.7
27767,Trent Klatt,1997-98,27.0,7,22,47,47,12,10,22,91.0,,156,30,53,83,247.0,48,5.97,37,209,1408,10.2
27768,Trent Klatt,1998-99,28.0,8,19,71,71,7,12,19,101.0,,227,37,65,102,348.0,82,6.29,74,413,2481,10.4
27769,Trent Klatt,1999-00,29.0,9,45,76,76,24,21,45,131.0,,303,61,86,147,479.0,82,5.83,55,336,2444,9.8
27770,Trent Klatt,2000-01,30.0,10,42,82,82,14,28,42,143.0,,385,75,114,189,622.0,82,5.28,57,380,2242,9.6
27771,Trent Klatt,2001-02,31.0,11,14,75,75,4,10,14,60.0,851.0,460,79,124,203,682.0,82,5.27,57,359,2285,9.4
27772,Trent Klatt,2002-03,32.0,12,20,47,47,10,10,20,100.0,755.0,507,89,134,223,782.0,82,5.49,53,331,2294,9.8
27773,Trent Klatt,2003-04,33.0,13,33,77,77,13,20,33,140.0,1044.0,584,102,154,256,922.0,82,5.51,63,376,2272,9.9
27774,Trent Klatt,2004-05,34.0,14,15,34,34,8,7,15,67.0,525.0,618,110,161,271,989.0,82,5.24,53,338,2262,9.5
27775,Trent Klatt,2005-06,35.0,15,29,82,82,16,13,29,127.0,1019.0,700,126,174,300,1116.0,82,5.31,60,363,2326,9.4
27776,Trent Klatt,2006-07,36.0,16,43,82,82,17,26,43,160.0,1332.0,782,143,200,343,1276.0,82,5.14,57,348,2300,9.2
27777,Trent McCleary,1998-99,26.0,4,14,75,75,4,10,14,58.0,,75,4,10,14,58.0,82,6.29,74,413,2481,10.4
27778,Trent McCleary,1999-00,27.0,5,8,59,59,3,5,8,41.0,,134,7,15,22,99.0,82,5.83,55,336,2444,9.8
27779,Trent McCleary,2001-02,29.0,6,0,46,46,0,0,0,18.0,268.0,180,7,15,22,117.0,82,5.27,57,359,2285,9.4
27780,Trent McCleary,2002-03,30.0,7,1,12,12,1,0,1,4.0,75.0,192,8,15,23,121.0,82,5.49,53,331,2294,9.8
27781,Trent Whitfield,2003-04,26.0,4,6,61,61,2,4,6,47.0,589.0,61,2,4,6,47.0,82,5.51,63,376,2272,9.9
27782,Trent Whitfield,2004-05,27.0,5,1,25,25,0,1,1,15.0,183.0,86,2,5,7,62.0,82,5.24,53,338,2262,9.5
27783,Trent Whitfield,2005-06,28.0,6,2,14,14,1,1,2,4.0,119.0,100,3,6,9,66.0,82,5.31,60,363,2326,9.4
27784,Trent Whitfield,2006-07,29.0,7,11,44,44,6,5,11,38.0,563.0,144,9,11,20,104.0,82,5.14,57,348,2300,9.2
27785,Trent Whitfield,2008-09,31.0,8,7,30,30,2,5,7,41.0,358.0,174,11,16,27,145.0,82,6.05,85,480,2458,10.1
27786,Trent Whitfield,2011-12,34.0,9,1,3,3,0,1,1,4.0,33.0,177,11,17,28,149.0,82,5.7,65,341,2477,9.4
27787,Trent Whitfield,2012-13,35.0,10,1,16,16,0,1,1,15.0,177.0,193,11,18,29,164.0,82,5.53,56,304,2486,9.1
27788,Trent Whitfield,2014-15,37.0,11,0,1,1,0,0,0,1.0,14.0,194,11,18,29,165.0,82,5.32,47,271,2439,8.9
27789,Trent Yawney,1990-91,25.0,4,10,15,15,2,8,10,26.0,,15,2,8,10,26.0,80,7.43,89,437,2435,12.2
27790,Trent Yawney,1991-92,26.0,5,24,69,69,5,19,24,75.0,,84,7,27,34,101.0,80,7.48,85,403,2430,12.3
27791,Trent Yawney,1992-93,27.0,6,20,70,70,5,15,20,58.0,,154,12,42,54,159.0,80,7.37,76,367,2421,12.2
27792,Trent Yawney,1993-94,28.0,7,16,61,61,3,13,16,52.0,,215,15,55,70,211.0,80,6.91,71,366,2385,11.6
27793,Trent Yawney,1994-95,29.0,8,13,47,47,4,9,13,33.0,,262,19,64,83,244.0,80,6.96,77,402,2440,11.4
27794,Trent Yawney,1995-96,30.0,9,17,63,63,1,16,17,61.0,,325,20,80,100,305.0,84,7.25,87,443,2603,11.7
27795,Trent Yawney,1996-97,31.0,10,21,58,58,6,15,21,62.0,,383,26,95,121,367.0,84,6.48,76,407,2545,10.7
27796,Trent Yawney,1997-98,32.0,11,2,37,37,0,2,2,20.0,,420,26,97,123,387.0,48,5.97,37,209,1408,10.2
27797,Trent Yawney,1998-99,33.0,12,3,69,69,0,3,3,51.0,,489,26,100,126,438.0,82,6.29,74,413,2481,10.4
27798,Trent Yawney,1999-00,34.0,13,2,39,39,0,2,2,8.0,,528,26,102,128,446.0,82,5.83,55,336,2444,9.8
27799,Trent Yawney,2000-01,35.0,14,1,45,45,1,0,1,19.0,,573,27,102,129,465.0,82,5.28,57,380,2242,9.6
27800,Trent Yawney,2001-02,36.0,15,0,20,20,0,0,0,11.0,269.0,593,27,102,129,476.0,82,5.27,57,359,2285,9.4
27801,Trevor Carrick,2018-19,24.0,4,0,2,2,0,0,0,3.0,33.0,2,0,0,0,3.0,82,5.34,48,255,2438,9.0
27802,Trevor Carrick,2020-21,26.0,5,0,1,1,0,0,0,1.0,8.0,3,0,0,0,4.0,82,5.86,50,250,2620,9.2
27803,Trevor Carrick,2021-22,27.0,6,0,1,1,0,0,0,0.0,11.0,4,0,0,0,4.0,82,5.96,47,239,2579,9.5
27804,Trevor Carrick,2022-23,28.0,7,0,3,3,0,0,0,1.0,17.0,7,0,0,0,5.0,70,5.96,42,208,2192,9.5
27805,Trevor Daley,2006-07,23.0,4,6,27,27,1,5,6,34.0,433.0,27,1,5,6,34.0,82,5.14,57,348,2300,9.2
27806,Trevor Daley,2008-09,25.0,5,14,81,81,3,11,14,91.0,1512.0,108,4,16,20,125.0,82,6.05,85,480,2458,10.1
27807,Trevor Daley,2009-10,26.0,6,12,74,74,4,8,12,68.0,1434.0,182,8,24,32,193.0,82,5.76,70,398,2426,9.7
27808,Trevor Daley,2010-11,27.0,7,24,82,82,5,19,24,87.0,1624.0,264,13,43,56,280.0,82,5.44,62,351,2383,9.4
27809,Trevor Daley,2011-12,28.0,8,25,75,75,7,18,25,104.0,1650.0,339,20,61,81,384.0,82,5.7,65,341,2477,9.4
27810,Trevor Daley,2012-13,29.0,9,22,77,77,6,16,22,107.0,1708.0,416,26,77,103,491.0,82,5.53,56,304,2486,9.1
27811,Trevor Daley,2013-14,30.0,10,27,82,82,8,19,27,131.0,1844.0,498,34,96,130,622.0,82,5.46,52,291,2492,9.0
27812,Trevor Daley,2014-15,31.0,11,25,79,79,4,21,25,134.0,1710.0,577,38,117,155,756.0,82,5.32,47,271,2439,8.9
27813,Trevor Daley,2015-16,32.0,12,13,44,44,4,9,13,58.0,942.0,621,42,126,168,814.0,48,5.31,29,160,1399,9.1
27814,Trevor Daley,2016-17,33.0,13,25,67,67,9,16,25,107.0,1417.0,688,51,142,193,921.0,82,5.34,48,269,2463,8.9
27815,Trevor Daley,2017-18,34.0,14,38,68,68,16,22,38,113.0,1556.0,756,67,164,231,1034.0,82,5.32,47,251,2453,8.9
27816,Trevor Daley,2018-19,35.0,15,28,82,82,6,22,28,130.0,1512.0,838,73,186,259,1164.0,82,5.34,48,255,2438,9.0
27817,Trevor Daley,2019-20,36.0,16,19,56,56,5,14,19,84.0,1141.0,894,78,200,278,1248.0,82,5.45,47,245,2478,9.0
27818,Trevor Daley,2020-21,37.0,17,16,77,77,9,7,16,103.0,1594.0,971,87,207,294,1351.0,82,5.86,50,250,2620,9.2
27819,Trevor Daley,2021-22,38.0,18,8,44,44,2,6,8,47.0,817.0,1015,89,213,302,1398.0,82,5.96,47,239,2579,9.5
27820,Trevor Daley,2022-23,39.0,19,7,43,43,0,7,7,37.0,673.0,1058,89,220,309,1435.0,70,5.96,42,208,2192,9.5
27821,Trevor Frischmon,2012-13,31.0,4,0,3,3,0,0,0,1.0,18.0,3,0,0,0,1.0,82,5.53,56,304,2486,9.1
27822,Trevor Gillies,2008-09,30.0,4,0,1,1,0,0,0,1.0,3.0,1,0,0,0,1.0,82,6.05,85,480,2458,10.1
27823,Trevor Gillies,2012-13,34.0,5,1,14,14,0,1,1,6.0,53.0,15,0,1,1,7.0,82,5.53,56,304,2486,9.1
27824,Trevor Gillies,2013-14,35.0,6,2,39,39,2,0,2,9.0,120.0,54,2,1,3,16.0,82,5.46,52,291,2492,9.0
27825,Trevor Gillies,2014-15,36.0,7,0,3,3,0,0,0,1.0,9.0,57,2,1,3,17.0,82,5.32,47,271,2439,8.9
27826,Trevor Halverson,2001-02,30.0,4,4,17,17,0,4,4,16.0,203.0,17,0,4,4,16.0,82,5.27,57,359,2285,9.4
27827,Trevor Letowski,2001-02,24.0,4,4,14,14,2,2,4,8.0,84.0,14,2,2,4,8.0,82,5.27,57,359,2285,9.4
27828,Trevor Letowski,2002-03,25.0,5,39,82,82,19,20,39,125.0,1316.0,96,21,22,43,133.0,82,5.49,53,331,2294,9.8
27829,Trevor Letowski,2003-04,26.0,6,22,77,77,7,15,22,110.0,1258.0,173,28,37,65,243.0,82,5.51,63,376,2272,9.9
27830,Trevor Letowski,2004-05,27.0,7,25,75,75,9,16,25,108.0,1014.0,248,37,53,90,351.0,82,5.24,53,338,2262,9.5
27831,Trevor Letowski,2005-06,28.0,8,25,78,78,11,14,25,136.0,970.0,326,48,67,115,487.0,82,5.31,60,363,2326,9.4
27832,Trevor Letowski,2006-07,29.0,9,32,73,73,15,17,32,126.0,1191.0,399,63,84,147,613.0,82,5.14,57,348,2300,9.2
27833,Trevor Letowski,2008-09,31.0,10,28,81,81,10,18,28,135.0,1339.0,480,73,102,175,748.0,82,6.05,85,480,2458,10.1
27834,Trevor Letowski,2009-10,32.0,11,8,61,61,2,6,8,69.0,591.0,541,75,108,183,817.0,82,5.76,70,398,2426,9.7
27835,Trevor Letowski,2010-11,33.0,12,18,75,75,9,9,18,67.0,770.0,616,84,117,201,884.0,82,5.44,62,351,2383,9.4
27836,Trevor Lewis,2011-12,25.0,4,3,6,6,1,2,3,10.0,70.0,6,1,2,3,10.0,82,5.7,65,341,2477,9.4
27837,Trevor Lewis,2012-13,26.0,5,0,5,5,0,0,0,4.0,46.0,11,1,2,3,14.0,82,5.53,56,304,2486,9.1
27838,Trevor Lewis,2013-14,27.0,6,13,72,72,3,10,13,105.0,827.0,83,4,12,16,119.0,82,5.46,52,291,2492,9.0
27839,Trevor Lewis,2014-15,28.0,7,7,72,72,3,4,7,103.0,953.0,155,7,16,23,222.0,82,5.32,47,271,2439,8.9
27840,Trevor Lewis,2015-16,29.0,8,14,48,48,5,9,14,92.0,730.0,203,12,25,37,314.0,48,5.31,29,160,1399,9.1
27841,Trevor Lewis,2016-17,30.0,9,11,73,73,6,5,11,111.0,968.0,276,18,30,48,425.0,82,5.34,48,269,2463,8.9
27842,Trevor Lewis,2017-18,31.0,10,25,73,73,9,16,25,143.0,1030.0,349,27,46,73,568.0,82,5.32,47,251,2453,8.9
27843,Trevor Lewis,2018-19,32.0,11,16,75,75,8,8,16,167.0,1092.0,424,35,54,89,735.0,82,5.34,48,255,2438,9.0
27844,Trevor Lewis,2019-20,33.0,12,24,82,82,12,12,24,145.0,1170.0,506,47,66,113,880.0,82,5.45,47,245,2478,9.0
27845,Trevor Lewis,2020-21,34.0,13,26,68,68,14,12,26,134.0,1036.0,574,61,78,139,1014.0,82,5.86,50,250,2620,9.2
27846,Trevor Lewis,2021-22,35.0,14,12,44,44,3,9,12,87.0,617.0,618,64,87,151,1101.0,82,5.96,47,239,2579,9.5
27847,Trevor Lewis,2022-23,36.0,15,12,56,56,6,6,12,92.0,666.0,674,70,93,163,1193.0,70,5.96,42,208,2192,9.5
27848,Trevor Linden,1991-92,21.0,4,59,80,80,30,29,59,186.0,,80,30,29,59,186.0,80,7.48,85,403,2430,12.3
27849,Trevor Linden,1992-93,22.0,5,51,73,73,21,30,51,171.0,,153,51,59,110,357.0,80,7.37,76,367,2421,12.2
27850,Trevor Linden,1993-94,23.0,6,70,80,80,33,37,70,229.0,,233,84,96,180,586.0,80,6.91,71,366,2385,11.6
27851,Trevor Linden,1994-95,24.0,7,75,80,80,31,44,75,201.0,,313,115,140,255,787.0,80,6.96,77,402,2440,11.4
27852,Trevor Linden,1995-96,25.0,8,72,84,84,33,39,72,209.0,,397,148,179,327,996.0,84,7.25,87,443,2603,11.7
27853,Trevor Linden,1996-97,26.0,9,61,84,84,32,29,61,234.0,,481,180,208,388,1230.0,84,6.48,76,407,2545,10.7
27854,Trevor Linden,1997-98,27.0,10,40,48,48,18,22,40,129.0,,529,198,230,428,1359.0,48,5.97,37,209,1408,10.2
27855,Trevor Linden,1998-99,28.0,11,80,82,82,33,47,80,202.0,,611,231,277,508,1561.0,82,6.29,74,413,2481,10.4
27856,Trevor Linden,1999-00,29.0,12,40,49,49,9,31,40,84.0,,660,240,308,548,1645.0,82,5.83,55,336,2444,9.8
27857,Trevor Linden,2000-01,30.0,13,38,67,67,17,21,38,133.0,,727,257,329,586,1778.0,82,5.28,57,380,2242,9.6
27858,Trevor Linden,2001-02,31.0,14,47,82,82,18,29,47,167.0,1762.0,809,275,358,633,1945.0,82,5.27,57,359,2285,9.4
27859,Trevor Linden,2002-03,32.0,15,30,50,50,13,17,30,87.0,892.0,859,288,375,663,2032.0,82,5.49,53,331,2294,9.8
27860,Trevor Linden,2003-04,33.0,16,37,69,69,15,22,37,126.0,1402.0,928,303,397,700,2158.0,82,5.51,63,376,2272,9.9
27861,Trevor Linden,2004-05,34.0,17,37,80,80,13,24,37,141.0,1498.0,1008,316,421,737,2299.0,82,5.24,53,338,2262,9.5
27862,Trevor Linden,2005-06,35.0,18,41,71,71,19,22,41,116.0,1126.0,1079,335,443,778,2415.0,82,5.31,60,363,2326,9.4
27863,Trevor Linden,2006-07,36.0,19,36,82,82,14,22,36,97.0,1336.0,1161,349,465,814,2512.0,82,5.14,57,348,2300,9.2
27864,Trevor Linden,2008-09,38.0,20,16,82,82,7,9,16,55.0,929.0,1243,356,474,830,2567.0,82,6.05,85,480,2458,10.1
27865,Trevor Linden,2009-10,39.0,21,25,80,80,12,13,25,92.0,987.0,1323,368,487,855,2659.0,82,5.76,70,398,2426,9.7
27866,Trevor Linden,2010-11,40.0,22,12,59,59,7,5,12,45.0,667.0,1382,375,492,867,2704.0,82,5.44,62,351,2383,9.4
27867,Trevor Moore,2021-22,26.0,4,8,25,25,2,6,8,26.0,227.0,25,2,6,8,26.0,82,5.96,47,239,2579,9.5
27868,Trevor Moore,2022-23,27.0,5,10,42,42,6,4,10,60.0,542.0,67,8,10,18,86.0,70,5.96,42,208,2192,9.5
27869,Trevor Murphy,2020-21,25.0,4,3,8,8,1,2,3,5.0,114.0,8,1,2,3,5.0,82,5.86,50,250,2620,9.2
27870,Trevor Sim,1992-93,22.0,4,1,3,3,0,1,1,0.0,,3,0,1,1,0.0,80,7.37,76,367,2421,12.2
27871,Trevor Smith,2011-12,26.0,4,1,7,7,1,0,1,7.0,83.0,7,1,0,1,7.0,82,5.7,65,341,2477,9.4
27872,Trevor Smith,2014-15,29.0,5,5,16,16,2,3,5,17.0,199.0,23,3,3,6,24.0,82,5.32,47,271,2439,8.9
27873,Trevor Smith,2015-16,30.0,6,0,1,1,0,0,0,0.0,10.0,24,3,3,6,24.0,48,5.31,29,160,1399,9.1
27874,Trevor Smith,2016-17,31.0,7,9,28,28,4,5,9,24.0,290.0,52,7,8,15,48.0,82,5.34,48,269,2463,8.9
27875,Trevor Smith,2017-18,32.0,8,5,54,54,2,3,5,46.0,597.0,106,9,11,20,94.0,82,5.32,47,251,2453,8.9
27876,Trevor Smith,2019-20,34.0,9,0,1,1,0,0,0,0.0,7.0,107,9,11,20,94.0,82,5.45,47,245,2478,9.0
27877,Trevor Stienburg,1988-89,22.0,4,1,2,2,1,0,1,6.0,,2,1,0,1,6.0,80,7.94,82,370,2484,12.8
27878,Trevor Stienburg,1989-90,23.0,5,1,6,6,1,0,1,6.0,,8,2,0,2,12.0,80,7.34,72,344,2400,12.2
27879,Trevor Stienburg,1990-91,24.0,6,1,8,8,0,1,1,3.0,,16,2,1,3,15.0,80,7.43,89,437,2435,12.2
27880,Trevor Stienburg,1991-92,25.0,7,9,55,55,6,3,9,65.0,,71,8,4,12,80.0,80,7.48,85,403,2430,12.3
27881,Trevor van Riemsdyk,2017-18,26.0,4,1,18,18,0,1,1,21.0,244.0,18,0,1,1,21.0,82,5.32,47,251,2453,8.9
27882,Trevor van Riemsdyk,2018-19,27.0,5,14,82,82,3,11,14,85.0,1639.0,100,3,12,15,106.0,82,5.34,48,255,2438,9.0
27883,Trevor van Riemsdyk,2019-20,28.0,6,16,58,58,5,11,16,73.0,1068.0,158,8,23,31,179.0,82,5.45,47,245,2478,9.0
27884,Trevor van Riemsdyk,2020-21,29.0,7,16,79,79,3,13,16,111.0,1347.0,237,11,36,47,290.0,82,5.86,50,250,2620,9.2
27885,Trevor van Riemsdyk,2021-22,30.0,8,14,78,78,3,11,14,102.0,1175.0,315,14,47,61,392.0,82,5.96,47,239,2579,9.5
27886,Trevor van Riemsdyk,2022-23,31.0,9,8,49,49,1,7,8,58.0,728.0,364,15,54,69,450.0,70,5.96,42,208,2192,9.5
27887,Triston Grant,2009-10,25.0,4,1,8,8,0,1,1,3.0,36.0,8,0,1,1,3.0,82,5.76,70,398,2426,9.7
27888,Triston Grant,2012-13,28.0,5,0,3,3,0,0,0,2.0,22.0,11,0,1,1,5.0,82,5.53,56,304,2486,9.1
27889,Troy Bodie,2011-12,27.0,4,0,4,4,0,0,0,5.0,33.0,4,0,0,0,5.0,82,5.7,65,341,2477,9.4
27890,Troy Bodie,2012-13,28.0,5,7,44,44,5,2,7,58.0,495.0,48,5,2,7,63.0,82,5.53,56,304,2486,9.1
27891,Troy Bodie,2013-14,29.0,6,4,59,59,1,3,4,44.0,403.0,107,6,5,11,107.0,82,5.46,52,291,2492,9.0
27892,Troy Bodie,2016-17,32.0,7,10,47,47,3,7,10,50.0,405.0,154,9,12,21,157.0,82,5.34,48,269,2463,8.9
27893,Troy Bodie,2017-18,33.0,8,0,5,5,0,0,0,1.0,23.0,159,9,12,21,158.0,82,5.32,47,251,2453,8.9
27894,Troy Brouwer,2009-10,24.0,4,0,10,10,0,0,0,7.0,99.0,10,0,0,0,7.0,82,5.76,70,398,2426,9.7
27895,Troy Brouwer,2010-11,25.0,5,1,2,2,0,1,1,0.0,24.0,12,0,1,1,7.0,82,5.44,62,351,2383,9.4
27896,Troy Brouwer,2011-12,26.0,6,26,69,69,10,16,26,126.0,1041.0,81,10,17,27,133.0,82,5.7,65,341,2477,9.4
27897,Troy Brouwer,2012-13,27.0,7,40,78,78,22,18,40,116.0,1277.0,159,32,35,67,249.0,82,5.53,56,304,2486,9.1
27898,Troy Brouwer,2013-14,28.0,8,36,79,79,17,19,36,122.0,1193.0,238,49,54,103,371.0,82,5.46,52,291,2492,9.0
27899,Troy Brouwer,2014-15,29.0,9,33,82,82,18,15,33,133.0,1408.0,320,67,69,136,504.0,82,5.32,47,271,2439,8.9
27900,Troy Brouwer,2015-16,30.0,10,33,47,47,19,14,33,111.0,871.0,367,86,83,169,615.0,48,5.31,29,160,1399,9.1
27901,Troy Brouwer,2016-17,31.0,11,43,82,82,25,18,43,161.0,1546.0,449,111,101,212,776.0,82,5.34,48,269,2463,8.9
27902,Troy Brouwer,2017-18,32.0,12,43,82,82,21,22,43,145.0,1437.0,531,132,123,255,921.0,82,5.32,47,251,2453,8.9
27903,Troy Brouwer,2018-19,33.0,13,39,82,82,18,21,39,142.0,1394.0,613,150,144,294,1063.0,82,5.34,48,255,2438,9.0
27904,Troy Brouwer,2019-20,34.0,14,25,74,74,13,12,25,86.0,1200.0,687,163,156,319,1149.0,82,5.45,47,245,2478,9.0
27905,Troy Brouwer,2020-21,35.0,15,22,76,76,6,16,22,79.0,1059.0,763,169,172,341,1228.0,82,5.86,50,250,2620,9.2
27906,Troy Brouwer,2021-22,36.0,16,21,75,75,12,9,21,86.0,952.0,838,181,181,362,1314.0,82,5.96,47,239,2579,9.5
27907,Troy Brouwer,2022-23,37.0,17,1,13,13,1,0,1,12.0,123.0,851,182,181,363,1326.0,70,5.96,42,208,2192,9.5
27908,Troy Crowder,1992-93,24.0,4,0,10,10,0,0,0,4.0,,10,0,0,0,4.0,80,7.37,76,367,2421,12.2
27909,Troy Crowder,1993-94,25.0,5,9,59,59,6,3,9,46.0,,69,6,3,9,50.0,80,6.91,71,366,2385,11.6
27910,Troy Crowder,1994-95,26.0,6,0,7,7,0,0,0,2.0,,76,6,3,9,52.0,80,6.96,77,402,2440,11.4
27911,Troy Crowder,1997-98,29.0,7,3,29,29,1,2,3,4.0,,105,7,5,12,56.0,48,5.97,37,209,1408,10.2
27912,Troy Crowder,1998-99,30.0,8,1,15,15,1,0,1,11.0,,120,8,5,13,67.0,82,6.29,74,413,2481,10.4
27913,Troy Crowder,1999-00,31.0,9,3,30,30,1,2,3,11.0,,150,9,7,16,78.0,82,5.83,55,336,2444,9.8
27914,Troy Loney,1986-87,23.0,4,0,13,13,0,0,0,5.0,,13,0,0,0,5.0,80,7.89,74,336,2448,12.9
27915,Troy Loney,1987-88,24.0,5,18,46,46,10,8,18,79.0,,59,10,8,18,84.0,80,7.77,71,321,2447,12.7
27916,Troy Loney,1988-89,25.0,6,12,47,47,3,9,12,50.0,,106,13,17,30,134.0,80,7.94,82,370,2484,12.8
27917,Troy Loney,1989-90,26.0,7,15,23,23,8,7,15,48.0,,129,21,24,45,182.0,80,7.34,72,344,2400,12.2
27918,Troy Loney,1990-91,27.0,8,18,65,65,5,13,18,87.0,,194,26,37,63,269.0,80,7.43,89,437,2435,12.2
27919,Troy Loney,1991-92,28.0,9,16,69,69,10,6,16,90.0,,263,36,43,79,359.0,80,7.48,85,403,2430,12.3
27920,Troy Loney,1992-93,29.0,10,27,67,67,11,16,27,78.0,,330,47,59,106,437.0,80,7.37,76,367,2421,12.2
27921,Troy Loney,1993-94,30.0,11,16,44,44,7,9,16,51.0,,374,54,68,122,488.0,80,6.91,71,366,2385,11.6
27922,Troy Loney,1994-95,31.0,12,26,76,76,10,16,26,94.0,,450,64,84,148,582.0,80,6.96,77,402,2440,11.4
27923,Troy Loney,1995-96,32.0,13,21,82,82,5,16,21,83.0,,532,69,100,169,665.0,84,7.25,87,443,2603,11.7
27924,Troy Loney,1996-97,33.0,14,19,62,62,13,6,19,93.0,,594,82,106,188,758.0,84,6.48,76,407,2545,10.7
27925,Troy Loney,1997-98,34.0,15,9,30,30,5,4,9,47.0,,624,87,110,197,805.0,48,5.97,37,209,1408,10.2
27926,Troy Mallette,1992-93,22.0,4,29,79,79,13,16,29,107.0,,79,13,16,29,107.0,80,7.37,76,367,2421,12.2
27927,Troy Mallette,1993-94,23.0,5,22,71,71,12,10,22,91.0,,150,25,26,51,198.0,80,6.91,71,366,2385,11.6
27928,Troy Mallette,1994-95,24.0,6,11,32,32,4,7,11,28.0,,182,29,33,62,226.0,80,6.96,77,402,2440,11.4
27929,Troy Mallette,1995-96,25.0,7,7,34,34,4,3,7,19.0,,216,33,36,69,245.0,84,7.25,87,443,2603,11.7
27930,Troy Mallette,1996-97,26.0,8,23,82,82,7,16,23,100.0,,298,40,52,92,345.0,84,6.48,76,407,2545,10.7
27931,Troy Mallette,1997-98,27.0,9,8,23,23,3,5,8,21.0,,321,43,57,100,366.0,48,5.97,37,209,1408,10.2
27932,Troy Mallette,1998-99,28.0,10,5,64,64,2,3,5,51.0,,385,45,60,105,417.0,82,6.29,74,413,2481,10.4
27933,Troy Mallette,1999-00,29.0,11,14,68,68,6,8,14,61.0,,453,51,68,119,478.0,82,5.83,55,336,2444,9.8
27934,Troy Mallette,2000-01,30.0,12,0,3,3,0,0,0,0.0,,456,51,68,119,478.0,82,5.28,57,380,2242,9.6
27935,Troy Murray,1984-85,22.0,4,0,1,1,0,0,0,2.0,,1,0,0,0,2.0,80,8.03,73,320,2489,12.9
27936,Troy Murray,1985-86,23.0,5,16,54,54,8,8,16,53.0,,55,8,8,16,55.0,80,7.73,71,310,2444,12.7
27937,Troy Murray,1986-87,24.0,6,30,61,61,15,15,30,118.0,,116,23,23,46,173.0,80,7.89,74,336,2448,12.9
27938,Troy Murray,1987-88,25.0,7,66,80,80,26,40,66,159.0,,196,49,63,112,332.0,80,7.77,71,321,2447,12.7
27939,Troy Murray,1988-89,26.0,8,99,80,80,45,54,99,196.0,,276,94,117,211,528.0,80,7.94,82,370,2484,12.8
27940,Troy Murray,1989-90,27.0,9,71,77,77,28,43,71,128.0,,353,122,160,282,656.0,80,7.34,72,344,2400,12.2
27941,Troy Murray,1990-91,28.0,10,58,79,79,22,36,58,148.0,,432,144,196,340,804.0,80,7.43,89,437,2435,12.2
27942,Troy Murray,1991-92,29.0,11,51,79,79,21,30,51,156.0,,511,165,226,391,960.0,80,7.48,85,403,2430,12.3
27943,Troy Murray,1992-93,30.0,12,55,68,68,17,38,55,111.0,,579,182,264,446,1071.0,80,7.37,76,367,2421,12.2
27944,Troy Murray,1993-94,31.0,13,37,75,75,14,23,37,130.0,,654,196,287,483,1201.0,80,6.91,71,366,2385,11.6
27945,Troy Murray,1994-95,32.0,14,47,74,74,17,30,47,156.0,,728,213,317,530,1357.0,80,6.96,77,402,2440,11.4
27946,Troy Murray,1995-96,33.0,15,11,51,51,4,7,11,77.0,,779,217,324,541,1434.0,84,7.25,87,443,2603,11.7
27947,Troy Murray,1996-97,34.0,16,6,27,27,2,4,6,21.0,,806,219,328,547,1455.0,84,6.48,76,407,2545,10.7
27948,Troy Murray,1997-98,35.0,17,16,46,46,4,12,16,45.0,,852,223,340,563,1500.0,48,5.97,37,209,1408,10.2
27949,Troy Murray,1998-99,36.0,18,21,63,63,7,14,21,36.0,,915,230,354,584,1536.0,82,6.29,74,413,2481,10.4
27950,Troy Stecher,2019-20,25.0,4,24,71,71,3,21,24,125.0,1419.0,71,3,21,24,125.0,82,5.45,47,245,2478,9.0
27951,Troy Stecher,2020-21,26.0,5,11,68,68,1,10,11,94.0,1279.0,139,4,31,35,219.0,82,5.86,50,250,2620,9.2
27952,Troy Stecher,2021-22,27.0,6,23,78,78,2,21,23,105.0,1554.0,217,6,52,58,324.0,82,5.96,47,239,2579,9.5
27953,Troy Stecher,2022-23,28.0,7,17,69,69,5,12,17,86.0,1059.0,286,11,64,75,410.0,70,5.96,42,208,2192,9.5
27954,Troy Terry,2020-21,23.0,4,0,2,2,0,0,0,3.0,20.0,2,0,0,0,3.0,82,5.86,50,250,2620,9.2
27955,Troy Terry,2021-22,24.0,5,13,32,32,4,9,13,25.0,446.0,34,4,9,13,28.0,82,5.96,47,239,2579,9.5
27956,Troy Terry,2022-23,25.0,6,15,47,47,4,11,15,73.0,682.0,81,8,20,28,101.0,70,5.96,42,208,2192,9.5
27957,Tucker Poolman,2020-21,27.0,4,2,24,24,1,1,2,27.0,302.0,24,1,1,2,27.0,82,5.86,50,250,2620,9.2
27958,Tucker Poolman,2022-23,29.0,5,16,57,57,4,12,16,64.0,995.0,81,5,13,18,91.0,70,5.96,42,208,2192,9.5
27959,Tuomas Gronman,1999-00,25.0,4,1,16,16,0,1,1,9.0,,16,0,1,1,9.0,82,5.83,55,336,2444,9.8
27960,Tuomas Gronman,2000-01,26.0,5,3,22,22,1,2,3,33.0,,38,1,3,4,42.0,82,5.28,57,380,2242,9.6
27961,Tuomas Pihlman,2006-07,24.0,4,0,2,2,0,0,0,1.0,14.0,2,0,0,0,1.0,82,5.14,57,348,2300,9.2
27962,Tuomas Pihlman,2008-09,26.0,5,2,11,11,1,1,2,14.0,111.0,13,1,1,2,15.0,82,6.05,85,480,2458,10.1
27963,Tuomas Pihlman,2009-10,27.0,6,0,2,2,0,0,0,0.0,13.0,15,1,1,2,15.0,82,5.76,70,398,2426,9.7
27964,Tuomo Ruutu,2006-07,23.0,4,44,82,82,23,21,44,174.0,1345.0,82,23,21,44,174.0,82,5.14,57,348,2300,9.2
27965,Tuomo Ruutu,2008-09,25.0,5,5,15,15,2,3,5,30.0,221.0,97,25,24,49,204.0,82,6.05,85,480,2458,10.1
27966,Tuomo Ruutu,2009-10,26.0,6,38,71,71,17,21,38,115.0,1232.0,168,42,45,87,319.0,82,5.76,70,398,2426,9.7
27967,Tuomo Ruutu,2010-11,27.0,7,32,77,77,10,22,32,100.0,1224.0,245,52,67,119,419.0,82,5.44,62,351,2383,9.4
27968,Tuomo Ruutu,2011-12,28.0,8,54,79,79,26,28,54,190.0,1447.0,324,78,95,173,609.0,82,5.7,65,341,2477,9.4
27969,Tuomo Ruutu,2012-13,29.0,9,35,54,54,14,21,35,122.0,885.0,378,92,116,208,731.0,82,5.53,56,304,2486,9.1
27970,Tuomo Ruutu,2013-14,30.0,10,57,82,82,19,38,57,148.0,1380.0,460,111,154,265,879.0,82,5.46,52,291,2492,9.0
27971,Tuomo Ruutu,2014-15,31.0,11,34,72,72,18,16,34,156.0,1185.0,532,129,170,299,1035.0,82,5.32,47,271,2439,8.9
27972,Tuomo Ruutu,2015-16,32.0,12,9,17,17,4,5,9,30.0,259.0,549,133,175,308,1065.0,48,5.31,29,160,1399,9.1
27973,Tuomo Ruutu,2016-17,33.0,13,24,76,76,8,16,24,105.0,1107.0,625,141,191,332,1170.0,82,5.34,48,269,2463,8.9
27974,Tuomo Ruutu,2017-18,34.0,14,13,77,77,7,6,13,74.0,837.0,702,148,197,345,1244.0,82,5.32,47,251,2453,8.9
27975,Tuomo Ruutu,2018-19,35.0,15,1,33,33,0,1,1,34.0,380.0,735,148,198,346,1278.0,82,5.34,48,255,2438,9.0
27976,Turner Elson,2018-19,26.0,4,1,1,1,0,1,1,0.0,15.0,1,0,1,1,0.0,82,5.34,48,255,2438,9.0
27977,Turner Stevenson,1995-96,23.0,4,0,1,1,0,0,0,1.0,,1,0,0,0,1.0,84,7.25,87,443,2603,11.7
27978,Turner Stevenson,1996-97,24.0,5,0,2,2,0,0,0,0.0,,3,0,0,0,1.0,84,6.48,76,407,2545,10.7
27979,Turner Stevenson,1997-98,25.0,6,7,41,41,6,1,7,35.0,,44,6,1,7,36.0,48,5.97,37,209,1408,10.2
27980,Turner Stevenson,1998-99,26.0,7,25,80,80,9,16,25,101.0,,124,15,17,32,137.0,82,6.29,74,413,2481,10.4
27981,Turner Stevenson,1999-00,27.0,8,21,65,65,8,13,21,76.0,,189,23,30,53,213.0,82,5.83,55,336,2444,9.8
27982,Turner Stevenson,2000-01,28.0,9,10,63,63,4,6,10,43.0,,252,27,36,63,256.0,82,5.28,57,380,2242,9.6
27983,Turner Stevenson,2001-02,29.0,10,27,69,69,10,17,27,102.0,894.0,321,37,53,90,358.0,82,5.27,57,359,2285,9.4
27984,Turner Stevenson,2002-03,30.0,11,21,64,64,8,13,21,94.0,843.0,385,45,66,111,452.0,82,5.49,53,331,2294,9.8
27985,Turner Stevenson,2003-04,31.0,12,26,69,69,8,18,26,92.0,759.0,454,53,84,137,544.0,82,5.51,63,376,2272,9.9
27986,Turner Stevenson,2004-05,32.0,13,2,21,21,0,2,2,33.0,244.0,475,53,86,139,577.0,82,5.24,53,338,2262,9.5
27987,Turner Stevenson,2005-06,33.0,14,20,77,77,7,13,20,85.0,915.0,552,60,99,159,662.0,82,5.31,60,363,2326,9.4
27988,Turner Stevenson,2006-07,34.0,15,27,61,61,14,13,27,76.0,775.0,613,74,112,186,738.0,82,5.14,57,348,2300,9.2
27989,Turner Stevenson,2008-09,36.0,16,4,31,31,1,3,4,26.0,258.0,644,75,115,190,764.0,82,6.05,85,480,2458,10.1
27990,Ty Jones,2001-02,22.0,4,0,8,8,0,0,0,3.0,63.0,8,0,0,0,3.0,82,5.27,57,359,2285,9.4
27991,Ty Jones,2006-07,27.0,5,0,6,6,0,0,0,1.0,19.0,14,0,0,0,4.0,82,5.14,57,348,2300,9.2
27992,Ty Rattie,2016-17,23.0,4,0,2,2,0,0,0,4.0,22.0,2,0,0,0,4.0,82,5.34,48,269,2463,8.9
27993,Ty Rattie,2017-18,24.0,5,2,11,11,0,2,2,8.0,100.0,13,0,2,2,12.0,82,5.32,47,251,2453,8.9
27994,Ty Rattie,2018-19,25.0,6,6,13,13,4,2,6,16.0,121.0,26,4,4,8,28.0,82,5.34,48,255,2438,9.0
27995,Ty Rattie,2019-20,26.0,7,2,9,9,0,2,2,10.0,97.0,35,4,6,10,38.0,82,5.45,47,245,2478,9.0
27996,Ty Rattie,2020-21,27.0,8,9,14,14,5,4,9,32.0,217.0,49,9,10,19,70.0,82,5.86,50,250,2620,9.2
27997,Ty Rattie,2021-22,28.0,9,11,50,50,4,7,11,84.0,567.0,99,13,17,30,154.0,82,5.96,47,239,2579,9.5
27998,Ty Wishart,2011-12,23.0,4,1,5,5,0,1,1,2.0,51.0,5,0,1,1,2.0,82,5.7,65,341,2477,9.4
27999,Ty Wishart,2013-14,25.0,5,5,20,20,1,4,5,23.0,336.0,25,1,5,6,25.0,82,5.46,52,291,2492,9.0
28000,Ty Wishart,2014-15,26.0,6,0,1,1,0,0,0,0.0,17.0,26,1,5,6,25.0,82,5.32,47,271,2439,8.9
28001,Tye McGinn,2015-16,25.0,4,5,18,18,3,2,5,33.0,229.0,18,3,2,5,33.0,48,5.31,29,160,1399,9.1
28002,Tye McGinn,2016-17,26.0,5,5,18,18,4,1,5,16.0,201.0,36,7,3,10,49.0,82,5.34,48,269,2463,8.9
28003,Tye McGinn,2017-18,27.0,6,7,51,51,2,5,7,60.0,515.0,87,9,8,17,109.0,82,5.32,47,251,2453,8.9
28004,Tye McGinn,2018-19,28.0,7,0,2,2,0,0,0,1.0,17.0,89,9,8,17,110.0,82,5.34,48,255,2438,9.0
28005,Tyler Arnason,2004-05,25.0,4,4,21,21,3,1,4,19.0,199.0,21,3,1,4,19.0,82,5.24,53,338,2262,9.5
28006,Tyler Arnason,2005-06,26.0,5,39,82,82,19,20,39,178.0,1190.0,103,22,21,43,197.0,82,5.31,60,363,2326,9.4
28007,Tyler Arnason,2006-07,27.0,6,55,82,82,22,33,55,222.0,1358.0,185,44,54,98,419.0,82,5.14,57,348,2300,9.2
28008,Tyler Arnason,2008-09,29.0,7,45,79,79,13,32,45,203.0,1132.0,264,57,86,143,622.0,82,6.05,85,480,2458,10.1
28009,Tyler Arnason,2009-10,30.0,8,49,82,82,16,33,49,211.0,1176.0,346,73,119,192,833.0,82,5.76,70,398,2426,9.7
28010,Tyler Arnason,2010-11,31.0,9,31,70,70,10,21,31,179.0,1068.0,416,83,140,223,1012.0,82,5.44,62,351,2383,9.4
28011,Tyler Arnason,2011-12,32.0,10,22,71,71,5,17,22,108.0,945.0,487,88,157,245,1120.0,82,5.7,65,341,2477,9.4
28012,Tyler Benson,2022-23,24.0,4,1,7,7,0,1,1,5.0,73.0,7,0,1,1,5.0,70,5.96,42,208,2192,9.5
28013,Tyler Bertuzzi,2019-20,24.0,4,0,7,7,0,0,0,3.0,64.0,7,0,0,0,3.0,82,5.45,47,245,2478,9.0
28014,Tyler Bertuzzi,2020-21,25.0,5,24,48,48,7,17,24,83.0,691.0,55,7,17,24,86.0,82,5.86,50,250,2620,9.2
28015,Tyler Bertuzzi,2021-22,26.0,6,47,73,73,21,26,47,131.0,1206.0,128,28,43,71,217.0,82,5.96,47,239,2579,9.5
28016,Tyler Bertuzzi,2022-23,27.0,7,48,71,71,21,27,48,129.0,1371.0,199,49,70,119,346.0,70,5.96,42,208,2192,9.5
28017,Tyler Bouck,2003-04,24.0,4,7,48,48,2,5,7,41.0,431.0,48,2,5,7,41.0,82,5.51,63,376,2272,9.9
28018,Tyler Bouck,2004-05,25.0,5,0,7,7,0,0,0,3.0,48.0,55,2,5,7,44.0,82,5.24,53,338,2262,9.5
28019,Tyler Bouck,2006-07,27.0,6,3,18,18,1,2,3,12.0,167.0,73,3,7,10,56.0,82,5.14,57,348,2300,9.2
28020,Tyler Bouck,2008-09,29.0,7,2,12,12,1,1,2,6.0,76.0,85,4,8,12,62.0,82,6.05,85,480,2458,10.1
28021,Tyler Bouck,2009-10,30.0,8,0,6,6,0,0,0,7.0,48.0,91,4,8,12,69.0,82,5.76,70,398,2426,9.7
28022,Tyler Bozak,2012-13,26.0,4,27,37,37,8,19,27,51.0,712.0,37,8,19,27,51.0,82,5.53,56,304,2486,9.1
28023,Tyler Bozak,2013-14,27.0,5,32,82,82,15,17,32,120.0,1581.0,119,23,36,59,171.0,82,5.46,52,291,2492,9.0
28024,Tyler Bozak,2014-15,28.0,6,47,73,73,18,29,47,109.0,1375.0,192,41,65,106,280.0,82,5.32,47,271,2439,8.9
28025,Tyler Bozak,2015-16,29.0,7,28,46,46,12,16,28,61.0,934.0,238,53,81,134,341.0,48,5.31,29,160,1399,9.1
28026,Tyler Bozak,2016-17,30.0,8,49,58,58,19,30,49,90.0,1215.0,296,72,111,183,431.0,82,5.34,48,269,2463,8.9
28027,Tyler Bozak,2017-18,31.0,9,49,82,82,23,26,49,154.0,1570.0,378,95,137,232,585.0,82,5.32,47,251,2453,8.9
28028,Tyler Bozak,2018-19,32.0,10,35,57,57,12,23,35,99.0,988.0,435,107,160,267,684.0,82,5.34,48,255,2438,9.0
28029,Tyler Bozak,2019-20,33.0,11,55,78,78,18,37,55,145.0,1282.0,513,125,197,322,829.0,82,5.45,47,245,2478,9.0
28030,Tyler Bozak,2020-21,34.0,12,43,81,81,11,32,43,154.0,1267.0,594,136,229,365,983.0,82,5.86,50,250,2620,9.2
28031,Tyler Bozak,2021-22,35.0,13,38,72,72,13,25,38,141.0,1177.0,666,149,254,403,1124.0,82,5.96,47,239,2579,9.5
28032,Tyler Bozak,2022-23,36.0,14,29,67,67,13,16,29,109.0,1026.0,733,162,270,432,1233.0,70,5.96,42,208,2192,9.5
28033,Tyler Cuma,2014-15,25.0,4,0,1,1,0,0,0,0.0,11.0,1,0,0,0,0.0,82,5.32,47,271,2439,8.9
28034,Tyler Eckford,2012-13,27.0,4,1,3,3,0,1,1,1.0,22.0,3,0,1,1,1.0,82,5.53,56,304,2486,9.1
28035,Tyler Eckford,2013-14,28.0,5,0,4,4,0,0,0,1.0,35.0,7,0,1,1,2.0,82,5.46,52,291,2492,9.0
28036,Tyler Ennis,2012-13,23.0,4,9,10,10,3,6,9,23.0,153.0,10,3,6,9,23.0,82,5.53,56,304,2486,9.1
28037,Tyler Ennis,2013-14,24.0,5,49,82,82,20,29,49,210.0,1285.0,92,23,35,58,233.0,82,5.46,52,291,2492,9.0
28038,Tyler Ennis,2014-15,25.0,6,34,48,48,15,19,34,82.0,776.0,140,38,54,92,315.0,82,5.32,47,271,2439,8.9
28039,Tyler Ennis,2015-16,26.0,7,31,47,47,10,21,31,108.0,840.0,187,48,75,123,423.0,48,5.31,29,160,1399,9.1
28040,Tyler Ennis,2016-17,27.0,8,43,80,80,21,22,43,210.0,1508.0,267,69,97,166,633.0,82,5.34,48,269,2463,8.9
28041,Tyler Ennis,2017-18,28.0,9,46,78,78,20,26,46,185.0,1491.0,345,89,123,212,818.0,82,5.32,47,251,2453,8.9
28042,Tyler Ennis,2018-19,29.0,10,11,23,23,3,8,11,57.0,416.0,368,92,131,223,875.0,82,5.34,48,255,2438,9.0
28043,Tyler Ennis,2019-20,30.0,11,13,51,51,5,8,13,89.0,655.0,419,97,139,236,964.0,82,5.45,47,245,2478,9.0
28044,Tyler Ennis,2020-21,31.0,12,22,73,73,8,14,22,115.0,874.0,492,105,153,258,1079.0,82,5.86,50,250,2620,9.2
28045,Tyler Ennis,2021-22,32.0,13,18,51,51,12,6,18,81.0,507.0,543,117,159,276,1160.0,82,5.96,47,239,2579,9.5
28046,Tyler Ennis,2022-23,33.0,14,37,70,70,16,21,37,159.0,1030.0,613,133,180,313,1319.0,70,5.96,42,208,2192,9.5
28047,Tyler Gaudet,2017-18,24.0,4,0,2,2,0,0,0,1.0,19.0,2,0,0,0,1.0,82,5.32,47,251,2453,8.9
28048,Tyler Gaudet,2018-19,25.0,5,3,14,14,1,2,3,6.0,148.0,16,1,2,3,7.0,82,5.34,48,255,2438,9.0
28049,Tyler Gaudet,2019-20,26.0,6,1,4,4,0,1,1,3.0,52.0,20,1,3,4,10.0,82,5.45,47,245,2478,9.0
28050,Tyler Graovac,2017-18,24.0,4,0,3,3,0,0,0,4.0,28.0,3,0,0,0,4.0,82,5.32,47,251,2453,8.9
28051,Tyler Graovac,2018-19,25.0,5,0,2,2,0,0,0,2.0,23.0,5,0,0,0,6.0,82,5.34,48,255,2438,9.0
28052,Tyler Graovac,2019-20,26.0,6,9,52,52,7,2,9,48.0,512.0,57,7,2,9,54.0,82,5.45,47,245,2478,9.0
28053,Tyler Graovac,2020-21,27.0,7,0,5,5,0,0,0,1.0,34.0,62,7,2,9,55.0,82,5.86,50,250,2620,9.2
28054,Tyler Graovac,2022-23,29.0,8,2,8,8,2,0,2,5.0,50.0,70,9,2,11,60.0,70,5.96,42,208,2192,9.5
28055,Tyler Johnson,2015-16,25.0,4,6,14,14,3,3,6,11.0,183.0,14,3,3,6,11.0,48,5.31,29,160,1399,9.1
28056,Tyler Johnson,2016-17,26.0,5,50,82,82,24,26,50,181.0,1540.0,96,27,29,56,192.0,82,5.34,48,269,2463,8.9
28057,Tyler Johnson,2017-18,27.0,6,72,77,77,29,43,72,203.0,1327.0,173,56,72,128,395.0,82,5.32,47,251,2453,8.9
28058,Tyler Johnson,2018-19,28.0,7,38,69,69,14,24,38,167.0,1183.0,242,70,96,166,562.0,82,5.34,48,255,2438,9.0
28059,Tyler Johnson,2019-20,29.0,8,45,66,66,19,26,45,130.0,1242.0,308,89,122,211,692.0,82,5.45,47,245,2478,9.0
28060,Tyler Johnson,2020-21,30.0,9,50,81,81,21,29,50,186.0,1376.0,389,110,151,261,878.0,82,5.86,50,250,2620,9.2
28061,Tyler Johnson,2021-22,31.0,10,47,80,80,29,18,47,163.0,1276.0,469,139,169,308,1041.0,82,5.96,47,239,2579,9.5
28062,Tyler Johnson,2022-23,32.0,11,31,65,65,14,17,31,113.0,945.0,534,153,186,339,1154.0,70,5.96,42,208,2192,9.5
28063,Tyler Kennedy,2010-11,24.0,4,19,55,55,10,9,19,104.0,672.0,55,10,9,19,104.0,82,5.44,62,351,2383,9.4
28064,Tyler Kennedy,2011-12,25.0,5,35,67,67,15,20,35,171.0,923.0,122,25,29,54,275.0,82,5.7,65,341,2477,9.4
28065,Tyler Kennedy,2012-13,26.0,6,25,64,64,13,12,25,175.0,805.0,186,38,41,79,450.0,82,5.53,56,304,2486,9.1
28066,Tyler Kennedy,2013-14,27.0,7,45,80,80,21,24,45,234.0,1162.0,266,59,65,124,684.0,82,5.46,52,291,2492,9.0
28067,Tyler Kennedy,2014-15,28.0,8,33,60,60,11,22,33,195.0,862.0,326,70,87,157,879.0,82,5.32,47,271,2439,8.9
28068,Tyler Kennedy,2015-16,29.0,9,11,46,46,6,5,11,100.0,573.0,372,76,92,168,979.0,48,5.31,29,160,1399,9.1
28069,Tyler Kennedy,2016-17,30.0,10,17,67,67,4,13,17,143.0,852.0,439,80,105,185,1122.0,82,5.34,48,269,2463,8.9
28070,Tyler Kennedy,2017-18,31.0,11,14,38,38,6,8,14,79.0,424.0,477,86,113,199,1201.0,82,5.32,47,251,2453,8.9
28071,Tyler Kennedy,2018-19,32.0,12,16,50,50,3,13,16,72.0,671.0,527,89,126,215,1273.0,82,5.34,48,255,2438,9.0
28072,Tyler Larter,1992-93,24.0,4,0,1,1,0,0,0,2.0,,1,0,0,0,2.0,80,7.37,76,367,2421,12.2
28073,Tyler Lewington,2021-22,27.0,4,2,2,2,1,1,2,3.0,28.0,2,1,1,2,3.0,82,5.96,47,239,2579,9.5
28074,Tyler Lewington,2022-23,28.0,5,0,6,6,0,0,0,2.0,61.0,8,1,1,2,5.0,70,5.96,42,208,2192,9.5
28075,Tyler Motte,2019-20,24.0,4,7,33,33,4,3,7,46.0,376.0,33,4,3,7,46.0,82,5.45,47,245,2478,9.0
28076,Tyler Motte,2020-21,25.0,5,7,46,46,5,2,7,64.0,516.0,79,9,5,14,110.0,82,5.86,50,250,2620,9.2
28077,Tyler Motte,2021-22,26.0,6,16,74,74,9,7,16,114.0,945.0,153,18,12,30,224.0,82,5.96,47,239,2579,9.5
28078,Tyler Motte,2022-23,27.0,7,8,34,34,4,4,8,38.0,446.0,187,22,16,38,262.0,70,5.96,42,208,2192,9.5
28079,Tyler Myers,2012-13,22.0,4,48,82,82,11,37,48,104.0,1947.0,82,11,37,48,104.0,82,5.53,56,304,2486,9.1
28080,Tyler Myers,2013-14,23.0,5,37,80,80,10,27,37,122.0,1797.0,162,21,64,85,226.0,82,5.46,52,291,2492,9.0
28081,Tyler Myers,2014-15,24.0,6,23,55,55,8,15,23,84.0,1237.0,217,29,79,108,310.0,82,5.32,47,271,2439,8.9
28082,Tyler Myers,2015-16,25.0,7,8,39,39,3,5,8,48.0,831.0,256,32,84,116,358.0,48,5.31,29,160,1399,9.1
28083,Tyler Myers,2016-17,26.0,8,22,62,62,9,13,22,99.0,1358.0,318,41,97,138,457.0,82,5.34,48,269,2463,8.9
28084,Tyler Myers,2017-18,27.0,9,28,71,71,7,21,28,124.0,1749.0,389,48,118,166,581.0,82,5.32,47,251,2453,8.9
28085,Tyler Myers,2018-19,28.0,10,27,73,73,9,18,27,140.0,1651.0,462,57,136,193,721.0,82,5.34,48,255,2438,9.0
28086,Tyler Myers,2019-20,29.0,11,5,11,11,2,3,5,16.0,244.0,473,59,139,198,737.0,82,5.45,47,245,2478,9.0
28087,Tyler Myers,2020-21,30.0,12,36,82,82,6,30,36,150.0,1757.0,555,65,169,234,887.0,82,5.86,50,250,2620,9.2
28088,Tyler Myers,2021-22,31.0,13,31,80,80,9,22,31,156.0,1628.0,635,74,191,265,1043.0,82,5.96,47,239,2579,9.5
28089,Tyler Myers,2022-23,32.0,14,21,68,68,6,15,21,134.0,1463.0,703,80,206,286,1177.0,70,5.96,42,208,2192,9.5
28090,Tyler Pitlick,2016-17,25.0,4,1,10,10,1,0,1,9.0,90.0,10,1,0,1,9.0,82,5.34,48,269,2463,8.9
28091,Tyler Pitlick,2017-18,26.0,5,2,17,17,2,0,2,18.0,212.0,27,3,0,3,27.0,82,5.32,47,251,2453,8.9
28092,Tyler Pitlick,2019-20,28.0,6,11,31,31,8,3,11,54.0,308.0,58,11,3,14,81.0,82,5.45,47,245,2478,9.0
28093,Tyler Pitlick,2020-21,29.0,7,27,80,80,14,13,27,129.0,1094.0,138,25,16,41,210.0,82,5.86,50,250,2620,9.2
28094,Tyler Pitlick,2021-22,30.0,8,12,47,47,8,4,12,75.0,629.0,185,33,20,53,285.0,82,5.96,47,239,2579,9.5
28095,Tyler Pitlick,2022-23,31.0,9,20,63,63,8,12,20,76.0,759.0,248,41,32,73,361.0,70,5.96,42,208,2192,9.5
28096,Tyler Randell,2018-19,27.0,4,6,27,27,6,0,6,18.0,189.0,27,6,0,6,18.0,82,5.34,48,255,2438,9.0
28097,Tyler Seguin,2013-14,22.0,4,22,74,74,11,11,22,131.0,904.0,74,11,11,22,131.0,82,5.46,52,291,2492,9.0
28098,Tyler Seguin,2014-15,23.0,5,67,81,81,29,38,67,242.0,1372.0,155,40,49,89,373.0,82,5.32,47,271,2439,8.9
28099,Tyler Seguin,2015-16,24.0,6,32,48,48,16,16,32,161.0,817.0,203,56,65,121,534.0,48,5.31,29,160,1399,9.1
28100,Tyler Seguin,2016-17,25.0,7,84,80,80,37,47,84,294.0,1548.0,283,93,112,205,828.0,82,5.34,48,269,2463,8.9
28101,Tyler Seguin,2017-18,26.0,8,77,71,71,37,40,77,280.0,1388.0,354,130,152,282,1108.0,82,5.32,47,251,2453,8.9
28102,Tyler Seguin,2018-19,27.0,9,73,72,72,33,40,73,278.0,1400.0,426,163,192,355,1386.0,82,5.34,48,255,2438,9.0
28103,Tyler Seguin,2019-20,28.0,10,72,82,82,26,46,72,301.0,1514.0,508,189,238,427,1687.0,82,5.45,47,245,2478,9.0
28104,Tyler Seguin,2020-21,29.0,11,78,82,82,40,38,78,335.0,1715.0,590,229,276,505,2022.0,82,5.86,50,250,2620,9.2
28105,Tyler Seguin,2021-22,30.0,12,80,82,82,33,47,80,334.0,1701.0,672,262,323,585,2356.0,82,5.96,47,239,2579,9.5
28106,Tyler Seguin,2022-23,31.0,13,50,69,69,17,33,50,245.0,1321.0,741,279,356,635,2601.0,70,5.96,42,208,2192,9.5
28107,Tyler Sloan,2011-12,30.0,4,5,26,26,1,4,5,8.0,433.0,26,1,4,5,8.0,82,5.7,65,341,2477,9.4
28108,Tyler Sloan,2012-13,31.0,5,6,40,40,2,4,6,34.0,570.0,66,3,8,11,42.0,82,5.53,56,304,2486,9.1
28109,Tyler Sloan,2013-14,32.0,6,6,33,33,1,5,6,12.0,413.0,99,4,13,17,54.0,82,5.46,52,291,2492,9.0
28110,Tyler Toffoli,2015-16,23.0,4,5,10,10,2,3,5,20.0,120.0,10,2,3,5,20.0,48,5.31,29,160,1399,9.1
28111,Tyler Toffoli,2016-17,24.0,5,29,62,62,12,17,29,124.0,802.0,72,14,20,34,144.0,82,5.34,48,269,2463,8.9
28112,Tyler Toffoli,2017-18,25.0,6,49,76,76,23,26,49,200.0,1109.0,148,37,46,83,344.0,82,5.32,47,251,2453,8.9
28113,Tyler Toffoli,2018-19,26.0,7,58,82,82,31,27,58,213.0,1420.0,230,68,73,141,557.0,82,5.34,48,255,2438,9.0
28114,Tyler Toffoli,2019-20,27.0,8,34,63,63,16,18,34,165.0,1045.0,293,84,91,175,722.0,82,5.45,47,245,2478,9.0
28115,Tyler Toffoli,2020-21,28.0,9,47,82,82,24,23,47,251.0,1322.0,375,108,114,222,973.0,82,5.86,50,250,2620,9.2
28116,Tyler Toffoli,2021-22,29.0,10,34,82,82,13,21,34,226.0,1411.0,457,121,135,256,1199.0,82,5.96,47,239,2579,9.5
28117,Tyler Toffoli,2022-23,30.0,11,44,68,68,24,20,44,203.0,1146.0,525,145,155,300,1402.0,70,5.96,42,208,2192,9.5
28118,Tyler Wotherspoon,2016-17,23.0,4,4,14,14,0,4,4,3.0,188.0,14,0,4,4,3.0,82,5.34,48,269,2463,8.9
28119,Tyler Wotherspoon,2017-18,24.0,5,0,1,1,0,0,0,1.0,20.0,15,0,4,4,4.0,82,5.32,47,251,2453,8.9
28120,Tyler Wotherspoon,2018-19,25.0,6,1,11,11,0,1,1,9.0,156.0,26,0,5,5,13.0,82,5.34,48,255,2438,9.0
28121,Tyler Wotherspoon,2019-20,26.0,7,0,4,4,0,0,0,4.0,44.0,30,0,5,5,17.0,82,5.45,47,245,2478,9.0
28122,Tyler Wright,1995-96,22.0,4,2,7,7,1,1,2,7.0,,7,1,1,2,7.0,84,7.25,87,443,2603,11.7
28123,Tyler Wright,1996-97,23.0,5,0,5,5,0,0,0,2.0,,12,1,1,2,9.0,84,6.48,76,407,2545,10.7
28124,Tyler Wright,1997-98,24.0,6,1,6,6,1,0,1,6.0,,18,2,1,3,15.0,48,5.97,37,209,1408,10.2
28125,Tyler Wright,1998-99,25.0,7,1,23,23,1,0,1,18.0,,41,3,1,4,33.0,82,6.29,74,413,2481,10.4
28126,Tyler Wright,1999-00,26.0,8,4,45,45,2,2,4,30.0,,86,5,3,8,63.0,82,5.83,55,336,2444,9.8
28127,Tyler Wright,2000-01,27.0,9,7,82,82,3,4,7,46.0,,168,8,7,15,109.0,82,5.28,57,380,2242,9.6
28128,Tyler Wright,2001-02,28.0,10,0,61,61,0,0,0,16.0,230.0,229,8,7,15,125.0,82,5.27,57,359,2285,9.4
28129,Tyler Wright,2002-03,29.0,11,22,50,50,12,10,22,68.0,670.0,279,20,17,37,193.0,82,5.49,53,331,2294,9.8
28130,Tyler Wright,2003-04,30.0,12,32,76,76,16,16,32,141.0,1344.0,355,36,33,69,334.0,82,5.51,63,376,2272,9.9
28131,Tyler Wright,2004-05,31.0,13,24,77,77,13,11,24,120.0,1325.0,432,49,44,93,454.0,82,5.24,53,338,2262,9.5
28132,Tyler Wright,2005-06,32.0,14,30,70,70,19,11,30,108.0,1129.0,502,68,55,123,562.0,82,5.31,60,363,2326,9.4
28133,Tyler Wright,2006-07,33.0,15,18,68,68,9,9,18,109.0,991.0,570,77,64,141,671.0,82,5.14,57,348,2300,9.2
28134,Tyler Wright,2008-09,35.0,16,8,43,43,2,6,8,43.0,479.0,613,79,70,149,714.0,82,6.05,85,480,2458,10.1
28135,Tyrell Goulbourne,2020-21,27.0,4,0,9,9,0,0,0,2.0,50.0,9,0,0,0,2.0,82,5.86,50,250,2620,9.2
28136,Tyrell Goulbourne,2021-22,28.0,5,0,2,2,0,0,0,3.0,15.0,11,0,0,0,5.0,82,5.96,47,239,2579,9.5
28137,Tyson Barrie,2014-15,23.0,4,0,10,10,0,0,0,15.0,176.0,10,0,0,0,15.0,82,5.32,47,271,2439,8.9
28138,Tyson Barrie,2015-16,24.0,5,13,32,32,2,11,13,58.0,691.0,42,2,11,13,73.0,48,5.31,29,160,1399,9.1
28139,Tyson Barrie,2016-17,25.0,6,38,64,64,13,25,38,101.0,1187.0,106,15,36,51,174.0,82,5.34,48,269,2463,8.9
28140,Tyson Barrie,2017-18,26.0,7,53,80,80,12,41,53,139.0,1709.0,186,27,77,104,313.0,82,5.32,47,251,2453,8.9
28141,Tyson Barrie,2018-19,27.0,8,49,78,78,13,36,49,172.0,1810.0,264,40,113,153,485.0,82,5.34,48,255,2438,9.0
28142,Tyson Barrie,2019-20,28.0,9,38,74,74,7,31,38,182.0,1725.0,338,47,144,191,667.0,82,5.45,47,245,2478,9.0
28143,Tyson Barrie,2020-21,29.0,10,57,68,68,14,43,57,178.0,1543.0,406,61,187,248,845.0,82,5.86,50,250,2620,9.2
28144,Tyson Barrie,2021-22,30.0,11,59,78,78,14,45,59,218.0,1699.0,484,75,232,307,1063.0,82,5.96,47,239,2579,9.5
28145,Tyson Barrie,2022-23,31.0,12,39,70,70,5,34,39,169.0,1531.0,554,80,266,346,1232.0,70,5.96,42,208,2192,9.5
28146,Tyson Jost,2019-20,21.0,4,1,6,6,1,0,1,9.0,94.0,6,1,0,1,9.0,82,5.45,47,245,2478,9.0
28147,Tyson Jost,2020-21,22.0,5,22,65,65,12,10,22,113.0,951.0,71,13,10,23,122.0,82,5.86,50,250,2620,9.2
28148,Tyson Jost,2021-22,23.0,6,26,70,70,11,15,26,114.0,910.0,141,24,25,49,236.0,82,5.96,47,239,2579,9.5
28149,Tyson Jost,2022-23,24.0,7,23,67,67,8,15,23,115.0,855.0,208,32,40,72,351.0,70,5.96,42,208,2192,9.5
28150,Tyson Nash,2001-02,26.0,4,0,2,2,0,0,0,1.0,15.0,2,0,0,0,1.0,82,5.27,57,359,2285,9.4
28151,Tyson Nash,2002-03,27.0,5,13,66,66,4,9,13,68.0,567.0,68,4,9,13,69.0,82,5.49,53,331,2294,9.8
28152,Tyson Nash,2003-04,28.0,6,15,57,57,8,7,15,113.0,711.0,125,12,16,28,182.0,82,5.51,63,376,2272,9.9
28153,Tyson Nash,2004-05,29.0,7,13,64,64,6,7,13,66.0,643.0,189,18,23,41,248.0,82,5.24,53,338,2262,9.5
28154,Tyson Nash,2005-06,30.0,8,9,66,66,6,3,9,77.0,652.0,255,24,26,50,325.0,82,5.31,60,363,2326,9.4
28155,Tyson Nash,2006-07,31.0,9,8,69,69,3,5,8,83.0,820.0,324,27,31,58,408.0,82,5.14,57,348,2300,9.2
28156,Tyson Nash,2008-09,33.0,10,6,50,50,0,6,6,44.0,502.0,374,27,37,64,452.0,82,6.05,85,480,2458,10.1
28157,Tyson Strachan,2011-12,27.0,4,3,30,30,0,3,3,21.0,403.0,30,0,3,3,21.0,82,5.7,65,341,2477,9.4
28158,Tyson Strachan,2012-13,28.0,5,2,8,8,0,2,2,7.0,112.0,38,0,5,5,28.0,82,5.53,56,304,2486,9.1
28159,Tyson Strachan,2013-14,29.0,6,1,29,29,0,1,1,28.0,352.0,67,0,6,6,56.0,82,5.46,52,291,2492,9.0
28160,Tyson Strachan,2014-15,30.0,7,3,15,15,1,2,3,14.0,215.0,82,1,8,9,70.0,82,5.32,47,271,2439,8.9
28161,Tyson Strachan,2015-16,31.0,8,4,38,38,0,4,4,42.0,720.0,120,1,12,13,112.0,48,5.31,29,160,1399,9.1
28162,Tyson Strachan,2016-17,32.0,9,2,18,18,0,2,2,7.0,312.0,138,1,14,15,119.0,82,5.34,48,269,2463,8.9
28163,Tyson Strachan,2017-18,33.0,10,5,46,46,0,5,5,38.0,873.0,184,1,19,20,157.0,82,5.32,47,251,2453,8.9
28164,Tyson Strachan,2018-19,34.0,11,0,2,2,0,0,0,0.0,15.0,186,1,19,20,157.0,82,5.34,48,255,2438,9.0
28165,Udo Kiessling,1984-85,29.0,4,0,1,1,0,0,0,1.0,,1,0,0,0,1.0,80,8.03,73,320,2489,12.9
28166,Ulf Dahlen,1990-91,24.0,4,52,70,70,29,23,52,159.0,,70,29,23,52,159.0,80,7.43,89,437,2435,12.2
28167,Ulf Dahlen,1991-92,25.0,5,43,56,56,24,19,43,147.0,,126,53,42,95,306.0,80,7.48,85,403,2430,12.3
28168,Ulf Dahlen,1992-93,26.0,6,42,76,76,20,22,42,135.0,,202,73,64,137,441.0,80,7.37,76,367,2421,12.2
28169,Ulf Dahlen,1993-94,27.0,7,39,66,66,21,18,39,133.0,,268,94,82,176,574.0,80,6.91,71,366,2385,11.6
28170,Ulf Dahlen,1994-95,28.0,8,66,79,79,36,30,66,216.0,,347,130,112,242,790.0,80,6.96,77,402,2440,11.4
28171,Ulf Dahlen,1995-96,29.0,9,74,83,83,35,39,74,223.0,,430,165,151,316,1013.0,84,7.25,87,443,2603,11.7
28172,Ulf Dahlen,1996-97,30.0,10,69,78,78,25,44,69,190.0,,508,190,195,385,1203.0,84,6.48,76,407,2545,10.7
28173,Ulf Dahlen,1997-98,31.0,11,34,46,46,11,23,34,85.0,,554,201,218,419,1288.0,48,5.97,37,209,1408,10.2
28174,Ulf Dahlen,1998-99,32.0,12,28,59,59,16,12,28,103.0,,613,217,230,447,1391.0,82,6.29,74,413,2481,10.4
28175,Ulf Dahlen,1999-00,33.0,13,33,73,73,14,19,33,131.0,,686,231,249,480,1522.0,82,5.83,55,336,2444,9.8
28176,Ulf Dahlen,2002-03,36.0,14,38,75,75,15,23,38,106.0,949.0,761,246,272,518,1628.0,82,5.49,53,331,2294,9.8
28177,Ulf Dahlen,2003-04,37.0,15,48,73,73,15,33,48,145.0,1081.0,834,261,305,566,1773.0,82,5.51,63,376,2272,9.9
28178,Ulf Dahlen,2004-05,38.0,16,52,69,69,23,29,52,141.0,1114.0,903,284,334,618,1914.0,82,5.24,53,338,2262,9.5
28179,Ulf Dahlen,2005-06,39.0,17,37,63,63,17,20,37,100.0,871.0,966,301,354,655,2014.0,82,5.31,60,363,2326,9.4
28180,Ulf Isaksson,1985-86,31.0,4,22,50,50,7,15,22,71.0,,50,7,15,22,71.0,80,7.73,71,310,2444,12.7
28181,Ulf Samuelsson,1987-88,23.0,4,8,41,41,2,6,8,33.0,,41,2,6,8,33.0,80,7.77,71,321,2447,12.7
28182,Ulf Samuelsson,1988-89,24.0,5,24,80,80,5,19,24,72.0,,121,7,25,32,105.0,80,7.94,82,370,2484,12.8
28183,Ulf Samuelsson,1989-90,25.0,6,33,78,78,2,31,33,104.0,,199,9,56,65,209.0,80,7.34,72,344,2400,12.2
28184,Ulf Samuelsson,1990-91,26.0,7,41,76,76,8,33,41,156.0,,275,17,89,106,365.0,80,7.43,89,437,2435,12.2
28185,Ulf Samuelsson,1991-92,27.0,8,35,71,71,9,26,35,122.0,,346,26,115,141,487.0,80,7.48,85,403,2430,12.3
28186,Ulf Samuelsson,1992-93,28.0,9,13,55,55,2,11,13,57.0,,401,28,126,154,544.0,80,7.37,76,367,2421,12.2
28187,Ulf Samuelsson,1993-94,29.0,10,26,76,76,4,22,26,125.0,,477,32,148,180,669.0,80,6.91,71,366,2385,11.6
28188,Ulf Samuelsson,1994-95,30.0,11,15,62,62,1,14,15,75.0,,539,33,162,195,744.0,80,6.96,77,402,2440,11.4
28189,Ulf Samuelsson,1995-96,31.0,12,29,77,77,3,26,29,96.0,,616,36,188,224,840.0,84,7.25,87,443,2603,11.7
28190,Ulf Samuelsson,1996-97,32.0,13,29,80,80,5,24,29,106.0,,696,41,212,253,946.0,84,6.48,76,407,2545,10.7
28191,Ulf Samuelsson,1997-98,33.0,14,16,44,44,1,15,16,47.0,,740,42,227,269,993.0,48,5.97,37,209,1408,10.2
28192,Ulf Samuelsson,1998-99,34.0,15,19,74,74,1,18,19,66.0,,814,43,245,288,1059.0,82,6.29,74,413,2481,10.4
28193,Ulf Samuelsson,1999-00,35.0,16,17,73,73,6,11,17,77.0,,887,49,256,305,1136.0,82,5.83,55,336,2444,9.8
28194,Ulf Samuelsson,2000-01,36.0,17,12,73,73,3,9,12,59.0,,960,52,265,317,1195.0,82,5.28,57,380,2242,9.6
28195,Ulf Samuelsson,2001-02,37.0,18,12,71,71,4,8,12,39.0,1443.0,1031,56,273,329,1234.0,82,5.27,57,359,2285,9.4
28196,Ulf Samuelsson,2002-03,38.0,19,3,49,49,1,2,3,17.0,768.0,1080,57,275,332,1251.0,82,5.49,53,331,2294,9.8
28197,Uli Hiemer,1987-88,25.0,4,29,53,53,5,24,29,86.0,,53,5,24,29,86.0,80,7.77,71,321,2447,12.7
28198,Uli Hiemer,1988-89,26.0,5,24,50,50,8,16,24,100.0,,103,13,40,53,186.0,80,7.94,82,370,2484,12.8
28199,Uli Hiemer,1989-90,27.0,6,20,40,40,6,14,20,80.0,,143,19,54,73,266.0,80,7.34,72,344,2400,12.2
28200,Urho Vaakanainen,2021-22,23.0,4,0,2,2,0,0,0,2.0,18.0,2,0,0,0,2.0,82,5.96,47,239,2579,9.5
28201,Urho Vaakanainen,2022-23,24.0,5,0,5,5,0,0,0,2.0,84.0,7,0,0,0,4.0,70,5.96,42,208,2192,9.5
28202,Uwe Krupp,1989-90,24.0,4,5,26,26,1,4,5,34.0,,26,1,4,5,34.0,80,7.34,72,344,2400,12.2
28203,Uwe Krupp,1990-91,25.0,5,11,75,75,2,9,11,84.0,,101,3,13,16,118.0,80,7.43,89,437,2435,12.2
28204,Uwe Krupp,1991-92,26.0,6,18,70,70,5,13,18,51.0,,171,8,26,34,169.0,80,7.48,85,403,2430,12.3
28205,Uwe Krupp,1992-93,27.0,7,23,74,74,3,20,23,69.0,,245,11,46,57,238.0,80,7.37,76,367,2421,12.2
28206,Uwe Krupp,1993-94,28.0,8,44,74,74,12,32,44,138.0,,319,23,78,101,376.0,80,6.91,71,366,2385,11.6
28207,Uwe Krupp,1994-95,29.0,9,37,67,67,8,29,37,128.0,,386,31,107,138,504.0,80,6.96,77,402,2440,11.4
28208,Uwe Krupp,1995-96,30.0,10,38,80,80,9,29,38,116.0,,466,40,136,176,620.0,84,7.25,87,443,2603,11.7
28209,Uwe Krupp,1996-97,31.0,11,21,41,41,7,14,21,82.0,,507,47,150,197,702.0,84,6.48,76,407,2545,10.7
28210,Uwe Krupp,1997-98,32.0,12,23,44,44,6,17,23,102.0,,551,53,167,220,804.0,48,5.97,37,209,1408,10.2
28211,Uwe Krupp,1998-99,33.0,13,3,6,6,0,3,3,9.0,,557,53,170,223,813.0,82,6.29,74,413,2481,10.4
28212,Uwe Krupp,1999-00,34.0,14,21,60,60,4,17,21,107.0,,617,57,187,244,920.0,82,5.83,55,336,2444,9.8
28213,Uwe Krupp,2000-01,35.0,15,31,78,78,9,22,31,149.0,,695,66,209,275,1069.0,82,5.28,57,380,2242,9.6
28214,Uwe Krupp,2001-02,36.0,16,5,22,22,3,2,5,32.0,470.0,717,69,211,280,1101.0,82,5.27,57,359,2285,9.4
28215,Uwe Krupp,2004-05,39.0,17,1,8,8,0,1,1,9.0,136.0,725,69,212,281,1110.0,82,5.24,53,338,2262,9.5
28216,Uwe Krupp,2005-06,40.0,18,0,4,4,0,0,0,1.0,61.0,729,69,212,281,1111.0,82,5.31,60,363,2326,9.4
28217,Vaclav Nedorost,2004-05,22.0,4,4,25,25,2,2,4,22.0,256.0,25,2,2,4,22.0,82,5.24,53,338,2262,9.5
28218,Vaclav Nedorost,2005-06,23.0,5,9,42,42,4,5,9,35.0,440.0,67,6,7,13,57.0,82,5.31,60,363,2326,9.4
28219,Vaclav Nedorost,2006-07,24.0,6,7,32,32,4,3,7,38.0,369.0,99,10,10,20,95.0,82,5.14,57,348,2300,9.2
28220,Vaclav Pletka,2004-05,25.0,4,0,1,1,0,0,0,2.0,12.0,1,0,0,0,2.0,82,5.24,53,338,2262,9.5
28221,Vaclav Varada,1998-99,22.0,4,0,1,1,0,0,0,2.0,,1,0,0,0,2.0,82,6.29,74,413,2481,10.4
28222,Vaclav Varada,1999-00,23.0,5,0,5,5,0,0,0,2.0,,6,0,0,0,4.0,82,5.83,55,336,2444,9.8
28223,Vaclav Varada,2000-01,24.0,6,11,27,27,5,6,11,27.0,,33,5,6,11,31.0,82,5.28,57,380,2242,9.6
28224,Vaclav Varada,2001-02,25.0,7,31,72,72,7,24,31,123.0,1044.0,105,12,30,42,154.0,82,5.27,57,359,2285,9.4
28225,Vaclav Varada,2002-03,26.0,8,37,76,76,10,27,37,140.0,1137.0,181,22,57,79,294.0,82,5.49,53,331,2294,9.8
28226,Vaclav Varada,2003-04,27.0,9,31,75,75,10,21,31,112.0,1196.0,256,32,78,110,406.0,82,5.51,63,376,2272,9.9
28227,Vaclav Varada,2004-05,28.0,10,23,76,76,7,16,23,138.0,1257.0,332,39,94,133,544.0,82,5.24,53,338,2262,9.5
28228,Vaclav Varada,2005-06,29.0,11,19,55,55,9,10,19,81.0,873.0,387,48,104,152,625.0,82,5.31,60,363,2326,9.4
28229,Vaclav Varada,2006-07,30.0,12,10,30,30,5,5,10,47.0,430.0,417,53,109,162,672.0,82,5.14,57,348,2300,9.2
28230,Vaclav Varada,2008-09,32.0,13,21,76,76,5,16,21,114.0,738.0,493,58,125,183,786.0,82,6.05,85,480,2458,10.1
28231,Vadim Sharifijanov,1999-00,24.0,4,0,2,2,0,0,0,4.0,,2,0,0,0,4.0,82,5.83,55,336,2444,9.8
28232,Vadim Sharifijanov,2001-02,26.0,5,27,53,53,11,16,27,71.0,723.0,55,11,16,27,75.0,82,5.27,57,359,2285,9.4
28233,Vadim Sharifijanov,2002-03,27.0,6,10,37,37,5,5,10,46.0,444.0,92,16,21,37,121.0,82,5.49,53,331,2294,9.8
28234,Vadim Shipachyov,2020-21,33.0,4,1,3,3,1,0,1,3.0,32.0,3,1,0,1,3.0,82,5.86,50,250,2620,9.2
28235,Val James,1984-85,27.0,4,0,7,7,0,0,0,5.0,,7,0,0,0,5.0,80,8.03,73,320,2489,12.9
28236,Val James,1989-90,32.0,5,0,4,4,0,0,0,0.0,,11,0,0,0,5.0,80,7.34,72,344,2400,12.2
28237,Valentin Zykov,2019-20,24.0,4,1,2,2,1,0,1,3.0,13.0,2,1,0,1,3.0,82,5.45,47,245,2478,9.0
28238,Valentin Zykov,2020-21,25.0,5,7,10,10,3,4,7,18.0,137.0,12,4,4,8,21.0,82,5.86,50,250,2620,9.2
28239,Valentin Zykov,2021-22,26.0,6,5,28,28,2,3,5,29.0,279.0,40,6,7,13,50.0,82,5.96,47,239,2579,9.5
28240,Valentin Zykov,2022-23,27.0,7,4,15,15,1,3,4,19.0,183.0,55,7,10,17,69.0,70,5.96,42,208,2192,9.5
28241,Valeri Bure,1997-98,23.0,4,4,24,24,3,1,4,39.0,,24,3,1,4,39.0,48,5.97,37,209,1408,10.2
28242,Valeri Bure,1998-99,24.0,5,42,77,77,22,20,42,143.0,,101,25,21,46,182.0,82,6.29,74,413,2481,10.4
28243,Valeri Bure,1999-00,25.0,6,35,64,64,14,21,35,131.0,,165,39,42,81,313.0,82,5.83,55,336,2444,9.8
28244,Valeri Bure,2000-01,26.0,7,38,66,66,12,26,38,179.0,,231,51,68,119,492.0,82,5.28,57,380,2242,9.6
28245,Valeri Bure,2001-02,27.0,8,53,80,80,26,27,53,260.0,1295.0,311,77,95,172,752.0,82,5.27,57,359,2285,9.4
28246,Valeri Bure,2002-03,28.0,9,75,82,82,35,40,75,308.0,1720.0,393,112,135,247,1060.0,82,5.49,53,331,2294,9.8
28247,Valeri Bure,2003-04,29.0,10,55,78,78,27,28,55,276.0,1483.0,471,139,163,302,1336.0,82,5.51,63,376,2272,9.9
28248,Valeri Bure,2004-05,30.0,11,18,31,31,8,10,18,100.0,576.0,502,147,173,320,1436.0,82,5.24,53,338,2262,9.5
28249,Valeri Bure,2005-06,31.0,12,28,51,51,5,23,28,161.0,933.0,553,152,196,348,1597.0,82,5.31,60,363,2326,9.4
28250,Valeri Bure,2006-07,32.0,13,52,68,68,22,30,52,209.0,1289.0,621,174,226,400,1806.0,82,5.14,57,348,2300,9.2
28251,Valeri Kamensky,1994-95,28.0,4,21,23,23,7,14,21,42.0,,23,7,14,21,42.0,80,6.96,77,402,2440,11.4
28252,Valeri Kamensky,1995-96,29.0,5,37,32,32,15,22,37,94.0,,55,22,36,58,136.0,84,7.25,87,443,2603,11.7
28253,Valeri Kamensky,1996-97,30.0,6,65,76,76,28,37,65,170.0,,131,50,73,123,306.0,84,6.48,76,407,2545,10.7
28254,Valeri Kamensky,1997-98,31.0,7,30,40,40,10,20,30,70.0,,171,60,93,153,376.0,48,5.97,37,209,1408,10.2
28255,Valeri Kamensky,1998-99,32.0,8,85,81,81,38,47,85,220.0,,252,98,140,238,596.0,82,6.29,74,413,2481,10.4
28256,Valeri Kamensky,1999-00,33.0,9,66,68,68,28,38,66,165.0,,320,126,178,304,761.0,82,5.83,55,336,2444,9.8
28257,Valeri Kamensky,2000-01,34.0,10,66,75,75,26,40,66,173.0,,395,152,218,370,934.0,82,5.28,57,380,2242,9.6
28258,Valeri Kamensky,2001-02,35.0,11,44,65,65,14,30,44,123.0,1143.0,460,166,248,414,1057.0,82,5.27,57,359,2285,9.4
28259,Valeri Kamensky,2002-03,36.0,12,32,58,58,13,19,32,88.0,868.0,518,179,267,446,1145.0,82,5.49,53,331,2294,9.8
28260,Valeri Kamensky,2003-04,37.0,13,34,65,65,14,20,34,129.0,995.0,583,193,287,480,1274.0,82,5.51,63,376,2272,9.9
28261,Valeri Kamensky,2004-05,38.0,14,21,54,54,7,14,21,72.0,618.0,637,200,301,501,1346.0,82,5.24,53,338,2262,9.5
28262,Valeri Karpov,1997-98,26.0,4,11,30,30,4,7,11,48.0,,30,4,7,11,48.0,48,5.97,37,209,1408,10.2
28263,Valeri Karpov,1998-99,27.0,5,17,37,37,9,8,17,42.0,,67,13,15,28,90.0,82,6.29,74,413,2481,10.4
28264,Valeri Karpov,1999-00,28.0,6,1,9,9,1,0,1,4.0,,76,14,15,29,94.0,82,5.83,55,336,2444,9.8
28265,Valeri Nichushkin,2016-17,21.0,4,34,79,79,14,20,34,128.0,1183.0,79,14,20,34,128.0,82,5.34,48,269,2463,8.9
28266,Valeri Nichushkin,2017-18,22.0,5,1,8,8,0,1,1,6.0,110.0,87,14,21,35,134.0,82,5.32,47,251,2453,8.9
28267,Valeri Nichushkin,2018-19,23.0,6,29,79,79,9,20,29,139.0,1101.0,166,23,41,64,273.0,82,5.34,48,255,2438,9.0
28268,Valeri Nichushkin,2021-22,26.0,7,10,57,57,0,10,10,65.0,679.0,223,23,51,74,338.0,82,5.96,47,239,2579,9.5
28269,Valeri Nichushkin,2022-23,27.0,8,27,65,65,13,14,27,113.0,915.0,288,36,65,101,451.0,70,5.96,42,208,2192,9.5
28270,Valeri Zelepukin,1994-95,26.0,4,31,44,44,13,18,31,94.0,,44,13,18,31,94.0,80,6.96,77,402,2440,11.4
28271,Valeri Zelepukin,1995-96,27.0,5,64,78,78,23,41,64,174.0,,122,36,59,95,268.0,84,7.25,87,443,2603,11.7
28272,Valeri Zelepukin,1996-97,28.0,6,57,82,82,26,31,57,155.0,,204,62,90,152,423.0,84,6.48,76,407,2545,10.7
28273,Valeri Zelepukin,1997-98,29.0,7,3,4,4,1,2,3,6.0,,208,63,92,155,429.0,48,5.97,37,209,1408,10.2
28274,Valeri Zelepukin,1998-99,30.0,8,15,61,61,6,9,15,86.0,,269,69,101,170,515.0,82,6.29,74,413,2481,10.4
28275,Valeri Zelepukin,1999-00,31.0,9,38,71,71,14,24,38,111.0,,340,83,125,208,626.0,82,5.83,55,336,2444,9.8
28276,Valeri Zelepukin,2000-01,32.0,10,22,68,68,4,18,22,101.0,,408,87,143,230,727.0,82,5.28,57,380,2242,9.6
28277,Valeri Zelepukin,2001-02,33.0,11,25,74,74,16,9,25,129.0,1077.0,482,103,152,255,856.0,82,5.27,57,359,2285,9.4
28278,Valeri Zelepukin,2002-03,34.0,12,32,77,77,11,21,32,125.0,1126.0,559,114,173,287,981.0,82,5.49,53,331,2294,9.8
28279,Valeri Zelepukin,2003-04,35.0,13,7,36,36,3,4,7,38.0,436.0,595,117,177,294,1019.0,82,5.51,63,376,2272,9.9
28280,Valtteri Filppula,2008-09,24.0,4,1,4,4,0,1,1,1.0,29.0,4,0,1,1,1.0,82,6.05,85,480,2458,10.1
28281,Valtteri Filppula,2009-10,25.0,5,17,73,73,10,7,17,76.0,822.0,77,10,8,18,77.0,82,5.76,70,398,2426,9.7
28282,Valtteri Filppula,2010-11,26.0,6,36,78,78,19,17,36,122.0,1323.0,155,29,25,54,199.0,82,5.44,62,351,2383,9.4
28283,Valtteri Filppula,2011-12,27.0,7,40,80,80,12,28,40,129.0,1288.0,235,41,53,94,328.0,82,5.7,65,341,2477,9.4
28284,Valtteri Filppula,2012-13,28.0,8,35,55,55,11,24,35,114.0,1003.0,290,52,77,129,442.0,82,5.53,56,304,2486,9.1
28285,Valtteri Filppula,2013-14,29.0,9,39,71,71,16,23,39,115.0,1187.0,361,68,100,168,557.0,82,5.46,52,291,2492,9.0
28286,Valtteri Filppula,2014-15,30.0,10,66,81,81,23,43,66,144.0,1479.0,442,91,143,234,701.0,82,5.32,47,271,2439,8.9
28287,Valtteri Filppula,2015-16,31.0,11,17,41,41,9,8,17,78.0,729.0,483,100,151,251,779.0,48,5.31,29,160,1399,9.1
28288,Valtteri Filppula,2016-17,32.0,12,58,75,75,25,33,58,131.0,1499.0,558,125,184,309,910.0,82,5.34,48,269,2463,8.9
28289,Valtteri Filppula,2017-18,33.0,13,48,82,82,12,36,48,91.0,1559.0,640,137,220,357,1001.0,82,5.32,47,251,2453,8.9
28290,Valtteri Filppula,2018-19,34.0,14,31,76,76,8,23,31,101.0,1388.0,716,145,243,388,1102.0,82,5.34,48,255,2438,9.0
28291,Valtteri Filppula,2019-20,35.0,15,42,79,79,12,30,42,97.0,1375.0,795,157,273,430,1199.0,82,5.45,47,245,2478,9.0
28292,Valtteri Filppula,2020-21,36.0,16,33,81,81,11,22,33,70.0,1335.0,876,168,295,463,1269.0,82,5.86,50,250,2620,9.2
28293,Valtteri Filppula,2021-22,37.0,17,31,72,72,17,14,31,78.0,1028.0,948,185,309,494,1347.0,82,5.96,47,239,2579,9.5
28294,Valtteri Filppula,2022-23,38.0,18,21,70,70,6,15,21,63.0,1163.0,1018,191,324,515,1410.0,70,5.96,42,208,2192,9.5
28295,Veli-Pekka Ketola,1984-85,36.0,4,14,44,44,9,5,14,42.0,,44,9,5,14,42.0,80,8.03,73,320,2489,12.9
28296,Vern Smith,1987-88,23.0,4,0,1,1,0,0,0,0.0,,1,0,0,0,0.0,80,7.77,71,321,2447,12.7
28297,Vernon Fiddler,2005-06,25.0,4,6,19,19,4,2,6,20.0,184.0,19,4,2,6,20.0,82,5.31,60,363,2326,9.4
28298,Vernon Fiddler,2006-07,26.0,5,0,17,17,0,0,0,8.0,138.0,36,4,2,6,28.0,82,5.14,57,348,2300,9.2
28299,Vernon Fiddler,2008-09,28.0,6,12,40,40,8,4,12,46.0,553.0,76,12,6,18,74.0,82,6.05,85,480,2458,10.1
28300,Vernon Fiddler,2009-10,29.0,7,26,72,72,11,15,26,90.0,981.0,148,23,21,44,164.0,82,5.76,70,398,2426,9.7
28301,Vernon Fiddler,2010-11,30.0,8,32,79,79,11,21,32,97.0,1101.0,227,34,42,76,261.0,82,5.44,62,351,2383,9.4
28302,Vernon Fiddler,2011-12,31.0,9,17,78,78,11,6,17,114.0,1089.0,305,45,48,93,375.0,82,5.7,65,341,2477,9.4
28303,Vernon Fiddler,2012-13,32.0,10,30,76,76,8,22,30,119.0,1090.0,381,53,70,123,494.0,82,5.53,56,304,2486,9.1
28304,Vernon Fiddler,2013-14,33.0,11,22,71,71,6,16,22,97.0,1104.0,452,59,86,145,591.0,82,5.46,52,291,2492,9.0
28305,Vernon Fiddler,2014-15,34.0,12,21,82,82,8,13,21,123.0,1147.0,534,67,99,166,714.0,82,5.32,47,271,2439,8.9
28306,Vernon Fiddler,2015-16,35.0,13,17,46,46,4,13,17,56.0,591.0,580,71,112,183,770.0,48,5.31,29,160,1399,9.1
28307,Vernon Fiddler,2016-17,36.0,14,23,76,76,6,17,23,109.0,1010.0,656,77,129,206,879.0,82,5.34,48,269,2463,8.9
28308,Vernon Fiddler,2017-18,37.0,15,29,80,80,13,16,29,132.0,1050.0,736,90,145,235,1011.0,82,5.32,47,251,2453,8.9
28309,Vernon Fiddler,2018-19,38.0,16,22,82,82,12,10,22,98.0,954.0,818,102,155,257,1109.0,82,5.34,48,255,2438,9.0
28310,Vernon Fiddler,2019-20,39.0,17,4,59,59,2,2,4,48.0,687.0,877,104,157,261,1157.0,82,5.45,47,245,2478,9.0
28311,Vesa Viitakoski,1996-97,25.0,4,3,8,8,1,2,3,15.0,,8,1,2,3,15.0,84,6.48,76,407,2545,10.7
28312,Vesa Viitakoski,1997-98,26.0,5,3,10,10,1,2,3,6.0,,18,2,4,6,21.0,48,5.97,37,209,1408,10.2
28313,Vesa Viitakoski,1998-99,27.0,6,0,5,5,0,0,0,7.0,,23,2,4,6,28.0,82,6.29,74,413,2481,10.4
28314,Viacheslav Butsayev,1995-96,25.0,4,16,52,52,2,14,16,58.0,,52,2,14,16,58.0,84,7.25,87,443,2603,11.7
28315,Viacheslav Butsayev,1996-97,26.0,5,23,59,59,12,11,23,85.0,,111,14,25,39,143.0,84,6.48,76,407,2545,10.7
28316,Viacheslav Butsayev,1997-98,27.0,6,2,6,6,2,0,2,6.0,,117,16,25,41,149.0,48,5.97,37,209,1408,10.2
28317,Viacheslav Butsayev,1998-99,28.0,7,1,7,7,1,0,1,9.0,,124,17,25,42,158.0,82,6.29,74,413,2481,10.4
28318,Viacheslav Butsayev,2001-02,31.0,8,1,3,3,0,1,1,5.0,39.0,127,17,26,43,163.0,82,5.27,57,359,2285,9.4
28319,Viacheslav Butsayev,2002-03,32.0,9,0,5,5,0,0,0,2.0,45.0,132,17,26,43,165.0,82,5.49,53,331,2294,9.8
28320,Viacheslav Fetisov,1992-93,34.0,4,42,72,72,8,34,42,108.0,,72,8,34,42,108.0,80,7.37,76,367,2421,12.2
28321,Viacheslav Fetisov,1993-94,35.0,5,19,67,67,3,16,19,71.0,,139,11,50,61,179.0,80,6.91,71,366,2385,11.6
28322,Viacheslav Fetisov,1994-95,36.0,6,26,70,70,3,23,26,70.0,,209,14,73,87,249.0,80,6.96,77,402,2440,11.4
28323,Viacheslav Fetisov,1995-96,37.0,7,27,76,76,4,23,27,63.0,,285,18,96,114,312.0,84,7.25,87,443,2603,11.7
28324,Viacheslav Fetisov,1996-97,38.0,8,15,52,52,1,14,15,36.0,,337,19,110,129,348.0,84,6.48,76,407,2545,10.7
28325,Viacheslav Fetisov,1997-98,39.0,9,15,18,18,3,12,15,37.0,,355,22,122,144,385.0,48,5.97,37,209,1408,10.2
28326,Viacheslav Fetisov,1998-99,40.0,10,42,69,69,7,35,42,127.0,,424,29,157,186,512.0,82,6.29,74,413,2481,10.4
28327,Viacheslav Fetisov,1999-00,41.0,11,28,64,64,5,23,28,95.0,,488,34,180,214,607.0,82,5.83,55,336,2444,9.8
28328,Viacheslav Fetisov,2000-01,42.0,12,14,58,58,2,12,14,55.0,,546,36,192,228,662.0,82,5.28,57,380,2242,9.6
28329,Victor Antipin,2020-21,28.0,4,10,47,47,0,10,10,40.0,718.0,47,0,10,10,40.0,82,5.86,50,250,2620,9.2
28330,Victor Bartley,2015-16,27.0,4,7,24,24,0,7,7,19.0,469.0,24,0,7,7,19.0,48,5.31,29,160,1399,9.1
28331,Victor Bartley,2016-17,28.0,5,6,50,50,1,5,6,21.0,768.0,74,1,12,13,40.0,82,5.34,48,269,2463,8.9
28332,Victor Bartley,2017-18,29.0,6,10,37,37,0,10,10,28.0,497.0,111,1,22,23,68.0,82,5.32,47,251,2453,8.9
28333,Victor Bartley,2018-19,30.0,7,0,10,10,0,0,0,8.0,133.0,121,1,22,23,76.0,82,5.34,48,255,2438,9.0
28334,Victor Ejdsell,2020-21,25.0,4,1,6,6,0,1,1,7.0,80.0,6,0,1,1,7.0,82,5.86,50,250,2620,9.2
28335,Victor Hedman,2012-13,22.0,4,20,74,74,4,16,20,90.0,1543.0,74,4,16,20,90.0,82,5.53,56,304,2486,9.1
28336,Victor Hedman,2013-14,23.0,5,26,79,79,3,23,26,101.0,1660.0,153,7,39,46,191.0,82,5.46,52,291,2492,9.0
28337,Victor Hedman,2014-15,24.0,6,23,61,61,5,18,23,82.0,1409.0,214,12,57,69,273.0,82,5.32,47,271,2439,8.9
28338,Victor Hedman,2015-16,25.0,7,20,44,44,4,16,20,76.0,997.0,258,16,73,89,349.0,48,5.31,29,160,1399,9.1
28339,Victor Hedman,2016-17,26.0,8,55,75,75,13,42,55,170.0,1683.0,333,29,115,144,519.0,82,5.34,48,269,2463,8.9
28340,Victor Hedman,2017-18,27.0,9,38,59,59,10,28,38,115.0,1338.0,392,39,143,182,634.0,82,5.32,47,251,2453,8.9
28341,Victor Hedman,2018-19,28.0,10,47,78,78,10,37,47,180.0,1799.0,470,49,180,229,814.0,82,5.34,48,255,2438,9.0
28342,Victor Hedman,2019-20,29.0,11,72,79,79,16,56,72,166.0,1936.0,549,65,236,301,980.0,82,5.45,47,245,2478,9.0
28343,Victor Hedman,2020-21,30.0,12,63,77,77,17,46,63,216.0,1991.0,626,82,282,364,1196.0,82,5.86,50,250,2620,9.2
28344,Victor Hedman,2021-22,31.0,13,54,70,70,12,42,54,182.0,1594.0,696,94,324,418,1378.0,82,5.96,47,239,2579,9.5
28345,Victor Hedman,2022-23,32.0,14,55,66,66,11,44,55,155.0,1588.0,762,105,368,473,1533.0,70,5.96,42,208,2192,9.5
28346,Victor Ignatjev,2001-02,31.0,4,1,11,11,0,1,1,15.0,135.0,11,0,1,1,15.0,82,5.27,57,359,2285,9.4
28347,Victor Mete,2020-21,22.0,4,7,49,49,0,7,7,43.0,764.0,49,0,7,7,43.0,82,5.86,50,250,2620,9.2
28348,Victor Mete,2021-22,23.0,5,13,71,71,0,13,13,65.0,1262.0,120,0,20,20,108.0,82,5.96,47,239,2579,9.5
28349,Victor Mete,2022-23,24.0,6,11,51,51,4,7,11,57.0,816.0,171,4,27,31,165.0,70,5.96,42,208,2192,9.5
28350,Victor Olofsson,2021-22,26.0,4,4,6,6,2,2,4,21.0,108.0,6,2,2,4,21.0,82,5.96,47,239,2579,9.5
28351,Victor Olofsson,2022-23,27.0,5,42,54,54,20,22,42,127.0,993.0,60,22,24,46,148.0,70,5.96,42,208,2192,9.5
28352,Victor Oreskovich,2012-13,26.0,4,6,50,50,2,4,6,55.0,444.0,50,2,4,6,55.0,82,5.53,56,304,2486,9.1
28353,Victor Oreskovich,2013-14,27.0,5,3,16,16,0,3,3,19.0,126.0,66,2,7,9,74.0,82,5.46,52,291,2492,9.0
28354,Victor Oreskovich,2014-15,28.0,6,0,1,1,0,0,0,0.0,6.0,67,2,7,9,74.0,82,5.32,47,271,2439,8.9
28355,Victor Posa,1988-89,22.0,4,0,2,2,0,0,0,1.0,,2,0,0,0,1.0,80,7.94,82,370,2484,12.8
28356,Victor Rask,2017-18,24.0,4,33,80,80,11,22,33,172.0,1307.0,80,11,22,33,172.0,82,5.32,47,251,2453,8.9
28357,Victor Rask,2018-19,25.0,5,48,80,80,21,27,48,160.0,1359.0,160,32,49,81,332.0,82,5.34,48,255,2438,9.0
28358,Victor Rask,2019-20,26.0,6,45,82,82,16,29,45,186.0,1418.0,242,48,78,126,518.0,82,5.45,47,245,2478,9.0
28359,Victor Rask,2020-21,27.0,7,31,71,71,14,17,31,126.0,1092.0,313,62,95,157,644.0,82,5.86,50,250,2620,9.2
28360,Victor Rask,2021-22,28.0,8,9,49,49,3,6,9,55.0,593.0,362,65,101,166,699.0,82,5.96,47,239,2579,9.5
28361,Victor Rask,2022-23,29.0,9,13,43,43,5,8,13,38.0,451.0,405,70,109,179,737.0,70,5.96,42,208,2192,9.5
28362,Viktor Arvidsson,2017-18,24.0,4,0,6,6,0,0,0,9.0,62.0,6,0,0,0,9.0,82,5.32,47,251,2453,8.9
28363,Viktor Arvidsson,2018-19,25.0,5,16,56,56,8,8,16,139.0,694.0,62,8,8,16,148.0,82,5.34,48,255,2438,9.0
28364,Viktor Arvidsson,2019-20,26.0,6,61,80,80,31,30,61,246.0,1372.0,142,39,38,77,394.0,82,5.45,47,245,2478,9.0
28365,Viktor Arvidsson,2020-21,27.0,7,61,78,78,29,32,61,247.0,1384.0,220,68,70,138,641.0,82,5.86,50,250,2620,9.2
28366,Viktor Arvidsson,2021-22,28.0,8,48,58,58,34,14,48,195.0,1110.0,278,102,84,186,836.0,82,5.96,47,239,2579,9.5
28367,Viktor Arvidsson,2022-23,29.0,9,28,57,57,15,13,28,127.0,924.0,335,117,97,214,963.0,70,5.96,42,208,2192,9.5
28368,Viktor Gordiouk,1995-96,25.0,4,9,16,16,3,6,9,24.0,,16,3,6,9,24.0,84,7.25,87,443,2603,11.7
28369,Viktor Gordiouk,1997-98,27.0,5,2,10,10,0,2,2,10.0,,26,3,8,11,34.0,48,5.97,37,209,1408,10.2
28370,Viktor Kozlov,1997-98,22.0,4,2,16,16,2,0,2,23.0,,16,2,0,2,23.0,48,5.97,37,209,1408,10.2
28371,Viktor Kozlov,1998-99,23.0,5,19,62,62,6,13,19,107.0,,78,8,13,21,130.0,82,6.29,74,413,2481,10.4
28372,Viktor Kozlov,1999-00,24.0,6,41,78,78,16,25,41,184.0,,156,24,38,62,314.0,82,5.83,55,336,2444,9.8
28373,Viktor Kozlov,2000-01,25.0,7,30,64,64,17,13,30,165.0,,220,41,51,92,479.0,82,5.28,57,380,2242,9.6
28374,Viktor Kozlov,2001-02,26.0,8,51,65,65,16,35,51,209.0,1238.0,285,57,86,143,688.0,82,5.27,57,359,2285,9.4
28375,Viktor Kozlov,2002-03,27.0,9,70,80,80,17,53,70,223.0,1556.0,365,74,139,213,911.0,82,5.49,53,331,2294,9.8
28376,Viktor Kozlov,2003-04,28.0,10,37,51,51,14,23,37,139.0,938.0,416,88,162,250,1050.0,82,5.51,63,376,2272,9.9
28377,Viktor Kozlov,2004-05,29.0,11,27,50,50,9,18,27,143.0,995.0,466,97,180,277,1193.0,82,5.24,53,338,2262,9.5
28378,Viktor Kozlov,2005-06,30.0,12,56,74,74,22,34,56,232.0,1671.0,540,119,214,333,1425.0,82,5.31,60,363,2326,9.4
28379,Viktor Kozlov,2006-07,31.0,13,33,59,59,13,20,33,143.0,1084.0,599,132,234,366,1568.0,82,5.14,57,348,2300,9.2
28380,Viktor Kozlov,2008-09,33.0,14,25,69,69,12,13,25,122.0,934.0,668,144,247,391,1690.0,82,6.05,85,480,2458,10.1
28381,Viktor Kozlov,2009-10,34.0,15,51,81,81,25,26,51,165.0,1330.0,749,169,273,442,1855.0,82,5.76,70,398,2426,9.7
28382,Viktor Kozlov,2010-11,35.0,16,54,81,81,16,38,54,219.0,1424.0,830,185,311,496,2074.0,82,5.44,62,351,2383,9.4
28383,Viktor Kozlov,2011-12,36.0,17,41,67,67,13,28,41,153.0,1050.0,897,198,339,537,2227.0,82,5.7,65,341,2477,9.4
28384,Viktor Loov,2018-19,26.0,4,2,4,4,0,2,2,1.0,42.0,4,0,2,2,1.0,82,5.34,48,255,2438,9.0
28385,Viktor Nechayev,1985-86,31.0,4,1,3,3,1,0,1,7.0,,3,1,0,1,7.0,80,7.73,71,310,2444,12.7
28386,Viktor Stalberg,2012-13,27.0,4,14,40,40,9,5,14,117.0,584.0,40,9,5,14,117.0,82,5.53,56,304,2486,9.1
28387,Viktor Stalberg,2013-14,28.0,5,24,77,77,12,12,24,135.0,824.0,117,21,17,38,252.0,82,5.46,52,291,2492,9.0
28388,Viktor Stalberg,2014-15,29.0,6,43,79,79,22,21,43,215.0,1112.0,196,43,38,81,467.0,82,5.32,47,271,2439,8.9
28389,Viktor Stalberg,2015-16,30.0,7,23,47,47,9,14,23,113.0,664.0,243,52,52,104,580.0,48,5.31,29,160,1399,9.1
28390,Viktor Stalberg,2016-17,31.0,8,18,70,70,8,10,18,114.0,881.0,313,60,62,122,694.0,82,5.34,48,269,2463,8.9
28391,Viktor Stalberg,2017-18,32.0,9,10,25,25,2,8,10,27.0,297.0,338,62,70,132,721.0,82,5.32,47,251,2453,8.9
28392,Viktor Stalberg,2018-19,33.0,10,20,75,75,9,11,20,125.0,915.0,413,71,81,152,846.0,82,5.34,48,255,2438,9.0
28393,Viktor Stalberg,2019-20,34.0,11,16,75,75,11,5,16,101.0,915.0,488,82,86,168,947.0,82,5.45,47,245,2478,9.0
28394,Viktor Svedberg,2018-19,27.0,4,4,27,27,2,2,4,40.0,425.0,27,2,2,4,40.0,82,5.34,48,255,2438,9.0
28395,Viktor Tikhonov,2011-12,23.0,4,16,61,61,8,8,16,71.0,740.0,61,8,8,16,71.0,82,5.7,65,341,2477,9.4
28396,Viktor Tikhonov,2018-19,30.0,5,6,50,50,3,3,6,41.0,572.0,111,11,11,22,112.0,82,5.34,48,255,2438,9.0
28397,Ville Heinola,2022-23,21.0,4,5,8,8,1,4,5,10.0,145.0,8,1,4,5,10.0,70,5.96,42,208,2192,9.5
28398,Ville Koistinen,2010-11,28.0,4,17,48,48,4,13,17,60.0,806.0,48,4,13,17,60.0,82,5.44,62,351,2383,9.4
28399,Ville Koistinen,2011-12,29.0,5,11,38,38,3,8,11,42.0,559.0,86,7,21,28,102.0,82,5.7,65,341,2477,9.4
28400,Ville Koistinen,2012-13,30.0,6,4,17,17,1,3,4,12.0,133.0,103,8,24,32,114.0,82,5.53,56,304,2486,9.1
28401,Ville Leino,2011-12,28.0,4,9,13,13,5,4,9,17.0,165.0,13,5,4,9,17.0,82,5.7,65,341,2477,9.4
28402,Ville Leino,2012-13,29.0,5,11,55,55,6,5,11,77.0,720.0,68,11,9,20,94.0,82,5.53,56,304,2486,9.1
28403,Ville Leino,2013-14,30.0,6,53,81,81,19,34,53,117.0,1297.0,149,30,43,73,211.0,82,5.46,52,291,2492,9.0
28404,Ville Leino,2014-15,31.0,7,25,71,71,8,17,25,78.0,1131.0,220,38,60,98,289.0,82,5.32,47,271,2439,8.9
28405,Ville Leino,2015-16,32.0,8,6,8,8,2,4,6,11.0,126.0,228,40,64,104,300.0,48,5.31,29,160,1399,9.1
28406,Ville Leino,2016-17,33.0,9,15,58,58,0,15,15,38.0,837.0,286,40,79,119,338.0,82,5.34,48,269,2463,8.9
28407,Ville Nieminen,2002-03,25.0,4,0,1,1,0,0,0,2.0,10.0,1,0,0,0,2.0,82,5.49,53,331,2294,9.8
28408,Ville Nieminen,2003-04,26.0,5,22,50,50,14,8,22,68.0,622.0,51,14,8,22,70.0,82,5.51,63,376,2272,9.9
28409,Ville Nieminen,2004-05,27.0,6,27,66,66,11,16,27,83.0,882.0,117,25,24,49,153.0,82,5.24,53,338,2262,9.5
28410,Ville Nieminen,2005-06,28.0,7,21,75,75,9,12,21,86.0,1061.0,192,34,36,70,239.0,82,5.31,60,363,2326,9.4
28411,Ville Nieminen,2006-07,29.0,8,21,79,79,5,16,21,83.0,983.0,271,39,52,91,322.0,82,5.14,57,348,2300,9.2
28412,Ville Nieminen,2008-09,31.0,9,24,70,70,8,16,24,114.0,897.0,341,47,68,115,436.0,82,6.05,85,480,2458,10.1
28413,Ville Nieminen,2009-10,32.0,10,2,44,44,1,1,2,43.0,387.0,385,48,69,117,479.0,82,5.76,70,398,2426,9.7
28414,Ville Peltonen,1998-99,25.0,4,13,31,31,2,11,13,58.0,,31,2,11,13,58.0,82,6.29,74,413,2481,10.4
28415,Ville Peltonen,1999-00,26.0,5,5,28,28,2,3,5,35.0,,59,4,14,18,93.0,82,5.83,55,336,2444,9.8
28416,Ville Peltonen,2001-02,28.0,6,10,14,14,5,5,10,31.0,223.0,73,9,19,28,124.0,82,5.27,57,359,2285,9.4
28417,Ville Peltonen,2002-03,29.0,7,28,79,79,6,22,28,125.0,1159.0,152,15,41,56,249.0,82,5.49,53,331,2294,9.8
28418,Ville Peltonen,2003-04,30.0,8,4,23,23,3,1,4,38.0,268.0,175,18,42,60,287.0,82,5.51,63,376,2272,9.9
28419,Ville Peltonen,2009-10,36.0,9,37,72,72,17,20,37,145.0,1182.0,247,35,62,97,432.0,82,5.76,70,398,2426,9.7
28420,Ville Peltonen,2010-11,37.0,10,20,56,56,5,15,20,108.0,886.0,303,40,77,117,540.0,82,5.44,62,351,2383,9.4
28421,Ville Peltonen,2011-12,38.0,11,31,79,79,12,19,31,121.0,1205.0,382,52,96,148,661.0,82,5.7,65,341,2477,9.4
28422,Ville Siren,1988-89,24.0,4,12,60,60,4,8,12,58.0,,60,4,8,12,58.0,80,7.94,82,370,2484,12.8
28423,Ville Siren,1989-90,25.0,5,22,69,69,5,17,22,84.0,,129,9,25,34,142.0,80,7.34,72,344,2400,12.2
28424,Ville Siren,1990-91,26.0,6,21,58,58,1,20,21,53.0,,187,10,45,55,195.0,80,7.43,89,437,2435,12.2
28425,Ville Siren,1991-92,27.0,7,13,50,50,3,10,13,50.0,,237,13,55,68,245.0,80,7.48,85,403,2430,12.3
28426,Ville Siren,1992-93,28.0,8,14,53,53,1,13,14,53.0,,290,14,68,82,298.0,80,7.37,76,367,2421,12.2
28427,Vince Dunn,2020-21,24.0,4,24,75,75,5,19,24,138.0,1292.0,75,5,19,24,138.0,82,5.86,50,250,2620,9.2
28428,Vince Dunn,2021-22,25.0,5,35,78,78,12,23,35,150.0,1368.0,153,17,42,59,288.0,82,5.96,47,239,2579,9.5
28429,Vince Dunn,2022-23,26.0,6,23,71,71,9,14,23,138.0,1155.0,224,26,56,82,426.0,70,5.96,42,208,2192,9.5
28430,Vincent Damphousse,1989-90,22.0,4,46,80,80,21,25,46,142.0,,80,21,25,46,142.0,80,7.34,72,344,2400,12.2
28431,Vincent Damphousse,1990-91,23.0,5,48,75,75,12,36,48,111.0,,155,33,61,94,253.0,80,7.43,89,437,2435,12.2
28432,Vincent Damphousse,1991-92,24.0,6,68,80,80,26,42,68,190.0,,235,59,103,162,443.0,80,7.48,85,403,2430,12.3
28433,Vincent Damphousse,1992-93,25.0,7,94,80,80,33,61,94,229.0,,315,92,164,256,672.0,80,7.37,76,367,2421,12.2
28434,Vincent Damphousse,1993-94,26.0,8,73,79,79,26,47,73,247.0,,394,118,211,329,919.0,80,6.91,71,366,2385,11.6
28435,Vincent Damphousse,1994-95,27.0,9,89,80,80,38,51,89,247.0,,474,156,262,418,1166.0,80,6.96,77,402,2440,11.4
28436,Vincent Damphousse,1995-96,28.0,10,97,84,84,39,58,97,287.0,,558,195,320,515,1453.0,84,7.25,87,443,2603,11.7
28437,Vincent Damphousse,1996-97,29.0,11,91,84,84,40,51,91,274.0,,642,235,371,606,1727.0,84,6.48,76,407,2545,10.7
28438,Vincent Damphousse,1997-98,30.0,12,40,48,48,10,30,40,123.0,,690,245,401,646,1850.0,48,5.97,37,209,1408,10.2
28439,Vincent Damphousse,1998-99,31.0,13,94,80,80,38,56,94,254.0,,770,283,457,740,2104.0,82,6.29,74,413,2481,10.4
28440,Vincent Damphousse,1999-00,32.0,14,81,82,82,27,54,81,244.0,,852,310,511,821,2348.0,82,5.83,55,336,2444,9.8
28441,Vincent Damphousse,2000-01,33.0,15,59,76,76,18,41,59,164.0,,928,328,552,880,2512.0,82,5.28,57,380,2242,9.6
28442,Vincent Damphousse,2001-02,34.0,16,49,77,77,19,30,49,190.0,1561.0,1005,347,582,929,2702.0,82,5.27,57,359,2285,9.4
28443,Vincent Damphousse,2002-03,35.0,17,70,82,82,21,49,70,204.0,1676.0,1087,368,631,999,2906.0,82,5.49,53,331,2294,9.8
28444,Vincent Damphousse,2003-04,36.0,18,46,45,45,9,37,46,101.0,937.0,1132,377,668,1045,3007.0,82,5.51,63,376,2272,9.9
28445,Vincent Damphousse,2004-05,37.0,19,58,82,82,20,38,58,172.0,1609.0,1214,397,706,1103,3179.0,82,5.24,53,338,2262,9.5
28446,Vincent Damphousse,2005-06,38.0,20,61,82,82,23,38,61,176.0,1571.0,1296,420,744,1164,3355.0,82,5.31,60,363,2326,9.4
28447,Vincent Damphousse,2006-07,39.0,21,41,82,82,12,29,41,156.0,1406.0,1378,432,773,1205,3511.0,82,5.14,57,348,2300,9.2
28448,Vincent Lecavalier,2001-02,21.0,4,28,82,82,13,15,28,125.0,1121.0,82,13,15,28,125.0,82,5.27,57,359,2285,9.4
28449,Vincent Lecavalier,2002-03,22.0,5,67,80,80,25,42,67,166.0,1544.0,162,38,57,95,291.0,82,5.49,53,331,2294,9.8
28450,Vincent Lecavalier,2003-04,23.0,6,51,68,68,23,28,51,165.0,1356.0,230,61,85,146,456.0,82,5.51,63,376,2272,9.9
28451,Vincent Lecavalier,2004-05,24.0,7,37,76,76,20,17,37,164.0,1303.0,306,81,102,183,620.0,82,5.24,53,338,2262,9.5
28452,Vincent Lecavalier,2005-06,25.0,8,78,80,80,33,45,78,274.0,1563.0,386,114,147,261,894.0,82,5.31,60,363,2326,9.4
28453,Vincent Lecavalier,2006-07,26.0,9,66,81,81,32,34,66,242.0,1463.0,467,146,181,327,1136.0,82,5.14,57,348,2300,9.2
28454,Vincent Lecavalier,2008-09,28.0,10,75,80,80,35,40,75,309.0,1610.0,547,181,221,402,1445.0,82,6.05,85,480,2458,10.1
28455,Vincent Lecavalier,2009-10,29.0,11,108,82,82,52,56,108,339.0,1854.0,629,233,277,510,1784.0,82,5.76,70,398,2426,9.7
28456,Vincent Lecavalier,2010-11,30.0,12,92,81,81,40,52,92,318.0,1859.0,710,273,329,602,2102.0,82,5.44,62,351,2383,9.4
28457,Vincent Lecavalier,2011-12,31.0,13,67,77,77,29,38,67,291.0,1559.0,787,302,367,669,2393.0,82,5.7,65,341,2477,9.4
28458,Vincent Lecavalier,2012-13,32.0,14,70,82,82,24,46,70,295.0,1623.0,869,326,413,739,2688.0,82,5.53,56,304,2486,9.1
28459,Vincent Lecavalier,2013-14,33.0,15,54,65,65,25,29,54,210.0,1200.0,934,351,442,793,2898.0,82,5.46,52,291,2492,9.0
28460,Vincent Lecavalier,2014-15,34.0,16,49,64,64,22,27,49,182.0,1212.0,998,373,469,842,3080.0,82,5.32,47,271,2439,8.9
28461,Vincent Lecavalier,2015-16,35.0,17,32,39,39,10,22,32,86.0,697.0,1037,383,491,874,3166.0,48,5.31,29,160,1399,9.1
28462,Vincent Lecavalier,2016-17,36.0,18,37,69,69,20,17,37,132.0,1048.0,1106,403,508,911,3298.0,82,5.34,48,269,2463,8.9
28463,Vincent Lecavalier,2017-18,37.0,19,20,57,57,8,12,20,103.0,721.0,1163,411,520,931,3401.0,82,5.32,47,251,2453,8.9
28464,Vincent Lecavalier,2018-19,38.0,20,18,49,49,10,8,18,67.0,649.0,1212,421,528,949,3468.0,82,5.34,48,255,2438,9.0
28465,Vincent Trocheck,2016-17,23.0,4,8,20,20,5,3,8,38.0,378.0,20,5,3,8,38.0,82,5.34,48,269,2463,8.9
28466,Vincent Trocheck,2017-18,24.0,5,22,50,50,7,15,22,89.0,700.0,70,12,18,30,127.0,82,5.32,47,251,2453,8.9
28467,Vincent Trocheck,2018-19,25.0,6,53,76,76,25,28,53,174.0,1351.0,146,37,46,83,301.0,82,5.34,48,255,2438,9.0
28468,Vincent Trocheck,2019-20,26.0,7,54,82,82,23,31,54,230.0,1708.0,228,60,77,137,531.0,82,5.45,47,245,2478,9.0
28469,Vincent Trocheck,2020-21,27.0,8,75,82,82,31,44,75,287.0,1752.0,310,91,121,212,818.0,82,5.86,50,250,2620,9.2
28470,Vincent Trocheck,2021-22,28.0,9,34,55,55,10,24,34,158.0,1081.0,365,101,145,246,976.0,82,5.96,47,239,2579,9.5
28471,Vincent Trocheck,2022-23,29.0,10,38,62,62,11,27,38,141.0,1037.0,427,112,172,284,1117.0,70,5.96,42,208,2192,9.5
28472,Vinni Lettieri,2020-21,25.0,4,5,19,19,1,4,5,28.0,229.0,19,1,4,5,28.0,82,5.86,50,250,2620,9.2
28473,Vinni Lettieri,2021-22,26.0,5,3,27,27,1,2,3,40.0,274.0,46,2,6,8,68.0,82,5.96,47,239,2579,9.5
28474,Vinnie Hinostroza,2018-19,24.0,4,0,7,7,0,0,0,6.0,61.0,7,0,0,0,6.0,82,5.34,48,255,2438,9.0
28475,Vinnie Hinostroza,2019-20,25.0,5,14,49,49,6,8,14,76.0,587.0,56,6,8,14,82.0,82,5.45,47,245,2478,9.0
28476,Vinnie Hinostroza,2020-21,26.0,6,25,50,50,7,18,25,86.0,691.0,106,13,26,39,168.0,82,5.86,50,250,2620,9.2
28477,Vinnie Hinostroza,2021-22,27.0,7,39,72,72,16,23,39,152.0,1099.0,178,29,49,78,320.0,82,5.96,47,239,2579,9.5
28478,Vinnie Hinostroza,2022-23,28.0,8,22,68,68,5,17,22,132.0,891.0,246,34,66,100,452.0,70,5.96,42,208,2192,9.5
28479,Vinny Prospal,1999-00,24.0,4,15,18,18,5,10,15,35.0,,18,5,10,15,35.0,82,5.83,55,336,2444,9.8
28480,Vinny Prospal,2000-01,25.0,5,25,56,56,6,19,25,88.0,,74,11,29,40,123.0,82,5.28,57,380,2242,9.6
28481,Vinny Prospal,2001-02,26.0,6,36,79,79,10,26,36,114.0,1031.0,153,21,55,76,237.0,82,5.27,57,359,2285,9.4
28482,Vinny Prospal,2002-03,27.0,7,55,79,79,22,33,55,204.0,1299.0,232,43,88,131,441.0,82,5.49,53,331,2294,9.8
28483,Vinny Prospal,2003-04,28.0,8,29,74,74,5,24,29,136.0,1082.0,306,48,112,160,577.0,82,5.51,63,376,2272,9.9
28484,Vinny Prospal,2004-05,29.0,9,55,81,81,18,37,55,166.0,1419.0,387,66,149,215,743.0,82,5.24,53,338,2262,9.5
28485,Vinny Prospal,2005-06,30.0,10,79,80,80,22,57,79,134.0,1493.0,467,88,206,294,877.0,82,5.31,60,363,2326,9.4
28486,Vinny Prospal,2006-07,31.0,11,54,82,82,19,35,54,185.0,1527.0,549,107,241,348,1062.0,82,5.14,57,348,2300,9.2
28487,Vinny Prospal,2008-09,33.0,12,80,81,81,25,55,80,236.0,1553.0,630,132,296,428,1298.0,82,6.05,85,480,2458,10.1
28488,Vinny Prospal,2009-10,34.0,13,55,82,82,14,41,55,219.0,1563.0,712,146,337,483,1517.0,82,5.76,70,398,2426,9.7
28489,Vinny Prospal,2010-11,35.0,14,71,80,80,33,38,71,215.0,1550.0,792,179,375,554,1732.0,82,5.44,62,351,2383,9.4
28490,Vinny Prospal,2011-12,36.0,15,45,82,82,19,26,45,194.0,1450.0,874,198,401,599,1926.0,82,5.7,65,341,2477,9.4
28491,Vinny Prospal,2012-13,37.0,16,58,75,75,20,38,58,180.0,1508.0,949,218,439,657,2106.0,82,5.53,56,304,2486,9.1
28492,Vinny Prospal,2013-14,38.0,17,23,29,29,9,14,23,61.0,445.0,978,227,453,680,2167.0,82,5.46,52,291,2492,9.0
28493,Vinny Prospal,2014-15,39.0,18,55,82,82,16,39,55,165.0,1467.0,1060,243,492,735,2332.0,82,5.32,47,271,2439,8.9
28494,Vinny Prospal,2015-16,40.0,19,30,48,48,12,18,30,85.0,793.0,1108,255,510,765,2417.0,48,5.31,29,160,1399,9.1
28495,Vitali Karamnov,1995-96,27.0,4,1,7,7,0,1,1,7.0,,7,0,1,1,7.0,84,7.25,87,443,2603,11.7
28496,Vitali Karamnov,1996-97,28.0,5,21,59,59,9,12,21,66.0,,66,9,13,22,73.0,84,6.48,76,407,2545,10.7
28497,Vitali Karamnov,1997-98,29.0,6,10,26,26,3,7,10,22.0,,92,12,20,32,95.0,48,5.97,37,209,1408,10.2
28498,Vitali Prokhorov,1995-96,29.0,4,5,26,26,4,1,5,21.0,,26,4,1,5,21.0,84,7.25,87,443,2603,11.7
28499,Vitali Prokhorov,1996-97,30.0,5,25,55,55,15,10,25,85.0,,81,19,11,30,106.0,84,6.48,76,407,2545,10.7
28500,Vitali Prokhorov,1997-98,31.0,6,0,2,2,0,0,0,0.0,,83,19,11,30,106.0,48,5.97,37,209,1408,10.2
28501,Vitali Yachmenev,1998-99,24.0,4,53,80,80,19,34,53,133.0,,80,19,34,53,133.0,82,6.29,74,413,2481,10.4
28502,Vitali Yachmenev,1999-00,25.0,5,32,65,65,10,22,32,97.0,,145,29,56,85,230.0,82,5.83,55,336,2444,9.8
28503,Vitali Yachmenev,2000-01,26.0,6,1,4,4,0,1,1,4.0,,149,29,57,86,234.0,82,5.28,57,380,2242,9.6
28504,Vitali Yachmenev,2001-02,27.0,7,17,55,55,7,10,17,83.0,831.0,204,36,67,103,317.0,82,5.27,57,359,2285,9.4
28505,Vitali Yachmenev,2002-03,28.0,8,32,68,68,16,16,32,120.0,1049.0,272,52,83,135,437.0,82,5.49,53,331,2294,9.8
28506,Vitali Yachmenev,2003-04,29.0,9,34,78,78,15,19,34,123.0,1393.0,350,67,102,169,560.0,82,5.51,63,376,2272,9.9
28507,Vitali Yachmenev,2004-05,30.0,10,27,75,75,11,16,27,103.0,1316.0,425,78,118,196,663.0,82,5.24,53,338,2262,9.5
28508,Vitali Yachmenev,2005-06,31.0,11,20,62,62,5,15,20,68.0,1032.0,487,83,133,216,731.0,82,5.31,60,363,2326,9.4
28509,Vitaly Abramov,2021-22,23.0,4,0,1,1,0,0,0,0.0,14.0,1,0,0,0,0.0,82,5.96,47,239,2579,9.5
28510,Vitaly Abramov,2022-23,24.0,5,1,2,2,1,0,1,3.0,12.0,3,1,0,1,3.0,70,5.96,42,208,2192,9.5
28511,Vitaly Vishnevski,2002-03,22.0,4,2,31,31,1,1,2,17.0,516.0,31,1,1,2,17.0,82,5.49,53,331,2294,9.8
28512,Vitaly Vishnevski,2003-04,23.0,5,11,76,76,1,10,11,49.0,1462.0,107,2,11,13,66.0,82,5.51,63,376,2272,9.9
28513,Vitaly Vishnevski,2004-05,24.0,6,3,74,74,0,3,3,54.0,1302.0,181,2,14,16,120.0,82,5.24,53,338,2262,9.5
28514,Vitaly Vishnevski,2005-06,25.0,7,8,80,80,2,6,8,65.0,1134.0,261,4,20,24,185.0,82,5.31,60,363,2326,9.4
28515,Vitaly Vishnevski,2006-07,26.0,8,16,73,73,6,10,16,86.0,1253.0,334,10,30,40,271.0,82,5.14,57,348,2300,9.2
28516,Vitaly Vishnevski,2008-09,28.0,9,8,82,82,1,7,8,90.0,1347.0,416,11,37,48,361.0,82,6.05,85,480,2458,10.1
28517,Vitaly Vishnevski,2009-10,29.0,10,13,67,67,3,10,13,47.0,1154.0,483,14,47,61,408.0,82,5.76,70,398,2426,9.7
28518,Vitaly Vishnevski,2010-11,30.0,11,7,69,69,2,5,7,48.0,1072.0,552,16,52,68,456.0,82,5.44,62,351,2383,9.4
28519,Vitezslav Duris,1983-84,30.0,4,13,57,57,1,12,13,70.0,,57,1,12,13,70.0,80,7.69,77,340,2441,12.6
28520,Vitezslav Duris,1985-86,32.0,5,10,32,32,2,8,10,49.0,,89,3,20,23,119.0,80,7.73,71,310,2444,12.7
28521,Vladimir Chebaturkin,2000-01,25.0,4,2,2,2,0,2,2,0.0,,2,0,2,2,0.0,82,5.28,57,380,2242,9.6
28522,Vladimir Chebaturkin,2001-02,26.0,5,0,8,8,0,0,0,4.0,138.0,10,0,2,2,4.0,82,5.27,57,359,2285,9.4
28523,Vladimir Chebaturkin,2002-03,27.0,6,2,17,17,1,1,2,9.0,288.0,27,1,3,4,13.0,82,5.49,53,331,2294,9.8
28524,Vladimir Chebaturkin,2003-04,28.0,7,3,22,22,1,2,3,5.0,289.0,49,2,5,7,18.0,82,5.51,63,376,2272,9.9
28525,Vladimir Chebaturkin,2004-05,29.0,8,2,13,13,0,2,2,8.0,165.0,62,2,7,9,26.0,82,5.24,53,338,2262,9.5
28526,Vladimir Konstantinov,1994-95,27.0,4,34,79,79,8,26,34,108.0,,79,8,26,34,108.0,80,6.96,77,402,2440,11.4
28527,Vladimir Konstantinov,1995-96,28.0,5,22,82,82,5,17,22,85.0,,161,13,43,56,193.0,84,7.25,87,443,2603,11.7
28528,Vladimir Konstantinov,1996-97,29.0,6,33,80,80,12,21,33,97.0,,241,25,64,89,290.0,84,6.48,76,407,2545,10.7
28529,Vladimir Konstantinov,1997-98,30.0,7,14,47,47,3,11,14,57.0,,288,28,75,103,347.0,48,5.97,37,209,1408,10.2
28530,Vladimir Konstantinov,1998-99,31.0,8,34,81,81,14,20,34,168.0,,369,42,95,137,515.0,82,6.29,74,413,2481,10.4
28531,Vladimir Konstantinov,1999-00,32.0,9,38,77,77,5,33,38,141.0,,446,47,128,175,656.0,82,5.83,55,336,2444,9.8
28532,Vladimir Krutov,1992-93,32.0,4,34,61,61,11,23,34,81.0,,61,11,23,34,81.0,80,7.37,76,367,2421,12.2
28533,Vladimir Malakhov,1995-96,27.0,4,52,64,64,14,38,52,178.0,,64,14,38,52,178.0,84,7.25,87,443,2603,11.7
28534,Vladimir Malakhov,1996-97,28.0,5,57,76,76,10,47,57,235.0,,140,24,85,109,413.0,84,6.48,76,407,2545,10.7
28535,Vladimir Malakhov,1997-98,29.0,6,21,40,40,4,17,21,91.0,,180,28,102,130,504.0,48,5.97,37,209,1408,10.2
28536,Vladimir Malakhov,1998-99,30.0,7,28,61,61,5,23,28,122.0,,241,33,125,158,626.0,82,6.29,74,413,2481,10.4
28537,Vladimir Malakhov,1999-00,31.0,8,30,65,65,10,20,30,177.0,,306,43,145,188,803.0,82,5.83,55,336,2444,9.8
28538,Vladimir Malakhov,2000-01,32.0,9,44,74,74,13,31,44,166.0,,380,56,176,232,969.0,82,5.28,57,380,2242,9.6
28539,Vladimir Malakhov,2001-02,33.0,10,34,62,62,13,21,34,143.0,1456.0,442,69,197,266,1112.0,82,5.27,57,359,2285,9.4
28540,Vladimir Malakhov,2002-03,34.0,11,5,24,24,1,4,5,18.0,494.0,466,70,201,271,1130.0,82,5.49,53,331,2294,9.8
28541,Vladimir Malakhov,2003-04,35.0,12,2,3,3,0,2,2,6.0,57.0,469,70,203,273,1136.0,82,5.51,63,376,2272,9.9
28542,Vladimir Malakhov,2004-05,36.0,13,28,81,81,6,22,28,145.0,1847.0,550,76,225,301,1281.0,82,5.24,53,338,2262,9.5
28543,Vladimir Malakhov,2005-06,37.0,14,17,71,71,3,14,17,131.0,1519.0,621,79,239,318,1412.0,82,5.31,60,363,2326,9.4
28544,Vladimir Malakhov,2006-07,38.0,15,19,62,62,3,16,19,95.0,1236.0,683,82,255,337,1507.0,82,5.14,57,348,2300,9.2
28545,Vladimir Malakhov,2008-09,40.0,16,9,29,29,4,5,9,43.0,601.0,712,86,260,346,1550.0,82,6.05,85,480,2458,10.1
28546,Vladimir Mihalik,2011-12,25.0,4,3,11,11,0,3,3,7.0,147.0,11,0,3,3,7.0,82,5.7,65,341,2477,9.4
28547,Vladimir Mihalik,2012-13,26.0,5,0,4,4,0,0,0,1.0,46.0,15,0,3,3,8.0,82,5.53,56,304,2486,9.1
28548,Vladimir Orszagh,2000-01,23.0,4,1,11,11,0,1,1,9.0,,11,0,1,1,9.0,82,5.28,57,380,2242,9.6
28549,Vladimir Orszagh,2001-02,24.0,5,1,12,12,1,0,1,5.0,79.0,23,1,1,2,14.0,82,5.27,57,359,2285,9.4
28550,Vladimir Orszagh,2002-03,25.0,6,3,11,11,2,1,3,16.0,131.0,34,3,2,5,30.0,82,5.49,53,331,2294,9.8
28551,Vladimir Orszagh,2004-05,27.0,7,36,79,79,15,21,36,113.0,1269.0,113,18,23,41,143.0,82,5.24,53,338,2262,9.5
28552,Vladimir Orszagh,2005-06,28.0,8,32,78,78,16,16,32,152.0,1370.0,191,34,39,73,295.0,82,5.31,60,363,2326,9.4
28553,Vladimir Orszagh,2006-07,29.0,9,37,82,82,16,21,37,124.0,1394.0,273,50,60,110,419.0,82,5.14,57,348,2300,9.2
28554,Vladimir Orszagh,2008-09,31.0,10,9,16,16,4,5,9,23.0,270.0,289,54,65,119,442.0,82,6.05,85,480,2458,10.1
28555,Vladimir Ruzicka,1992-93,29.0,4,17,25,25,11,6,17,52.0,,25,11,6,17,52.0,80,7.37,76,367,2421,12.2
28556,Vladimir Ruzicka,1993-94,30.0,5,16,29,29,8,8,16,51.0,,54,19,14,33,103.0,80,6.91,71,366,2385,11.6
28557,Vladimir Ruzicka,1994-95,31.0,6,75,77,77,39,36,75,228.0,,131,58,50,108,331.0,80,6.96,77,402,2440,11.4
28558,Vladimir Ruzicka,1995-96,32.0,7,41,60,60,19,22,41,146.0,,191,77,72,149,477.0,84,7.25,87,443,2603,11.7
28559,Vladimir Ruzicka,1996-97,33.0,8,18,42,42,5,13,18,64.0,,233,82,85,167,541.0,84,6.48,76,407,2545,10.7
28560,Vladimir Sobotka,2010-11,23.0,4,7,48,48,1,6,7,40.0,424.0,48,1,6,7,40.0,82,5.44,62,351,2383,9.4
28561,Vladimir Sobotka,2011-12,24.0,5,5,25,25,1,4,5,19.0,264.0,73,2,10,12,59.0,82,5.7,65,341,2477,9.4
28562,Vladimir Sobotka,2012-13,25.0,6,10,61,61,4,6,10,67.0,677.0,134,6,16,22,126.0,82,5.53,56,304,2486,9.1
28563,Vladimir Sobotka,2013-14,26.0,7,29,65,65,7,22,29,75.0,1052.0,199,13,38,51,201.0,82,5.46,52,291,2492,9.0
28564,Vladimir Sobotka,2014-15,27.0,8,20,73,73,5,15,20,117.0,1157.0,272,18,53,71,318.0,82,5.32,47,271,2439,8.9
28565,Vladimir Sobotka,2015-16,28.0,9,19,48,48,8,11,19,69.0,742.0,320,26,64,90,387.0,48,5.31,29,160,1399,9.1
28566,Vladimir Sobotka,2016-17,29.0,10,33,61,61,9,24,33,102.0,1021.0,381,35,88,123,489.0,82,5.34,48,269,2463,8.9
28567,Vladimir Sobotka,2019-20,32.0,11,1,1,1,1,0,1,2.0,17.0,382,36,88,124,491.0,82,5.45,47,245,2478,9.0
28568,Vladimir Sobotka,2020-21,33.0,12,31,81,81,11,20,31,136.0,1387.0,463,47,108,155,627.0,82,5.86,50,250,2620,9.2
28569,Vladimir Sobotka,2021-22,34.0,13,13,69,69,5,8,13,71.0,979.0,532,52,116,168,698.0,82,5.96,47,239,2579,9.5
28570,Vladimir Sobotka,2022-23,35.0,14,3,16,16,1,2,3,23.0,228.0,548,53,118,171,721.0,70,5.96,42,208,2192,9.5
28571,Vladimir Tarasenko,2015-16,24.0,4,19,38,38,8,11,19,75.0,510.0,38,8,11,19,75.0,48,5.31,29,160,1399,9.1
28572,Vladimir Tarasenko,2016-17,25.0,5,43,64,64,21,22,43,136.0,971.0,102,29,33,62,211.0,82,5.34,48,269,2463,8.9
28573,Vladimir Tarasenko,2017-18,26.0,6,73,77,77,37,36,73,264.0,1357.0,179,66,69,135,475.0,82,5.32,47,251,2453,8.9
28574,Vladimir Tarasenko,2018-19,27.0,7,74,80,80,40,34,74,292.0,1491.0,259,106,103,209,767.0,82,5.34,48,255,2438,9.0
28575,Vladimir Tarasenko,2019-20,28.0,8,75,82,82,39,36,75,286.0,1515.0,341,145,139,284,1053.0,82,5.45,47,245,2478,9.0
28576,Vladimir Tarasenko,2020-21,29.0,9,66,80,80,33,33,66,306.0,1525.0,421,178,172,350,1359.0,82,5.86,50,250,2620,9.2
28577,Vladimir Tarasenko,2021-22,30.0,10,68,76,76,33,35,68,275.0,1398.0,497,211,207,418,1634.0,82,5.96,47,239,2579,9.5
28578,Vladimir Tarasenko,2022-23,31.0,11,10,10,10,3,7,10,26.0,162.0,507,214,214,428,1660.0,70,5.96,42,208,2192,9.5
28579,Vladimir Tsyplakov,1998-99,29.0,4,10,23,23,5,5,10,40.0,,23,5,5,10,40.0,82,6.29,74,413,2481,10.4
28580,Vladimir Tsyplakov,1999-00,30.0,5,39,67,67,16,23,39,118.0,,90,21,28,49,158.0,82,5.83,55,336,2444,9.8
28581,Vladimir Tsyplakov,2000-01,31.0,6,52,73,73,18,34,52,113.0,,163,39,62,101,271.0,82,5.28,57,380,2242,9.6
28582,Vladimir Tsyplakov,2001-02,32.0,7,23,69,69,11,12,23,111.0,1130.0,232,50,74,124,382.0,82,5.27,57,359,2285,9.4
28583,Vladimir Tsyplakov,2002-03,33.0,8,32,63,63,12,20,32,76.0,774.0,295,62,94,156,458.0,82,5.49,53,331,2294,9.8
28584,Vladimir Tsyplakov,2003-04,34.0,9,14,36,36,7,7,14,39.0,407.0,331,69,101,170,497.0,82,5.51,63,376,2272,9.9
28585,Vladimir Vorobiev,1999-00,27.0,4,10,16,16,5,5,10,42.0,,16,5,5,10,42.0,82,5.83,55,336,2444,9.8
28586,Vladimir Vorobiev,2000-01,28.0,5,4,15,15,2,2,4,27.0,,31,7,7,14,69.0,82,5.28,57,380,2242,9.6
28587,Vladimir Vorobiev,2001-02,29.0,6,2,2,2,2,0,2,5.0,23.0,33,9,7,16,74.0,82,5.27,57,359,2285,9.4
28588,Vladimir Vujtek,1994-95,22.0,4,0,2,2,0,0,0,1.0,,2,0,0,0,1.0,80,6.96,77,402,2440,11.4
28589,Vladimir Vujtek,1995-96,23.0,5,11,30,30,1,10,11,49.0,,32,1,10,11,50.0,84,7.25,87,443,2603,11.7
28590,Vladimir Vujtek,1996-97,24.0,6,19,40,40,4,15,19,66.0,,72,5,25,30,116.0,84,6.48,76,407,2545,10.7
28591,Vladimir Vujtek,2000-01,28.0,7,6,30,30,2,4,6,44.0,,102,7,29,36,160.0,82,5.28,57,380,2242,9.6
28592,Vladimir Vujtek,2002-03,30.0,8,0,3,3,0,0,0,2.0,33.0,105,7,29,36,162.0,82,5.49,53,331,2294,9.8
28593,Vladimir Vujtek,2005-06,33.0,9,1,5,5,0,1,1,3.0,38.0,110,7,30,37,165.0,82,5.31,60,363,2326,9.4
28594,Vladimir Zharkov,2012-13,25.0,4,10,40,40,0,10,10,54.0,458.0,40,0,10,10,54.0,82,5.53,56,304,2486,9.1
28595,Vladimir Zharkov,2013-14,26.0,5,4,38,38,2,2,4,40.0,431.0,78,2,12,14,94.0,82,5.46,52,291,2492,9.0
28596,Vladimir Zharkov,2014-15,27.0,6,0,4,4,0,0,0,0.0,20.0,82,2,12,14,94.0,82,5.32,47,271,2439,8.9
28597,Vladislav Gavrikov,2022-23,27.0,4,18,69,69,5,13,18,81.0,1310.0,69,5,13,18,81.0,70,5.96,42,208,2192,9.5
28598,Vladislav Kamenev,2019-20,23.0,4,0,2,2,0,0,0,1.0,20.0,2,0,0,0,1.0,82,5.45,47,245,2478,9.0
28599,Vladislav Kamenev,2020-21,24.0,5,0,3,3,0,0,0,1.0,26.0,5,0,0,0,2.0,82,5.86,50,250,2620,9.2
28600,Vladislav Kamenev,2021-22,25.0,6,5,23,23,2,3,5,22.0,208.0,28,2,3,5,24.0,82,5.96,47,239,2579,9.5
28601,Vladislav Kamenev,2022-23,26.0,7,8,38,38,1,7,8,32.0,341.0,66,3,10,13,56.0,70,5.96,42,208,2192,9.5
28602,Vladislav Namestnikov,2016-17,24.0,4,0,4,4,0,0,0,4.0,38.0,4,0,0,0,4.0,82,5.34,48,269,2463,8.9
28603,Vladislav Namestnikov,2017-18,25.0,5,16,43,43,9,7,16,46.0,516.0,47,9,7,16,50.0,82,5.32,47,251,2453,8.9
28604,Vladislav Namestnikov,2018-19,26.0,6,35,80,80,14,21,35,106.0,1129.0,127,23,28,51,156.0,82,5.34,48,255,2438,9.0
28605,Vladislav Namestnikov,2019-20,27.0,7,28,74,74,10,18,28,114.0,1094.0,201,33,46,79,270.0,82,5.45,47,245,2478,9.0
28606,Vladislav Namestnikov,2020-21,28.0,8,48,81,81,22,26,48,155.0,1384.0,282,55,72,127,425.0,82,5.86,50,250,2620,9.2
28607,Vladislav Namestnikov,2021-22,29.0,9,31,78,78,11,20,31,119.0,1232.0,360,66,92,158,544.0,82,5.96,47,239,2579,9.5
28608,Vladislav Namestnikov,2022-23,30.0,10,31,65,65,17,14,31,98.0,979.0,425,83,106,189,642.0,70,5.96,42,208,2192,9.5
28609,Vlastimil Kroupa,1996-97,21.0,4,4,27,27,1,3,4,16.0,,27,1,3,4,16.0,84,6.48,76,407,2545,10.7
28610,Vlastimil Kroupa,1997-98,22.0,5,2,14,14,0,2,2,4.0,,41,1,5,6,20.0,48,5.97,37,209,1408,10.2
28611,Vlastimil Kroupa,1998-99,23.0,6,8,27,27,1,7,8,11.0,,68,2,12,14,31.0,82,6.29,74,413,2481,10.4
28612,Vlastimil Kroupa,1999-00,24.0,7,8,35,35,2,6,8,24.0,,103,4,18,22,55.0,82,5.83,55,336,2444,9.8
28613,Vlastimil Kroupa,2000-01,25.0,8,1,2,2,0,1,1,1.0,,105,4,19,23,56.0,82,5.28,57,380,2242,9.6
28614,Vojtech Mozik,2018-19,26.0,4,0,7,7,0,0,0,6.0,93.0,7,0,0,0,6.0,82,5.34,48,255,2438,9.0
28615,Vojtech Polak,2008-09,23.0,4,0,3,3,0,0,0,3.0,20.0,3,0,0,0,3.0,82,6.05,85,480,2458,10.1
28616,Vojtech Polak,2009-10,24.0,5,0,2,2,0,0,0,2.0,15.0,5,0,0,0,5.0,82,5.76,70,398,2426,9.7
28617,Vyacheslav Kozlov,1994-95,22.0,4,2,7,7,0,2,2,9.0,,7,0,2,2,9.0,80,6.96,77,402,2440,11.4
28618,Vyacheslav Kozlov,1995-96,23.0,5,5,17,17,4,1,5,26.0,,24,4,3,7,35.0,84,7.25,87,443,2603,11.7
28619,Vyacheslav Kozlov,1996-97,24.0,6,73,77,77,34,39,73,202.0,,101,38,42,80,237.0,84,6.48,76,407,2545,10.7
28620,Vyacheslav Kozlov,1997-98,25.0,7,33,46,46,13,20,33,97.0,,147,51,62,113,334.0,48,5.97,37,209,1408,10.2
28621,Vyacheslav Kozlov,1998-99,26.0,8,73,82,82,36,37,73,237.0,,229,87,99,186,571.0,82,6.29,74,413,2481,10.4
28622,Vyacheslav Kozlov,1999-00,27.0,9,45,75,75,23,22,45,211.0,,304,110,121,231,782.0,82,5.83,55,336,2444,9.8
28623,Vyacheslav Kozlov,2000-01,28.0,10,52,80,80,25,27,52,221.0,,384,135,148,283,1003.0,82,5.28,57,380,2242,9.6
28624,Vyacheslav Kozlov,2001-02,29.0,11,58,79,79,29,29,58,209.0,1267.0,463,164,177,341,1212.0,82,5.27,57,359,2285,9.4
28625,Vyacheslav Kozlov,2002-03,30.0,12,36,72,72,18,18,36,165.0,1116.0,535,182,195,377,1377.0,82,5.49,53,331,2294,9.8
28626,Vyacheslav Kozlov,2003-04,31.0,13,38,72,72,20,18,38,187.0,1060.0,607,202,213,415,1564.0,82,5.51,63,376,2272,9.9
28627,Vyacheslav Kozlov,2004-05,32.0,14,22,38,38,9,13,22,68.0,628.0,645,211,226,437,1632.0,82,5.24,53,338,2262,9.5
28628,Vyacheslav Kozlov,2005-06,33.0,15,70,79,79,21,49,70,185.0,1581.0,724,232,275,507,1817.0,82,5.31,60,363,2326,9.4
28629,Vyacheslav Kozlov,2006-07,34.0,16,52,76,76,20,32,52,191.0,1546.0,800,252,307,559,2008.0,82,5.14,57,348,2300,9.2
28630,Vyacheslav Kozlov,2008-09,36.0,17,71,82,82,25,46,71,206.0,1458.0,882,277,353,630,2214.0,82,6.05,85,480,2458,10.1
28631,Vyacheslav Kozlov,2009-10,37.0,18,80,81,81,28,52,80,190.0,1660.0,963,305,405,710,2404.0,82,5.76,70,398,2426,9.7
28632,Vyacheslav Kozlov,2010-11,38.0,19,41,82,82,17,24,41,161.0,1307.0,1045,322,429,751,2565.0,82,5.44,62,351,2383,9.4
28633,Vyacheslav Kozlov,2011-12,39.0,20,76,82,82,26,50,76,165.0,1413.0,1127,348,479,827,2730.0,82,5.7,65,341,2477,9.4
28634,Vyacheslav Kozlov,2012-13,40.0,21,26,55,55,8,18,26,113.0,840.0,1182,356,497,853,2843.0,82,5.53,56,304,2486,9.1
28635,Wade Belak,1999-00,23.0,4,0,5,5,0,0,0,1.0,,5,0,0,0,1.0,82,5.83,55,336,2444,9.8
28636,Wade Belak,2000-01,24.0,5,2,8,8,1,1,2,2.0,,13,1,1,2,3.0,82,5.28,57,380,2242,9.6
28637,Wade Belak,2001-02,25.0,6,1,31,31,0,1,1,7.0,247.0,44,1,2,3,10.0,82,5.27,57,359,2285,9.4
28638,Wade Belak,2002-03,26.0,7,2,40,40,0,2,2,11.0,302.0,84,1,4,5,21.0,82,5.49,53,331,2294,9.8
28639,Wade Belak,2003-04,27.0,8,2,39,39,1,1,2,16.0,377.0,123,2,5,7,37.0,82,5.51,63,376,2272,9.9
28640,Wade Belak,2004-05,28.0,9,4,63,63,1,3,4,47.0,582.0,186,3,8,11,84.0,82,5.24,53,338,2262,9.5
28641,Wade Belak,2005-06,29.0,10,9,55,55,3,6,9,33.0,596.0,241,6,14,20,117.0,82,5.31,60,363,2326,9.4
28642,Wade Belak,2006-07,30.0,11,2,34,34,1,1,2,15.0,238.0,275,7,15,22,132.0,82,5.14,57,348,2300,9.2
28643,Wade Belak,2008-09,32.0,12,3,55,55,0,3,3,16.0,549.0,330,7,18,25,148.0,82,6.05,85,480,2458,10.1
28644,Wade Belak,2009-10,33.0,13,3,65,65,0,3,3,16.0,327.0,395,7,21,28,164.0,82,5.76,70,398,2426,9.7
28645,Wade Belak,2010-11,34.0,14,1,47,47,1,0,1,17.0,192.0,442,8,21,29,181.0,82,5.44,62,351,2383,9.4
28646,Wade Belak,2011-12,35.0,15,2,53,53,0,2,2,19.0,278.0,495,8,23,31,200.0,82,5.7,65,341,2477,9.4
28647,Wade Belak,2012-13,36.0,16,2,39,39,0,2,2,8.0,170.0,534,8,25,33,208.0,82,5.53,56,304,2486,9.1
28648,Wade Belak,2013-14,37.0,17,0,15,15,0,0,0,4.0,57.0,549,8,25,33,212.0,82,5.46,52,291,2492,9.0
28649,Wade Brookbank,2006-07,29.0,4,2,29,29,2,0,2,7.0,108.0,29,2,0,2,7.0,82,5.14,57,348,2300,9.2
28650,Wade Brookbank,2008-09,31.0,5,3,32,32,1,2,3,10.0,158.0,61,3,2,5,17.0,82,6.05,85,480,2458,10.1
28651,Wade Brookbank,2009-10,32.0,6,1,7,7,1,0,1,1.0,31.0,68,4,2,6,18.0,82,5.76,70,398,2426,9.7
28652,Wade Brookbank,2010-11,33.0,7,2,32,32,1,1,2,12.0,122.0,100,5,3,8,30.0,82,5.44,62,351,2383,9.4
28653,Wade Brookbank,2011-12,34.0,8,1,27,27,1,0,1,8.0,67.0,127,6,3,9,38.0,82,5.7,65,341,2477,9.4
28654,Wade Campbell,1985-86,25.0,4,3,42,42,1,2,3,37.0,,42,1,2,3,37.0,80,7.73,71,310,2444,12.7
28655,Wade Campbell,1986-87,26.0,5,21,79,79,7,14,21,92.0,,121,8,16,24,129.0,80,7.89,74,336,2448,12.9
28656,Wade Campbell,1987-88,27.0,6,7,40,40,1,6,7,28.0,,161,9,22,31,157.0,80,7.77,71,321,2447,12.7
28657,Wade Campbell,1988-89,28.0,7,1,32,32,0,1,1,13.0,,193,9,23,32,170.0,80,7.94,82,370,2484,12.8
28658,Wade Campbell,1989-90,29.0,8,3,14,14,0,3,3,20.0,,207,9,26,35,190.0,80,7.34,72,344,2400,12.2
28659,Wade Campbell,1990-91,30.0,9,1,6,6,0,1,1,3.0,,213,9,27,36,193.0,80,7.43,89,437,2435,12.2
28660,Wade Megan,2019-20,29.0,4,1,3,3,1,0,1,6.0,26.0,3,1,0,1,6.0,82,5.45,47,245,2478,9.0
28661,Wade Megan,2020-21,30.0,5,0,1,1,0,0,0,1.0,8.0,4,1,0,1,7.0,82,5.86,50,250,2620,9.2
28662,Wade Megan,2021-22,31.0,6,1,11,11,0,1,1,16.0,87.0,15,1,1,2,23.0,82,5.96,47,239,2579,9.5
28663,Wade Redden,1999-00,22.0,4,30,82,82,6,24,30,102.0,,82,6,24,30,102.0,82,5.83,55,336,2444,9.8
28664,Wade Redden,2000-01,23.0,5,22,80,80,8,14,22,103.0,,162,14,38,52,205.0,82,5.28,57,380,2242,9.6
28665,Wade Redden,2001-02,24.0,6,29,72,72,8,21,29,127.0,1688.0,234,22,59,81,332.0,82,5.27,57,359,2285,9.4
28666,Wade Redden,2002-03,25.0,7,36,81,81,10,26,36,163.0,1921.0,315,32,85,117,495.0,82,5.49,53,331,2294,9.8
28667,Wade Redden,2003-04,26.0,8,47,78,78,10,37,47,159.0,1972.0,393,42,122,164,654.0,82,5.51,63,376,2272,9.9
28668,Wade Redden,2004-05,27.0,9,34,79,79,9,25,34,156.0,1983.0,472,51,147,198,810.0,82,5.24,53,338,2262,9.5
28669,Wade Redden,2005-06,28.0,10,45,76,76,10,35,45,154.0,1930.0,548,61,182,243,964.0,82,5.31,60,363,2326,9.4
28670,Wade Redden,2006-07,29.0,11,43,81,81,17,26,43,175.0,2017.0,629,78,208,286,1139.0,82,5.14,57,348,2300,9.2
28671,Wade Redden,2008-09,31.0,12,50,65,65,10,40,50,153.0,1526.0,694,88,248,336,1292.0,82,6.05,85,480,2458,10.1
28672,Wade Redden,2009-10,32.0,13,36,64,64,7,29,36,122.0,1466.0,758,95,277,372,1414.0,82,5.76,70,398,2426,9.7
28673,Wade Redden,2010-11,33.0,14,38,80,80,6,32,38,136.0,1777.0,838,101,309,410,1550.0,82,5.44,62,351,2383,9.4
28674,Wade Redden,2011-12,34.0,15,26,81,81,3,23,26,161.0,1809.0,919,104,332,436,1711.0,82,5.7,65,341,2477,9.4
28675,Wade Redden,2012-13,35.0,16,14,75,75,2,12,14,66.0,1314.0,994,106,344,450,1777.0,82,5.53,56,304,2486,9.1
28676,Wade Redden,2015-16,38.0,17,7,29,29,3,4,7,28.0,437.0,1023,109,348,457,1805.0,48,5.31,29,160,1399,9.1
28677,Wade Skolney,2008-09,27.0,4,0,1,1,0,0,0,0.0,7.0,1,0,0,0,0.0,82,6.05,85,480,2458,10.1
28678,Wally Schreiber,1990-91,28.0,4,11,16,16,6,5,11,29.0,,16,6,5,11,29.0,80,7.43,89,437,2435,12.2
28679,Wally Schreiber,1991-92,29.0,5,7,25,25,2,5,7,41.0,,41,8,10,18,70.0,80,7.48,85,403,2430,12.3
28680,Wally Weir,1982-83,28.0,4,15,73,73,3,12,15,91.0,,73,3,12,15,91.0,80,7.03,61,280,2352,12.0
28681,Wally Weir,1983-84,29.0,5,14,54,54,6,8,14,50.0,,127,9,20,29,141.0,80,7.69,77,340,2441,12.6
28682,Wally Weir,1984-85,30.0,6,8,62,62,3,5,8,46.0,,189,12,25,37,187.0,80,8.03,73,320,2489,12.9
28683,Wally Weir,1985-86,31.0,7,16,58,58,5,11,16,50.0,,247,17,36,53,237.0,80,7.73,71,310,2444,12.7
28684,Wally Weir,1986-87,32.0,8,5,25,25,2,3,5,16.0,,272,19,39,58,253.0,80,7.89,74,336,2448,12.9
28685,Wally Weir,1987-88,33.0,9,8,48,48,2,6,8,32.0,,320,21,45,66,285.0,80,7.77,71,321,2447,12.7
28686,Walt Poddubny,1984-85,24.0,4,7,15,15,3,4,7,24.0,,15,3,4,7,24.0,80,8.03,73,320,2489,12.9
28687,Walt Poddubny,1985-86,25.0,5,59,72,72,28,31,59,163.0,,87,31,35,66,187.0,80,7.73,71,310,2444,12.7
28688,Walt Poddubny,1986-87,26.0,6,25,38,38,11,14,25,77.0,,125,42,49,91,264.0,80,7.89,74,336,2448,12.9
28689,Walt Poddubny,1987-88,27.0,7,20,32,32,5,15,20,51.0,,157,47,64,111,315.0,80,7.77,71,321,2447,12.7
28690,Walt Poddubny,1988-89,28.0,8,34,33,33,12,22,34,76.0,,190,59,86,145,391.0,80,7.94,82,370,2484,12.8
28691,Walt Poddubny,1989-90,29.0,9,87,75,75,40,47,87,253.0,,265,99,133,232,644.0,80,7.34,72,344,2400,12.2
28692,Walt Poddubny,1990-91,30.0,10,88,77,77,38,50,88,202.0,,342,137,183,320,846.0,80,7.43,89,437,2435,12.2
28693,Walt Poddubny,1991-92,31.0,11,75,72,72,38,37,75,197.0,,414,175,220,395,1043.0,80,7.48,85,403,2430,12.3
28694,Walt Poddubny,1992-93,32.0,12,14,33,33,4,10,14,50.0,,447,179,230,409,1093.0,80,7.37,76,367,2421,12.2
28695,Walt Poddubny,1993-94,33.0,13,10,14,14,4,6,10,22.0,,461,183,236,419,1115.0,80,6.91,71,366,2385,11.6
28696,Walt Poddubny,1994-95,34.0,14,3,7,7,1,2,3,9.0,,468,184,238,422,1124.0,80,6.96,77,402,2440,11.4
28697,Warren Babe,1990-91,22.0,4,1,6,6,0,1,1,2.0,,6,0,1,1,2.0,80,7.43,89,437,2435,12.2
28698,Warren Babe,1991-92,23.0,5,5,14,14,2,3,5,15.0,,20,2,4,6,17.0,80,7.48,85,403,2430,12.3
28699,Warren Babe,1993-94,25.0,6,1,1,1,0,1,1,0.0,,21,2,5,7,17.0,80,6.91,71,366,2385,11.6
28700,Warren Foegele,2020-21,24.0,4,3,2,2,2,1,3,6.0,24.0,2,2,1,3,6.0,82,5.86,50,250,2620,9.2
28701,Warren Foegele,2021-22,25.0,5,15,77,77,10,5,15,106.0,962.0,79,12,6,18,112.0,82,5.96,47,239,2579,9.5
28702,Warren Foegele,2022-23,26.0,6,30,68,68,13,17,30,129.0,932.0,147,25,23,48,241.0,70,5.96,42,208,2192,9.5
28703,Warren Holmes,1984-85,27.0,4,2,3,3,0,2,2,6.0,,3,0,2,2,6.0,80,8.03,73,320,2489,12.9
28704,Warren Holmes,1985-86,28.0,5,24,39,39,8,16,24,66.0,,42,8,18,26,72.0,80,7.73,71,310,2444,12.7
28705,Warren Holmes,1986-87,29.0,6,0,3,3,0,0,0,3.0,,45,8,18,26,75.0,80,7.89,74,336,2448,12.9
28706,Warren Luhning,2000-01,25.0,4,0,8,8,0,0,0,6.0,,8,0,0,0,6.0,82,5.28,57,380,2242,9.6
28707,Warren Luhning,2001-02,26.0,5,0,11,11,0,0,0,11.0,102.0,19,0,0,0,17.0,82,5.27,57,359,2285,9.4
28708,Warren Luhning,2002-03,27.0,6,1,10,10,0,1,1,7.0,103.0,29,0,1,1,24.0,82,5.49,53,331,2294,9.8
28709,Warren Miller,1982-83,28.0,4,13,55,55,7,6,13,51.0,,55,7,6,13,51.0,80,7.03,61,280,2352,12.0
28710,Warren Miller,1983-84,29.0,5,44,77,77,22,22,44,160.0,,132,29,28,57,211.0,80,7.69,77,340,2441,12.6
28711,Warren Miller,1984-85,30.0,6,22,74,74,10,12,22,152.0,,206,39,40,79,363.0,80,8.03,73,320,2489,12.9
28712,Warren Miller,1985-86,31.0,7,11,56,56,1,10,11,75.0,,262,40,50,90,438.0,80,7.73,71,310,2444,12.7
28713,Warren Peters,2011-12,29.0,4,1,16,16,1,0,1,13.0,113.0,16,1,0,1,13.0,82,5.7,65,341,2477,9.4
28714,Warren Peters,2012-13,30.0,5,1,11,11,1,0,1,8.0,79.0,27,2,0,2,21.0,82,5.53,56,304,2486,9.1
28715,Warren Peters,2013-14,31.0,6,1,11,11,1,0,1,11.0,96.0,38,3,0,3,32.0,82,5.46,52,291,2492,9.0
28716,Warren Peters,2014-15,32.0,7,5,58,58,1,4,5,54.0,614.0,96,4,4,8,86.0,82,5.32,47,271,2439,8.9
28717,Warren Rychel,1991-92,24.0,4,0,2,2,0,0,0,3.0,,2,0,0,0,3.0,80,7.48,85,403,2430,12.3
28718,Warren Rychel,1995-96,28.0,5,13,70,70,6,7,13,67.0,,72,6,7,13,70.0,84,7.25,87,443,2603,11.7
28719,Warren Rychel,1996-97,29.0,6,19,80,80,10,9,19,105.0,,152,16,16,32,175.0,84,6.48,76,407,2545,10.7
28720,Warren Rychel,1997-98,30.0,7,7,33,33,1,6,7,41.0,,185,17,22,39,216.0,48,5.97,37,209,1408,10.2
28721,Warren Rychel,1998-99,31.0,8,8,52,52,6,2,8,45.0,,237,23,24,47,261.0,82,6.29,74,413,2481,10.4
28722,Warren Rychel,1999-00,32.0,9,17,70,70,10,7,17,59.0,,307,33,31,64,320.0,82,5.83,55,336,2444,9.8
28723,Warren Rychel,2000-01,33.0,10,11,71,71,5,6,11,66.0,,378,38,37,75,386.0,82,5.28,57,380,2242,9.6
28724,Warren Rychel,2001-02,34.0,11,2,28,28,0,2,2,15.0,133.0,406,38,39,77,401.0,82,5.27,57,359,2285,9.4
28725,Warren Young,1984-85,29.0,4,0,1,1,0,0,0,0.0,,1,0,0,0,0.0,80,8.03,73,320,2489,12.9
28726,Warren Young,1985-86,30.0,5,2,4,4,1,1,2,2.0,,5,1,1,2,2.0,80,7.73,71,310,2444,12.7
28727,Warren Young,1986-87,31.0,6,8,15,15,1,7,8,12.0,,20,2,8,10,14.0,80,7.89,74,336,2448,12.9
28728,Warren Young,1987-88,32.0,7,72,80,80,40,32,72,131.0,,100,42,40,82,145.0,80,7.77,71,321,2447,12.7
28729,Warren Young,1988-89,33.0,8,46,79,79,22,24,46,92.0,,179,64,64,128,237.0,80,7.94,82,370,2484,12.8
28730,Warren Young,1989-90,34.0,9,21,50,50,8,13,21,52.0,,229,72,77,149,289.0,80,7.34,72,344,2400,12.2
28731,Warren Young,1990-91,35.0,10,0,7,7,0,0,0,3.0,,236,72,77,149,292.0,80,7.43,89,437,2435,12.2
28732,Wayne Gretzky,1982-83,22.0,4,137,79,79,51,86,137,284.0,,79,51,86,137,284.0,80,7.03,61,280,2352,12.0
28733,Wayne Gretzky,1983-84,23.0,5,164,80,80,55,109,164,261.0,,159,106,195,301,545.0,80,7.69,77,340,2441,12.6
28734,Wayne Gretzky,1984-85,24.0,6,212,80,80,92,120,212,370.0,,239,198,315,513,915.0,80,8.03,73,320,2489,12.9
28735,Wayne Gretzky,1985-86,25.0,7,196,80,80,71,125,196,348.0,,319,269,440,709,1263.0,80,7.73,71,310,2444,12.7
28736,Wayne Gretzky,1986-87,26.0,8,205,74,74,87,118,205,326.0,,393,356,558,914,1589.0,80,7.89,74,336,2448,12.9
28737,Wayne Gretzky,1987-88,27.0,9,208,80,80,73,135,208,354.0,,473,429,693,1122,1943.0,80,7.77,71,321,2447,12.7
28738,Wayne Gretzky,1988-89,28.0,10,215,80,80,52,163,215,350.0,,553,481,856,1337,2293.0,80,7.94,82,370,2484,12.8
28739,Wayne Gretzky,1989-90,29.0,11,183,79,79,62,121,183,288.0,,632,543,977,1520,2581.0,80,7.34,72,344,2400,12.2
28740,Wayne Gretzky,1990-91,30.0,12,149,64,64,40,109,149,211.0,,696,583,1086,1669,2792.0,80,7.43,89,437,2435,12.2
28741,Wayne Gretzky,1991-92,31.0,13,168,78,78,54,114,168,303.0,,774,637,1200,1837,3095.0,80,7.48,85,403,2430,12.3
28742,Wayne Gretzky,1992-93,32.0,14,142,73,73,40,102,142,236.0,,847,677,1302,1979,3331.0,80,7.37,76,367,2421,12.2
28743,Wayne Gretzky,1993-94,33.0,15,163,78,78,41,122,163,212.0,,925,718,1424,2142,3543.0,80,6.91,71,366,2385,11.6
28744,Wayne Gretzky,1994-95,34.0,16,121,74,74,31,90,121,215.0,,999,749,1514,2263,3758.0,80,6.96,77,402,2440,11.4
28745,Wayne Gretzky,1995-96,35.0,17,65,45,45,16,49,65,141.0,,1044,765,1563,2328,3899.0,84,7.25,87,443,2603,11.7
28746,Wayne Gretzky,1996-97,36.0,18,130,81,81,38,92,130,233.0,,1125,803,1655,2458,4132.0,84,6.48,76,407,2545,10.7
28747,Wayne Gretzky,1997-98,37.0,19,48,48,48,11,37,48,142.0,,1173,814,1692,2506,4274.0,48,5.97,37,209,1408,10.2
28748,Wayne Gretzky,1998-99,38.0,20,102,80,80,23,79,102,195.0,,1253,837,1771,2608,4469.0,82,6.29,74,413,2481,10.4
28749,Wayne Gretzky,1999-00,39.0,21,97,82,82,25,72,97,286.0,,1335,862,1843,2705,4755.0,82,5.83,55,336,2444,9.8
28750,Wayne Gretzky,2000-01,40.0,22,90,82,82,23,67,90,201.0,,1417,885,1910,2795,4956.0,82,5.28,57,380,2242,9.6
28751,Wayne Gretzky,2001-02,41.0,23,62,70,70,9,53,62,132.0,1475.0,1487,894,1963,2857,5088.0,82,5.27,57,359,2285,9.4
28752,Wayne Groulx,1987-88,22.0,4,0,1,1,0,0,0,0.0,,1,0,0,0,0.0,80,7.77,71,321,2447,12.7
28753,Wayne McBean,1990-91,21.0,4,1,27,27,0,1,1,21.0,,27,0,1,1,21.0,80,7.43,89,437,2435,12.2
28754,Wayne McBean,1991-92,22.0,5,6,52,52,0,6,6,36.0,,79,0,7,7,57.0,80,7.48,85,403,2430,12.3
28755,Wayne McBean,1992-93,23.0,6,1,5,5,0,1,1,3.0,,84,0,8,8,60.0,80,7.37,76,367,2421,12.2
28756,Wayne McBean,1993-94,24.0,7,19,52,52,5,14,19,93.0,,136,5,22,27,153.0,80,6.91,71,366,2385,11.6
28757,Wayne McBean,1994-95,25.0,8,6,25,25,2,4,6,51.0,,161,7,26,33,204.0,80,6.96,77,402,2440,11.4
28758,Wayne McBean,1996-97,27.0,9,16,50,50,3,13,16,114.0,,211,10,39,49,318.0,84,6.48,76,407,2545,10.7
28759,Wayne Presley,1987-88,22.0,4,1,3,3,0,1,1,0.0,,3,0,1,1,0.0,80,7.77,71,321,2447,12.7
28760,Wayne Presley,1988-89,23.0,5,15,38,38,7,8,15,56.0,,41,7,9,16,56.0,80,7.94,82,370,2484,12.8
28761,Wayne Presley,1989-90,24.0,6,61,80,80,32,29,61,167.0,,121,39,38,77,223.0,80,7.34,72,344,2400,12.2
28762,Wayne Presley,1990-91,25.0,7,22,42,42,12,10,22,89.0,,163,51,48,99,312.0,80,7.43,89,437,2435,12.2
28763,Wayne Presley,1991-92,26.0,8,40,72,72,21,19,40,132.0,,235,72,67,139,444.0,80,7.48,85,403,2430,12.3
28764,Wayne Presley,1992-93,27.0,9,13,49,49,6,7,13,75.0,,284,78,74,152,519.0,80,7.37,76,367,2421,12.2
28765,Wayne Presley,1993-94,28.0,10,34,71,71,15,19,34,141.0,,355,93,93,186,660.0,80,6.91,71,366,2385,11.6
28766,Wayne Presley,1994-95,29.0,11,26,59,59,10,16,26,135.0,,414,103,109,212,795.0,80,6.96,77,402,2440,11.4
28767,Wayne Presley,1995-96,30.0,12,32,79,79,15,17,32,97.0,,493,118,126,244,892.0,84,7.25,87,443,2603,11.7
28768,Wayne Presley,1996-97,31.0,13,25,65,65,17,8,25,93.0,,558,135,134,269,985.0,84,6.48,76,407,2545,10.7
28769,Wayne Presley,1997-98,32.0,14,19,46,46,14,5,19,90.0,,604,149,139,288,1075.0,48,5.97,37,209,1408,10.2
28770,Wayne Presley,1998-99,33.0,15,14,80,80,6,8,14,113.0,,684,155,147,302,1188.0,82,6.29,74,413,2481,10.4
28771,Wayne Primeau,1997-98,21.0,4,1,1,1,1,0,1,2.0,,1,1,0,1,2.0,48,5.97,37,209,1408,10.2
28772,Wayne Primeau,1998-99,22.0,5,0,2,2,0,0,0,0.0,,3,1,0,1,2.0,82,6.29,74,413,2481,10.4
28773,Wayne Primeau,1999-00,23.0,6,6,45,45,2,4,6,25.0,,48,3,4,7,27.0,82,5.83,55,336,2444,9.8
28774,Wayne Primeau,2000-01,24.0,7,12,69,69,6,6,12,51.0,,117,9,10,19,78.0,82,5.28,57,380,2242,9.6
28775,Wayne Primeau,2001-02,25.0,8,13,67,67,5,8,13,55.0,691.0,184,14,18,32,133.0,82,5.27,57,359,2285,9.4
28776,Wayne Primeau,2002-03,26.0,9,17,58,58,7,10,17,75.0,697.0,242,21,28,49,208.0,82,5.49,53,331,2294,9.8
28777,Wayne Primeau,2003-04,27.0,10,22,75,75,3,19,22,77.0,1024.0,317,24,47,71,285.0,82,5.51,63,376,2272,9.9
28778,Wayne Primeau,2004-05,28.0,11,10,33,33,3,7,10,28.0,417.0,350,27,54,81,313.0,82,5.24,53,338,2262,9.5
28779,Wayne Primeau,2005-06,29.0,12,18,77,77,6,12,18,114.0,1251.0,427,33,66,99,427.0,82,5.31,60,363,2326,9.4
28780,Wayne Primeau,2006-07,30.0,13,29,72,72,9,20,29,142.0,1114.0,499,42,86,128,569.0,82,5.14,57,348,2300,9.2
28781,Wayne Primeau,2008-09,32.0,14,22,71,71,11,11,22,101.0,1156.0,570,53,97,150,670.0,82,6.05,85,480,2458,10.1
28782,Wayne Primeau,2009-10,33.0,15,22,78,78,10,12,22,107.0,1056.0,648,63,109,172,777.0,82,5.76,70,398,2426,9.7
28783,Wayne Primeau,2010-11,34.0,16,10,43,43,3,7,10,39.0,475.0,691,66,116,182,816.0,82,5.44,62,351,2383,9.4
28784,Wayne Primeau,2011-12,35.0,17,4,24,24,0,4,4,22.0,249.0,715,66,120,186,838.0,82,5.7,65,341,2477,9.4
28785,Wayne Primeau,2012-13,36.0,18,8,59,59,3,5,8,47.0,652.0,774,69,125,194,885.0,82,5.53,56,304,2486,9.1
28786,Wayne Simmonds,2011-12,23.0,4,23,82,82,9,14,23,127.0,1135.0,82,9,14,23,127.0,82,5.7,65,341,2477,9.4
28787,Wayne Simmonds,2012-13,24.0,5,40,78,78,16,24,40,127.0,1129.0,160,25,38,63,254.0,82,5.53,56,304,2486,9.1
28788,Wayne Simmonds,2013-14,25.0,6,30,80,80,14,16,30,117.0,1076.0,240,39,54,93,371.0,82,5.46,52,291,2492,9.0
28789,Wayne Simmonds,2014-15,26.0,7,49,82,82,28,21,49,197.0,1305.0,322,67,75,142,568.0,82,5.32,47,271,2439,8.9
28790,Wayne Simmonds,2015-16,27.0,8,32,45,45,15,17,32,110.0,704.0,367,82,92,174,678.0,48,5.31,29,160,1399,9.1
28791,Wayne Simmonds,2016-17,28.0,9,60,82,82,29,31,60,209.0,1375.0,449,111,123,234,887.0,82,5.34,48,269,2463,8.9
28792,Wayne Simmonds,2017-18,29.0,10,50,75,75,28,22,50,188.0,1261.0,524,139,145,284,1075.0,82,5.32,47,251,2453,8.9
28793,Wayne Simmonds,2018-19,30.0,11,60,81,81,32,28,60,229.0,1396.0,605,171,173,344,1304.0,82,5.34,48,255,2438,9.0
28794,Wayne Simmonds,2019-20,31.0,12,54,82,82,31,23,54,224.0,1556.0,687,202,196,398,1528.0,82,5.45,47,245,2478,9.0
28795,Wayne Simmonds,2020-21,32.0,13,46,75,75,24,22,46,176.0,1357.0,762,226,218,444,1704.0,82,5.86,50,250,2620,9.2
28796,Wayne Simmonds,2021-22,33.0,14,30,79,79,17,13,30,157.0,1238.0,841,243,231,474,1861.0,82,5.96,47,239,2579,9.5
28797,Wayne Simmonds,2022-23,34.0,15,25,68,68,8,17,25,119.0,1015.0,909,251,248,499,1980.0,70,5.96,42,208,2192,9.5
28798,Wayne Van Dorp,1989-90,28.0,4,0,3,3,0,0,0,3.0,,3,0,0,0,3.0,80,7.34,72,344,2400,12.2
28799,Wayne Van Dorp,1990-91,29.0,5,4,25,25,1,3,4,15.0,,28,1,3,4,18.0,80,7.43,89,437,2435,12.2
28800,Wayne Van Dorp,1991-92,30.0,6,0,8,8,0,0,0,4.0,,36,1,3,4,22.0,80,7.48,85,403,2430,12.3
28801,Wayne Van Dorp,1992-93,31.0,7,11,61,61,7,4,11,38.0,,97,8,7,15,60.0,80,7.37,76,367,2421,12.2
28802,Wayne Van Dorp,1993-94,32.0,8,1,4,4,1,0,1,2.0,,101,9,7,16,62.0,80,6.91,71,366,2385,11.6
28803,Wayne Van Dorp,1994-95,33.0,9,8,24,24,3,5,8,19.0,,125,12,12,24,81.0,80,6.96,77,402,2440,11.4
28804,Wendel Clark,1988-89,22.0,4,45,66,66,34,11,45,164.0,,66,34,11,45,164.0,80,7.94,82,370,2484,12.8
28805,Wendel Clark,1989-90,23.0,5,60,80,80,37,23,60,246.0,,146,71,34,105,410.0,80,7.34,72,344,2400,12.2
28806,Wendel Clark,1990-91,24.0,6,23,28,28,12,11,23,93.0,,174,83,45,128,503.0,80,7.43,89,437,2435,12.2
28807,Wendel Clark,1991-92,25.0,7,11,15,15,7,4,11,30.0,,189,90,49,139,533.0,80,7.48,85,403,2430,12.3
28808,Wendel Clark,1992-93,26.0,8,26,38,38,18,8,26,85.0,,227,108,57,165,618.0,80,7.37,76,367,2421,12.2
28809,Wendel Clark,1993-94,27.0,9,34,63,63,18,16,34,181.0,,290,126,73,199,799.0,80,6.91,71,366,2385,11.6
28810,Wendel Clark,1994-95,28.0,10,40,43,43,19,21,40,158.0,,333,145,94,239,957.0,80,6.96,77,402,2440,11.4
28811,Wendel Clark,1995-96,29.0,11,39,66,66,17,22,39,146.0,,399,162,116,278,1103.0,84,7.25,87,443,2603,11.7
28812,Wendel Clark,1996-97,30.0,12,76,64,64,46,30,76,275.0,,463,208,146,354,1378.0,84,6.48,76,407,2545,10.7
28813,Wendel Clark,1997-98,31.0,13,30,37,37,12,18,30,95.0,,500,220,164,384,1473.0,48,5.97,37,209,1408,10.2
28814,Wendel Clark,1998-99,32.0,14,58,71,71,32,26,58,237.0,,571,252,190,442,1710.0,82,6.29,74,413,2481,10.4
28815,Wendel Clark,1999-00,33.0,15,49,65,65,30,19,49,212.0,,636,282,209,491,1922.0,82,5.83,55,336,2444,9.8
28816,Wendel Clark,2000-01,34.0,16,19,47,47,12,7,19,140.0,,683,294,216,510,2062.0,82,5.28,57,380,2242,9.6
28817,Wendel Clark,2001-02,35.0,17,48,77,77,32,16,48,215.0,1220.0,760,326,232,558,2277.0,82,5.27,57,359,2285,9.4
28818,Wendel Clark,2002-03,36.0,18,6,33,33,4,2,6,63.0,401.0,793,330,234,564,2340.0,82,5.49,53,331,2294,9.8
28819,Wes Jarvis,1982-83,24.0,4,26,63,63,11,15,26,42.0,,63,11,15,26,42.0,80,7.03,61,280,2352,12.0
28820,Wes Jarvis,1983-84,25.0,5,23,55,55,9,14,23,61.0,,118,20,29,49,103.0,80,7.69,77,340,2441,12.6
28821,Wes Jarvis,1984-85,26.0,6,13,26,26,1,12,13,22.0,,144,21,41,62,125.0,80,8.03,73,320,2489,12.9
28822,Wes Jarvis,1985-86,27.0,7,0,3,3,0,0,0,2.0,,147,21,41,62,127.0,80,7.73,71,310,2444,12.7
28823,Wes Jarvis,1986-87,28.0,8,22,61,61,9,13,22,63.0,,208,30,54,84,190.0,80,7.89,74,336,2448,12.9
28824,Wes Jarvis,1987-88,29.0,9,1,26,26,0,1,1,12.0,,234,30,55,85,202.0,80,7.77,71,321,2447,12.7
28825,Wes Jarvis,1988-89,30.0,10,1,2,2,1,0,1,2.0,,236,31,55,86,204.0,80,7.94,82,370,2484,12.8
28826,Wes Jarvis,1990-91,32.0,11,0,1,1,0,0,0,0.0,,237,31,55,86,204.0,80,7.43,89,437,2435,12.2
28827,Wes O'Neill,2011-12,25.0,4,0,3,3,0,0,0,1.0,33.0,3,0,0,0,1.0,82,5.7,65,341,2477,9.4
28828,Wes O'Neill,2012-13,26.0,5,0,2,2,0,0,0,1.0,19.0,5,0,0,0,2.0,82,5.53,56,304,2486,9.1
28829,Wes Walz,1992-93,22.0,4,2,2,2,1,1,2,1.0,,2,1,1,2,1.0,80,7.37,76,367,2421,12.2
28830,Wes Walz,1993-94,23.0,5,16,56,56,8,8,16,57.0,,58,9,9,18,58.0,80,6.91,71,366,2385,11.6
28831,Wes Walz,1994-95,24.0,6,4,17,17,1,3,4,19.0,,75,10,12,22,77.0,80,6.96,77,402,2440,11.4
28832,Wes Walz,1996-97,26.0,7,38,53,53,11,27,38,79.0,,128,21,39,60,156.0,84,6.48,76,407,2545,10.7
28833,Wes Walz,1997-98,27.0,8,18,39,39,6,12,18,73.0,,167,27,51,78,229.0,48,5.97,37,209,1408,10.2
28834,Wes Walz,1998-99,28.0,9,0,2,2,0,0,0,2.0,,169,27,51,78,231.0,82,6.29,74,413,2481,10.4
28835,Wes Walz,2003-04,33.0,10,30,82,82,18,12,30,152.0,1373.0,251,45,63,108,383.0,82,5.51,63,376,2272,9.9
28836,Wes Walz,2004-05,34.0,11,30,64,64,10,20,30,97.0,1069.0,315,55,83,138,480.0,82,5.24,53,338,2262,9.5
28837,Wes Walz,2005-06,35.0,12,32,80,80,13,19,32,115.0,1275.0,395,68,102,170,595.0,82,5.31,60,363,2326,9.4
28838,Wes Walz,2006-07,36.0,13,25,57,57,12,13,25,70.0,929.0,452,80,115,195,665.0,82,5.14,57,348,2300,9.2
28839,Wes Walz,2008-09,38.0,14,37,82,82,19,18,37,127.0,1304.0,534,99,133,232,792.0,82,6.05,85,480,2458,10.1
28840,Wes Walz,2009-10,39.0,15,24,62,62,9,15,24,77.0,923.0,596,108,148,256,869.0,82,5.76,70,398,2426,9.7
28841,Wes Walz,2010-11,40.0,16,4,11,11,1,3,4,9.0,152.0,607,109,151,260,878.0,82,5.44,62,351,2383,9.4
28842,Will Acton,2016-17,29.0,4,5,30,30,3,2,5,18.0,244.0,30,3,2,5,18.0,82,5.34,48,269,2463,8.9
28843,Will Acton,2017-18,30.0,5,0,3,3,0,0,0,2.0,32.0,33,3,2,5,20.0,82,5.32,47,251,2453,8.9
28844,Will Butcher,2020-21,26.0,4,44,81,81,5,39,44,88.0,1301.0,81,5,39,44,88.0,82,5.86,50,250,2620,9.2
28845,Will Butcher,2021-22,27.0,5,30,78,78,4,26,30,108.0,1503.0,159,9,65,74,196.0,82,5.96,47,239,2579,9.5
28846,Will Butcher,2022-23,28.0,6,21,56,56,4,17,21,62.0,1003.0,215,13,82,95,258.0,70,5.96,42,208,2192,9.5
28847,Will O'Neill,2020-21,32.0,4,0,1,1,0,0,0,3.0,9.0,1,0,0,0,3.0,82,5.86,50,250,2620,9.2
28848,William Borgen,2021-22,25.0,4,0,4,4,0,0,0,2.0,66.0,4,0,0,0,2.0,82,5.96,47,239,2579,9.5
28849,William Carrier,2019-20,25.0,4,8,41,41,5,3,8,50.0,369.0,41,5,3,8,50.0,82,5.45,47,245,2478,9.0
28850,William Carrier,2020-21,26.0,5,3,37,37,1,2,3,52.0,327.0,78,6,5,11,102.0,82,5.86,50,250,2620,9.2
28851,William Carrier,2021-22,27.0,6,9,54,54,8,1,9,85.0,537.0,132,14,6,20,187.0,82,5.96,47,239,2579,9.5
28852,William Carrier,2022-23,28.0,7,19,71,71,7,12,19,99.0,701.0,203,21,18,39,286.0,70,5.96,42,208,2192,9.5
28853,William Karlsson,2017-18,25.0,4,5,21,21,3,2,5,29.0,257.0,21,3,2,5,29.0,82,5.32,47,251,2453,8.9
28854,William Karlsson,2018-19,26.0,5,20,81,81,9,11,20,108.0,1172.0,102,12,13,25,137.0,82,5.34,48,255,2438,9.0
28855,William Karlsson,2019-20,27.0,6,25,81,81,6,19,25,96.0,1084.0,183,18,32,50,233.0,82,5.45,47,245,2478,9.0
28856,William Karlsson,2020-21,28.0,7,78,82,82,43,35,78,184.0,1535.0,265,61,67,128,417.0,82,5.86,50,250,2620,9.2
28857,William Karlsson,2021-22,29.0,8,56,82,82,24,32,56,169.0,1545.0,347,85,99,184,586.0,82,5.96,47,239,2579,9.5
28858,William Karlsson,2022-23,30.0,9,46,63,63,15,31,46,138.0,1189.0,410,100,130,230,724.0,70,5.96,42,208,2192,9.5
28859,William Lagesson,2022-23,26.0,4,0,8,8,0,0,0,8.0,95.0,8,0,0,0,8.0,70,5.96,42,208,2192,9.5
28860,William Nylander,2018-19,22.0,4,13,22,22,6,7,13,43.0,359.0,22,6,7,13,43.0,82,5.34,48,255,2438,9.0
28861,William Nylander,2019-20,23.0,5,61,81,81,22,39,61,205.0,1297.0,103,28,46,74,248.0,82,5.45,47,245,2478,9.0
28862,William Nylander,2020-21,24.0,6,61,82,82,20,41,61,184.0,1368.0,185,48,87,135,432.0,82,5.86,50,250,2620,9.2
28863,William Nylander,2021-22,25.0,7,27,54,54,7,20,27,130.0,838.0,239,55,107,162,562.0,82,5.96,47,239,2579,9.5
28864,William Nylander,2022-23,26.0,8,59,68,68,31,28,59,197.0,1238.0,307,86,135,221,759.0,70,5.96,42,208,2192,9.5
28865,Willie Mitchell,2002-03,25.0,4,0,2,2,0,0,0,2.0,32.0,2,0,0,0,2.0,82,5.49,53,331,2294,9.8
28866,Willie Mitchell,2003-04,26.0,5,10,33,33,1,9,10,30.0,592.0,35,1,9,10,32.0,82,5.51,63,376,2272,9.9
28867,Willie Mitchell,2004-05,27.0,6,13,68,68,3,10,13,67.0,1457.0,103,4,19,23,99.0,82,5.24,53,338,2262,9.5
28868,Willie Mitchell,2005-06,28.0,7,14,69,69,2,12,14,67.0,1482.0,172,6,31,37,166.0,82,5.31,60,363,2326,9.4
28869,Willie Mitchell,2006-07,29.0,8,14,70,70,1,13,14,58.0,1582.0,242,7,44,51,224.0,82,5.14,57,348,2300,9.2
28870,Willie Mitchell,2008-09,31.0,9,10,80,80,2,8,10,58.0,1668.0,322,9,52,61,282.0,82,6.05,85,480,2458,10.1
28871,Willie Mitchell,2009-10,32.0,10,11,62,62,1,10,11,54.0,1377.0,384,10,62,72,336.0,82,5.76,70,398,2426,9.7
28872,Willie Mitchell,2010-11,33.0,11,12,72,72,2,10,12,65.0,1670.0,456,12,72,84,401.0,82,5.44,62,351,2383,9.4
28873,Willie Mitchell,2011-12,34.0,12,23,82,82,3,20,23,88.0,1879.0,538,15,92,107,489.0,82,5.7,65,341,2477,9.4
28874,Willie Mitchell,2012-13,35.0,13,12,48,48,4,8,12,47.0,1085.0,586,19,100,119,536.0,82,5.53,56,304,2486,9.1
28875,Willie Mitchell,2013-14,36.0,14,10,57,57,5,5,10,59.0,1243.0,643,24,105,129,595.0,82,5.46,52,291,2492,9.0
28876,Willie Mitchell,2014-15,37.0,15,24,76,76,5,19,24,104.0,1689.0,719,29,124,153,699.0,82,5.32,47,271,2439,8.9
28877,Willie Mitchell,2016-17,39.0,16,12,76,76,1,11,12,73.0,1545.0,795,30,135,165,772.0,82,5.34,48,269,2463,8.9
28878,Willie Mitchell,2017-18,40.0,17,8,66,66,3,5,8,78.0,1431.0,861,33,140,173,850.0,82,5.32,47,251,2453,8.9
28879,Willie Mitchell,2018-19,41.0,18,7,46,46,1,6,7,33.0,917.0,907,34,146,180,883.0,82,5.34,48,255,2438,9.0
28880,Willy Lindstrom,1982-83,31.0,4,49,79,79,23,26,49,243.0,,79,23,26,49,243.0,80,7.03,61,280,2352,12.0
28881,Willy Lindstrom,1983-84,32.0,5,35,72,72,22,13,35,163.0,,151,45,39,84,406.0,80,7.69,77,340,2441,12.6
28882,Willy Lindstrom,1984-85,33.0,6,59,74,74,32,27,59,236.0,,225,77,66,143,642.0,80,8.03,73,320,2489,12.9
28883,Willy Lindstrom,1985-86,34.0,7,56,73,73,26,30,56,225.0,,298,103,96,199,867.0,80,7.73,71,310,2444,12.7
28884,Willy Lindstrom,1986-87,35.0,8,38,73,73,22,16,38,116.0,,371,125,112,237,983.0,80,7.89,74,336,2448,12.9
28885,Willy Lindstrom,1987-88,36.0,9,32,80,80,12,20,32,98.0,,451,137,132,269,1081.0,80,7.77,71,321,2447,12.7
28886,Willy Lindstrom,1988-89,37.0,10,31,71,71,14,17,31,87.0,,522,151,149,300,1168.0,80,7.94,82,370,2484,12.8
28887,Willy Lindstrom,1989-90,38.0,11,23,60,60,10,13,23,93.0,,582,161,162,323,1261.0,80,7.34,72,344,2400,12.2
28888,Wojtek Wolski,2008-09,22.0,4,6,9,9,2,4,6,9.0,88.0,9,2,4,6,9.0,82,6.05,85,480,2458,10.1
28889,Wojtek Wolski,2009-10,23.0,5,50,76,76,22,28,50,165.0,1180.0,85,24,32,56,174.0,82,5.76,70,398,2426,9.7
28890,Wojtek Wolski,2010-11,24.0,6,48,77,77,18,30,48,158.0,1227.0,162,42,62,104,332.0,82,5.44,62,351,2383,9.4
28891,Wojtek Wolski,2011-12,25.0,7,42,78,78,14,28,42,169.0,1434.0,240,56,90,146,501.0,82,5.7,65,341,2477,9.4
28892,Wojtek Wolski,2012-13,26.0,8,65,80,80,23,42,65,195.0,1499.0,320,79,132,211,696.0,82,5.53,56,304,2486,9.1
28893,Wojtek Wolski,2013-14,27.0,9,35,73,73,12,23,35,135.0,1064.0,393,91,155,246,831.0,82,5.46,52,291,2492,9.0
28894,Wojtek Wolski,2014-15,28.0,10,12,31,31,4,8,12,50.0,427.0,424,95,163,258,881.0,82,5.32,47,271,2439,8.9
28895,Wojtek Wolski,2015-16,29.0,11,9,27,27,4,5,9,49.0,360.0,451,99,168,267,930.0,48,5.31,29,160,1399,9.1
28896,Wyatt Smith,2002-03,25.0,4,0,2,2,0,0,0,0.0,23.0,2,0,0,0,0.0,82,5.49,53,331,2294,9.8
28897,Wyatt Smith,2003-04,26.0,5,10,42,42,3,7,10,40.0,518.0,44,3,7,10,40.0,82,5.51,63,376,2272,9.9
28898,Wyatt Smith,2004-05,27.0,6,0,10,10,0,0,0,4.0,106.0,54,3,7,10,44.0,82,5.24,53,338,2262,9.5
28899,Wyatt Smith,2005-06,28.0,7,1,11,11,1,0,1,8.0,131.0,65,4,7,11,52.0,82,5.31,60,363,2326,9.4
28900,Wyatt Smith,2006-07,29.0,8,4,18,18,3,1,4,21.0,186.0,83,7,8,15,73.0,82,5.14,57,348,2300,9.2
28901,Wyatt Smith,2008-09,31.0,9,8,42,42,0,8,8,37.0,472.0,125,7,16,23,110.0,82,6.05,85,480,2458,10.1
28902,Wyatt Smith,2009-10,32.0,10,6,61,61,3,3,6,44.0,580.0,186,10,19,29,154.0,82,5.76,70,398,2426,9.7
28903,Wyatt Smith,2010-11,33.0,11,3,25,25,0,3,3,25.0,291.0,211,10,22,32,179.0,82,5.44,62,351,2383,9.4
28904,Xavier Delisle,2001-02,24.0,4,0,2,2,0,0,0,1.0,12.0,2,0,0,0,1.0,82,5.27,57,359,2285,9.4
28905,Xavier Delisle,2003-04,26.0,5,5,14,14,3,2,5,15.0,143.0,16,3,2,5,16.0,82,5.51,63,376,2272,9.9
28906,Xavier Ouellet,2016-17,23.0,4,0,4,4,0,0,0,4.0,58.0,4,0,0,0,4.0,82,5.34,48,269,2463,8.9
28907,Xavier Ouellet,2017-18,24.0,5,3,21,21,2,1,3,27.0,344.0,25,2,1,3,31.0,82,5.32,47,251,2453,8.9
28908,Xavier Ouellet,2018-19,25.0,6,1,5,5,0,1,1,4.0,81.0,30,2,2,4,35.0,82,5.34,48,255,2438,9.0
28909,Xavier Ouellet,2019-20,26.0,7,12,66,66,3,9,12,89.0,1186.0,96,5,11,16,124.0,82,5.45,47,245,2478,9.0
28910,Xavier Ouellet,2020-21,27.0,8,7,45,45,0,7,7,57.0,624.0,141,5,18,23,181.0,82,5.86,50,250,2620,9.2
28911,Xavier Ouellet,2021-22,28.0,9,3,19,19,0,3,3,32.0,323.0,160,5,21,26,213.0,82,5.96,47,239,2579,9.5
28912,Xavier Ouellet,2022-23,29.0,10,2,12,12,0,2,2,8.0,167.0,172,5,23,28,221.0,70,5.96,42,208,2192,9.5
28913,Yakov Trenin,2022-23,26.0,4,6,21,21,2,4,6,25.0,204.0,21,2,4,6,25.0,70,5.96,42,208,2192,9.5
28914,Yan Golubovsky,2000-01,24.0,4,2,12,12,0,2,2,9.0,,12,0,2,2,9.0,82,5.28,57,380,2242,9.6
28915,Yan Golubovsky,2001-02,25.0,5,1,17,17,0,1,1,10.0,164.0,29,0,3,3,19.0,82,5.27,57,359,2285,9.4
28916,Yan Golubovsky,2002-03,26.0,6,3,21,21,1,2,3,7.0,187.0,50,1,5,6,26.0,82,5.49,53,331,2294,9.8
28917,Yan Golubovsky,2003-04,27.0,7,2,6,6,0,2,2,4.0,100.0,56,1,7,8,30.0,82,5.51,63,376,2272,9.9
28918,Yan Kaminsky,1996-97,25.0,4,3,24,24,2,1,3,23.0,,24,2,1,3,23.0,84,6.48,76,407,2545,10.7
28919,Yan Kaminsky,1997-98,26.0,5,2,2,2,1,1,2,4.0,,26,3,2,5,27.0,48,5.97,37,209,1408,10.2
28920,Yan Stastny,2008-09,26.0,4,4,20,20,1,3,4,14.0,195.0,20,1,3,4,14.0,82,6.05,85,480,2458,10.1
28921,Yan Stastny,2009-10,27.0,5,2,21,21,0,2,2,7.0,157.0,41,1,5,6,21.0,82,5.76,70,398,2426,9.7
28922,Yan Stastny,2010-11,28.0,6,2,12,12,1,1,2,10.0,132.0,53,2,6,8,31.0,82,5.44,62,351,2383,9.4
28923,Yan Stastny,2011-12,29.0,7,7,34,34,3,4,7,30.0,433.0,87,5,10,15,61.0,82,5.7,65,341,2477,9.4
28924,Yan Stastny,2012-13,30.0,8,1,4,4,1,0,1,7.0,38.0,91,6,10,16,68.0,82,5.53,56,304,2486,9.1
28925,Yanic Perreault,1996-97,25.0,4,6,13,13,3,3,6,24.0,,13,3,3,6,24.0,84,6.48,76,407,2545,10.7
28926,Yanic Perreault,1997-98,26.0,5,7,26,26,2,5,7,43.0,,39,5,8,13,67.0,48,5.97,37,209,1408,10.2
28927,Yanic Perreault,1998-99,27.0,6,49,78,78,25,24,49,175.0,,117,30,32,62,242.0,82,6.29,74,413,2481,10.4
28928,Yanic Perreault,1999-00,28.0,7,25,41,41,11,14,25,98.0,,158,41,46,87,340.0,82,5.83,55,336,2444,9.8
28929,Yanic Perreault,2000-01,29.0,8,48,79,79,28,20,48,206.0,,237,69,66,135,546.0,82,5.28,57,380,2242,9.6
28930,Yanic Perreault,2001-02,30.0,9,42,76,76,17,25,42,141.0,1146.0,313,86,91,177,687.0,82,5.27,57,359,2285,9.4
28931,Yanic Perreault,2002-03,31.0,10,45,58,58,18,27,45,114.0,887.0,371,104,118,222,801.0,82,5.49,53,331,2294,9.8
28932,Yanic Perreault,2003-04,32.0,11,52,76,76,24,28,52,134.0,1066.0,447,128,146,274,935.0,82,5.51,63,376,2272,9.9
28933,Yanic Perreault,2004-05,33.0,12,56,82,82,27,29,56,156.0,1377.0,529,155,175,330,1091.0,82,5.24,53,338,2262,9.5
28934,Yanic Perreault,2005-06,34.0,13,46,73,73,24,22,46,145.0,1174.0,602,179,197,376,1236.0,82,5.31,60,363,2326,9.4
28935,Yanic Perreault,2006-07,35.0,14,31,69,69,16,15,31,114.0,950.0,671,195,212,407,1350.0,82,5.14,57,348,2300,9.2
28936,Yanic Perreault,2008-09,37.0,15,57,69,69,22,35,57,145.0,1031.0,740,217,247,464,1495.0,82,6.05,85,480,2458,10.1
28937,Yanic Perreault,2009-10,38.0,16,38,66,66,21,17,38,125.0,1026.0,806,238,264,502,1620.0,82,5.76,70,398,2426,9.7
28938,Yanic Perreault,2010-11,39.0,17,14,53,53,9,5,14,58.0,610.0,859,247,269,516,1678.0,82,5.44,62,351,2383,9.4
28939,Yanick Dupre,1994-95,22.0,4,0,1,1,0,0,0,0.0,,1,0,0,0,0.0,80,6.96,77,402,2440,11.4
28940,Yanick Dupre,1997-98,25.0,5,0,22,22,0,0,0,21.0,,23,0,0,0,21.0,48,5.97,37,209,1408,10.2
28941,Yanick Dupre,1998-99,26.0,6,2,12,12,2,0,2,10.0,,35,2,0,2,31.0,82,6.29,74,413,2481,10.4
28942,Yanick Lehoux,2008-09,26.0,4,1,3,3,1,0,1,5.0,29.0,3,1,0,1,5.0,82,6.05,85,480,2458,10.1
28943,Yanick Lehoux,2009-10,27.0,5,3,7,7,1,2,3,10.0,88.0,10,2,2,4,15.0,82,5.76,70,398,2426,9.7
28944,Yann Sauve,2013-14,23.0,4,0,5,5,0,0,0,6.0,65.0,5,0,0,0,6.0,82,5.46,52,291,2492,9.0
28945,Yann Sauve,2016-17,26.0,5,0,3,3,0,0,0,1.0,37.0,8,0,0,0,7.0,82,5.34,48,269,2463,8.9
28946,Yanni Gourde,2018-19,27.0,4,1,2,2,0,1,1,0.0,15.0,2,0,1,1,0.0,82,5.34,48,255,2438,9.0
28947,Yanni Gourde,2019-20,28.0,5,8,20,20,6,2,8,30.0,307.0,22,6,3,9,30.0,82,5.45,47,245,2478,9.0
28948,Yanni Gourde,2020-21,29.0,6,64,82,82,25,39,64,136.0,1325.0,104,31,42,73,166.0,82,5.86,50,250,2620,9.2
28949,Yanni Gourde,2021-22,30.0,7,48,80,80,22,26,48,130.0,1267.0,184,53,68,121,296.0,82,5.96,47,239,2579,9.5
28950,Yanni Gourde,2022-23,31.0,8,30,70,70,10,20,30,110.0,985.0,254,63,88,151,406.0,70,5.96,42,208,2192,9.5
28951,Yannick Tremblay,1999-00,24.0,4,0,5,5,0,0,0,2.0,,5,0,0,0,2.0,82,5.83,55,336,2444,9.8
28952,Yannick Tremblay,2000-01,25.0,5,6,38,38,2,4,6,45.0,,43,2,4,6,47.0,82,5.28,57,380,2242,9.6
28953,Yannick Tremblay,2001-02,26.0,6,9,35,35,2,7,9,37.0,618.0,78,4,11,15,84.0,82,5.27,57,359,2285,9.4
28954,Yannick Tremblay,2002-03,27.0,7,31,75,75,10,21,31,139.0,1459.0,153,14,32,46,223.0,82,5.49,53,331,2294,9.8
28955,Yannick Tremblay,2003-04,28.0,8,12,46,46,4,8,12,102.0,940.0,199,18,40,58,325.0,82,5.51,63,376,2272,9.9
28956,Yannick Tremblay,2004-05,29.0,9,24,66,66,9,15,24,115.0,1441.0,265,27,55,82,440.0,82,5.24,53,338,2262,9.5
28957,Yannick Tremblay,2005-06,30.0,10,30,75,75,8,22,30,151.0,1631.0,340,35,77,112,591.0,82,5.31,60,363,2326,9.4
28958,Yannick Tremblay,2006-07,31.0,11,10,38,38,2,8,10,47.0,821.0,378,37,85,122,638.0,82,5.14,57,348,2300,9.2
28959,Yannick Tremblay,2009-10,34.0,12,3,12,12,1,2,3,30.0,153.0,390,38,87,125,668.0,82,5.76,70,398,2426,9.7
28960,Yannick Weber,2011-12,23.0,4,1,3,3,0,1,1,6.0,45.0,3,0,1,1,6.0,82,5.7,65,341,2477,9.4
28961,Yannick Weber,2012-13,24.0,5,0,5,5,0,0,0,2.0,69.0,8,0,1,1,8.0,82,5.53,56,304,2486,9.1
28962,Yannick Weber,2013-14,25.0,6,11,41,41,1,10,11,63.0,679.0,49,1,11,12,71.0,82,5.46,52,291,2492,9.0
28963,Yannick Weber,2014-15,26.0,7,18,60,60,4,14,18,88.0,937.0,109,5,25,30,159.0,82,5.32,47,271,2439,8.9
28964,Yannick Weber,2015-16,27.0,8,2,6,6,0,2,2,3.0,83.0,115,5,27,32,162.0,48,5.31,29,160,1399,9.1
28965,Yannick Weber,2016-17,28.0,9,10,49,49,6,4,10,70.0,584.0,164,11,31,42,232.0,82,5.34,48,269,2463,8.9
28966,Yannick Weber,2017-18,29.0,10,21,65,65,11,10,21,117.0,1117.0,229,22,41,63,349.0,82,5.32,47,251,2453,8.9
28967,Yannick Weber,2018-19,30.0,11,7,45,45,0,7,7,65.0,847.0,274,22,48,70,414.0,82,5.34,48,255,2438,9.0
28968,Yannick Weber,2019-20,31.0,12,8,73,73,1,7,8,72.0,870.0,347,23,55,78,486.0,82,5.45,47,245,2478,9.0
28969,Yannick Weber,2020-21,32.0,13,5,47,47,2,3,5,40.0,567.0,394,25,58,83,526.0,82,5.86,50,250,2620,9.2
28970,Yannick Weber,2021-22,33.0,14,8,62,62,2,6,8,67.0,739.0,456,27,64,91,593.0,82,5.96,47,239,2579,9.5
28971,Yannick Weber,2022-23,34.0,15,3,41,41,1,2,3,45.0,574.0,497,28,66,94,638.0,70,5.96,42,208,2192,9.5
28972,Yevgeny Shaldybin,1999-00,24.0,4,1,3,3,1,0,1,5.0,,3,1,0,1,5.0,82,5.83,55,336,2444,9.8
28973,Yohann Auvitu,2019-20,30.0,4,4,25,25,2,2,4,54.0,390.0,25,2,2,4,54.0,82,5.45,47,245,2478,9.0
28974,Yohann Auvitu,2020-21,31.0,5,9,33,33,3,6,9,69.0,447.0,58,5,8,13,123.0,82,5.86,50,250,2620,9.2
28975,Yuri Babenko,2003-04,26.0,4,0,3,3,0,0,0,2.0,32.0,3,0,0,0,2.0,82,5.51,63,376,2272,9.9
28976,Yuri Butsayev,2002-03,24.0,4,8,57,57,5,3,8,46.0,547.0,57,5,3,8,46.0,82,5.49,53,331,2294,9.8
28977,Yuri Butsayev,2003-04,25.0,5,2,15,15,1,1,2,18.0,137.0,72,6,4,10,64.0,82,5.51,63,376,2272,9.9
28978,Yuri Butsayev,2004-05,26.0,6,2,11,11,2,0,2,10.0,137.0,83,8,4,12,74.0,82,5.24,53,338,2262,9.5
28979,Yuri Butsayev,2005-06,27.0,7,2,16,16,2,0,2,21.0,193.0,99,10,4,14,95.0,82,5.31,60,363,2326,9.4
28980,Yuri Khmylev,1995-96,31.0,4,39,68,68,20,19,39,122.0,,68,20,19,39,122.0,84,7.25,87,443,2603,11.7
28981,Yuri Khmylev,1996-97,32.0,5,58,72,72,27,31,58,171.0,,140,47,50,97,293.0,84,6.48,76,407,2545,10.7
28982,Yuri Khmylev,1997-98,33.0,6,25,48,48,8,17,25,71.0,,188,55,67,122,364.0,48,5.97,37,209,1408,10.2
28983,Yuri Khmylev,1998-99,34.0,7,29,73,73,8,21,29,136.0,,261,63,88,151,500.0,82,6.29,74,413,2481,10.4
28984,Yuri Khmylev,1999-00,35.0,8,1,2,2,1,0,1,3.0,,263,64,88,152,503.0,82,5.83,55,336,2444,9.8
28985,Yvan Joly,1983-84,23.0,4,0,1,1,0,0,0,0.0,,1,0,0,0,0.0,80,7.69,77,340,2441,12.6
28986,Yvan Joly,1985-86,25.0,5,0,1,1,0,0,0,1.0,,2,0,0,0,1.0,80,7.73,71,310,2444,12.7
28987,Yves Beaudoin,1988-89,24.0,4,0,4,4,0,0,0,7.0,,4,0,0,0,7.0,80,7.94,82,370,2484,12.8
28988,Yves Beaudoin,1989-90,25.0,5,0,6,6,0,0,0,4.0,,10,0,0,0,11.0,80,7.34,72,344,2400,12.2
28989,Yves Beaudoin,1990-91,26.0,6,0,1,1,0,0,0,0.0,,11,0,0,0,11.0,80,7.43,89,437,2435,12.2
28990,Yves Courteau,1987-88,23.0,4,5,14,14,1,4,5,18.0,,14,1,4,5,18.0,80,7.77,71,321,2447,12.7
28991,Yves Courteau,1988-89,24.0,5,2,4,4,1,1,2,7.0,,18,2,5,7,25.0,80,7.94,82,370,2484,12.8
28992,Yves Courteau,1989-90,25.0,6,0,4,4,0,0,0,4.0,,22,2,5,7,29.0,80,7.34,72,344,2400,12.2
28993,Yves Heroux,1989-90,24.0,4,0,1,1,0,0,0,0.0,,1,0,0,0,0.0,80,7.34,72,344,2400,12.2
28994,Yves Racine,1992-93,23.0,4,13,28,28,4,9,13,49.0,,28,4,9,13,49.0,80,7.37,76,367,2421,12.2
28995,Yves Racine,1993-94,24.0,5,47,62,62,7,40,47,131.0,,90,11,49,60,180.0,80,6.91,71,366,2385,11.6
28996,Yves Racine,1994-95,25.0,6,24,61,61,2,22,24,103.0,,151,13,71,84,283.0,80,6.96,77,402,2440,11.4
28997,Yves Racine,1995-96,26.0,7,40,80,80,9,31,40,163.0,,231,22,102,124,446.0,84,7.25,87,443,2603,11.7
28998,Yves Racine,1996-97,27.0,8,52,67,67,9,43,52,142.0,,298,31,145,176,588.0,84,6.48,76,407,2545,10.7
28999,Yves Racine,1997-98,28.0,9,11,47,47,4,7,11,63.0,,345,35,152,187,651.0,48,5.97,37,209,1408,10.2
29000,Yves Racine,1998-99,29.0,10,20,57,57,1,19,20,51.0,,402,36,171,207,702.0,82,6.29,74,413,2481,10.4
29001,Yves Racine,1999-00,30.0,11,16,46,46,1,15,16,82.0,,448,37,186,223,784.0,82,5.83,55,336,2444,9.8
29002,Yves Racine,2000-01,31.0,12,8,60,60,0,8,8,76.0,,508,37,194,231,860.0,82,5.28,57,380,2242,9.6
29003,Yves Sarault,1997-98,25.0,4,1,8,8,0,1,1,9.0,,8,0,1,1,9.0,48,5.97,37,209,1408,10.2
29004,Yves Sarault,1998-99,26.0,5,3,25,25,2,1,3,26.0,,33,2,2,4,35.0,82,6.29,74,413,2481,10.4
29005,Yves Sarault,1999-00,27.0,6,3,28,28,2,1,3,41.0,,61,4,3,7,76.0,82,5.83,55,336,2444,9.8
29006,Yves Sarault,2000-01,28.0,7,1,2,2,1,0,1,1.0,,63,5,3,8,77.0,82,5.28,57,380,2242,9.6
29007,Yves Sarault,2001-02,29.0,8,1,11,11,0,1,1,7.0,80.0,74,5,4,9,84.0,82,5.27,57,359,2285,9.4
29008,Yves Sarault,2002-03,30.0,9,2,11,11,0,2,2,13.0,100.0,85,5,6,11,97.0,82,5.49,53,331,2294,9.8
29009,Yves Sarault,2003-04,31.0,10,9,20,20,5,4,9,44.0,263.0,105,10,10,20,141.0,82,5.51,63,376,2272,9.9
29010,Yves Sarault,2004-05,32.0,11,0,1,1,0,0,0,0.0,5.0,106,10,10,20,141.0,82,5.24,53,338,2262,9.5
29011,Yvon Corriveau,1988-89,21.0,4,0,2,2,0,0,0,3.0,,2,0,0,0,3.0,80,7.94,82,370,2484,12.8
29012,Yvon Corriveau,1989-90,22.0,5,2,17,17,1,1,2,7.0,,19,1,1,2,10.0,80,7.34,72,344,2400,12.2
29013,Yvon Corriveau,1990-91,23.0,6,19,44,44,10,9,19,52.0,,63,11,10,21,62.0,80,7.43,89,437,2435,12.2
29014,Yvon Corriveau,1991-92,24.0,7,5,33,33,3,2,5,39.0,,96,14,12,26,101.0,80,7.48,85,403,2430,12.3
29015,Yvon Corriveau,1992-93,25.0,8,20,63,63,13,7,20,90.0,,159,27,19,46,191.0,80,7.37,76,367,2421,12.2
29016,Yvon Corriveau,1993-94,26.0,9,2,23,23,1,1,2,21.0,,182,28,20,48,212.0,80,6.91,71,366,2385,11.6
29017,Yvon Corriveau,1994-95,27.0,10,20,38,38,12,8,20,69.0,,220,40,28,68,281.0,80,6.96,77,402,2440,11.4
29018,Yvon Corriveau,1995-96,28.0,11,20,57,57,8,12,20,77.0,,277,48,40,88,358.0,84,7.25,87,443,2603,11.7
29019,Yvon Corriveau,1996-97,29.0,12,0,3,3,0,0,0,0.0,,280,48,40,88,358.0,84,6.48,76,407,2545,10.7
29020,Yvon Vautour,1982-83,26.0,4,4,17,17,3,1,4,16.0,,17,3,1,4,16.0,80,7.03,61,280,2352,12.0
29021,Yvon Vautour,1983-84,27.0,5,34,74,74,15,19,34,97.0,,91,18,20,38,113.0,80,7.69,77,340,2441,12.6
29022,Yvon Vautour,1984-85,28.0,6,3,14,14,1,2,3,21.0,,105,19,22,41,134.0,80,8.03,73,320,2489,12.9
29023,Yvon Vautour,1985-86,29.0,7,11,52,52,4,7,11,54.0,,157,23,29,52,188.0,80,7.73,71,310,2444,12.7
29024,Yvon Vautour,1986-87,30.0,8,7,42,42,3,4,7,44.0,,199,26,33,59,232.0,80,7.89,74,336,2448,12.9
29025,Yvon Vautour,1987-88,31.0,9,0,5,5,0,0,0,1.0,,204,26,33,59,233.0,80,7.77,71,321,2447,12.7
29026,Zac Boyer,1997-98,26.0,4,0,1,1,0,0,0,1.0,,1,0,0,0,1.0,48,5.97,37,209,1408,10.2
29027,Zac Boyer,1998-99,27.0,5,0,2,2,0,0,0,3.0,,3,0,0,0,4.0,82,6.29,74,413,2481,10.4
29028,Zac Dalpe,2013-14,24.0,4,4,15,15,3,1,4,16.0,119.0,15,3,1,4,16.0,82,5.46,52,291,2492,9.0
29029,Zac Dalpe,2014-15,25.0,5,3,16,16,1,2,3,20.0,153.0,31,4,3,7,36.0,82,5.32,47,271,2439,8.9
29030,Zac Dalpe,2015-16,26.0,6,3,10,10,1,2,3,18.0,123.0,41,5,5,10,54.0,48,5.31,29,160,1399,9.1
29031,Zac Dalpe,2016-17,27.0,7,7,55,55,4,3,7,52.0,392.0,96,9,8,17,106.0,82,5.34,48,269,2463,8.9
29032,Zac Dalpe,2017-18,28.0,8,3,21,21,1,2,3,29.0,195.0,117,10,10,20,135.0,82,5.32,47,251,2453,8.9
29033,Zac Dalpe,2018-19,29.0,9,1,2,2,1,0,1,3.0,21.0,119,11,10,21,138.0,82,5.34,48,255,2438,9.0
29034,Zac Dalpe,2019-20,30.0,10,3,9,9,1,2,3,8.0,77.0,128,12,12,24,146.0,82,5.45,47,245,2478,9.0
29035,Zac Dalpe,2020-21,31.0,11,0,12,12,0,0,0,18.0,89.0,140,12,12,24,164.0,82,5.86,50,250,2620,9.2
29036,Zac Dalpe,2021-22,32.0,12,1,1,1,0,1,1,1.0,9.0,141,12,13,25,165.0,82,5.96,47,239,2579,9.5
29037,Zac Rinaldo,2014-15,24.0,4,9,66,66,2,7,9,54.0,494.0,66,2,7,9,54.0,82,5.32,47,271,2439,8.9
29038,Zac Rinaldo,2015-16,25.0,5,5,32,32,3,2,5,15.0,268.0,98,5,9,14,69.0,48,5.31,29,160,1399,9.1
29039,Zac Rinaldo,2016-17,26.0,6,4,67,67,2,2,4,54.0,516.0,165,7,11,18,123.0,82,5.34,48,269,2463,8.9
29040,Zac Rinaldo,2017-18,27.0,7,6,58,58,1,5,6,45.0,517.0,223,8,16,24,168.0,82,5.32,47,251,2453,8.9
29041,Zac Rinaldo,2018-19,28.0,8,3,52,52,1,2,3,38.0,431.0,275,9,18,27,206.0,82,5.34,48,255,2438,9.0
29042,Zac Rinaldo,2020-21,30.0,9,7,53,53,5,2,7,56.0,598.0,328,14,20,34,262.0,82,5.86,50,250,2620,9.2
29043,Zac Rinaldo,2021-22,31.0,10,3,23,23,1,2,3,11.0,164.0,351,15,22,37,273.0,82,5.96,47,239,2579,9.5
29044,Zac Rinaldo,2022-23,32.0,11,5,19,19,3,2,5,19.0,157.0,370,18,24,42,292.0,70,5.96,42,208,2192,9.5
29045,Zach Aston-Reese,2020-21,26.0,4,6,16,16,4,2,6,20.0,182.0,16,4,2,6,20.0,82,5.86,50,250,2620,9.2
29046,Zach Aston-Reese,2021-22,27.0,5,17,43,43,8,9,17,76.0,587.0,59,12,11,23,96.0,82,5.96,47,239,2579,9.5
29047,Zach Aston-Reese,2022-23,28.0,6,13,57,57,6,7,13,98.0,822.0,116,18,18,36,194.0,70,5.96,42,208,2192,9.5
29048,Zach Bogosian,2011-12,21.0,4,19,47,47,9,10,19,90.0,851.0,47,9,10,19,90.0,82,5.7,65,341,2477,9.4
29049,Zach Bogosian,2012-13,22.0,5,23,81,81,10,13,23,155.0,1734.0,128,19,23,42,245.0,82,5.53,56,304,2486,9.1
29050,Zach Bogosian,2013-14,23.0,6,17,71,71,5,12,17,155.0,1591.0,199,24,35,59,400.0,82,5.46,52,291,2492,9.0
29051,Zach Bogosian,2014-15,24.0,7,30,65,65,5,25,30,150.0,1516.0,264,29,60,89,550.0,82,5.32,47,271,2439,8.9
29052,Zach Bogosian,2015-16,25.0,8,14,33,33,5,9,14,85.0,763.0,297,34,69,103,635.0,48,5.31,29,160,1399,9.1
29053,Zach Bogosian,2016-17,26.0,9,11,55,55,3,8,11,134.0,1260.0,352,37,77,114,769.0,82,5.34,48,269,2463,8.9
29054,Zach Bogosian,2017-18,27.0,10,20,62,62,3,17,20,125.0,1469.0,414,40,94,134,894.0,82,5.32,47,251,2453,8.9
29055,Zach Bogosian,2018-19,28.0,11,24,64,64,7,17,24,121.0,1430.0,478,47,111,158,1015.0,82,5.34,48,255,2438,9.0
29056,Zach Bogosian,2019-20,29.0,12,11,56,56,2,9,11,73.0,1125.0,534,49,120,169,1088.0,82,5.45,47,245,2478,9.0
29057,Zach Bogosian,2020-21,30.0,13,1,18,18,0,1,1,29.0,345.0,552,49,121,170,1117.0,82,5.86,50,250,2620,9.2
29058,Zach Bogosian,2021-22,31.0,14,19,65,65,3,16,19,93.0,1406.0,617,52,137,189,1210.0,82,5.96,47,239,2579,9.5
29059,Zach Bogosian,2022-23,32.0,15,7,27,27,1,6,7,29.0,449.0,644,53,143,196,1239.0,70,5.96,42,208,2192,9.5
29060,Zach Boychuk,2011-12,22.0,4,0,2,2,0,0,0,0.0,24.0,2,0,0,0,0.0,82,5.7,65,341,2477,9.4
29061,Zach Boychuk,2012-13,23.0,5,9,31,31,3,6,9,37.0,333.0,33,3,6,9,37.0,82,5.53,56,304,2486,9.1
29062,Zach Boychuk,2013-14,24.0,6,7,23,23,4,3,7,44.0,247.0,56,7,9,16,81.0,82,5.46,52,291,2492,9.0
29063,Zach Boychuk,2014-15,25.0,7,2,16,16,0,2,2,10.0,143.0,72,7,11,18,91.0,82,5.32,47,271,2439,8.9
29064,Zach Boychuk,2015-16,26.0,8,2,13,13,1,1,2,14.0,160.0,85,8,12,20,105.0,48,5.31,29,160,1399,9.1
29065,Zach Boychuk,2016-17,27.0,9,4,11,11,1,3,4,15.0,112.0,96,9,15,24,120.0,82,5.34,48,269,2463,8.9
29066,Zach Boychuk,2017-18,28.0,10,6,31,31,3,3,6,35.0,329.0,127,12,18,30,155.0,82,5.32,47,251,2453,8.9
29067,Zach Hamill,2012-13,24.0,4,1,1,1,0,1,1,1.0,12.0,1,0,1,1,1.0,82,5.53,56,304,2486,9.1
29068,Zach Hamill,2013-14,25.0,5,1,3,3,0,1,1,1.0,31.0,4,0,2,2,2.0,82,5.46,52,291,2492,9.0
29069,Zach Hamill,2014-15,26.0,6,2,16,16,0,2,2,13.0,176.0,20,0,4,4,15.0,82,5.32,47,271,2439,8.9
29070,Zach Hyman,2018-19,26.0,4,6,16,16,4,2,6,37.0,251.0,16,4,2,6,37.0,82,5.34,48,255,2438,9.0
29071,Zach Hyman,2019-20,27.0,5,28,82,82,10,18,28,156.0,1369.0,98,14,20,34,193.0,82,5.45,47,245,2478,9.0
29072,Zach Hyman,2020-21,28.0,6,40,82,82,15,25,40,148.0,1423.0,180,29,45,74,341.0,82,5.86,50,250,2620,9.2
29073,Zach Hyman,2021-22,29.0,7,41,71,71,21,20,41,144.0,1227.0,251,50,65,115,485.0,82,5.96,47,239,2579,9.5
29074,Zach Hyman,2022-23,30.0,8,37,51,51,21,16,37,106.0,974.0,302,71,81,152,591.0,70,5.96,42,208,2192,9.5
29075,Zach Parise,2008-09,24.0,4,32,81,81,14,18,32,133.0,1064.0,81,14,18,32,133.0,82,6.05,85,480,2458,10.1
29076,Zach Parise,2009-10,25.0,5,62,82,82,31,31,62,247.0,1438.0,163,45,49,94,380.0,82,5.76,70,398,2426,9.7
29077,Zach Parise,2010-11,26.0,6,65,81,81,32,33,65,266.0,1463.0,244,77,82,159,646.0,82,5.44,62,351,2383,9.4
29078,Zach Parise,2011-12,27.0,7,94,82,82,45,49,94,364.0,1538.0,326,122,131,253,1010.0,82,5.7,65,341,2477,9.4
29079,Zach Parise,2012-13,28.0,8,82,81,81,38,44,82,347.0,1602.0,407,160,175,335,1357.0,82,5.53,56,304,2486,9.1
29080,Zach Parise,2013-14,29.0,9,6,13,13,3,3,6,49.0,258.0,420,163,178,341,1406.0,82,5.46,52,291,2492,9.0
29081,Zach Parise,2014-15,30.0,10,69,82,82,31,38,69,293.0,1762.0,502,194,216,410,1699.0,82,5.32,47,271,2439,8.9
29082,Zach Parise,2015-16,31.0,11,38,48,48,18,20,38,182.0,992.0,550,212,236,448,1881.0,48,5.31,29,160,1399,9.1
29083,Zach Parise,2016-17,32.0,12,56,67,67,29,27,56,245.0,1369.0,617,241,263,504,2126.0,82,5.34,48,269,2463,8.9
29084,Zach Parise,2017-18,33.0,13,62,74,74,33,29,62,259.0,1420.0,691,274,292,566,2385.0,82,5.32,47,251,2453,8.9
29085,Zach Parise,2018-19,34.0,14,53,70,70,25,28,53,234.0,1350.0,761,299,320,619,2619.0,82,5.34,48,255,2438,9.0
29086,Zach Parise,2019-20,35.0,15,42,69,69,19,23,42,194.0,1203.0,830,318,343,661,2813.0,82,5.45,47,245,2478,9.0
29087,Zach Parise,2020-21,36.0,16,24,42,42,15,9,24,119.0,717.0,872,333,352,685,2932.0,82,5.86,50,250,2620,9.2
29088,Zach Parise,2021-22,37.0,17,61,74,74,28,33,61,229.0,1381.0,946,361,385,746,3161.0,82,5.96,47,239,2579,9.5
29089,Zach Parise,2022-23,38.0,18,46,69,69,25,21,46,155.0,1187.0,1015,386,406,792,3316.0,70,5.96,42,208,2192,9.5
29090,Zach Redmond,2015-16,27.0,4,4,8,8,1,3,4,13.0,157.0,8,1,3,4,13.0,48,5.31,29,160,1399,9.1
29091,Zach Redmond,2016-17,28.0,5,3,10,10,1,2,3,10.0,153.0,18,2,5,7,23.0,82,5.34,48,269,2463,8.9
29092,Zach Redmond,2017-18,29.0,6,20,59,59,5,15,20,93.0,1012.0,77,7,20,27,116.0,82,5.32,47,251,2453,8.9
29093,Zach Redmond,2018-19,30.0,7,6,37,37,2,4,6,22.0,436.0,114,9,24,33,138.0,82,5.34,48,255,2438,9.0
29094,Zach Redmond,2019-20,31.0,8,5,16,16,0,5,5,12.0,197.0,130,9,29,38,150.0,82,5.45,47,245,2478,9.0
29095,Zach Redmond,2020-21,32.0,9,0,3,3,0,0,0,7.0,43.0,133,9,29,38,157.0,82,5.86,50,250,2620,9.2
29096,Zach Sanford,2019-20,25.0,4,8,39,39,4,4,8,36.0,423.0,39,4,4,8,36.0,82,5.45,47,245,2478,9.0
29097,Zach Sanford,2021-22,27.0,5,20,60,60,8,12,20,77.0,755.0,99,12,16,28,113.0,82,5.96,47,239,2579,9.5
29098,Zach Sanford,2022-23,28.0,6,30,58,58,16,14,30,90.0,797.0,157,28,30,58,203.0,70,5.96,42,208,2192,9.5
29099,Zach Sill,2016-17,28.0,4,0,20,20,0,0,0,14.0,216.0,20,0,0,0,14.0,82,5.34,48,269,2463,8.9
29100,Zach Sill,2017-18,29.0,5,4,63,63,1,3,4,43.0,528.0,83,1,3,4,57.0,82,5.32,47,251,2453,8.9
29101,Zach Sill,2018-19,30.0,6,1,10,10,1,0,1,13.0,99.0,93,2,3,5,70.0,82,5.34,48,255,2438,9.0
29102,Zach Trotman,2016-17,26.0,4,0,2,2,0,0,0,4.0,30.0,2,0,0,0,4.0,82,5.34,48,269,2463,8.9
29103,Zach Trotman,2017-18,27.0,5,5,27,27,1,4,5,46.0,443.0,29,1,4,5,50.0,82,5.32,47,251,2453,8.9
29104,Zach Trotman,2018-19,28.0,6,7,38,38,2,5,7,60.0,705.0,67,3,9,12,110.0,82,5.34,48,255,2438,9.0
29105,Zach Trotman,2020-21,30.0,7,0,3,3,0,0,0,6.0,38.0,70,3,9,12,116.0,82,5.86,50,250,2620,9.2
29106,Zach Trotman,2021-22,31.0,8,1,13,13,0,1,1,16.0,198.0,83,3,10,13,132.0,82,5.96,47,239,2579,9.5
29107,Zach Trotman,2022-23,32.0,9,0,8,8,0,0,0,11.0,118.0,91,3,10,13,143.0,70,5.96,42,208,2192,9.5
29108,Zach Werenski,2019-20,22.0,4,47,78,78,11,36,47,188.0,1631.0,78,11,36,47,188.0,82,5.45,47,245,2478,9.0
29109,Zach Werenski,2020-21,23.0,5,37,77,77,16,21,37,207.0,1738.0,155,27,57,84,395.0,82,5.86,50,250,2620,9.2
29110,Zach Werenski,2021-22,24.0,6,44,82,82,11,33,44,168.0,1878.0,237,38,90,128,563.0,82,5.96,47,239,2579,9.5
29111,Zach Werenski,2022-23,25.0,7,41,63,63,20,21,41,187.0,1511.0,300,58,111,169,750.0,70,5.96,42,208,2192,9.5
29112,Zach Whitecloud,2020-21,24.0,4,0,1,1,0,0,0,0.0,17.0,1,0,0,0,0.0,82,5.86,50,250,2620,9.2
29113,Zach Whitecloud,2022-23,26.0,5,1,16,16,0,1,1,9.0,229.0,17,0,1,1,9.0,70,5.96,42,208,2192,9.5
29114,Zachary Senyshyn,2021-22,24.0,4,1,2,2,1,0,1,4.0,23.0,2,1,0,1,4.0,82,5.96,47,239,2579,9.5
29115,Zachary Senyshyn,2022-23,25.0,5,2,4,4,0,2,2,1.0,34.0,6,1,2,3,5.0,70,5.96,42,208,2192,9.5
29116,Zack Fitzgerald,2010-11,25.0,4,0,1,1,0,0,0,1.0,13.0,1,0,0,0,1.0,82,5.44,62,351,2383,9.4
29117,Zack Kassian,2014-15,24.0,4,10,44,44,4,6,10,54.0,497.0,44,4,6,10,54.0,82,5.32,47,271,2439,8.9
29118,Zack Kassian,2015-16,25.0,5,11,39,39,7,4,11,49.0,526.0,83,11,10,21,103.0,48,5.31,29,160,1399,9.1
29119,Zack Kassian,2016-17,26.0,6,29,73,73,14,15,29,91.0,944.0,156,25,25,50,194.0,82,5.34,48,269,2463,8.9
29120,Zack Kassian,2017-18,27.0,7,16,42,42,10,6,16,55.0,530.0,198,35,31,66,249.0,82,5.32,47,251,2453,8.9
29121,Zack Kassian,2018-19,28.0,8,8,36,36,3,5,8,42.0,448.0,234,38,36,74,291.0,82,5.34,48,255,2438,9.0
29122,Zack Kassian,2019-20,29.0,9,24,79,79,7,17,24,110.0,972.0,313,45,53,98,401.0,82,5.45,47,245,2478,9.0
29123,Zack Kassian,2020-21,30.0,10,19,74,74,7,12,19,86.0,864.0,387,52,65,117,487.0,82,5.86,50,250,2620,9.2
29124,Zack Kassian,2021-22,31.0,11,26,79,79,15,11,26,111.0,1169.0,466,67,76,143,598.0,82,5.96,47,239,2579,9.5
29125,Zack Kassian,2022-23,32.0,12,34,59,59,15,19,34,99.0,924.0,525,82,95,177,697.0,70,5.96,42,208,2192,9.5
29126,Zack MacEwen,2021-22,25.0,4,1,4,4,0,1,1,2.0,29.0,4,0,1,1,2.0,82,5.96,47,239,2579,9.5
29127,Zack MacEwen,2022-23,26.0,5,6,17,17,5,1,6,17.0,163.0,21,5,2,7,19.0,70,5.96,42,208,2192,9.5
29128,Zack Mitchell,2019-20,27.0,4,0,11,11,0,0,0,10.0,93.0,11,0,0,0,10.0,82,5.45,47,245,2478,9.0
29129,Zack Mitchell,2020-21,28.0,5,5,23,23,3,2,5,17.0,242.0,34,3,2,5,27.0,82,5.86,50,250,2620,9.2
29130,Zack Smith,2011-12,23.0,4,0,1,1,0,0,0,0.0,7.0,1,0,0,0,0.0,82,5.7,65,341,2477,9.4
29131,Zack Smith,2012-13,24.0,5,3,15,15,2,1,3,11.0,136.0,16,2,1,3,11.0,82,5.53,56,304,2486,9.1
29132,Zack Smith,2013-14,25.0,6,9,55,55,4,5,9,78.0,693.0,71,6,6,12,89.0,82,5.46,52,291,2492,9.0
29133,Zack Smith,2014-15,26.0,7,26,81,81,14,12,26,134.0,1140.0,152,20,18,38,223.0,82,5.32,47,271,2439,8.9
29134,Zack Smith,2015-16,27.0,8,15,48,48,4,11,15,94.0,727.0,200,24,29,53,317.0,48,5.31,29,160,1399,9.1
29135,Zack Smith,2016-17,28.0,9,22,82,82,13,9,22,154.0,1274.0,282,37,38,75,471.0,82,5.34,48,269,2463,8.9
29136,Zack Smith,2017-18,29.0,10,3,37,37,2,1,3,38.0,445.0,319,39,39,78,509.0,82,5.32,47,251,2453,8.9
29137,Zack Smith,2018-19,30.0,11,36,81,81,25,11,36,121.0,1247.0,400,64,50,114,630.0,82,5.34,48,255,2438,9.0
29138,Zack Smith,2019-20,31.0,12,32,74,74,16,16,32,137.0,1212.0,474,80,66,146,767.0,82,5.45,47,245,2478,9.0
29139,Zack Smith,2020-21,32.0,13,19,68,68,5,14,19,124.0,1137.0,542,85,80,165,891.0,82,5.86,50,250,2620,9.2
29140,Zack Smith,2021-22,33.0,14,28,70,70,9,19,28,101.0,1145.0,612,94,99,193,992.0,82,5.96,47,239,2579,9.5
29141,Zack Smith,2022-23,34.0,15,11,50,50,4,7,11,43.0,589.0,662,98,106,204,1035.0,70,5.96,42,208,2192,9.5
29142,Zack Stortini,2009-10,24.0,4,1,29,29,1,0,1,17.0,207.0,29,1,0,1,17.0,82,5.76,70,398,2426,9.7
29143,Zack Stortini,2010-11,25.0,5,12,66,66,3,9,12,38.0,539.0,95,4,9,13,55.0,82,5.44,62,351,2383,9.4
29144,Zack Stortini,2011-12,26.0,6,11,52,52,6,5,11,23.0,379.0,147,10,14,24,78.0,82,5.7,65,341,2477,9.4
29145,Zack Stortini,2012-13,27.0,7,13,77,77,4,9,13,46.0,715.0,224,14,23,37,124.0,82,5.53,56,304,2486,9.1
29146,Zack Stortini,2013-14,28.0,8,4,32,32,0,4,4,16.0,227.0,256,14,27,41,140.0,82,5.46,52,291,2492,9.0
29147,Zack Stortini,2014-15,29.0,9,0,1,1,0,0,0,1.0,5.0,257,14,27,41,141.0,82,5.32,47,271,2439,8.9
29148,Zarley Zalapski,1990-91,22.0,4,11,15,15,3,8,11,31.0,,15,3,8,11,31.0,80,7.43,89,437,2435,12.2
29149,Zarley Zalapski,1991-92,23.0,5,45,58,58,12,33,45,95.0,,73,15,41,56,126.0,80,7.48,85,403,2430,12.3
29150,Zarley Zalapski,1992-93,24.0,6,31,51,51,6,25,31,85.0,,124,21,66,87,211.0,80,7.37,76,367,2421,12.2
29151,Zarley Zalapski,1993-94,25.0,7,54,77,77,15,39,54,156.0,,201,36,105,141,367.0,80,6.91,71,366,2385,11.6
29152,Zarley Zalapski,1994-95,26.0,8,57,79,79,20,37,57,230.0,,280,56,142,198,597.0,80,6.96,77,402,2440,11.4
29153,Zarley Zalapski,1995-96,27.0,9,65,83,83,14,51,65,192.0,,363,70,193,263,789.0,84,7.25,87,443,2603,11.7
29154,Zarley Zalapski,1996-97,28.0,10,47,69,69,10,37,47,156.0,,432,80,230,310,945.0,84,6.48,76,407,2545,10.7
29155,Zarley Zalapski,1997-98,29.0,11,28,48,48,4,24,28,76.0,,480,84,254,338,1021.0,48,5.97,37,209,1408,10.2
29156,Zarley Zalapski,1998-99,30.0,12,29,80,80,12,17,29,145.0,,560,96,271,367,1166.0,82,6.29,74,413,2481,10.4
29157,Zarley Zalapski,1999-00,31.0,13,0,2,2,0,0,0,7.0,,562,96,271,367,1173.0,82,5.83,55,336,2444,9.8
29158,Zarley Zalapski,2000-01,32.0,14,15,63,63,3,12,15,73.0,,625,99,283,382,1246.0,82,5.28,57,380,2242,9.6
29159,Zarley Zalapski,2002-03,34.0,15,2,12,12,0,2,2,6.0,170.0,637,99,285,384,1252.0,82,5.49,53,331,2294,9.8
29160,Zbynek Michalek,2006-07,24.0,4,2,22,22,1,1,2,17.0,313.0,22,1,1,2,17.0,82,5.14,57,348,2300,9.2
29161,Zbynek Michalek,2008-09,26.0,5,24,82,82,9,15,24,105.0,1872.0,104,10,16,26,122.0,82,6.05,85,480,2458,10.1
29162,Zbynek Michalek,2009-10,27.0,6,28,82,82,4,24,28,144.0,1941.0,186,14,40,54,266.0,82,5.76,70,398,2426,9.7
29163,Zbynek Michalek,2010-11,28.0,7,17,75,75,4,13,17,92.0,1620.0,261,18,53,71,358.0,82,5.44,62,351,2383,9.4
29164,Zbynek Michalek,2011-12,29.0,8,27,82,82,6,21,27,106.0,1863.0,343,24,74,98,464.0,82,5.7,65,341,2477,9.4
29165,Zbynek Michalek,2012-13,30.0,9,17,72,72,3,14,17,104.0,1631.0,415,27,88,115,568.0,82,5.53,56,304,2486,9.1
29166,Zbynek Michalek,2013-14,31.0,10,19,73,73,5,14,19,104.0,1594.0,488,32,102,134,672.0,82,5.46,52,291,2492,9.0
29167,Zbynek Michalek,2014-15,32.0,11,13,62,62,2,11,13,77.0,1342.0,550,34,113,147,749.0,82,5.32,47,271,2439,8.9
29168,Zbynek Michalek,2015-16,33.0,12,2,34,34,0,2,2,42.0,724.0,584,34,115,149,791.0,48,5.31,29,160,1399,9.1
29169,Zbynek Michalek,2016-17,34.0,13,10,59,59,2,8,10,78.0,1238.0,643,36,123,159,869.0,82,5.34,48,269,2463,8.9
29170,Zbynek Michalek,2017-18,35.0,14,12,68,68,4,8,12,86.0,1412.0,711,40,131,171,955.0,82,5.32,47,251,2453,8.9
29171,Zbynek Michalek,2018-19,36.0,15,7,70,70,2,5,7,69.0,1191.0,781,42,136,178,1024.0,82,5.34,48,255,2438,9.0
29172,Zbynek Michalek,2019-20,37.0,16,0,3,3,0,0,0,3.0,53.0,784,42,136,178,1027.0,82,5.45,47,245,2478,9.0
29173,Zdenek Blatny,2005-06,25.0,4,0,4,4,0,0,0,2.0,42.0,4,0,0,0,2.0,82,5.31,60,363,2326,9.4
29174,Zdenek Blatny,2006-07,26.0,5,3,16,16,3,0,3,17.0,167.0,20,3,0,3,19.0,82,5.14,57,348,2300,9.2
29175,Zdenek Blatny,2008-09,28.0,6,0,5,5,0,0,0,3.0,26.0,25,3,0,3,22.0,82,6.05,85,480,2458,10.1
29176,Zdenek Kutlak,2003-04,23.0,4,2,10,10,0,2,2,7.0,161.0,10,0,2,2,7.0,82,5.51,63,376,2272,9.9
29177,Zdenek Kutlak,2005-06,25.0,5,1,4,4,1,0,1,1.0,21.0,14,1,2,3,8.0,82,5.31,60,363,2326,9.4
29178,Zdenek Kutlak,2006-07,26.0,6,0,2,2,0,0,0,0.0,23.0,16,1,2,3,8.0,82,5.14,57,348,2300,9.2
29179,Zdenek Nedved,1997-98,22.0,4,0,1,1,0,0,0,0.0,,1,0,0,0,0.0,48,5.97,37,209,1408,10.2
29180,Zdenek Nedved,1998-99,23.0,5,2,7,7,1,1,2,7.0,,8,1,1,2,7.0,82,6.29,74,413,2481,10.4
29181,Zdenek Nedved,1999-00,24.0,6,8,23,23,3,5,8,22.0,,31,4,6,10,29.0,82,5.83,55,336,2444,9.8
29182,Zdeno Chara,2000-01,23.0,4,1,25,25,0,1,1,10.0,,25,0,1,1,10.0,82,5.28,57,380,2242,9.6
29183,Zdeno Chara,2001-02,24.0,5,8,59,59,2,6,8,56.0,1115.0,84,2,7,9,66.0,82,5.27,57,359,2285,9.4
29184,Zdeno Chara,2002-03,25.0,6,11,65,65,2,9,11,47.0,1486.0,149,4,16,20,113.0,82,5.49,53,331,2294,9.8
29185,Zdeno Chara,2003-04,26.0,7,9,82,82,2,7,9,83.0,1832.0,231,6,23,29,196.0,82,5.51,63,376,2272,9.9
29186,Zdeno Chara,2004-05,27.0,8,23,75,75,10,13,23,105.0,1670.0,306,16,36,52,301.0,82,5.24,53,338,2262,9.5
29187,Zdeno Chara,2005-06,28.0,9,39,74,74,9,30,39,168.0,1847.0,380,25,66,91,469.0,82,5.31,60,363,2326,9.4
29188,Zdeno Chara,2006-07,29.0,10,41,79,79,16,25,41,185.0,1946.0,459,41,91,132,654.0,82,5.14,57,348,2300,9.2
29189,Zdeno Chara,2008-09,31.0,11,43,71,71,16,27,43,212.0,1930.0,530,57,118,175,866.0,82,6.05,85,480,2458,10.1
29190,Zdeno Chara,2009-10,32.0,12,43,80,80,11,32,43,204.0,2237.0,610,68,150,218,1070.0,82,5.76,70,398,2426,9.7
29191,Zdeno Chara,2010-11,33.0,13,51,77,77,17,34,51,207.0,2067.0,687,85,184,269,1277.0,82,5.44,62,351,2383,9.4
29192,Zdeno Chara,2011-12,34.0,14,50,80,80,19,31,50,216.0,2085.0,767,104,215,319,1493.0,82,5.7,65,341,2477,9.4
29193,Zdeno Chara,2012-13,35.0,15,44,80,80,7,37,44,242.0,2030.0,847,111,252,363,1735.0,82,5.53,56,304,2486,9.1
29194,Zdeno Chara,2013-14,36.0,16,44,81,81,14,30,44,264.0,2060.0,928,125,282,407,1999.0,82,5.46,52,291,2492,9.0
29195,Zdeno Chara,2014-15,37.0,17,52,79,79,12,40,52,224.0,1975.0,1007,137,322,459,2223.0,82,5.32,47,271,2439,8.9
29196,Zdeno Chara,2015-16,38.0,18,19,48,48,7,12,19,119.0,1197.0,1055,144,334,478,2342.0,48,5.31,29,160,1399,9.1
29197,Zdeno Chara,2016-17,39.0,19,40,77,77,17,23,40,168.0,1898.0,1132,161,357,518,2510.0,82,5.34,48,269,2463,8.9
29198,Zdeno Chara,2017-18,40.0,20,20,63,63,8,12,20,138.0,1471.0,1195,169,369,538,2648.0,82,5.32,47,251,2453,8.9
29199,Zdeno Chara,2018-19,41.0,21,37,80,80,9,28,37,158.0,1928.0,1275,178,397,575,2806.0,82,5.34,48,255,2438,9.0
29200,Zdeno Chara,2019-20,42.0,22,29,75,75,10,19,29,136.0,1750.0,1350,188,416,604,2942.0,82,5.45,47,245,2478,9.0
29201,Zdeno Chara,2020-21,43.0,23,24,73,73,7,17,24,144.0,1672.0,1423,195,433,628,3086.0,82,5.86,50,250,2620,9.2
29202,Zdeno Chara,2021-22,44.0,24,14,62,62,5,9,14,99.0,1307.0,1485,200,442,642,3185.0,82,5.96,47,239,2579,9.5
29203,Zdeno Chara,2022-23,45.0,25,14,68,68,5,9,14,86.0,1429.0,1553,205,451,656,3271.0,70,5.96,42,208,2192,9.5
29204,Zdeno Ciger,1993-94,24.0,4,25,45,45,8,17,25,82.0,,45,8,17,25,82.0,80,6.91,71,366,2385,11.6
29205,Zdeno Ciger,1994-95,25.0,5,11,20,20,6,5,11,33.0,,65,14,22,36,115.0,80,6.96,77,402,2440,11.4
29206,Zdeno Ciger,1995-96,26.0,6,36,64,64,13,23,36,106.0,,129,27,45,72,221.0,84,7.25,87,443,2603,11.7
29207,Zdeno Ciger,1996-97,27.0,7,57,84,84,22,35,57,158.0,,213,49,80,129,379.0,84,6.48,76,407,2545,10.7
29208,Zdeno Ciger,1997-98,28.0,8,4,5,5,2,2,4,10.0,,218,51,82,133,389.0,48,5.97,37,209,1408,10.2
29209,Zdeno Ciger,1998-99,29.0,9,70,78,78,31,39,70,184.0,,296,82,121,203,573.0,82,6.29,74,413,2481,10.4
29210,Zdeno Ciger,2004-05,35.0,10,25,56,56,12,13,25,92.0,856.0,352,94,134,228,665.0,82,5.24,53,338,2262,9.5
29211,Zemgus Girgensons,2016-17,23.0,4,22,70,70,8,14,22,115.0,1072.0,70,8,14,22,115.0,82,5.34,48,269,2463,8.9
29212,Zemgus Girgensons,2017-18,24.0,5,30,61,61,15,15,30,115.0,1164.0,131,23,29,52,230.0,82,5.32,47,251,2453,8.9
29213,Zemgus Girgensons,2018-19,25.0,6,18,71,71,7,11,18,110.0,1068.0,202,30,40,70,340.0,82,5.34,48,255,2438,9.0
29214,Zemgus Girgensons,2019-20,26.0,7,16,75,75,7,9,16,112.0,987.0,277,37,49,86,452.0,82,5.45,47,245,2478,9.0
29215,Zemgus Girgensons,2020-21,27.0,8,15,71,71,7,8,15,113.0,973.0,348,44,57,101,565.0,82,5.86,50,250,2620,9.2
29216,Zemgus Girgensons,2021-22,28.0,9,18,72,72,5,13,18,78.0,980.0,420,49,70,119,643.0,82,5.96,47,239,2579,9.5
29217,Zemgus Girgensons,2022-23,29.0,10,19,69,69,12,7,19,85.0,952.0,489,61,77,138,728.0,70,5.96,42,208,2192,9.5
29218,Zenith Komarniski,2002-03,24.0,4,2,18,18,1,1,2,21.0,291.0,18,1,1,2,21.0,82,5.49,53,331,2294,9.8
29219,Zenith Komarniski,2005-06,27.0,5,0,1,1,0,0,0,0.0,6.0,19,1,1,2,21.0,82,5.31,60,363,2326,9.4
29220,Zenith Komarniski,2006-07,28.0,6,0,2,2,0,0,0,1.0,30.0,21,1,1,2,22.0,82,5.14,57,348,2300,9.2
29221,Zenon Konopka,2008-09,28.0,4,7,23,23,4,3,7,18.0,168.0,23,4,3,7,18.0,82,6.05,85,480,2458,10.1
29222,Zenon Konopka,2009-10,29.0,5,0,6,6,0,0,0,2.0,30.0,29,4,3,7,20.0,82,5.76,70,398,2426,9.7
29223,Zenon Konopka,2010-11,30.0,6,0,3,3,0,0,0,4.0,24.0,32,4,3,7,24.0,82,5.44,62,351,2383,9.4
29224,Zenon Konopka,2011-12,31.0,7,1,7,7,0,1,1,6.0,49.0,39,4,4,8,30.0,82,5.7,65,341,2477,9.4
29225,Zenon Konopka,2012-13,32.0,8,5,74,74,2,3,5,41.0,602.0,113,6,7,13,71.0,82,5.53,56,304,2486,9.1
29226,Zenon Konopka,2013-14,33.0,9,9,82,82,2,7,9,56.0,836.0,195,8,14,22,127.0,82,5.46,52,291,2492,9.0
29227,Zenon Konopka,2014-15,34.0,10,5,55,55,3,2,5,34.0,431.0,250,11,16,27,161.0,82,5.32,47,271,2439,8.9
29228,Zenon Konopka,2015-16,35.0,11,0,37,37,0,0,0,18.0,312.0,287,11,16,27,179.0,48,5.31,29,160,1399,9.1
29229,Zenon Konopka,2016-17,36.0,12,3,59,59,1,2,3,21.0,466.0,346,12,18,30,200.0,82,5.34,48,269,2463,8.9
29230,Ziggy Palffy,1996-97,24.0,4,0,5,5,0,0,0,5.0,,5,0,0,0,5.0,84,6.48,76,407,2545,10.7
29231,Ziggy Palffy,1997-98,25.0,5,17,33,33,10,7,17,75.0,,38,10,7,17,80.0,48,5.97,37,209,1408,10.2
29232,Ziggy Palffy,1998-99,26.0,6,87,81,81,43,44,87,257.0,,119,53,51,104,337.0,82,6.29,74,413,2481,10.4
29233,Ziggy Palffy,1999-00,27.0,7,90,80,80,48,42,90,292.0,,199,101,93,194,629.0,82,5.83,55,336,2444,9.8
29234,Ziggy Palffy,2000-01,28.0,8,87,82,82,45,42,87,277.0,,281,146,135,281,906.0,82,5.28,57,380,2242,9.6
29235,Ziggy Palffy,2001-02,29.0,9,50,50,50,22,28,50,168.0,1103.0,331,168,163,331,1074.0,82,5.27,57,359,2285,9.4
29236,Ziggy Palffy,2002-03,30.0,10,66,64,64,27,39,66,186.0,1258.0,395,195,202,397,1260.0,82,5.49,53,331,2294,9.8
29237,Ziggy Palffy,2003-04,31.0,11,89,73,73,38,51,89,217.0,1443.0,468,233,253,486,1477.0,82,5.51,63,376,2272,9.9
29238,Ziggy Palffy,2004-05,32.0,12,59,63,63,32,27,59,161.0,1279.0,531,265,280,545,1638.0,82,5.24,53,338,2262,9.5
29239,Ziggy Palffy,2005-06,33.0,13,85,76,76,37,48,85,277.0,1706.0,607,302,328,630,1915.0,82,5.31,60,363,2326,9.4
29240,Ziggy Palffy,2006-07,34.0,14,41,35,35,16,25,41,109.0,754.0,642,318,353,671,2024.0,82,5.14,57,348,2300,9.2
29241,Ziggy Palffy,2008-09,36.0,15,42,42,42,11,31,42,112.0,812.0,684,329,384,713,2136.0,82,6.05,85,480,2458,10.1
